# frame_skip_agent_A, frame_skip_agent_B, episode, score_A, score_B, reward
11,1,0,7,10,-3
11,1,1,13,12,1
11,1,2,11,20,-9
11,1,3,5,6,-1
11,1,4,10,23,-13
11,1,5,5,12,-7
11,1,6,21,10,11
11,1,7,11,17,-6
11,1,8,8,13,-5
11,1,9,7,13,-6
11,1,10,12,12,0
11,1,11,15,12,3
11,1,12,14,9,5
11,1,13,11,27,-16
11,1,14,5,14,-9
11,1,15,11,14,-3
11,1,16,1,3,-2
11,1,17,19,20,-1
11,1,18,6,14,-8
11,1,19,5,11,-6
11,1,20,5,14,-9
11,1,21,5,8,-3
11,1,22,4,7,-3
11,1,23,10,10,0
11,1,24,6,19,-13
11,1,25,12,18,-6
11,1,26,15,15,0
11,1,27,6,15,-9
11,1,28,8,11,-3
11,1,29,3,15,-12
11,1,30,8,5,3
11,1,31,7,9,-2
11,1,32,9,21,-12
11,1,33,16,9,7
11,1,34,10,19,-9
11,1,35,10,17,-7
11,1,36,12,25,-13
11,1,37,18,11,7
11,1,38,10,9,1
11,1,39,8,17,-9
11,1,40,6,8,-2
11,1,41,9,12,-3
11,1,42,4,14,-10
11,1,43,3,12,-9
11,1,44,23,19,4
11,1,45,3,6,-3
11,1,46,9,24,-15
11,1,47,12,12,0
11,1,48,7,17,-10
11,1,49,5,16,-11
11,1,50,5,9,-4
11,1,51,4,6,-2
11,1,52,9,14,-5
11,1,53,17,9,8
11,1,54,5,16,-11
11,1,55,2,9,-7
11,1,56,12,5,7
11,1,57,8,22,-14
11,1,58,7,12,-5
11,1,59,12,9,3
11,1,60,3,14,-11
11,1,61,17,29,-12
11,1,62,19,17,2
11,1,63,5,11,-6
11,1,64,19,14,5
11,1,65,4,13,-9
11,1,66,9,13,-4
11,1,67,10,12,-2
11,1,68,7,14,-7
11,1,69,7,14,-7
11,1,70,12,15,-3
11,1,71,8,16,-8
11,1,72,5,24,-19
11,1,73,9,7,2
11,1,74,25,18,7
11,1,75,6,18,-12
11,1,76,9,13,-4
11,1,77,5,15,-10
11,1,78,6,6,0
11,1,79,4,26,-22
11,1,80,7,4,3
11,1,81,11,8,3
11,1,82,1,7,-6
11,1,83,13,12,1
11,1,84,7,2,5
11,1,85,12,23,-11
11,1,86,8,13,-5
11,1,87,9,16,-7
11,1,88,10,9,1
11,1,89,6,8,-2
11,1,90,11,10,1
11,1,91,14,16,-2
11,1,92,8,9,-1
11,1,93,8,20,-12
11,1,94,9,11,-2
11,1,95,9,3,6
11,1,96,5,12,-7
11,1,97,7,7,0
11,1,98,7,11,-4
11,1,99,8,9,-1
11,1,100,8,16,-8
11,1,101,13,20,-7
11,1,102,0,4,-4
11,1,103,10,21,-11
11,1,104,13,23,-10
11,1,105,15,14,1
11,1,106,13,16,-3
11,1,107,0,12,-12
11,1,108,10,22,-12
11,1,109,17,16,1
11,1,110,13,11,2
11,1,111,18,18,0
11,1,112,13,11,2
11,1,113,10,22,-12
11,1,114,12,16,-4
11,1,115,13,13,0
11,1,116,6,7,-1
11,1,117,9,14,-5
11,1,118,6,15,-9
11,1,119,9,20,-11
11,1,120,6,16,-10
11,1,121,11,12,-1
11,1,122,4,5,-1
11,1,123,6,18,-12
11,1,124,8,19,-11
11,1,125,11,19,-8
11,1,126,18,17,1
11,1,127,20,24,-4
11,1,128,11,11,0
11,1,129,4,11,-7
11,1,130,10,18,-8
11,1,131,7,13,-6
11,1,132,16,6,10
11,1,133,11,18,-7
11,1,134,5,1,4
11,1,135,14,13,1
11,1,136,4,13,-9
11,1,137,4,20,-16
11,1,138,5,10,-5
11,1,139,11,15,-4
11,1,140,6,30,-24
11,1,141,7,10,-3
11,1,142,12,17,-5
11,1,143,4,8,-4
11,1,144,12,18,-6
11,1,145,9,9,0
11,1,146,13,12,1
11,1,147,6,11,-5
11,1,148,9,11,-2
11,1,149,10,14,-4
11,1,150,13,17,-4
11,1,151,6,10,-4
11,1,152,5,19,-14
11,1,153,6,7,-1
11,1,154,10,14,-4
11,1,155,1,11,-10
11,1,156,15,11,4
11,1,157,6,16,-10
11,1,158,8,10,-2
11,1,159,2,11,-9
11,1,160,14,11,3
11,1,161,10,11,-1
11,1,162,8,15,-7
11,1,163,5,8,-3
11,1,164,5,11,-6
11,1,165,7,14,-7
11,1,166,4,19,-15
11,1,167,14,7,7
11,1,168,21,15,6
11,1,169,6,14,-8
11,1,170,8,8,0
11,1,171,12,19,-7
11,1,172,7,11,-4
11,1,173,9,14,-5
11,1,174,10,10,0
11,1,175,6,20,-14
11,1,176,15,15,0
11,1,177,2,1,1
11,1,178,10,11,-1
11,1,179,4,8,-4
11,1,180,8,8,0
11,1,181,5,19,-14
11,1,182,5,21,-16
11,1,183,6,16,-10
11,1,184,10,22,-12
11,1,185,6,6,0
11,1,186,8,18,-10
11,1,187,13,15,-2
11,1,188,6,11,-5
11,1,189,7,18,-11
11,1,190,8,8,0
11,1,191,4,13,-9
11,1,192,7,6,1
11,1,193,8,14,-6
11,1,194,3,30,-27
11,1,195,8,22,-14
11,1,196,8,11,-3
11,1,197,6,15,-9
11,1,198,7,9,-2
11,1,199,5,8,-3
11,1,200,15,16,-1
11,1,201,14,10,4
11,1,202,13,14,-1
11,1,203,4,10,-6
11,1,204,10,9,1
11,1,205,3,16,-13
11,1,206,10,17,-7
11,1,207,5,14,-9
11,1,208,13,11,2
11,1,209,5,2,3
11,1,210,14,11,3
11,1,211,8,10,-2
11,1,212,16,27,-11
11,1,213,10,6,4
11,1,214,12,24,-12
11,1,215,11,14,-3
11,1,216,13,17,-4
11,1,217,7,19,-12
11,1,218,22,11,11
11,1,219,10,13,-3
11,1,220,14,8,6
11,1,221,7,12,-5
11,1,222,4,11,-7
11,1,223,25,15,10
11,1,224,4,14,-10
11,1,225,11,6,5
11,1,226,7,7,0
11,1,227,5,14,-9
11,1,228,4,11,-7
11,1,229,12,4,8
11,1,230,5,13,-8
11,1,231,11,8,3
11,1,232,16,6,10
11,1,233,10,11,-1
11,1,234,4,14,-10
11,1,235,10,5,5
11,1,236,11,6,5
11,1,237,14,23,-9
11,1,238,14,12,2
11,1,239,4,10,-6
11,1,240,7,16,-9
11,1,241,6,14,-8
11,1,242,9,12,-3
11,1,243,10,9,1
11,1,244,8,19,-11
11,1,245,5,9,-4
11,1,246,17,26,-9
11,1,247,4,17,-13
11,1,248,6,10,-4
11,1,249,15,12,3
11,1,250,9,17,-8
11,1,251,7,15,-8
11,1,252,4,14,-10
11,1,253,11,15,-4
11,1,254,8,8,0
11,1,255,6,29,-23
11,1,256,9,14,-5
11,1,257,10,10,0
11,1,258,5,20,-15
11,1,259,10,18,-8
11,1,260,5,23,-18
11,1,261,8,6,2
11,1,262,6,14,-8
11,1,263,18,12,6
11,1,264,9,14,-5
11,1,265,10,11,-1
11,1,266,5,13,-8
11,1,267,8,8,0
11,1,268,3,13,-10
11,1,269,8,14,-6
11,1,270,6,7,-1
11,1,271,5,8,-3
11,1,272,8,15,-7
11,1,273,4,18,-14
11,1,274,25,19,6
11,1,275,14,8,6
11,1,276,4,13,-9
11,1,277,12,22,-10
11,1,278,12,10,2
11,1,279,1,9,-8
11,1,280,4,14,-10
11,1,281,7,7,0
11,1,282,11,7,4
11,1,283,12,19,-7
11,1,284,8,12,-4
11,1,285,5,20,-15
11,1,286,2,8,-6
11,1,287,15,26,-11
11,1,288,13,20,-7
11,1,289,10,9,1
11,1,290,6,16,-10
11,1,291,3,19,-16
11,1,292,10,20,-10
11,1,293,6,10,-4
11,1,294,18,19,-1
11,1,295,9,15,-6
11,1,296,9,6,3
11,1,297,12,12,0
11,1,298,4,17,-13
11,1,299,8,13,-5
11,2,0,7,7,0
11,2,1,9,10,-1
11,2,2,1,3,-2
11,2,3,12,17,-5
11,2,4,6,11,-5
11,2,5,14,19,-5
11,2,6,13,4,9
11,2,7,5,14,-9
11,2,8,8,9,-1
11,2,9,18,9,9
11,2,10,6,11,-5
11,2,11,9,15,-6
11,2,12,19,12,7
11,2,13,3,14,-11
11,2,14,11,13,-2
11,2,15,6,15,-9
11,2,16,22,30,-8
11,2,17,12,12,0
11,2,18,1,13,-12
11,2,19,15,14,1
11,2,20,16,14,2
11,2,21,6,9,-3
11,2,22,10,12,-2
11,2,23,12,9,3
11,2,24,9,9,0
11,2,25,1,10,-9
11,2,26,17,14,3
11,2,27,17,26,-9
11,2,28,12,15,-3
11,2,29,20,22,-2
11,2,30,14,30,-16
11,2,31,6,16,-10
11,2,32,6,20,-14
11,2,33,8,9,-1
11,2,34,12,12,0
11,2,35,9,10,-1
11,2,36,4,5,-1
11,2,37,5,12,-7
11,2,38,16,18,-2
11,2,39,12,17,-5
11,2,40,8,16,-8
11,2,41,5,14,-9
11,2,42,11,19,-8
11,2,43,8,14,-6
11,2,44,6,15,-9
11,2,45,14,17,-3
11,2,46,11,9,2
11,2,47,4,19,-15
11,2,48,17,10,7
11,2,49,11,6,5
11,2,50,1,5,-4
11,2,51,15,25,-10
11,2,52,14,24,-10
11,2,53,12,22,-10
11,2,54,7,14,-7
11,2,55,6,8,-2
11,2,56,9,19,-10
11,2,57,11,15,-4
11,2,58,13,14,-1
11,2,59,21,24,-3
11,2,60,12,22,-10
11,2,61,4,22,-18
11,2,62,7,4,3
11,2,63,10,17,-7
11,2,64,13,12,1
11,2,65,11,24,-13
11,2,66,5,9,-4
11,2,67,9,7,2
11,2,68,6,3,3
11,2,69,10,34,-24
11,2,70,14,19,-5
11,2,71,9,17,-8
11,2,72,4,3,1
11,2,73,8,15,-7
11,2,74,14,8,6
11,2,75,12,11,1
11,2,76,9,15,-6
11,2,77,5,4,1
11,2,78,16,27,-11
11,2,79,12,7,5
11,2,80,17,3,14
11,2,81,19,21,-2
11,2,82,7,19,-12
11,2,83,7,19,-12
11,2,84,10,11,-1
11,2,85,14,14,0
11,2,86,16,7,9
11,2,87,4,24,-20
11,2,88,11,10,1
11,2,89,4,10,-6
11,2,90,8,9,-1
11,2,91,1,11,-10
11,2,92,9,23,-14
11,2,93,16,16,0
11,2,94,7,3,4
11,2,95,8,12,-4
11,2,96,13,28,-15
11,2,97,12,18,-6
11,2,98,24,11,13
11,2,99,12,19,-7
11,2,100,16,14,2
11,2,101,18,18,0
11,2,102,2,2,0
11,2,103,8,12,-4
11,2,104,10,19,-9
11,2,105,9,16,-7
11,2,106,12,20,-8
11,2,107,14,18,-4
11,2,108,8,10,-2
11,2,109,7,13,-6
11,2,110,5,14,-9
11,2,111,10,22,-12
11,2,112,3,9,-6
11,2,113,19,27,-8
11,2,114,7,8,-1
11,2,115,11,18,-7
11,2,116,12,13,-1
11,2,117,16,18,-2
11,2,118,9,12,-3
11,2,119,9,9,0
11,2,120,9,19,-10
11,2,121,25,22,3
11,2,122,11,10,1
11,2,123,16,19,-3
11,2,124,8,12,-4
11,2,125,5,8,-3
11,2,126,17,16,1
11,2,127,8,11,-3
11,2,128,9,30,-21
11,2,129,3,9,-6
11,2,130,17,16,1
11,2,131,14,15,-1
11,2,132,11,15,-4
11,2,133,9,11,-2
11,2,134,9,12,-3
11,2,135,9,11,-2
11,2,136,15,6,9
11,2,137,8,23,-15
11,2,138,7,16,-9
11,2,139,8,15,-7
11,2,140,15,18,-3
11,2,141,16,10,6
11,2,142,5,4,1
11,2,143,14,41,-27
11,2,144,2,6,-4
11,2,145,8,8,0
11,2,146,3,5,-2
11,2,147,8,19,-11
11,2,148,8,21,-13
11,2,149,5,17,-12
11,2,150,6,14,-8
11,2,151,15,21,-6
11,2,152,14,28,-14
11,2,153,15,13,2
11,2,154,15,11,4
11,2,155,19,29,-10
11,2,156,13,15,-2
11,2,157,13,23,-10
11,2,158,18,10,8
11,2,159,7,20,-13
11,2,160,10,7,3
11,2,161,6,18,-12
11,2,162,6,3,3
11,2,163,11,9,2
11,2,164,0,11,-11
11,2,165,13,14,-1
11,2,166,15,6,9
11,2,167,14,14,0
11,2,168,3,11,-8
11,2,169,11,9,2
11,2,170,13,25,-12
11,2,171,5,18,-13
11,2,172,13,8,5
11,2,173,15,21,-6
11,2,174,10,19,-9
11,2,175,4,8,-4
11,2,176,3,16,-13
11,2,177,9,13,-4
11,2,178,12,13,-1
11,2,179,11,10,1
11,2,180,4,11,-7
11,2,181,5,8,-3
11,2,182,13,9,4
11,2,183,6,22,-16
11,2,184,10,16,-6
11,2,185,18,21,-3
11,2,186,11,8,3
11,2,187,15,8,7
11,2,188,5,3,2
11,2,189,6,4,2
11,2,190,19,13,6
11,2,191,10,11,-1
11,2,192,6,13,-7
11,2,193,17,10,7
11,2,194,9,13,-4
11,2,195,12,16,-4
11,2,196,6,12,-6
11,2,197,6,14,-8
11,2,198,8,17,-9
11,2,199,10,10,0
11,2,200,9,10,-1
11,2,201,17,25,-8
11,2,202,16,19,-3
11,2,203,8,19,-11
11,2,204,7,10,-3
11,2,205,11,11,0
11,2,206,7,13,-6
11,2,207,17,21,-4
11,2,208,4,10,-6
11,2,209,4,12,-8
11,2,210,15,24,-9
11,2,211,9,12,-3
11,2,212,7,15,-8
11,2,213,16,15,1
11,2,214,21,23,-2
11,2,215,8,14,-6
11,2,216,15,24,-9
11,2,217,10,13,-3
11,2,218,12,5,7
11,2,219,7,14,-7
11,2,220,7,10,-3
11,2,221,11,11,0
11,2,222,8,18,-10
11,2,223,8,11,-3
11,2,224,6,22,-16
11,2,225,25,28,-3
11,2,226,9,16,-7
11,2,227,7,11,-4
11,2,228,14,35,-21
11,2,229,5,12,-7
11,2,230,12,16,-4
11,2,231,2,8,-6
11,2,232,14,20,-6
11,2,233,2,14,-12
11,2,234,14,17,-3
11,2,235,7,15,-8
11,2,236,7,17,-10
11,2,237,4,20,-16
11,2,238,11,15,-4
11,2,239,3,19,-16
11,2,240,11,10,1
11,2,241,5,14,-9
11,2,242,4,3,1
11,2,243,10,10,0
11,2,244,4,7,-3
11,2,245,7,21,-14
11,2,246,11,8,3
11,2,247,6,12,-6
11,2,248,9,16,-7
11,2,249,14,17,-3
11,2,250,11,13,-2
11,2,251,2,13,-11
11,2,252,9,17,-8
11,2,253,7,15,-8
11,2,254,20,27,-7
11,2,255,12,26,-14
11,2,256,3,11,-8
11,2,257,9,14,-5
11,2,258,26,19,7
11,2,259,14,14,0
11,2,260,15,16,-1
11,2,261,16,24,-8
11,2,262,3,6,-3
11,2,263,9,16,-7
11,2,264,10,11,-1
11,2,265,8,20,-12
11,2,266,8,18,-10
11,2,267,10,18,-8
11,2,268,4,20,-16
11,2,269,5,12,-7
11,2,270,3,6,-3
11,2,271,11,18,-7
11,2,272,5,14,-9
11,2,273,9,16,-7
11,2,274,10,7,3
11,2,275,16,9,7
11,2,276,6,21,-15
11,2,277,7,20,-13
11,2,278,16,36,-20
11,2,279,5,8,-3
11,2,280,12,17,-5
11,2,281,8,4,4
11,2,282,5,11,-6
11,2,283,7,10,-3
11,2,284,11,9,2
11,2,285,9,19,-10
11,2,286,2,6,-4
11,2,287,15,21,-6
11,2,288,10,15,-5
11,2,289,8,10,-2
11,2,290,5,8,-3
11,2,291,14,18,-4
11,2,292,9,7,2
11,2,293,12,5,7
11,2,294,4,13,-9
11,2,295,4,19,-15
11,2,296,10,8,2
11,2,297,9,14,-5
11,2,298,9,8,1
11,2,299,13,28,-15
11,3,0,14,5,9
11,3,1,16,17,-1
11,3,2,10,12,-2
11,3,3,9,15,-6
11,3,4,6,20,-14
11,3,5,16,20,-4
11,3,6,19,10,9
11,3,7,6,18,-12
11,3,8,8,15,-7
11,3,9,6,12,-6
11,3,10,23,15,8
11,3,11,7,16,-9
11,3,12,11,13,-2
11,3,13,7,13,-6
11,3,14,16,9,7
11,3,15,18,18,0
11,3,16,14,13,1
11,3,17,4,20,-16
11,3,18,10,11,-1
11,3,19,16,11,5
11,3,20,11,16,-5
11,3,21,3,14,-11
11,3,22,8,19,-11
11,3,23,5,10,-5
11,3,24,20,15,5
11,3,25,10,11,-1
11,3,26,13,10,3
11,3,27,15,14,1
11,3,28,8,26,-18
11,3,29,14,22,-8
11,3,30,13,18,-5
11,3,31,16,14,2
11,3,32,14,16,-2
11,3,33,6,10,-4
11,3,34,20,14,6
11,3,35,5,7,-2
11,3,36,5,20,-15
11,3,37,19,21,-2
11,3,38,9,16,-7
11,3,39,14,24,-10
11,3,40,4,13,-9
11,3,41,12,27,-15
11,3,42,11,20,-9
11,3,43,10,14,-4
11,3,44,14,6,8
11,3,45,11,11,0
11,3,46,17,11,6
11,3,47,9,10,-1
11,3,48,2,14,-12
11,3,49,15,23,-8
11,3,50,9,21,-12
11,3,51,12,22,-10
11,3,52,12,30,-18
11,3,53,17,15,2
11,3,54,16,13,3
11,3,55,8,8,0
11,3,56,10,9,1
11,3,57,8,8,0
11,3,58,5,10,-5
11,3,59,18,27,-9
11,3,60,12,27,-15
11,3,61,7,17,-10
11,3,62,6,16,-10
11,3,63,15,30,-15
11,3,64,4,16,-12
11,3,65,18,19,-1
11,3,66,13,10,3
11,3,67,8,10,-2
11,3,68,10,26,-16
11,3,69,9,13,-4
11,3,70,7,15,-8
11,3,71,12,23,-11
11,3,72,18,9,9
11,3,73,3,12,-9
11,3,74,16,16,0
11,3,75,15,14,1
11,3,76,0,6,-6
11,3,77,6,18,-12
11,3,78,9,14,-5
11,3,79,15,21,-6
11,3,80,10,10,0
11,3,81,9,16,-7
11,3,82,12,35,-23
11,3,83,12,10,2
11,3,84,6,12,-6
11,3,85,9,17,-8
11,3,86,6,15,-9
11,3,87,8,10,-2
11,3,88,16,25,-9
11,3,89,12,14,-2
11,3,90,3,12,-9
11,3,91,10,18,-8
11,3,92,17,26,-9
11,3,93,0,3,-3
11,3,94,9,7,2
11,3,95,10,25,-15
11,3,96,17,24,-7
11,3,97,8,27,-19
11,3,98,5,10,-5
11,3,99,21,33,-12
11,3,100,6,19,-13
11,3,101,16,23,-7
11,3,102,8,17,-9
11,3,103,13,7,6
11,3,104,23,16,7
11,3,105,17,7,10
11,3,106,9,10,-1
11,3,107,14,25,-11
11,3,108,4,15,-11
11,3,109,8,8,0
11,3,110,10,14,-4
11,3,111,19,13,6
11,3,112,9,12,-3
11,3,113,8,17,-9
11,3,114,9,10,-1
11,3,115,15,11,4
11,3,116,14,33,-19
11,3,117,9,19,-10
11,3,118,7,26,-19
11,3,119,4,34,-30
11,3,120,14,13,1
11,3,121,4,17,-13
11,3,122,9,14,-5
11,3,123,15,9,6
11,3,124,19,12,7
11,3,125,15,21,-6
11,3,126,7,10,-3
11,3,127,18,19,-1
11,3,128,13,19,-6
11,3,129,12,14,-2
11,3,130,17,22,-5
11,3,131,5,7,-2
11,3,132,6,10,-4
11,3,133,5,14,-9
11,3,134,8,13,-5
11,3,135,12,13,-1
11,3,136,12,22,-10
11,3,137,8,17,-9
11,3,138,14,16,-2
11,3,139,5,8,-3
11,3,140,12,18,-6
11,3,141,6,16,-10
11,3,142,9,25,-16
11,3,143,4,4,0
11,3,144,7,18,-11
11,3,145,8,10,-2
11,3,146,10,15,-5
11,3,147,5,18,-13
11,3,148,22,20,2
11,3,149,10,9,1
11,3,150,7,23,-16
11,3,151,11,13,-2
11,3,152,7,12,-5
11,3,153,14,28,-14
11,3,154,8,16,-8
11,3,155,12,13,-1
11,3,156,8,18,-10
11,3,157,18,32,-14
11,3,158,4,15,-11
11,3,159,6,14,-8
11,3,160,18,24,-6
11,3,161,19,12,7
11,3,162,13,13,0
11,3,163,13,11,2
11,3,164,10,14,-4
11,3,165,12,10,2
11,3,166,10,11,-1
11,3,167,4,25,-21
11,3,168,13,27,-14
11,3,169,5,5,0
11,3,170,10,9,1
11,3,171,7,10,-3
11,3,172,8,12,-4
11,3,173,8,16,-8
11,3,174,9,17,-8
11,3,175,9,21,-12
11,3,176,0,9,-9
11,3,177,1,9,-8
11,3,178,4,16,-12
11,3,179,30,26,4
11,3,180,18,16,2
11,3,181,16,24,-8
11,3,182,10,15,-5
11,3,183,14,18,-4
11,3,184,5,6,-1
11,3,185,3,7,-4
11,3,186,6,16,-10
11,3,187,11,16,-5
11,3,188,9,16,-7
11,3,189,8,13,-5
11,3,190,13,16,-3
11,3,191,10,17,-7
11,3,192,11,15,-4
11,3,193,22,18,4
11,3,194,10,17,-7
11,3,195,20,16,4
11,3,196,16,27,-11
11,3,197,14,8,6
11,3,198,5,9,-4
11,3,199,17,16,1
11,3,200,10,10,0
11,3,201,2,11,-9
11,3,202,7,19,-12
11,3,203,8,7,1
11,3,204,7,14,-7
11,3,205,9,8,1
11,3,206,8,8,0
11,3,207,12,11,1
11,3,208,9,10,-1
11,3,209,10,14,-4
11,3,210,2,3,-1
11,3,211,7,7,0
11,3,212,11,20,-9
11,3,213,14,21,-7
11,3,214,12,17,-5
11,3,215,8,18,-10
11,3,216,10,32,-22
11,3,217,5,10,-5
11,3,218,7,14,-7
11,3,219,10,17,-7
11,3,220,11,13,-2
11,3,221,15,11,4
11,3,222,20,32,-12
11,3,223,18,14,4
11,3,224,13,12,1
11,3,225,6,11,-5
11,3,226,16,15,1
11,3,227,3,4,-1
11,3,228,8,12,-4
11,3,229,13,20,-7
11,3,230,8,7,1
11,3,231,11,13,-2
11,3,232,9,10,-1
11,3,233,11,7,4
11,3,234,13,10,3
11,3,235,14,15,-1
11,3,236,10,18,-8
11,3,237,8,22,-14
11,3,238,10,26,-16
11,3,239,6,8,-2
11,3,240,8,13,-5
11,3,241,17,16,1
11,3,242,2,10,-8
11,3,243,12,12,0
11,3,244,18,15,3
11,3,245,9,12,-3
11,3,246,13,26,-13
11,3,247,5,3,2
11,3,248,24,30,-6
11,3,249,5,4,1
11,3,250,6,13,-7
11,3,251,21,20,1
11,3,252,12,17,-5
11,3,253,12,12,0
11,3,254,26,27,-1
11,3,255,3,6,-3
11,3,256,6,11,-5
11,3,257,8,10,-2
11,3,258,27,20,7
11,3,259,3,4,-1
11,3,260,12,8,4
11,3,261,10,8,2
11,3,262,7,16,-9
11,3,263,26,28,-2
11,3,264,11,10,1
11,3,265,15,24,-9
11,3,266,12,17,-5
11,3,267,5,20,-15
11,3,268,4,4,0
11,3,269,10,25,-15
11,3,270,10,12,-2
11,3,271,24,22,2
11,3,272,16,17,-1
11,3,273,13,13,0
11,3,274,14,19,-5
11,3,275,15,19,-4
11,3,276,9,10,-1
11,3,277,12,8,4
11,3,278,1,9,-8
11,3,279,17,20,-3
11,3,280,16,18,-2
11,3,281,9,10,-1
11,3,282,18,19,-1
11,3,283,8,21,-13
11,3,284,11,15,-4
11,3,285,23,10,13
11,3,286,13,29,-16
11,3,287,7,6,1
11,3,288,8,18,-10
11,3,289,13,17,-4
11,3,290,1,9,-8
11,3,291,9,6,3
11,3,292,20,16,4
11,3,293,23,18,5
11,3,294,1,1,0
11,3,295,7,10,-3
11,3,296,3,6,-3
11,3,297,13,10,3
11,3,298,11,17,-6
11,3,299,19,20,-1
11,4,0,8,10,-2
11,4,1,13,20,-7
11,4,2,13,12,1
11,4,3,14,12,2
11,4,4,9,10,-1
11,4,5,1,14,-13
11,4,6,13,25,-12
11,4,7,6,10,-4
11,4,8,8,22,-14
11,4,9,10,13,-3
11,4,10,10,16,-6
11,4,11,9,8,1
11,4,12,7,3,4
11,4,13,21,25,-4
11,4,14,16,18,-2
11,4,15,16,15,1
11,4,16,14,14,0
11,4,17,11,24,-13
11,4,18,25,27,-2
11,4,19,9,13,-4
11,4,20,26,25,1
11,4,21,16,22,-6
11,4,22,11,18,-7
11,4,23,11,28,-17
11,4,24,3,16,-13
11,4,25,9,13,-4
11,4,26,16,12,4
11,4,27,11,11,0
11,4,28,8,23,-15
11,4,29,8,24,-16
11,4,30,10,16,-6
11,4,31,2,6,-4
11,4,32,18,16,2
11,4,33,17,11,6
11,4,34,5,17,-12
11,4,35,11,11,0
11,4,36,6,10,-4
11,4,37,20,15,5
11,4,38,13,11,2
11,4,39,21,16,5
11,4,40,12,16,-4
11,4,41,14,8,6
11,4,42,9,17,-8
11,4,43,11,18,-7
11,4,44,17,10,7
11,4,45,14,17,-3
11,4,46,8,28,-20
11,4,47,5,13,-8
11,4,48,11,11,0
11,4,49,13,12,1
11,4,50,12,14,-2
11,4,51,10,7,3
11,4,52,12,15,-3
11,4,53,15,15,0
11,4,54,13,15,-2
11,4,55,8,8,0
11,4,56,12,16,-4
11,4,57,15,20,-5
11,4,58,12,9,3
11,4,59,2,11,-9
11,4,60,12,22,-10
11,4,61,4,12,-8
11,4,62,11,11,0
11,4,63,11,14,-3
11,4,64,9,18,-9
11,4,65,10,2,8
11,4,66,12,9,3
11,4,67,11,9,2
11,4,68,15,19,-4
11,4,69,5,9,-4
11,4,70,8,14,-6
11,4,71,22,25,-3
11,4,72,18,15,3
11,4,73,6,8,-2
11,4,74,14,18,-4
11,4,75,14,13,1
11,4,76,8,17,-9
11,4,77,9,7,2
11,4,78,23,18,5
11,4,79,6,19,-13
11,4,80,9,13,-4
11,4,81,22,18,4
11,4,82,17,12,5
11,4,83,13,20,-7
11,4,84,9,8,1
11,4,85,16,24,-8
11,4,86,10,17,-7
11,4,87,16,19,-3
11,4,88,11,3,8
11,4,89,14,13,1
11,4,90,10,8,2
11,4,91,10,23,-13
11,4,92,18,8,10
11,4,93,12,9,3
11,4,94,6,15,-9
11,4,95,10,11,-1
11,4,96,7,16,-9
11,4,97,8,15,-7
11,4,98,10,7,3
11,4,99,11,14,-3
11,4,100,11,24,-13
11,4,101,3,11,-8
11,4,102,7,6,1
11,4,103,10,5,5
11,4,104,14,17,-3
11,4,105,12,17,-5
11,4,106,10,7,3
11,4,107,16,19,-3
11,4,108,22,16,6
11,4,109,11,7,4
11,4,110,20,29,-9
11,4,111,8,19,-11
11,4,112,8,10,-2
11,4,113,11,16,-5
11,4,114,17,4,13
11,4,115,3,3,0
11,4,116,15,11,4
11,4,117,23,29,-6
11,4,118,7,7,0
11,4,119,6,15,-9
11,4,120,14,16,-2
11,4,121,19,20,-1
11,4,122,11,12,-1
11,4,123,18,26,-8
11,4,124,7,16,-9
11,4,125,16,18,-2
11,4,126,13,11,2
11,4,127,4,10,-6
11,4,128,14,18,-4
11,4,129,9,8,1
11,4,130,2,11,-9
11,4,131,4,16,-12
11,4,132,10,9,1
11,4,133,8,18,-10
11,4,134,15,11,4
11,4,135,17,14,3
11,4,136,9,10,-1
11,4,137,9,19,-10
11,4,138,11,24,-13
11,4,139,12,40,-28
11,4,140,17,22,-5
11,4,141,7,13,-6
11,4,142,12,27,-15
11,4,143,13,12,1
11,4,144,14,13,1
11,4,145,13,6,7
11,4,146,4,10,-6
11,4,147,6,11,-5
11,4,148,10,11,-1
11,4,149,13,27,-14
11,4,150,5,14,-9
11,4,151,9,17,-8
11,4,152,11,11,0
11,4,153,4,20,-16
11,4,154,7,8,-1
11,4,155,7,12,-5
11,4,156,1,11,-10
11,4,157,7,7,0
11,4,158,14,16,-2
11,4,159,11,20,-9
11,4,160,21,13,8
11,4,161,15,19,-4
11,4,162,13,9,4
11,4,163,9,14,-5
11,4,164,7,16,-9
11,4,165,7,27,-20
11,4,166,6,11,-5
11,4,167,12,12,0
11,4,168,20,28,-8
11,4,169,9,19,-10
11,4,170,9,7,2
11,4,171,10,26,-16
11,4,172,8,26,-18
11,4,173,5,13,-8
11,4,174,10,15,-5
11,4,175,18,14,4
11,4,176,8,13,-5
11,4,177,19,26,-7
11,4,178,15,15,0
11,4,179,11,20,-9
11,4,180,5,10,-5
11,4,181,13,29,-16
11,4,182,13,28,-15
11,4,183,6,14,-8
11,4,184,8,9,-1
11,4,185,9,15,-6
11,4,186,4,10,-6
11,4,187,11,17,-6
11,4,188,9,16,-7
11,4,189,15,23,-8
11,4,190,3,5,-2
11,4,191,17,44,-27
11,4,192,12,24,-12
11,4,193,17,29,-12
11,4,194,6,11,-5
11,4,195,14,15,-1
11,4,196,1,9,-8
11,4,197,10,7,3
11,4,198,3,4,-1
11,4,199,8,7,1
11,4,200,17,20,-3
11,4,201,12,17,-5
11,4,202,18,22,-4
11,4,203,13,18,-5
11,4,204,13,11,2
11,4,205,6,25,-19
11,4,206,9,4,5
11,4,207,10,23,-13
11,4,208,6,12,-6
11,4,209,11,7,4
11,4,210,13,21,-8
11,4,211,16,17,-1
11,4,212,12,23,-11
11,4,213,12,10,2
11,4,214,17,31,-14
11,4,215,17,10,7
11,4,216,7,8,-1
11,4,217,12,14,-2
11,4,218,5,12,-7
11,4,219,7,12,-5
11,4,220,12,8,4
11,4,221,14,14,0
11,4,222,12,20,-8
11,4,223,16,13,3
11,4,224,14,15,-1
11,4,225,15,29,-14
11,4,226,15,20,-5
11,4,227,7,24,-17
11,4,228,15,11,4
11,4,229,17,15,2
11,4,230,17,15,2
11,4,231,3,15,-12
11,4,232,3,9,-6
11,4,233,5,26,-21
11,4,234,14,11,3
11,4,235,6,13,-7
11,4,236,5,7,-2
11,4,237,8,11,-3
11,4,238,13,11,2
11,4,239,12,18,-6
11,4,240,12,22,-10
11,4,241,9,16,-7
11,4,242,6,12,-6
11,4,243,11,27,-16
11,4,244,7,15,-8
11,4,245,10,26,-16
11,4,246,7,15,-8
11,4,247,10,20,-10
11,4,248,6,14,-8
11,4,249,9,20,-11
11,4,250,9,15,-6
11,4,251,8,22,-14
11,4,252,13,19,-6
11,4,253,16,28,-12
11,4,254,14,9,5
11,4,255,7,7,0
11,4,256,8,19,-11
11,4,257,11,15,-4
11,4,258,13,12,1
11,4,259,11,11,0
11,4,260,10,7,3
11,4,261,11,25,-14
11,4,262,13,12,1
11,4,263,9,11,-2
11,4,264,7,5,2
11,4,265,6,15,-9
11,4,266,13,19,-6
11,4,267,15,19,-4
11,4,268,10,20,-10
11,4,269,8,33,-25
11,4,270,17,17,0
11,4,271,10,11,-1
11,4,272,5,9,-4
11,4,273,17,15,2
11,4,274,13,20,-7
11,4,275,16,20,-4
11,4,276,8,21,-13
11,4,277,11,19,-8
11,4,278,9,16,-7
11,4,279,13,15,-2
11,4,280,0,3,-3
11,4,281,14,11,3
11,4,282,11,12,-1
11,4,283,10,17,-7
11,4,284,13,15,-2
11,4,285,7,13,-6
11,4,286,19,13,6
11,4,287,22,21,1
11,4,288,12,18,-6
11,4,289,17,10,7
11,4,290,5,26,-21
11,4,291,23,17,6
11,4,292,11,10,1
11,4,293,19,21,-2
11,4,294,16,17,-1
11,4,295,13,17,-4
11,4,296,6,11,-5
11,4,297,9,10,-1
11,4,298,8,16,-8
11,4,299,11,9,2
11,5,0,10,14,-4
11,5,1,9,12,-3
11,5,2,14,14,0
11,5,3,16,16,0
11,5,4,12,14,-2
11,5,5,6,26,-20
11,5,6,11,21,-10
11,5,7,14,35,-21
11,5,8,17,15,2
11,5,9,2,10,-8
11,5,10,12,11,1
11,5,11,8,14,-6
11,5,12,20,29,-9
11,5,13,11,12,-1
11,5,14,12,11,1
11,5,15,10,8,2
11,5,16,16,17,-1
11,5,17,15,21,-6
11,5,18,18,26,-8
11,5,19,10,27,-17
11,5,20,14,19,-5
11,5,21,19,23,-4
11,5,22,20,19,1
11,5,23,15,7,8
11,5,24,20,15,5
11,5,25,18,22,-4
11,5,26,15,19,-4
11,5,27,11,15,-4
11,5,28,11,20,-9
11,5,29,8,14,-6
11,5,30,19,16,3
11,5,31,11,29,-18
11,5,32,22,9,13
11,5,33,11,9,2
11,5,34,16,17,-1
11,5,35,10,16,-6
11,5,36,4,14,-10
11,5,37,12,18,-6
11,5,38,19,17,2
11,5,39,7,23,-16
11,5,40,11,22,-11
11,5,41,12,14,-2
11,5,42,9,19,-10
11,5,43,2,21,-19
11,5,44,12,18,-6
11,5,45,20,13,7
11,5,46,19,19,0
11,5,47,10,11,-1
11,5,48,6,14,-8
11,5,49,7,22,-15
11,5,50,8,17,-9
11,5,51,13,13,0
11,5,52,12,7,5
11,5,53,10,7,3
11,5,54,19,15,4
11,5,55,13,18,-5
11,5,56,10,6,4
11,5,57,13,10,3
11,5,58,10,24,-14
11,5,59,11,12,-1
11,5,60,17,21,-4
11,5,61,12,13,-1
11,5,62,13,27,-14
11,5,63,8,21,-13
11,5,64,16,22,-6
11,5,65,11,18,-7
11,5,66,11,13,-2
11,5,67,11,10,1
11,5,68,12,18,-6
11,5,69,13,18,-5
11,5,70,4,12,-8
11,5,71,19,25,-6
11,5,72,12,11,1
11,5,73,13,10,3
11,5,74,10,18,-8
11,5,75,12,22,-10
11,5,76,32,18,14
11,5,77,8,15,-7
11,5,78,6,13,-7
11,5,79,11,28,-17
11,5,80,14,20,-6
11,5,81,9,15,-6
11,5,82,2,14,-12
11,5,83,14,19,-5
11,5,84,10,22,-12
11,5,85,10,19,-9
11,5,86,6,13,-7
11,5,87,21,28,-7
11,5,88,17,21,-4
11,5,89,10,16,-6
11,5,90,11,7,4
11,5,91,11,9,2
11,5,92,13,23,-10
11,5,93,10,16,-6
11,5,94,18,14,4
11,5,95,18,15,3
11,5,96,4,18,-14
11,5,97,15,16,-1
11,5,98,13,21,-8
11,5,99,31,19,12
11,5,100,7,27,-20
11,5,101,21,13,8
11,5,102,6,18,-12
11,5,103,10,18,-8
11,5,104,21,14,7
11,5,105,18,15,3
11,5,106,6,18,-12
11,5,107,15,23,-8
11,5,108,6,1,5
11,5,109,22,19,3
11,5,110,17,20,-3
11,5,111,19,14,5
11,5,112,10,8,2
11,5,113,7,20,-13
11,5,114,21,12,9
11,5,115,13,14,-1
11,5,116,10,15,-5
11,5,117,10,18,-8
11,5,118,10,21,-11
11,5,119,10,20,-10
11,5,120,9,15,-6
11,5,121,15,13,2
11,5,122,10,24,-14
11,5,123,7,28,-21
11,5,124,11,18,-7
11,5,125,4,29,-25
11,5,126,15,8,7
11,5,127,21,27,-6
11,5,128,25,27,-2
11,5,129,15,13,2
11,5,130,20,32,-12
11,5,131,5,16,-11
11,5,132,7,11,-4
11,5,133,19,16,3
11,5,134,12,18,-6
11,5,135,19,19,0
11,5,136,10,15,-5
11,5,137,19,18,1
11,5,138,15,15,0
11,5,139,18,21,-3
11,5,140,15,15,0
11,5,141,17,15,2
11,5,142,13,20,-7
11,5,143,15,12,3
11,5,144,9,23,-14
11,5,145,6,8,-2
11,5,146,20,15,5
11,5,147,18,14,4
11,5,148,21,15,6
11,5,149,16,20,-4
11,5,150,4,12,-8
11,5,151,15,19,-4
11,5,152,12,26,-14
11,5,153,15,25,-10
11,5,154,15,18,-3
11,5,155,8,17,-9
11,5,156,18,14,4
11,5,157,17,12,5
11,5,158,17,23,-6
11,5,159,19,23,-4
11,5,160,17,31,-14
11,5,161,16,12,4
11,5,162,8,20,-12
11,5,163,21,14,7
11,5,164,13,17,-4
11,5,165,20,11,9
11,5,166,9,16,-7
11,5,167,7,24,-17
11,5,168,8,16,-8
11,5,169,16,11,5
11,5,170,14,35,-21
11,5,171,9,33,-24
11,5,172,19,20,-1
11,5,173,12,7,5
11,5,174,11,12,-1
11,5,175,15,18,-3
11,5,176,8,15,-7
11,5,177,13,21,-8
11,5,178,14,27,-13
11,5,179,12,16,-4
11,5,180,14,23,-9
11,5,181,19,31,-12
11,5,182,8,18,-10
11,5,183,9,3,6
11,5,184,8,18,-10
11,5,185,11,20,-9
11,5,186,10,9,1
11,5,187,18,25,-7
11,5,188,11,18,-7
11,5,189,7,13,-6
11,5,190,15,12,3
11,5,191,12,11,1
11,5,192,8,22,-14
11,5,193,8,10,-2
11,5,194,7,13,-6
11,5,195,3,20,-17
11,5,196,8,18,-10
11,5,197,14,14,0
11,5,198,17,11,6
11,5,199,9,13,-4
11,5,200,6,32,-26
11,5,201,10,9,1
11,5,202,14,14,0
11,5,203,6,26,-20
11,5,204,6,9,-3
11,5,205,5,26,-21
11,5,206,14,9,5
11,5,207,12,17,-5
11,5,208,23,29,-6
11,5,209,14,12,2
11,5,210,10,25,-15
11,5,211,17,24,-7
11,5,212,24,21,3
11,5,213,10,21,-11
11,5,214,27,16,11
11,5,215,28,17,11
11,5,216,14,20,-6
11,5,217,10,17,-7
11,5,218,11,11,0
11,5,219,18,24,-6
11,5,220,23,17,6
11,5,221,14,15,-1
11,5,222,6,18,-12
11,5,223,4,13,-9
11,5,224,10,15,-5
11,5,225,19,22,-3
11,5,226,10,8,2
11,5,227,9,22,-13
11,5,228,14,18,-4
11,5,229,6,12,-6
11,5,230,19,17,2
11,5,231,11,16,-5
11,5,232,4,8,-4
11,5,233,12,11,1
11,5,234,8,12,-4
11,5,235,11,28,-17
11,5,236,9,10,-1
11,5,237,14,19,-5
11,5,238,8,7,1
11,5,239,8,20,-12
11,5,240,6,8,-2
11,5,241,22,32,-10
11,5,242,16,25,-9
11,5,243,12,18,-6
11,5,244,13,8,5
11,5,245,10,21,-11
11,5,246,21,10,11
11,5,247,12,33,-21
11,5,248,10,12,-2
11,5,249,6,10,-4
11,5,250,12,25,-13
11,5,251,5,17,-12
11,5,252,12,16,-4
11,5,253,17,21,-4
11,5,254,8,17,-9
11,5,255,17,20,-3
11,5,256,8,19,-11
11,5,257,23,14,9
11,5,258,8,25,-17
11,5,259,12,17,-5
11,5,260,20,22,-2
11,5,261,10,14,-4
11,5,262,6,12,-6
11,5,263,13,16,-3
11,5,264,11,21,-10
11,5,265,14,22,-8
11,5,266,16,25,-9
11,5,267,16,13,3
11,5,268,16,17,-1
11,5,269,9,16,-7
11,5,270,15,25,-10
11,5,271,6,19,-13
11,5,272,10,12,-2
11,5,273,19,22,-3
11,5,274,15,10,5
11,5,275,10,14,-4
11,5,276,22,13,9
11,5,277,13,23,-10
11,5,278,14,5,9
11,5,279,9,10,-1
11,5,280,22,20,2
11,5,281,8,10,-2
11,5,282,6,16,-10
11,5,283,14,24,-10
11,5,284,10,12,-2
11,5,285,13,26,-13
11,5,286,12,20,-8
11,5,287,10,10,0
11,5,288,16,15,1
11,5,289,21,17,4
11,5,290,11,14,-3
11,5,291,9,15,-6
11,5,292,15,40,-25
11,5,293,14,19,-5
11,5,294,27,16,11
11,5,295,10,14,-4
11,5,296,20,16,4
11,5,297,20,22,-2
11,5,298,16,14,2
11,5,299,14,13,1
11,6,0,14,15,-1
11,6,1,20,20,0
11,6,2,7,10,-3
11,6,3,17,13,4
11,6,4,17,27,-10
11,6,5,14,10,4
11,6,6,12,17,-5
11,6,7,14,9,5
11,6,8,10,34,-24
11,6,9,14,20,-6
11,6,10,17,15,2
11,6,11,12,14,-2
11,6,12,10,33,-23
11,6,13,22,15,7
11,6,14,6,6,0
11,6,15,16,33,-17
11,6,16,17,32,-15
11,6,17,18,13,5
11,6,18,11,18,-7
11,6,19,12,18,-6
11,6,20,13,11,2
11,6,21,19,18,1
11,6,22,12,22,-10
11,6,23,7,11,-4
11,6,24,23,19,4
11,6,25,15,23,-8
11,6,26,23,19,4
11,6,27,13,23,-10
11,6,28,15,28,-13
11,6,29,8,14,-6
11,6,30,16,15,1
11,6,31,3,16,-13
11,6,32,16,20,-4
11,6,33,15,19,-4
11,6,34,10,7,3
11,6,35,19,17,2
11,6,36,14,15,-1
11,6,37,23,16,7
11,6,38,10,24,-14
11,6,39,18,22,-4
11,6,40,8,6,2
11,6,41,10,17,-7
11,6,42,8,11,-3
11,6,43,5,4,1
11,6,44,10,6,4
11,6,45,7,14,-7
11,6,46,16,23,-7
11,6,47,14,21,-7
11,6,48,3,13,-10
11,6,49,18,23,-5
11,6,50,12,8,4
11,6,51,12,16,-4
11,6,52,15,20,-5
11,6,53,12,11,1
11,6,54,18,16,2
11,6,55,16,10,6
11,6,56,12,9,3
11,6,57,13,15,-2
11,6,58,7,15,-8
11,6,59,19,30,-11
11,6,60,9,15,-6
11,6,61,16,18,-2
11,6,62,16,17,-1
11,6,63,7,10,-3
11,6,64,11,31,-20
11,6,65,11,19,-8
11,6,66,8,7,1
11,6,67,13,7,6
11,6,68,16,23,-7
11,6,69,15,12,3
11,6,70,18,14,4
11,6,71,22,8,14
11,6,72,30,24,6
11,6,73,13,22,-9
11,6,74,5,5,0
11,6,75,4,12,-8
11,6,76,11,17,-6
11,6,77,20,24,-4
11,6,78,15,21,-6
11,6,79,7,26,-19
11,6,80,10,22,-12
11,6,81,11,10,1
11,6,82,8,14,-6
11,6,83,11,14,-3
11,6,84,13,21,-8
11,6,85,18,12,6
11,6,86,13,19,-6
11,6,87,19,17,2
11,6,88,20,27,-7
11,6,89,7,16,-9
11,6,90,9,26,-17
11,6,91,8,14,-6
11,6,92,20,42,-22
11,6,93,8,16,-8
11,6,94,11,19,-8
11,6,95,10,17,-7
11,6,96,17,12,5
11,6,97,20,18,2
11,6,98,15,8,7
11,6,99,8,30,-22
11,6,100,12,13,-1
11,6,101,12,15,-3
11,6,102,5,11,-6
11,6,103,26,25,1
11,6,104,16,15,1
11,6,105,12,12,0
11,6,106,16,23,-7
11,6,107,17,18,-1
11,6,108,10,12,-2
11,6,109,13,10,3
11,6,110,15,28,-13
11,6,111,9,31,-22
11,6,112,10,9,1
11,6,113,6,23,-17
11,6,114,14,14,0
11,6,115,8,15,-7
11,6,116,9,17,-8
11,6,117,17,15,2
11,6,118,4,11,-7
11,6,119,14,11,3
11,6,120,13,16,-3
11,6,121,15,19,-4
11,6,122,7,20,-13
11,6,123,14,16,-2
11,6,124,13,9,4
11,6,125,7,14,-7
11,6,126,13,11,2
11,6,127,12,25,-13
11,6,128,13,21,-8
11,6,129,19,20,-1
11,6,130,11,18,-7
11,6,131,7,7,0
11,6,132,17,26,-9
11,6,133,14,8,6
11,6,134,12,17,-5
11,6,135,16,20,-4
11,6,136,11,18,-7
11,6,137,15,19,-4
11,6,138,14,14,0
11,6,139,6,10,-4
11,6,140,6,14,-8
11,6,141,21,21,0
11,6,142,5,13,-8
11,6,143,13,13,0
11,6,144,20,22,-2
11,6,145,16,26,-10
11,6,146,10,27,-17
11,6,147,5,15,-10
11,6,148,14,24,-10
11,6,149,2,5,-3
11,6,150,13,15,-2
11,6,151,19,22,-3
11,6,152,12,17,-5
11,6,153,12,25,-13
11,6,154,10,18,-8
11,6,155,15,22,-7
11,6,156,5,11,-6
11,6,157,12,23,-11
11,6,158,20,18,2
11,6,159,11,23,-12
11,6,160,22,12,10
11,6,161,14,16,-2
11,6,162,16,14,2
11,6,163,15,16,-1
11,6,164,10,20,-10
11,6,165,8,16,-8
11,6,166,15,19,-4
11,6,167,10,18,-8
11,6,168,13,26,-13
11,6,169,19,14,5
11,6,170,5,6,-1
11,6,171,3,16,-13
11,6,172,8,11,-3
11,6,173,7,21,-14
11,6,174,6,20,-14
11,6,175,12,11,1
11,6,176,6,9,-3
11,6,177,12,17,-5
11,6,178,11,20,-9
11,6,179,5,20,-15
11,6,180,8,17,-9
11,6,181,11,28,-17
11,6,182,13,8,5
11,6,183,17,7,10
11,6,184,15,21,-6
11,6,185,17,12,5
11,6,186,18,18,0
11,6,187,3,11,-8
11,6,188,8,9,-1
11,6,189,15,14,1
11,6,190,22,18,4
11,6,191,12,20,-8
11,6,192,4,12,-8
11,6,193,14,10,4
11,6,194,11,15,-4
11,6,195,16,12,4
11,6,196,5,6,-1
11,6,197,13,17,-4
11,6,198,7,19,-12
11,6,199,6,12,-6
11,6,200,21,18,3
11,6,201,9,15,-6
11,6,202,26,26,0
11,6,203,7,15,-8
11,6,204,22,13,9
11,6,205,11,14,-3
11,6,206,5,18,-13
11,6,207,11,15,-4
11,6,208,16,4,12
11,6,209,19,18,1
11,6,210,12,21,-9
11,6,211,13,26,-13
11,6,212,11,19,-8
11,6,213,17,13,4
11,6,214,10,26,-16
11,6,215,21,31,-10
11,6,216,12,17,-5
11,6,217,15,15,0
11,6,218,8,23,-15
11,6,219,11,20,-9
11,6,220,13,5,8
11,6,221,17,26,-9
11,6,222,1,2,-1
11,6,223,21,14,7
11,6,224,13,15,-2
11,6,225,10,22,-12
11,6,226,14,20,-6
11,6,227,13,17,-4
11,6,228,13,28,-15
11,6,229,19,10,9
11,6,230,13,6,7
11,6,231,6,13,-7
11,6,232,11,7,4
11,6,233,30,25,5
11,6,234,12,9,3
11,6,235,29,21,8
11,6,236,8,20,-12
11,6,237,6,10,-4
11,6,238,4,6,-2
11,6,239,16,32,-16
11,6,240,18,27,-9
11,6,241,6,21,-15
11,6,242,14,17,-3
11,6,243,4,19,-15
11,6,244,17,10,7
11,6,245,9,13,-4
11,6,246,11,11,0
11,6,247,8,23,-15
11,6,248,14,16,-2
11,6,249,18,10,8
11,6,250,21,14,7
11,6,251,4,15,-11
11,6,252,8,22,-14
11,6,253,4,12,-8
11,6,254,9,12,-3
11,6,255,12,18,-6
11,6,256,16,18,-2
11,6,257,11,10,1
11,6,258,11,16,-5
11,6,259,21,17,4
11,6,260,7,11,-4
11,6,261,13,12,1
11,6,262,8,17,-9
11,6,263,19,14,5
11,6,264,9,15,-6
11,6,265,10,24,-14
11,6,266,11,14,-3
11,6,267,15,23,-8
11,6,268,6,17,-11
11,6,269,6,8,-2
11,6,270,14,18,-4
11,6,271,11,6,5
11,6,272,15,10,5
11,6,273,12,28,-16
11,6,274,17,10,7
11,6,275,5,3,2
11,6,276,8,23,-15
11,6,277,6,13,-7
11,6,278,10,6,4
11,6,279,18,15,3
11,6,280,14,10,4
11,6,281,8,15,-7
11,6,282,13,13,0
11,6,283,7,19,-12
11,6,284,18,14,4
11,6,285,7,11,-4
11,6,286,9,7,2
11,6,287,16,11,5
11,6,288,9,6,3
11,6,289,18,19,-1
11,6,290,10,6,4
11,6,291,14,7,7
11,6,292,16,18,-2
11,6,293,14,20,-6
11,6,294,15,15,0
11,6,295,12,11,1
11,6,296,13,14,-1
11,6,297,12,15,-3
11,6,298,20,18,2
11,6,299,15,17,-2
11,7,0,15,20,-5
11,7,1,23,18,5
11,7,2,13,23,-10
11,7,3,11,12,-1
11,7,4,4,16,-12
11,7,5,17,12,5
11,7,6,9,10,-1
11,7,7,6,22,-16
11,7,8,21,18,3
11,7,9,8,9,-1
11,7,10,12,14,-2
11,7,11,26,20,6
11,7,12,11,13,-2
11,7,13,6,9,-3
11,7,14,14,21,-7
11,7,15,7,14,-7
11,7,16,22,27,-5
11,7,17,19,29,-10
11,7,18,19,19,0
11,7,19,9,17,-8
11,7,20,7,12,-5
11,7,21,16,21,-5
11,7,22,15,16,-1
11,7,23,24,12,12
11,7,24,13,23,-10
11,7,25,14,26,-12
11,7,26,10,13,-3
11,7,27,17,23,-6
11,7,28,7,26,-19
11,7,29,21,15,6
11,7,30,7,8,-1
11,7,31,7,6,1
11,7,32,6,16,-10
11,7,33,9,16,-7
11,7,34,12,30,-18
11,7,35,16,11,5
11,7,36,12,12,0
11,7,37,11,12,-1
11,7,38,7,17,-10
11,7,39,28,18,10
11,7,40,9,13,-4
11,7,41,17,21,-4
11,7,42,6,22,-16
11,7,43,11,17,-6
11,7,44,13,20,-7
11,7,45,30,24,6
11,7,46,24,24,0
11,7,47,10,17,-7
11,7,48,10,21,-11
11,7,49,18,10,8
11,7,50,18,14,4
11,7,51,7,17,-10
11,7,52,14,16,-2
11,7,53,14,18,-4
11,7,54,12,28,-16
11,7,55,19,12,7
11,7,56,5,13,-8
11,7,57,29,9,20
11,7,58,16,8,8
11,7,59,17,24,-7
11,7,60,6,11,-5
11,7,61,11,17,-6
11,7,62,16,17,-1
11,7,63,14,29,-15
11,7,64,9,10,-1
11,7,65,11,13,-2
11,7,66,17,22,-5
11,7,67,27,28,-1
11,7,68,6,18,-12
11,7,69,14,15,-1
11,7,70,12,18,-6
11,7,71,9,20,-11
11,7,72,9,10,-1
11,7,73,10,14,-4
11,7,74,12,16,-4
11,7,75,33,20,13
11,7,76,14,22,-8
11,7,77,13,19,-6
11,7,78,10,18,-8
11,7,79,16,6,10
11,7,80,22,23,-1
11,7,81,13,11,2
11,7,82,12,17,-5
11,7,83,4,7,-3
11,7,84,22,13,9
11,7,85,17,21,-4
11,7,86,9,26,-17
11,7,87,8,5,3
11,7,88,8,14,-6
11,7,89,13,25,-12
11,7,90,11,14,-3
11,7,91,5,22,-17
11,7,92,19,23,-4
11,7,93,13,19,-6
11,7,94,7,10,-3
11,7,95,25,16,9
11,7,96,18,21,-3
11,7,97,19,15,4
11,7,98,16,7,9
11,7,99,19,13,6
11,7,100,11,20,-9
11,7,101,13,24,-11
11,7,102,14,17,-3
11,7,103,28,20,8
11,7,104,15,24,-9
11,7,105,19,26,-7
11,7,106,18,15,3
11,7,107,4,11,-7
11,7,108,15,12,3
11,7,109,12,14,-2
11,7,110,13,19,-6
11,7,111,5,9,-4
11,7,112,23,12,11
11,7,113,14,9,5
11,7,114,12,4,8
11,7,115,25,17,8
11,7,116,12,9,3
11,7,117,14,19,-5
11,7,118,15,18,-3
11,7,119,5,11,-6
11,7,120,27,23,4
11,7,121,10,14,-4
11,7,122,14,21,-7
11,7,123,12,20,-8
11,7,124,9,20,-11
11,7,125,10,14,-4
11,7,126,12,22,-10
11,7,127,10,8,2
11,7,128,16,27,-11
11,7,129,18,20,-2
11,7,130,13,12,1
11,7,131,30,28,2
11,7,132,23,7,16
11,7,133,11,14,-3
11,7,134,11,8,3
11,7,135,16,18,-2
11,7,136,5,9,-4
11,7,137,22,15,7
11,7,138,7,15,-8
11,7,139,18,12,6
11,7,140,36,23,13
11,7,141,15,15,0
11,7,142,18,16,2
11,7,143,15,16,-1
11,7,144,14,22,-8
11,7,145,14,28,-14
11,7,146,20,27,-7
11,7,147,11,3,8
11,7,148,12,35,-23
11,7,149,11,39,-28
11,7,150,16,19,-3
11,7,151,2,7,-5
11,7,152,9,25,-16
11,7,153,16,30,-14
11,7,154,10,16,-6
11,7,155,17,20,-3
11,7,156,15,10,5
11,7,157,6,22,-16
11,7,158,7,30,-23
11,7,159,17,15,2
11,7,160,7,12,-5
11,7,161,16,21,-5
11,7,162,9,11,-2
11,7,163,8,10,-2
11,7,164,11,25,-14
11,7,165,13,27,-14
11,7,166,13,18,-5
11,7,167,14,15,-1
11,7,168,8,9,-1
11,7,169,16,14,2
11,7,170,7,19,-12
11,7,171,14,11,3
11,7,172,8,5,3
11,7,173,10,17,-7
11,7,174,10,24,-14
11,7,175,15,17,-2
11,7,176,7,19,-12
11,7,177,11,22,-11
11,7,178,15,19,-4
11,7,179,18,15,3
11,7,180,12,10,2
11,7,181,14,18,-4
11,7,182,19,30,-11
11,7,183,12,12,0
11,7,184,8,15,-7
11,7,185,14,20,-6
11,7,186,14,25,-11
11,7,187,16,24,-8
11,7,188,11,12,-1
11,7,189,17,13,4
11,7,190,13,12,1
11,7,191,14,24,-10
11,7,192,10,21,-11
11,7,193,13,15,-2
11,7,194,17,16,1
11,7,195,22,11,11
11,7,196,16,11,5
11,7,197,15,13,2
11,7,198,27,31,-4
11,7,199,10,22,-12
11,7,200,18,15,3
11,7,201,12,11,1
11,7,202,6,12,-6
11,7,203,5,9,-4
11,7,204,12,6,6
11,7,205,9,17,-8
11,7,206,21,14,7
11,7,207,14,9,5
11,7,208,21,20,1
11,7,209,8,19,-11
11,7,210,16,24,-8
11,7,211,16,15,1
11,7,212,15,10,5
11,7,213,10,14,-4
11,7,214,6,8,-2
11,7,215,8,18,-10
11,7,216,16,14,2
11,7,217,11,31,-20
11,7,218,17,18,-1
11,7,219,18,33,-15
11,7,220,12,21,-9
11,7,221,10,11,-1
11,7,222,11,20,-9
11,7,223,7,17,-10
11,7,224,6,12,-6
11,7,225,18,18,0
11,7,226,9,9,0
11,7,227,8,38,-30
11,7,228,21,27,-6
11,7,229,9,14,-5
11,7,230,24,16,8
11,7,231,22,25,-3
11,7,232,17,27,-10
11,7,233,16,22,-6
11,7,234,19,13,6
11,7,235,14,12,2
11,7,236,13,12,1
11,7,237,10,13,-3
11,7,238,8,11,-3
11,7,239,14,15,-1
11,7,240,13,13,0
11,7,241,12,10,2
11,7,242,10,10,0
11,7,243,14,12,2
11,7,244,10,18,-8
11,7,245,17,5,12
11,7,246,14,12,2
11,7,247,10,14,-4
11,7,248,12,15,-3
11,7,249,19,20,-1
11,7,250,9,12,-3
11,7,251,20,10,10
11,7,252,9,21,-12
11,7,253,11,19,-8
11,7,254,19,23,-4
11,7,255,7,9,-2
11,7,256,7,15,-8
11,7,257,10,12,-2
11,7,258,7,18,-11
11,7,259,27,23,4
11,7,260,10,14,-4
11,7,261,11,15,-4
11,7,262,16,31,-15
11,7,263,8,10,-2
11,7,264,8,18,-10
11,7,265,19,28,-9
11,7,266,16,15,1
11,7,267,21,16,5
11,7,268,12,4,8
11,7,269,16,21,-5
11,7,270,21,24,-3
11,7,271,18,15,3
11,7,272,8,24,-16
11,7,273,7,17,-10
11,7,274,11,15,-4
11,7,275,12,41,-29
11,7,276,12,15,-3
11,7,277,19,6,13
11,7,278,14,7,7
11,7,279,11,18,-7
11,7,280,9,9,0
11,7,281,28,20,8
11,7,282,22,31,-9
11,7,283,12,7,5
11,7,284,10,27,-17
11,7,285,8,9,-1
11,7,286,6,12,-6
11,7,287,14,21,-7
11,7,288,1,24,-23
11,7,289,9,18,-9
11,7,290,22,15,7
11,7,291,16,14,2
11,7,292,17,16,1
11,7,293,21,20,1
11,7,294,18,33,-15
11,7,295,15,20,-5
11,7,296,31,19,12
11,7,297,18,17,1
11,7,298,10,11,-1
11,7,299,5,6,-1
11,8,0,15,16,-1
11,8,1,9,21,-12
11,8,2,8,8,0
11,8,3,13,19,-6
11,8,4,13,20,-7
11,8,5,14,24,-10
11,8,6,15,7,8
11,8,7,14,19,-5
11,8,8,17,17,0
11,8,9,15,6,9
11,8,10,17,18,-1
11,8,11,12,25,-13
11,8,12,13,20,-7
11,8,13,7,8,-1
11,8,14,8,32,-24
11,8,15,11,17,-6
11,8,16,10,18,-8
11,8,17,9,16,-7
11,8,18,8,12,-4
11,8,19,13,15,-2
11,8,20,14,18,-4
11,8,21,19,23,-4
11,8,22,15,16,-1
11,8,23,10,8,2
11,8,24,24,16,8
11,8,25,11,18,-7
11,8,26,11,19,-8
11,8,27,18,18,0
11,8,28,12,18,-6
11,8,29,15,28,-13
11,8,30,16,11,5
11,8,31,15,20,-5
11,8,32,15,23,-8
11,8,33,19,13,6
11,8,34,17,24,-7
11,8,35,17,15,2
11,8,36,14,11,3
11,8,37,11,23,-12
11,8,38,13,15,-2
11,8,39,9,14,-5
11,8,40,4,7,-3
11,8,41,15,17,-2
11,8,42,13,23,-10
11,8,43,10,14,-4
11,8,44,16,20,-4
11,8,45,8,18,-10
11,8,46,15,10,5
11,8,47,15,16,-1
11,8,48,9,4,5
11,8,49,24,15,9
11,8,50,13,24,-11
11,8,51,11,13,-2
11,8,52,12,14,-2
11,8,53,14,12,2
11,8,54,26,15,11
11,8,55,8,11,-3
11,8,56,26,17,9
11,8,57,15,8,7
11,8,58,7,8,-1
11,8,59,9,15,-6
11,8,60,13,24,-11
11,8,61,13,11,2
11,8,62,19,15,4
11,8,63,12,21,-9
11,8,64,14,16,-2
11,8,65,18,11,7
11,8,66,14,17,-3
11,8,67,15,29,-14
11,8,68,10,19,-9
11,8,69,27,25,2
11,8,70,15,22,-7
11,8,71,13,19,-6
11,8,72,8,11,-3
11,8,73,9,6,3
11,8,74,8,17,-9
11,8,75,5,23,-18
11,8,76,13,9,4
11,8,77,12,19,-7
11,8,78,29,16,13
11,8,79,6,8,-2
11,8,80,13,28,-15
11,8,81,6,7,-1
11,8,82,15,17,-2
11,8,83,8,23,-15
11,8,84,28,21,7
11,8,85,17,13,4
11,8,86,14,20,-6
11,8,87,22,22,0
11,8,88,14,25,-11
11,8,89,11,11,0
11,8,90,15,9,6
11,8,91,7,4,3
11,8,92,6,11,-5
11,8,93,17,15,2
11,8,94,9,20,-11
11,8,95,11,17,-6
11,8,96,9,9,0
11,8,97,12,12,0
11,8,98,2,17,-15
11,8,99,29,11,18
11,8,100,1,17,-16
11,8,101,10,19,-9
11,8,102,23,26,-3
11,8,103,17,27,-10
11,8,104,5,16,-11
11,8,105,20,22,-2
11,8,106,8,14,-6
11,8,107,12,15,-3
11,8,108,18,11,7
11,8,109,13,25,-12
11,8,110,16,11,5
11,8,111,11,13,-2
11,8,112,7,13,-6
11,8,113,7,8,-1
11,8,114,7,15,-8
11,8,115,11,21,-10
11,8,116,13,9,4
11,8,117,17,25,-8
11,8,118,5,13,-8
11,8,119,16,25,-9
11,8,120,10,12,-2
11,8,121,11,20,-9
11,8,122,18,24,-6
11,8,123,17,8,9
11,8,124,28,25,3
11,8,125,2,7,-5
11,8,126,13,23,-10
11,8,127,10,15,-5
11,8,128,13,18,-5
11,8,129,16,22,-6
11,8,130,7,6,1
11,8,131,14,12,2
11,8,132,18,21,-3
11,8,133,11,14,-3
11,8,134,19,23,-4
11,8,135,13,13,0
11,8,136,6,7,-1
11,8,137,17,15,2
11,8,138,17,18,-1
11,8,139,6,14,-8
11,8,140,17,14,3
11,8,141,6,10,-4
11,8,142,17,30,-13
11,8,143,13,16,-3
11,8,144,17,24,-7
11,8,145,21,15,6
11,8,146,11,15,-4
11,8,147,5,9,-4
11,8,148,3,13,-10
11,8,149,22,25,-3
11,8,150,15,14,1
11,8,151,18,19,-1
11,8,152,19,20,-1
11,8,153,14,12,2
11,8,154,15,19,-4
11,8,155,12,11,1
11,8,156,6,16,-10
11,8,157,19,19,0
11,8,158,11,10,1
11,8,159,10,8,2
11,8,160,13,28,-15
11,8,161,17,25,-8
11,8,162,11,5,6
11,8,163,17,22,-5
11,8,164,21,20,1
11,8,165,18,22,-4
11,8,166,7,12,-5
11,8,167,8,8,0
11,8,168,10,22,-12
11,8,169,10,18,-8
11,8,170,8,13,-5
11,8,171,20,23,-3
11,8,172,7,15,-8
11,8,173,15,18,-3
11,8,174,14,19,-5
11,8,175,16,13,3
11,8,176,9,17,-8
11,8,177,11,18,-7
11,8,178,13,15,-2
11,8,179,14,19,-5
11,8,180,8,13,-5
11,8,181,16,20,-4
11,8,182,5,3,2
11,8,183,19,22,-3
11,8,184,21,24,-3
11,8,185,28,28,0
11,8,186,17,27,-10
11,8,187,15,10,5
11,8,188,4,6,-2
11,8,189,11,14,-3
11,8,190,15,14,1
11,8,191,13,38,-25
11,8,192,12,25,-13
11,8,193,17,8,9
11,8,194,13,14,-1
11,8,195,18,20,-2
11,8,196,12,14,-2
11,8,197,25,9,16
11,8,198,10,13,-3
11,8,199,13,22,-9
11,8,200,17,16,1
11,8,201,28,20,8
11,8,202,12,15,-3
11,8,203,22,24,-2
11,8,204,14,16,-2
11,8,205,15,24,-9
11,8,206,8,24,-16
11,8,207,11,11,0
11,8,208,14,21,-7
11,8,209,21,13,8
11,8,210,28,30,-2
11,8,211,17,19,-2
11,8,212,11,15,-4
11,8,213,19,21,-2
11,8,214,22,29,-7
11,8,215,15,19,-4
11,8,216,15,6,9
11,8,217,6,16,-10
11,8,218,15,19,-4
11,8,219,14,17,-3
11,8,220,17,18,-1
11,8,221,26,19,7
11,8,222,14,17,-3
11,8,223,11,11,0
11,8,224,11,19,-8
11,8,225,9,19,-10
11,8,226,15,14,1
11,8,227,5,10,-5
11,8,228,12,20,-8
11,8,229,19,13,6
11,8,230,19,7,12
11,8,231,10,14,-4
11,8,232,9,16,-7
11,8,233,12,18,-6
11,8,234,9,8,1
11,8,235,11,13,-2
11,8,236,13,15,-2
11,8,237,17,16,1
11,8,238,14,7,7
11,8,239,16,25,-9
11,8,240,13,13,0
11,8,241,10,12,-2
11,8,242,4,3,1
11,8,243,23,23,0
11,8,244,10,25,-15
11,8,245,7,16,-9
11,8,246,24,44,-20
11,8,247,12,8,4
11,8,248,20,21,-1
11,8,249,16,13,3
11,8,250,8,7,1
11,8,251,6,16,-10
11,8,252,18,20,-2
11,8,253,28,19,9
11,8,254,9,11,-2
11,8,255,27,23,4
11,8,256,11,20,-9
11,8,257,22,8,14
11,8,258,15,13,2
11,8,259,18,20,-2
11,8,260,18,28,-10
11,8,261,8,18,-10
11,8,262,9,16,-7
11,8,263,14,2,12
11,8,264,13,16,-3
11,8,265,14,22,-8
11,8,266,7,15,-8
11,8,267,11,17,-6
11,8,268,5,16,-11
11,8,269,10,29,-19
11,8,270,16,15,1
11,8,271,14,21,-7
11,8,272,14,13,1
11,8,273,19,16,3
11,8,274,5,14,-9
11,8,275,13,26,-13
11,8,276,11,5,6
11,8,277,12,21,-9
11,8,278,10,4,6
11,8,279,20,13,7
11,8,280,13,15,-2
11,8,281,14,22,-8
11,8,282,12,10,2
11,8,283,18,28,-10
11,8,284,15,17,-2
11,8,285,14,15,-1
11,8,286,15,11,4
11,8,287,11,5,6
11,8,288,14,29,-15
11,8,289,10,21,-11
11,8,290,13,23,-10
11,8,291,21,25,-4
11,8,292,14,16,-2
11,8,293,17,16,1
11,8,294,16,17,-1
11,8,295,22,15,7
11,8,296,26,20,6
11,8,297,5,13,-8
11,8,298,12,13,-1
11,8,299,23,15,8
11,9,0,7,10,-3
11,9,1,17,16,1
11,9,2,11,21,-10
11,9,3,8,10,-2
11,9,4,20,13,7
11,9,5,9,13,-4
11,9,6,12,13,-1
11,9,7,8,15,-7
11,9,8,14,20,-6
11,9,9,13,16,-3
11,9,10,13,22,-9
11,9,11,13,7,6
11,9,12,6,13,-7
11,9,13,12,24,-12
11,9,14,14,16,-2
11,9,15,7,9,-2
11,9,16,11,14,-3
11,9,17,20,13,7
11,9,18,17,19,-2
11,9,19,9,19,-10
11,9,20,18,23,-5
11,9,21,7,8,-1
11,9,22,14,14,0
11,9,23,14,26,-12
11,9,24,9,7,2
11,9,25,13,19,-6
11,9,26,19,12,7
11,9,27,11,21,-10
11,9,28,15,14,1
11,9,29,15,20,-5
11,9,30,25,11,14
11,9,31,14,12,2
11,9,32,26,28,-2
11,9,33,15,19,-4
11,9,34,4,15,-11
11,9,35,18,29,-11
11,9,36,19,14,5
11,9,37,27,26,1
11,9,38,18,32,-14
11,9,39,11,22,-11
11,9,40,18,16,2
11,9,41,20,17,3
11,9,42,7,14,-7
11,9,43,12,16,-4
11,9,44,15,10,5
11,9,45,14,21,-7
11,9,46,16,18,-2
11,9,47,10,5,5
11,9,48,8,18,-10
11,9,49,18,15,3
11,9,50,12,7,5
11,9,51,19,17,2
11,9,52,13,11,2
11,9,53,9,11,-2
11,9,54,19,25,-6
11,9,55,11,20,-9
11,9,56,6,12,-6
11,9,57,12,21,-9
11,9,58,14,25,-11
11,9,59,14,19,-5
11,9,60,18,25,-7
11,9,61,8,13,-5
11,9,62,8,9,-1
11,9,63,11,21,-10
11,9,64,27,13,14
11,9,65,14,10,4
11,9,66,18,8,10
11,9,67,16,7,9
11,9,68,9,13,-4
11,9,69,16,33,-17
11,9,70,12,6,6
11,9,71,12,19,-7
11,9,72,11,9,2
11,9,73,9,7,2
11,9,74,12,15,-3
11,9,75,16,15,1
11,9,76,14,18,-4
11,9,77,21,31,-10
11,9,78,5,13,-8
11,9,79,14,11,3
11,9,80,19,25,-6
11,9,81,13,19,-6
11,9,82,18,17,1
11,9,83,12,14,-2
11,9,84,26,30,-4
11,9,85,22,20,2
11,9,86,11,12,-1
11,9,87,12,23,-11
11,9,88,22,26,-4
11,9,89,12,18,-6
11,9,90,26,24,2
11,9,91,24,27,-3
11,9,92,14,9,5
11,9,93,22,10,12
11,9,94,15,21,-6
11,9,95,9,17,-8
11,9,96,30,22,8
11,9,97,12,11,1
11,9,98,8,6,2
11,9,99,18,32,-14
11,9,100,11,16,-5
11,9,101,21,20,1
11,9,102,23,21,2
11,9,103,20,23,-3
11,9,104,20,18,2
11,9,105,26,22,4
11,9,106,21,19,2
11,9,107,16,13,3
11,9,108,12,5,7
11,9,109,18,22,-4
11,9,110,20,22,-2
11,9,111,12,13,-1
11,9,112,11,13,-2
11,9,113,12,27,-15
11,9,114,16,8,8
11,9,115,15,10,5
11,9,116,6,17,-11
11,9,117,13,26,-13
11,9,118,15,9,6
11,9,119,11,18,-7
11,9,120,9,7,2
11,9,121,16,22,-6
11,9,122,14,7,7
11,9,123,11,5,6
11,9,124,19,19,0
11,9,125,21,11,10
11,9,126,13,11,2
11,9,127,16,12,4
11,9,128,11,18,-7
11,9,129,8,11,-3
11,9,130,16,19,-3
11,9,131,18,25,-7
11,9,132,9,6,3
11,9,133,13,21,-8
11,9,134,14,21,-7
11,9,135,9,16,-7
11,9,136,19,10,9
11,9,137,12,25,-13
11,9,138,25,24,1
11,9,139,14,23,-9
11,9,140,14,15,-1
11,9,141,14,16,-2
11,9,142,10,16,-6
11,9,143,15,13,2
11,9,144,19,11,8
11,9,145,14,19,-5
11,9,146,18,18,0
11,9,147,23,17,6
11,9,148,9,11,-2
11,9,149,17,17,0
11,9,150,16,16,0
11,9,151,15,12,3
11,9,152,7,14,-7
11,9,153,13,11,2
11,9,154,8,13,-5
11,9,155,8,22,-14
11,9,156,22,26,-4
11,9,157,13,21,-8
11,9,158,24,13,11
11,9,159,7,9,-2
11,9,160,4,13,-9
11,9,161,13,8,5
11,9,162,21,17,4
11,9,163,7,16,-9
11,9,164,7,14,-7
11,9,165,16,12,4
11,9,166,4,12,-8
11,9,167,4,15,-11
11,9,168,5,33,-28
11,9,169,24,22,2
11,9,170,18,19,-1
11,9,171,7,20,-13
11,9,172,10,10,0
11,9,173,8,13,-5
11,9,174,17,34,-17
11,9,175,7,12,-5
11,9,176,6,22,-16
11,9,177,13,13,0
11,9,178,10,13,-3
11,9,179,6,12,-6
11,9,180,18,14,4
11,9,181,16,29,-13
11,9,182,12,24,-12
11,9,183,4,9,-5
11,9,184,7,14,-7
11,9,185,19,11,8
11,9,186,28,21,7
11,9,187,15,10,5
11,9,188,20,8,12
11,9,189,15,10,5
11,9,190,6,10,-4
11,9,191,9,16,-7
11,9,192,5,15,-10
11,9,193,5,9,-4
11,9,194,12,10,2
11,9,195,6,16,-10
11,9,196,15,11,4
11,9,197,13,26,-13
11,9,198,18,26,-8
11,9,199,17,18,-1
11,9,200,14,14,0
11,9,201,11,10,1
11,9,202,15,33,-18
11,9,203,16,27,-11
11,9,204,10,25,-15
11,9,205,21,14,7
11,9,206,13,5,8
11,9,207,15,11,4
11,9,208,5,9,-4
11,9,209,9,12,-3
11,9,210,8,21,-13
11,9,211,9,13,-4
11,9,212,6,10,-4
11,9,213,18,30,-12
11,9,214,14,16,-2
11,9,215,17,32,-15
11,9,216,27,7,20
11,9,217,21,12,9
11,9,218,21,8,13
11,9,219,14,14,0
11,9,220,5,10,-5
11,9,221,16,18,-2
11,9,222,7,13,-6
11,9,223,17,14,3
11,9,224,16,20,-4
11,9,225,28,42,-14
11,9,226,7,12,-5
11,9,227,29,23,6
11,9,228,21,16,5
11,9,229,14,12,2
11,9,230,13,27,-14
11,9,231,18,18,0
11,9,232,22,24,-2
11,9,233,25,6,19
11,9,234,12,20,-8
11,9,235,28,20,8
11,9,236,14,16,-2
11,9,237,24,16,8
11,9,238,11,16,-5
11,9,239,18,16,2
11,9,240,17,14,3
11,9,241,16,35,-19
11,9,242,24,17,7
11,9,243,19,37,-18
11,9,244,14,25,-11
11,9,245,15,15,0
11,9,246,11,14,-3
11,9,247,8,22,-14
11,9,248,15,13,2
11,9,249,6,8,-2
11,9,250,16,18,-2
11,9,251,15,13,2
11,9,252,13,18,-5
11,9,253,19,18,1
11,9,254,12,21,-9
11,9,255,21,13,8
11,9,256,11,20,-9
11,9,257,8,27,-19
11,9,258,5,1,4
11,9,259,28,18,10
11,9,260,12,16,-4
11,9,261,20,23,-3
11,9,262,12,14,-2
11,9,263,15,17,-2
11,9,264,12,14,-2
11,9,265,5,9,-4
11,9,266,22,4,18
11,9,267,13,11,2
11,9,268,19,28,-9
11,9,269,20,21,-1
11,9,270,20,17,3
11,9,271,13,14,-1
11,9,272,21,15,6
11,9,273,11,16,-5
11,9,274,9,14,-5
11,9,275,9,19,-10
11,9,276,17,14,3
11,9,277,15,10,5
11,9,278,16,17,-1
11,9,279,14,19,-5
11,9,280,22,13,9
11,9,281,19,27,-8
11,9,282,12,24,-12
11,9,283,6,14,-8
11,9,284,8,14,-6
11,9,285,12,17,-5
11,9,286,4,18,-14
11,9,287,15,11,4
11,9,288,15,31,-16
11,9,289,15,24,-9
11,9,290,19,24,-5
11,9,291,13,5,8
11,9,292,9,11,-2
11,9,293,18,27,-9
11,9,294,9,19,-10
11,9,295,15,22,-7
11,9,296,12,15,-3
11,9,297,11,26,-15
11,9,298,22,27,-5
11,9,299,16,23,-7
11,10,0,7,23,-16
11,10,1,16,12,4
11,10,2,8,12,-4
11,10,3,24,13,11
11,10,4,13,22,-9
11,10,5,15,15,0
11,10,6,18,16,2
11,10,7,12,16,-4
11,10,8,16,11,5
11,10,9,19,14,5
11,10,10,5,25,-20
11,10,11,14,15,-1
11,10,12,31,33,-2
11,10,13,7,23,-16
11,10,14,21,16,5
11,10,15,13,23,-10
11,10,16,23,22,1
11,10,17,17,22,-5
11,10,18,18,17,1
11,10,19,11,13,-2
11,10,20,11,15,-4
11,10,21,16,18,-2
11,10,22,15,19,-4
11,10,23,22,12,10
11,10,24,6,17,-11
11,10,25,12,6,6
11,10,26,25,21,4
11,10,27,19,17,2
11,10,28,7,9,-2
11,10,29,9,7,2
11,10,30,18,24,-6
11,10,31,14,13,1
11,10,32,12,12,0
11,10,33,24,17,7
11,10,34,29,15,14
11,10,35,14,10,4
11,10,36,11,26,-15
11,10,37,7,6,1
11,10,38,15,17,-2
11,10,39,15,16,-1
11,10,40,14,16,-2
11,10,41,8,10,-2
11,10,42,8,10,-2
11,10,43,27,19,8
11,10,44,12,6,6
11,10,45,20,35,-15
11,10,46,14,18,-4
11,10,47,16,24,-8
11,10,48,11,30,-19
11,10,49,13,16,-3
11,10,50,18,20,-2
11,10,51,13,22,-9
11,10,52,20,16,4
11,10,53,10,20,-10
11,10,54,12,19,-7
11,10,55,5,6,-1
11,10,56,9,8,1
11,10,57,12,18,-6
11,10,58,11,30,-19
11,10,59,11,21,-10
11,10,60,13,12,1
11,10,61,19,12,7
11,10,62,11,10,1
11,10,63,16,13,3
11,10,64,13,23,-10
11,10,65,10,18,-8
11,10,66,15,24,-9
11,10,67,19,13,6
11,10,68,15,21,-6
11,10,69,20,7,13
11,10,70,5,9,-4
11,10,71,16,6,10
11,10,72,10,31,-21
11,10,73,20,25,-5
11,10,74,8,25,-17
11,10,75,9,13,-4
11,10,76,18,24,-6
11,10,77,14,3,11
11,10,78,18,27,-9
11,10,79,11,30,-19
11,10,80,27,10,17
11,10,81,22,23,-1
11,10,82,21,22,-1
11,10,83,9,11,-2
11,10,84,6,16,-10
11,10,85,13,4,9
11,10,86,11,29,-18
11,10,87,17,11,6
11,10,88,18,17,1
11,10,89,20,13,7
11,10,90,7,13,-6
11,10,91,3,9,-6
11,10,92,26,25,1
11,10,93,9,8,1
11,10,94,18,15,3
11,10,95,4,12,-8
11,10,96,12,19,-7
11,10,97,6,13,-7
11,10,98,13,23,-10
11,10,99,9,24,-15
11,10,100,16,20,-4
11,10,101,18,27,-9
11,10,102,5,17,-12
11,10,103,12,30,-18
11,10,104,13,19,-6
11,10,105,19,17,2
11,10,106,18,23,-5
11,10,107,15,9,6
11,10,108,6,14,-8
11,10,109,20,12,8
11,10,110,17,15,2
11,10,111,12,13,-1
11,10,112,15,10,5
11,10,113,13,23,-10
11,10,114,10,13,-3
11,10,115,5,19,-14
11,10,116,13,22,-9
11,10,117,23,28,-5
11,10,118,23,37,-14
11,10,119,27,24,3
11,10,120,16,18,-2
11,10,121,17,16,1
11,10,122,18,12,6
11,10,123,21,11,10
11,10,124,22,16,6
11,10,125,17,13,4
11,10,126,10,16,-6
11,10,127,16,15,1
11,10,128,8,13,-5
11,10,129,10,18,-8
11,10,130,18,19,-1
11,10,131,10,9,1
11,10,132,19,23,-4
11,10,133,26,23,3
11,10,134,16,16,0
11,10,135,12,21,-9
11,10,136,16,10,6
11,10,137,9,9,0
11,10,138,15,16,-1
11,10,139,16,23,-7
11,10,140,11,19,-8
11,10,141,20,11,9
11,10,142,8,8,0
11,10,143,20,11,9
11,10,144,17,16,1
11,10,145,14,14,0
11,10,146,5,11,-6
11,10,147,15,15,0
11,10,148,10,22,-12
11,10,149,11,9,2
11,10,150,19,12,7
11,10,151,25,30,-5
11,10,152,15,14,1
11,10,153,13,16,-3
11,10,154,20,17,3
11,10,155,18,27,-9
11,10,156,18,29,-11
11,10,157,14,25,-11
11,10,158,25,14,11
11,10,159,10,10,0
11,10,160,25,32,-7
11,10,161,17,19,-2
11,10,162,24,26,-2
11,10,163,11,21,-10
11,10,164,16,14,2
11,10,165,10,27,-17
11,10,166,8,29,-21
11,10,167,22,11,11
11,10,168,18,14,4
11,10,169,13,14,-1
11,10,170,9,16,-7
11,10,171,19,28,-9
11,10,172,9,5,4
11,10,173,9,13,-4
11,10,174,18,20,-2
11,10,175,20,11,9
11,10,176,15,11,4
11,10,177,12,18,-6
11,10,178,15,11,4
11,10,179,19,21,-2
11,10,180,24,25,-1
11,10,181,19,18,1
11,10,182,16,13,3
11,10,183,6,13,-7
11,10,184,17,40,-23
11,10,185,18,10,8
11,10,186,16,17,-1
11,10,187,8,16,-8
11,10,188,17,8,9
11,10,189,10,16,-6
11,10,190,11,13,-2
11,10,191,16,15,1
11,10,192,19,22,-3
11,10,193,10,17,-7
11,10,194,12,12,0
11,10,195,15,24,-9
11,10,196,9,14,-5
11,10,197,18,16,2
11,10,198,20,11,9
11,10,199,15,44,-29
11,10,200,13,16,-3
11,10,201,15,10,5
11,10,202,18,22,-4
11,10,203,20,19,1
11,10,204,13,20,-7
11,10,205,9,12,-3
11,10,206,12,8,4
11,10,207,18,13,5
11,10,208,1,12,-11
11,10,209,18,13,5
11,10,210,26,21,5
11,10,211,10,24,-14
11,10,212,16,20,-4
11,10,213,10,15,-5
11,10,214,11,18,-7
11,10,215,24,37,-13
11,10,216,5,14,-9
11,10,217,3,11,-8
11,10,218,13,24,-11
11,10,219,9,17,-8
11,10,220,19,23,-4
11,10,221,7,13,-6
11,10,222,18,15,3
11,10,223,23,13,10
11,10,224,10,13,-3
11,10,225,7,9,-2
11,10,226,24,8,16
11,10,227,15,20,-5
11,10,228,14,7,7
11,10,229,9,12,-3
11,10,230,12,15,-3
11,10,231,6,6,0
11,10,232,7,12,-5
11,10,233,31,4,27
11,10,234,12,21,-9
11,10,235,25,31,-6
11,10,236,21,24,-3
11,10,237,10,7,3
11,10,238,9,16,-7
11,10,239,13,19,-6
11,10,240,16,16,0
11,10,241,29,19,10
11,10,242,10,11,-1
11,10,243,11,17,-6
11,10,244,8,15,-7
11,10,245,14,27,-13
11,10,246,15,6,9
11,10,247,14,9,5
11,10,248,9,17,-8
11,10,249,4,9,-5
11,10,250,10,16,-6
11,10,251,12,16,-4
11,10,252,18,12,6
11,10,253,11,14,-3
11,10,254,5,28,-23
11,10,255,11,22,-11
11,10,256,5,6,-1
11,10,257,20,23,-3
11,10,258,14,19,-5
11,10,259,12,13,-1
11,10,260,20,9,11
11,10,261,22,24,-2
11,10,262,15,22,-7
11,10,263,23,22,1
11,10,264,12,18,-6
11,10,265,10,24,-14
11,10,266,13,18,-5
11,10,267,19,20,-1
11,10,268,29,25,4
11,10,269,16,14,2
11,10,270,17,19,-2
11,10,271,7,15,-8
11,10,272,4,8,-4
11,10,273,9,4,5
11,10,274,22,14,8
11,10,275,20,16,4
11,10,276,10,22,-12
11,10,277,17,13,4
11,10,278,15,25,-10
11,10,279,14,5,9
11,10,280,25,19,6
11,10,281,20,28,-8
11,10,282,20,20,0
11,10,283,16,17,-1
11,10,284,16,22,-6
11,10,285,15,14,1
11,10,286,6,7,-1
11,10,287,9,15,-6
11,10,288,10,23,-13
11,10,289,15,17,-2
11,10,290,22,10,12
11,10,291,15,13,2
11,10,292,13,10,3
11,10,293,13,17,-4
11,10,294,18,18,0
11,10,295,6,12,-6
11,10,296,13,17,-4
11,10,297,10,7,3
11,10,298,17,26,-9
11,10,299,13,17,-4
11,11,0,13,11,2
11,11,1,19,14,5
11,11,2,15,20,-5
11,11,3,24,24,0
11,11,4,17,27,-10
11,11,5,8,22,-14
11,11,6,7,20,-13
11,11,7,14,19,-5
11,11,8,7,16,-9
11,11,9,6,19,-13
11,11,10,18,30,-12
11,11,11,8,12,-4
11,11,12,8,7,1
11,11,13,26,21,5
11,11,14,11,12,-1
11,11,15,11,7,4
11,11,16,19,21,-2
11,11,17,14,7,7
11,11,18,15,25,-10
11,11,19,9,16,-7
11,11,20,15,16,-1
11,11,21,11,6,5
11,11,22,23,19,4
11,11,23,11,24,-13
11,11,24,8,18,-10
11,11,25,15,17,-2
11,11,26,16,8,8
11,11,27,17,24,-7
11,11,28,11,21,-10
11,11,29,28,25,3
11,11,30,23,15,8
11,11,31,11,18,-7
11,11,32,25,19,6
11,11,33,16,14,2
11,11,34,9,22,-13
11,11,35,18,30,-12
11,11,36,19,14,5
11,11,37,11,19,-8
11,11,38,3,5,-2
11,11,39,8,13,-5
11,11,40,8,8,0
11,11,41,11,14,-3
11,11,42,28,31,-3
11,11,43,14,9,5
11,11,44,21,17,4
11,11,45,20,16,4
11,11,46,10,22,-12
11,11,47,21,21,0
11,11,48,6,18,-12
11,11,49,15,17,-2
11,11,50,13,12,1
11,11,51,9,12,-3
11,11,52,17,31,-14
11,11,53,6,20,-14
11,11,54,14,23,-9
11,11,55,14,10,4
11,11,56,16,9,7
11,11,57,7,15,-8
11,11,58,18,23,-5
11,11,59,22,13,9
11,11,60,15,13,2
11,11,61,22,13,9
11,11,62,24,22,2
11,11,63,6,9,-3
11,11,64,12,10,2
11,11,65,13,20,-7
11,11,66,15,16,-1
11,11,67,22,25,-3
11,11,68,11,18,-7
11,11,69,9,8,1
11,11,70,8,24,-16
11,11,71,12,15,-3
11,11,72,12,13,-1
11,11,73,4,7,-3
11,11,74,21,26,-5
11,11,75,18,12,6
11,11,76,23,24,-1
11,11,77,11,18,-7
11,11,78,5,13,-8
11,11,79,20,17,3
11,11,80,15,5,10
11,11,81,12,15,-3
11,11,82,16,11,5
11,11,83,28,15,13
11,11,84,8,11,-3
11,11,85,18,21,-3
11,11,86,18,12,6
11,11,87,13,5,8
11,11,88,9,11,-2
11,11,89,6,6,0
11,11,90,15,23,-8
11,11,91,9,9,0
11,11,92,19,19,0
11,11,93,18,17,1
11,11,94,14,10,4
11,11,95,30,21,9
11,11,96,19,12,7
11,11,97,5,16,-11
11,11,98,5,7,-2
11,11,99,21,16,5
11,11,100,12,18,-6
11,11,101,9,22,-13
11,11,102,27,16,11
11,11,103,25,10,15
11,11,104,22,21,1
11,11,105,12,11,1
11,11,106,31,20,11
11,11,107,13,17,-4
11,11,108,15,19,-4
11,11,109,10,22,-12
11,11,110,21,17,4
11,11,111,14,28,-14
11,11,112,20,22,-2
11,11,113,19,18,1
11,11,114,10,10,0
11,11,115,23,16,7
11,11,116,11,21,-10
11,11,117,16,14,2
11,11,118,12,6,6
11,11,119,26,28,-2
11,11,120,14,13,1
11,11,121,11,13,-2
11,11,122,13,20,-7
11,11,123,12,18,-6
11,11,124,20,17,3
11,11,125,11,7,4
11,11,126,7,9,-2
11,11,127,23,18,5
11,11,128,21,11,10
11,11,129,24,19,5
11,11,130,7,9,-2
11,11,131,5,5,0
11,11,132,9,6,3
11,11,133,20,16,4
11,11,134,27,18,9
11,11,135,20,11,9
11,11,136,19,17,2
11,11,137,10,24,-14
11,11,138,17,23,-6
11,11,139,22,16,6
11,11,140,15,15,0
11,11,141,17,22,-5
11,11,142,23,20,3
11,11,143,15,18,-3
11,11,144,17,35,-18
11,11,145,10,9,1
11,11,146,12,19,-7
11,11,147,14,13,1
11,11,148,9,6,3
11,11,149,21,21,0
11,11,150,9,34,-25
11,11,151,14,19,-5
11,11,152,13,20,-7
11,11,153,15,7,8
11,11,154,19,33,-14
11,11,155,10,13,-3
11,11,156,13,20,-7
11,11,157,15,31,-16
11,11,158,8,27,-19
11,11,159,5,8,-3
11,11,160,13,14,-1
11,11,161,19,11,8
11,11,162,23,15,8
11,11,163,2,5,-3
11,11,164,15,11,4
11,11,165,16,20,-4
11,11,166,29,22,7
11,11,167,13,12,1
11,11,168,11,12,-1
11,11,169,17,13,4
11,11,170,9,24,-15
11,11,171,6,11,-5
11,11,172,5,16,-11
11,11,173,19,15,4
11,11,174,14,12,2
11,11,175,8,16,-8
11,11,176,13,9,4
11,11,177,21,29,-8
11,11,178,8,12,-4
11,11,179,10,13,-3
11,11,180,8,13,-5
11,11,181,6,17,-11
11,11,182,17,12,5
11,11,183,18,13,5
11,11,184,13,18,-5
11,11,185,13,21,-8
11,11,186,20,28,-8
11,11,187,16,15,1
11,11,188,8,7,1
11,11,189,19,25,-6
11,11,190,10,13,-3
11,11,191,4,25,-21
11,11,192,11,6,5
11,11,193,14,16,-2
11,11,194,12,15,-3
11,11,195,5,5,0
11,11,196,13,17,-4
11,11,197,14,19,-5
11,11,198,8,19,-11
11,11,199,15,22,-7
11,11,200,12,18,-6
11,11,201,13,18,-5
11,11,202,9,28,-19
11,11,203,14,19,-5
11,11,204,27,24,3
11,11,205,7,15,-8
11,11,206,22,15,7
11,11,207,17,11,6
11,11,208,8,3,5
11,11,209,8,8,0
11,11,210,20,9,11
11,11,211,12,17,-5
11,11,212,11,10,1
11,11,213,9,12,-3
11,11,214,13,13,0
11,11,215,7,12,-5
11,11,216,15,26,-11
11,11,217,8,26,-18
11,11,218,16,14,2
11,11,219,16,17,-1
11,11,220,15,13,2
11,11,221,15,13,2
11,11,222,16,17,-1
11,11,223,22,13,9
11,11,224,12,12,0
11,11,225,14,13,1
11,11,226,14,13,1
11,11,227,20,13,7
11,11,228,26,16,10
11,11,229,20,18,2
11,11,230,11,16,-5
11,11,231,14,14,0
11,11,232,5,12,-7
11,11,233,20,16,4
11,11,234,15,16,-1
11,11,235,6,8,-2
11,11,236,12,10,2
11,11,237,13,13,0
11,11,238,24,17,7
11,11,239,6,13,-7
11,11,240,17,27,-10
11,11,241,10,23,-13
11,11,242,16,22,-6
11,11,243,21,29,-8
11,11,244,10,20,-10
11,11,245,17,17,0
11,11,246,19,19,0
11,11,247,11,7,4
11,11,248,10,21,-11
11,11,249,13,21,-8
11,11,250,19,19,0
11,11,251,13,18,-5
11,11,252,15,21,-6
11,11,253,18,10,8
11,11,254,21,15,6
11,11,255,11,31,-20
11,11,256,16,22,-6
11,11,257,16,17,-1
11,11,258,10,8,2
11,11,259,14,16,-2
11,11,260,23,16,7
11,11,261,9,5,4
11,11,262,10,15,-5
11,11,263,6,12,-6
11,11,264,5,20,-15
11,11,265,15,13,2
11,11,266,5,17,-12
11,11,267,19,17,2
11,11,268,21,15,6
11,11,269,6,13,-7
11,11,270,14,14,0
11,11,271,24,18,6
11,11,272,17,17,0
11,11,273,17,26,-9
11,11,274,19,26,-7
11,11,275,10,19,-9
11,11,276,19,15,4
11,11,277,13,13,0
11,11,278,5,9,-4
11,11,279,16,13,3
11,11,280,11,11,0
11,11,281,3,6,-3
11,11,282,24,21,3
11,11,283,22,19,3
11,11,284,21,27,-6
11,11,285,13,25,-12
11,11,286,18,30,-12
11,11,287,10,15,-5
11,11,288,11,26,-15
11,11,289,19,18,1
11,11,290,7,10,-3
11,11,291,21,41,-20
11,11,292,11,35,-24
11,11,293,7,25,-18
11,11,294,13,24,-11
11,11,295,17,11,6
11,11,296,14,12,2
11,11,297,21,16,5
11,11,298,29,25,4
11,11,299,21,16,5
11,12,0,19,23,-4
11,12,1,12,16,-4
11,12,2,13,15,-2
11,12,3,14,16,-2
11,12,4,16,27,-11
11,12,5,16,7,9
11,12,6,14,19,-5
11,12,7,32,14,18
11,12,8,23,16,7
11,12,9,15,6,9
11,12,10,13,4,9
11,12,11,29,9,20
11,12,12,16,10,6
11,12,13,22,17,5
11,12,14,17,19,-2
11,12,15,17,10,7
11,12,16,15,6,9
11,12,17,6,13,-7
11,12,18,19,18,1
11,12,19,23,12,11
11,12,20,16,15,1
11,12,21,9,15,-6
11,12,22,17,25,-8
11,12,23,21,17,4
11,12,24,14,15,-1
11,12,25,11,10,1
11,12,26,19,13,6
11,12,27,18,30,-12
11,12,28,9,11,-2
11,12,29,10,21,-11
11,12,30,10,13,-3
11,12,31,18,5,13
11,12,32,17,11,6
11,12,33,12,30,-18
11,12,34,8,11,-3
11,12,35,11,8,3
11,12,36,16,11,5
11,12,37,17,31,-14
11,12,38,23,6,17
11,12,39,22,15,7
11,12,40,17,23,-6
11,12,41,10,5,5
11,12,42,16,12,4
11,12,43,21,18,3
11,12,44,16,19,-3
11,12,45,12,15,-3
11,12,46,11,8,3
11,12,47,29,31,-2
11,12,48,14,15,-1
11,12,49,17,16,1
11,12,50,6,8,-2
11,12,51,21,20,1
11,12,52,21,9,12
11,12,53,12,21,-9
11,12,54,20,8,12
11,12,55,17,21,-4
11,12,56,10,16,-6
11,12,57,21,26,-5
11,12,58,19,8,11
11,12,59,14,17,-3
11,12,60,21,22,-1
11,12,61,25,22,3
11,12,62,16,19,-3
11,12,63,17,25,-8
11,12,64,22,10,12
11,12,65,10,23,-13
11,12,66,13,5,8
11,12,67,16,14,2
11,12,68,13,15,-2
11,12,69,12,22,-10
11,12,70,10,21,-11
11,12,71,12,15,-3
11,12,72,24,17,7
11,12,73,12,21,-9
11,12,74,17,10,7
11,12,75,25,14,11
11,12,76,10,21,-11
11,12,77,22,19,3
11,12,78,14,21,-7
11,12,79,8,14,-6
11,12,80,11,12,-1
11,12,81,9,7,2
11,12,82,13,19,-6
11,12,83,19,24,-5
11,12,84,17,14,3
11,12,85,29,13,16
11,12,86,21,10,11
11,12,87,18,9,9
11,12,88,10,13,-3
11,12,89,10,12,-2
11,12,90,6,11,-5
11,12,91,18,22,-4
11,12,92,23,20,3
11,12,93,16,8,8
11,12,94,36,25,11
11,12,95,3,6,-3
11,12,96,15,21,-6
11,12,97,22,28,-6
11,12,98,19,14,5
11,12,99,17,4,13
11,12,100,25,12,13
11,12,101,16,7,9
11,12,102,21,25,-4
11,12,103,23,26,-3
11,12,104,33,11,22
11,12,105,17,19,-2
11,12,106,16,23,-7
11,12,107,16,21,-5
11,12,108,13,9,4
11,12,109,18,11,7
11,12,110,12,17,-5
11,12,111,19,25,-6
11,12,112,19,11,8
11,12,113,22,20,2
11,12,114,17,11,6
11,12,115,23,8,15
11,12,116,22,17,5
11,12,117,17,19,-2
11,12,118,23,21,2
11,12,119,18,16,2
11,12,120,12,19,-7
11,12,121,21,26,-5
11,12,122,25,21,4
11,12,123,7,16,-9
11,12,124,23,18,5
11,12,125,12,7,5
11,12,126,22,26,-4
11,12,127,31,29,2
11,12,128,17,16,1
11,12,129,13,7,6
11,12,130,17,13,4
11,12,131,13,9,4
11,12,132,7,23,-16
11,12,133,34,20,14
11,12,134,21,27,-6
11,12,135,14,23,-9
11,12,136,29,24,5
11,12,137,11,17,-6
11,12,138,19,15,4
11,12,139,10,17,-7
11,12,140,12,13,-1
11,12,141,17,10,7
11,12,142,26,15,11
11,12,143,14,15,-1
11,12,144,13,10,3
11,12,145,13,9,4
11,12,146,21,7,14
11,12,147,18,22,-4
11,12,148,15,15,0
11,12,149,20,19,1
11,12,150,12,17,-5
11,12,151,11,15,-4
11,12,152,15,12,3
11,12,153,5,13,-8
11,12,154,23,13,10
11,12,155,19,10,9
11,12,156,15,8,7
11,12,157,10,13,-3
11,12,158,24,7,17
11,12,159,16,9,7
11,12,160,18,11,7
11,12,161,26,13,13
11,12,162,11,3,8
11,12,163,14,11,3
11,12,164,18,12,6
11,12,165,18,16,2
11,12,166,22,14,8
11,12,167,24,18,6
11,12,168,12,16,-4
11,12,169,20,11,9
11,12,170,20,21,-1
11,12,171,18,13,5
11,12,172,16,12,4
11,12,173,6,3,3
11,12,174,12,12,0
11,12,175,12,14,-2
11,12,176,12,13,-1
11,12,177,11,15,-4
11,12,178,21,23,-2
11,12,179,26,24,2
11,12,180,22,36,-14
11,12,181,14,16,-2
11,12,182,17,20,-3
11,12,183,25,19,6
11,12,184,14,17,-3
11,12,185,36,10,26
11,12,186,15,20,-5
11,12,187,10,11,-1
11,12,188,4,4,0
11,12,189,26,17,9
11,12,190,8,14,-6
11,12,191,13,23,-10
11,12,192,6,18,-12
11,12,193,12,18,-6
11,12,194,24,21,3
11,12,195,13,14,-1
11,12,196,11,9,2
11,12,197,9,14,-5
11,12,198,9,11,-2
11,12,199,14,11,3
11,12,200,17,23,-6
11,12,201,9,11,-2
11,12,202,15,17,-2
11,12,203,31,24,7
11,12,204,15,15,0
11,12,205,25,10,15
11,12,206,15,15,0
11,12,207,16,8,8
11,12,208,23,16,7
11,12,209,8,10,-2
11,12,210,26,20,6
11,12,211,11,11,0
11,12,212,10,9,1
11,12,213,18,16,2
11,12,214,8,14,-6
11,12,215,10,14,-4
11,12,216,2,28,-26
11,12,217,10,18,-8
11,12,218,11,16,-5
11,12,219,26,9,17
11,12,220,23,21,2
11,12,221,8,13,-5
11,12,222,26,40,-14
11,12,223,17,24,-7
11,12,224,12,10,2
11,12,225,15,18,-3
11,12,226,7,17,-10
11,12,227,10,8,2
11,12,228,15,9,6
11,12,229,15,16,-1
11,12,230,12,17,-5
11,12,231,9,12,-3
11,12,232,24,17,7
11,12,233,21,21,0
11,12,234,28,22,6
11,12,235,14,16,-2
11,12,236,4,5,-1
11,12,237,21,15,6
11,12,238,22,17,5
11,12,239,13,10,3
11,12,240,24,16,8
11,12,241,26,22,4
11,12,242,23,20,3
11,12,243,12,12,0
11,12,244,17,9,8
11,12,245,17,11,6
11,12,246,20,21,-1
11,12,247,20,15,5
11,12,248,9,11,-2
11,12,249,12,18,-6
11,12,250,3,9,-6
11,12,251,12,22,-10
11,12,252,15,20,-5
11,12,253,15,13,2
11,12,254,18,7,11
11,12,255,8,13,-5
11,12,256,26,15,11
11,12,257,13,23,-10
11,12,258,13,17,-4
11,12,259,24,5,19
11,12,260,20,28,-8
11,12,261,22,13,9
11,12,262,8,28,-20
11,12,263,16,9,7
11,12,264,17,13,4
11,12,265,25,27,-2
11,12,266,5,14,-9
11,12,267,20,24,-4
11,12,268,13,10,3
11,12,269,25,15,10
11,12,270,18,7,11
11,12,271,9,14,-5
11,12,272,14,11,3
11,12,273,17,26,-9
11,12,274,21,18,3
11,12,275,20,20,0
11,12,276,22,16,6
11,12,277,1,13,-12
11,12,278,19,16,3
11,12,279,22,21,1
11,12,280,17,20,-3
11,12,281,17,12,5
11,12,282,10,12,-2
11,12,283,12,17,-5
11,12,284,23,16,7
11,12,285,21,6,15
11,12,286,30,25,5
11,12,287,10,12,-2
11,12,288,10,13,-3
11,12,289,21,26,-5
11,12,290,18,13,5
11,12,291,23,23,0
11,12,292,17,18,-1
11,12,293,21,18,3
11,12,294,18,13,5
11,12,295,21,16,5
11,12,296,16,12,4
11,12,297,14,13,1
11,12,298,7,9,-2
11,12,299,24,18,6
11,13,0,17,29,-12
11,13,1,11,16,-5
11,13,2,26,24,2
11,13,3,10,13,-3
11,13,4,15,14,1
11,13,5,13,32,-19
11,13,6,11,16,-5
11,13,7,13,13,0
11,13,8,14,12,2
11,13,9,14,14,0
11,13,10,19,13,6
11,13,11,22,25,-3
11,13,12,26,20,6
11,13,13,14,12,2
11,13,14,17,18,-1
11,13,15,25,14,11
11,13,16,11,15,-4
11,13,17,23,19,4
11,13,18,25,20,5
11,13,19,13,16,-3
11,13,20,12,12,0
11,13,21,11,25,-14
11,13,22,18,23,-5
11,13,23,23,16,7
11,13,24,16,11,5
11,13,25,15,18,-3
11,13,26,25,18,7
11,13,27,26,25,1
11,13,28,17,28,-11
11,13,29,7,28,-21
11,13,30,11,16,-5
11,13,31,25,19,6
11,13,32,10,13,-3
11,13,33,19,14,5
11,13,34,17,32,-15
11,13,35,18,12,6
11,13,36,27,12,15
11,13,37,9,7,2
11,13,38,22,14,8
11,13,39,24,12,12
11,13,40,11,21,-10
11,13,41,12,12,0
11,13,42,13,17,-4
11,13,43,14,22,-8
11,13,44,33,22,11
11,13,45,8,23,-15
11,13,46,19,22,-3
11,13,47,12,13,-1
11,13,48,18,18,0
11,13,49,7,8,-1
11,13,50,27,21,6
11,13,51,7,6,1
11,13,52,11,16,-5
11,13,53,6,14,-8
11,13,54,18,15,3
11,13,55,17,20,-3
11,13,56,17,17,0
11,13,57,21,26,-5
11,13,58,24,12,12
11,13,59,10,14,-4
11,13,60,19,11,8
11,13,61,26,17,9
11,13,62,29,22,7
11,13,63,20,22,-2
11,13,64,18,27,-9
11,13,65,14,16,-2
11,13,66,21,14,7
11,13,67,10,10,0
11,13,68,18,15,3
11,13,69,28,22,6
11,13,70,8,21,-13
11,13,71,12,11,1
11,13,72,10,13,-3
11,13,73,26,20,6
11,13,74,13,17,-4
11,13,75,11,15,-4
11,13,76,5,13,-8
11,13,77,10,20,-10
11,13,78,8,9,-1
11,13,79,18,18,0
11,13,80,19,19,0
11,13,81,12,14,-2
11,13,82,14,9,5
11,13,83,27,16,11
11,13,84,21,9,12
11,13,85,9,15,-6
11,13,86,8,14,-6
11,13,87,20,16,4
11,13,88,37,24,13
11,13,89,18,21,-3
11,13,90,20,15,5
11,13,91,17,9,8
11,13,92,13,3,10
11,13,93,21,19,2
11,13,94,25,30,-5
11,13,95,8,17,-9
11,13,96,28,19,9
11,13,97,21,17,4
11,13,98,11,13,-2
11,13,99,12,12,0
11,13,100,15,11,4
11,13,101,8,17,-9
11,13,102,12,14,-2
11,13,103,11,22,-11
11,13,104,5,9,-4
11,13,105,29,16,13
11,13,106,12,15,-3
11,13,107,12,16,-4
11,13,108,20,15,5
11,13,109,21,16,5
11,13,110,14,16,-2
11,13,111,13,17,-4
11,13,112,15,17,-2
11,13,113,28,13,15
11,13,114,13,5,8
11,13,115,21,19,2
11,13,116,17,14,3
11,13,117,11,25,-14
11,13,118,16,22,-6
11,13,119,18,14,4
11,13,120,13,24,-11
11,13,121,20,9,11
11,13,122,22,14,8
11,13,123,7,15,-8
11,13,124,13,8,5
11,13,125,16,24,-8
11,13,126,18,11,7
11,13,127,13,21,-8
11,13,128,20,21,-1
11,13,129,13,7,6
11,13,130,25,22,3
11,13,131,15,19,-4
11,13,132,20,19,1
11,13,133,10,13,-3
11,13,134,13,13,0
11,13,135,24,12,12
11,13,136,30,12,18
11,13,137,20,21,-1
11,13,138,11,16,-5
11,13,139,7,19,-12
11,13,140,12,5,7
11,13,141,10,12,-2
11,13,142,17,11,6
11,13,143,13,20,-7
11,13,144,10,14,-4
11,13,145,17,20,-3
11,13,146,17,16,1
11,13,147,8,9,-1
11,13,148,9,15,-6
11,13,149,17,8,9
11,13,150,12,36,-24
11,13,151,18,20,-2
11,13,152,15,21,-6
11,13,153,5,5,0
11,13,154,25,26,-1
11,13,155,16,31,-15
11,13,156,10,18,-8
11,13,157,19,20,-1
11,13,158,17,12,5
11,13,159,11,10,1
11,13,160,15,9,6
11,13,161,15,13,2
11,13,162,16,9,7
11,13,163,11,21,-10
11,13,164,13,21,-8
11,13,165,20,27,-7
11,13,166,17,21,-4
11,13,167,20,22,-2
11,13,168,4,7,-3
11,13,169,20,28,-8
11,13,170,19,11,8
11,13,171,14,13,1
11,13,172,10,12,-2
11,13,173,11,16,-5
11,13,174,5,1,4
11,13,175,12,27,-15
11,13,176,15,25,-10
11,13,177,19,29,-10
11,13,178,14,14,0
11,13,179,12,22,-10
11,13,180,10,11,-1
11,13,181,25,9,16
11,13,182,14,20,-6
11,13,183,18,31,-13
11,13,184,4,8,-4
11,13,185,15,17,-2
11,13,186,16,20,-4
11,13,187,11,14,-3
11,13,188,28,14,14
11,13,189,18,29,-11
11,13,190,15,22,-7
11,13,191,26,16,10
11,13,192,22,15,7
11,13,193,10,5,5
11,13,194,16,19,-3
11,13,195,19,15,4
11,13,196,13,8,5
11,13,197,16,7,9
11,13,198,18,17,1
11,13,199,11,19,-8
11,13,200,38,27,11
11,13,201,18,11,7
11,13,202,7,7,0
11,13,203,17,15,2
11,13,204,17,18,-1
11,13,205,23,13,10
11,13,206,12,23,-11
11,13,207,10,10,0
11,13,208,8,20,-12
11,13,209,24,17,7
11,13,210,26,21,5
11,13,211,14,13,1
11,13,212,20,13,7
11,13,213,15,13,2
11,13,214,9,18,-9
11,13,215,10,10,0
11,13,216,26,16,10
11,13,217,13,11,2
11,13,218,19,18,1
11,13,219,20,24,-4
11,13,220,14,14,0
11,13,221,15,18,-3
11,13,222,15,12,3
11,13,223,5,19,-14
11,13,224,13,18,-5
11,13,225,16,17,-1
11,13,226,8,4,4
11,13,227,18,21,-3
11,13,228,29,16,13
11,13,229,3,5,-2
11,13,230,10,14,-4
11,13,231,21,26,-5
11,13,232,14,10,4
11,13,233,13,10,3
11,13,234,15,12,3
11,13,235,14,14,0
11,13,236,18,18,0
11,13,237,14,26,-12
11,13,238,8,20,-12
11,13,239,18,15,3
11,13,240,12,12,0
11,13,241,20,28,-8
11,13,242,14,7,7
11,13,243,19,8,11
11,13,244,15,16,-1
11,13,245,19,8,11
11,13,246,20,6,14
11,13,247,7,9,-2
11,13,248,11,10,1
11,13,249,32,16,16
11,13,250,26,18,8
11,13,251,12,13,-1
11,13,252,18,20,-2
11,13,253,12,18,-6
11,13,254,8,8,0
11,13,255,18,9,9
11,13,256,6,8,-2
11,13,257,15,6,9
11,13,258,19,16,3
11,13,259,12,14,-2
11,13,260,25,25,0
11,13,261,15,15,0
11,13,262,14,8,6
11,13,263,13,7,6
11,13,264,33,24,9
11,13,265,11,15,-4
11,13,266,19,20,-1
11,13,267,22,18,4
11,13,268,13,9,4
11,13,269,14,21,-7
11,13,270,15,11,4
11,13,271,16,20,-4
11,13,272,23,27,-4
11,13,273,23,15,8
11,13,274,10,19,-9
11,13,275,13,11,2
11,13,276,13,17,-4
11,13,277,10,7,3
11,13,278,8,9,-1
11,13,279,18,10,8
11,13,280,6,11,-5
11,13,281,11,14,-3
11,13,282,23,10,13
11,13,283,14,19,-5
11,13,284,25,12,13
11,13,285,9,24,-15
11,13,286,20,16,4
11,13,287,7,12,-5
11,13,288,9,25,-16
11,13,289,11,12,-1
11,13,290,15,16,-1
11,13,291,8,11,-3
11,13,292,16,18,-2
11,13,293,15,10,5
11,13,294,7,5,2
11,13,295,19,21,-2
11,13,296,17,9,8
11,13,297,13,15,-2
11,13,298,30,26,4
11,13,299,10,15,-5
11,14,0,11,7,4
11,14,1,20,15,5
11,14,2,25,11,14
11,14,3,14,12,2
11,14,4,19,11,8
11,14,5,22,11,11
11,14,6,8,8,0
11,14,7,12,24,-12
11,14,8,10,14,-4
11,14,9,19,10,9
11,14,10,9,15,-6
11,14,11,9,14,-5
11,14,12,14,10,4
11,14,13,5,9,-4
11,14,14,6,9,-3
11,14,15,9,15,-6
11,14,16,22,17,5
11,14,17,16,10,6
11,14,18,19,14,5
11,14,19,17,11,6
11,14,20,8,24,-16
11,14,21,24,8,16
11,14,22,28,22,6
11,14,23,24,22,2
11,14,24,18,24,-6
11,14,25,14,15,-1
11,14,26,16,14,2
11,14,27,26,17,9
11,14,28,14,8,6
11,14,29,23,28,-5
11,14,30,17,13,4
11,14,31,11,10,1
11,14,32,23,28,-5
11,14,33,9,18,-9
11,14,34,35,22,13
11,14,35,20,10,10
11,14,36,10,14,-4
11,14,37,9,8,1
11,14,38,8,12,-4
11,14,39,22,7,15
11,14,40,10,2,8
11,14,41,42,13,29
11,14,42,17,28,-11
11,14,43,25,21,4
11,14,44,9,18,-9
11,14,45,5,11,-6
11,14,46,7,5,2
11,14,47,22,5,17
11,14,48,28,26,2
11,14,49,20,19,1
11,14,50,16,14,2
11,14,51,14,6,8
11,14,52,27,12,15
11,14,53,12,19,-7
11,14,54,16,8,8
11,14,55,18,18,0
11,14,56,11,10,1
11,14,57,10,14,-4
11,14,58,14,20,-6
11,14,59,9,10,-1
11,14,60,21,12,9
11,14,61,28,13,15
11,14,62,21,13,8
11,14,63,17,11,6
11,14,64,17,13,4
11,14,65,14,10,4
11,14,66,24,29,-5
11,14,67,24,16,8
11,14,68,10,10,0
11,14,69,13,10,3
11,14,70,18,12,6
11,14,71,14,15,-1
11,14,72,16,10,6
11,14,73,7,46,-39
11,14,74,15,18,-3
11,14,75,22,16,6
11,14,76,13,15,-2
11,14,77,8,6,2
11,14,78,25,14,11
11,14,79,10,12,-2
11,14,80,9,8,1
11,14,81,21,15,6
11,14,82,12,13,-1
11,14,83,25,12,13
11,14,84,22,16,6
11,14,85,10,30,-20
11,14,86,31,33,-2
11,14,87,29,11,18
11,14,88,7,2,5
11,14,89,9,9,0
11,14,90,13,11,2
11,14,91,15,9,6
11,14,92,20,31,-11
11,14,93,9,17,-8
11,14,94,19,24,-5
11,14,95,14,6,8
11,14,96,28,24,4
11,14,97,10,6,4
11,14,98,15,17,-2
11,14,99,14,10,4
11,14,100,9,13,-4
11,14,101,15,20,-5
11,14,102,34,22,12
11,14,103,13,12,1
11,14,104,18,16,2
11,14,105,7,14,-7
11,14,106,10,11,-1
11,14,107,12,7,5
11,14,108,19,16,3
11,14,109,24,29,-5
11,14,110,19,23,-4
11,14,111,17,17,0
11,14,112,8,12,-4
11,14,113,17,16,1
11,14,114,11,26,-15
11,14,115,10,19,-9
11,14,116,27,35,-8
11,14,117,11,17,-6
11,14,118,16,16,0
11,14,119,15,14,1
11,14,120,24,7,17
11,14,121,8,17,-9
11,14,122,12,9,3
11,14,123,20,16,4
11,14,124,21,32,-11
11,14,125,13,17,-4
11,14,126,30,29,1
11,14,127,6,11,-5
11,14,128,13,17,-4
11,14,129,14,12,2
11,14,130,11,21,-10
11,14,131,22,13,9
11,14,132,14,17,-3
11,14,133,18,24,-6
11,14,134,8,12,-4
11,14,135,17,15,2
11,14,136,22,20,2
11,14,137,12,12,0
11,14,138,21,13,8
11,14,139,16,17,-1
11,14,140,25,37,-12
11,14,141,12,17,-5
11,14,142,21,3,18
11,14,143,24,12,12
11,14,144,14,22,-8
11,14,145,10,22,-12
11,14,146,19,19,0
11,14,147,9,13,-4
11,14,148,17,25,-8
11,14,149,8,8,0
11,14,150,25,21,4
11,14,151,14,13,1
11,14,152,16,15,1
11,14,153,22,12,10
11,14,154,11,12,-1
11,14,155,24,31,-7
11,14,156,15,20,-5
11,14,157,27,18,9
11,14,158,16,18,-2
11,14,159,10,12,-2
11,14,160,7,12,-5
11,14,161,13,10,3
11,14,162,27,22,5
11,14,163,14,17,-3
11,14,164,6,6,0
11,14,165,26,32,-6
11,14,166,14,15,-1
11,14,167,10,13,-3
11,14,168,24,18,6
11,14,169,12,21,-9
11,14,170,21,12,9
11,14,171,15,10,5
11,14,172,20,16,4
11,14,173,10,21,-11
11,14,174,10,10,0
11,14,175,18,20,-2
11,14,176,19,5,14
11,14,177,9,15,-6
11,14,178,9,10,-1
11,14,179,19,23,-4
11,14,180,14,21,-7
11,14,181,9,10,-1
11,14,182,16,12,4
11,14,183,25,10,15
11,14,184,16,13,3
11,14,185,40,17,23
11,14,186,13,16,-3
11,14,187,6,7,-1
11,14,188,23,8,15
11,14,189,9,13,-4
11,14,190,21,26,-5
11,14,191,22,18,4
11,14,192,17,19,-2
11,14,193,14,17,-3
11,14,194,26,14,12
11,14,195,15,14,1
11,14,196,24,19,5
11,14,197,14,16,-2
11,14,198,9,13,-4
11,14,199,12,9,3
11,14,200,16,15,1
11,14,201,21,17,4
11,14,202,16,12,4
11,14,203,28,19,9
11,14,204,8,24,-16
11,14,205,27,8,19
11,14,206,17,19,-2
11,14,207,13,12,1
11,14,208,15,36,-21
11,14,209,15,14,1
11,14,210,15,12,3
11,14,211,22,28,-6
11,14,212,13,26,-13
11,14,213,5,15,-10
11,14,214,16,11,5
11,14,215,8,14,-6
11,14,216,9,15,-6
11,14,217,14,11,3
11,14,218,16,17,-1
11,14,219,11,14,-3
11,14,220,7,9,-2
11,14,221,20,15,5
11,14,222,7,16,-9
11,14,223,17,15,2
11,14,224,13,9,4
11,14,225,18,25,-7
11,14,226,21,19,2
11,14,227,19,8,11
11,14,228,16,9,7
11,14,229,8,22,-14
11,14,230,22,14,8
11,14,231,19,27,-8
11,14,232,15,13,2
11,14,233,10,12,-2
11,14,234,23,15,8
11,14,235,11,21,-10
11,14,236,17,10,7
11,14,237,13,15,-2
11,14,238,17,20,-3
11,14,239,8,17,-9
11,14,240,20,30,-10
11,14,241,11,4,7
11,14,242,9,13,-4
11,14,243,28,27,1
11,14,244,27,29,-2
11,14,245,19,11,8
11,14,246,16,16,0
11,14,247,10,13,-3
11,14,248,10,9,1
11,14,249,18,12,6
11,14,250,31,17,14
11,14,251,19,15,4
11,14,252,21,19,2
11,14,253,12,15,-3
11,14,254,10,2,8
11,14,255,17,14,3
11,14,256,10,12,-2
11,14,257,27,14,13
11,14,258,12,9,3
11,14,259,15,13,2
11,14,260,15,11,4
11,14,261,20,15,5
11,14,262,10,9,1
11,14,263,10,11,-1
11,14,264,14,16,-2
11,14,265,16,17,-1
11,14,266,17,15,2
11,14,267,11,5,6
11,14,268,10,12,-2
11,14,269,21,10,11
11,14,270,22,14,8
11,14,271,29,24,5
11,14,272,17,21,-4
11,14,273,23,15,8
11,14,274,10,15,-5
11,14,275,24,14,10
11,14,276,22,18,4
11,14,277,17,21,-4
11,14,278,16,15,1
11,14,279,23,18,5
11,14,280,13,9,4
11,14,281,5,12,-7
11,14,282,20,24,-4
11,14,283,18,18,0
11,14,284,27,25,2
11,14,285,13,17,-4
11,14,286,33,10,23
11,14,287,20,19,1
11,14,288,15,12,3
11,14,289,12,7,5
11,14,290,25,25,0
11,14,291,10,14,-4
11,14,292,14,15,-1
11,14,293,15,20,-5
11,14,294,18,19,-1
11,14,295,13,22,-9
11,14,296,9,9,0
11,14,297,9,16,-7
11,14,298,11,12,-1
11,14,299,18,18,0
11,15,0,14,10,4
11,15,1,13,19,-6
11,15,2,27,18,9
11,15,3,7,8,-1
11,15,4,28,17,11
11,15,5,18,13,5
11,15,6,13,11,2
11,15,7,12,9,3
11,15,8,14,15,-1
11,15,9,15,23,-8
11,15,10,5,13,-8
11,15,11,21,12,9
11,15,12,26,28,-2
11,15,13,17,8,9
11,15,14,16,6,10
11,15,15,26,13,13
11,15,16,20,14,6
11,15,17,11,6,5
11,15,18,11,16,-5
11,15,19,15,12,3
11,15,20,19,10,9
11,15,21,13,19,-6
11,15,22,20,12,8
11,15,23,17,6,11
11,15,24,31,25,6
11,15,25,10,16,-6
11,15,26,20,19,1
11,15,27,5,6,-1
11,15,28,23,15,8
11,15,29,10,18,-8
11,15,30,13,12,1
11,15,31,16,12,4
11,15,32,17,22,-5
11,15,33,32,26,6
11,15,34,24,24,0
11,15,35,12,15,-3
11,15,36,18,24,-6
11,15,37,18,18,0
11,15,38,7,9,-2
11,15,39,16,25,-9
11,15,40,7,12,-5
11,15,41,17,18,-1
11,15,42,13,17,-4
11,15,43,18,21,-3
11,15,44,11,13,-2
11,15,45,21,15,6
11,15,46,13,10,3
11,15,47,26,10,16
11,15,48,10,10,0
11,15,49,28,20,8
11,15,50,22,26,-4
11,15,51,7,16,-9
11,15,52,29,23,6
11,15,53,16,16,0
11,15,54,18,10,8
11,15,55,8,19,-11
11,15,56,12,20,-8
11,15,57,11,17,-6
11,15,58,18,8,10
11,15,59,15,16,-1
11,15,60,24,17,7
11,15,61,8,15,-7
11,15,62,25,18,7
11,15,63,18,6,12
11,15,64,9,12,-3
11,15,65,21,12,9
11,15,66,23,19,4
11,15,67,14,16,-2
11,15,68,27,13,14
11,15,69,9,13,-4
11,15,70,6,15,-9
11,15,71,14,20,-6
11,15,72,22,17,5
11,15,73,13,14,-1
11,15,74,10,7,3
11,15,75,10,9,1
11,15,76,17,9,8
11,15,77,13,24,-11
11,15,78,19,25,-6
11,15,79,18,24,-6
11,15,80,18,21,-3
11,15,81,15,14,1
11,15,82,20,14,6
11,15,83,16,19,-3
11,15,84,6,21,-15
11,15,85,6,11,-5
11,15,86,9,17,-8
11,15,87,34,16,18
11,15,88,25,19,6
11,15,89,12,16,-4
11,15,90,10,18,-8
11,15,91,12,21,-9
11,15,92,18,14,4
11,15,93,10,14,-4
11,15,94,28,12,16
11,15,95,19,13,6
11,15,96,12,14,-2
11,15,97,20,19,1
11,15,98,12,19,-7
11,15,99,18,11,7
11,15,100,13,11,2
11,15,101,21,19,2
11,15,102,10,10,0
11,15,103,15,10,5
11,15,104,9,7,2
11,15,105,20,21,-1
11,15,106,23,9,14
11,15,107,16,12,4
11,15,108,11,17,-6
11,15,109,14,20,-6
11,15,110,11,12,-1
11,15,111,12,5,7
11,15,112,25,16,9
11,15,113,13,15,-2
11,15,114,8,5,3
11,15,115,23,19,4
11,15,116,19,21,-2
11,15,117,11,28,-17
11,15,118,17,17,0
11,15,119,15,14,1
11,15,120,18,20,-2
11,15,121,18,10,8
11,15,122,6,11,-5
11,15,123,18,16,2
11,15,124,16,10,6
11,15,125,20,15,5
11,15,126,6,11,-5
11,15,127,20,24,-4
11,15,128,9,7,2
11,15,129,7,15,-8
11,15,130,20,19,1
11,15,131,24,23,1
11,15,132,16,13,3
11,15,133,25,8,17
11,15,134,31,17,14
11,15,135,13,17,-4
11,15,136,18,12,6
11,15,137,14,15,-1
11,15,138,23,35,-12
11,15,139,13,8,5
11,15,140,22,18,4
11,15,141,4,6,-2
11,15,142,14,14,0
11,15,143,10,14,-4
11,15,144,18,19,-1
11,15,145,31,14,17
11,15,146,8,14,-6
11,15,147,29,26,3
11,15,148,8,8,0
11,15,149,16,3,13
11,15,150,17,18,-1
11,15,151,13,11,2
11,15,152,14,9,5
11,15,153,20,20,0
11,15,154,16,17,-1
11,15,155,14,10,4
11,15,156,11,18,-7
11,15,157,13,15,-2
11,15,158,10,2,8
11,15,159,14,18,-4
11,15,160,24,15,9
11,15,161,13,13,0
11,15,162,19,16,3
11,15,163,23,14,9
11,15,164,18,8,10
11,15,165,19,20,-1
11,15,166,21,2,19
11,15,167,9,19,-10
11,15,168,6,17,-11
11,15,169,21,17,4
11,15,170,17,14,3
11,15,171,25,13,12
11,15,172,18,14,4
11,15,173,7,18,-11
11,15,174,20,10,10
11,15,175,9,12,-3
11,15,176,21,21,0
11,15,177,16,12,4
11,15,178,13,21,-8
11,15,179,19,20,-1
11,15,180,24,13,11
11,15,181,23,14,9
11,15,182,23,18,5
11,15,183,22,29,-7
11,15,184,6,18,-12
11,15,185,10,15,-5
11,15,186,10,12,-2
11,15,187,22,22,0
11,15,188,20,13,7
11,15,189,15,29,-14
11,15,190,14,9,5
11,15,191,10,15,-5
11,15,192,11,12,-1
11,15,193,19,20,-1
11,15,194,11,13,-2
11,15,195,6,9,-3
11,15,196,18,18,0
11,15,197,17,19,-2
11,15,198,12,9,3
11,15,199,8,8,0
11,15,200,18,24,-6
11,15,201,3,5,-2
11,15,202,14,8,6
11,15,203,11,19,-8
11,15,204,7,10,-3
11,15,205,16,7,9
11,15,206,30,18,12
11,15,207,14,14,0
11,15,208,13,11,2
11,15,209,14,17,-3
11,15,210,8,11,-3
11,15,211,21,9,12
11,15,212,16,12,4
11,15,213,35,26,9
11,15,214,23,20,3
11,15,215,25,24,1
11,15,216,18,10,8
11,15,217,22,13,9
11,15,218,20,13,7
11,15,219,14,8,6
11,15,220,27,27,0
11,15,221,8,15,-7
11,15,222,11,15,-4
11,15,223,15,22,-7
11,15,224,17,22,-5
11,15,225,13,8,5
11,15,226,10,15,-5
11,15,227,21,13,8
11,15,228,14,24,-10
11,15,229,23,7,16
11,15,230,16,16,0
11,15,231,15,18,-3
11,15,232,6,14,-8
11,15,233,32,13,19
11,15,234,11,12,-1
11,15,235,9,16,-7
11,15,236,9,9,0
11,15,237,20,16,4
11,15,238,15,10,5
11,15,239,14,18,-4
11,15,240,12,23,-11
11,15,241,23,25,-2
11,15,242,22,16,6
11,15,243,18,11,7
11,15,244,23,22,1
11,15,245,14,11,3
11,15,246,22,18,4
11,15,247,24,11,13
11,15,248,18,20,-2
11,15,249,20,15,5
11,15,250,22,11,11
11,15,251,25,11,14
11,15,252,19,15,4
11,15,253,10,6,4
11,15,254,6,17,-11
11,15,255,27,24,3
11,15,256,18,6,12
11,15,257,16,15,1
11,15,258,15,16,-1
11,15,259,13,12,1
11,15,260,18,20,-2
11,15,261,10,16,-6
11,15,262,22,16,6
11,15,263,12,9,3
11,15,264,24,7,17
11,15,265,15,14,1
11,15,266,22,20,2
11,15,267,1,11,-10
11,15,268,15,15,0
11,15,269,19,13,6
11,15,270,32,16,16
11,15,271,13,25,-12
11,15,272,19,19,0
11,15,273,28,10,18
11,15,274,9,15,-6
11,15,275,16,8,8
11,15,276,11,12,-1
11,15,277,23,18,5
11,15,278,22,13,9
11,15,279,11,12,-1
11,15,280,16,19,-3
11,15,281,8,18,-10
11,15,282,12,20,-8
11,15,283,21,16,5
11,15,284,14,13,1
11,15,285,13,14,-1
11,15,286,20,29,-9
11,15,287,7,5,2
11,15,288,17,18,-1
11,15,289,16,11,5
11,15,290,23,20,3
11,15,291,13,12,1
11,15,292,8,14,-6
11,15,293,6,10,-4
11,15,294,10,20,-10
11,15,295,23,15,8
11,15,296,13,18,-5
11,15,297,15,17,-2
11,15,298,22,22,0
11,15,299,15,7,8
11,16,0,23,11,12
11,16,1,32,20,12
11,16,2,13,12,1
11,16,3,16,15,1
11,16,4,17,22,-5
11,16,5,11,9,2
11,16,6,18,13,5
11,16,7,18,22,-4
11,16,8,19,20,-1
11,16,9,11,7,4
11,16,10,9,18,-9
11,16,11,19,15,4
11,16,12,9,19,-10
11,16,13,34,22,12
11,16,14,16,8,8
11,16,15,22,19,3
11,16,16,19,15,4
11,16,17,18,18,0
11,16,18,8,8,0
11,16,19,7,9,-2
11,16,20,5,17,-12
11,16,21,23,16,7
11,16,22,9,13,-4
11,16,23,12,11,1
11,16,24,18,24,-6
11,16,25,12,20,-8
11,16,26,6,8,-2
11,16,27,17,15,2
11,16,28,17,11,6
11,16,29,24,12,12
11,16,30,19,20,-1
11,16,31,6,10,-4
11,16,32,17,13,4
11,16,33,12,14,-2
11,16,34,18,22,-4
11,16,35,8,12,-4
11,16,36,15,6,9
11,16,37,7,8,-1
11,16,38,22,29,-7
11,16,39,33,10,23
11,16,40,18,21,-3
11,16,41,15,9,6
11,16,42,18,16,2
11,16,43,9,15,-6
11,16,44,15,20,-5
11,16,45,10,6,4
11,16,46,8,9,-1
11,16,47,6,5,1
11,16,48,13,22,-9
11,16,49,22,25,-3
11,16,50,14,5,9
11,16,51,16,16,0
11,16,52,21,22,-1
11,16,53,23,9,14
11,16,54,16,21,-5
11,16,55,16,14,2
11,16,56,24,12,12
11,16,57,15,9,6
11,16,58,14,12,2
11,16,59,15,6,9
11,16,60,12,9,3
11,16,61,20,21,-1
11,16,62,16,17,-1
11,16,63,20,11,9
11,16,64,18,9,9
11,16,65,15,9,6
11,16,66,21,5,16
11,16,67,12,12,0
11,16,68,15,10,5
11,16,69,21,14,7
11,16,70,16,13,3
11,16,71,15,13,2
11,16,72,17,1,16
11,16,73,21,12,9
11,16,74,11,16,-5
11,16,75,15,14,1
11,16,76,12,14,-2
11,16,77,7,18,-11
11,16,78,22,12,10
11,16,79,17,15,2
11,16,80,25,17,8
11,16,81,27,13,14
11,16,82,18,20,-2
11,16,83,18,20,-2
11,16,84,34,15,19
11,16,85,13,22,-9
11,16,86,17,15,2
11,16,87,15,15,0
11,16,88,17,18,-1
11,16,89,20,20,0
11,16,90,8,13,-5
11,16,91,34,14,20
11,16,92,21,27,-6
11,16,93,14,10,4
11,16,94,16,15,1
11,16,95,17,19,-2
11,16,96,11,10,1
11,16,97,14,26,-12
11,16,98,4,6,-2
11,16,99,13,11,2
11,16,100,12,17,-5
11,16,101,14,9,5
11,16,102,20,17,3
11,16,103,20,14,6
11,16,104,13,13,0
11,16,105,19,16,3
11,16,106,15,13,2
11,16,107,19,17,2
11,16,108,15,18,-3
11,16,109,22,17,5
11,16,110,14,24,-10
11,16,111,23,25,-2
11,16,112,4,9,-5
11,16,113,16,17,-1
11,16,114,21,15,6
11,16,115,18,12,6
11,16,116,12,21,-9
11,16,117,4,14,-10
11,16,118,26,17,9
11,16,119,6,14,-8
11,16,120,18,15,3
11,16,121,20,16,4
11,16,122,16,15,1
11,16,123,21,17,4
11,16,124,19,12,7
11,16,125,9,17,-8
11,16,126,9,11,-2
11,16,127,15,15,0
11,16,128,16,12,4
11,16,129,7,12,-5
11,16,130,19,18,1
11,16,131,12,11,1
11,16,132,11,10,1
11,16,133,30,14,16
11,16,134,11,16,-5
11,16,135,13,12,1
11,16,136,13,3,10
11,16,137,20,17,3
11,16,138,18,13,5
11,16,139,19,15,4
11,16,140,29,24,5
11,16,141,10,11,-1
11,16,142,8,19,-11
11,16,143,27,15,12
11,16,144,18,18,0
11,16,145,18,16,2
11,16,146,18,12,6
11,16,147,9,24,-15
11,16,148,2,2,0
11,16,149,17,10,7
11,16,150,16,12,4
11,16,151,13,14,-1
11,16,152,3,11,-8
11,16,153,15,13,2
11,16,154,16,15,1
11,16,155,20,28,-8
11,16,156,25,16,9
11,16,157,16,17,-1
11,16,158,12,26,-14
11,16,159,15,9,6
11,16,160,21,13,8
11,16,161,23,28,-5
11,16,162,20,12,8
11,16,163,16,4,12
11,16,164,12,3,9
11,16,165,17,7,10
11,16,166,8,15,-7
11,16,167,23,15,8
11,16,168,15,13,2
11,16,169,15,7,8
11,16,170,17,9,8
11,16,171,19,10,9
11,16,172,11,17,-6
11,16,173,13,8,5
11,16,174,17,11,6
11,16,175,8,19,-11
11,16,176,16,16,0
11,16,177,15,10,5
11,16,178,19,25,-6
11,16,179,16,12,4
11,16,180,11,19,-8
11,16,181,8,2,6
11,16,182,24,16,8
11,16,183,18,10,8
11,16,184,11,12,-1
11,16,185,15,26,-11
11,16,186,16,15,1
11,16,187,16,18,-2
11,16,188,38,23,15
11,16,189,8,7,1
11,16,190,27,15,12
11,16,191,20,20,0
11,16,192,10,14,-4
11,16,193,14,9,5
11,16,194,19,14,5
11,16,195,19,13,6
11,16,196,18,17,1
11,16,197,29,29,0
11,16,198,14,19,-5
11,16,199,17,19,-2
11,16,200,12,20,-8
11,16,201,12,12,0
11,16,202,11,12,-1
11,16,203,18,12,6
11,16,204,13,13,0
11,16,205,27,12,15
11,16,206,14,9,5
11,16,207,23,31,-8
11,16,208,26,26,0
11,16,209,11,11,0
11,16,210,10,20,-10
11,16,211,20,26,-6
11,16,212,19,9,10
11,16,213,17,8,9
11,16,214,14,8,6
11,16,215,10,10,0
11,16,216,8,6,2
11,16,217,13,11,2
11,16,218,17,17,0
11,16,219,16,10,6
11,16,220,14,4,10
11,16,221,13,13,0
11,16,222,17,10,7
11,16,223,20,28,-8
11,16,224,18,19,-1
11,16,225,21,5,16
11,16,226,27,15,12
11,16,227,8,10,-2
11,16,228,16,12,4
11,16,229,8,3,5
11,16,230,17,17,0
11,16,231,15,6,9
11,16,232,3,10,-7
11,16,233,15,12,3
11,16,234,37,19,18
11,16,235,9,15,-6
11,16,236,12,23,-11
11,16,237,12,9,3
11,16,238,5,13,-8
11,16,239,13,16,-3
11,16,240,22,7,15
11,16,241,10,4,6
11,16,242,19,17,2
11,16,243,9,10,-1
11,16,244,19,20,-1
11,16,245,19,11,8
11,16,246,19,18,1
11,16,247,9,7,2
11,16,248,23,10,13
11,16,249,10,17,-7
11,16,250,14,6,8
11,16,251,21,16,5
11,16,252,9,15,-6
11,16,253,19,9,10
11,16,254,5,11,-6
11,16,255,12,16,-4
11,16,256,7,11,-4
11,16,257,23,13,10
11,16,258,16,20,-4
11,16,259,24,13,11
11,16,260,24,28,-4
11,16,261,26,17,9
11,16,262,7,4,3
11,16,263,24,25,-1
11,16,264,3,13,-10
11,16,265,23,11,12
11,16,266,16,15,1
11,16,267,14,3,11
11,16,268,10,24,-14
11,16,269,2,2,0
11,16,270,17,18,-1
11,16,271,12,16,-4
11,16,272,16,10,6
11,16,273,11,12,-1
11,16,274,12,9,3
11,16,275,18,16,2
11,16,276,9,17,-8
11,16,277,14,12,2
11,16,278,30,13,17
11,16,279,24,24,0
11,16,280,18,18,0
11,16,281,20,18,2
11,16,282,25,19,6
11,16,283,7,17,-10
11,16,284,25,31,-6
11,16,285,16,18,-2
11,16,286,20,15,5
11,16,287,19,23,-4
11,16,288,25,18,7
11,16,289,18,30,-12
11,16,290,18,21,-3
11,16,291,13,11,2
11,16,292,15,25,-10
11,16,293,16,10,6
11,16,294,27,17,10
11,16,295,7,17,-10
11,16,296,19,19,0
11,16,297,4,16,-12
11,16,298,18,13,5
11,16,299,12,15,-3
11,17,0,9,7,2
11,17,1,18,16,2
11,17,2,20,16,4
11,17,3,10,13,-3
11,17,4,21,22,-1
11,17,5,16,22,-6
11,17,6,14,6,8
11,17,7,24,19,5
11,17,8,16,21,-5
11,17,9,17,29,-12
11,17,10,25,7,18
11,17,11,22,23,-1
11,17,12,18,13,5
11,17,13,12,14,-2
11,17,14,12,12,0
11,17,15,13,12,1
11,17,16,26,15,11
11,17,17,17,11,6
11,17,18,20,23,-3
11,17,19,26,36,-10
11,17,20,29,20,9
11,17,21,17,16,1
11,17,22,11,13,-2
11,17,23,13,18,-5
11,17,24,20,14,6
11,17,25,24,22,2
11,17,26,15,21,-6
11,17,27,11,5,6
11,17,28,6,10,-4
11,17,29,29,8,21
11,17,30,17,22,-5
11,17,31,3,16,-13
11,17,32,12,20,-8
11,17,33,26,14,12
11,17,34,17,17,0
11,17,35,13,4,9
11,17,36,16,19,-3
11,17,37,15,12,3
11,17,38,21,12,9
11,17,39,11,17,-6
11,17,40,17,14,3
11,17,41,21,18,3
11,17,42,14,10,4
11,17,43,20,23,-3
11,17,44,9,15,-6
11,17,45,19,12,7
11,17,46,10,7,3
11,17,47,26,13,13
11,17,48,22,9,13
11,17,49,16,17,-1
11,17,50,10,10,0
11,17,51,19,21,-2
11,17,52,12,6,6
11,17,53,18,13,5
11,17,54,19,19,0
11,17,55,23,18,5
11,17,56,23,13,10
11,17,57,10,17,-7
11,17,58,21,5,16
11,17,59,15,2,13
11,17,60,24,15,9
11,17,61,8,13,-5
11,17,62,22,15,7
11,17,63,32,4,28
11,17,64,7,19,-12
11,17,65,15,6,9
11,17,66,14,9,5
11,17,67,4,10,-6
11,17,68,15,13,2
11,17,69,8,14,-6
11,17,70,20,12,8
11,17,71,18,9,9
11,17,72,22,13,9
11,17,73,14,10,4
11,17,74,19,13,6
11,17,75,15,4,11
11,17,76,20,22,-2
11,17,77,19,17,2
11,17,78,22,13,9
11,17,79,14,14,0
11,17,80,19,26,-7
11,17,81,16,17,-1
11,17,82,23,4,19
11,17,83,11,11,0
11,17,84,25,15,10
11,17,85,22,27,-5
11,17,86,12,20,-8
11,17,87,24,23,1
11,17,88,11,6,5
11,17,89,17,25,-8
11,17,90,19,17,2
11,17,91,23,13,10
11,17,92,23,8,15
11,17,93,16,16,0
11,17,94,17,11,6
11,17,95,17,13,4
11,17,96,11,11,0
11,17,97,13,10,3
11,17,98,22,17,5
11,17,99,23,16,7
11,17,100,22,15,7
11,17,101,17,10,7
11,17,102,10,17,-7
11,17,103,23,11,12
11,17,104,22,8,14
11,17,105,7,18,-11
11,17,106,15,14,1
11,17,107,22,16,6
11,17,108,27,18,9
11,17,109,14,10,4
11,17,110,8,5,3
11,17,111,21,11,10
11,17,112,21,21,0
11,17,113,27,29,-2
11,17,114,11,6,5
11,17,115,17,10,7
11,17,116,9,18,-9
11,17,117,18,13,5
11,17,118,14,12,2
11,17,119,9,9,0
11,17,120,23,14,9
11,17,121,22,19,3
11,17,122,9,9,0
11,17,123,18,11,7
11,17,124,15,27,-12
11,17,125,26,30,-4
11,17,126,34,22,12
11,17,127,8,7,1
11,17,128,5,18,-13
11,17,129,10,19,-9
11,17,130,12,14,-2
11,17,131,15,13,2
11,17,132,12,7,5
11,17,133,21,11,10
11,17,134,16,29,-13
11,17,135,16,9,7
11,17,136,20,11,9
11,17,137,24,7,17
11,17,138,25,19,6
11,17,139,21,17,4
11,17,140,8,26,-18
11,17,141,11,12,-1
11,17,142,28,17,11
11,17,143,9,11,-2
11,17,144,6,15,-9
11,17,145,14,9,5
11,17,146,14,13,1
11,17,147,23,10,13
11,17,148,16,16,0
11,17,149,12,20,-8
11,17,150,8,3,5
11,17,151,16,10,6
11,17,152,3,10,-7
11,17,153,14,17,-3
11,17,154,33,18,15
11,17,155,11,10,1
11,17,156,19,10,9
11,17,157,24,30,-6
11,17,158,6,12,-6
11,17,159,16,21,-5
11,17,160,10,11,-1
11,17,161,31,9,22
11,17,162,31,11,20
11,17,163,24,18,6
11,17,164,11,22,-11
11,17,165,4,9,-5
11,17,166,18,13,5
11,17,167,8,19,-11
11,17,168,8,7,1
11,17,169,28,20,8
11,17,170,22,20,2
11,17,171,15,17,-2
11,17,172,23,12,11
11,17,173,21,11,10
11,17,174,16,12,4
11,17,175,10,18,-8
11,17,176,21,22,-1
11,17,177,22,13,9
11,17,178,24,20,4
11,17,179,18,12,6
11,17,180,8,10,-2
11,17,181,13,15,-2
11,17,182,31,16,15
11,17,183,20,19,1
11,17,184,31,15,16
11,17,185,17,8,9
11,17,186,30,19,11
11,17,187,9,12,-3
11,17,188,8,16,-8
11,17,189,15,21,-6
11,17,190,18,12,6
11,17,191,15,9,6
11,17,192,24,17,7
11,17,193,16,12,4
11,17,194,18,19,-1
11,17,195,4,3,1
11,17,196,21,12,9
11,17,197,22,13,9
11,17,198,12,15,-3
11,17,199,15,10,5
11,17,200,9,9,0
11,17,201,21,17,4
11,17,202,10,9,1
11,17,203,16,7,9
11,17,204,15,34,-19
11,17,205,2,13,-11
11,17,206,25,16,9
11,17,207,9,11,-2
11,17,208,19,10,9
11,17,209,11,13,-2
11,17,210,5,6,-1
11,17,211,17,7,10
11,17,212,23,18,5
11,17,213,21,6,15
11,17,214,10,10,0
11,17,215,17,19,-2
11,17,216,20,24,-4
11,17,217,16,9,7
11,17,218,8,9,-1
11,17,219,22,18,4
11,17,220,8,8,0
11,17,221,22,10,12
11,17,222,20,17,3
11,17,223,8,14,-6
11,17,224,15,22,-7
11,17,225,15,19,-4
11,17,226,29,11,18
11,17,227,16,18,-2
11,17,228,14,7,7
11,17,229,13,22,-9
11,17,230,10,12,-2
11,17,231,14,14,0
11,17,232,8,6,2
11,17,233,11,9,2
11,17,234,13,18,-5
11,17,235,17,17,0
11,17,236,37,12,25
11,17,237,23,5,18
11,17,238,17,3,14
11,17,239,17,9,8
11,17,240,11,10,1
11,17,241,8,11,-3
11,17,242,10,8,2
11,17,243,17,25,-8
11,17,244,10,7,3
11,17,245,15,16,-1
11,17,246,22,21,1
11,17,247,7,20,-13
11,17,248,11,20,-9
11,17,249,17,23,-6
11,17,250,13,21,-8
11,17,251,22,16,6
11,17,252,29,12,17
11,17,253,22,16,6
11,17,254,21,13,8
11,17,255,21,21,0
11,17,256,15,11,4
11,17,257,14,21,-7
11,17,258,19,11,8
11,17,259,12,11,1
11,17,260,25,13,12
11,17,261,18,11,7
11,17,262,14,10,4
11,17,263,16,17,-1
11,17,264,22,15,7
11,17,265,21,15,6
11,17,266,16,12,4
11,17,267,26,28,-2
11,17,268,11,4,7
11,17,269,17,15,2
11,17,270,8,23,-15
11,17,271,18,24,-6
11,17,272,12,8,4
11,17,273,15,22,-7
11,17,274,10,19,-9
11,17,275,19,10,9
11,17,276,12,13,-1
11,17,277,13,16,-3
11,17,278,21,15,6
11,17,279,10,10,0
11,17,280,48,17,31
11,17,281,20,25,-5
11,17,282,8,17,-9
11,17,283,16,16,0
11,17,284,12,22,-10
11,17,285,20,3,17
11,17,286,13,18,-5
11,17,287,28,24,4
11,17,288,8,6,2
11,17,289,10,10,0
11,17,290,19,11,8
11,17,291,23,13,10
11,17,292,11,17,-6
11,17,293,25,22,3
11,17,294,17,21,-4
11,17,295,11,13,-2
11,17,296,13,4,9
11,17,297,15,32,-17
11,17,298,10,17,-7
11,17,299,21,16,5
11,18,0,19,9,10
11,18,1,19,8,11
11,18,2,19,15,4
11,18,3,18,14,4
11,18,4,14,8,6
11,18,5,9,11,-2
11,18,6,33,12,21
11,18,7,18,10,8
11,18,8,22,10,12
11,18,9,36,25,11
11,18,10,10,12,-2
11,18,11,24,18,6
11,18,12,18,18,0
11,18,13,9,21,-12
11,18,14,10,11,-1
11,18,15,26,17,9
11,18,16,11,12,-1
11,18,17,22,9,13
11,18,18,18,9,9
11,18,19,25,15,10
11,18,20,12,11,1
11,18,21,20,22,-2
11,18,22,16,12,4
11,18,23,17,8,9
11,18,24,19,15,4
11,18,25,11,10,1
11,18,26,16,25,-9
11,18,27,22,5,17
11,18,28,23,9,14
11,18,29,19,15,4
11,18,30,3,10,-7
11,18,31,13,9,4
11,18,32,16,20,-4
11,18,33,11,13,-2
11,18,34,15,11,4
11,18,35,23,8,15
11,18,36,11,18,-7
11,18,37,11,5,6
11,18,38,11,5,6
11,18,39,32,20,12
11,18,40,16,13,3
11,18,41,15,23,-8
11,18,42,17,16,1
11,18,43,24,10,14
11,18,44,2,6,-4
11,18,45,22,24,-2
11,18,46,13,9,4
11,18,47,24,20,4
11,18,48,11,17,-6
11,18,49,20,20,0
11,18,50,13,16,-3
11,18,51,13,29,-16
11,18,52,19,11,8
11,18,53,18,17,1
11,18,54,23,27,-4
11,18,55,22,16,6
11,18,56,18,13,5
11,18,57,29,14,15
11,18,58,6,8,-2
11,18,59,16,25,-9
11,18,60,7,24,-17
11,18,61,8,17,-9
11,18,62,13,17,-4
11,18,63,13,12,1
11,18,64,14,18,-4
11,18,65,33,14,19
11,18,66,2,5,-3
11,18,67,10,13,-3
11,18,68,17,17,0
11,18,69,13,10,3
11,18,70,11,25,-14
11,18,71,19,12,7
11,18,72,13,9,4
11,18,73,17,8,9
11,18,74,16,11,5
11,18,75,18,25,-7
11,18,76,10,9,1
11,18,77,20,12,8
11,18,78,17,11,6
11,18,79,15,8,7
11,18,80,17,12,5
11,18,81,20,13,7
11,18,82,16,9,7
11,18,83,11,15,-4
11,18,84,14,12,2
11,18,85,16,9,7
11,18,86,20,23,-3
11,18,87,9,12,-3
11,18,88,12,13,-1
11,18,89,20,12,8
11,18,90,11,15,-4
11,18,91,6,11,-5
11,18,92,11,11,0
11,18,93,23,5,18
11,18,94,28,21,7
11,18,95,17,14,3
11,18,96,23,22,1
11,18,97,17,9,8
11,18,98,10,14,-4
11,18,99,26,11,15
11,18,100,22,6,16
11,18,101,15,18,-3
11,18,102,20,23,-3
11,18,103,17,18,-1
11,18,104,18,10,8
11,18,105,9,6,3
11,18,106,26,14,12
11,18,107,10,9,1
11,18,108,22,27,-5
11,18,109,21,16,5
11,18,110,26,22,4
11,18,111,15,7,8
11,18,112,15,13,2
11,18,113,15,10,5
11,18,114,13,13,0
11,18,115,27,17,10
11,18,116,14,13,1
11,18,117,24,15,9
11,18,118,13,16,-3
11,18,119,26,19,7
11,18,120,31,14,17
11,18,121,21,3,18
11,18,122,10,27,-17
11,18,123,13,11,2
11,18,124,13,12,1
11,18,125,13,15,-2
11,18,126,11,14,-3
11,18,127,14,21,-7
11,18,128,23,19,4
11,18,129,16,21,-5
11,18,130,16,13,3
11,18,131,18,16,2
11,18,132,29,13,16
11,18,133,19,22,-3
11,18,134,37,19,18
11,18,135,29,14,15
11,18,136,18,10,8
11,18,137,15,15,0
11,18,138,22,15,7
11,18,139,19,6,13
11,18,140,11,12,-1
11,18,141,7,7,0
11,18,142,26,27,-1
11,18,143,18,22,-4
11,18,144,11,14,-3
11,18,145,22,13,9
11,18,146,12,12,0
11,18,147,13,6,7
11,18,148,21,16,5
11,18,149,21,6,15
11,18,150,19,18,1
11,18,151,15,11,4
11,18,152,26,27,-1
11,18,153,5,13,-8
11,18,154,8,7,1
11,18,155,11,5,6
11,18,156,13,13,0
11,18,157,12,8,4
11,18,158,18,16,2
11,18,159,14,14,0
11,18,160,8,20,-12
11,18,161,10,13,-3
11,18,162,19,9,10
11,18,163,16,6,10
11,18,164,8,9,-1
11,18,165,11,10,1
11,18,166,17,20,-3
11,18,167,9,7,2
11,18,168,17,11,6
11,18,169,22,34,-12
11,18,170,8,0,8
11,18,171,32,18,14
11,18,172,6,11,-5
11,18,173,22,9,13
11,18,174,19,17,2
11,18,175,20,16,4
11,18,176,36,21,15
11,18,177,12,6,6
11,18,178,4,11,-7
11,18,179,11,14,-3
11,18,180,15,12,3
11,18,181,23,20,3
11,18,182,29,9,20
11,18,183,16,14,2
11,18,184,13,12,1
11,18,185,19,13,6
11,18,186,6,6,0
11,18,187,21,24,-3
11,18,188,24,19,5
11,18,189,29,20,9
11,18,190,27,21,6
11,18,191,11,13,-2
11,18,192,27,13,14
11,18,193,8,19,-11
11,18,194,14,13,1
11,18,195,20,13,7
11,18,196,16,4,12
11,18,197,20,10,10
11,18,198,8,12,-4
11,18,199,14,5,9
11,18,200,17,13,4
11,18,201,16,28,-12
11,18,202,12,15,-3
11,18,203,15,20,-5
11,18,204,27,12,15
11,18,205,8,4,4
11,18,206,18,13,5
11,18,207,17,12,5
11,18,208,17,10,7
11,18,209,18,12,6
11,18,210,25,14,11
11,18,211,19,33,-14
11,18,212,16,13,3
11,18,213,28,19,9
11,18,214,13,9,4
11,18,215,7,7,0
11,18,216,7,9,-2
11,18,217,14,11,3
11,18,218,20,11,9
11,18,219,32,23,9
11,18,220,18,16,2
11,18,221,16,18,-2
11,18,222,13,8,5
11,18,223,12,20,-8
11,18,224,9,8,1
11,18,225,11,24,-13
11,18,226,13,7,6
11,18,227,16,15,1
11,18,228,12,5,7
11,18,229,8,9,-1
11,18,230,26,20,6
11,18,231,30,20,10
11,18,232,7,6,1
11,18,233,9,21,-12
11,18,234,28,11,17
11,18,235,21,16,5
11,18,236,9,1,8
11,18,237,15,15,0
11,18,238,19,15,4
11,18,239,15,23,-8
11,18,240,16,7,9
11,18,241,21,6,15
11,18,242,13,23,-10
11,18,243,12,17,-5
11,18,244,14,18,-4
11,18,245,25,8,17
11,18,246,25,19,6
11,18,247,11,11,0
11,18,248,19,8,11
11,18,249,20,8,12
11,18,250,14,17,-3
11,18,251,18,18,0
11,18,252,12,18,-6
11,18,253,21,23,-2
11,18,254,15,12,3
11,18,255,17,9,8
11,18,256,27,20,7
11,18,257,13,9,4
11,18,258,21,23,-2
11,18,259,27,22,5
11,18,260,12,8,4
11,18,261,15,18,-3
11,18,262,12,9,3
11,18,263,20,11,9
11,18,264,22,15,7
11,18,265,27,3,24
11,18,266,21,23,-2
11,18,267,7,24,-17
11,18,268,8,8,0
11,18,269,12,12,0
11,18,270,11,25,-14
11,18,271,16,13,3
11,18,272,16,16,0
11,18,273,22,16,6
11,18,274,20,13,7
11,18,275,5,9,-4
11,18,276,19,16,3
11,18,277,31,19,12
11,18,278,15,14,1
11,18,279,7,7,0
11,18,280,18,12,6
11,18,281,8,24,-16
11,18,282,19,14,5
11,18,283,20,16,4
11,18,284,11,12,-1
11,18,285,14,8,6
11,18,286,12,10,2
11,18,287,20,10,10
11,18,288,16,15,1
11,18,289,6,13,-7
11,18,290,17,11,6
11,18,291,18,10,8
11,18,292,20,9,11
11,18,293,16,15,1
11,18,294,10,12,-2
11,18,295,19,12,7
11,18,296,39,13,26
11,18,297,21,19,2
11,18,298,12,19,-7
11,18,299,21,7,14
11,19,0,26,20,6
11,19,1,23,12,11
11,19,2,15,24,-9
11,19,3,24,22,2
11,19,4,8,11,-3
11,19,5,20,20,0
11,19,6,14,8,6
11,19,7,13,10,3
11,19,8,15,11,4
11,19,9,21,16,5
11,19,10,14,5,9
11,19,11,13,18,-5
11,19,12,26,22,4
11,19,13,15,8,7
11,19,14,17,14,3
11,19,15,8,17,-9
11,19,16,12,8,4
11,19,17,19,15,4
11,19,18,6,11,-5
11,19,19,21,24,-3
11,19,20,10,5,5
11,19,21,28,22,6
11,19,22,22,8,14
11,19,23,7,4,3
11,19,24,15,9,6
11,19,25,24,14,10
11,19,26,19,5,14
11,19,27,16,7,9
11,19,28,12,9,3
11,19,29,10,22,-12
11,19,30,13,7,6
11,19,31,16,14,2
11,19,32,11,16,-5
11,19,33,23,17,6
11,19,34,23,15,8
11,19,35,12,9,3
11,19,36,9,8,1
11,19,37,16,24,-8
11,19,38,16,15,1
11,19,39,17,11,6
11,19,40,21,12,9
11,19,41,12,16,-4
11,19,42,24,18,6
11,19,43,23,14,9
11,19,44,24,31,-7
11,19,45,14,8,6
11,19,46,15,22,-7
11,19,47,10,7,3
11,19,48,18,4,14
11,19,49,15,16,-1
11,19,50,8,4,4
11,19,51,10,14,-4
11,19,52,19,29,-10
11,19,53,10,16,-6
11,19,54,20,18,2
11,19,55,15,14,1
11,19,56,10,10,0
11,19,57,22,14,8
11,19,58,24,27,-3
11,19,59,13,12,1
11,19,60,22,19,3
11,19,61,14,10,4
11,19,62,15,7,8
11,19,63,16,10,6
11,19,64,18,16,2
11,19,65,29,25,4
11,19,66,8,12,-4
11,19,67,20,11,9
11,19,68,14,14,0
11,19,69,23,11,12
11,19,70,10,13,-3
11,19,71,10,8,2
11,19,72,39,17,22
11,19,73,28,14,14
11,19,74,23,14,9
11,19,75,10,11,-1
11,19,76,19,12,7
11,19,77,15,2,13
11,19,78,11,13,-2
11,19,79,7,6,1
11,19,80,22,12,10
11,19,81,13,11,2
11,19,82,27,33,-6
11,19,83,12,6,6
11,19,84,11,13,-2
11,19,85,30,16,14
11,19,86,17,8,9
11,19,87,10,9,1
11,19,88,15,14,1
11,19,89,16,15,1
11,19,90,23,14,9
11,19,91,14,8,6
11,19,92,12,9,3
11,19,93,3,8,-5
11,19,94,19,20,-1
11,19,95,23,18,5
11,19,96,15,11,4
11,19,97,22,8,14
11,19,98,20,6,14
11,19,99,15,23,-8
11,19,100,10,25,-15
11,19,101,14,11,3
11,19,102,14,8,6
11,19,103,23,15,8
11,19,104,11,9,2
11,19,105,10,12,-2
11,19,106,8,11,-3
11,19,107,12,21,-9
11,19,108,16,16,0
11,19,109,15,10,5
11,19,110,21,10,11
11,19,111,12,7,5
11,19,112,17,6,11
11,19,113,26,13,13
11,19,114,31,12,19
11,19,115,21,11,10
11,19,116,13,7,6
11,19,117,14,14,0
11,19,118,7,10,-3
11,19,119,14,14,0
11,19,120,13,9,4
11,19,121,4,11,-7
11,19,122,19,17,2
11,19,123,11,12,-1
11,19,124,15,14,1
11,19,125,22,15,7
11,19,126,13,3,10
11,19,127,13,17,-4
11,19,128,15,9,6
11,19,129,13,18,-5
11,19,130,19,14,5
11,19,131,15,13,2
11,19,132,23,11,12
11,19,133,6,13,-7
11,19,134,25,9,16
11,19,135,23,35,-12
11,19,136,20,10,10
11,19,137,24,22,2
11,19,138,9,13,-4
11,19,139,22,18,4
11,19,140,12,16,-4
11,19,141,18,14,4
11,19,142,13,16,-3
11,19,143,25,17,8
11,19,144,26,16,10
11,19,145,5,18,-13
11,19,146,14,16,-2
11,19,147,26,21,5
11,19,148,15,9,6
11,19,149,19,17,2
11,19,150,14,20,-6
11,19,151,16,20,-4
11,19,152,12,11,1
11,19,153,15,16,-1
11,19,154,12,17,-5
11,19,155,12,13,-1
11,19,156,14,8,6
11,19,157,14,12,2
11,19,158,11,27,-16
11,19,159,17,14,3
11,19,160,19,14,5
11,19,161,17,24,-7
11,19,162,13,12,1
11,19,163,23,9,14
11,19,164,10,13,-3
11,19,165,7,11,-4
11,19,166,10,16,-6
11,19,167,23,16,7
11,19,168,10,12,-2
11,19,169,7,14,-7
11,19,170,8,6,2
11,19,171,11,10,1
11,19,172,24,18,6
11,19,173,26,16,10
11,19,174,19,17,2
11,19,175,14,10,4
11,19,176,25,20,5
11,19,177,16,11,5
11,19,178,25,6,19
11,19,179,25,10,15
11,19,180,13,3,10
11,19,181,23,17,6
11,19,182,18,15,3
11,19,183,28,22,6
11,19,184,11,11,0
11,19,185,8,5,3
11,19,186,15,9,6
11,19,187,9,14,-5
11,19,188,21,16,5
11,19,189,21,18,3
11,19,190,12,14,-2
11,19,191,27,14,13
11,19,192,24,15,9
11,19,193,17,12,5
11,19,194,9,8,1
11,19,195,27,15,12
11,19,196,11,10,1
11,19,197,14,11,3
11,19,198,22,17,5
11,19,199,21,13,8
11,19,200,10,14,-4
11,19,201,6,13,-7
11,19,202,12,18,-6
11,19,203,23,11,12
11,19,204,13,25,-12
11,19,205,20,13,7
11,19,206,25,9,16
11,19,207,15,10,5
11,19,208,8,3,5
11,19,209,13,11,2
11,19,210,24,10,14
11,19,211,20,8,12
11,19,212,17,19,-2
11,19,213,13,13,0
11,19,214,28,19,9
11,19,215,14,21,-7
11,19,216,17,13,4
11,19,217,27,22,5
11,19,218,24,18,6
11,19,219,16,12,4
11,19,220,23,12,11
11,19,221,25,29,-4
11,19,222,16,9,7
11,19,223,20,17,3
11,19,224,16,10,6
11,19,225,21,15,6
11,19,226,11,15,-4
11,19,227,16,10,6
11,19,228,23,15,8
11,19,229,13,13,0
11,19,230,12,9,3
11,19,231,22,20,2
11,19,232,23,26,-3
11,19,233,7,16,-9
11,19,234,7,8,-1
11,19,235,11,23,-12
11,19,236,22,14,8
11,19,237,12,23,-11
11,19,238,19,15,4
11,19,239,15,22,-7
11,19,240,18,9,9
11,19,241,13,9,4
11,19,242,23,19,4
11,19,243,7,15,-8
11,19,244,16,14,2
11,19,245,21,16,5
11,19,246,19,8,11
11,19,247,12,9,3
11,19,248,27,16,11
11,19,249,25,15,10
11,19,250,13,28,-15
11,19,251,15,13,2
11,19,252,20,13,7
11,19,253,19,9,10
11,19,254,18,16,2
11,19,255,15,14,1
11,19,256,12,8,4
11,19,257,15,23,-8
11,19,258,12,17,-5
11,19,259,18,23,-5
11,19,260,20,18,2
11,19,261,13,18,-5
11,19,262,15,18,-3
11,19,263,14,5,9
11,19,264,27,11,16
11,19,265,41,16,25
11,19,266,23,14,9
11,19,267,16,17,-1
11,19,268,5,11,-6
11,19,269,16,19,-3
11,19,270,15,14,1
11,19,271,18,11,7
11,19,272,13,12,1
11,19,273,28,10,18
11,19,274,8,5,3
11,19,275,21,14,7
11,19,276,17,14,3
11,19,277,13,21,-8
11,19,278,13,18,-5
11,19,279,24,9,15
11,19,280,11,16,-5
11,19,281,17,11,6
11,19,282,14,9,5
11,19,283,12,4,8
11,19,284,18,10,8
11,19,285,13,14,-1
11,19,286,16,13,3
11,19,287,6,16,-10
11,19,288,14,12,2
11,19,289,21,11,10
11,19,290,24,7,17
11,19,291,24,20,4
11,19,292,21,10,11
11,19,293,8,13,-5
11,19,294,19,14,5
11,19,295,23,10,13
11,19,296,18,16,2
11,19,297,18,12,6
11,19,298,12,14,-2
11,19,299,14,21,-7
11,20,0,10,6,4
11,20,1,9,13,-4
11,20,2,7,5,2
11,20,3,13,9,4
11,20,4,15,16,-1
11,20,5,10,10,0
11,20,6,26,14,12
11,20,7,10,16,-6
11,20,8,20,14,6
11,20,9,7,3,4
11,20,10,19,7,12
11,20,11,21,33,-12
11,20,12,9,8,1
11,20,13,16,17,-1
11,20,14,21,15,6
11,20,15,17,10,7
11,20,16,11,20,-9
11,20,17,15,18,-3
11,20,18,11,17,-6
11,20,19,25,12,13
11,20,20,6,14,-8
11,20,21,18,19,-1
11,20,22,12,12,0
11,20,23,18,10,8
11,20,24,14,5,9
11,20,25,19,9,10
11,20,26,17,10,7
11,20,27,9,16,-7
11,20,28,14,12,2
11,20,29,15,24,-9
11,20,30,17,15,2
11,20,31,15,9,6
11,20,32,24,9,15
11,20,33,29,14,15
11,20,34,23,12,11
11,20,35,10,16,-6
11,20,36,19,14,5
11,20,37,4,14,-10
11,20,38,23,18,5
11,20,39,15,13,2
11,20,40,17,8,9
11,20,41,11,6,5
11,20,42,14,7,7
11,20,43,28,12,16
11,20,44,5,11,-6
11,20,45,21,10,11
11,20,46,25,22,3
11,20,47,16,24,-8
11,20,48,14,11,3
11,20,49,14,19,-5
11,20,50,24,17,7
11,20,51,14,7,7
11,20,52,10,19,-9
11,20,53,18,10,8
11,20,54,17,6,11
11,20,55,15,5,10
11,20,56,12,8,4
11,20,57,13,10,3
11,20,58,9,13,-4
11,20,59,10,3,7
11,20,60,12,17,-5
11,20,61,18,8,10
11,20,62,22,12,10
11,20,63,5,16,-11
11,20,64,18,24,-6
11,20,65,23,19,4
11,20,66,7,10,-3
11,20,67,26,11,15
11,20,68,32,15,17
11,20,69,10,11,-1
11,20,70,7,10,-3
11,20,71,12,22,-10
11,20,72,21,14,7
11,20,73,21,17,4
11,20,74,0,6,-6
11,20,75,20,15,5
11,20,76,29,21,8
11,20,77,26,22,4
11,20,78,11,4,7
11,20,79,19,16,3
11,20,80,31,23,8
11,20,81,28,25,3
11,20,82,32,27,5
11,20,83,14,6,8
11,20,84,33,15,18
11,20,85,25,22,3
11,20,86,15,12,3
11,20,87,23,13,10
11,20,88,17,29,-12
11,20,89,20,9,11
11,20,90,11,11,0
11,20,91,18,21,-3
11,20,92,15,19,-4
11,20,93,15,23,-8
11,20,94,21,12,9
11,20,95,21,13,8
11,20,96,11,17,-6
11,20,97,10,8,2
11,20,98,16,8,8
11,20,99,37,15,22
11,20,100,9,10,-1
11,20,101,28,15,13
11,20,102,11,16,-5
11,20,103,23,11,12
11,20,104,13,5,8
11,20,105,25,18,7
11,20,106,8,10,-2
11,20,107,21,20,1
11,20,108,23,14,9
11,20,109,20,16,4
11,20,110,13,16,-3
11,20,111,6,7,-1
11,20,112,18,11,7
11,20,113,23,16,7
11,20,114,10,9,1
11,20,115,16,15,1
11,20,116,24,22,2
11,20,117,24,18,6
11,20,118,22,9,13
11,20,119,28,16,12
11,20,120,8,12,-4
11,20,121,7,6,1
11,20,122,12,16,-4
11,20,123,19,15,4
11,20,124,19,16,3
11,20,125,19,23,-4
11,20,126,24,15,9
11,20,127,15,22,-7
11,20,128,24,15,9
11,20,129,23,15,8
11,20,130,22,16,6
11,20,131,13,5,8
11,20,132,8,7,1
11,20,133,16,8,8
11,20,134,22,19,3
11,20,135,20,10,10
11,20,136,23,19,4
11,20,137,19,24,-5
11,20,138,15,14,1
11,20,139,6,10,-4
11,20,140,19,10,9
11,20,141,16,5,11
11,20,142,14,19,-5
11,20,143,16,7,9
11,20,144,18,13,5
11,20,145,12,10,2
11,20,146,27,13,14
11,20,147,18,8,10
11,20,148,24,13,11
11,20,149,16,7,9
11,20,150,12,8,4
11,20,151,27,14,13
11,20,152,19,14,5
11,20,153,27,3,24
11,20,154,12,9,3
11,20,155,13,11,2
11,20,156,11,6,5
11,20,157,14,10,4
11,20,158,17,27,-10
11,20,159,32,14,18
11,20,160,17,11,6
11,20,161,23,17,6
11,20,162,14,13,1
11,20,163,10,17,-7
11,20,164,29,11,18
11,20,165,35,20,15
11,20,166,4,9,-5
11,20,167,22,8,14
11,20,168,3,14,-11
11,20,169,14,14,0
11,20,170,19,14,5
11,20,171,15,13,2
11,20,172,29,10,19
11,20,173,11,16,-5
11,20,174,9,8,1
11,20,175,12,16,-4
11,20,176,37,15,22
11,20,177,14,4,10
11,20,178,12,19,-7
11,20,179,8,7,1
11,20,180,20,15,5
11,20,181,11,8,3
11,20,182,14,15,-1
11,20,183,16,16,0
11,20,184,13,13,0
11,20,185,16,10,6
11,20,186,23,12,11
11,20,187,15,21,-6
11,20,188,16,10,6
11,20,189,25,16,9
11,20,190,19,21,-2
11,20,191,20,16,4
11,20,192,9,24,-15
11,20,193,8,7,1
11,20,194,14,22,-8
11,20,195,12,22,-10
11,20,196,17,8,9
11,20,197,13,12,1
11,20,198,10,20,-10
11,20,199,21,17,4
11,20,200,11,12,-1
11,20,201,16,4,12
11,20,202,28,19,9
11,20,203,16,10,6
11,20,204,20,14,6
11,20,205,21,15,6
11,20,206,33,21,12
11,20,207,13,15,-2
11,20,208,13,10,3
11,20,209,19,22,-3
11,20,210,12,8,4
11,20,211,17,11,6
11,20,212,34,22,12
11,20,213,34,16,18
11,20,214,23,20,3
11,20,215,16,18,-2
11,20,216,13,8,5
11,20,217,19,16,3
11,20,218,24,18,6
11,20,219,15,16,-1
11,20,220,32,28,4
11,20,221,16,22,-6
11,20,222,19,16,3
11,20,223,19,17,2
11,20,224,14,22,-8
11,20,225,6,6,0
11,20,226,17,11,6
11,20,227,27,15,12
11,20,228,19,22,-3
11,20,229,25,13,12
11,20,230,24,14,10
11,20,231,25,7,18
11,20,232,15,16,-1
11,20,233,24,20,4
11,20,234,8,15,-7
11,20,235,16,12,4
11,20,236,20,15,5
11,20,237,13,11,2
11,20,238,8,19,-11
11,20,239,13,10,3
11,20,240,14,20,-6
11,20,241,19,23,-4
11,20,242,20,15,5
11,20,243,15,9,6
11,20,244,16,10,6
11,20,245,23,19,4
11,20,246,20,7,13
11,20,247,40,15,25
11,20,248,16,14,2
11,20,249,16,15,1
11,20,250,11,13,-2
11,20,251,12,8,4
11,20,252,22,22,0
11,20,253,16,18,-2
11,20,254,23,5,18
11,20,255,23,8,15
11,20,256,23,14,9
11,20,257,17,16,1
11,20,258,21,7,14
11,20,259,10,15,-5
11,20,260,23,16,7
11,20,261,21,17,4
11,20,262,7,10,-3
11,20,263,19,8,11
11,20,264,12,20,-8
11,20,265,16,10,6
11,20,266,14,15,-1
11,20,267,21,6,15
11,20,268,15,3,12
11,20,269,10,7,3
11,20,270,30,24,6
11,20,271,11,15,-4
11,20,272,26,15,11
11,20,273,9,10,-1
11,20,274,21,20,1
11,20,275,17,14,3
11,20,276,24,13,11
11,20,277,32,22,10
11,20,278,27,26,1
11,20,279,9,10,-1
11,20,280,18,16,2
11,20,281,15,34,-19
11,20,282,11,14,-3
11,20,283,16,13,3
11,20,284,21,10,11
11,20,285,12,9,3
11,20,286,20,23,-3
11,20,287,18,15,3
11,20,288,17,11,6
11,20,289,17,27,-10
11,20,290,20,24,-4
11,20,291,10,16,-6
11,20,292,13,15,-2
11,20,293,24,14,10
11,20,294,14,13,1
11,20,295,10,11,-1
11,20,296,20,14,6
11,20,297,9,18,-9
11,20,298,18,7,11
11,20,299,15,14,1
11,21,0,15,9,6
11,21,1,11,9,2
11,21,2,24,18,6
11,21,3,23,15,8
11,21,4,12,6,6
11,21,5,27,16,11
11,21,6,16,12,4
11,21,7,16,6,10
11,21,8,10,9,1
11,21,9,20,11,9
11,21,10,25,19,6
11,21,11,14,10,4
11,21,12,13,18,-5
11,21,13,31,13,18
11,21,14,4,12,-8
11,21,15,11,17,-6
11,21,16,31,20,11
11,21,17,17,16,1
11,21,18,21,15,6
11,21,19,22,12,10
11,21,20,15,7,8
11,21,21,24,10,14
11,21,22,9,9,0
11,21,23,15,7,8
11,21,24,3,1,2
11,21,25,16,16,0
11,21,26,16,29,-13
11,21,27,29,10,19
11,21,28,15,23,-8
11,21,29,13,8,5
11,21,30,24,17,7
11,21,31,18,11,7
11,21,32,35,14,21
11,21,33,20,24,-4
11,21,34,16,8,8
11,21,35,7,11,-4
11,21,36,16,6,10
11,21,37,14,21,-7
11,21,38,17,11,6
11,21,39,17,12,5
11,21,40,11,19,-8
11,21,41,24,14,10
11,21,42,13,7,6
11,21,43,14,14,0
11,21,44,15,15,0
11,21,45,21,22,-1
11,21,46,22,10,12
11,21,47,14,22,-8
11,21,48,22,17,5
11,21,49,29,21,8
11,21,50,20,21,-1
11,21,51,5,3,2
11,21,52,9,17,-8
11,21,53,24,12,12
11,21,54,16,21,-5
11,21,55,12,16,-4
11,21,56,18,14,4
11,21,57,26,9,17
11,21,58,13,8,5
11,21,59,8,11,-3
11,21,60,29,16,13
11,21,61,29,21,8
11,21,62,17,15,2
11,21,63,15,7,8
11,21,64,11,0,11
11,21,65,14,8,6
11,21,66,20,16,4
11,21,67,9,9,0
11,21,68,28,13,15
11,21,69,13,13,0
11,21,70,16,10,6
11,21,71,20,14,6
11,21,72,14,17,-3
11,21,73,13,9,4
11,21,74,19,10,9
11,21,75,26,18,8
11,21,76,16,15,1
11,21,77,34,20,14
11,21,78,11,6,5
11,21,79,17,20,-3
11,21,80,27,14,13
11,21,81,16,27,-11
11,21,82,15,12,3
11,21,83,11,11,0
11,21,84,11,10,1
11,21,85,16,9,7
11,21,86,13,19,-6
11,21,87,20,10,10
11,21,88,20,15,5
11,21,89,22,18,4
11,21,90,7,16,-9
11,21,91,8,7,1
11,21,92,23,16,7
11,21,93,16,7,9
11,21,94,22,22,0
11,21,95,29,8,21
11,21,96,28,10,18
11,21,97,12,4,8
11,21,98,10,17,-7
11,21,99,16,12,4
11,21,100,17,21,-4
11,21,101,27,21,6
11,21,102,27,35,-8
11,21,103,24,13,11
11,21,104,13,0,13
11,21,105,19,11,8
11,21,106,9,12,-3
11,21,107,18,14,4
11,21,108,15,17,-2
11,21,109,17,15,2
11,21,110,19,7,12
11,21,111,24,9,15
11,21,112,34,11,23
11,21,113,27,11,16
11,21,114,13,8,5
11,21,115,23,10,13
11,21,116,28,15,13
11,21,117,35,23,12
11,21,118,19,14,5
11,21,119,15,14,1
11,21,120,20,9,11
11,21,121,10,18,-8
11,21,122,10,15,-5
11,21,123,16,10,6
11,21,124,19,15,4
11,21,125,14,9,5
11,21,126,18,6,12
11,21,127,23,9,14
11,21,128,14,11,3
11,21,129,8,4,4
11,21,130,8,7,1
11,21,131,19,25,-6
11,21,132,15,11,4
11,21,133,14,23,-9
11,21,134,21,8,13
11,21,135,22,13,9
11,21,136,19,10,9
11,21,137,23,16,7
11,21,138,28,21,7
11,21,139,20,12,8
11,21,140,12,9,3
11,21,141,18,10,8
11,21,142,19,17,2
11,21,143,25,23,2
11,21,144,8,19,-11
11,21,145,17,23,-6
11,21,146,12,15,-3
11,21,147,29,20,9
11,21,148,12,18,-6
11,21,149,19,12,7
11,21,150,23,15,8
11,21,151,22,12,10
11,21,152,14,22,-8
11,21,153,25,18,7
11,21,154,13,10,3
11,21,155,21,11,10
11,21,156,23,16,7
11,21,157,6,15,-9
11,21,158,15,16,-1
11,21,159,10,8,2
11,21,160,15,10,5
11,21,161,30,39,-9
11,21,162,13,10,3
11,21,163,5,12,-7
11,21,164,14,16,-2
11,21,165,14,7,7
11,21,166,11,4,7
11,21,167,7,9,-2
11,21,168,14,11,3
11,21,169,23,21,2
11,21,170,23,15,8
11,21,171,11,23,-12
11,21,172,16,18,-2
11,21,173,12,6,6
11,21,174,29,10,19
11,21,175,21,13,8
11,21,176,27,14,13
11,21,177,27,14,13
11,21,178,8,7,1
11,21,179,14,5,9
11,21,180,24,24,0
11,21,181,27,26,1
11,21,182,16,10,6
11,21,183,12,16,-4
11,21,184,11,6,5
11,21,185,24,17,7
11,21,186,15,9,6
11,21,187,13,22,-9
11,21,188,28,25,3
11,21,189,16,11,5
11,21,190,25,13,12
11,21,191,33,16,17
11,21,192,8,5,3
11,21,193,13,14,-1
11,21,194,15,10,5
11,21,195,40,18,22
11,21,196,17,11,6
11,21,197,15,8,7
11,21,198,19,14,5
11,21,199,13,3,10
11,21,200,15,12,3
11,21,201,17,20,-3
11,21,202,15,9,6
11,21,203,19,17,2
11,21,204,9,14,-5
11,21,205,23,14,9
11,21,206,25,12,13
11,21,207,17,6,11
11,21,208,11,10,1
11,21,209,9,9,0
11,21,210,13,14,-1
11,21,211,7,14,-7
11,21,212,11,7,4
11,21,213,12,3,9
11,21,214,11,17,-6
11,21,215,26,17,9
11,21,216,15,19,-4
11,21,217,10,10,0
11,21,218,13,7,6
11,21,219,25,15,10
11,21,220,31,13,18
11,21,221,22,12,10
11,21,222,10,14,-4
11,21,223,15,10,5
11,21,224,15,7,8
11,21,225,21,21,0
11,21,226,14,4,10
11,21,227,33,17,16
11,21,228,18,13,5
11,21,229,7,3,4
11,21,230,14,15,-1
11,21,231,15,16,-1
11,21,232,9,10,-1
11,21,233,11,12,-1
11,21,234,12,8,4
11,21,235,6,16,-10
11,21,236,16,12,4
11,21,237,6,8,-2
11,21,238,22,16,6
11,21,239,20,22,-2
11,21,240,12,5,7
11,21,241,32,19,13
11,21,242,14,17,-3
11,21,243,14,14,0
11,21,244,12,10,2
11,21,245,17,9,8
11,21,246,15,18,-3
11,21,247,22,14,8
11,21,248,18,9,9
11,21,249,18,6,12
11,21,250,30,19,11
11,21,251,8,10,-2
11,21,252,11,22,-11
11,21,253,18,13,5
11,21,254,18,27,-9
11,21,255,22,15,7
11,21,256,24,19,5
11,21,257,15,21,-6
11,21,258,18,18,0
11,21,259,19,21,-2
11,21,260,15,2,13
11,21,261,18,16,2
11,21,262,13,16,-3
11,21,263,23,17,6
11,21,264,9,1,8
11,21,265,24,11,13
11,21,266,22,7,15
11,21,267,11,9,2
11,21,268,22,16,6
11,21,269,7,9,-2
11,21,270,10,9,1
11,21,271,17,17,0
11,21,272,20,5,15
11,21,273,18,14,4
11,21,274,12,14,-2
11,21,275,8,12,-4
11,21,276,20,10,10
11,21,277,14,7,7
11,21,278,24,15,9
11,21,279,39,20,19
11,21,280,17,11,6
11,21,281,20,8,12
11,21,282,22,9,13
11,21,283,8,8,0
11,21,284,14,15,-1
11,21,285,15,12,3
11,21,286,19,12,7
11,21,287,25,20,5
11,21,288,21,12,9
11,21,289,8,4,4
11,21,290,24,20,4
11,21,291,19,10,9
11,21,292,8,20,-12
11,21,293,13,12,1
11,21,294,16,15,1
11,21,295,11,11,0
11,21,296,21,8,13
11,21,297,14,10,4
11,21,298,35,18,17
11,21,299,11,10,1
11,22,0,22,14,8
11,22,1,14,10,4
11,22,2,18,22,-4
11,22,3,20,8,12
11,22,4,19,25,-6
11,22,5,16,12,4
11,22,6,12,9,3
11,22,7,11,4,7
11,22,8,22,22,0
11,22,9,24,7,17
11,22,10,28,29,-1
11,22,11,32,15,17
11,22,12,18,19,-1
11,22,13,11,12,-1
11,22,14,21,20,1
11,22,15,15,15,0
11,22,16,15,16,-1
11,22,17,24,16,8
11,22,18,11,16,-5
11,22,19,16,12,4
11,22,20,9,8,1
11,22,21,28,6,22
11,22,22,10,12,-2
11,22,23,17,10,7
11,22,24,22,11,11
11,22,25,15,6,9
11,22,26,22,22,0
11,22,27,13,9,4
11,22,28,20,7,13
11,22,29,30,30,0
11,22,30,13,12,1
11,22,31,18,14,4
11,22,32,23,20,3
11,22,33,11,18,-7
11,22,34,20,9,11
11,22,35,8,9,-1
11,22,36,10,11,-1
11,22,37,9,14,-5
11,22,38,35,22,13
11,22,39,17,12,5
11,22,40,15,13,2
11,22,41,12,5,7
11,22,42,10,6,4
11,22,43,12,15,-3
11,22,44,26,13,13
11,22,45,8,6,2
11,22,46,9,12,-3
11,22,47,18,12,6
11,22,48,23,20,3
11,22,49,18,16,2
11,22,50,22,9,13
11,22,51,15,8,7
11,22,52,15,10,5
11,22,53,22,16,6
11,22,54,9,16,-7
11,22,55,21,17,4
11,22,56,11,21,-10
11,22,57,12,8,4
11,22,58,17,14,3
11,22,59,18,16,2
11,22,60,14,25,-11
11,22,61,12,14,-2
11,22,62,18,25,-7
11,22,63,9,17,-8
11,22,64,21,16,5
11,22,65,25,15,10
11,22,66,22,16,6
11,22,67,19,16,3
11,22,68,22,21,1
11,22,69,18,3,15
11,22,70,14,18,-4
11,22,71,9,18,-9
11,22,72,13,12,1
11,22,73,14,13,1
11,22,74,15,12,3
11,22,75,13,15,-2
11,22,76,14,23,-9
11,22,77,19,13,6
11,22,78,19,22,-3
11,22,79,14,15,-1
11,22,80,19,8,11
11,22,81,14,18,-4
11,22,82,14,18,-4
11,22,83,27,13,14
11,22,84,16,21,-5
11,22,85,12,13,-1
11,22,86,26,24,2
11,22,87,21,22,-1
11,22,88,21,12,9
11,22,89,26,18,8
11,22,90,20,14,6
11,22,91,5,1,4
11,22,92,20,13,7
11,22,93,5,10,-5
11,22,94,15,15,0
11,22,95,34,16,18
11,22,96,18,9,9
11,22,97,8,15,-7
11,22,98,21,23,-2
11,22,99,27,18,9
11,22,100,16,17,-1
11,22,101,28,13,15
11,22,102,9,16,-7
11,22,103,9,13,-4
11,22,104,29,23,6
11,22,105,19,29,-10
11,22,106,19,11,8
11,22,107,18,21,-3
11,22,108,30,23,7
11,22,109,6,9,-3
11,22,110,15,5,10
11,22,111,7,4,3
11,22,112,9,7,2
11,22,113,13,14,-1
11,22,114,18,15,3
11,22,115,21,8,13
11,22,116,15,12,3
11,22,117,17,15,2
11,22,118,24,11,13
11,22,119,27,9,18
11,22,120,12,28,-16
11,22,121,2,11,-9
11,22,122,19,12,7
11,22,123,28,10,18
11,22,124,19,16,3
11,22,125,19,15,4
11,22,126,20,12,8
11,22,127,23,26,-3
11,22,128,22,15,7
11,22,129,21,15,6
11,22,130,23,16,7
11,22,131,39,30,9
11,22,132,16,13,3
11,22,133,17,16,1
11,22,134,7,11,-4
11,22,135,14,11,3
11,22,136,19,12,7
11,22,137,12,13,-1
11,22,138,19,7,12
11,22,139,21,8,13
11,22,140,15,8,7
11,22,141,17,19,-2
11,22,142,14,9,5
11,22,143,8,11,-3
11,22,144,11,9,2
11,22,145,9,7,2
11,22,146,14,9,5
11,22,147,27,22,5
11,22,148,28,20,8
11,22,149,14,7,7
11,22,150,21,14,7
11,22,151,16,4,12
11,22,152,14,9,5
11,22,153,25,18,7
11,22,154,15,18,-3
11,22,155,19,16,3
11,22,156,13,21,-8
11,22,157,21,15,6
11,22,158,17,19,-2
11,22,159,7,7,0
11,22,160,14,10,4
11,22,161,15,7,8
11,22,162,29,17,12
11,22,163,16,7,9
11,22,164,22,4,18
11,22,165,21,27,-6
11,22,166,19,19,0
11,22,167,7,11,-4
11,22,168,18,9,9
11,22,169,12,13,-1
11,22,170,19,13,6
11,22,171,14,16,-2
11,22,172,21,20,1
11,22,173,17,19,-2
11,22,174,16,18,-2
11,22,175,14,8,6
11,22,176,16,10,6
11,22,177,9,13,-4
11,22,178,25,17,8
11,22,179,14,12,2
11,22,180,17,9,8
11,22,181,22,5,17
11,22,182,20,22,-2
11,22,183,19,25,-6
11,22,184,18,10,8
11,22,185,23,16,7
11,22,186,15,15,0
11,22,187,29,15,14
11,22,188,10,3,7
11,22,189,25,10,15
11,22,190,29,8,21
11,22,191,19,14,5
11,22,192,15,5,10
11,22,193,25,21,4
11,22,194,27,1,26
11,22,195,11,14,-3
11,22,196,7,14,-7
11,22,197,28,17,11
11,22,198,15,6,9
11,22,199,22,12,10
11,22,200,16,7,9
11,22,201,5,8,-3
11,22,202,14,20,-6
11,22,203,15,17,-2
11,22,204,12,6,6
11,22,205,16,20,-4
11,22,206,22,13,9
11,22,207,13,9,4
11,22,208,17,10,7
11,22,209,18,11,7
11,22,210,17,13,4
11,22,211,6,9,-3
11,22,212,16,12,4
11,22,213,8,20,-12
11,22,214,16,4,12
11,22,215,19,12,7
11,22,216,13,22,-9
11,22,217,26,29,-3
11,22,218,13,12,1
11,22,219,23,13,10
11,22,220,18,14,4
11,22,221,11,5,6
11,22,222,9,9,0
11,22,223,12,12,0
11,22,224,9,8,1
11,22,225,21,16,5
11,22,226,28,19,9
11,22,227,11,8,3
11,22,228,22,19,3
11,22,229,18,12,6
11,22,230,8,16,-8
11,22,231,17,19,-2
11,22,232,20,23,-3
11,22,233,17,11,6
11,22,234,13,15,-2
11,22,235,10,11,-1
11,22,236,18,20,-2
11,22,237,13,13,0
11,22,238,16,13,3
11,22,239,25,20,5
11,22,240,18,14,4
11,22,241,15,16,-1
11,22,242,17,12,5
11,22,243,19,14,5
11,22,244,29,10,19
11,22,245,13,21,-8
11,22,246,15,14,1
11,22,247,14,8,6
11,22,248,24,9,15
11,22,249,20,12,8
11,22,250,25,9,16
11,22,251,12,19,-7
11,22,252,24,16,8
11,22,253,20,17,3
11,22,254,13,14,-1
11,22,255,22,24,-2
11,22,256,10,7,3
11,22,257,13,10,3
11,22,258,36,27,9
11,22,259,14,5,9
11,22,260,13,12,1
11,22,261,11,13,-2
11,22,262,10,9,1
11,22,263,22,6,16
11,22,264,37,18,19
11,22,265,23,21,2
11,22,266,15,3,12
11,22,267,16,13,3
11,22,268,23,16,7
11,22,269,19,13,6
11,22,270,16,15,1
11,22,271,11,11,0
11,22,272,14,11,3
11,22,273,10,20,-10
11,22,274,20,28,-8
11,22,275,16,21,-5
11,22,276,18,9,9
11,22,277,16,16,0
11,22,278,19,13,6
11,22,279,12,11,1
11,22,280,21,27,-6
11,22,281,27,25,2
11,22,282,22,20,2
11,22,283,21,17,4
11,22,284,21,9,12
11,22,285,7,10,-3
11,22,286,15,26,-11
11,22,287,13,12,1
11,22,288,8,10,-2
11,22,289,12,7,5
11,22,290,14,9,5
11,22,291,12,12,0
11,22,292,12,6,6
11,22,293,7,9,-2
11,22,294,14,17,-3
11,22,295,17,13,4
11,22,296,12,8,4
11,22,297,13,15,-2
11,22,298,20,8,12
11,22,299,12,9,3
11,23,0,22,7,15
11,23,1,13,14,-1
11,23,2,21,7,14
11,23,3,25,13,12
11,23,4,17,6,11
11,23,5,7,9,-2
11,23,6,7,5,2
11,23,7,21,13,8
11,23,8,12,1,11
11,23,9,30,17,13
11,23,10,11,10,1
11,23,11,22,17,5
11,23,12,18,16,2
11,23,13,14,13,1
11,23,14,20,8,12
11,23,15,10,11,-1
11,23,16,25,10,15
11,23,17,13,13,0
11,23,18,7,9,-2
11,23,19,16,18,-2
11,23,20,16,20,-4
11,23,21,22,8,14
11,23,22,16,10,6
11,23,23,13,19,-6
11,23,24,15,15,0
11,23,25,15,16,-1
11,23,26,16,14,2
11,23,27,33,20,13
11,23,28,8,17,-9
11,23,29,27,24,3
11,23,30,9,18,-9
11,23,31,6,16,-10
11,23,32,13,8,5
11,23,33,6,11,-5
11,23,34,15,10,5
11,23,35,12,20,-8
11,23,36,31,4,27
11,23,37,13,12,1
11,23,38,13,15,-2
11,23,39,18,7,11
11,23,40,27,16,11
11,23,41,17,34,-17
11,23,42,27,13,14
11,23,43,11,3,8
11,23,44,25,13,12
11,23,45,16,6,10
11,23,46,44,19,25
11,23,47,18,15,3
11,23,48,12,14,-2
11,23,49,10,10,0
11,23,50,23,7,16
11,23,51,19,12,7
11,23,52,10,13,-3
11,23,53,14,17,-3
11,23,54,17,21,-4
11,23,55,16,6,10
11,23,56,32,9,23
11,23,57,15,19,-4
11,23,58,8,14,-6
11,23,59,23,21,2
11,23,60,23,10,13
11,23,61,16,14,2
11,23,62,16,6,10
11,23,63,19,12,7
11,23,64,15,20,-5
11,23,65,17,16,1
11,23,66,13,9,4
11,23,67,13,12,1
11,23,68,10,8,2
11,23,69,18,12,6
11,23,70,23,17,6
11,23,71,22,18,4
11,23,72,20,13,7
11,23,73,33,17,16
11,23,74,12,16,-4
11,23,75,22,16,6
11,23,76,15,21,-6
11,23,77,18,9,9
11,23,78,10,12,-2
11,23,79,7,11,-4
11,23,80,26,12,14
11,23,81,28,16,12
11,23,82,26,14,12
11,23,83,20,10,10
11,23,84,19,10,9
11,23,85,18,13,5
11,23,86,12,8,4
11,23,87,17,10,7
11,23,88,13,17,-4
11,23,89,3,14,-11
11,23,90,9,19,-10
11,23,91,17,9,8
11,23,92,33,13,20
11,23,93,20,11,9
11,23,94,7,6,1
11,23,95,16,16,0
11,23,96,20,15,5
11,23,97,7,5,2
11,23,98,10,12,-2
11,23,99,31,12,19
11,23,100,20,13,7
11,23,101,13,18,-5
11,23,102,13,10,3
11,23,103,15,8,7
11,23,104,36,20,16
11,23,105,23,12,11
11,23,106,10,13,-3
11,23,107,21,17,4
11,23,108,21,19,2
11,23,109,15,14,1
11,23,110,29,9,20
11,23,111,8,10,-2
11,23,112,25,18,7
11,23,113,13,15,-2
11,23,114,27,12,15
11,23,115,26,13,13
11,23,116,15,10,5
11,23,117,29,10,19
11,23,118,18,17,1
11,23,119,14,15,-1
11,23,120,24,19,5
11,23,121,27,14,13
11,23,122,14,19,-5
11,23,123,38,12,26
11,23,124,29,8,21
11,23,125,16,13,3
11,23,126,14,10,4
11,23,127,11,6,5
11,23,128,15,7,8
11,23,129,10,11,-1
11,23,130,14,7,7
11,23,131,7,9,-2
11,23,132,14,9,5
11,23,133,12,14,-2
11,23,134,20,8,12
11,23,135,12,1,11
11,23,136,22,10,12
11,23,137,13,14,-1
11,23,138,14,12,2
11,23,139,16,18,-2
11,23,140,40,17,23
11,23,141,16,10,6
11,23,142,20,13,7
11,23,143,10,19,-9
11,23,144,17,8,9
11,23,145,9,8,1
11,23,146,11,8,3
11,23,147,6,14,-8
11,23,148,13,14,-1
11,23,149,13,6,7
11,23,150,25,15,10
11,23,151,7,2,5
11,23,152,15,15,0
11,23,153,9,8,1
11,23,154,20,6,14
11,23,155,5,9,-4
11,23,156,17,17,0
11,23,157,26,24,2
11,23,158,13,21,-8
11,23,159,16,8,8
11,23,160,21,14,7
11,23,161,23,20,3
11,23,162,12,15,-3
11,23,163,11,18,-7
11,23,164,10,13,-3
11,23,165,9,17,-8
11,23,166,17,7,10
11,23,167,15,15,0
11,23,168,11,17,-6
11,23,169,20,13,7
11,23,170,12,25,-13
11,23,171,27,9,18
11,23,172,16,20,-4
11,23,173,25,17,8
11,23,174,20,19,1
11,23,175,15,17,-2
11,23,176,18,10,8
11,23,177,7,5,2
11,23,178,24,14,10
11,23,179,12,12,0
11,23,180,15,11,4
11,23,181,5,12,-7
11,23,182,17,19,-2
11,23,183,15,9,6
11,23,184,18,20,-2
11,23,185,12,14,-2
11,23,186,12,16,-4
11,23,187,15,8,7
11,23,188,17,15,2
11,23,189,12,7,5
11,23,190,23,11,12
11,23,191,17,10,7
11,23,192,15,19,-4
11,23,193,32,11,21
11,23,194,13,17,-4
11,23,195,19,17,2
11,23,196,20,11,9
11,23,197,24,7,17
11,23,198,15,17,-2
11,23,199,22,13,9
11,23,200,10,6,4
11,23,201,22,22,0
11,23,202,16,17,-1
11,23,203,17,9,8
11,23,204,20,8,12
11,23,205,23,20,3
11,23,206,13,9,4
11,23,207,15,16,-1
11,23,208,6,11,-5
11,23,209,16,10,6
11,23,210,9,19,-10
11,23,211,16,11,5
11,23,212,7,10,-3
11,23,213,19,16,3
11,23,214,18,16,2
11,23,215,8,1,7
11,23,216,8,12,-4
11,23,217,13,14,-1
11,23,218,16,17,-1
11,23,219,30,11,19
11,23,220,23,8,15
11,23,221,18,13,5
11,23,222,19,29,-10
11,23,223,33,30,3
11,23,224,24,19,5
11,23,225,10,10,0
11,23,226,22,7,15
11,23,227,16,6,10
11,23,228,16,11,5
11,23,229,17,13,4
11,23,230,22,16,6
11,23,231,23,14,9
11,23,232,30,12,18
11,23,233,19,17,2
11,23,234,24,20,4
11,23,235,15,11,4
11,23,236,8,12,-4
11,23,237,10,23,-13
11,23,238,20,14,6
11,23,239,14,16,-2
11,23,240,15,14,1
11,23,241,28,12,16
11,23,242,21,25,-4
11,23,243,10,6,4
11,23,244,21,11,10
11,23,245,8,6,2
11,23,246,16,19,-3
11,23,247,12,19,-7
11,23,248,21,18,3
11,23,249,24,15,9
11,23,250,14,19,-5
11,23,251,19,5,14
11,23,252,15,7,8
11,23,253,13,7,6
11,23,254,10,12,-2
11,23,255,14,12,2
11,23,256,21,10,11
11,23,257,32,21,11
11,23,258,19,15,4
11,23,259,37,30,7
11,23,260,16,14,2
11,23,261,20,7,13
11,23,262,22,27,-5
11,23,263,19,9,10
11,23,264,17,7,10
11,23,265,14,13,1
11,23,266,17,22,-5
11,23,267,25,13,12
11,23,268,28,21,7
11,23,269,34,11,23
11,23,270,7,4,3
11,23,271,12,8,4
11,23,272,22,13,9
11,23,273,14,10,4
11,23,274,14,3,11
11,23,275,11,14,-3
11,23,276,16,24,-8
11,23,277,14,19,-5
11,23,278,22,16,6
11,23,279,19,3,16
11,23,280,19,2,17
11,23,281,19,5,14
11,23,282,13,13,0
11,23,283,25,10,15
11,23,284,17,6,11
11,23,285,18,12,6
11,23,286,19,13,6
11,23,287,11,18,-7
11,23,288,12,8,4
11,23,289,19,10,9
11,23,290,12,10,2
11,23,291,24,16,8
11,23,292,11,18,-7
11,23,293,22,8,14
11,23,294,10,10,0
11,23,295,22,24,-2
11,23,296,18,12,6
11,23,297,26,9,17
11,23,298,18,6,12
11,23,299,16,12,4
11,24,0,19,18,1
11,24,1,16,16,0
11,24,2,24,19,5
11,24,3,17,9,8
11,24,4,27,12,15
11,24,5,20,11,9
11,24,6,28,15,13
11,24,7,29,10,19
11,24,8,23,8,15
11,24,9,10,6,4
11,24,10,14,17,-3
11,24,11,28,24,4
11,24,12,29,14,15
11,24,13,18,11,7
11,24,14,12,9,3
11,24,15,9,16,-7
11,24,16,5,15,-10
11,24,17,7,8,-1
11,24,18,14,17,-3
11,24,19,20,18,2
11,24,20,16,14,2
11,24,21,28,6,22
11,24,22,20,12,8
11,24,23,14,23,-9
11,24,24,8,29,-21
11,24,25,14,14,0
11,24,26,23,12,11
11,24,27,12,10,2
11,24,28,17,3,14
11,24,29,27,20,7
11,24,30,19,9,10
11,24,31,16,7,9
11,24,32,18,9,9
11,24,33,14,10,4
11,24,34,10,8,2
11,24,35,17,23,-6
11,24,36,19,17,2
11,24,37,32,10,22
11,24,38,24,13,11
11,24,39,29,13,16
11,24,40,19,6,13
11,24,41,21,11,10
11,24,42,16,18,-2
11,24,43,26,14,12
11,24,44,18,16,2
11,24,45,20,12,8
11,24,46,14,23,-9
11,24,47,22,11,11
11,24,48,11,5,6
11,24,49,18,8,10
11,24,50,20,22,-2
11,24,51,16,9,7
11,24,52,9,9,0
11,24,53,25,22,3
11,24,54,15,15,0
11,24,55,10,14,-4
11,24,56,33,26,7
11,24,57,8,5,3
11,24,58,16,4,12
11,24,59,10,3,7
11,24,60,19,19,0
11,24,61,28,13,15
11,24,62,15,15,0
11,24,63,19,3,16
11,24,64,19,8,11
11,24,65,6,11,-5
11,24,66,21,8,13
11,24,67,13,12,1
11,24,68,18,5,13
11,24,69,22,12,10
11,24,70,11,6,5
11,24,71,17,13,4
11,24,72,13,10,3
11,24,73,7,7,0
11,24,74,15,14,1
11,24,75,22,13,9
11,24,76,6,8,-2
11,24,77,14,9,5
11,24,78,33,25,8
11,24,79,16,5,11
11,24,80,19,23,-4
11,24,81,13,7,6
11,24,82,31,25,6
11,24,83,30,8,22
11,24,84,20,26,-6
11,24,85,13,14,-1
11,24,86,3,7,-4
11,24,87,21,14,7
11,24,88,20,10,10
11,24,89,34,23,11
11,24,90,13,11,2
11,24,91,21,9,12
11,24,92,36,13,23
11,24,93,9,8,1
11,24,94,28,10,18
11,24,95,23,6,17
11,24,96,10,15,-5
11,24,97,15,16,-1
11,24,98,14,34,-20
11,24,99,13,8,5
11,24,100,17,15,2
11,24,101,22,16,6
11,24,102,20,18,2
11,24,103,19,17,2
11,24,104,21,18,3
11,24,105,17,11,6
11,24,106,15,13,2
11,24,107,16,18,-2
11,24,108,20,5,15
11,24,109,9,9,0
11,24,110,12,13,-1
11,24,111,21,15,6
11,24,112,11,10,1
11,24,113,28,9,19
11,24,114,26,13,13
11,24,115,9,16,-7
11,24,116,22,13,9
11,24,117,11,6,5
11,24,118,15,13,2
11,24,119,21,11,10
11,24,120,30,9,21
11,24,121,20,8,12
11,24,122,30,12,18
11,24,123,23,10,13
11,24,124,22,15,7
11,24,125,21,6,15
11,24,126,25,11,14
11,24,127,24,19,5
11,24,128,18,14,4
11,24,129,20,20,0
11,24,130,17,12,5
11,24,131,11,17,-6
11,24,132,25,11,14
11,24,133,21,8,13
11,24,134,12,13,-1
11,24,135,19,23,-4
11,24,136,6,19,-13
11,24,137,18,18,0
11,24,138,21,10,11
11,24,139,23,12,11
11,24,140,25,11,14
11,24,141,9,10,-1
11,24,142,11,9,2
11,24,143,14,15,-1
11,24,144,18,11,7
11,24,145,9,5,4
11,24,146,19,6,13
11,24,147,18,22,-4
11,24,148,23,17,6
11,24,149,23,5,18
11,24,150,36,25,11
11,24,151,5,12,-7
11,24,152,19,6,13
11,24,153,27,19,8
11,24,154,19,21,-2
11,24,155,25,28,-3
11,24,156,19,12,7
11,24,157,24,9,15
11,24,158,13,8,5
11,24,159,21,19,2
11,24,160,17,5,12
11,24,161,10,8,2
11,24,162,12,13,-1
11,24,163,18,18,0
11,24,164,15,14,1
11,24,165,18,11,7
11,24,166,24,14,10
11,24,167,19,9,10
11,24,168,13,9,4
11,24,169,23,21,2
11,24,170,22,8,14
11,24,171,6,13,-7
11,24,172,34,2,32
11,24,173,14,14,0
11,24,174,27,14,13
11,24,175,21,20,1
11,24,176,21,11,10
11,24,177,6,4,2
11,24,178,4,7,-3
11,24,179,20,12,8
11,24,180,15,16,-1
11,24,181,20,11,9
11,24,182,8,9,-1
11,24,183,23,7,16
11,24,184,20,17,3
11,24,185,19,9,10
11,24,186,23,17,6
11,24,187,5,13,-8
11,24,188,19,10,9
11,24,189,13,10,3
11,24,190,20,16,4
11,24,191,16,12,4
11,24,192,21,7,14
11,24,193,16,7,9
11,24,194,16,12,4
11,24,195,18,18,0
11,24,196,22,11,11
11,24,197,14,11,3
11,24,198,17,8,9
11,24,199,17,8,9
11,24,200,22,17,5
11,24,201,23,8,15
11,24,202,21,8,13
11,24,203,14,13,1
11,24,204,19,16,3
11,24,205,6,5,1
11,24,206,22,19,3
11,24,207,13,7,6
11,24,208,28,9,19
11,24,209,8,6,2
11,24,210,11,16,-5
11,24,211,11,14,-3
11,24,212,18,9,9
11,24,213,15,14,1
11,24,214,15,13,2
11,24,215,15,4,11
11,24,216,10,11,-1
11,24,217,23,7,16
11,24,218,15,12,3
11,24,219,30,21,9
11,24,220,12,11,1
11,24,221,12,2,10
11,24,222,24,9,15
11,24,223,14,9,5
11,24,224,27,9,18
11,24,225,20,16,4
11,24,226,19,18,1
11,24,227,22,5,17
11,24,228,9,9,0
11,24,229,12,9,3
11,24,230,25,16,9
11,24,231,17,14,3
11,24,232,20,6,14
11,24,233,9,12,-3
11,24,234,12,11,1
11,24,235,16,3,13
11,24,236,20,8,12
11,24,237,23,16,7
11,24,238,16,25,-9
11,24,239,15,8,7
11,24,240,26,9,17
11,24,241,23,10,13
11,24,242,16,12,4
11,24,243,14,9,5
11,24,244,14,20,-6
11,24,245,15,11,4
11,24,246,22,16,6
11,24,247,15,3,12
11,24,248,20,10,10
11,24,249,14,4,10
11,24,250,26,11,15
11,24,251,18,10,8
11,24,252,22,15,7
11,24,253,21,10,11
11,24,254,22,11,11
11,24,255,16,12,4
11,24,256,25,17,8
11,24,257,39,16,23
11,24,258,21,7,14
11,24,259,10,10,0
11,24,260,21,15,6
11,24,261,20,15,5
11,24,262,14,13,1
11,24,263,19,24,-5
11,24,264,17,7,10
11,24,265,17,10,7
11,24,266,19,9,10
11,24,267,18,16,2
11,24,268,13,18,-5
11,24,269,17,6,11
11,24,270,16,12,4
11,24,271,19,11,8
11,24,272,25,11,14
11,24,273,18,17,1
11,24,274,21,8,13
11,24,275,21,7,14
11,24,276,13,9,4
11,24,277,20,10,10
11,24,278,10,7,3
11,24,279,16,5,11
11,24,280,28,13,15
11,24,281,14,11,3
11,24,282,9,11,-2
11,24,283,13,6,7
11,24,284,21,16,5
11,24,285,16,5,11
11,24,286,16,10,6
11,24,287,14,16,-2
11,24,288,12,25,-13
11,24,289,21,14,7
11,24,290,7,13,-6
11,24,291,21,7,14
11,24,292,16,7,9
11,24,293,19,17,2
11,24,294,9,8,1
11,24,295,21,20,1
11,24,296,23,13,10
11,24,297,17,15,2
11,24,298,14,13,1
11,24,299,17,20,-3
11,25,0,14,13,1
11,25,1,31,10,21
11,25,2,13,13,0
11,25,3,18,18,0
11,25,4,24,19,5
11,25,5,11,11,0
11,25,6,17,5,12
11,25,7,33,13,20
11,25,8,23,10,13
11,25,9,5,4,1
11,25,10,15,12,3
11,25,11,19,11,8
11,25,12,13,15,-2
11,25,13,11,9,2
11,25,14,16,2,14
11,25,15,11,14,-3
11,25,16,11,3,8
11,25,17,10,13,-3
11,25,18,21,12,9
11,25,19,18,6,12
11,25,20,13,12,1
11,25,21,17,9,8
11,25,22,15,8,7
11,25,23,10,10,0
11,25,24,19,14,5
11,25,25,23,11,12
11,25,26,12,6,6
11,25,27,20,19,1
11,25,28,23,6,17
11,25,29,8,3,5
11,25,30,22,5,17
11,25,31,20,12,8
11,25,32,21,9,12
11,25,33,38,17,21
11,25,34,16,16,0
11,25,35,22,11,11
11,25,36,19,9,10
11,25,37,10,18,-8
11,25,38,27,9,18
11,25,39,15,10,5
11,25,40,6,15,-9
11,25,41,23,11,12
11,25,42,10,9,1
11,25,43,15,2,13
11,25,44,16,9,7
11,25,45,29,19,10
11,25,46,17,12,5
11,25,47,13,5,8
11,25,48,14,7,7
11,25,49,15,22,-7
11,25,50,17,7,10
11,25,51,17,14,3
11,25,52,9,13,-4
11,25,53,18,17,1
11,25,54,24,9,15
11,25,55,15,9,6
11,25,56,9,15,-6
11,25,57,24,8,16
11,25,58,21,18,3
11,25,59,23,12,11
11,25,60,15,14,1
11,25,61,11,7,4
11,25,62,21,14,7
11,25,63,9,16,-7
11,25,64,13,20,-7
11,25,65,22,6,16
11,25,66,17,13,4
11,25,67,25,2,23
11,25,68,28,15,13
11,25,69,18,14,4
11,25,70,27,6,21
11,25,71,25,19,6
11,25,72,15,11,4
11,25,73,15,7,8
11,25,74,19,13,6
11,25,75,19,23,-4
11,25,76,25,11,14
11,25,77,18,12,6
11,25,78,12,20,-8
11,25,79,21,6,15
11,25,80,19,8,11
11,25,81,32,13,19
11,25,82,17,14,3
11,25,83,22,18,4
11,25,84,34,19,15
11,25,85,10,15,-5
11,25,86,16,7,9
11,25,87,19,13,6
11,25,88,25,12,13
11,25,89,22,18,4
11,25,90,12,5,7
11,25,91,10,4,6
11,25,92,15,8,7
11,25,93,8,8,0
11,25,94,11,10,1
11,25,95,18,14,4
11,25,96,27,22,5
11,25,97,16,21,-5
11,25,98,11,3,8
11,25,99,18,9,9
11,25,100,36,16,20
11,25,101,25,8,17
11,25,102,17,7,10
11,25,103,18,9,9
11,25,104,29,13,16
11,25,105,21,14,7
11,25,106,25,20,5
11,25,107,9,12,-3
11,25,108,19,17,2
11,25,109,35,13,22
11,25,110,23,25,-2
11,25,111,6,5,1
11,25,112,21,5,16
11,25,113,17,13,4
11,25,114,24,16,8
11,25,115,27,9,18
11,25,116,19,9,10
11,25,117,24,18,6
11,25,118,23,18,5
11,25,119,28,12,16
11,25,120,14,9,5
11,25,121,32,6,26
11,25,122,28,14,14
11,25,123,11,12,-1
11,25,124,18,7,11
11,25,125,19,18,1
11,25,126,21,14,7
11,25,127,26,8,18
11,25,128,15,7,8
11,25,129,11,12,-1
11,25,130,29,10,19
11,25,131,21,16,5
11,25,132,22,12,10
11,25,133,22,19,3
11,25,134,10,15,-5
11,25,135,13,9,4
11,25,136,34,15,19
11,25,137,28,13,15
11,25,138,16,10,6
11,25,139,26,12,14
11,25,140,21,12,9
11,25,141,30,15,15
11,25,142,16,5,11
11,25,143,20,10,10
11,25,144,31,15,16
11,25,145,25,13,12
11,25,146,23,16,7
11,25,147,9,10,-1
11,25,148,20,13,7
11,25,149,20,21,-1
11,25,150,11,14,-3
11,25,151,24,10,14
11,25,152,13,12,1
11,25,153,23,16,7
11,25,154,13,11,2
11,25,155,13,15,-2
11,25,156,12,9,3
11,25,157,24,8,16
11,25,158,12,5,7
11,25,159,13,11,2
11,25,160,32,9,23
11,25,161,7,8,-1
11,25,162,14,8,6
11,25,163,24,11,13
11,25,164,18,12,6
11,25,165,11,7,4
11,25,166,21,14,7
11,25,167,28,22,6
11,25,168,15,7,8
11,25,169,35,16,19
11,25,170,16,17,-1
11,25,171,23,19,4
11,25,172,30,17,13
11,25,173,19,22,-3
11,25,174,22,23,-1
11,25,175,33,14,19
11,25,176,29,17,12
11,25,177,25,5,20
11,25,178,10,7,3
11,25,179,16,8,8
11,25,180,20,12,8
11,25,181,10,11,-1
11,25,182,16,10,6
11,25,183,14,18,-4
11,25,184,11,9,2
11,25,185,18,19,-1
11,25,186,13,10,3
11,25,187,16,8,8
11,25,188,25,14,11
11,25,189,14,6,8
11,25,190,31,19,12
11,25,191,30,16,14
11,25,192,27,12,15
11,25,193,16,6,10
11,25,194,13,10,3
11,25,195,24,25,-1
11,25,196,6,11,-5
11,25,197,17,18,-1
11,25,198,21,14,7
11,25,199,13,12,1
11,25,200,24,8,16
11,25,201,19,13,6
11,25,202,10,13,-3
11,25,203,7,18,-11
11,25,204,19,7,12
11,25,205,13,15,-2
11,25,206,14,12,2
11,25,207,13,14,-1
11,25,208,17,9,8
11,25,209,14,10,4
11,25,210,8,15,-7
11,25,211,5,12,-7
11,25,212,19,10,9
11,25,213,21,18,3
11,25,214,19,11,8
11,25,215,24,13,11
11,25,216,27,15,12
11,25,217,31,26,5
11,25,218,15,9,6
11,25,219,20,22,-2
11,25,220,19,15,4
11,25,221,21,11,10
11,25,222,17,14,3
11,25,223,14,27,-13
11,25,224,15,17,-2
11,25,225,26,7,19
11,25,226,13,14,-1
11,25,227,14,13,1
11,25,228,18,19,-1
11,25,229,21,11,10
11,25,230,21,12,9
11,25,231,19,7,12
11,25,232,34,18,16
11,25,233,23,15,8
11,25,234,26,17,9
11,25,235,11,4,7
11,25,236,22,9,13
11,25,237,18,6,12
11,25,238,21,9,12
11,25,239,27,16,11
11,25,240,13,11,2
11,25,241,13,17,-4
11,25,242,16,8,8
11,25,243,11,10,1
11,25,244,11,14,-3
11,25,245,10,11,-1
11,25,246,19,16,3
11,25,247,20,13,7
11,25,248,25,11,14
11,25,249,13,12,1
11,25,250,21,8,13
11,25,251,14,13,1
11,25,252,24,9,15
11,25,253,14,7,7
11,25,254,15,7,8
11,25,255,15,4,11
11,25,256,3,2,1
11,25,257,16,10,6
11,25,258,13,11,2
11,25,259,18,12,6
11,25,260,12,8,4
11,25,261,24,11,13
11,25,262,23,15,8
11,25,263,43,13,30
11,25,264,20,20,0
11,25,265,13,12,1
11,25,266,16,27,-11
11,25,267,18,6,12
11,25,268,19,19,0
11,25,269,12,8,4
11,25,270,17,10,7
11,25,271,21,11,10
11,25,272,19,20,-1
11,25,273,7,21,-14
11,25,274,14,15,-1
11,25,275,20,17,3
11,25,276,16,5,11
11,25,277,7,11,-4
11,25,278,13,23,-10
11,25,279,21,17,4
11,25,280,9,12,-3
11,25,281,24,4,20
11,25,282,16,9,7
11,25,283,18,24,-6
11,25,284,21,9,12
11,25,285,20,18,2
11,25,286,9,10,-1
11,25,287,7,10,-3
11,25,288,10,19,-9
11,25,289,20,17,3
11,25,290,12,11,1
11,25,291,20,22,-2
11,25,292,23,9,14
11,25,293,24,17,7
11,25,294,27,15,12
11,25,295,11,13,-2
11,25,296,12,9,3
11,25,297,9,12,-3
11,25,298,9,12,-3
11,25,299,10,11,-1
11,26,0,12,12,0
11,26,1,20,16,4
11,26,2,12,11,1
11,26,3,16,9,7
11,26,4,21,15,6
11,26,5,25,18,7
11,26,6,17,8,9
11,26,7,23,6,17
11,26,8,19,14,5
11,26,9,21,17,4
11,26,10,6,14,-8
11,26,11,23,18,5
11,26,12,14,4,10
11,26,13,13,8,5
11,26,14,15,15,0
11,26,15,19,11,8
11,26,16,15,12,3
11,26,17,21,21,0
11,26,18,17,10,7
11,26,19,11,13,-2
11,26,20,17,36,-19
11,26,21,14,12,2
11,26,22,16,17,-1
11,26,23,32,10,22
11,26,24,25,9,16
11,26,25,20,17,3
11,26,26,19,11,8
11,26,27,22,8,14
11,26,28,10,6,4
11,26,29,27,18,9
11,26,30,22,12,10
11,26,31,15,16,-1
11,26,32,25,7,18
11,26,33,10,8,2
11,26,34,15,12,3
11,26,35,17,3,14
11,26,36,17,10,7
11,26,37,26,17,9
11,26,38,8,8,0
11,26,39,13,6,7
11,26,40,16,12,4
11,26,41,14,8,6
11,26,42,20,12,8
11,26,43,30,16,14
11,26,44,14,10,4
11,26,45,16,16,0
11,26,46,16,9,7
11,26,47,14,13,1
11,26,48,24,11,13
11,26,49,20,17,3
11,26,50,22,10,12
11,26,51,23,11,12
11,26,52,24,8,16
11,26,53,14,5,9
11,26,54,19,9,10
11,26,55,14,10,4
11,26,56,22,18,4
11,26,57,19,18,1
11,26,58,28,17,11
11,26,59,13,11,2
11,26,60,15,7,8
11,26,61,26,16,10
11,26,62,16,14,2
11,26,63,15,16,-1
11,26,64,23,3,20
11,26,65,24,9,15
11,26,66,17,12,5
11,26,67,18,17,1
11,26,68,28,12,16
11,26,69,20,4,16
11,26,70,9,10,-1
11,26,71,18,21,-3
11,26,72,25,12,13
11,26,73,15,13,2
11,26,74,16,13,3
11,26,75,10,14,-4
11,26,76,11,20,-9
11,26,77,17,5,12
11,26,78,5,8,-3
11,26,79,17,15,2
11,26,80,21,19,2
11,26,81,17,10,7
11,26,82,15,8,7
11,26,83,24,13,11
11,26,84,8,7,1
11,26,85,11,13,-2
11,26,86,12,5,7
11,26,87,17,3,14
11,26,88,16,18,-2
11,26,89,11,17,-6
11,26,90,23,13,10
11,26,91,15,11,4
11,26,92,13,15,-2
11,26,93,20,10,10
11,26,94,26,16,10
11,26,95,9,11,-2
11,26,96,15,20,-5
11,26,97,17,16,1
11,26,98,13,9,4
11,26,99,16,2,14
11,26,100,23,24,-1
11,26,101,21,26,-5
11,26,102,4,10,-6
11,26,103,19,16,3
11,26,104,13,9,4
11,26,105,35,24,11
11,26,106,22,3,19
11,26,107,21,13,8
11,26,108,12,10,2
11,26,109,14,18,-4
11,26,110,35,19,16
11,26,111,6,14,-8
11,26,112,22,25,-3
11,26,113,17,4,13
11,26,114,26,26,0
11,26,115,16,16,0
11,26,116,15,10,5
11,26,117,11,6,5
11,26,118,4,4,0
11,26,119,18,11,7
11,26,120,28,12,16
11,26,121,16,7,9
11,26,122,17,11,6
11,26,123,5,3,2
11,26,124,15,13,2
11,26,125,21,9,12
11,26,126,14,12,2
11,26,127,21,8,13
11,26,128,12,9,3
11,26,129,15,5,10
11,26,130,24,19,5
11,26,131,31,27,4
11,26,132,10,8,2
11,26,133,12,19,-7
11,26,134,8,7,1
11,26,135,18,4,14
11,26,136,19,12,7
11,26,137,16,7,9
11,26,138,18,22,-4
11,26,139,11,11,0
11,26,140,31,15,16
11,26,141,12,13,-1
11,26,142,20,4,16
11,26,143,12,15,-3
11,26,144,12,13,-1
11,26,145,24,6,18
11,26,146,32,19,13
11,26,147,24,26,-2
11,26,148,13,11,2
11,26,149,19,2,17
11,26,150,32,16,16
11,26,151,22,16,6
11,26,152,26,22,4
11,26,153,17,8,9
11,26,154,19,15,4
11,26,155,13,14,-1
11,26,156,15,13,2
11,26,157,19,5,14
11,26,158,18,8,10
11,26,159,30,10,20
11,26,160,27,17,10
11,26,161,32,21,11
11,26,162,15,3,12
11,26,163,19,17,2
11,26,164,25,13,12
11,26,165,18,8,10
11,26,166,22,10,12
11,26,167,20,10,10
11,26,168,16,12,4
11,26,169,19,5,14
11,26,170,21,12,9
11,26,171,20,10,10
11,26,172,16,5,11
11,26,173,14,3,11
11,26,174,13,2,11
11,26,175,11,7,4
11,26,176,23,15,8
11,26,177,15,15,0
11,26,178,22,15,7
11,26,179,28,23,5
11,26,180,12,11,1
11,26,181,4,8,-4
11,26,182,21,17,4
11,26,183,16,14,2
11,26,184,12,2,10
11,26,185,23,6,17
11,26,186,25,15,10
11,26,187,25,12,13
11,26,188,25,9,16
11,26,189,24,10,14
11,26,190,18,18,0
11,26,191,7,5,2
11,26,192,18,12,6
11,26,193,37,4,33
11,26,194,14,8,6
11,26,195,18,10,8
11,26,196,14,14,0
11,26,197,15,5,10
11,26,198,18,8,10
11,26,199,16,10,6
11,26,200,16,11,5
11,26,201,14,5,9
11,26,202,15,19,-4
11,26,203,21,28,-7
11,26,204,4,19,-15
11,26,205,11,11,0
11,26,206,13,7,6
11,26,207,15,14,1
11,26,208,16,8,8
11,26,209,24,9,15
11,26,210,26,15,11
11,26,211,29,28,1
11,26,212,22,13,9
11,26,213,18,10,8
11,26,214,29,17,12
11,26,215,23,8,15
11,26,216,19,18,1
11,26,217,17,9,8
11,26,218,24,10,14
11,26,219,15,9,6
11,26,220,27,8,19
11,26,221,20,18,2
11,26,222,19,8,11
11,26,223,25,19,6
11,26,224,18,7,11
11,26,225,20,10,10
11,26,226,15,11,4
11,26,227,13,12,1
11,26,228,13,12,1
11,26,229,18,8,10
11,26,230,15,7,8
11,26,231,14,15,-1
11,26,232,20,13,7
11,26,233,28,11,17
11,26,234,19,12,7
11,26,235,11,9,2
11,26,236,16,20,-4
11,26,237,32,18,14
11,26,238,21,12,9
11,26,239,8,4,4
11,26,240,10,3,7
11,26,241,14,8,6
11,26,242,15,6,9
11,26,243,12,15,-3
11,26,244,23,13,10
11,26,245,12,9,3
11,26,246,24,9,15
11,26,247,14,2,12
11,26,248,11,14,-3
11,26,249,22,16,6
11,26,250,23,5,18
11,26,251,14,3,11
11,26,252,7,8,-1
11,26,253,18,7,11
11,26,254,31,14,17
11,26,255,25,14,11
11,26,256,18,16,2
11,26,257,11,4,7
11,26,258,23,14,9
11,26,259,10,9,1
11,26,260,20,14,6
11,26,261,13,15,-2
11,26,262,21,21,0
11,26,263,15,7,8
11,26,264,12,4,8
11,26,265,18,7,11
11,26,266,40,12,28
11,26,267,16,10,6
11,26,268,16,10,6
11,26,269,29,10,19
11,26,270,23,8,15
11,26,271,23,9,14
11,26,272,30,13,17
11,26,273,22,6,16
11,26,274,28,10,18
11,26,275,9,9,0
11,26,276,20,21,-1
11,26,277,14,22,-8
11,26,278,22,18,4
11,26,279,15,23,-8
11,26,280,12,9,3
11,26,281,12,6,6
11,26,282,18,17,1
11,26,283,21,20,1
11,26,284,28,5,23
11,26,285,20,12,8
11,26,286,18,6,12
11,26,287,22,14,8
11,26,288,14,19,-5
11,26,289,29,9,20
11,26,290,19,16,3
11,26,291,19,17,2
11,26,292,13,14,-1
11,26,293,35,23,12
11,26,294,21,20,1
11,26,295,23,13,10
11,26,296,30,7,23
11,26,297,13,7,6
11,26,298,11,12,-1
11,26,299,23,15,8
11,27,0,15,13,2
11,27,1,12,12,0
11,27,2,23,8,15
11,27,3,13,11,2
11,27,4,8,9,-1
11,27,5,20,14,6
11,27,6,28,17,11
11,27,7,19,17,2
11,27,8,11,3,8
11,27,9,10,12,-2
11,27,10,12,3,9
11,27,11,25,7,18
11,27,12,15,8,7
11,27,13,19,18,1
11,27,14,15,6,9
11,27,15,20,8,12
11,27,16,23,4,19
11,27,17,6,13,-7
11,27,18,16,15,1
11,27,19,21,12,9
11,27,20,12,8,4
11,27,21,14,14,0
11,27,22,15,12,3
11,27,23,2,7,-5
11,27,24,27,8,19
11,27,25,20,8,12
11,27,26,27,27,0
11,27,27,19,14,5
11,27,28,13,6,7
11,27,29,32,8,24
11,27,30,29,19,10
11,27,31,8,6,2
11,27,32,22,9,13
11,27,33,20,15,5
11,27,34,5,6,-1
11,27,35,38,14,24
11,27,36,15,8,7
11,27,37,13,8,5
11,27,38,16,14,2
11,27,39,10,5,5
11,27,40,20,10,10
11,27,41,26,18,8
11,27,42,20,23,-3
11,27,43,15,12,3
11,27,44,11,11,0
11,27,45,22,16,6
11,27,46,27,10,17
11,27,47,21,6,15
11,27,48,24,14,10
11,27,49,6,9,-3
11,27,50,10,2,8
11,27,51,16,16,0
11,27,52,25,12,13
11,27,53,27,12,15
11,27,54,4,10,-6
11,27,55,17,4,13
11,27,56,18,18,0
11,27,57,16,8,8
11,27,58,19,8,11
11,27,59,12,10,2
11,27,60,7,10,-3
11,27,61,15,5,10
11,27,62,15,18,-3
11,27,63,28,17,11
11,27,64,18,5,13
11,27,65,21,12,9
11,27,66,21,16,5
11,27,67,15,8,7
11,27,68,17,9,8
11,27,69,33,17,16
11,27,70,22,25,-3
11,27,71,29,11,18
11,27,72,9,22,-13
11,27,73,7,9,-2
11,27,74,4,12,-8
11,27,75,15,16,-1
11,27,76,17,18,-1
11,27,77,18,16,2
11,27,78,27,17,10
11,27,79,16,12,4
11,27,80,28,17,11
11,27,81,32,6,26
11,27,82,18,1,17
11,27,83,19,13,6
11,27,84,14,3,11
11,27,85,22,11,11
11,27,86,11,16,-5
11,27,87,11,15,-4
11,27,88,5,3,2
11,27,89,17,12,5
11,27,90,3,11,-8
11,27,91,17,14,3
11,27,92,12,6,6
11,27,93,22,9,13
11,27,94,8,17,-9
11,27,95,14,13,1
11,27,96,27,14,13
11,27,97,15,10,5
11,27,98,19,7,12
11,27,99,15,16,-1
11,27,100,21,10,11
11,27,101,23,10,13
11,27,102,9,16,-7
11,27,103,20,12,8
11,27,104,22,11,11
11,27,105,13,9,4
11,27,106,19,15,4
11,27,107,11,16,-5
11,27,108,10,11,-1
11,27,109,22,9,13
11,27,110,27,11,16
11,27,111,18,8,10
11,27,112,27,20,7
11,27,113,16,19,-3
11,27,114,27,17,10
11,27,115,15,12,3
11,27,116,26,17,9
11,27,117,18,18,0
11,27,118,5,12,-7
11,27,119,22,15,7
11,27,120,12,14,-2
11,27,121,13,12,1
11,27,122,12,7,5
11,27,123,7,6,1
11,27,124,20,15,5
11,27,125,15,14,1
11,27,126,18,10,8
11,27,127,20,18,2
11,27,128,16,19,-3
11,27,129,16,19,-3
11,27,130,8,17,-9
11,27,131,18,14,4
11,27,132,17,6,11
11,27,133,22,14,8
11,27,134,20,15,5
11,27,135,20,11,9
11,27,136,31,20,11
11,27,137,15,9,6
11,27,138,14,10,4
11,27,139,36,4,32
11,27,140,23,13,10
11,27,141,8,8,0
11,27,142,15,3,12
11,27,143,26,9,17
11,27,144,12,9,3
11,27,145,20,27,-7
11,27,146,21,8,13
11,27,147,16,5,11
11,27,148,24,11,13
11,27,149,6,14,-8
11,27,150,31,23,8
11,27,151,17,16,1
11,27,152,21,8,13
11,27,153,24,20,4
11,27,154,14,5,9
11,27,155,20,13,7
11,27,156,17,9,8
11,27,157,13,12,1
11,27,158,19,14,5
11,27,159,17,5,12
11,27,160,27,10,17
11,27,161,14,13,1
11,27,162,18,19,-1
11,27,163,14,9,5
11,27,164,13,16,-3
11,27,165,20,9,11
11,27,166,10,11,-1
11,27,167,21,14,7
11,27,168,18,14,4
11,27,169,19,16,3
11,27,170,20,11,9
11,27,171,32,12,20
11,27,172,11,16,-5
11,27,173,15,7,8
11,27,174,11,6,5
11,27,175,25,8,17
11,27,176,29,26,3
11,27,177,20,16,4
11,27,178,8,6,2
11,27,179,11,7,4
11,27,180,25,16,9
11,27,181,24,18,6
11,27,182,13,10,3
11,27,183,8,17,-9
11,27,184,16,8,8
11,27,185,22,9,13
11,27,186,11,5,6
11,27,187,23,3,20
11,27,188,31,6,25
11,27,189,16,11,5
11,27,190,12,12,0
11,27,191,26,16,10
11,27,192,18,5,13
11,27,193,25,15,10
11,27,194,27,3,24
11,27,195,22,14,8
11,27,196,15,16,-1
11,27,197,17,10,7
11,27,198,11,16,-5
11,27,199,15,1,14
11,27,200,13,18,-5
11,27,201,12,11,1
11,27,202,24,9,15
11,27,203,8,16,-8
11,27,204,31,13,18
11,27,205,10,12,-2
11,27,206,15,12,3
11,27,207,14,14,0
11,27,208,17,11,6
11,27,209,6,7,-1
11,27,210,14,12,2
11,27,211,23,12,11
11,27,212,13,10,3
11,27,213,12,14,-2
11,27,214,21,12,9
11,27,215,6,6,0
11,27,216,9,15,-6
11,27,217,14,11,3
11,27,218,24,12,12
11,27,219,19,7,12
11,27,220,12,12,0
11,27,221,28,13,15
11,27,222,16,6,10
11,27,223,28,6,22
11,27,224,7,11,-4
11,27,225,19,10,9
11,27,226,19,14,5
11,27,227,6,11,-5
11,27,228,16,2,14
11,27,229,18,13,5
11,27,230,27,11,16
11,27,231,23,13,10
11,27,232,18,7,11
11,27,233,18,15,3
11,27,234,24,15,9
11,27,235,10,8,2
11,27,236,22,8,14
11,27,237,21,14,7
11,27,238,14,8,6
11,27,239,21,12,9
11,27,240,20,6,14
11,27,241,27,11,16
11,27,242,8,13,-5
11,27,243,23,11,12
11,27,244,21,11,10
11,27,245,40,8,32
11,27,246,32,4,28
11,27,247,22,12,10
11,27,248,13,10,3
11,27,249,17,12,5
11,27,250,14,9,5
11,27,251,16,7,9
11,27,252,16,13,3
11,27,253,23,15,8
11,27,254,14,13,1
11,27,255,33,15,18
11,27,256,19,16,3
11,27,257,22,9,13
11,27,258,12,17,-5
11,27,259,14,17,-3
11,27,260,4,12,-8
11,27,261,21,23,-2
11,27,262,17,7,10
11,27,263,20,9,11
11,27,264,13,20,-7
11,27,265,21,6,15
11,27,266,24,15,9
11,27,267,13,6,7
11,27,268,29,21,8
11,27,269,27,8,19
11,27,270,18,16,2
11,27,271,35,9,26
11,27,272,18,10,8
11,27,273,19,21,-2
11,27,274,21,9,12
11,27,275,29,11,18
11,27,276,18,23,-5
11,27,277,16,18,-2
11,27,278,25,13,12
11,27,279,16,13,3
11,27,280,11,13,-2
11,27,281,10,8,2
11,27,282,5,8,-3
11,27,283,24,11,13
11,27,284,18,10,8
11,27,285,11,8,3
11,27,286,17,8,9
11,27,287,30,22,8
11,27,288,25,15,10
11,27,289,21,14,7
11,27,290,23,15,8
11,27,291,22,10,12
11,27,292,15,13,2
11,27,293,22,10,12
11,27,294,19,6,13
11,27,295,12,4,8
11,27,296,14,7,7
11,27,297,9,5,4
11,27,298,36,17,19
11,27,299,20,13,7
11,28,0,20,9,11
11,28,1,27,12,15
11,28,2,19,9,10
11,28,3,20,7,13
11,28,4,23,9,14
11,28,5,11,4,7
11,28,6,28,12,16
11,28,7,17,4,13
11,28,8,26,13,13
11,28,9,21,10,11
11,28,10,22,8,14
11,28,11,16,12,4
11,28,12,16,9,7
11,28,13,18,15,3
11,28,14,22,8,14
11,28,15,38,19,19
11,28,16,18,18,0
11,28,17,17,12,5
11,28,18,19,13,6
11,28,19,15,8,7
11,28,20,22,8,14
11,28,21,20,9,11
11,28,22,17,14,3
11,28,23,13,10,3
11,28,24,17,14,3
11,28,25,21,10,11
11,28,26,20,7,13
11,28,27,21,4,17
11,28,28,22,23,-1
11,28,29,23,15,8
11,28,30,19,11,8
11,28,31,27,8,19
11,28,32,9,6,3
11,28,33,14,15,-1
11,28,34,18,17,1
11,28,35,24,12,12
11,28,36,20,22,-2
11,28,37,17,13,4
11,28,38,15,20,-5
11,28,39,18,13,5
11,28,40,22,19,3
11,28,41,7,8,-1
11,28,42,12,10,2
11,28,43,20,14,6
11,28,44,20,11,9
11,28,45,21,5,16
11,28,46,19,19,0
11,28,47,20,9,11
11,28,48,9,13,-4
11,28,49,11,13,-2
11,28,50,4,8,-4
11,28,51,36,16,20
11,28,52,12,5,7
11,28,53,11,18,-7
11,28,54,20,9,11
11,28,55,15,20,-5
11,28,56,16,11,5
11,28,57,12,13,-1
11,28,58,33,13,20
11,28,59,10,9,1
11,28,60,27,17,10
11,28,61,26,12,14
11,28,62,21,10,11
11,28,63,12,17,-5
11,28,64,9,12,-3
11,28,65,13,5,8
11,28,66,28,10,18
11,28,67,12,9,3
11,28,68,23,11,12
11,28,69,15,6,9
11,28,70,17,13,4
11,28,71,12,4,8
11,28,72,11,5,6
11,28,73,24,12,12
11,28,74,19,10,9
11,28,75,28,24,4
11,28,76,30,18,12
11,28,77,12,4,8
11,28,78,18,15,3
11,28,79,16,12,4
11,28,80,16,9,7
11,28,81,19,10,9
11,28,82,13,8,5
11,28,83,8,8,0
11,28,84,18,27,-9
11,28,85,34,12,22
11,28,86,17,14,3
11,28,87,15,10,5
11,28,88,18,19,-1
11,28,89,20,10,10
11,28,90,21,5,16
11,28,91,16,15,1
11,28,92,19,24,-5
11,28,93,19,9,10
11,28,94,16,7,9
11,28,95,15,18,-3
11,28,96,16,9,7
11,28,97,20,10,10
11,28,98,24,15,9
11,28,99,21,6,15
11,28,100,18,11,7
11,28,101,15,8,7
11,28,102,15,20,-5
11,28,103,15,12,3
11,28,104,9,1,8
11,28,105,22,7,15
11,28,106,22,10,12
11,28,107,10,15,-5
11,28,108,15,13,2
11,28,109,8,11,-3
11,28,110,20,14,6
11,28,111,10,7,3
11,28,112,9,21,-12
11,28,113,11,9,2
11,28,114,22,8,14
11,28,115,20,8,12
11,28,116,27,4,23
11,28,117,22,15,7
11,28,118,26,5,21
11,28,119,19,4,15
11,28,120,25,16,9
11,28,121,22,9,13
11,28,122,7,7,0
11,28,123,13,5,8
11,28,124,11,14,-3
11,28,125,32,10,22
11,28,126,20,10,10
11,28,127,16,17,-1
11,28,128,33,15,18
11,28,129,12,3,9
11,28,130,23,11,12
11,28,131,20,15,5
11,28,132,18,6,12
11,28,133,17,10,7
11,28,134,26,22,4
11,28,135,24,24,0
11,28,136,10,14,-4
11,28,137,30,12,18
11,28,138,8,13,-5
11,28,139,13,8,5
11,28,140,18,14,4
11,28,141,19,5,14
11,28,142,18,12,6
11,28,143,24,19,5
11,28,144,20,6,14
11,28,145,19,7,12
11,28,146,13,15,-2
11,28,147,8,11,-3
11,28,148,20,13,7
11,28,149,19,8,11
11,28,150,26,10,16
11,28,151,14,6,8
11,28,152,17,5,12
11,28,153,23,9,14
11,28,154,17,11,6
11,28,155,20,8,12
11,28,156,23,13,10
11,28,157,25,15,10
11,28,158,26,10,16
11,28,159,30,21,9
11,28,160,15,16,-1
11,28,161,23,17,6
11,28,162,19,9,10
11,28,163,26,16,10
11,28,164,9,15,-6
11,28,165,19,8,11
11,28,166,17,7,10
11,28,167,20,12,8
11,28,168,20,11,9
11,28,169,29,13,16
11,28,170,25,15,10
11,28,171,9,17,-8
11,28,172,12,14,-2
11,28,173,14,11,3
11,28,174,12,9,3
11,28,175,19,14,5
11,28,176,22,19,3
11,28,177,27,5,22
11,28,178,32,17,15
11,28,179,27,11,16
11,28,180,20,17,3
11,28,181,9,13,-4
11,28,182,18,15,3
11,28,183,22,8,14
11,28,184,24,10,14
11,28,185,22,10,12
11,28,186,27,19,8
11,28,187,8,13,-5
11,28,188,21,8,13
11,28,189,16,11,5
11,28,190,8,16,-8
11,28,191,9,9,0
11,28,192,23,16,7
11,28,193,25,17,8
11,28,194,17,22,-5
11,28,195,14,14,0
11,28,196,22,3,19
11,28,197,9,8,1
11,28,198,14,10,4
11,28,199,24,12,12
11,28,200,18,15,3
11,28,201,10,9,1
11,28,202,18,8,10
11,28,203,15,10,5
11,28,204,12,8,4
11,28,205,11,13,-2
11,28,206,15,12,3
11,28,207,21,19,2
11,28,208,20,9,11
11,28,209,8,5,3
11,28,210,17,5,12
11,28,211,17,14,3
11,28,212,15,10,5
11,28,213,13,8,5
11,28,214,19,14,5
11,28,215,22,11,11
11,28,216,13,14,-1
11,28,217,26,8,18
11,28,218,13,13,0
11,28,219,19,11,8
11,28,220,25,15,10
11,28,221,12,10,2
11,28,222,25,14,11
11,28,223,29,10,19
11,28,224,31,7,24
11,28,225,18,16,2
11,28,226,11,6,5
11,28,227,9,11,-2
11,28,228,20,14,6
11,28,229,19,15,4
11,28,230,17,10,7
11,28,231,19,6,13
11,28,232,18,13,5
11,28,233,15,23,-8
11,28,234,9,5,4
11,28,235,10,3,7
11,28,236,18,9,9
11,28,237,15,6,9
11,28,238,31,10,21
11,28,239,13,12,1
11,28,240,14,6,8
11,28,241,12,17,-5
11,28,242,7,8,-1
11,28,243,21,15,6
11,28,244,37,18,19
11,28,245,27,12,15
11,28,246,13,5,8
11,28,247,13,15,-2
11,28,248,14,7,7
11,28,249,17,17,0
11,28,250,15,9,6
11,28,251,28,13,15
11,28,252,11,19,-8
11,28,253,16,6,10
11,28,254,19,15,4
11,28,255,15,20,-5
11,28,256,12,26,-14
11,28,257,7,15,-8
11,28,258,18,10,8
11,28,259,22,25,-3
11,28,260,26,13,13
11,28,261,16,20,-4
11,28,262,18,9,9
11,28,263,23,18,5
11,28,264,12,3,9
11,28,265,15,7,8
11,28,266,38,14,24
11,28,267,14,13,1
11,28,268,12,6,6
11,28,269,12,10,2
11,28,270,19,10,9
11,28,271,24,14,10
11,28,272,11,15,-4
11,28,273,19,17,2
11,28,274,27,12,15
11,28,275,27,7,20
11,28,276,14,10,4
11,28,277,16,6,10
11,28,278,18,14,4
11,28,279,25,10,15
11,28,280,20,3,17
11,28,281,14,10,4
11,28,282,19,11,8
11,28,283,12,16,-4
11,28,284,7,9,-2
11,28,285,28,11,17
11,28,286,18,14,4
11,28,287,29,9,20
11,28,288,26,11,15
11,28,289,22,15,7
11,28,290,17,9,8
11,28,291,22,13,9
11,28,292,35,15,20
11,28,293,22,11,11
11,28,294,7,14,-7
11,28,295,18,14,4
11,28,296,24,16,8
11,28,297,26,22,4
11,28,298,20,7,13
11,28,299,13,9,4
11,29,0,7,17,-10
11,29,1,38,25,13
11,29,2,17,10,7
11,29,3,15,6,9
11,29,4,27,16,11
11,29,5,15,11,4
11,29,6,13,9,4
11,29,7,14,13,1
11,29,8,17,11,6
11,29,9,12,8,4
11,29,10,31,18,13
11,29,11,11,11,0
11,29,12,13,2,11
11,29,13,3,8,-5
11,29,14,18,13,5
11,29,15,15,11,4
11,29,16,14,14,0
11,29,17,14,11,3
11,29,18,17,7,10
11,29,19,12,9,3
11,29,20,21,13,8
11,29,21,6,10,-4
11,29,22,20,9,11
11,29,23,32,8,24
11,29,24,15,13,2
11,29,25,13,6,7
11,29,26,14,15,-1
11,29,27,12,6,6
11,29,28,22,10,12
11,29,29,11,10,1
11,29,30,35,11,24
11,29,31,17,10,7
11,29,32,15,16,-1
11,29,33,17,14,3
11,29,34,16,8,8
11,29,35,7,14,-7
11,29,36,24,10,14
11,29,37,19,11,8
11,29,38,22,20,2
11,29,39,15,12,3
11,29,40,14,3,11
11,29,41,18,5,13
11,29,42,15,7,8
11,29,43,26,8,18
11,29,44,32,16,16
11,29,45,17,4,13
11,29,46,17,14,3
11,29,47,16,15,1
11,29,48,20,15,5
11,29,49,25,11,14
11,29,50,27,8,19
11,29,51,40,22,18
11,29,52,26,11,15
11,29,53,16,4,12
11,29,54,13,12,1
11,29,55,20,8,12
11,29,56,16,10,6
11,29,57,30,14,16
11,29,58,27,26,1
11,29,59,20,14,6
11,29,60,26,6,20
11,29,61,17,5,12
11,29,62,29,10,19
11,29,63,12,17,-5
11,29,64,27,14,13
11,29,65,12,16,-4
11,29,66,6,9,-3
11,29,67,6,14,-8
11,29,68,13,7,6
11,29,69,27,12,15
11,29,70,11,3,8
11,29,71,27,13,14
11,29,72,20,6,14
11,29,73,10,10,0
11,29,74,33,16,17
11,29,75,9,8,1
11,29,76,18,2,16
11,29,77,9,7,2
11,29,78,22,8,14
11,29,79,6,9,-3
11,29,80,14,12,2
11,29,81,17,13,4
11,29,82,20,13,7
11,29,83,29,9,20
11,29,84,31,23,8
11,29,85,24,7,17
11,29,86,29,10,19
11,29,87,10,5,5
11,29,88,11,8,3
11,29,89,17,19,-2
11,29,90,12,9,3
11,29,91,14,8,6
11,29,92,10,17,-7
11,29,93,24,10,14
11,29,94,23,12,11
11,29,95,29,11,18
11,29,96,12,14,-2
11,29,97,17,15,2
11,29,98,19,18,1
11,29,99,21,18,3
11,29,100,18,15,3
11,29,101,16,16,0
11,29,102,17,7,10
11,29,103,12,5,7
11,29,104,23,3,20
11,29,105,4,6,-2
11,29,106,14,9,5
11,29,107,10,13,-3
11,29,108,22,5,17
11,29,109,9,8,1
11,29,110,11,19,-8
11,29,111,17,11,6
11,29,112,13,9,4
11,29,113,32,13,19
11,29,114,11,5,6
11,29,115,25,19,6
11,29,116,27,23,4
11,29,117,16,8,8
11,29,118,11,10,1
11,29,119,18,9,9
11,29,120,12,18,-6
11,29,121,13,11,2
11,29,122,23,26,-3
11,29,123,10,11,-1
11,29,124,24,11,13
11,29,125,18,13,5
11,29,126,15,7,8
11,29,127,26,16,10
11,29,128,29,9,20
11,29,129,39,17,22
11,29,130,17,12,5
11,29,131,15,9,6
11,29,132,26,12,14
11,29,133,17,7,10
11,29,134,12,13,-1
11,29,135,8,5,3
11,29,136,14,9,5
11,29,137,17,9,8
11,29,138,7,11,-4
11,29,139,30,6,24
11,29,140,20,7,13
11,29,141,20,5,15
11,29,142,26,14,12
11,29,143,14,7,7
11,29,144,26,17,9
11,29,145,16,14,2
11,29,146,20,15,5
11,29,147,38,11,27
11,29,148,17,11,6
11,29,149,22,12,10
11,29,150,31,16,15
11,29,151,16,17,-1
11,29,152,15,8,7
11,29,153,31,17,14
11,29,154,17,12,5
11,29,155,20,10,10
11,29,156,19,16,3
11,29,157,17,23,-6
11,29,158,27,14,13
11,29,159,10,4,6
11,29,160,27,20,7
11,29,161,15,10,5
11,29,162,13,4,9
11,29,163,22,17,5
11,29,164,14,5,9
11,29,165,9,9,0
11,29,166,25,13,12
11,29,167,32,12,20
11,29,168,13,7,6
11,29,169,13,11,2
11,29,170,8,5,3
11,29,171,28,9,19
11,29,172,32,11,21
11,29,173,26,16,10
11,29,174,14,3,11
11,29,175,20,8,12
11,29,176,14,3,11
11,29,177,25,25,0
11,29,178,15,17,-2
11,29,179,13,12,1
11,29,180,27,9,18
11,29,181,12,11,1
11,29,182,14,3,11
11,29,183,20,8,12
11,29,184,19,18,1
11,29,185,10,7,3
11,29,186,16,8,8
11,29,187,23,12,11
11,29,188,21,12,9
11,29,189,11,12,-1
11,29,190,26,15,11
11,29,191,16,21,-5
11,29,192,15,15,0
11,29,193,13,14,-1
11,29,194,9,6,3
11,29,195,20,18,2
11,29,196,22,10,12
11,29,197,13,14,-1
11,29,198,16,17,-1
11,29,199,10,16,-6
11,29,200,9,8,1
11,29,201,10,3,7
11,29,202,11,9,2
11,29,203,16,9,7
11,29,204,13,9,4
11,29,205,19,16,3
11,29,206,22,12,10
11,29,207,22,6,16
11,29,208,18,8,10
11,29,209,30,7,23
11,29,210,7,5,2
11,29,211,18,16,2
11,29,212,9,6,3
11,29,213,13,6,7
11,29,214,21,7,14
11,29,215,26,14,12
11,29,216,10,6,4
11,29,217,15,6,9
11,29,218,19,8,11
11,29,219,22,8,14
11,29,220,27,6,21
11,29,221,18,18,0
11,29,222,35,9,26
11,29,223,24,12,12
11,29,224,27,11,16
11,29,225,18,10,8
11,29,226,25,16,9
11,29,227,20,13,7
11,29,228,19,7,12
11,29,229,17,9,8
11,29,230,12,20,-8
11,29,231,19,14,5
11,29,232,27,14,13
11,29,233,24,5,19
11,29,234,14,10,4
11,29,235,27,13,14
11,29,236,30,13,17
11,29,237,18,6,12
11,29,238,13,19,-6
11,29,239,12,8,4
11,29,240,21,26,-5
11,29,241,14,13,1
11,29,242,13,14,-1
11,29,243,20,8,12
11,29,244,25,15,10
11,29,245,21,6,15
11,29,246,25,18,7
11,29,247,10,12,-2
11,29,248,12,18,-6
11,29,249,6,8,-2
11,29,250,19,10,9
11,29,251,36,13,23
11,29,252,19,10,9
11,29,253,20,19,1
11,29,254,21,13,8
11,29,255,19,11,8
11,29,256,29,18,11
11,29,257,27,21,6
11,29,258,23,11,12
11,29,259,27,21,6
11,29,260,24,19,5
11,29,261,11,8,3
11,29,262,30,21,9
11,29,263,26,10,16
11,29,264,25,13,12
11,29,265,20,12,8
11,29,266,10,10,0
11,29,267,8,10,-2
11,29,268,28,9,19
11,29,269,9,11,-2
11,29,270,25,8,17
11,29,271,4,4,0
11,29,272,18,14,4
11,29,273,7,7,0
11,29,274,14,10,4
11,29,275,19,17,2
11,29,276,10,14,-4
11,29,277,13,16,-3
11,29,278,21,15,6
11,29,279,9,3,6
11,29,280,29,13,16
11,29,281,25,12,13
11,29,282,23,13,10
11,29,283,6,4,2
11,29,284,19,9,10
11,29,285,11,13,-2
11,29,286,7,7,0
11,29,287,14,12,2
11,29,288,26,7,19
11,29,289,28,18,10
11,29,290,20,5,15
11,29,291,19,7,12
11,29,292,28,9,19
11,29,293,19,10,9
11,29,294,25,22,3
11,29,295,18,16,2
11,29,296,17,19,-2
11,29,297,23,7,16
11,29,298,28,11,17
11,29,299,34,18,16
11,30,0,19,8,11
11,30,1,18,11,7
11,30,2,15,5,10
11,30,3,20,11,9
11,30,4,30,7,23
11,30,5,15,13,2
11,30,6,19,9,10
11,30,7,26,14,12
11,30,8,19,9,10
11,30,9,7,4,3
11,30,10,9,10,-1
11,30,11,12,2,10
11,30,12,25,12,13
11,30,13,16,12,4
11,30,14,27,6,21
11,30,15,8,7,1
11,30,16,19,13,6
11,30,17,23,2,21
11,30,18,27,15,12
11,30,19,10,7,3
11,30,20,18,3,15
11,30,21,25,17,8
11,30,22,23,4,19
11,30,23,17,11,6
11,30,24,18,8,10
11,30,25,15,10,5
11,30,26,15,6,9
11,30,27,26,11,15
11,30,28,42,17,25
11,30,29,33,26,7
11,30,30,19,13,6
11,30,31,8,0,8
11,30,32,12,7,5
11,30,33,20,14,6
11,30,34,27,16,11
11,30,35,12,2,10
11,30,36,24,11,13
11,30,37,13,4,9
11,30,38,25,6,19
11,30,39,26,9,17
11,30,40,20,12,8
11,30,41,7,8,-1
11,30,42,17,6,11
11,30,43,8,15,-7
11,30,44,7,13,-6
11,30,45,26,15,11
11,30,46,17,7,10
11,30,47,23,19,4
11,30,48,20,16,4
11,30,49,18,13,5
11,30,50,27,9,18
11,30,51,31,9,22
11,30,52,16,9,7
11,30,53,13,7,6
11,30,54,20,4,16
11,30,55,19,13,6
11,30,56,16,8,8
11,30,57,8,9,-1
11,30,58,29,18,11
11,30,59,19,14,5
11,30,60,27,19,8
11,30,61,6,8,-2
11,30,62,27,12,15
11,30,63,16,12,4
11,30,64,18,10,8
11,30,65,10,7,3
11,30,66,25,12,13
11,30,67,33,25,8
11,30,68,15,19,-4
11,30,69,25,13,12
11,30,70,11,4,7
11,30,71,6,11,-5
11,30,72,10,9,1
11,30,73,6,6,0
11,30,74,23,10,13
11,30,75,14,4,10
11,30,76,13,11,2
11,30,77,10,7,3
11,30,78,23,9,14
11,30,79,8,3,5
11,30,80,22,4,18
11,30,81,14,5,9
11,30,82,25,4,21
11,30,83,19,4,15
11,30,84,21,10,11
11,30,85,27,15,12
11,30,86,19,11,8
11,30,87,15,10,5
11,30,88,8,6,2
11,30,89,36,12,24
11,30,90,19,12,7
11,30,91,17,13,4
11,30,92,23,22,1
11,30,93,19,20,-1
11,30,94,23,15,8
11,30,95,21,11,10
11,30,96,15,8,7
11,30,97,17,17,0
11,30,98,19,22,-3
11,30,99,24,6,18
11,30,100,16,7,9
11,30,101,18,7,11
11,30,102,22,9,13
11,30,103,12,9,3
11,30,104,21,12,9
11,30,105,16,4,12
11,30,106,23,11,12
11,30,107,24,9,15
11,30,108,22,10,12
11,30,109,24,7,17
11,30,110,8,11,-3
11,30,111,14,6,8
11,30,112,24,21,3
11,30,113,14,10,4
11,30,114,18,13,5
11,30,115,11,14,-3
11,30,116,15,14,1
11,30,117,20,10,10
11,30,118,21,14,7
11,30,119,13,11,2
11,30,120,10,19,-9
11,30,121,16,17,-1
11,30,122,12,16,-4
11,30,123,16,12,4
11,30,124,11,9,2
11,30,125,12,5,7
11,30,126,4,27,-23
11,30,127,18,18,0
11,30,128,24,12,12
11,30,129,15,16,-1
11,30,130,13,11,2
11,30,131,20,6,14
11,30,132,32,21,11
11,30,133,27,15,12
11,30,134,21,9,12
11,30,135,21,13,8
11,30,136,10,5,5
11,30,137,28,9,19
11,30,138,25,14,11
11,30,139,16,11,5
11,30,140,20,15,5
11,30,141,16,15,1
11,30,142,25,9,16
11,30,143,8,15,-7
11,30,144,24,14,10
11,30,145,11,7,4
11,30,146,14,5,9
11,30,147,14,11,3
11,30,148,21,17,4
11,30,149,15,17,-2
11,30,150,27,25,2
11,30,151,23,19,4
11,30,152,13,7,6
11,30,153,11,13,-2
11,30,154,28,11,17
11,30,155,12,14,-2
11,30,156,23,9,14
11,30,157,23,11,12
11,30,158,30,22,8
11,30,159,24,4,20
11,30,160,16,8,8
11,30,161,19,6,13
11,30,162,20,13,7
11,30,163,32,18,14
11,30,164,13,14,-1
11,30,165,28,12,16
11,30,166,26,8,18
11,30,167,10,14,-4
11,30,168,18,10,8
11,30,169,15,9,6
11,30,170,14,6,8
11,30,171,17,13,4
11,30,172,18,9,9
11,30,173,19,3,16
11,30,174,12,7,5
11,30,175,22,13,9
11,30,176,24,8,16
11,30,177,10,8,2
11,30,178,13,19,-6
11,30,179,15,15,0
11,30,180,18,2,16
11,30,181,21,9,12
11,30,182,20,3,17
11,30,183,17,11,6
11,30,184,46,9,37
11,30,185,24,16,8
11,30,186,17,4,13
11,30,187,20,7,13
11,30,188,17,8,9
11,30,189,13,4,9
11,30,190,20,19,1
11,30,191,16,15,1
11,30,192,29,4,25
11,30,193,16,6,10
11,30,194,13,10,3
11,30,195,10,5,5
11,30,196,8,13,-5
11,30,197,24,9,15
11,30,198,25,11,14
11,30,199,27,10,17
11,30,200,17,10,7
11,30,201,12,20,-8
11,30,202,23,18,5
11,30,203,31,12,19
11,30,204,18,4,14
11,30,205,10,4,6
11,30,206,17,12,5
11,30,207,12,5,7
11,30,208,11,6,5
11,30,209,10,4,6
11,30,210,22,24,-2
11,30,211,18,6,12
11,30,212,26,25,1
11,30,213,10,8,2
11,30,214,22,23,-1
11,30,215,17,15,2
11,30,216,11,12,-1
11,30,217,22,3,19
11,30,218,25,20,5
11,30,219,10,13,-3
11,30,220,14,3,11
11,30,221,25,15,10
11,30,222,13,11,2
11,30,223,26,10,16
11,30,224,19,11,8
11,30,225,17,10,7
11,30,226,20,10,10
11,30,227,15,21,-6
11,30,228,15,11,4
11,30,229,17,16,1
11,30,230,15,11,4
11,30,231,21,17,4
11,30,232,32,23,9
11,30,233,17,9,8
11,30,234,25,20,5
11,30,235,10,9,1
11,30,236,28,6,22
11,30,237,26,14,12
11,30,238,23,14,9
11,30,239,12,10,2
11,30,240,21,16,5
11,30,241,22,18,4
11,30,242,19,3,16
11,30,243,17,16,1
11,30,244,40,9,31
11,30,245,8,4,4
11,30,246,18,10,8
11,30,247,33,13,20
11,30,248,24,14,10
11,30,249,12,12,0
11,30,250,29,9,20
11,30,251,23,12,11
11,30,252,13,11,2
11,30,253,21,25,-4
11,30,254,29,13,16
11,30,255,19,9,10
11,30,256,18,8,10
11,30,257,12,7,5
11,30,258,22,13,9
11,30,259,20,10,10
11,30,260,23,20,3
11,30,261,7,12,-5
11,30,262,13,4,9
11,30,263,12,4,8
11,30,264,25,14,11
11,30,265,12,13,-1
11,30,266,20,11,9
11,30,267,11,10,1
11,30,268,26,8,18
11,30,269,24,11,13
11,30,270,18,14,4
11,30,271,26,12,14
11,30,272,29,23,6
11,30,273,9,9,0
11,30,274,18,12,6
11,30,275,20,9,11
11,30,276,24,11,13
11,30,277,11,7,4
11,30,278,10,13,-3
11,30,279,21,19,2
11,30,280,3,5,-2
11,30,281,10,8,2
11,30,282,12,4,8
11,30,283,24,7,17
11,30,284,29,7,22
11,30,285,23,16,7
11,30,286,16,8,8
11,30,287,11,11,0
11,30,288,16,13,3
11,30,289,12,14,-2
11,30,290,5,8,-3
11,30,291,22,9,13
11,30,292,26,18,8
11,30,293,16,18,-2
11,30,294,23,7,16
11,30,295,12,16,-4
11,30,296,44,17,27
11,30,297,20,12,8
11,30,298,16,12,4
11,30,299,17,9,8
12,1,0,8,10,-2
12,1,1,7,13,-6
12,1,2,3,3,0
12,1,3,6,10,-4
12,1,4,7,5,2
12,1,5,11,9,2
12,1,6,3,8,-5
12,1,7,4,10,-6
12,1,8,16,17,-1
12,1,9,9,13,-4
12,1,10,4,8,-4
12,1,11,7,8,-1
12,1,12,3,14,-11
12,1,13,2,8,-6
12,1,14,10,15,-5
12,1,15,18,22,-4
12,1,16,4,6,-2
12,1,17,13,14,-1
12,1,18,15,12,3
12,1,19,6,6,0
12,1,20,14,5,9
12,1,21,12,20,-8
12,1,22,13,8,5
12,1,23,8,11,-3
12,1,24,15,9,6
12,1,25,9,22,-13
12,1,26,13,11,2
12,1,27,17,23,-6
12,1,28,10,29,-19
12,1,29,6,14,-8
12,1,30,10,16,-6
12,1,31,17,20,-3
12,1,32,8,8,0
12,1,33,4,10,-6
12,1,34,14,23,-9
12,1,35,11,14,-3
12,1,36,13,18,-5
12,1,37,0,15,-15
12,1,38,12,8,4
12,1,39,7,19,-12
12,1,40,11,9,2
12,1,41,2,7,-5
12,1,42,11,19,-8
12,1,43,10,10,0
12,1,44,10,11,-1
12,1,45,14,14,0
12,1,46,10,11,-1
12,1,47,9,15,-6
12,1,48,5,20,-15
12,1,49,16,15,1
12,1,50,5,6,-1
12,1,51,3,5,-2
12,1,52,9,6,3
12,1,53,14,14,0
12,1,54,14,25,-11
12,1,55,10,14,-4
12,1,56,10,14,-4
12,1,57,11,21,-10
12,1,58,8,17,-9
12,1,59,6,13,-7
12,1,60,9,16,-7
12,1,61,8,15,-7
12,1,62,14,16,-2
12,1,63,8,18,-10
12,1,64,7,11,-4
12,1,65,9,14,-5
12,1,66,10,10,0
12,1,67,5,10,-5
12,1,68,10,11,-1
12,1,69,11,13,-2
12,1,70,13,14,-1
12,1,71,9,19,-10
12,1,72,11,11,0
12,1,73,10,17,-7
12,1,74,12,19,-7
12,1,75,6,10,-4
12,1,76,2,12,-10
12,1,77,6,15,-9
12,1,78,7,13,-6
12,1,79,20,26,-6
12,1,80,8,15,-7
12,1,81,5,9,-4
12,1,82,16,7,9
12,1,83,11,10,1
12,1,84,6,11,-5
12,1,85,10,20,-10
12,1,86,3,7,-4
12,1,87,13,16,-3
12,1,88,25,17,8
12,1,89,14,15,-1
12,1,90,6,10,-4
12,1,91,5,12,-7
12,1,92,12,15,-3
12,1,93,12,19,-7
12,1,94,7,9,-2
12,1,95,1,10,-9
12,1,96,13,10,3
12,1,97,18,16,2
12,1,98,3,6,-3
12,1,99,8,10,-2
12,1,100,11,8,3
12,1,101,3,14,-11
12,1,102,15,15,0
12,1,103,11,14,-3
12,1,104,6,8,-2
12,1,105,5,16,-11
12,1,106,8,6,2
12,1,107,8,15,-7
12,1,108,17,10,7
12,1,109,9,4,5
12,1,110,7,13,-6
12,1,111,13,20,-7
12,1,112,7,8,-1
12,1,113,5,16,-11
12,1,114,11,15,-4
12,1,115,12,10,2
12,1,116,9,17,-8
12,1,117,5,1,4
12,1,118,7,12,-5
12,1,119,7,11,-4
12,1,120,24,24,0
12,1,121,5,10,-5
12,1,122,8,20,-12
12,1,123,4,27,-23
12,1,124,13,19,-6
12,1,125,9,20,-11
12,1,126,2,8,-6
12,1,127,6,15,-9
12,1,128,8,12,-4
12,1,129,6,5,1
12,1,130,7,10,-3
12,1,131,5,16,-11
12,1,132,13,8,5
12,1,133,9,17,-8
12,1,134,15,15,0
12,1,135,12,19,-7
12,1,136,5,17,-12
12,1,137,7,7,0
12,1,138,20,19,1
12,1,139,10,10,0
12,1,140,9,15,-6
12,1,141,18,12,6
12,1,142,4,4,0
12,1,143,6,10,-4
12,1,144,10,15,-5
12,1,145,18,13,5
12,1,146,18,14,4
12,1,147,16,14,2
12,1,148,5,12,-7
12,1,149,6,18,-12
12,1,150,8,15,-7
12,1,151,13,15,-2
12,1,152,19,17,2
12,1,153,9,10,-1
12,1,154,9,14,-5
12,1,155,20,27,-7
12,1,156,5,9,-4
12,1,157,5,17,-12
12,1,158,11,10,1
12,1,159,5,3,2
12,1,160,16,17,-1
12,1,161,3,18,-15
12,1,162,7,18,-11
12,1,163,4,17,-13
12,1,164,2,20,-18
12,1,165,13,8,5
12,1,166,6,18,-12
12,1,167,11,15,-4
12,1,168,17,20,-3
12,1,169,10,15,-5
12,1,170,17,8,9
12,1,171,9,13,-4
12,1,172,15,17,-2
12,1,173,17,23,-6
12,1,174,13,13,0
12,1,175,13,12,1
12,1,176,5,16,-11
12,1,177,14,18,-4
12,1,178,12,15,-3
12,1,179,7,9,-2
12,1,180,6,11,-5
12,1,181,4,12,-8
12,1,182,2,13,-11
12,1,183,9,12,-3
12,1,184,28,15,13
12,1,185,11,28,-17
12,1,186,9,13,-4
12,1,187,6,19,-13
12,1,188,8,12,-4
12,1,189,8,13,-5
12,1,190,5,27,-22
12,1,191,2,6,-4
12,1,192,10,12,-2
12,1,193,8,13,-5
12,1,194,6,15,-9
12,1,195,8,16,-8
12,1,196,13,17,-4
12,1,197,4,7,-3
12,1,198,17,15,2
12,1,199,8,12,-4
12,1,200,12,9,3
12,1,201,7,5,2
12,1,202,10,9,1
12,1,203,17,16,1
12,1,204,6,12,-6
12,1,205,5,15,-10
12,1,206,9,14,-5
12,1,207,4,11,-7
12,1,208,1,15,-14
12,1,209,6,13,-7
12,1,210,5,9,-4
12,1,211,7,4,3
12,1,212,13,12,1
12,1,213,1,6,-5
12,1,214,9,12,-3
12,1,215,9,16,-7
12,1,216,3,7,-4
12,1,217,7,11,-4
12,1,218,3,8,-5
12,1,219,11,15,-4
12,1,220,9,8,1
12,1,221,9,13,-4
12,1,222,7,13,-6
12,1,223,16,10,6
12,1,224,7,18,-11
12,1,225,6,9,-3
12,1,226,5,10,-5
12,1,227,11,14,-3
12,1,228,3,8,-5
12,1,229,9,16,-7
12,1,230,9,17,-8
12,1,231,4,9,-5
12,1,232,15,10,5
12,1,233,5,11,-6
12,1,234,10,10,0
12,1,235,10,28,-18
12,1,236,4,25,-21
12,1,237,25,27,-2
12,1,238,6,15,-9
12,1,239,5,16,-11
12,1,240,10,11,-1
12,1,241,13,9,4
12,1,242,14,19,-5
12,1,243,11,6,5
12,1,244,3,0,3
12,1,245,8,22,-14
12,1,246,2,9,-7
12,1,247,5,17,-12
12,1,248,6,13,-7
12,1,249,2,4,-2
12,1,250,7,14,-7
12,1,251,10,15,-5
12,1,252,15,12,3
12,1,253,6,30,-24
12,1,254,11,16,-5
12,1,255,7,10,-3
12,1,256,10,12,-2
12,1,257,7,17,-10
12,1,258,7,11,-4
12,1,259,6,5,1
12,1,260,8,13,-5
12,1,261,7,22,-15
12,1,262,5,6,-1
12,1,263,7,8,-1
12,1,264,22,23,-1
12,1,265,1,9,-8
12,1,266,11,13,-2
12,1,267,2,14,-12
12,1,268,17,18,-1
12,1,269,3,12,-9
12,1,270,4,12,-8
12,1,271,8,15,-7
12,1,272,9,15,-6
12,1,273,17,12,5
12,1,274,2,10,-8
12,1,275,10,14,-4
12,1,276,7,20,-13
12,1,277,13,16,-3
12,1,278,6,17,-11
12,1,279,5,14,-9
12,1,280,18,27,-9
12,1,281,14,25,-11
12,1,282,14,17,-3
12,1,283,8,23,-15
12,1,284,3,10,-7
12,1,285,12,17,-5
12,1,286,3,3,0
12,1,287,6,10,-4
12,1,288,10,18,-8
12,1,289,7,15,-8
12,1,290,9,16,-7
12,1,291,6,14,-8
12,1,292,9,20,-11
12,1,293,1,5,-4
12,1,294,6,9,-3
12,1,295,4,16,-12
12,1,296,8,22,-14
12,1,297,6,14,-8
12,1,298,5,8,-3
12,1,299,13,10,3
12,2,0,3,8,-5
12,2,1,3,3,0
12,2,2,7,16,-9
12,2,3,13,27,-14
12,2,4,7,9,-2
12,2,5,10,22,-12
12,2,6,7,4,3
12,2,7,8,13,-5
12,2,8,1,23,-22
12,2,9,9,10,-1
12,2,10,10,25,-15
12,2,11,14,21,-7
12,2,12,10,17,-7
12,2,13,3,5,-2
12,2,14,8,7,1
12,2,15,14,15,-1
12,2,16,10,14,-4
12,2,17,7,21,-14
12,2,18,7,14,-7
12,2,19,17,26,-9
12,2,20,16,26,-10
12,2,21,4,8,-4
12,2,22,2,7,-5
12,2,23,10,13,-3
12,2,24,13,7,6
12,2,25,1,8,-7
12,2,26,10,16,-6
12,2,27,5,6,-1
12,2,28,14,30,-16
12,2,29,4,11,-7
12,2,30,6,8,-2
12,2,31,6,13,-7
12,2,32,11,25,-14
12,2,33,16,18,-2
12,2,34,10,18,-8
12,2,35,11,29,-18
12,2,36,7,10,-3
12,2,37,4,8,-4
12,2,38,11,9,2
12,2,39,14,16,-2
12,2,40,8,6,2
12,2,41,10,10,0
12,2,42,8,15,-7
12,2,43,11,43,-32
12,2,44,18,17,1
12,2,45,14,13,1
12,2,46,13,19,-6
12,2,47,25,23,2
12,2,48,3,16,-13
12,2,49,14,17,-3
12,2,50,11,14,-3
12,2,51,9,10,-1
12,2,52,4,6,-2
12,2,53,16,25,-9
12,2,54,12,22,-10
12,2,55,9,8,1
12,2,56,6,21,-15
12,2,57,8,8,0
12,2,58,6,7,-1
12,2,59,14,28,-14
12,2,60,15,17,-2
12,2,61,11,17,-6
12,2,62,10,17,-7
12,2,63,21,9,12
12,2,64,16,12,4
12,2,65,9,9,0
12,2,66,14,25,-11
12,2,67,7,22,-15
12,2,68,15,31,-16
12,2,69,15,17,-2
12,2,70,5,10,-5
12,2,71,18,18,0
12,2,72,6,21,-15
12,2,73,9,23,-14
12,2,74,6,4,2
12,2,75,7,15,-8
12,2,76,12,27,-15
12,2,77,12,18,-6
12,2,78,25,20,5
12,2,79,13,21,-8
12,2,80,8,15,-7
12,2,81,6,12,-6
12,2,82,21,20,1
12,2,83,4,8,-4
12,2,84,15,22,-7
12,2,85,14,7,7
12,2,86,5,21,-16
12,2,87,9,23,-14
12,2,88,9,13,-4
12,2,89,10,9,1
12,2,90,12,22,-10
12,2,91,7,6,1
12,2,92,3,5,-2
12,2,93,1,10,-9
12,2,94,3,12,-9
12,2,95,8,18,-10
12,2,96,6,11,-5
12,2,97,2,11,-9
12,2,98,7,7,0
12,2,99,8,19,-11
12,2,100,14,14,0
12,2,101,2,12,-10
12,2,102,11,22,-11
12,2,103,12,11,1
12,2,104,5,21,-16
12,2,105,8,9,-1
12,2,106,6,5,1
12,2,107,12,9,3
12,2,108,3,6,-3
12,2,109,20,14,6
12,2,110,10,21,-11
12,2,111,16,38,-22
12,2,112,7,15,-8
12,2,113,14,25,-11
12,2,114,6,7,-1
12,2,115,11,22,-11
12,2,116,8,15,-7
12,2,117,12,16,-4
12,2,118,9,18,-9
12,2,119,7,15,-8
12,2,120,8,5,3
12,2,121,8,13,-5
12,2,122,13,14,-1
12,2,123,4,16,-12
12,2,124,6,11,-5
12,2,125,11,27,-16
12,2,126,8,19,-11
12,2,127,7,21,-14
12,2,128,7,15,-8
12,2,129,9,13,-4
12,2,130,10,16,-6
12,2,131,6,14,-8
12,2,132,13,6,7
12,2,133,28,19,9
12,2,134,12,8,4
12,2,135,2,13,-11
12,2,136,12,9,3
12,2,137,5,6,-1
12,2,138,3,3,0
12,2,139,11,18,-7
12,2,140,5,16,-11
12,2,141,6,20,-14
12,2,142,9,21,-12
12,2,143,27,14,13
12,2,144,3,7,-4
12,2,145,19,26,-7
12,2,146,7,21,-14
12,2,147,0,7,-7
12,2,148,6,14,-8
12,2,149,12,9,3
12,2,150,5,25,-20
12,2,151,5,7,-2
12,2,152,9,20,-11
12,2,153,11,10,1
12,2,154,5,25,-20
12,2,155,9,19,-10
12,2,156,11,24,-13
12,2,157,10,17,-7
12,2,158,11,9,2
12,2,159,18,41,-23
12,2,160,7,16,-9
12,2,161,16,11,5
12,2,162,9,9,0
12,2,163,16,19,-3
12,2,164,13,20,-7
12,2,165,11,9,2
12,2,166,5,20,-15
12,2,167,11,24,-13
12,2,168,0,14,-14
12,2,169,10,11,-1
12,2,170,20,26,-6
12,2,171,11,24,-13
12,2,172,11,30,-19
12,2,173,15,27,-12
12,2,174,19,16,3
12,2,175,17,15,2
12,2,176,11,10,1
12,2,177,5,7,-2
12,2,178,9,15,-6
12,2,179,12,13,-1
12,2,180,5,18,-13
12,2,181,12,21,-9
12,2,182,3,7,-4
12,2,183,10,18,-8
12,2,184,7,12,-5
12,2,185,6,13,-7
12,2,186,7,17,-10
12,2,187,18,12,6
12,2,188,7,15,-8
12,2,189,7,7,0
12,2,190,11,21,-10
12,2,191,12,11,1
12,2,192,12,19,-7
12,2,193,10,6,4
12,2,194,7,14,-7
12,2,195,13,35,-22
12,2,196,11,29,-18
12,2,197,10,13,-3
12,2,198,11,13,-2
12,2,199,7,13,-6
12,2,200,7,16,-9
12,2,201,9,15,-6
12,2,202,6,11,-5
12,2,203,6,6,0
12,2,204,5,4,1
12,2,205,7,10,-3
12,2,206,10,9,1
12,2,207,11,15,-4
12,2,208,2,9,-7
12,2,209,5,9,-4
12,2,210,5,18,-13
12,2,211,8,8,0
12,2,212,5,12,-7
12,2,213,7,14,-7
12,2,214,11,26,-15
12,2,215,12,10,2
12,2,216,5,3,2
12,2,217,5,17,-12
12,2,218,8,6,2
12,2,219,8,8,0
12,2,220,10,13,-3
12,2,221,7,17,-10
12,2,222,6,18,-12
12,2,223,8,17,-9
12,2,224,8,14,-6
12,2,225,14,28,-14
12,2,226,4,7,-3
12,2,227,10,18,-8
12,2,228,16,14,2
12,2,229,12,29,-17
12,2,230,4,18,-14
12,2,231,8,19,-11
12,2,232,8,24,-16
12,2,233,10,12,-2
12,2,234,14,10,4
12,2,235,9,14,-5
12,2,236,8,10,-2
12,2,237,11,21,-10
12,2,238,13,22,-9
12,2,239,8,6,2
12,2,240,10,19,-9
12,2,241,8,7,1
12,2,242,19,14,5
12,2,243,4,10,-6
12,2,244,9,21,-12
12,2,245,9,16,-7
12,2,246,10,8,2
12,2,247,16,15,1
12,2,248,14,27,-13
12,2,249,8,8,0
12,2,250,16,10,6
12,2,251,10,26,-16
12,2,252,5,15,-10
12,2,253,22,15,7
12,2,254,10,11,-1
12,2,255,10,18,-8
12,2,256,11,30,-19
12,2,257,11,12,-1
12,2,258,10,14,-4
12,2,259,14,16,-2
12,2,260,8,9,-1
12,2,261,8,7,1
12,2,262,9,21,-12
12,2,263,15,20,-5
12,2,264,4,5,-1
12,2,265,15,21,-6
12,2,266,7,14,-7
12,2,267,9,14,-5
12,2,268,13,14,-1
12,2,269,10,14,-4
12,2,270,6,3,3
12,2,271,13,27,-14
12,2,272,13,11,2
12,2,273,10,22,-12
12,2,274,19,22,-3
12,2,275,5,6,-1
12,2,276,16,17,-1
12,2,277,19,20,-1
12,2,278,13,18,-5
12,2,279,8,12,-4
12,2,280,14,21,-7
12,2,281,7,15,-8
12,2,282,9,14,-5
12,2,283,7,21,-14
12,2,284,3,11,-8
12,2,285,4,9,-5
12,2,286,14,17,-3
12,2,287,6,11,-5
12,2,288,9,23,-14
12,2,289,10,26,-16
12,2,290,7,6,1
12,2,291,12,17,-5
12,2,292,14,27,-13
12,2,293,13,17,-4
12,2,294,4,8,-4
12,2,295,12,15,-3
12,2,296,8,25,-17
12,2,297,5,15,-10
12,2,298,12,10,2
12,2,299,15,11,4
12,3,0,7,18,-11
12,3,1,4,17,-13
12,3,2,6,21,-15
12,3,3,8,19,-11
12,3,4,9,18,-9
12,3,5,10,9,1
12,3,6,11,25,-14
12,3,7,8,10,-2
12,3,8,13,17,-4
12,3,9,13,24,-11
12,3,10,24,25,-1
12,3,11,13,17,-4
12,3,12,10,14,-4
12,3,13,14,28,-14
12,3,14,20,18,2
12,3,15,5,12,-7
12,3,16,13,11,2
12,3,17,7,10,-3
12,3,18,10,6,4
12,3,19,15,21,-6
12,3,20,11,16,-5
12,3,21,16,20,-4
12,3,22,6,18,-12
12,3,23,7,17,-10
12,3,24,3,8,-5
12,3,25,8,17,-9
12,3,26,8,29,-21
12,3,27,5,16,-11
12,3,28,3,8,-5
12,3,29,10,18,-8
12,3,30,4,5,-1
12,3,31,5,9,-4
12,3,32,13,14,-1
12,3,33,8,17,-9
12,3,34,10,22,-12
12,3,35,7,18,-11
12,3,36,10,4,6
12,3,37,19,18,1
12,3,38,16,13,3
12,3,39,9,8,1
12,3,40,9,20,-11
12,3,41,12,12,0
12,3,42,9,13,-4
12,3,43,2,7,-5
12,3,44,9,21,-12
12,3,45,10,16,-6
12,3,46,6,26,-20
12,3,47,8,19,-11
12,3,48,10,8,2
12,3,49,12,19,-7
12,3,50,7,14,-7
12,3,51,10,17,-7
12,3,52,10,14,-4
12,3,53,11,21,-10
12,3,54,15,8,7
12,3,55,8,20,-12
12,3,56,11,21,-10
12,3,57,19,13,6
12,3,58,21,6,15
12,3,59,24,16,8
12,3,60,7,11,-4
12,3,61,9,8,1
12,3,62,9,17,-8
12,3,63,8,19,-11
12,3,64,20,29,-9
12,3,65,5,21,-16
12,3,66,20,14,6
12,3,67,3,20,-17
12,3,68,18,10,8
12,3,69,15,12,3
12,3,70,5,9,-4
12,3,71,8,25,-17
12,3,72,15,10,5
12,3,73,11,26,-15
12,3,74,9,19,-10
12,3,75,17,29,-12
12,3,76,12,15,-3
12,3,77,6,30,-24
12,3,78,13,16,-3
12,3,79,15,10,5
12,3,80,9,14,-5
12,3,81,14,13,1
12,3,82,7,17,-10
12,3,83,9,29,-20
12,3,84,14,27,-13
12,3,85,10,19,-9
12,3,86,15,14,1
12,3,87,6,16,-10
12,3,88,17,25,-8
12,3,89,6,6,0
12,3,90,15,24,-9
12,3,91,13,14,-1
12,3,92,13,13,0
12,3,93,15,16,-1
12,3,94,12,12,0
12,3,95,6,4,2
12,3,96,17,11,6
12,3,97,18,24,-6
12,3,98,17,19,-2
12,3,99,11,25,-14
12,3,100,13,48,-35
12,3,101,5,9,-4
12,3,102,4,19,-15
12,3,103,19,13,6
12,3,104,10,13,-3
12,3,105,9,15,-6
12,3,106,9,8,1
12,3,107,10,9,1
12,3,108,8,14,-6
12,3,109,4,14,-10
12,3,110,10,26,-16
12,3,111,14,26,-12
12,3,112,13,16,-3
12,3,113,8,24,-16
12,3,114,16,17,-1
12,3,115,14,17,-3
12,3,116,6,12,-6
12,3,117,12,26,-14
12,3,118,8,9,-1
12,3,119,18,8,10
12,3,120,10,27,-17
12,3,121,21,21,0
12,3,122,7,14,-7
12,3,123,4,16,-12
12,3,124,13,20,-7
12,3,125,9,14,-5
12,3,126,12,9,3
12,3,127,12,14,-2
12,3,128,14,22,-8
12,3,129,15,17,-2
12,3,130,8,11,-3
12,3,131,3,14,-11
12,3,132,11,34,-23
12,3,133,10,19,-9
12,3,134,6,13,-7
12,3,135,8,10,-2
12,3,136,8,13,-5
12,3,137,14,14,0
12,3,138,6,12,-6
12,3,139,16,24,-8
12,3,140,3,7,-4
12,3,141,14,27,-13
12,3,142,16,10,6
12,3,143,11,16,-5
12,3,144,8,9,-1
12,3,145,6,19,-13
12,3,146,14,12,2
12,3,147,5,13,-8
12,3,148,15,9,6
12,3,149,8,8,0
12,3,150,4,8,-4
12,3,151,3,15,-12
12,3,152,10,9,1
12,3,153,8,14,-6
12,3,154,18,18,0
12,3,155,6,19,-13
12,3,156,21,31,-10
12,3,157,4,18,-14
12,3,158,23,20,3
12,3,159,13,23,-10
12,3,160,6,7,-1
12,3,161,7,6,1
12,3,162,18,30,-12
12,3,163,19,12,7
12,3,164,8,21,-13
12,3,165,21,31,-10
12,3,166,4,10,-6
12,3,167,10,23,-13
12,3,168,8,18,-10
12,3,169,11,19,-8
12,3,170,16,30,-14
12,3,171,7,21,-14
12,3,172,10,23,-13
12,3,173,5,13,-8
12,3,174,8,7,1
12,3,175,12,23,-11
12,3,176,5,13,-8
12,3,177,11,17,-6
12,3,178,16,20,-4
12,3,179,12,12,0
12,3,180,8,17,-9
12,3,181,20,31,-11
12,3,182,15,20,-5
12,3,183,4,5,-1
12,3,184,7,11,-4
12,3,185,12,23,-11
12,3,186,10,10,0
12,3,187,17,17,0
12,3,188,8,19,-11
12,3,189,11,22,-11
12,3,190,24,24,0
12,3,191,13,31,-18
12,3,192,6,12,-6
12,3,193,11,12,-1
12,3,194,11,29,-18
12,3,195,13,31,-18
12,3,196,8,15,-7
12,3,197,13,17,-4
12,3,198,5,19,-14
12,3,199,13,22,-9
12,3,200,11,19,-8
12,3,201,20,25,-5
12,3,202,5,28,-23
12,3,203,7,11,-4
12,3,204,7,21,-14
12,3,205,11,29,-18
12,3,206,7,17,-10
12,3,207,20,20,0
12,3,208,7,13,-6
12,3,209,10,10,0
12,3,210,10,18,-8
12,3,211,14,22,-8
12,3,212,9,13,-4
12,3,213,15,23,-8
12,3,214,5,9,-4
12,3,215,3,8,-5
12,3,216,10,33,-23
12,3,217,15,26,-11
12,3,218,6,16,-10
12,3,219,10,8,2
12,3,220,3,16,-13
12,3,221,3,9,-6
12,3,222,15,15,0
12,3,223,7,31,-24
12,3,224,10,12,-2
12,3,225,12,5,7
12,3,226,3,19,-16
12,3,227,6,6,0
12,3,228,7,10,-3
12,3,229,6,12,-6
12,3,230,9,13,-4
12,3,231,5,11,-6
12,3,232,8,15,-7
12,3,233,6,10,-4
12,3,234,8,21,-13
12,3,235,10,6,4
12,3,236,15,22,-7
12,3,237,13,12,1
12,3,238,9,12,-3
12,3,239,18,22,-4
12,3,240,7,20,-13
12,3,241,5,14,-9
12,3,242,17,27,-10
12,3,243,15,14,1
12,3,244,14,12,2
12,3,245,10,23,-13
12,3,246,6,8,-2
12,3,247,1,16,-15
12,3,248,17,20,-3
12,3,249,19,30,-11
12,3,250,10,20,-10
12,3,251,9,14,-5
12,3,252,9,29,-20
12,3,253,11,11,0
12,3,254,3,3,0
12,3,255,12,21,-9
12,3,256,15,18,-3
12,3,257,13,40,-27
12,3,258,22,24,-2
12,3,259,12,6,6
12,3,260,3,15,-12
12,3,261,9,7,2
12,3,262,11,27,-16
12,3,263,21,12,9
12,3,264,27,23,4
12,3,265,12,5,7
12,3,266,7,15,-8
12,3,267,13,13,0
12,3,268,5,20,-15
12,3,269,14,18,-4
12,3,270,10,13,-3
12,3,271,10,18,-8
12,3,272,18,17,1
12,3,273,10,19,-9
12,3,274,15,7,8
12,3,275,20,19,1
12,3,276,12,21,-9
12,3,277,8,13,-5
12,3,278,5,12,-7
12,3,279,9,18,-9
12,3,280,9,20,-11
12,3,281,10,15,-5
12,3,282,6,10,-4
12,3,283,8,6,2
12,3,284,5,3,2
12,3,285,8,23,-15
12,3,286,11,14,-3
12,3,287,10,20,-10
12,3,288,8,12,-4
12,3,289,12,8,4
12,3,290,11,15,-4
12,3,291,7,9,-2
12,3,292,7,15,-8
12,3,293,20,25,-5
12,3,294,20,25,-5
12,3,295,16,18,-2
12,3,296,8,16,-8
12,3,297,15,20,-5
12,3,298,24,15,9
12,3,299,23,25,-2
12,4,0,7,13,-6
12,4,1,13,17,-4
12,4,2,12,14,-2
12,4,3,19,15,4
12,4,4,9,6,3
12,4,5,19,23,-4
12,4,6,7,14,-7
12,4,7,24,18,6
12,4,8,9,10,-1
12,4,9,6,16,-10
12,4,10,8,16,-8
12,4,11,13,9,4
12,4,12,7,16,-9
12,4,13,20,24,-4
12,4,14,5,15,-10
12,4,15,9,15,-6
12,4,16,9,16,-7
12,4,17,7,17,-10
12,4,18,10,10,0
12,4,19,7,12,-5
12,4,20,9,5,4
12,4,21,16,12,4
12,4,22,19,15,4
12,4,23,15,13,2
12,4,24,12,25,-13
12,4,25,8,9,-1
12,4,26,7,12,-5
12,4,27,5,12,-7
12,4,28,11,17,-6
12,4,29,14,9,5
12,4,30,6,35,-29
12,4,31,5,6,-1
12,4,32,11,18,-7
12,4,33,10,17,-7
12,4,34,8,33,-25
12,4,35,10,8,2
12,4,36,19,32,-13
12,4,37,18,20,-2
12,4,38,11,17,-6
12,4,39,22,13,9
12,4,40,19,29,-10
12,4,41,9,15,-6
12,4,42,4,14,-10
12,4,43,20,21,-1
12,4,44,10,31,-21
12,4,45,9,11,-2
12,4,46,11,14,-3
12,4,47,8,12,-4
12,4,48,9,17,-8
12,4,49,3,8,-5
12,4,50,4,11,-7
12,4,51,9,17,-8
12,4,52,13,28,-15
12,4,53,14,21,-7
12,4,54,6,23,-17
12,4,55,14,23,-9
12,4,56,11,19,-8
12,4,57,15,18,-3
12,4,58,11,18,-7
12,4,59,12,16,-4
12,4,60,15,24,-9
12,4,61,20,14,6
12,4,62,10,15,-5
12,4,63,8,22,-14
12,4,64,26,25,1
12,4,65,9,17,-8
12,4,66,12,12,0
12,4,67,4,12,-8
12,4,68,12,16,-4
12,4,69,18,28,-10
12,4,70,14,18,-4
12,4,71,12,31,-19
12,4,72,7,15,-8
12,4,73,14,16,-2
12,4,74,12,13,-1
12,4,75,15,11,4
12,4,76,13,21,-8
12,4,77,11,16,-5
12,4,78,3,12,-9
12,4,79,7,12,-5
12,4,80,14,26,-12
12,4,81,11,20,-9
12,4,82,4,8,-4
12,4,83,20,21,-1
12,4,84,11,13,-2
12,4,85,11,10,1
12,4,86,16,17,-1
12,4,87,12,21,-9
12,4,88,10,27,-17
12,4,89,5,13,-8
12,4,90,15,13,2
12,4,91,17,23,-6
12,4,92,17,12,5
12,4,93,5,10,-5
12,4,94,22,16,6
12,4,95,13,16,-3
12,4,96,7,17,-10
12,4,97,8,18,-10
12,4,98,1,12,-11
12,4,99,11,21,-10
12,4,100,13,17,-4
12,4,101,16,17,-1
12,4,102,2,6,-4
12,4,103,14,13,1
12,4,104,4,18,-14
12,4,105,15,14,1
12,4,106,14,14,0
12,4,107,11,14,-3
12,4,108,28,10,18
12,4,109,8,10,-2
12,4,110,11,13,-2
12,4,111,27,52,-25
12,4,112,2,11,-9
12,4,113,5,17,-12
12,4,114,8,18,-10
12,4,115,14,24,-10
12,4,116,12,11,1
12,4,117,18,11,7
12,4,118,10,13,-3
12,4,119,13,30,-17
12,4,120,8,10,-2
12,4,121,13,22,-9
12,4,122,6,29,-23
12,4,123,9,23,-14
12,4,124,17,14,3
12,4,125,11,16,-5
12,4,126,11,19,-8
12,4,127,8,14,-6
12,4,128,15,14,1
12,4,129,8,9,-1
12,4,130,25,15,10
12,4,131,6,17,-11
12,4,132,13,8,5
12,4,133,8,16,-8
12,4,134,15,12,3
12,4,135,8,16,-8
12,4,136,25,22,3
12,4,137,16,7,9
12,4,138,13,25,-12
12,4,139,23,24,-1
12,4,140,5,12,-7
12,4,141,14,19,-5
12,4,142,10,18,-8
12,4,143,14,23,-9
12,4,144,11,28,-17
12,4,145,17,19,-2
12,4,146,19,15,4
12,4,147,14,15,-1
12,4,148,5,12,-7
12,4,149,5,15,-10
12,4,150,12,14,-2
12,4,151,16,20,-4
12,4,152,12,8,4
12,4,153,21,29,-8
12,4,154,9,23,-14
12,4,155,6,16,-10
12,4,156,13,11,2
12,4,157,11,27,-16
12,4,158,13,24,-11
12,4,159,13,17,-4
12,4,160,9,21,-12
12,4,161,2,10,-8
12,4,162,9,25,-16
12,4,163,12,15,-3
12,4,164,7,16,-9
12,4,165,9,13,-4
12,4,166,12,10,2
12,4,167,10,12,-2
12,4,168,10,13,-3
12,4,169,6,20,-14
12,4,170,11,13,-2
12,4,171,14,16,-2
12,4,172,2,9,-7
12,4,173,19,23,-4
12,4,174,11,15,-4
12,4,175,12,19,-7
12,4,176,10,22,-12
12,4,177,14,35,-21
12,4,178,17,18,-1
12,4,179,6,4,2
12,4,180,7,25,-18
12,4,181,13,13,0
12,4,182,13,11,2
12,4,183,12,17,-5
12,4,184,17,10,7
12,4,185,11,14,-3
12,4,186,12,11,1
12,4,187,9,25,-16
12,4,188,15,23,-8
12,4,189,13,20,-7
12,4,190,7,25,-18
12,4,191,12,14,-2
12,4,192,12,16,-4
12,4,193,11,17,-6
12,4,194,27,21,6
12,4,195,14,11,3
12,4,196,8,21,-13
12,4,197,11,15,-4
12,4,198,20,23,-3
12,4,199,14,27,-13
12,4,200,12,23,-11
12,4,201,9,22,-13
12,4,202,12,16,-4
12,4,203,8,11,-3
12,4,204,15,16,-1
12,4,205,4,18,-14
12,4,206,18,16,2
12,4,207,11,10,1
12,4,208,8,32,-24
12,4,209,11,3,8
12,4,210,9,4,5
12,4,211,15,20,-5
12,4,212,3,23,-20
12,4,213,22,8,14
12,4,214,12,14,-2
12,4,215,17,18,-1
12,4,216,7,13,-6
12,4,217,8,24,-16
12,4,218,19,13,6
12,4,219,3,11,-8
12,4,220,8,13,-5
12,4,221,17,17,0
12,4,222,10,14,-4
12,4,223,6,18,-12
12,4,224,11,22,-11
12,4,225,6,11,-5
12,4,226,26,16,10
12,4,227,10,21,-11
12,4,228,4,6,-2
12,4,229,7,15,-8
12,4,230,2,14,-12
12,4,231,7,9,-2
12,4,232,7,22,-15
12,4,233,13,25,-12
12,4,234,6,22,-16
12,4,235,14,29,-15
12,4,236,9,28,-19
12,4,237,15,34,-19
12,4,238,11,27,-16
12,4,239,10,11,-1
12,4,240,11,6,5
12,4,241,14,13,1
12,4,242,6,17,-11
12,4,243,13,20,-7
12,4,244,27,22,5
12,4,245,11,20,-9
12,4,246,25,24,1
12,4,247,13,16,-3
12,4,248,11,14,-3
12,4,249,8,17,-9
12,4,250,7,20,-13
12,4,251,22,16,6
12,4,252,7,19,-12
12,4,253,12,26,-14
12,4,254,10,19,-9
12,4,255,12,12,0
12,4,256,15,16,-1
12,4,257,18,32,-14
12,4,258,5,17,-12
12,4,259,1,9,-8
12,4,260,21,27,-6
12,4,261,7,11,-4
12,4,262,9,20,-11
12,4,263,8,16,-8
12,4,264,7,9,-2
12,4,265,12,18,-6
12,4,266,4,16,-12
12,4,267,6,18,-12
12,4,268,17,13,4
12,4,269,14,10,4
12,4,270,13,14,-1
12,4,271,18,14,4
12,4,272,19,20,-1
12,4,273,3,27,-24
12,4,274,25,25,0
12,4,275,13,12,1
12,4,276,15,23,-8
12,4,277,12,12,0
12,4,278,10,15,-5
12,4,279,6,7,-1
12,4,280,14,6,8
12,4,281,4,7,-3
12,4,282,6,9,-3
12,4,283,9,11,-2
12,4,284,11,18,-7
12,4,285,15,22,-7
12,4,286,9,27,-18
12,4,287,17,24,-7
12,4,288,11,16,-5
12,4,289,25,26,-1
12,4,290,12,21,-9
12,4,291,11,14,-3
12,4,292,5,22,-17
12,4,293,8,21,-13
12,4,294,9,18,-9
12,4,295,14,25,-11
12,4,296,6,13,-7
12,4,297,6,17,-11
12,4,298,8,15,-7
12,4,299,7,16,-9
12,5,0,10,25,-15
12,5,1,9,11,-2
12,5,2,11,14,-3
12,5,3,5,10,-5
12,5,4,13,14,-1
12,5,5,7,21,-14
12,5,6,11,21,-10
12,5,7,2,17,-15
12,5,8,6,13,-7
12,5,9,10,15,-5
12,5,10,13,11,2
12,5,11,19,35,-16
12,5,12,3,27,-24
12,5,13,11,17,-6
12,5,14,17,14,3
12,5,15,12,25,-13
12,5,16,8,18,-10
12,5,17,14,13,1
12,5,18,13,9,4
12,5,19,11,18,-7
12,5,20,17,31,-14
12,5,21,13,18,-5
12,5,22,10,10,0
12,5,23,8,7,1
12,5,24,8,11,-3
12,5,25,6,23,-17
12,5,26,10,22,-12
12,5,27,12,14,-2
12,5,28,8,31,-23
12,5,29,9,22,-13
12,5,30,7,26,-19
12,5,31,19,8,11
12,5,32,9,9,0
12,5,33,3,22,-19
12,5,34,8,23,-15
12,5,35,6,13,-7
12,5,36,6,7,-1
12,5,37,6,17,-11
12,5,38,5,10,-5
12,5,39,11,10,1
12,5,40,2,5,-3
12,5,41,12,22,-10
12,5,42,11,15,-4
12,5,43,11,18,-7
12,5,44,16,13,3
12,5,45,1,10,-9
12,5,46,12,15,-3
12,5,47,15,15,0
12,5,48,11,24,-13
12,5,49,5,14,-9
12,5,50,23,12,11
12,5,51,3,7,-4
12,5,52,3,13,-10
12,5,53,10,6,4
12,5,54,21,18,3
12,5,55,11,17,-6
12,5,56,7,25,-18
12,5,57,9,24,-15
12,5,58,7,11,-4
12,5,59,4,16,-12
12,5,60,16,16,0
12,5,61,14,20,-6
12,5,62,12,16,-4
12,5,63,8,16,-8
12,5,64,8,18,-10
12,5,65,16,26,-10
12,5,66,5,15,-10
12,5,67,14,23,-9
12,5,68,16,16,0
12,5,69,18,15,3
12,5,70,13,18,-5
12,5,71,10,24,-14
12,5,72,5,15,-10
12,5,73,18,36,-18
12,5,74,27,22,5
12,5,75,9,24,-15
12,5,76,13,25,-12
12,5,77,9,21,-12
12,5,78,5,10,-5
12,5,79,21,22,-1
12,5,80,8,24,-16
12,5,81,11,17,-6
12,5,82,7,10,-3
12,5,83,7,8,-1
12,5,84,14,21,-7
12,5,85,20,26,-6
12,5,86,19,14,5
12,5,87,4,6,-2
12,5,88,18,28,-10
12,5,89,7,16,-9
12,5,90,20,31,-11
12,5,91,18,28,-10
12,5,92,16,21,-5
12,5,93,9,16,-7
12,5,94,5,16,-11
12,5,95,18,11,7
12,5,96,8,12,-4
12,5,97,13,19,-6
12,5,98,16,32,-16
12,5,99,16,27,-11
12,5,100,10,20,-10
12,5,101,13,38,-25
12,5,102,14,12,2
12,5,103,3,10,-7
12,5,104,11,22,-11
12,5,105,19,21,-2
12,5,106,17,21,-4
12,5,107,10,16,-6
12,5,108,10,23,-13
12,5,109,7,7,0
12,5,110,15,29,-14
12,5,111,21,37,-16
12,5,112,3,10,-7
12,5,113,9,15,-6
12,5,114,15,16,-1
12,5,115,17,24,-7
12,5,116,9,30,-21
12,5,117,9,17,-8
12,5,118,9,10,-1
12,5,119,14,13,1
12,5,120,15,27,-12
12,5,121,9,24,-15
12,5,122,7,8,-1
12,5,123,20,19,1
12,5,124,17,9,8
12,5,125,9,12,-3
12,5,126,17,18,-1
12,5,127,18,16,2
12,5,128,6,12,-6
12,5,129,10,10,0
12,5,130,15,25,-10
12,5,131,16,11,5
12,5,132,25,29,-4
12,5,133,6,10,-4
12,5,134,10,17,-7
12,5,135,6,11,-5
12,5,136,10,26,-16
12,5,137,25,24,1
12,5,138,14,20,-6
12,5,139,5,14,-9
12,5,140,3,11,-8
12,5,141,15,29,-14
12,5,142,15,22,-7
12,5,143,14,16,-2
12,5,144,0,6,-6
12,5,145,12,36,-24
12,5,146,8,24,-16
12,5,147,18,22,-4
12,5,148,16,15,1
12,5,149,7,27,-20
12,5,150,7,32,-25
12,5,151,11,10,1
12,5,152,11,16,-5
12,5,153,14,10,4
12,5,154,25,32,-7
12,5,155,7,11,-4
12,5,156,6,15,-9
12,5,157,16,23,-7
12,5,158,7,20,-13
12,5,159,10,20,-10
12,5,160,6,17,-11
12,5,161,8,12,-4
12,5,162,6,19,-13
12,5,163,8,9,-1
12,5,164,23,28,-5
12,5,165,17,7,10
12,5,166,3,10,-7
12,5,167,8,11,-3
12,5,168,17,34,-17
12,5,169,13,22,-9
12,5,170,15,22,-7
12,5,171,8,10,-2
12,5,172,21,20,1
12,5,173,13,15,-2
12,5,174,17,14,3
12,5,175,9,26,-17
12,5,176,4,8,-4
12,5,177,15,11,4
12,5,178,13,8,5
12,5,179,12,8,4
12,5,180,7,19,-12
12,5,181,6,11,-5
12,5,182,12,20,-8
12,5,183,7,18,-11
12,5,184,10,13,-3
12,5,185,21,24,-3
12,5,186,9,22,-13
12,5,187,12,10,2
12,5,188,3,17,-14
12,5,189,12,24,-12
12,5,190,9,35,-26
12,5,191,24,16,8
12,5,192,12,29,-17
12,5,193,11,14,-3
12,5,194,15,19,-4
12,5,195,6,21,-15
12,5,196,4,7,-3
12,5,197,6,18,-12
12,5,198,8,21,-13
12,5,199,8,22,-14
12,5,200,17,18,-1
12,5,201,4,16,-12
12,5,202,10,13,-3
12,5,203,15,16,-1
12,5,204,10,9,1
12,5,205,12,17,-5
12,5,206,10,8,2
12,5,207,3,13,-10
12,5,208,10,26,-16
12,5,209,16,22,-6
12,5,210,17,16,1
12,5,211,16,29,-13
12,5,212,11,13,-2
12,5,213,6,13,-7
12,5,214,18,10,8
12,5,215,11,16,-5
12,5,216,6,9,-3
12,5,217,7,10,-3
12,5,218,13,19,-6
12,5,219,18,17,1
12,5,220,13,16,-3
12,5,221,12,26,-14
12,5,222,12,19,-7
12,5,223,15,22,-7
12,5,224,19,10,9
12,5,225,6,10,-4
12,5,226,5,26,-21
12,5,227,14,18,-4
12,5,228,21,13,8
12,5,229,21,19,2
12,5,230,14,15,-1
12,5,231,17,34,-17
12,5,232,24,18,6
12,5,233,18,14,4
12,5,234,10,25,-15
12,5,235,5,13,-8
12,5,236,12,17,-5
12,5,237,12,8,4
12,5,238,7,15,-8
12,5,239,7,12,-5
12,5,240,9,12,-3
12,5,241,4,8,-4
12,5,242,8,18,-10
12,5,243,19,28,-9
12,5,244,11,24,-13
12,5,245,7,16,-9
12,5,246,10,16,-6
12,5,247,13,21,-8
12,5,248,17,19,-2
12,5,249,15,26,-11
12,5,250,15,11,4
12,5,251,5,10,-5
12,5,252,9,14,-5
12,5,253,16,26,-10
12,5,254,7,20,-13
12,5,255,9,29,-20
12,5,256,9,15,-6
12,5,257,19,10,9
12,5,258,16,21,-5
12,5,259,21,20,1
12,5,260,2,6,-4
12,5,261,5,24,-19
12,5,262,11,20,-9
12,5,263,17,10,7
12,5,264,6,8,-2
12,5,265,19,13,6
12,5,266,10,18,-8
12,5,267,19,25,-6
12,5,268,9,9,0
12,5,269,17,17,0
12,5,270,3,15,-12
12,5,271,12,25,-13
12,5,272,20,14,6
12,5,273,7,18,-11
12,5,274,11,18,-7
12,5,275,13,22,-9
12,5,276,6,15,-9
12,5,277,16,16,0
12,5,278,17,14,3
12,5,279,4,30,-26
12,5,280,7,11,-4
12,5,281,8,12,-4
12,5,282,20,20,0
12,5,283,13,20,-7
12,5,284,4,19,-15
12,5,285,9,14,-5
12,5,286,18,12,6
12,5,287,6,16,-10
12,5,288,9,16,-7
12,5,289,14,14,0
12,5,290,11,9,2
12,5,291,11,23,-12
12,5,292,7,15,-8
12,5,293,14,21,-7
12,5,294,10,19,-9
12,5,295,15,14,1
12,5,296,15,24,-9
12,5,297,3,9,-6
12,5,298,9,28,-19
12,5,299,20,26,-6
12,6,0,6,24,-18
12,6,1,5,20,-15
12,6,2,7,15,-8
12,6,3,15,33,-18
12,6,4,12,7,5
12,6,5,15,19,-4
12,6,6,10,18,-8
12,6,7,20,21,-1
12,6,8,1,9,-8
12,6,9,13,12,1
12,6,10,16,18,-2
12,6,11,17,21,-4
12,6,12,13,14,-1
12,6,13,18,20,-2
12,6,14,4,14,-10
12,6,15,8,24,-16
12,6,16,27,27,0
12,6,17,15,21,-6
12,6,18,10,11,-1
12,6,19,7,10,-3
12,6,20,14,21,-7
12,6,21,12,21,-9
12,6,22,4,18,-14
12,6,23,9,8,1
12,6,24,20,19,1
12,6,25,6,14,-8
12,6,26,24,26,-2
12,6,27,23,28,-5
12,6,28,14,34,-20
12,6,29,8,29,-21
12,6,30,12,27,-15
12,6,31,17,23,-6
12,6,32,6,22,-16
12,6,33,14,17,-3
12,6,34,13,17,-4
12,6,35,7,9,-2
12,6,36,5,10,-5
12,6,37,6,8,-2
12,6,38,11,13,-2
12,6,39,14,21,-7
12,6,40,22,21,1
12,6,41,3,20,-17
12,6,42,9,7,2
12,6,43,16,27,-11
12,6,44,20,10,10
12,6,45,15,14,1
12,6,46,10,14,-4
12,6,47,7,5,2
12,6,48,14,26,-12
12,6,49,13,17,-4
12,6,50,6,13,-7
12,6,51,15,25,-10
12,6,52,5,24,-19
12,6,53,6,5,1
12,6,54,13,14,-1
12,6,55,4,6,-2
12,6,56,11,14,-3
12,6,57,30,28,2
12,6,58,14,22,-8
12,6,59,22,15,7
12,6,60,15,19,-4
12,6,61,15,17,-2
12,6,62,15,24,-9
12,6,63,13,19,-6
12,6,64,10,10,0
12,6,65,11,16,-5
12,6,66,10,21,-11
12,6,67,8,13,-5
12,6,68,15,37,-22
12,6,69,10,12,-2
12,6,70,10,18,-8
12,6,71,11,26,-15
12,6,72,17,17,0
12,6,73,9,29,-20
12,6,74,12,9,3
12,6,75,9,14,-5
12,6,76,16,21,-5
12,6,77,14,17,-3
12,6,78,19,11,8
12,6,79,10,25,-15
12,6,80,14,23,-9
12,6,81,12,13,-1
12,6,82,12,18,-6
12,6,83,7,19,-12
12,6,84,4,9,-5
12,6,85,5,11,-6
12,6,86,13,10,3
12,6,87,16,18,-2
12,6,88,18,19,-1
12,6,89,13,9,4
12,6,90,19,20,-1
12,6,91,6,9,-3
12,6,92,25,21,4
12,6,93,19,25,-6
12,6,94,14,10,4
12,6,95,14,24,-10
12,6,96,15,21,-6
12,6,97,4,27,-23
12,6,98,20,20,0
12,6,99,17,23,-6
12,6,100,14,26,-12
12,6,101,11,17,-6
12,6,102,13,14,-1
12,6,103,6,19,-13
12,6,104,23,16,7
12,6,105,18,21,-3
12,6,106,6,24,-18
12,6,107,17,12,5
12,6,108,9,23,-14
12,6,109,13,16,-3
12,6,110,16,15,1
12,6,111,19,11,8
12,6,112,20,30,-10
12,6,113,16,9,7
12,6,114,8,15,-7
12,6,115,20,27,-7
12,6,116,9,25,-16
12,6,117,7,5,2
12,6,118,7,18,-11
12,6,119,10,21,-11
12,6,120,16,28,-12
12,6,121,12,23,-11
12,6,122,8,17,-9
12,6,123,8,10,-2
12,6,124,16,12,4
12,6,125,9,14,-5
12,6,126,8,10,-2
12,6,127,8,12,-4
12,6,128,8,20,-12
12,6,129,22,21,1
12,6,130,12,25,-13
12,6,131,7,22,-15
12,6,132,6,2,4
12,6,133,27,17,10
12,6,134,20,17,3
12,6,135,15,15,0
12,6,136,13,24,-11
12,6,137,17,23,-6
12,6,138,24,15,9
12,6,139,3,26,-23
12,6,140,10,16,-6
12,6,141,15,18,-3
12,6,142,14,24,-10
12,6,143,13,34,-21
12,6,144,7,19,-12
12,6,145,5,15,-10
12,6,146,14,12,2
12,6,147,13,20,-7
12,6,148,9,8,1
12,6,149,3,14,-11
12,6,150,11,9,2
12,6,151,6,17,-11
12,6,152,10,15,-5
12,6,153,7,20,-13
12,6,154,15,14,1
12,6,155,17,21,-4
12,6,156,23,19,4
12,6,157,16,25,-9
12,6,158,12,12,0
12,6,159,5,19,-14
12,6,160,14,27,-13
12,6,161,15,19,-4
12,6,162,5,10,-5
12,6,163,10,9,1
12,6,164,4,26,-22
12,6,165,11,11,0
12,6,166,11,27,-16
12,6,167,3,18,-15
12,6,168,6,17,-11
12,6,169,11,15,-4
12,6,170,18,19,-1
12,6,171,1,18,-17
12,6,172,16,20,-4
12,6,173,10,17,-7
12,6,174,8,9,-1
12,6,175,5,23,-18
12,6,176,8,9,-1
12,6,177,11,15,-4
12,6,178,5,20,-15
12,6,179,6,10,-4
12,6,180,3,13,-10
12,6,181,20,21,-1
12,6,182,10,4,6
12,6,183,10,11,-1
12,6,184,8,12,-4
12,6,185,13,16,-3
12,6,186,9,12,-3
12,6,187,24,19,5
12,6,188,13,15,-2
12,6,189,7,10,-3
12,6,190,14,26,-12
12,6,191,11,30,-19
12,6,192,18,17,1
12,6,193,24,11,13
12,6,194,22,20,2
12,6,195,17,14,3
12,6,196,17,23,-6
12,6,197,9,20,-11
12,6,198,8,20,-12
12,6,199,13,32,-19
12,6,200,16,30,-14
12,6,201,6,17,-11
12,6,202,10,14,-4
12,6,203,17,24,-7
12,6,204,11,17,-6
12,6,205,19,29,-10
12,6,206,26,12,14
12,6,207,16,25,-9
12,6,208,13,15,-2
12,6,209,10,27,-17
12,6,210,6,15,-9
12,6,211,17,18,-1
12,6,212,9,9,0
12,6,213,12,14,-2
12,6,214,15,17,-2
12,6,215,13,15,-2
12,6,216,15,9,6
12,6,217,16,21,-5
12,6,218,7,17,-10
12,6,219,12,13,-1
12,6,220,9,9,0
12,6,221,13,16,-3
12,6,222,8,26,-18
12,6,223,11,15,-4
12,6,224,15,19,-4
12,6,225,14,10,4
12,6,226,9,17,-8
12,6,227,20,23,-3
12,6,228,15,17,-2
12,6,229,19,22,-3
12,6,230,10,14,-4
12,6,231,14,31,-17
12,6,232,13,15,-2
12,6,233,11,25,-14
12,6,234,9,15,-6
12,6,235,14,20,-6
12,6,236,8,8,0
12,6,237,6,18,-12
12,6,238,19,13,6
12,6,239,17,14,3
12,6,240,9,34,-25
12,6,241,13,15,-2
12,6,242,15,19,-4
12,6,243,13,23,-10
12,6,244,8,20,-12
12,6,245,4,19,-15
12,6,246,8,20,-12
12,6,247,6,24,-18
12,6,248,19,19,0
12,6,249,16,28,-12
12,6,250,14,26,-12
12,6,251,11,17,-6
12,6,252,8,19,-11
12,6,253,6,4,2
12,6,254,10,20,-10
12,6,255,11,24,-13
12,6,256,6,17,-11
12,6,257,4,18,-14
12,6,258,14,23,-9
12,6,259,3,15,-12
12,6,260,15,15,0
12,6,261,12,12,0
12,6,262,9,12,-3
12,6,263,20,30,-10
12,6,264,3,18,-15
12,6,265,14,14,0
12,6,266,11,23,-12
12,6,267,15,8,7
12,6,268,14,44,-30
12,6,269,16,26,-10
12,6,270,12,15,-3
12,6,271,9,17,-8
12,6,272,6,19,-13
12,6,273,16,25,-9
12,6,274,12,12,0
12,6,275,10,10,0
12,6,276,12,23,-11
12,6,277,6,28,-22
12,6,278,17,29,-12
12,6,279,15,25,-10
12,6,280,4,9,-5
12,6,281,5,15,-10
12,6,282,11,10,1
12,6,283,16,28,-12
12,6,284,5,17,-12
12,6,285,17,35,-18
12,6,286,18,22,-4
12,6,287,8,22,-14
12,6,288,12,16,-4
12,6,289,10,12,-2
12,6,290,16,19,-3
12,6,291,7,27,-20
12,6,292,8,12,-4
12,6,293,3,16,-13
12,6,294,18,27,-9
12,6,295,8,15,-7
12,6,296,12,15,-3
12,6,297,6,13,-7
12,6,298,14,16,-2
12,6,299,9,12,-3
12,7,0,15,8,7
12,7,1,8,14,-6
12,7,2,14,15,-1
12,7,3,15,24,-9
12,7,4,15,15,0
12,7,5,22,24,-2
12,7,6,9,32,-23
12,7,7,13,17,-4
12,7,8,11,15,-4
12,7,9,7,7,0
12,7,10,8,10,-2
12,7,11,20,30,-10
12,7,12,9,18,-9
12,7,13,13,13,0
12,7,14,8,12,-4
12,7,15,10,22,-12
12,7,16,12,12,0
12,7,17,11,30,-19
12,7,18,11,18,-7
12,7,19,32,13,19
12,7,20,15,19,-4
12,7,21,15,23,-8
12,7,22,20,29,-9
12,7,23,20,11,9
12,7,24,12,11,1
12,7,25,7,15,-8
12,7,26,4,13,-9
12,7,27,6,19,-13
12,7,28,11,10,1
12,7,29,19,12,7
12,7,30,23,26,-3
12,7,31,10,13,-3
12,7,32,14,20,-6
12,7,33,18,19,-1
12,7,34,2,1,1
12,7,35,18,16,2
12,7,36,14,18,-4
12,7,37,13,15,-2
12,7,38,20,23,-3
12,7,39,11,19,-8
12,7,40,18,21,-3
12,7,41,11,24,-13
12,7,42,12,22,-10
12,7,43,11,27,-16
12,7,44,16,19,-3
12,7,45,8,11,-3
12,7,46,11,20,-9
12,7,47,14,21,-7
12,7,48,19,16,3
12,7,49,13,14,-1
12,7,50,10,24,-14
12,7,51,12,14,-2
12,7,52,11,42,-31
12,7,53,11,10,1
12,7,54,28,31,-3
12,7,55,15,29,-14
12,7,56,4,11,-7
12,7,57,18,11,7
12,7,58,16,28,-12
12,7,59,14,13,1
12,7,60,5,13,-8
12,7,61,4,10,-6
12,7,62,4,11,-7
12,7,63,7,15,-8
12,7,64,7,15,-8
12,7,65,8,14,-6
12,7,66,20,28,-8
12,7,67,14,34,-20
12,7,68,17,17,0
12,7,69,9,10,-1
12,7,70,22,20,2
12,7,71,15,23,-8
12,7,72,10,12,-2
12,7,73,13,14,-1
12,7,74,16,15,1
12,7,75,7,17,-10
12,7,76,15,12,3
12,7,77,15,17,-2
12,7,78,13,32,-19
12,7,79,19,16,3
12,7,80,16,22,-6
12,7,81,11,7,4
12,7,82,9,21,-12
12,7,83,5,7,-2
12,7,84,12,23,-11
12,7,85,22,25,-3
12,7,86,5,8,-3
12,7,87,8,15,-7
12,7,88,20,17,3
12,7,89,8,23,-15
12,7,90,23,23,0
12,7,91,8,20,-12
12,7,92,7,20,-13
12,7,93,10,11,-1
12,7,94,3,19,-16
12,7,95,8,18,-10
12,7,96,13,24,-11
12,7,97,16,22,-6
12,7,98,13,19,-6
12,7,99,4,5,-1
12,7,100,19,17,2
12,7,101,12,18,-6
12,7,102,5,25,-20
12,7,103,8,17,-9
12,7,104,23,20,3
12,7,105,7,19,-12
12,7,106,14,16,-2
12,7,107,9,34,-25
12,7,108,23,41,-18
12,7,109,6,15,-9
12,7,110,14,24,-10
12,7,111,16,27,-11
12,7,112,11,21,-10
12,7,113,8,6,2
12,7,114,11,25,-14
12,7,115,14,24,-10
12,7,116,14,20,-6
12,7,117,17,33,-16
12,7,118,28,9,19
12,7,119,11,11,0
12,7,120,14,12,2
12,7,121,4,11,-7
12,7,122,11,17,-6
12,7,123,14,26,-12
12,7,124,12,17,-5
12,7,125,19,19,0
12,7,126,11,25,-14
12,7,127,31,34,-3
12,7,128,8,35,-27
12,7,129,24,16,8
12,7,130,9,16,-7
12,7,131,9,11,-2
12,7,132,15,13,2
12,7,133,13,11,2
12,7,134,9,21,-12
12,7,135,10,12,-2
12,7,136,19,12,7
12,7,137,21,17,4
12,7,138,20,21,-1
12,7,139,11,11,0
12,7,140,8,10,-2
12,7,141,9,7,2
12,7,142,16,16,0
12,7,143,22,23,-1
12,7,144,18,19,-1
12,7,145,12,11,1
12,7,146,17,27,-10
12,7,147,30,17,13
12,7,148,12,18,-6
12,7,149,17,16,1
12,7,150,16,15,1
12,7,151,25,13,12
12,7,152,17,27,-10
12,7,153,19,23,-4
12,7,154,17,28,-11
12,7,155,13,27,-14
12,7,156,16,26,-10
12,7,157,19,21,-2
12,7,158,13,14,-1
12,7,159,26,14,12
12,7,160,12,16,-4
12,7,161,6,12,-6
12,7,162,7,24,-17
12,7,163,12,11,1
12,7,164,18,15,3
12,7,165,14,11,3
12,7,166,13,21,-8
12,7,167,14,20,-6
12,7,168,9,19,-10
12,7,169,8,16,-8
12,7,170,14,18,-4
12,7,171,9,11,-2
12,7,172,12,20,-8
12,7,173,13,11,2
12,7,174,16,19,-3
12,7,175,13,22,-9
12,7,176,8,25,-17
12,7,177,25,26,-1
12,7,178,15,24,-9
12,7,179,14,23,-9
12,7,180,11,14,-3
12,7,181,7,21,-14
12,7,182,18,18,0
12,7,183,10,21,-11
12,7,184,6,14,-8
12,7,185,8,23,-15
12,7,186,21,28,-7
12,7,187,21,29,-8
12,7,188,6,10,-4
12,7,189,12,18,-6
12,7,190,14,15,-1
12,7,191,22,21,1
12,7,192,14,12,2
12,7,193,15,16,-1
12,7,194,7,17,-10
12,7,195,10,27,-17
12,7,196,14,8,6
12,7,197,5,14,-9
12,7,198,17,12,5
12,7,199,14,18,-4
12,7,200,22,11,11
12,7,201,18,36,-18
12,7,202,18,21,-3
12,7,203,12,11,1
12,7,204,9,20,-11
12,7,205,4,7,-3
12,7,206,5,24,-19
12,7,207,12,4,8
12,7,208,7,14,-7
12,7,209,10,26,-16
12,7,210,16,15,1
12,7,211,10,25,-15
12,7,212,9,4,5
12,7,213,5,10,-5
12,7,214,15,17,-2
12,7,215,9,18,-9
12,7,216,13,20,-7
12,7,217,11,19,-8
12,7,218,7,16,-9
12,7,219,12,11,1
12,7,220,21,23,-2
12,7,221,11,19,-8
12,7,222,8,19,-11
12,7,223,13,11,2
12,7,224,10,27,-17
12,7,225,2,33,-31
12,7,226,17,25,-8
12,7,227,9,26,-17
12,7,228,10,14,-4
12,7,229,21,12,9
12,7,230,24,26,-2
12,7,231,14,17,-3
12,7,232,6,15,-9
12,7,233,6,23,-17
12,7,234,9,27,-18
12,7,235,6,17,-11
12,7,236,8,15,-7
12,7,237,10,8,2
12,7,238,14,21,-7
12,7,239,26,26,0
12,7,240,13,13,0
12,7,241,19,15,4
12,7,242,12,11,1
12,7,243,14,19,-5
12,7,244,8,17,-9
12,7,245,9,29,-20
12,7,246,14,25,-11
12,7,247,14,16,-2
12,7,248,8,8,0
12,7,249,9,32,-23
12,7,250,20,18,2
12,7,251,8,14,-6
12,7,252,15,9,6
12,7,253,15,21,-6
12,7,254,17,14,3
12,7,255,13,26,-13
12,7,256,15,28,-13
12,7,257,12,14,-2
12,7,258,13,15,-2
12,7,259,15,21,-6
12,7,260,8,7,1
12,7,261,10,22,-12
12,7,262,13,10,3
12,7,263,16,16,0
12,7,264,18,6,12
12,7,265,13,18,-5
12,7,266,15,22,-7
12,7,267,14,13,1
12,7,268,10,18,-8
12,7,269,16,12,4
12,7,270,8,12,-4
12,7,271,14,18,-4
12,7,272,10,24,-14
12,7,273,20,9,11
12,7,274,20,10,10
12,7,275,11,17,-6
12,7,276,9,12,-3
12,7,277,11,11,0
12,7,278,17,25,-8
12,7,279,17,25,-8
12,7,280,6,6,0
12,7,281,14,17,-3
12,7,282,11,27,-16
12,7,283,3,11,-8
12,7,284,13,19,-6
12,7,285,6,7,-1
12,7,286,27,23,4
12,7,287,10,15,-5
12,7,288,3,31,-28
12,7,289,14,11,3
12,7,290,13,8,5
12,7,291,10,19,-9
12,7,292,20,19,1
12,7,293,9,16,-7
12,7,294,14,11,3
12,7,295,17,20,-3
12,7,296,10,14,-4
12,7,297,5,13,-8
12,7,298,14,9,5
12,7,299,7,11,-4
12,8,0,7,22,-15
12,8,1,12,6,6
12,8,2,26,19,7
12,8,3,22,14,8
12,8,4,14,28,-14
12,8,5,4,19,-15
12,8,6,11,30,-19
12,8,7,15,14,1
12,8,8,10,12,-2
12,8,9,10,14,-4
12,8,10,10,9,1
12,8,11,18,36,-18
12,8,12,11,18,-7
12,8,13,9,14,-5
12,8,14,11,20,-9
12,8,15,8,12,-4
12,8,16,16,23,-7
12,8,17,12,19,-7
12,8,18,10,16,-6
12,8,19,9,18,-9
12,8,20,13,14,-1
12,8,21,9,15,-6
12,8,22,19,16,3
12,8,23,12,16,-4
12,8,24,20,19,1
12,8,25,10,22,-12
12,8,26,7,16,-9
12,8,27,10,10,0
12,8,28,12,18,-6
12,8,29,19,24,-5
12,8,30,16,21,-5
12,8,31,11,21,-10
12,8,32,11,9,2
12,8,33,15,14,1
12,8,34,28,12,16
12,8,35,12,6,6
12,8,36,13,9,4
12,8,37,9,23,-14
12,8,38,17,33,-16
12,8,39,15,16,-1
12,8,40,4,6,-2
12,8,41,18,18,0
12,8,42,12,22,-10
12,8,43,2,6,-4
12,8,44,11,17,-6
12,8,45,23,9,14
12,8,46,10,16,-6
12,8,47,4,12,-8
12,8,48,8,20,-12
12,8,49,10,7,3
12,8,50,6,24,-18
12,8,51,10,13,-3
12,8,52,12,35,-23
12,8,53,18,20,-2
12,8,54,4,7,-3
12,8,55,8,10,-2
12,8,56,17,19,-2
12,8,57,9,34,-25
12,8,58,8,16,-8
12,8,59,7,8,-1
12,8,60,17,19,-2
12,8,61,17,18,-1
12,8,62,16,19,-3
12,8,63,19,7,12
12,8,64,19,14,5
12,8,65,14,11,3
12,8,66,10,19,-9
12,8,67,12,18,-6
12,8,68,10,14,-4
12,8,69,9,6,3
12,8,70,5,15,-10
12,8,71,19,26,-7
12,8,72,11,23,-12
12,8,73,23,17,6
12,8,74,11,25,-14
12,8,75,24,26,-2
12,8,76,19,28,-9
12,8,77,9,16,-7
12,8,78,17,25,-8
12,8,79,12,16,-4
12,8,80,6,13,-7
12,8,81,2,8,-6
12,8,82,13,13,0
12,8,83,10,14,-4
12,8,84,12,28,-16
12,8,85,22,37,-15
12,8,86,10,18,-8
12,8,87,7,24,-17
12,8,88,14,16,-2
12,8,89,11,15,-4
12,8,90,9,17,-8
12,8,91,6,24,-18
12,8,92,12,18,-6
12,8,93,16,25,-9
12,8,94,15,10,5
12,8,95,18,17,1
12,8,96,7,14,-7
12,8,97,12,15,-3
12,8,98,14,27,-13
12,8,99,22,15,7
12,8,100,15,17,-2
12,8,101,6,5,1
12,8,102,7,21,-14
12,8,103,18,30,-12
12,8,104,10,17,-7
12,8,105,12,19,-7
12,8,106,11,11,0
12,8,107,12,15,-3
12,8,108,15,14,1
12,8,109,12,13,-1
12,8,110,17,14,3
12,8,111,4,22,-18
12,8,112,7,10,-3
12,8,113,6,14,-8
12,8,114,22,24,-2
12,8,115,12,30,-18
12,8,116,5,11,-6
12,8,117,7,19,-12
12,8,118,6,23,-17
12,8,119,11,10,1
12,8,120,7,31,-24
12,8,121,15,30,-15
12,8,122,9,9,0
12,8,123,12,21,-9
12,8,124,9,10,-1
12,8,125,4,6,-2
12,8,126,7,15,-8
12,8,127,12,19,-7
12,8,128,10,12,-2
12,8,129,8,22,-14
12,8,130,10,20,-10
12,8,131,13,7,6
12,8,132,20,24,-4
12,8,133,13,15,-2
12,8,134,13,19,-6
12,8,135,12,22,-10
12,8,136,5,21,-16
12,8,137,9,14,-5
12,8,138,10,25,-15
12,8,139,11,19,-8
12,8,140,5,16,-11
12,8,141,13,16,-3
12,8,142,12,11,1
12,8,143,4,13,-9
12,8,144,6,16,-10
12,8,145,15,10,5
12,8,146,11,9,2
12,8,147,3,13,-10
12,8,148,6,14,-8
12,8,149,22,21,1
12,8,150,19,9,10
12,8,151,23,19,4
12,8,152,4,11,-7
12,8,153,32,24,8
12,8,154,5,22,-17
12,8,155,15,7,8
12,8,156,20,25,-5
12,8,157,11,25,-14
12,8,158,18,11,7
12,8,159,14,22,-8
12,8,160,12,25,-13
12,8,161,7,18,-11
12,8,162,12,11,1
12,8,163,20,19,1
12,8,164,13,22,-9
12,8,165,7,15,-8
12,8,166,15,15,0
12,8,167,24,15,9
12,8,168,6,16,-10
12,8,169,11,15,-4
12,8,170,14,18,-4
12,8,171,15,16,-1
12,8,172,22,29,-7
12,8,173,25,14,11
12,8,174,12,14,-2
12,8,175,21,8,13
12,8,176,14,10,4
12,8,177,13,24,-11
12,8,178,7,18,-11
12,8,179,7,7,0
12,8,180,9,6,3
12,8,181,18,28,-10
12,8,182,13,28,-15
12,8,183,5,18,-13
12,8,184,16,23,-7
12,8,185,14,17,-3
12,8,186,10,13,-3
12,8,187,6,15,-9
12,8,188,13,30,-17
12,8,189,11,13,-2
12,8,190,11,20,-9
12,8,191,7,22,-15
12,8,192,12,9,3
12,8,193,3,18,-15
12,8,194,5,10,-5
12,8,195,29,23,6
12,8,196,3,16,-13
12,8,197,14,17,-3
12,8,198,14,14,0
12,8,199,20,17,3
12,8,200,9,25,-16
12,8,201,20,18,2
12,8,202,17,14,3
12,8,203,20,12,8
12,8,204,8,10,-2
12,8,205,10,16,-6
12,8,206,21,25,-4
12,8,207,8,17,-9
12,8,208,29,34,-5
12,8,209,9,16,-7
12,8,210,12,10,2
12,8,211,15,13,2
12,8,212,10,19,-9
12,8,213,15,19,-4
12,8,214,16,7,9
12,8,215,10,13,-3
12,8,216,17,17,0
12,8,217,6,15,-9
12,8,218,12,8,4
12,8,219,23,24,-1
12,8,220,19,29,-10
12,8,221,16,13,3
12,8,222,9,14,-5
12,8,223,15,17,-2
12,8,224,11,13,-2
12,8,225,13,24,-11
12,8,226,6,10,-4
12,8,227,17,22,-5
12,8,228,11,5,6
12,8,229,21,19,2
12,8,230,22,23,-1
12,8,231,11,13,-2
12,8,232,25,28,-3
12,8,233,10,16,-6
12,8,234,6,15,-9
12,8,235,18,34,-16
12,8,236,8,13,-5
12,8,237,15,18,-3
12,8,238,6,18,-12
12,8,239,16,18,-2
12,8,240,20,29,-9
12,8,241,14,20,-6
12,8,242,8,11,-3
12,8,243,13,23,-10
12,8,244,22,7,15
12,8,245,23,12,11
12,8,246,13,10,3
12,8,247,11,17,-6
12,8,248,16,15,1
12,8,249,26,30,-4
12,8,250,20,18,2
12,8,251,15,19,-4
12,8,252,18,18,0
12,8,253,6,13,-7
12,8,254,14,25,-11
12,8,255,13,18,-5
12,8,256,8,3,5
12,8,257,10,14,-4
12,8,258,3,13,-10
12,8,259,19,21,-2
12,8,260,19,25,-6
12,8,261,16,11,5
12,8,262,9,14,-5
12,8,263,14,8,6
12,8,264,8,16,-8
12,8,265,11,13,-2
12,8,266,15,24,-9
12,8,267,4,24,-20
12,8,268,12,15,-3
12,8,269,25,34,-9
12,8,270,5,14,-9
12,8,271,5,26,-21
12,8,272,14,13,1
12,8,273,4,15,-11
12,8,274,6,20,-14
12,8,275,13,16,-3
12,8,276,8,11,-3
12,8,277,16,14,2
12,8,278,12,12,0
12,8,279,14,27,-13
12,8,280,20,24,-4
12,8,281,10,19,-9
12,8,282,18,16,2
12,8,283,8,8,0
12,8,284,18,25,-7
12,8,285,15,17,-2
12,8,286,21,4,17
12,8,287,19,32,-13
12,8,288,9,15,-6
12,8,289,15,22,-7
12,8,290,10,19,-9
12,8,291,19,16,3
12,8,292,16,7,9
12,8,293,10,9,1
12,8,294,14,28,-14
12,8,295,15,11,4
12,8,296,13,23,-10
12,8,297,25,20,5
12,8,298,14,17,-3
12,8,299,11,13,-2
12,9,0,19,26,-7
12,9,1,11,9,2
12,9,2,14,14,0
12,9,3,24,20,4
12,9,4,15,14,1
12,9,5,8,16,-8
12,9,6,15,23,-8
12,9,7,11,10,1
12,9,8,24,24,0
12,9,9,13,17,-4
12,9,10,14,19,-5
12,9,11,11,18,-7
12,9,12,22,30,-8
12,9,13,16,11,5
12,9,14,6,7,-1
12,9,15,16,15,1
12,9,16,17,29,-12
12,9,17,10,15,-5
12,9,18,17,19,-2
12,9,19,12,15,-3
12,9,20,16,18,-2
12,9,21,22,29,-7
12,9,22,6,11,-5
12,9,23,12,13,-1
12,9,24,15,16,-1
12,9,25,16,20,-4
12,9,26,12,16,-4
12,9,27,13,22,-9
12,9,28,7,23,-16
12,9,29,11,17,-6
12,9,30,20,18,2
12,9,31,19,23,-4
12,9,32,17,16,1
12,9,33,15,15,0
12,9,34,17,26,-9
12,9,35,4,17,-13
12,9,36,17,26,-9
12,9,37,23,20,3
12,9,38,11,22,-11
12,9,39,12,15,-3
12,9,40,10,17,-7
12,9,41,13,18,-5
12,9,42,15,14,1
12,9,43,12,11,1
12,9,44,13,11,2
12,9,45,22,47,-25
12,9,46,18,23,-5
12,9,47,10,28,-18
12,9,48,20,16,4
12,9,49,9,21,-12
12,9,50,14,15,-1
12,9,51,5,16,-11
12,9,52,15,14,1
12,9,53,19,27,-8
12,9,54,7,24,-17
12,9,55,8,14,-6
12,9,56,13,16,-3
12,9,57,9,9,0
12,9,58,3,20,-17
12,9,59,16,29,-13
12,9,60,10,33,-23
12,9,61,11,19,-8
12,9,62,5,17,-12
12,9,63,12,12,0
12,9,64,22,26,-4
12,9,65,12,25,-13
12,9,66,11,15,-4
12,9,67,8,17,-9
12,9,68,23,24,-1
12,9,69,8,20,-12
12,9,70,20,26,-6
12,9,71,11,9,2
12,9,72,8,12,-4
12,9,73,13,15,-2
12,9,74,4,13,-9
12,9,75,16,28,-12
12,9,76,7,11,-4
12,9,77,16,9,7
12,9,78,14,19,-5
12,9,79,14,25,-11
12,9,80,28,25,3
12,9,81,10,14,-4
12,9,82,26,24,2
12,9,83,14,9,5
12,9,84,16,18,-2
12,9,85,24,25,-1
12,9,86,5,1,4
12,9,87,8,24,-16
12,9,88,20,25,-5
12,9,89,10,13,-3
12,9,90,18,33,-15
12,9,91,18,8,10
12,9,92,11,12,-1
12,9,93,14,14,0
12,9,94,19,27,-8
12,9,95,16,12,4
12,9,96,6,16,-10
12,9,97,21,13,8
12,9,98,5,14,-9
12,9,99,19,29,-10
12,9,100,11,17,-6
12,9,101,14,18,-4
12,9,102,13,31,-18
12,9,103,17,11,6
12,9,104,11,13,-2
12,9,105,14,26,-12
12,9,106,17,10,7
12,9,107,13,11,2
12,9,108,13,21,-8
12,9,109,14,26,-12
12,9,110,15,21,-6
12,9,111,13,15,-2
12,9,112,22,15,7
12,9,113,17,11,6
12,9,114,15,11,4
12,9,115,6,14,-8
12,9,116,6,23,-17
12,9,117,17,36,-19
12,9,118,20,23,-3
12,9,119,17,17,0
12,9,120,18,19,-1
12,9,121,10,8,2
12,9,122,14,21,-7
12,9,123,10,15,-5
12,9,124,12,10,2
12,9,125,10,19,-9
12,9,126,9,14,-5
12,9,127,7,8,-1
12,9,128,15,17,-2
12,9,129,14,17,-3
12,9,130,9,17,-8
12,9,131,8,10,-2
12,9,132,6,12,-6
12,9,133,18,17,1
12,9,134,10,17,-7
12,9,135,16,23,-7
12,9,136,14,17,-3
12,9,137,6,21,-15
12,9,138,16,18,-2
12,9,139,22,16,6
12,9,140,7,11,-4
12,9,141,17,16,1
12,9,142,8,10,-2
12,9,143,15,19,-4
12,9,144,10,13,-3
12,9,145,19,16,3
12,9,146,18,14,4
12,9,147,14,17,-3
12,9,148,9,22,-13
12,9,149,21,23,-2
12,9,150,17,20,-3
12,9,151,13,21,-8
12,9,152,10,10,0
12,9,153,19,24,-5
12,9,154,22,23,-1
12,9,155,8,16,-8
12,9,156,13,22,-9
12,9,157,12,28,-16
12,9,158,12,12,0
12,9,159,9,16,-7
12,9,160,12,40,-28
12,9,161,20,15,5
12,9,162,22,33,-11
12,9,163,8,27,-19
12,9,164,15,13,2
12,9,165,18,17,1
12,9,166,12,21,-9
12,9,167,13,13,0
12,9,168,21,21,0
12,9,169,10,10,0
12,9,170,3,13,-10
12,9,171,14,30,-16
12,9,172,9,15,-6
12,9,173,2,9,-7
12,9,174,10,12,-2
12,9,175,6,14,-8
12,9,176,14,11,3
12,9,177,9,21,-12
12,9,178,20,15,5
12,9,179,10,15,-5
12,9,180,11,9,2
12,9,181,24,12,12
12,9,182,15,17,-2
12,9,183,14,13,1
12,9,184,5,20,-15
12,9,185,22,31,-9
12,9,186,10,25,-15
12,9,187,24,16,8
12,9,188,16,17,-1
12,9,189,4,7,-3
12,9,190,15,19,-4
12,9,191,14,14,0
12,9,192,24,16,8
12,9,193,13,20,-7
12,9,194,25,20,5
12,9,195,23,8,15
12,9,196,22,26,-4
12,9,197,12,23,-11
12,9,198,10,14,-4
12,9,199,19,18,1
12,9,200,13,15,-2
12,9,201,22,24,-2
12,9,202,13,8,5
12,9,203,5,17,-12
12,9,204,16,29,-13
12,9,205,11,29,-18
12,9,206,9,22,-13
12,9,207,13,12,1
12,9,208,17,23,-6
12,9,209,24,14,10
12,9,210,12,15,-3
12,9,211,8,9,-1
12,9,212,18,13,5
12,9,213,12,12,0
12,9,214,11,17,-6
12,9,215,11,15,-4
12,9,216,11,20,-9
12,9,217,12,33,-21
12,9,218,5,11,-6
12,9,219,6,14,-8
12,9,220,15,15,0
12,9,221,10,16,-6
12,9,222,10,13,-3
12,9,223,14,18,-4
12,9,224,33,28,5
12,9,225,12,6,6
12,9,226,12,9,3
12,9,227,3,12,-9
12,9,228,4,20,-16
12,9,229,17,31,-14
12,9,230,24,26,-2
12,9,231,15,22,-7
12,9,232,6,13,-7
12,9,233,11,15,-4
12,9,234,22,20,2
12,9,235,10,19,-9
12,9,236,6,15,-9
12,9,237,11,9,2
12,9,238,12,28,-16
12,9,239,19,7,12
12,9,240,4,9,-5
12,9,241,7,10,-3
12,9,242,17,16,1
12,9,243,7,18,-11
12,9,244,25,28,-3
12,9,245,14,22,-8
12,9,246,8,7,1
12,9,247,5,12,-7
12,9,248,15,19,-4
12,9,249,12,24,-12
12,9,250,12,14,-2
12,9,251,26,24,2
12,9,252,25,30,-5
12,9,253,20,17,3
12,9,254,14,12,2
12,9,255,21,27,-6
12,9,256,26,19,7
12,9,257,17,20,-3
12,9,258,8,15,-7
12,9,259,25,15,10
12,9,260,10,17,-7
12,9,261,15,36,-21
12,9,262,15,17,-2
12,9,263,11,28,-17
12,9,264,15,21,-6
12,9,265,7,6,1
12,9,266,16,25,-9
12,9,267,17,18,-1
12,9,268,2,10,-8
12,9,269,21,28,-7
12,9,270,12,14,-2
12,9,271,11,21,-10
12,9,272,13,16,-3
12,9,273,17,24,-7
12,9,274,7,16,-9
12,9,275,12,9,3
12,9,276,23,21,2
12,9,277,9,8,1
12,9,278,15,19,-4
12,9,279,16,23,-7
12,9,280,22,23,-1
12,9,281,6,20,-14
12,9,282,15,15,0
12,9,283,14,18,-4
12,9,284,23,20,3
12,9,285,10,29,-19
12,9,286,4,6,-2
12,9,287,10,22,-12
12,9,288,20,21,-1
12,9,289,11,14,-3
12,9,290,9,9,0
12,9,291,19,18,1
12,9,292,13,14,-1
12,9,293,11,16,-5
12,9,294,6,27,-21
12,9,295,13,17,-4
12,9,296,10,18,-8
12,9,297,9,15,-6
12,9,298,8,21,-13
12,9,299,14,16,-2
12,10,0,30,25,5
12,10,1,13,23,-10
12,10,2,22,16,6
12,10,3,5,19,-14
12,10,4,11,13,-2
12,10,5,11,16,-5
12,10,6,16,17,-1
12,10,7,8,8,0
12,10,8,5,6,-1
12,10,9,10,18,-8
12,10,10,22,30,-8
12,10,11,9,19,-10
12,10,12,11,26,-15
12,10,13,21,18,3
12,10,14,13,12,1
12,10,15,10,18,-8
12,10,16,15,24,-9
12,10,17,7,14,-7
12,10,18,11,14,-3
12,10,19,18,16,2
12,10,20,10,6,4
12,10,21,10,16,-6
12,10,22,19,16,3
12,10,23,9,18,-9
12,10,24,9,11,-2
12,10,25,9,11,-2
12,10,26,6,11,-5
12,10,27,9,18,-9
12,10,28,13,19,-6
12,10,29,16,7,9
12,10,30,23,20,3
12,10,31,11,20,-9
12,10,32,18,13,5
12,10,33,20,18,2
12,10,34,14,23,-9
12,10,35,15,19,-4
12,10,36,15,7,8
12,10,37,17,24,-7
12,10,38,5,16,-11
12,10,39,10,14,-4
12,10,40,15,22,-7
12,10,41,22,28,-6
12,10,42,10,20,-10
12,10,43,16,18,-2
12,10,44,9,7,2
12,10,45,22,14,8
12,10,46,3,6,-3
12,10,47,16,33,-17
12,10,48,16,6,10
12,10,49,15,25,-10
12,10,50,18,14,4
12,10,51,13,21,-8
12,10,52,15,13,2
12,10,53,10,12,-2
12,10,54,12,19,-7
12,10,55,19,12,7
12,10,56,20,15,5
12,10,57,18,29,-11
12,10,58,10,24,-14
12,10,59,13,17,-4
12,10,60,12,18,-6
12,10,61,14,8,6
12,10,62,21,25,-4
12,10,63,15,29,-14
12,10,64,7,13,-6
12,10,65,13,22,-9
12,10,66,7,13,-6
12,10,67,15,9,6
12,10,68,13,19,-6
12,10,69,24,18,6
12,10,70,15,17,-2
12,10,71,16,12,4
12,10,72,13,19,-6
12,10,73,15,14,1
12,10,74,14,10,4
12,10,75,11,9,2
12,10,76,13,14,-1
12,10,77,14,20,-6
12,10,78,10,10,0
12,10,79,29,28,1
12,10,80,9,12,-3
12,10,81,16,16,0
12,10,82,9,14,-5
12,10,83,17,17,0
12,10,84,14,19,-5
12,10,85,28,13,15
12,10,86,19,17,2
12,10,87,12,16,-4
12,10,88,5,15,-10
12,10,89,8,14,-6
12,10,90,7,12,-5
12,10,91,21,17,4
12,10,92,17,20,-3
12,10,93,11,11,0
12,10,94,23,12,11
12,10,95,4,19,-15
12,10,96,16,19,-3
12,10,97,12,18,-6
12,10,98,12,15,-3
12,10,99,18,18,0
12,10,100,20,14,6
12,10,101,16,5,11
12,10,102,17,25,-8
12,10,103,11,17,-6
12,10,104,17,37,-20
12,10,105,28,26,2
12,10,106,6,30,-24
12,10,107,27,16,11
12,10,108,9,10,-1
12,10,109,10,16,-6
12,10,110,10,7,3
12,10,111,17,13,4
12,10,112,20,12,8
12,10,113,23,20,3
12,10,114,9,19,-10
12,10,115,11,21,-10
12,10,116,14,20,-6
12,10,117,23,20,3
12,10,118,15,18,-3
12,10,119,24,9,15
12,10,120,11,24,-13
12,10,121,11,25,-14
12,10,122,18,24,-6
12,10,123,10,8,2
12,10,124,11,25,-14
12,10,125,22,25,-3
12,10,126,9,14,-5
12,10,127,7,21,-14
12,10,128,14,17,-3
12,10,129,10,22,-12
12,10,130,26,26,0
12,10,131,25,14,11
12,10,132,8,12,-4
12,10,133,13,26,-13
12,10,134,7,10,-3
12,10,135,10,17,-7
12,10,136,11,13,-2
12,10,137,13,15,-2
12,10,138,10,17,-7
12,10,139,5,7,-2
12,10,140,6,13,-7
12,10,141,9,18,-9
12,10,142,17,29,-12
12,10,143,10,12,-2
12,10,144,2,8,-6
12,10,145,17,18,-1
12,10,146,15,19,-4
12,10,147,18,12,6
12,10,148,12,21,-9
12,10,149,8,28,-20
12,10,150,12,13,-1
12,10,151,9,19,-10
12,10,152,20,26,-6
12,10,153,6,11,-5
12,10,154,14,8,6
12,10,155,13,12,1
12,10,156,9,30,-21
12,10,157,16,20,-4
12,10,158,14,13,1
12,10,159,24,31,-7
12,10,160,11,17,-6
12,10,161,14,30,-16
12,10,162,22,20,2
12,10,163,35,17,18
12,10,164,7,24,-17
12,10,165,11,11,0
12,10,166,19,20,-1
12,10,167,33,26,7
12,10,168,18,17,1
12,10,169,10,21,-11
12,10,170,13,20,-7
12,10,171,19,21,-2
12,10,172,12,9,3
12,10,173,13,14,-1
12,10,174,12,19,-7
12,10,175,15,20,-5
12,10,176,10,12,-2
12,10,177,16,23,-7
12,10,178,10,20,-10
12,10,179,13,11,2
12,10,180,15,21,-6
12,10,181,10,24,-14
12,10,182,14,10,4
12,10,183,11,11,0
12,10,184,6,26,-20
12,10,185,16,19,-3
12,10,186,6,7,-1
12,10,187,10,30,-20
12,10,188,18,16,2
12,10,189,7,27,-20
12,10,190,9,15,-6
12,10,191,17,18,-1
12,10,192,18,19,-1
12,10,193,13,23,-10
12,10,194,12,9,3
12,10,195,14,22,-8
12,10,196,7,18,-11
12,10,197,16,8,8
12,10,198,15,22,-7
12,10,199,27,23,4
12,10,200,14,10,4
12,10,201,15,17,-2
12,10,202,13,17,-4
12,10,203,21,23,-2
12,10,204,25,18,7
12,10,205,10,14,-4
12,10,206,8,14,-6
12,10,207,16,13,3
12,10,208,21,18,3
12,10,209,12,13,-1
12,10,210,10,18,-8
12,10,211,13,18,-5
12,10,212,19,12,7
12,10,213,10,18,-8
12,10,214,21,31,-10
12,10,215,10,7,3
12,10,216,23,22,1
12,10,217,24,21,3
12,10,218,10,17,-7
12,10,219,10,12,-2
12,10,220,9,23,-14
12,10,221,15,18,-3
12,10,222,11,11,0
12,10,223,18,18,0
12,10,224,8,16,-8
12,10,225,6,11,-5
12,10,226,18,34,-16
12,10,227,18,12,6
12,10,228,21,31,-10
12,10,229,9,11,-2
12,10,230,24,27,-3
12,10,231,9,19,-10
12,10,232,10,18,-8
12,10,233,19,18,1
12,10,234,9,12,-3
12,10,235,5,18,-13
12,10,236,4,19,-15
12,10,237,32,30,2
12,10,238,13,14,-1
12,10,239,5,9,-4
12,10,240,9,8,1
12,10,241,14,18,-4
12,10,242,22,17,5
12,10,243,18,13,5
12,10,244,16,28,-12
12,10,245,9,7,2
12,10,246,19,29,-10
12,10,247,9,21,-12
12,10,248,17,21,-4
12,10,249,6,18,-12
12,10,250,10,15,-5
12,10,251,20,18,2
12,10,252,18,11,7
12,10,253,11,13,-2
12,10,254,9,12,-3
12,10,255,21,17,4
12,10,256,22,25,-3
12,10,257,8,16,-8
12,10,258,16,17,-1
12,10,259,18,27,-9
12,10,260,17,18,-1
12,10,261,12,8,4
12,10,262,18,20,-2
12,10,263,16,24,-8
12,10,264,16,24,-8
12,10,265,12,14,-2
12,10,266,16,7,9
12,10,267,17,21,-4
12,10,268,22,17,5
12,10,269,21,16,5
12,10,270,16,21,-5
12,10,271,15,12,3
12,10,272,11,8,3
12,10,273,13,24,-11
12,10,274,12,11,1
12,10,275,10,6,4
12,10,276,12,21,-9
12,10,277,10,21,-11
12,10,278,18,21,-3
12,10,279,11,17,-6
12,10,280,9,16,-7
12,10,281,8,12,-4
12,10,282,15,11,4
12,10,283,14,26,-12
12,10,284,11,4,7
12,10,285,9,13,-4
12,10,286,14,24,-10
12,10,287,12,19,-7
12,10,288,11,15,-4
12,10,289,14,16,-2
12,10,290,10,9,1
12,10,291,14,25,-11
12,10,292,6,18,-12
12,10,293,20,23,-3
12,10,294,8,18,-10
12,10,295,14,19,-5
12,10,296,9,20,-11
12,10,297,15,19,-4
12,10,298,9,9,0
12,10,299,10,14,-4
12,11,0,19,21,-2
12,11,1,6,8,-2
12,11,2,10,8,2
12,11,3,18,10,8
12,11,4,9,22,-13
12,11,5,19,20,-1
12,11,6,7,18,-11
12,11,7,24,15,9
12,11,8,17,23,-6
12,11,9,4,13,-9
12,11,10,15,20,-5
12,11,11,12,18,-6
12,11,12,12,22,-10
12,11,13,8,18,-10
12,11,14,14,13,1
12,11,15,17,18,-1
12,11,16,13,8,5
12,11,17,7,9,-2
12,11,18,27,14,13
12,11,19,17,13,4
12,11,20,14,17,-3
12,11,21,9,11,-2
12,11,22,16,14,2
12,11,23,10,10,0
12,11,24,19,14,5
12,11,25,18,18,0
12,11,26,13,20,-7
12,11,27,13,17,-4
12,11,28,15,28,-13
12,11,29,15,21,-6
12,11,30,4,21,-17
12,11,31,4,10,-6
12,11,32,22,18,4
12,11,33,10,24,-14
12,11,34,29,31,-2
12,11,35,13,27,-14
12,11,36,5,15,-10
12,11,37,17,25,-8
12,11,38,16,15,1
12,11,39,13,8,5
12,11,40,11,18,-7
12,11,41,19,20,-1
12,11,42,17,11,6
12,11,43,11,11,0
12,11,44,22,15,7
12,11,45,7,16,-9
12,11,46,7,17,-10
12,11,47,9,8,1
12,11,48,22,17,5
12,11,49,20,24,-4
12,11,50,5,12,-7
12,11,51,8,12,-4
12,11,52,16,30,-14
12,11,53,4,12,-8
12,11,54,9,18,-9
12,11,55,10,18,-8
12,11,56,23,34,-11
12,11,57,11,14,-3
12,11,58,16,23,-7
12,11,59,10,11,-1
12,11,60,21,14,7
12,11,61,23,21,2
12,11,62,16,24,-8
12,11,63,21,27,-6
12,11,64,23,27,-4
12,11,65,17,21,-4
12,11,66,20,22,-2
12,11,67,22,17,5
12,11,68,23,18,5
12,11,69,32,18,14
12,11,70,16,16,0
12,11,71,25,34,-9
12,11,72,9,7,2
12,11,73,7,17,-10
12,11,74,16,6,10
12,11,75,8,15,-7
12,11,76,17,11,6
12,11,77,9,25,-16
12,11,78,6,19,-13
12,11,79,14,16,-2
12,11,80,13,14,-1
12,11,81,14,21,-7
12,11,82,33,9,24
12,11,83,7,14,-7
12,11,84,11,10,1
12,11,85,9,11,-2
12,11,86,22,21,1
12,11,87,19,21,-2
12,11,88,11,15,-4
12,11,89,7,19,-12
12,11,90,5,16,-11
12,11,91,10,19,-9
12,11,92,14,21,-7
12,11,93,17,13,4
12,11,94,27,6,21
12,11,95,25,17,8
12,11,96,17,13,4
12,11,97,14,20,-6
12,11,98,12,19,-7
12,11,99,4,8,-4
12,11,100,16,25,-9
12,11,101,13,24,-11
12,11,102,18,15,3
12,11,103,9,6,3
12,11,104,21,14,7
12,11,105,20,23,-3
12,11,106,18,22,-4
12,11,107,15,28,-13
12,11,108,26,7,19
12,11,109,6,11,-5
12,11,110,19,15,4
12,11,111,19,21,-2
12,11,112,22,11,11
12,11,113,19,8,11
12,11,114,15,11,4
12,11,115,14,13,1
12,11,116,4,9,-5
12,11,117,22,17,5
12,11,118,16,16,0
12,11,119,13,15,-2
12,11,120,11,18,-7
12,11,121,22,14,8
12,11,122,14,19,-5
12,11,123,23,16,7
12,11,124,16,10,6
12,11,125,11,7,4
12,11,126,16,25,-9
12,11,127,9,7,2
12,11,128,19,18,1
12,11,129,25,20,5
12,11,130,14,22,-8
12,11,131,14,12,2
12,11,132,20,21,-1
12,11,133,16,12,4
12,11,134,15,16,-1
12,11,135,22,16,6
12,11,136,21,23,-2
12,11,137,21,13,8
12,11,138,13,20,-7
12,11,139,9,10,-1
12,11,140,15,20,-5
12,11,141,16,16,0
12,11,142,7,6,1
12,11,143,9,9,0
12,11,144,13,28,-15
12,11,145,25,12,13
12,11,146,14,15,-1
12,11,147,19,14,5
12,11,148,14,14,0
12,11,149,16,11,5
12,11,150,18,16,2
12,11,151,12,15,-3
12,11,152,19,21,-2
12,11,153,8,8,0
12,11,154,18,11,7
12,11,155,13,17,-4
12,11,156,19,23,-4
12,11,157,8,18,-10
12,11,158,15,21,-6
12,11,159,18,8,10
12,11,160,21,20,1
12,11,161,12,11,1
12,11,162,10,6,4
12,11,163,25,11,14
12,11,164,8,14,-6
12,11,165,17,18,-1
12,11,166,12,6,6
12,11,167,9,15,-6
12,11,168,18,17,1
12,11,169,19,12,7
12,11,170,12,13,-1
12,11,171,15,30,-15
12,11,172,13,9,4
12,11,173,10,19,-9
12,11,174,10,18,-8
12,11,175,5,28,-23
12,11,176,20,17,3
12,11,177,13,24,-11
12,11,178,7,20,-13
12,11,179,21,20,1
12,11,180,13,16,-3
12,11,181,12,19,-7
12,11,182,2,12,-10
12,11,183,24,18,6
12,11,184,19,15,4
12,11,185,9,7,2
12,11,186,10,19,-9
12,11,187,18,22,-4
12,11,188,8,18,-10
12,11,189,14,14,0
12,11,190,15,9,6
12,11,191,25,19,6
12,11,192,12,9,3
12,11,193,8,9,-1
12,11,194,6,12,-6
12,11,195,18,24,-6
12,11,196,3,20,-17
12,11,197,12,18,-6
12,11,198,6,10,-4
12,11,199,14,17,-3
12,11,200,16,15,1
12,11,201,10,10,0
12,11,202,13,24,-11
12,11,203,9,18,-9
12,11,204,8,11,-3
12,11,205,7,6,1
12,11,206,13,19,-6
12,11,207,10,11,-1
12,11,208,12,7,5
12,11,209,15,17,-2
12,11,210,18,22,-4
12,11,211,9,13,-4
12,11,212,21,30,-9
12,11,213,13,10,3
12,11,214,14,11,3
12,11,215,28,11,17
12,11,216,12,11,1
12,11,217,11,22,-11
12,11,218,11,17,-6
12,11,219,14,26,-12
12,11,220,10,11,-1
12,11,221,9,18,-9
12,11,222,12,24,-12
12,11,223,17,18,-1
12,11,224,23,16,7
12,11,225,15,24,-9
12,11,226,12,30,-18
12,11,227,24,13,11
12,11,228,15,12,3
12,11,229,19,25,-6
12,11,230,8,8,0
12,11,231,13,23,-10
12,11,232,10,16,-6
12,11,233,14,30,-16
12,11,234,13,14,-1
12,11,235,18,19,-1
12,11,236,31,22,9
12,11,237,21,8,13
12,11,238,20,21,-1
12,11,239,16,11,5
12,11,240,24,20,4
12,11,241,7,8,-1
12,11,242,14,11,3
12,11,243,18,32,-14
12,11,244,18,12,6
12,11,245,16,15,1
12,11,246,17,15,2
12,11,247,15,9,6
12,11,248,20,21,-1
12,11,249,20,25,-5
12,11,250,6,9,-3
12,11,251,15,26,-11
12,11,252,18,15,3
12,11,253,11,19,-8
12,11,254,7,15,-8
12,11,255,11,12,-1
12,11,256,32,19,13
12,11,257,14,25,-11
12,11,258,14,11,3
12,11,259,11,13,-2
12,11,260,7,15,-8
12,11,261,14,13,1
12,11,262,16,16,0
12,11,263,14,12,2
12,11,264,14,14,0
12,11,265,20,10,10
12,11,266,17,28,-11
12,11,267,19,19,0
12,11,268,28,20,8
12,11,269,9,15,-6
12,11,270,11,9,2
12,11,271,20,33,-13
12,11,272,12,15,-3
12,11,273,9,16,-7
12,11,274,18,24,-6
12,11,275,13,42,-29
12,11,276,12,15,-3
12,11,277,24,21,3
12,11,278,17,12,5
12,11,279,15,23,-8
12,11,280,18,16,2
12,11,281,16,14,2
12,11,282,7,17,-10
12,11,283,20,31,-11
12,11,284,10,7,3
12,11,285,7,26,-19
12,11,286,12,13,-1
12,11,287,17,16,1
12,11,288,16,22,-6
12,11,289,12,12,0
12,11,290,12,6,6
12,11,291,15,17,-2
12,11,292,11,10,1
12,11,293,15,21,-6
12,11,294,20,12,8
12,11,295,8,6,2
12,11,296,12,14,-2
12,11,297,13,15,-2
12,11,298,27,20,7
12,11,299,17,33,-16
12,12,0,11,34,-23
12,12,1,9,19,-10
12,12,2,8,20,-12
12,12,3,16,22,-6
12,12,4,15,10,5
12,12,5,24,22,2
12,12,6,11,11,0
12,12,7,17,12,5
12,12,8,23,23,0
12,12,9,12,22,-10
12,12,10,14,10,4
12,12,11,12,19,-7
12,12,12,18,12,6
12,12,13,7,9,-2
12,12,14,8,27,-19
12,12,15,16,14,2
12,12,16,17,25,-8
12,12,17,9,24,-15
12,12,18,17,17,0
12,12,19,15,16,-1
12,12,20,10,9,1
12,12,21,7,17,-10
12,12,22,6,25,-19
12,12,23,16,18,-2
12,12,24,17,24,-7
12,12,25,18,25,-7
12,12,26,7,9,-2
12,12,27,10,12,-2
12,12,28,15,30,-15
12,12,29,15,12,3
12,12,30,12,12,0
12,12,31,2,7,-5
12,12,32,6,12,-6
12,12,33,8,19,-11
12,12,34,22,11,11
12,12,35,10,13,-3
12,12,36,16,17,-1
12,12,37,4,11,-7
12,12,38,10,13,-3
12,12,39,11,9,2
12,12,40,9,5,4
12,12,41,18,21,-3
12,12,42,12,25,-13
12,12,43,7,6,1
12,12,44,24,25,-1
12,12,45,18,16,2
12,12,46,9,14,-5
12,12,47,13,18,-5
12,12,48,19,22,-3
12,12,49,3,7,-4
12,12,50,10,5,5
12,12,51,20,12,8
12,12,52,12,8,4
12,12,53,6,11,-5
12,12,54,16,12,4
12,12,55,20,38,-18
12,12,56,21,26,-5
12,12,57,4,23,-19
12,12,58,12,15,-3
12,12,59,10,10,0
12,12,60,15,10,5
12,12,61,12,19,-7
12,12,62,13,21,-8
12,12,63,26,32,-6
12,12,64,10,29,-19
12,12,65,20,19,1
12,12,66,6,18,-12
12,12,67,2,10,-8
12,12,68,2,11,-9
12,12,69,22,20,2
12,12,70,14,9,5
12,12,71,33,19,14
12,12,72,8,19,-11
12,12,73,10,20,-10
12,12,74,12,3,9
12,12,75,10,12,-2
12,12,76,24,19,5
12,12,77,14,11,3
12,12,78,2,11,-9
12,12,79,9,17,-8
12,12,80,14,16,-2
12,12,81,6,4,2
12,12,82,15,21,-6
12,12,83,26,22,4
12,12,84,11,21,-10
12,12,85,17,17,0
12,12,86,12,13,-1
12,12,87,15,13,2
12,12,88,18,16,2
12,12,89,9,23,-14
12,12,90,10,9,1
12,12,91,20,6,14
12,12,92,12,10,2
12,12,93,16,16,0
12,12,94,8,18,-10
12,12,95,11,25,-14
12,12,96,10,22,-12
12,12,97,20,17,3
12,12,98,10,3,7
12,12,99,14,18,-4
12,12,100,21,18,3
12,12,101,25,21,4
12,12,102,14,19,-5
12,12,103,6,12,-6
12,12,104,34,24,10
12,12,105,3,22,-19
12,12,106,17,2,15
12,12,107,29,18,11
12,12,108,19,11,8
12,12,109,7,16,-9
12,12,110,10,23,-13
12,12,111,28,20,8
12,12,112,26,13,13
12,12,113,7,7,0
12,12,114,10,40,-30
12,12,115,5,15,-10
12,12,116,8,17,-9
12,12,117,12,18,-6
12,12,118,7,19,-12
12,12,119,19,12,7
12,12,120,11,11,0
12,12,121,15,25,-10
12,12,122,7,15,-8
12,12,123,10,9,1
12,12,124,13,9,4
12,12,125,11,15,-4
12,12,126,9,11,-2
12,12,127,19,28,-9
12,12,128,12,13,-1
12,12,129,19,24,-5
12,12,130,15,24,-9
12,12,131,6,15,-9
12,12,132,7,12,-5
12,12,133,12,8,4
12,12,134,13,18,-5
12,12,135,15,19,-4
12,12,136,16,10,6
12,12,137,11,11,0
12,12,138,9,21,-12
12,12,139,10,12,-2
12,12,140,14,4,10
12,12,141,6,15,-9
12,12,142,12,18,-6
12,12,143,13,27,-14
12,12,144,9,26,-17
12,12,145,8,10,-2
12,12,146,11,17,-6
12,12,147,10,16,-6
12,12,148,19,25,-6
12,12,149,5,34,-29
12,12,150,13,20,-7
12,12,151,13,19,-6
12,12,152,10,13,-3
12,12,153,19,13,6
12,12,154,9,35,-26
12,12,155,14,10,4
12,12,156,15,11,4
12,12,157,8,16,-8
12,12,158,21,15,6
12,12,159,9,4,5
12,12,160,10,25,-15
12,12,161,14,15,-1
12,12,162,3,8,-5
12,12,163,19,22,-3
12,12,164,13,25,-12
12,12,165,14,22,-8
12,12,166,14,20,-6
12,12,167,10,19,-9
12,12,168,20,28,-8
12,12,169,18,18,0
12,12,170,27,15,12
12,12,171,12,7,5
12,12,172,10,11,-1
12,12,173,12,14,-2
12,12,174,19,16,3
12,12,175,27,27,0
12,12,176,13,15,-2
12,12,177,22,27,-5
12,12,178,22,22,0
12,12,179,19,15,4
12,12,180,9,11,-2
12,12,181,17,21,-4
12,12,182,13,17,-4
12,12,183,11,7,4
12,12,184,19,13,6
12,12,185,14,22,-8
12,12,186,20,15,5
12,12,187,8,6,2
12,12,188,15,25,-10
12,12,189,12,12,0
12,12,190,7,28,-21
12,12,191,12,11,1
12,12,192,25,20,5
12,12,193,30,28,2
12,12,194,14,6,8
12,12,195,13,4,9
12,12,196,5,14,-9
12,12,197,13,13,0
12,12,198,23,24,-1
12,12,199,19,16,3
12,12,200,8,24,-16
12,12,201,11,15,-4
12,12,202,17,21,-4
12,12,203,7,13,-6
12,12,204,10,16,-6
12,12,205,19,13,6
12,12,206,6,13,-7
12,12,207,6,25,-19
12,12,208,8,21,-13
12,12,209,14,5,9
12,12,210,12,12,0
12,12,211,16,5,11
12,12,212,17,8,9
12,12,213,20,16,4
12,12,214,15,18,-3
12,12,215,6,10,-4
12,12,216,12,9,3
12,12,217,11,21,-10
12,12,218,29,14,15
12,12,219,30,22,8
12,12,220,19,19,0
12,12,221,24,16,8
12,12,222,15,19,-4
12,12,223,15,11,4
12,12,224,13,10,3
12,12,225,9,21,-12
12,12,226,22,14,8
12,12,227,11,13,-2
12,12,228,17,17,0
12,12,229,20,21,-1
12,12,230,13,13,0
12,12,231,22,17,5
12,12,232,11,8,3
12,12,233,20,7,13
12,12,234,12,24,-12
12,12,235,15,19,-4
12,12,236,22,17,5
12,12,237,14,20,-6
12,12,238,12,12,0
12,12,239,4,16,-12
12,12,240,35,29,6
12,12,241,16,21,-5
12,12,242,11,17,-6
12,12,243,15,14,1
12,12,244,11,14,-3
12,12,245,21,11,10
12,12,246,18,29,-11
12,12,247,13,16,-3
12,12,248,24,18,6
12,12,249,17,28,-11
12,12,250,13,16,-3
12,12,251,11,23,-12
12,12,252,9,16,-7
12,12,253,10,27,-17
12,12,254,22,17,5
12,12,255,13,19,-6
12,12,256,14,9,5
12,12,257,16,11,5
12,12,258,9,24,-15
12,12,259,8,20,-12
12,12,260,12,12,0
12,12,261,11,19,-8
12,12,262,10,24,-14
12,12,263,12,10,2
12,12,264,15,28,-13
12,12,265,9,12,-3
12,12,266,4,14,-10
12,12,267,13,13,0
12,12,268,15,20,-5
12,12,269,17,14,3
12,12,270,14,15,-1
12,12,271,20,17,3
12,12,272,16,15,1
12,12,273,16,24,-8
12,12,274,3,13,-10
12,12,275,22,10,12
12,12,276,23,8,15
12,12,277,20,21,-1
12,12,278,9,9,0
12,12,279,10,17,-7
12,12,280,8,20,-12
12,12,281,16,15,1
12,12,282,6,14,-8
12,12,283,12,10,2
12,12,284,20,23,-3
12,12,285,21,7,14
12,12,286,10,9,1
12,12,287,16,21,-5
12,12,288,16,12,4
12,12,289,12,13,-1
12,12,290,20,22,-2
12,12,291,21,18,3
12,12,292,16,14,2
12,12,293,10,9,1
12,12,294,12,10,2
12,12,295,19,13,6
12,12,296,21,12,9
12,12,297,11,12,-1
12,12,298,18,13,5
12,12,299,17,27,-10
12,13,0,5,18,-13
12,13,1,18,15,3
12,13,2,4,6,-2
12,13,3,17,14,3
12,13,4,12,28,-16
12,13,5,12,13,-1
12,13,6,14,11,3
12,13,7,9,16,-7
12,13,8,21,15,6
12,13,9,16,26,-10
12,13,10,14,20,-6
12,13,11,10,16,-6
12,13,12,10,11,-1
12,13,13,19,19,0
12,13,14,14,11,3
12,13,15,22,8,14
12,13,16,22,10,12
12,13,17,11,9,2
12,13,18,8,12,-4
12,13,19,15,9,6
12,13,20,24,11,13
12,13,21,7,20,-13
12,13,22,20,14,6
12,13,23,25,24,1
12,13,24,22,17,5
12,13,25,4,13,-9
12,13,26,18,13,5
12,13,27,16,9,7
12,13,28,17,15,2
12,13,29,1,5,-4
12,13,30,24,19,5
12,13,31,22,24,-2
12,13,32,16,20,-4
12,13,33,13,13,0
12,13,34,19,16,3
12,13,35,14,21,-7
12,13,36,11,9,2
12,13,37,12,18,-6
12,13,38,8,11,-3
12,13,39,13,17,-4
12,13,40,6,3,3
12,13,41,25,24,1
12,13,42,3,9,-6
12,13,43,13,9,4
12,13,44,21,18,3
12,13,45,13,21,-8
12,13,46,27,18,9
12,13,47,11,7,4
12,13,48,17,7,10
12,13,49,4,9,-5
12,13,50,12,19,-7
12,13,51,13,21,-8
12,13,52,12,22,-10
12,13,53,23,19,4
12,13,54,17,20,-3
12,13,55,4,10,-6
12,13,56,19,50,-31
12,13,57,15,14,1
12,13,58,11,23,-12
12,13,59,19,12,7
12,13,60,16,4,12
12,13,61,8,17,-9
12,13,62,9,25,-16
12,13,63,15,11,4
12,13,64,12,11,1
12,13,65,20,16,4
12,13,66,8,22,-14
12,13,67,12,41,-29
12,13,68,12,10,2
12,13,69,4,13,-9
12,13,70,12,11,1
12,13,71,11,9,2
12,13,72,16,24,-8
12,13,73,15,21,-6
12,13,74,13,25,-12
12,13,75,18,20,-2
12,13,76,16,10,6
12,13,77,9,18,-9
12,13,78,9,12,-3
12,13,79,14,18,-4
12,13,80,4,10,-6
12,13,81,22,15,7
12,13,82,12,17,-5
12,13,83,21,13,8
12,13,84,15,10,5
12,13,85,8,5,3
12,13,86,9,22,-13
12,13,87,11,19,-8
12,13,88,12,4,8
12,13,89,15,6,9
12,13,90,17,13,4
12,13,91,14,17,-3
12,13,92,17,18,-1
12,13,93,24,24,0
12,13,94,11,21,-10
12,13,95,12,18,-6
12,13,96,19,20,-1
12,13,97,7,11,-4
12,13,98,8,14,-6
12,13,99,7,15,-8
12,13,100,20,16,4
12,13,101,5,14,-9
12,13,102,23,20,3
12,13,103,18,9,9
12,13,104,21,17,4
12,13,105,6,16,-10
12,13,106,12,10,2
12,13,107,11,17,-6
12,13,108,16,14,2
12,13,109,17,12,5
12,13,110,18,14,4
12,13,111,7,17,-10
12,13,112,13,6,7
12,13,113,8,3,5
12,13,114,17,19,-2
12,13,115,20,14,6
12,13,116,14,20,-6
12,13,117,10,18,-8
12,13,118,13,10,3
12,13,119,9,12,-3
12,13,120,18,19,-1
12,13,121,12,21,-9
12,13,122,13,11,2
12,13,123,11,14,-3
12,13,124,27,14,13
12,13,125,6,22,-16
12,13,126,6,6,0
12,13,127,23,15,8
12,13,128,15,18,-3
12,13,129,14,6,8
12,13,130,12,9,3
12,13,131,21,13,8
12,13,132,11,11,0
12,13,133,11,15,-4
12,13,134,18,18,0
12,13,135,11,16,-5
12,13,136,9,5,4
12,13,137,13,14,-1
12,13,138,18,17,1
12,13,139,25,16,9
12,13,140,5,14,-9
12,13,141,28,26,2
12,13,142,15,24,-9
12,13,143,23,13,10
12,13,144,11,19,-8
12,13,145,11,5,6
12,13,146,8,8,0
12,13,147,11,18,-7
12,13,148,7,25,-18
12,13,149,8,9,-1
12,13,150,7,6,1
12,13,151,13,11,2
12,13,152,11,16,-5
12,13,153,12,13,-1
12,13,154,26,32,-6
12,13,155,10,11,-1
12,13,156,4,20,-16
12,13,157,22,16,6
12,13,158,10,11,-1
12,13,159,13,9,4
12,13,160,31,29,2
12,13,161,5,14,-9
12,13,162,20,12,8
12,13,163,11,11,0
12,13,164,16,19,-3
12,13,165,20,26,-6
12,13,166,31,30,1
12,13,167,18,13,5
12,13,168,15,14,1
12,13,169,13,13,0
12,13,170,14,10,4
12,13,171,21,12,9
12,13,172,10,26,-16
12,13,173,7,11,-4
12,13,174,10,25,-15
12,13,175,22,13,9
12,13,176,24,12,12
12,13,177,15,17,-2
12,13,178,9,15,-6
12,13,179,9,14,-5
12,13,180,9,26,-17
12,13,181,26,22,4
12,13,182,8,19,-11
12,13,183,26,10,16
12,13,184,17,18,-1
12,13,185,22,19,3
12,13,186,18,14,4
12,13,187,8,9,-1
12,13,188,20,15,5
12,13,189,10,23,-13
12,13,190,11,11,0
12,13,191,27,14,13
12,13,192,12,14,-2
12,13,193,17,18,-1
12,13,194,11,24,-13
12,13,195,16,18,-2
12,13,196,20,17,3
12,13,197,16,12,4
12,13,198,11,12,-1
12,13,199,21,16,5
12,13,200,17,14,3
12,13,201,20,40,-20
12,13,202,9,15,-6
12,13,203,26,23,3
12,13,204,20,17,3
12,13,205,13,20,-7
12,13,206,14,18,-4
12,13,207,17,18,-1
12,13,208,17,12,5
12,13,209,12,23,-11
12,13,210,10,17,-7
12,13,211,20,12,8
12,13,212,14,12,2
12,13,213,9,10,-1
12,13,214,14,16,-2
12,13,215,18,15,3
12,13,216,16,11,5
12,13,217,12,5,7
12,13,218,6,8,-2
12,13,219,11,16,-5
12,13,220,13,18,-5
12,13,221,14,22,-8
12,13,222,16,26,-10
12,13,223,17,11,6
12,13,224,7,10,-3
12,13,225,13,13,0
12,13,226,11,14,-3
12,13,227,17,24,-7
12,13,228,10,12,-2
12,13,229,13,13,0
12,13,230,20,21,-1
12,13,231,12,25,-13
12,13,232,13,17,-4
12,13,233,9,7,2
12,13,234,10,8,2
12,13,235,5,12,-7
12,13,236,17,29,-12
12,13,237,7,8,-1
12,13,238,9,2,7
12,13,239,14,30,-16
12,13,240,14,11,3
12,13,241,26,20,6
12,13,242,18,13,5
12,13,243,12,12,0
12,13,244,16,20,-4
12,13,245,17,17,0
12,13,246,16,16,0
12,13,247,10,11,-1
12,13,248,22,19,3
12,13,249,14,18,-4
12,13,250,21,19,2
12,13,251,12,13,-1
12,13,252,23,10,13
12,13,253,15,20,-5
12,13,254,2,21,-19
12,13,255,17,16,1
12,13,256,6,11,-5
12,13,257,9,18,-9
12,13,258,8,21,-13
12,13,259,19,20,-1
12,13,260,17,20,-3
12,13,261,22,15,7
12,13,262,17,25,-8
12,13,263,15,16,-1
12,13,264,20,20,0
12,13,265,11,13,-2
12,13,266,16,6,10
12,13,267,13,23,-10
12,13,268,29,18,11
12,13,269,18,15,3
12,13,270,8,7,1
12,13,271,9,11,-2
12,13,272,21,19,2
12,13,273,19,7,12
12,13,274,19,22,-3
12,13,275,20,13,7
12,13,276,21,15,6
12,13,277,14,17,-3
12,13,278,12,17,-5
12,13,279,13,25,-12
12,13,280,13,12,1
12,13,281,22,29,-7
12,13,282,10,24,-14
12,13,283,25,10,15
12,13,284,11,9,2
12,13,285,15,28,-13
12,13,286,20,13,7
12,13,287,13,11,2
12,13,288,7,30,-23
12,13,289,16,16,0
12,13,290,21,23,-2
12,13,291,33,17,16
12,13,292,31,32,-1
12,13,293,12,19,-7
12,13,294,33,22,11
12,13,295,19,22,-3
12,13,296,19,22,-3
12,13,297,13,9,4
12,13,298,8,12,-4
12,13,299,17,10,7
12,14,0,14,16,-2
12,14,1,11,8,3
12,14,2,20,19,1
12,14,3,13,19,-6
12,14,4,4,7,-3
12,14,5,19,24,-5
12,14,6,14,24,-10
12,14,7,10,19,-9
12,14,8,21,22,-1
12,14,9,10,24,-14
12,14,10,17,10,7
12,14,11,22,8,14
12,14,12,22,15,7
12,14,13,6,7,-1
12,14,14,22,14,8
12,14,15,24,22,2
12,14,16,10,14,-4
12,14,17,15,24,-9
12,14,18,24,26,-2
12,14,19,8,16,-8
12,14,20,16,15,1
12,14,21,22,17,5
12,14,22,15,17,-2
12,14,23,12,6,6
12,14,24,35,20,15
12,14,25,11,7,4
12,14,26,13,9,4
12,14,27,15,9,6
12,14,28,16,12,4
12,14,29,24,20,4
12,14,30,15,8,7
12,14,31,20,15,5
12,14,32,12,12,0
12,14,33,18,19,-1
12,14,34,18,8,10
12,14,35,16,28,-12
12,14,36,10,17,-7
12,14,37,23,30,-7
12,14,38,32,23,9
12,14,39,11,3,8
12,14,40,16,6,10
12,14,41,16,13,3
12,14,42,25,24,1
12,14,43,20,9,11
12,14,44,11,19,-8
12,14,45,6,11,-5
12,14,46,14,15,-1
12,14,47,19,11,8
12,14,48,20,4,16
12,14,49,25,21,4
12,14,50,12,29,-17
12,14,51,11,15,-4
12,14,52,6,9,-3
12,14,53,19,21,-2
12,14,54,27,20,7
12,14,55,14,15,-1
12,14,56,11,17,-6
12,14,57,25,15,10
12,14,58,19,10,9
12,14,59,19,17,2
12,14,60,16,15,1
12,14,61,15,19,-4
12,14,62,12,9,3
12,14,63,13,16,-3
12,14,64,13,14,-1
12,14,65,10,11,-1
12,14,66,19,20,-1
12,14,67,18,17,1
12,14,68,7,12,-5
12,14,69,12,10,2
12,14,70,11,8,3
12,14,71,25,18,7
12,14,72,9,12,-3
12,14,73,16,10,6
12,14,74,6,21,-15
12,14,75,22,10,12
12,14,76,10,6,4
12,14,77,14,15,-1
12,14,78,13,8,5
12,14,79,13,9,4
12,14,80,22,29,-7
12,14,81,19,12,7
12,14,82,8,9,-1
12,14,83,23,18,5
12,14,84,6,11,-5
12,14,85,17,14,3
12,14,86,18,16,2
12,14,87,4,11,-7
12,14,88,28,14,14
12,14,89,18,30,-12
12,14,90,15,23,-8
12,14,91,17,12,5
12,14,92,21,29,-8
12,14,93,16,23,-7
12,14,94,11,15,-4
12,14,95,22,24,-2
12,14,96,13,27,-14
12,14,97,12,16,-4
12,14,98,23,8,15
12,14,99,9,12,-3
12,14,100,21,21,0
12,14,101,18,26,-8
12,14,102,11,8,3
12,14,103,18,20,-2
12,14,104,7,22,-15
12,14,105,25,16,9
12,14,106,9,6,3
12,14,107,13,11,2
12,14,108,19,14,5
12,14,109,19,10,9
12,14,110,18,31,-13
12,14,111,14,17,-3
12,14,112,16,12,4
12,14,113,26,10,16
12,14,114,11,17,-6
12,14,115,7,16,-9
12,14,116,15,12,3
12,14,117,20,25,-5
12,14,118,14,13,1
12,14,119,24,19,5
12,14,120,3,12,-9
12,14,121,17,10,7
12,14,122,12,11,1
12,14,123,14,9,5
12,14,124,21,19,2
12,14,125,13,15,-2
12,14,126,9,7,2
12,14,127,22,19,3
12,14,128,18,11,7
12,14,129,24,7,17
12,14,130,12,14,-2
12,14,131,11,3,8
12,14,132,18,16,2
12,14,133,10,19,-9
12,14,134,10,18,-8
12,14,135,16,11,5
12,14,136,17,22,-5
12,14,137,14,12,2
12,14,138,23,16,7
12,14,139,22,14,8
12,14,140,7,15,-8
12,14,141,11,19,-8
12,14,142,10,17,-7
12,14,143,15,14,1
12,14,144,22,5,17
12,14,145,21,20,1
12,14,146,20,21,-1
12,14,147,12,20,-8
12,14,148,14,20,-6
12,14,149,19,14,5
12,14,150,18,11,7
12,14,151,10,11,-1
12,14,152,13,16,-3
12,14,153,12,25,-13
12,14,154,8,12,-4
12,14,155,29,26,3
12,14,156,13,17,-4
12,14,157,20,8,12
12,14,158,7,18,-11
12,14,159,13,28,-15
12,14,160,20,12,8
12,14,161,20,12,8
12,14,162,16,9,7
12,14,163,17,10,7
12,14,164,11,20,-9
12,14,165,14,14,0
12,14,166,13,27,-14
12,14,167,19,13,6
12,14,168,11,29,-18
12,14,169,13,8,5
12,14,170,26,23,3
12,14,171,1,12,-11
12,14,172,13,21,-8
12,14,173,8,18,-10
12,14,174,21,19,2
12,14,175,8,14,-6
12,14,176,10,11,-1
12,14,177,12,14,-2
12,14,178,12,8,4
12,14,179,18,19,-1
12,14,180,7,12,-5
12,14,181,15,16,-1
12,14,182,17,12,5
12,14,183,19,18,1
12,14,184,17,12,5
12,14,185,13,13,0
12,14,186,13,16,-3
12,14,187,20,12,8
12,14,188,21,10,11
12,14,189,18,2,16
12,14,190,8,21,-13
12,14,191,13,6,7
12,14,192,11,19,-8
12,14,193,22,23,-1
12,14,194,24,17,7
12,14,195,19,16,3
12,14,196,10,15,-5
12,14,197,11,10,1
12,14,198,10,13,-3
12,14,199,19,28,-9
12,14,200,21,34,-13
12,14,201,9,9,0
12,14,202,18,15,3
12,14,203,12,17,-5
12,14,204,11,9,2
12,14,205,26,12,14
12,14,206,11,16,-5
12,14,207,12,5,7
12,14,208,21,13,8
12,14,209,15,25,-10
12,14,210,5,12,-7
12,14,211,23,19,4
12,14,212,20,12,8
12,14,213,8,21,-13
12,14,214,14,9,5
12,14,215,20,21,-1
12,14,216,21,15,6
12,14,217,22,22,0
12,14,218,25,20,5
12,14,219,16,9,7
12,14,220,16,17,-1
12,14,221,10,4,6
12,14,222,13,22,-9
12,14,223,13,18,-5
12,14,224,16,27,-11
12,14,225,14,19,-5
12,14,226,13,22,-9
12,14,227,10,14,-4
12,14,228,17,14,3
12,14,229,14,13,1
12,14,230,22,11,11
12,14,231,10,18,-8
12,14,232,14,20,-6
12,14,233,12,11,1
12,14,234,11,11,0
12,14,235,21,20,1
12,14,236,11,10,1
12,14,237,23,24,-1
12,14,238,16,6,10
12,14,239,23,12,11
12,14,240,13,22,-9
12,14,241,19,22,-3
12,14,242,8,19,-11
12,14,243,10,16,-6
12,14,244,22,16,6
12,14,245,10,15,-5
12,14,246,9,16,-7
12,14,247,10,3,7
12,14,248,13,9,4
12,14,249,9,16,-7
12,14,250,21,19,2
12,14,251,20,17,3
12,14,252,12,8,4
12,14,253,15,14,1
12,14,254,13,16,-3
12,14,255,24,27,-3
12,14,256,8,15,-7
12,14,257,18,15,3
12,14,258,20,23,-3
12,14,259,7,5,2
12,14,260,26,20,6
12,14,261,7,7,0
12,14,262,21,6,15
12,14,263,20,21,-1
12,14,264,19,14,5
12,14,265,19,22,-3
12,14,266,16,23,-7
12,14,267,17,19,-2
12,14,268,12,9,3
12,14,269,14,19,-5
12,14,270,7,25,-18
12,14,271,7,13,-6
12,14,272,6,12,-6
12,14,273,19,27,-8
12,14,274,9,20,-11
12,14,275,9,15,-6
12,14,276,28,24,4
12,14,277,22,20,2
12,14,278,13,32,-19
12,14,279,5,14,-9
12,14,280,23,24,-1
12,14,281,12,4,8
12,14,282,9,20,-11
12,14,283,23,16,7
12,14,284,17,18,-1
12,14,285,19,15,4
12,14,286,8,7,1
12,14,287,27,18,9
12,14,288,16,16,0
12,14,289,17,6,11
12,14,290,21,12,9
12,14,291,12,12,0
12,14,292,11,23,-12
12,14,293,11,10,1
12,14,294,11,12,-1
12,14,295,32,13,19
12,14,296,18,35,-17
12,14,297,18,30,-12
12,14,298,11,8,3
12,14,299,14,11,3
12,15,0,22,22,0
12,15,1,14,17,-3
12,15,2,19,13,6
12,15,3,20,18,2
12,15,4,19,17,2
12,15,5,9,11,-2
12,15,6,11,12,-1
12,15,7,28,12,16
12,15,8,38,25,13
12,15,9,20,13,7
12,15,10,13,6,7
12,15,11,22,14,8
12,15,12,10,14,-4
12,15,13,15,12,3
12,15,14,12,20,-8
12,15,15,6,7,-1
12,15,16,21,17,4
12,15,17,24,21,3
12,15,18,17,18,-1
12,15,19,19,17,2
12,15,20,20,13,7
12,15,21,33,20,13
12,15,22,23,20,3
12,15,23,13,4,9
12,15,24,13,22,-9
12,15,25,15,5,10
12,15,26,25,13,12
12,15,27,8,16,-8
12,15,28,17,14,3
12,15,29,20,17,3
12,15,30,18,35,-17
12,15,31,16,22,-6
12,15,32,12,16,-4
12,15,33,18,14,4
12,15,34,11,14,-3
12,15,35,16,12,4
12,15,36,16,25,-9
12,15,37,13,21,-8
12,15,38,8,6,2
12,15,39,8,10,-2
12,15,40,19,14,5
12,15,41,6,11,-5
12,15,42,18,14,4
12,15,43,11,13,-2
12,15,44,14,8,6
12,15,45,13,14,-1
12,15,46,18,12,6
12,15,47,16,17,-1
12,15,48,9,15,-6
12,15,49,21,24,-3
12,15,50,7,15,-8
12,15,51,9,36,-27
12,15,52,13,9,4
12,15,53,16,11,5
12,15,54,7,8,-1
12,15,55,19,17,2
12,15,56,17,14,3
12,15,57,14,15,-1
12,15,58,9,14,-5
12,15,59,25,15,10
12,15,60,13,3,10
12,15,61,12,14,-2
12,15,62,10,14,-4
12,15,63,16,20,-4
12,15,64,23,12,11
12,15,65,11,15,-4
12,15,66,8,5,3
12,15,67,18,19,-1
12,15,68,9,7,2
12,15,69,16,26,-10
12,15,70,10,18,-8
12,15,71,13,18,-5
12,15,72,21,23,-2
12,15,73,23,23,0
12,15,74,11,23,-12
12,15,75,10,17,-7
12,15,76,14,14,0
12,15,77,20,19,1
12,15,78,18,13,5
12,15,79,12,13,-1
12,15,80,11,18,-7
12,15,81,19,12,7
12,15,82,21,20,1
12,15,83,30,17,13
12,15,84,24,14,10
12,15,85,9,10,-1
12,15,86,25,16,9
12,15,87,9,14,-5
12,15,88,28,33,-5
12,15,89,8,13,-5
12,15,90,5,29,-24
12,15,91,14,16,-2
12,15,92,20,31,-11
12,15,93,7,11,-4
12,15,94,11,13,-2
12,15,95,8,8,0
12,15,96,14,23,-9
12,15,97,17,8,9
12,15,98,10,16,-6
12,15,99,8,7,1
12,15,100,21,18,3
12,15,101,21,18,3
12,15,102,8,6,2
12,15,103,15,11,4
12,15,104,6,11,-5
12,15,105,14,15,-1
12,15,106,16,16,0
12,15,107,14,22,-8
12,15,108,18,14,4
12,15,109,18,12,6
12,15,110,18,17,1
12,15,111,14,13,1
12,15,112,16,14,2
12,15,113,31,10,21
12,15,114,30,13,17
12,15,115,11,15,-4
12,15,116,21,11,10
12,15,117,9,7,2
12,15,118,17,6,11
12,15,119,14,11,3
12,15,120,16,15,1
12,15,121,22,22,0
12,15,122,9,21,-12
12,15,123,11,18,-7
12,15,124,13,12,1
12,15,125,5,14,-9
12,15,126,16,13,3
12,15,127,13,17,-4
12,15,128,19,10,9
12,15,129,37,17,20
12,15,130,14,12,2
12,15,131,11,23,-12
12,15,132,11,14,-3
12,15,133,20,6,14
12,15,134,22,17,5
12,15,135,21,29,-8
12,15,136,10,15,-5
12,15,137,20,20,0
12,15,138,18,23,-5
12,15,139,28,24,4
12,15,140,14,13,1
12,15,141,9,14,-5
12,15,142,11,24,-13
12,15,143,25,16,9
12,15,144,20,16,4
12,15,145,17,20,-3
12,15,146,7,12,-5
12,15,147,28,23,5
12,15,148,3,18,-15
12,15,149,14,16,-2
12,15,150,21,20,1
12,15,151,17,17,0
12,15,152,16,13,3
12,15,153,16,9,7
12,15,154,14,21,-7
12,15,155,15,10,5
12,15,156,31,14,17
12,15,157,6,10,-4
12,15,158,9,9,0
12,15,159,16,13,3
12,15,160,13,15,-2
12,15,161,13,15,-2
12,15,162,9,12,-3
12,15,163,22,19,3
12,15,164,14,13,1
12,15,165,15,23,-8
12,15,166,8,10,-2
12,15,167,10,6,4
12,15,168,16,8,8
12,15,169,19,11,8
12,15,170,10,11,-1
12,15,171,20,7,13
12,15,172,22,11,11
12,15,173,13,7,6
12,15,174,14,13,1
12,15,175,11,9,2
12,15,176,27,20,7
12,15,177,12,11,1
12,15,178,29,18,11
12,15,179,16,23,-7
12,15,180,14,11,3
12,15,181,11,9,2
12,15,182,11,13,-2
12,15,183,16,17,-1
12,15,184,26,13,13
12,15,185,16,22,-6
12,15,186,12,8,4
12,15,187,20,24,-4
12,15,188,6,16,-10
12,15,189,14,5,9
12,15,190,10,11,-1
12,15,191,6,20,-14
12,15,192,3,14,-11
12,15,193,11,8,3
12,15,194,23,14,9
12,15,195,15,29,-14
12,15,196,14,21,-7
12,15,197,16,17,-1
12,15,198,19,21,-2
12,15,199,22,12,10
12,15,200,11,5,6
12,15,201,17,10,7
12,15,202,8,17,-9
12,15,203,22,32,-10
12,15,204,6,12,-6
12,15,205,19,35,-16
12,15,206,19,9,10
12,15,207,6,17,-11
12,15,208,19,18,1
12,15,209,14,18,-4
12,15,210,17,14,3
12,15,211,12,24,-12
12,15,212,17,20,-3
12,15,213,16,19,-3
12,15,214,13,13,0
12,15,215,16,14,2
12,15,216,10,12,-2
12,15,217,21,18,3
12,15,218,14,18,-4
12,15,219,22,7,15
12,15,220,22,22,0
12,15,221,16,13,3
12,15,222,20,16,4
12,15,223,13,17,-4
12,15,224,9,3,6
12,15,225,34,27,7
12,15,226,11,9,2
12,15,227,24,14,10
12,15,228,5,16,-11
12,15,229,25,19,6
12,15,230,19,23,-4
12,15,231,5,6,-1
12,15,232,21,13,8
12,15,233,27,26,1
12,15,234,10,18,-8
12,15,235,12,13,-1
12,15,236,22,15,7
12,15,237,17,8,9
12,15,238,18,26,-8
12,15,239,28,9,19
12,15,240,6,3,3
12,15,241,24,8,16
12,15,242,14,24,-10
12,15,243,13,11,2
12,15,244,9,14,-5
12,15,245,17,14,3
12,15,246,18,18,0
12,15,247,18,19,-1
12,15,248,3,27,-24
12,15,249,13,14,-1
12,15,250,21,24,-3
12,15,251,16,14,2
12,15,252,16,8,8
12,15,253,28,18,10
12,15,254,8,8,0
12,15,255,22,21,1
12,15,256,27,17,10
12,15,257,10,10,0
12,15,258,11,12,-1
12,15,259,29,24,5
12,15,260,17,14,3
12,15,261,8,3,5
12,15,262,20,20,0
12,15,263,6,19,-13
12,15,264,13,17,-4
12,15,265,7,9,-2
12,15,266,26,13,13
12,15,267,27,12,15
12,15,268,18,21,-3
12,15,269,27,8,19
12,15,270,18,22,-4
12,15,271,9,8,1
12,15,272,21,28,-7
12,15,273,12,15,-3
12,15,274,24,12,12
12,15,275,14,17,-3
12,15,276,14,5,9
12,15,277,19,16,3
12,15,278,19,10,9
12,15,279,10,20,-10
12,15,280,19,19,0
12,15,281,13,16,-3
12,15,282,24,24,0
12,15,283,10,21,-11
12,15,284,12,17,-5
12,15,285,12,23,-11
12,15,286,23,17,6
12,15,287,19,12,7
12,15,288,8,12,-4
12,15,289,24,10,14
12,15,290,18,18,0
12,15,291,8,9,-1
12,15,292,10,13,-3
12,15,293,15,8,7
12,15,294,23,15,8
12,15,295,31,23,8
12,15,296,18,20,-2
12,15,297,18,17,1
12,15,298,11,15,-4
12,15,299,16,12,4
12,16,0,1,16,-15
12,16,1,16,7,9
12,16,2,19,30,-11
12,16,3,11,13,-2
12,16,4,13,9,4
12,16,5,20,20,0
12,16,6,17,9,8
12,16,7,14,20,-6
12,16,8,21,18,3
12,16,9,17,7,10
12,16,10,19,22,-3
12,16,11,13,9,4
12,16,12,19,21,-2
12,16,13,9,15,-6
12,16,14,28,14,14
12,16,15,28,14,14
12,16,16,16,15,1
12,16,17,13,17,-4
12,16,18,22,14,8
12,16,19,14,6,8
12,16,20,13,26,-13
12,16,21,12,16,-4
12,16,22,9,5,4
12,16,23,24,15,9
12,16,24,18,30,-12
12,16,25,21,5,16
12,16,26,18,24,-6
12,16,27,1,4,-3
12,16,28,17,17,0
12,16,29,14,21,-7
12,16,30,13,4,9
12,16,31,8,14,-6
12,16,32,20,27,-7
12,16,33,14,20,-6
12,16,34,16,29,-13
12,16,35,15,10,5
12,16,36,19,14,5
12,16,37,21,18,3
12,16,38,21,23,-2
12,16,39,3,2,1
12,16,40,19,14,5
12,16,41,18,24,-6
12,16,42,12,11,1
12,16,43,17,17,0
12,16,44,19,18,1
12,16,45,12,12,0
12,16,46,9,11,-2
12,16,47,19,18,1
12,16,48,16,14,2
12,16,49,11,8,3
12,16,50,12,8,4
12,16,51,8,15,-7
12,16,52,17,8,9
12,16,53,14,6,8
12,16,54,13,14,-1
12,16,55,15,9,6
12,16,56,9,11,-2
12,16,57,12,4,8
12,16,58,24,23,1
12,16,59,18,17,1
12,16,60,19,22,-3
12,16,61,19,11,8
12,16,62,10,16,-6
12,16,63,14,19,-5
12,16,64,18,10,8
12,16,65,11,7,4
12,16,66,15,14,1
12,16,67,11,7,4
12,16,68,17,24,-7
12,16,69,20,12,8
12,16,70,23,14,9
12,16,71,17,12,5
12,16,72,17,7,10
12,16,73,18,8,10
12,16,74,24,16,8
12,16,75,21,15,6
12,16,76,14,13,1
12,16,77,9,10,-1
12,16,78,21,15,6
12,16,79,20,16,4
12,16,80,11,2,9
12,16,81,5,14,-9
12,16,82,13,9,4
12,16,83,30,29,1
12,16,84,25,23,2
12,16,85,17,7,10
12,16,86,16,14,2
12,16,87,14,15,-1
12,16,88,20,19,1
12,16,89,29,18,11
12,16,90,11,26,-15
12,16,91,17,21,-4
12,16,92,20,17,3
12,16,93,15,9,6
12,16,94,6,7,-1
12,16,95,20,13,7
12,16,96,10,7,3
12,16,97,7,8,-1
12,16,98,16,24,-8
12,16,99,16,9,7
12,16,100,14,15,-1
12,16,101,11,14,-3
12,16,102,15,26,-11
12,16,103,12,21,-9
12,16,104,18,16,2
12,16,105,17,11,6
12,16,106,13,24,-11
12,16,107,19,19,0
12,16,108,19,12,7
12,16,109,20,17,3
12,16,110,24,21,3
12,16,111,16,14,2
12,16,112,14,14,0
12,16,113,21,23,-2
12,16,114,16,10,6
12,16,115,27,24,3
12,16,116,18,15,3
12,16,117,3,2,1
12,16,118,13,19,-6
12,16,119,24,18,6
12,16,120,18,13,5
12,16,121,18,14,4
12,16,122,18,17,1
12,16,123,9,12,-3
12,16,124,13,12,1
12,16,125,26,13,13
12,16,126,15,25,-10
12,16,127,17,23,-6
12,16,128,11,13,-2
12,16,129,14,18,-4
12,16,130,7,8,-1
12,16,131,30,6,24
12,16,132,16,9,7
12,16,133,25,38,-13
12,16,134,19,7,12
12,16,135,25,12,13
12,16,136,10,8,2
12,16,137,22,31,-9
12,16,138,30,22,8
12,16,139,16,16,0
12,16,140,10,10,0
12,16,141,11,9,2
12,16,142,21,12,9
12,16,143,24,14,10
12,16,144,10,9,1
12,16,145,13,14,-1
12,16,146,12,14,-2
12,16,147,24,14,10
12,16,148,11,5,6
12,16,149,23,9,14
12,16,150,31,18,13
12,16,151,10,18,-8
12,16,152,12,16,-4
12,16,153,18,27,-9
12,16,154,11,20,-9
12,16,155,17,21,-4
12,16,156,18,22,-4
12,16,157,12,15,-3
12,16,158,22,12,10
12,16,159,10,3,7
12,16,160,10,25,-15
12,16,161,17,7,10
12,16,162,6,12,-6
12,16,163,6,20,-14
12,16,164,11,17,-6
12,16,165,21,22,-1
12,16,166,15,19,-4
12,16,167,14,7,7
12,16,168,23,15,8
12,16,169,20,12,8
12,16,170,14,29,-15
12,16,171,7,5,2
12,16,172,8,10,-2
12,16,173,27,11,16
12,16,174,12,20,-8
12,16,175,17,10,7
12,16,176,11,13,-2
12,16,177,22,18,4
12,16,178,23,23,0
12,16,179,8,19,-11
12,16,180,10,10,0
12,16,181,22,19,3
12,16,182,14,20,-6
12,16,183,17,7,10
12,16,184,12,18,-6
12,16,185,27,12,15
12,16,186,8,11,-3
12,16,187,10,28,-18
12,16,188,13,15,-2
12,16,189,5,7,-2
12,16,190,18,29,-11
12,16,191,18,12,6
12,16,192,8,16,-8
12,16,193,22,21,1
12,16,194,12,22,-10
12,16,195,21,10,11
12,16,196,12,9,3
12,16,197,22,16,6
12,16,198,25,25,0
12,16,199,13,13,0
12,16,200,9,12,-3
12,16,201,12,10,2
12,16,202,13,11,2
12,16,203,11,14,-3
12,16,204,11,13,-2
12,16,205,19,26,-7
12,16,206,11,20,-9
12,16,207,14,12,2
12,16,208,18,19,-1
12,16,209,20,22,-2
12,16,210,16,20,-4
12,16,211,13,16,-3
12,16,212,28,22,6
12,16,213,16,10,6
12,16,214,16,21,-5
12,16,215,12,16,-4
12,16,216,17,17,0
12,16,217,23,12,11
12,16,218,22,9,13
12,16,219,16,10,6
12,16,220,25,18,7
12,16,221,13,17,-4
12,16,222,21,10,11
12,16,223,15,12,3
12,16,224,16,11,5
12,16,225,20,26,-6
12,16,226,6,15,-9
12,16,227,6,19,-13
12,16,228,21,17,4
12,16,229,17,7,10
12,16,230,16,29,-13
12,16,231,15,5,10
12,16,232,14,11,3
12,16,233,17,14,3
12,16,234,35,26,9
12,16,235,8,9,-1
12,16,236,11,13,-2
12,16,237,15,13,2
12,16,238,11,9,2
12,16,239,15,17,-2
12,16,240,13,21,-8
12,16,241,5,10,-5
12,16,242,9,10,-1
12,16,243,25,43,-18
12,16,244,20,8,12
12,16,245,19,15,4
12,16,246,25,21,4
12,16,247,16,7,9
12,16,248,7,11,-4
12,16,249,13,15,-2
12,16,250,17,26,-9
12,16,251,19,20,-1
12,16,252,16,12,4
12,16,253,28,16,12
12,16,254,27,16,11
12,16,255,19,11,8
12,16,256,17,23,-6
12,16,257,23,17,6
12,16,258,14,16,-2
12,16,259,12,12,0
12,16,260,12,10,2
12,16,261,10,14,-4
12,16,262,19,24,-5
12,16,263,12,14,-2
12,16,264,11,5,6
12,16,265,14,18,-4
12,16,266,18,14,4
12,16,267,20,22,-2
12,16,268,19,31,-12
12,16,269,7,18,-11
12,16,270,26,15,11
12,16,271,18,16,2
12,16,272,11,14,-3
12,16,273,15,15,0
12,16,274,14,17,-3
12,16,275,23,20,3
12,16,276,11,13,-2
12,16,277,5,14,-9
12,16,278,14,15,-1
12,16,279,9,10,-1
12,16,280,14,8,6
12,16,281,14,9,5
12,16,282,22,8,14
12,16,283,14,10,4
12,16,284,13,16,-3
12,16,285,28,22,6
12,16,286,9,21,-12
12,16,287,17,19,-2
12,16,288,3,10,-7
12,16,289,10,14,-4
12,16,290,15,10,5
12,16,291,20,16,4
12,16,292,15,23,-8
12,16,293,19,12,7
12,16,294,7,7,0
12,16,295,9,24,-15
12,16,296,15,12,3
12,16,297,25,25,0
12,16,298,10,21,-11
12,16,299,14,12,2
12,17,0,10,17,-7
12,17,1,9,15,-6
12,17,2,13,14,-1
12,17,3,12,7,5
12,17,4,21,20,1
12,17,5,26,14,12
12,17,6,19,7,12
12,17,7,12,19,-7
12,17,8,16,7,9
12,17,9,18,8,10
12,17,10,8,11,-3
12,17,11,13,17,-4
12,17,12,11,12,-1
12,17,13,25,15,10
12,17,14,5,12,-7
12,17,15,9,5,4
12,17,16,24,18,6
12,17,17,18,15,3
12,17,18,15,18,-3
12,17,19,18,12,6
12,17,20,26,17,9
12,17,21,8,21,-13
12,17,22,12,9,3
12,17,23,14,13,1
12,17,24,12,17,-5
12,17,25,24,12,12
12,17,26,20,16,4
12,17,27,10,26,-16
12,17,28,34,23,11
12,17,29,10,24,-14
12,17,30,15,17,-2
12,17,31,16,9,7
12,17,32,17,23,-6
12,17,33,12,14,-2
12,17,34,29,18,11
12,17,35,14,16,-2
12,17,36,11,15,-4
12,17,37,6,9,-3
12,17,38,21,9,12
12,17,39,17,9,8
12,17,40,12,23,-11
12,17,41,29,18,11
12,17,42,8,19,-11
12,17,43,23,22,1
12,17,44,16,23,-7
12,17,45,26,12,14
12,17,46,9,10,-1
12,17,47,12,5,7
12,17,48,19,11,8
12,17,49,24,23,1
12,17,50,10,12,-2
12,17,51,17,20,-3
12,17,52,17,8,9
12,17,53,10,9,1
12,17,54,24,20,4
12,17,55,26,16,10
12,17,56,18,21,-3
12,17,57,19,19,0
12,17,58,13,14,-1
12,17,59,23,15,8
12,17,60,12,21,-9
12,17,61,4,11,-7
12,17,62,22,21,1
12,17,63,23,25,-2
12,17,64,21,11,10
12,17,65,8,9,-1
12,17,66,11,22,-11
12,17,67,10,14,-4
12,17,68,24,10,14
12,17,69,17,29,-12
12,17,70,22,14,8
12,17,71,6,4,2
12,17,72,16,7,9
12,17,73,20,9,11
12,17,74,27,15,12
12,17,75,14,17,-3
12,17,76,17,27,-10
12,17,77,14,11,3
12,17,78,18,12,6
12,17,79,21,12,9
12,17,80,24,16,8
12,17,81,23,14,9
12,17,82,17,14,3
12,17,83,15,7,8
12,17,84,20,10,10
12,17,85,29,16,13
12,17,86,9,19,-10
12,17,87,14,13,1
12,17,88,11,8,3
12,17,89,11,9,2
12,17,90,20,14,6
12,17,91,11,11,0
12,17,92,8,11,-3
12,17,93,13,19,-6
12,17,94,19,3,16
12,17,95,11,26,-15
12,17,96,12,17,-5
12,17,97,8,7,1
12,17,98,19,23,-4
12,17,99,6,9,-3
12,17,100,15,18,-3
12,17,101,9,14,-5
12,17,102,26,14,12
12,17,103,20,18,2
12,17,104,6,15,-9
12,17,105,3,7,-4
12,17,106,21,5,16
12,17,107,9,23,-14
12,17,108,8,14,-6
12,17,109,9,16,-7
12,17,110,5,10,-5
12,17,111,22,10,12
12,17,112,17,10,7
12,17,113,11,10,1
12,17,114,17,24,-7
12,17,115,13,25,-12
12,17,116,23,18,5
12,17,117,21,26,-5
12,17,118,8,1,7
12,17,119,12,10,2
12,17,120,20,17,3
12,17,121,24,17,7
12,17,122,13,8,5
12,17,123,17,16,1
12,17,124,14,6,8
12,17,125,16,17,-1
12,17,126,15,13,2
12,17,127,9,7,2
12,17,128,5,18,-13
12,17,129,20,14,6
12,17,130,19,24,-5
12,17,131,14,12,2
12,17,132,15,11,4
12,17,133,11,14,-3
12,17,134,8,6,2
12,17,135,18,17,1
12,17,136,11,16,-5
12,17,137,18,10,8
12,17,138,29,23,6
12,17,139,29,12,17
12,17,140,22,19,3
12,17,141,12,14,-2
12,17,142,13,9,4
12,17,143,19,16,3
12,17,144,13,22,-9
12,17,145,13,9,4
12,17,146,21,11,10
12,17,147,12,4,8
12,17,148,31,23,8
12,17,149,19,25,-6
12,17,150,15,20,-5
12,17,151,20,18,2
12,17,152,15,20,-5
12,17,153,13,13,0
12,17,154,22,21,1
12,17,155,18,1,17
12,17,156,14,19,-5
12,17,157,12,14,-2
12,17,158,14,17,-3
12,17,159,16,11,5
12,17,160,21,17,4
12,17,161,5,12,-7
12,17,162,21,24,-3
12,17,163,22,31,-9
12,17,164,15,21,-6
12,17,165,17,10,7
12,17,166,19,5,14
12,17,167,11,15,-4
12,17,168,19,8,11
12,17,169,23,12,11
12,17,170,20,17,3
12,17,171,27,13,14
12,17,172,17,19,-2
12,17,173,8,4,4
12,17,174,13,17,-4
12,17,175,12,6,6
12,17,176,12,7,5
12,17,177,20,5,15
12,17,178,16,7,9
12,17,179,14,23,-9
12,17,180,14,16,-2
12,17,181,15,13,2
12,17,182,15,8,7
12,17,183,12,18,-6
12,17,184,4,6,-2
12,17,185,16,12,4
12,17,186,15,19,-4
12,17,187,16,12,4
12,17,188,19,13,6
12,17,189,12,8,4
12,17,190,16,16,0
12,17,191,18,18,0
12,17,192,19,12,7
12,17,193,18,7,11
12,17,194,15,12,3
12,17,195,21,18,3
12,17,196,13,17,-4
12,17,197,11,11,0
12,17,198,11,28,-17
12,17,199,13,15,-2
12,17,200,13,29,-16
12,17,201,17,7,10
12,17,202,13,12,1
12,17,203,12,17,-5
12,17,204,17,25,-8
12,17,205,13,9,4
12,17,206,11,10,1
12,17,207,18,7,11
12,17,208,19,4,15
12,17,209,13,19,-6
12,17,210,11,12,-1
12,17,211,17,8,9
12,17,212,25,23,2
12,17,213,8,15,-7
12,17,214,4,11,-7
12,17,215,28,14,14
12,17,216,9,12,-3
12,17,217,18,5,13
12,17,218,18,14,4
12,17,219,17,16,1
12,17,220,15,16,-1
12,17,221,13,19,-6
12,17,222,17,12,5
12,17,223,20,6,14
12,17,224,15,10,5
12,17,225,16,22,-6
12,17,226,19,28,-9
12,17,227,28,21,7
12,17,228,23,23,0
12,17,229,18,24,-6
12,17,230,13,33,-20
12,17,231,14,22,-8
12,17,232,13,13,0
12,17,233,16,22,-6
12,17,234,10,8,2
12,17,235,38,13,25
12,17,236,8,16,-8
12,17,237,12,17,-5
12,17,238,17,22,-5
12,17,239,10,15,-5
12,17,240,26,8,18
12,17,241,22,30,-8
12,17,242,16,22,-6
12,17,243,12,9,3
12,17,244,14,19,-5
12,17,245,7,15,-8
12,17,246,10,9,1
12,17,247,23,30,-7
12,17,248,9,10,-1
12,17,249,12,10,2
12,17,250,16,11,5
12,17,251,18,17,1
12,17,252,18,15,3
12,17,253,13,8,5
12,17,254,20,16,4
12,17,255,13,14,-1
12,17,256,13,7,6
12,17,257,10,15,-5
12,17,258,31,19,12
12,17,259,11,6,5
12,17,260,22,15,7
12,17,261,9,18,-9
12,17,262,28,12,16
12,17,263,16,19,-3
12,17,264,20,16,4
12,17,265,16,6,10
12,17,266,5,5,0
12,17,267,25,17,8
12,17,268,15,16,-1
12,17,269,23,20,3
12,17,270,21,20,1
12,17,271,9,21,-12
12,17,272,11,4,7
12,17,273,3,7,-4
12,17,274,9,8,1
12,17,275,18,22,-4
12,17,276,15,15,0
12,17,277,17,16,1
12,17,278,16,10,6
12,17,279,11,9,2
12,17,280,29,24,5
12,17,281,14,17,-3
12,17,282,8,11,-3
12,17,283,22,14,8
12,17,284,15,22,-7
12,17,285,12,8,4
12,17,286,12,14,-2
12,17,287,14,11,3
12,17,288,8,10,-2
12,17,289,12,13,-1
12,17,290,7,4,3
12,17,291,12,9,3
12,17,292,13,20,-7
12,17,293,15,15,0
12,17,294,18,12,6
12,17,295,18,16,2
12,17,296,22,18,4
12,17,297,20,15,5
12,17,298,11,13,-2
12,17,299,19,18,1
12,18,0,10,13,-3
12,18,1,13,14,-1
12,18,2,11,17,-6
12,18,3,9,11,-2
12,18,4,26,11,15
12,18,5,8,6,2
12,18,6,18,20,-2
12,18,7,15,17,-2
12,18,8,20,12,8
12,18,9,7,21,-14
12,18,10,10,23,-13
12,18,11,19,8,11
12,18,12,9,20,-11
12,18,13,13,6,7
12,18,14,22,15,7
12,18,15,12,10,2
12,18,16,17,14,3
12,18,17,9,8,1
12,18,18,6,9,-3
12,18,19,9,22,-13
12,18,20,9,18,-9
12,18,21,19,16,3
12,18,22,12,14,-2
12,18,23,20,14,6
12,18,24,29,11,18
12,18,25,3,12,-9
12,18,26,6,7,-1
12,18,27,14,9,5
12,18,28,30,16,14
12,18,29,23,22,1
12,18,30,20,24,-4
12,18,31,16,15,1
12,18,32,18,20,-2
12,18,33,17,19,-2
12,18,34,21,22,-1
12,18,35,13,15,-2
12,18,36,21,20,1
12,18,37,22,21,1
12,18,38,17,12,5
12,18,39,13,12,1
12,18,40,21,20,1
12,18,41,25,12,13
12,18,42,24,12,12
12,18,43,9,20,-11
12,18,44,16,20,-4
12,18,45,15,10,5
12,18,46,9,15,-6
12,18,47,21,9,12
12,18,48,25,12,13
12,18,49,15,18,-3
12,18,50,17,2,15
12,18,51,6,16,-10
12,18,52,13,5,8
12,18,53,9,10,-1
12,18,54,25,19,6
12,18,55,12,14,-2
12,18,56,15,8,7
12,18,57,25,26,-1
12,18,58,12,17,-5
12,18,59,5,9,-4
12,18,60,15,5,10
12,18,61,26,16,10
12,18,62,16,9,7
12,18,63,29,20,9
12,18,64,11,13,-2
12,18,65,15,15,0
12,18,66,16,12,4
12,18,67,16,19,-3
12,18,68,11,12,-1
12,18,69,20,19,1
12,18,70,12,24,-12
12,18,71,15,12,3
12,18,72,23,27,-4
12,18,73,21,10,11
12,18,74,19,18,1
12,18,75,21,20,1
12,18,76,11,9,2
12,18,77,14,14,0
12,18,78,16,25,-9
12,18,79,13,13,0
12,18,80,19,18,1
12,18,81,20,21,-1
12,18,82,27,22,5
12,18,83,12,25,-13
12,18,84,23,22,1
12,18,85,6,13,-7
12,18,86,8,17,-9
12,18,87,18,11,7
12,18,88,14,23,-9
12,18,89,12,21,-9
12,18,90,17,16,1
12,18,91,20,12,8
12,18,92,21,11,10
12,18,93,14,26,-12
12,18,94,8,9,-1
12,18,95,11,7,4
12,18,96,12,19,-7
12,18,97,15,22,-7
12,18,98,11,15,-4
12,18,99,8,13,-5
12,18,100,16,10,6
12,18,101,16,13,3
12,18,102,13,20,-7
12,18,103,26,17,9
12,18,104,19,12,7
12,18,105,20,31,-11
12,18,106,6,12,-6
12,18,107,21,24,-3
12,18,108,16,14,2
12,18,109,16,13,3
12,18,110,11,24,-13
12,18,111,18,19,-1
12,18,112,10,12,-2
12,18,113,9,13,-4
12,18,114,20,13,7
12,18,115,21,22,-1
12,18,116,20,4,16
12,18,117,14,11,3
12,18,118,9,4,5
12,18,119,22,18,4
12,18,120,8,7,1
12,18,121,15,16,-1
12,18,122,10,7,3
12,18,123,5,19,-14
12,18,124,11,14,-3
12,18,125,21,15,6
12,18,126,11,11,0
12,18,127,21,23,-2
12,18,128,17,10,7
12,18,129,17,12,5
12,18,130,23,12,11
12,18,131,39,9,30
12,18,132,21,22,-1
12,18,133,9,11,-2
12,18,134,11,15,-4
12,18,135,14,17,-3
12,18,136,20,19,1
12,18,137,17,17,0
12,18,138,20,5,15
12,18,139,22,12,10
12,18,140,14,12,2
12,18,141,4,6,-2
12,18,142,21,4,17
12,18,143,12,10,2
12,18,144,4,14,-10
12,18,145,7,10,-3
12,18,146,27,13,14
12,18,147,21,10,11
12,18,148,20,11,9
12,18,149,14,21,-7
12,18,150,18,24,-6
12,18,151,20,12,8
12,18,152,18,19,-1
12,18,153,29,10,19
12,18,154,17,17,0
12,18,155,15,8,7
12,18,156,23,21,2
12,18,157,15,11,4
12,18,158,22,37,-15
12,18,159,19,17,2
12,18,160,23,14,9
12,18,161,14,3,11
12,18,162,10,11,-1
12,18,163,18,26,-8
12,18,164,17,17,0
12,18,165,5,12,-7
12,18,166,20,10,10
12,18,167,19,14,5
12,18,168,22,9,13
12,18,169,35,14,21
12,18,170,7,9,-2
12,18,171,9,19,-10
12,18,172,10,17,-7
12,18,173,8,15,-7
12,18,174,9,3,6
12,18,175,15,16,-1
12,18,176,12,4,8
12,18,177,21,18,3
12,18,178,24,21,3
12,18,179,18,17,1
12,18,180,11,18,-7
12,18,181,9,8,1
12,18,182,17,12,5
12,18,183,10,12,-2
12,18,184,11,7,4
12,18,185,13,20,-7
12,18,186,13,4,9
12,18,187,13,19,-6
12,18,188,16,18,-2
12,18,189,14,16,-2
12,18,190,10,13,-3
12,18,191,9,14,-5
12,18,192,17,13,4
12,18,193,11,6,5
12,18,194,24,27,-3
12,18,195,15,32,-17
12,18,196,11,11,0
12,18,197,8,9,-1
12,18,198,21,16,5
12,18,199,7,12,-5
12,18,200,6,10,-4
12,18,201,26,6,20
12,18,202,18,16,2
12,18,203,11,17,-6
12,18,204,16,15,1
12,18,205,15,14,1
12,18,206,11,22,-11
12,18,207,18,15,3
12,18,208,29,17,12
12,18,209,11,13,-2
12,18,210,14,29,-15
12,18,211,14,17,-3
12,18,212,20,14,6
12,18,213,14,24,-10
12,18,214,35,10,25
12,18,215,12,8,4
12,18,216,19,15,4
12,18,217,10,14,-4
12,18,218,19,35,-16
12,18,219,12,21,-9
12,18,220,9,6,3
12,18,221,8,9,-1
12,18,222,9,18,-9
12,18,223,33,14,19
12,18,224,10,9,1
12,18,225,18,21,-3
12,18,226,26,26,0
12,18,227,19,18,1
12,18,228,10,9,1
12,18,229,17,23,-6
12,18,230,19,6,13
12,18,231,22,16,6
12,18,232,11,9,2
12,18,233,12,19,-7
12,18,234,17,15,2
12,18,235,15,10,5
12,18,236,14,11,3
12,18,237,25,18,7
12,18,238,22,20,2
12,18,239,11,16,-5
12,18,240,16,24,-8
12,18,241,17,18,-1
12,18,242,7,12,-5
12,18,243,19,12,7
12,18,244,21,14,7
12,18,245,21,21,0
12,18,246,15,9,6
12,18,247,16,28,-12
12,18,248,14,13,1
12,18,249,14,16,-2
12,18,250,10,4,6
12,18,251,6,14,-8
12,18,252,6,18,-12
12,18,253,13,20,-7
12,18,254,12,16,-4
12,18,255,15,11,4
12,18,256,31,9,22
12,18,257,20,16,4
12,18,258,10,13,-3
12,18,259,8,9,-1
12,18,260,24,25,-1
12,18,261,16,20,-4
12,18,262,17,15,2
12,18,263,16,13,3
12,18,264,9,9,0
12,18,265,16,20,-4
12,18,266,13,18,-5
12,18,267,9,9,0
12,18,268,30,8,22
12,18,269,17,18,-1
12,18,270,14,8,6
12,18,271,7,4,3
12,18,272,16,6,10
12,18,273,13,11,2
12,18,274,13,8,5
12,18,275,9,8,1
12,18,276,25,16,9
12,18,277,17,12,5
12,18,278,19,11,8
12,18,279,27,11,16
12,18,280,13,18,-5
12,18,281,15,20,-5
12,18,282,19,16,3
12,18,283,14,19,-5
12,18,284,13,14,-1
12,18,285,18,30,-12
12,18,286,17,21,-4
12,18,287,23,19,4
12,18,288,26,20,6
12,18,289,8,20,-12
12,18,290,7,17,-10
12,18,291,16,14,2
12,18,292,16,17,-1
12,18,293,19,23,-4
12,18,294,14,22,-8
12,18,295,9,3,6
12,18,296,10,13,-3
12,18,297,14,13,1
12,18,298,39,17,22
12,18,299,10,11,-1
12,19,0,12,16,-4
12,19,1,23,18,5
12,19,2,19,20,-1
12,19,3,7,20,-13
12,19,4,26,19,7
12,19,5,20,11,9
12,19,6,21,15,6
12,19,7,12,25,-13
12,19,8,11,10,1
12,19,9,17,14,3
12,19,10,19,21,-2
12,19,11,23,13,10
12,19,12,14,16,-2
12,19,13,13,19,-6
12,19,14,11,6,5
12,19,15,12,12,0
12,19,16,31,10,21
12,19,17,21,20,1
12,19,18,16,20,-4
12,19,19,15,14,1
12,19,20,6,7,-1
12,19,21,11,15,-4
12,19,22,8,3,5
12,19,23,13,22,-9
12,19,24,13,21,-8
12,19,25,17,5,12
12,19,26,21,19,2
12,19,27,29,25,4
12,19,28,20,12,8
12,19,29,14,19,-5
12,19,30,19,21,-2
12,19,31,22,24,-2
12,19,32,11,5,6
12,19,33,17,16,1
12,19,34,8,10,-2
12,19,35,22,21,1
12,19,36,20,32,-12
12,19,37,25,13,12
12,19,38,29,24,5
12,19,39,18,19,-1
12,19,40,17,19,-2
12,19,41,16,11,5
12,19,42,10,18,-8
12,19,43,21,23,-2
12,19,44,22,11,11
12,19,45,12,14,-2
12,19,46,18,12,6
12,19,47,35,18,17
12,19,48,22,15,7
12,19,49,12,7,5
12,19,50,20,22,-2
12,19,51,16,15,1
12,19,52,10,14,-4
12,19,53,15,18,-3
12,19,54,24,21,3
12,19,55,18,14,4
12,19,56,22,19,3
12,19,57,10,12,-2
12,19,58,14,11,3
12,19,59,12,6,6
12,19,60,16,16,0
12,19,61,6,13,-7
12,19,62,12,7,5
12,19,63,19,25,-6
12,19,64,25,13,12
12,19,65,19,13,6
12,19,66,17,14,3
12,19,67,14,24,-10
12,19,68,9,7,2
12,19,69,22,11,11
12,19,70,21,10,11
12,19,71,24,14,10
12,19,72,17,18,-1
12,19,73,10,12,-2
12,19,74,11,14,-3
12,19,75,10,7,3
12,19,76,17,19,-2
12,19,77,10,18,-8
12,19,78,25,28,-3
12,19,79,18,17,1
12,19,80,14,17,-3
12,19,81,13,13,0
12,19,82,12,12,0
12,19,83,16,8,8
12,19,84,11,15,-4
12,19,85,19,14,5
12,19,86,20,21,-1
12,19,87,24,23,1
12,19,88,19,19,0
12,19,89,14,10,4
12,19,90,22,11,11
12,19,91,4,10,-6
12,19,92,21,14,7
12,19,93,17,8,9
12,19,94,23,10,13
12,19,95,27,18,9
12,19,96,21,16,5
12,19,97,25,8,17
12,19,98,23,19,4
12,19,99,22,18,4
12,19,100,20,15,5
12,19,101,16,8,8
12,19,102,19,9,10
12,19,103,6,13,-7
12,19,104,9,15,-6
12,19,105,23,18,5
12,19,106,20,21,-1
12,19,107,16,12,4
12,19,108,14,14,0
12,19,109,8,21,-13
12,19,110,20,12,8
12,19,111,22,11,11
12,19,112,14,11,3
12,19,113,17,8,9
12,19,114,22,27,-5
12,19,115,8,7,1
12,19,116,11,14,-3
12,19,117,11,9,2
12,19,118,15,21,-6
12,19,119,15,23,-8
12,19,120,9,11,-2
12,19,121,15,21,-6
12,19,122,13,13,0
12,19,123,16,14,2
12,19,124,14,8,6
12,19,125,12,18,-6
12,19,126,21,25,-4
12,19,127,11,19,-8
12,19,128,7,20,-13
12,19,129,16,12,4
12,19,130,34,27,7
12,19,131,16,12,4
12,19,132,11,8,3
12,19,133,21,15,6
12,19,134,14,10,4
12,19,135,6,5,1
12,19,136,23,17,6
12,19,137,11,19,-8
12,19,138,21,12,9
12,19,139,7,15,-8
12,19,140,26,13,13
12,19,141,14,17,-3
12,19,142,9,16,-7
12,19,143,25,14,11
12,19,144,12,9,3
12,19,145,13,7,6
12,19,146,12,16,-4
12,19,147,20,16,4
12,19,148,14,18,-4
12,19,149,21,14,7
12,19,150,10,12,-2
12,19,151,25,8,17
12,19,152,13,17,-4
12,19,153,16,10,6
12,19,154,15,19,-4
12,19,155,11,14,-3
12,19,156,20,24,-4
12,19,157,12,24,-12
12,19,158,11,4,7
12,19,159,15,20,-5
12,19,160,21,13,8
12,19,161,14,11,3
12,19,162,9,17,-8
12,19,163,16,22,-6
12,19,164,12,19,-7
12,19,165,17,25,-8
12,19,166,18,10,8
12,19,167,5,14,-9
12,19,168,20,11,9
12,19,169,19,19,0
12,19,170,13,24,-11
12,19,171,23,21,2
12,19,172,25,11,14
12,19,173,23,9,14
12,19,174,9,18,-9
12,19,175,24,16,8
12,19,176,8,17,-9
12,19,177,14,22,-8
12,19,178,10,14,-4
12,19,179,8,19,-11
12,19,180,18,21,-3
12,19,181,17,13,4
12,19,182,21,15,6
12,19,183,18,8,10
12,19,184,4,5,-1
12,19,185,23,18,5
12,19,186,24,14,10
12,19,187,23,19,4
12,19,188,13,8,5
12,19,189,7,10,-3
12,19,190,18,12,6
12,19,191,10,15,-5
12,19,192,6,16,-10
12,19,193,30,15,15
12,19,194,25,15,10
12,19,195,19,14,5
12,19,196,12,15,-3
12,19,197,7,19,-12
12,19,198,25,22,3
12,19,199,20,21,-1
12,19,200,17,7,10
12,19,201,14,11,3
12,19,202,24,13,11
12,19,203,17,23,-6
12,19,204,9,14,-5
12,19,205,22,18,4
12,19,206,16,10,6
12,19,207,14,9,5
12,19,208,15,12,3
12,19,209,11,14,-3
12,19,210,4,15,-11
12,19,211,14,11,3
12,19,212,17,20,-3
12,19,213,14,14,0
12,19,214,24,11,13
12,19,215,14,19,-5
12,19,216,26,13,13
12,19,217,11,8,3
12,19,218,12,13,-1
12,19,219,17,13,4
12,19,220,23,16,7
12,19,221,17,15,2
12,19,222,11,25,-14
12,19,223,18,15,3
12,19,224,23,14,9
12,19,225,17,11,6
12,19,226,10,17,-7
12,19,227,23,25,-2
12,19,228,16,11,5
12,19,229,21,24,-3
12,19,230,10,13,-3
12,19,231,10,11,-1
12,19,232,13,12,1
12,19,233,11,20,-9
12,19,234,9,19,-10
12,19,235,17,14,3
12,19,236,9,11,-2
12,19,237,13,13,0
12,19,238,17,18,-1
12,19,239,19,11,8
12,19,240,19,10,9
12,19,241,12,19,-7
12,19,242,15,17,-2
12,19,243,10,9,1
12,19,244,8,17,-9
12,19,245,18,7,11
12,19,246,26,15,11
12,19,247,15,15,0
12,19,248,13,11,2
12,19,249,21,25,-4
12,19,250,16,15,1
12,19,251,10,22,-12
12,19,252,13,21,-8
12,19,253,10,7,3
12,19,254,15,36,-21
12,19,255,15,20,-5
12,19,256,16,9,7
12,19,257,10,9,1
12,19,258,16,20,-4
12,19,259,9,9,0
12,19,260,23,18,5
12,19,261,23,16,7
12,19,262,15,8,7
12,19,263,20,16,4
12,19,264,21,19,2
12,19,265,13,18,-5
12,19,266,14,9,5
12,19,267,21,7,14
12,19,268,24,13,11
12,19,269,17,15,2
12,19,270,26,10,16
12,19,271,15,19,-4
12,19,272,29,22,7
12,19,273,14,9,5
12,19,274,11,4,7
12,19,275,13,14,-1
12,19,276,19,17,2
12,19,277,18,17,1
12,19,278,20,12,8
12,19,279,19,13,6
12,19,280,21,19,2
12,19,281,12,12,0
12,19,282,17,17,0
12,19,283,25,8,17
12,19,284,6,15,-9
12,19,285,7,9,-2
12,19,286,12,15,-3
12,19,287,12,11,1
12,19,288,12,28,-16
12,19,289,18,21,-3
12,19,290,7,10,-3
12,19,291,18,13,5
12,19,292,15,13,2
12,19,293,24,20,4
12,19,294,20,19,1
12,19,295,22,11,11
12,19,296,16,15,1
12,19,297,8,18,-10
12,19,298,14,17,-3
12,19,299,12,9,3
12,20,0,12,9,3
12,20,1,14,8,6
12,20,2,20,10,10
12,20,3,14,13,1
12,20,4,12,12,0
12,20,5,23,14,9
12,20,6,18,11,7
12,20,7,12,8,4
12,20,8,11,18,-7
12,20,9,21,5,16
12,20,10,18,17,1
12,20,11,24,10,14
12,20,12,12,17,-5
12,20,13,8,15,-7
12,20,14,22,22,0
12,20,15,15,12,3
12,20,16,17,19,-2
12,20,17,7,8,-1
12,20,18,25,8,17
12,20,19,17,7,10
12,20,20,24,17,7
12,20,21,10,7,3
12,20,22,33,12,21
12,20,23,26,15,11
12,20,24,7,16,-9
12,20,25,16,7,9
12,20,26,15,14,1
12,20,27,6,18,-12
12,20,28,11,26,-15
12,20,29,12,15,-3
12,20,30,10,28,-18
12,20,31,16,7,9
12,20,32,32,14,18
12,20,33,20,9,11
12,20,34,31,13,18
12,20,35,18,24,-6
12,20,36,15,15,0
12,20,37,17,18,-1
12,20,38,12,9,3
12,20,39,15,12,3
12,20,40,18,7,11
12,20,41,11,8,3
12,20,42,19,17,2
12,20,43,17,9,8
12,20,44,5,19,-14
12,20,45,17,10,7
12,20,46,30,21,9
12,20,47,22,19,3
12,20,48,26,13,13
12,20,49,20,15,5
12,20,50,18,18,0
12,20,51,24,11,13
12,20,52,13,10,3
12,20,53,10,6,4
12,20,54,12,15,-3
12,20,55,12,13,-1
12,20,56,17,16,1
12,20,57,24,14,10
12,20,58,24,19,5
12,20,59,18,21,-3
12,20,60,26,16,10
12,20,61,21,17,4
12,20,62,8,8,0
12,20,63,21,10,11
12,20,64,21,20,1
12,20,65,23,18,5
12,20,66,10,12,-2
12,20,67,20,8,12
12,20,68,6,20,-14
12,20,69,16,13,3
12,20,70,9,17,-8
12,20,71,24,28,-4
12,20,72,17,15,2
12,20,73,15,23,-8
12,20,74,7,8,-1
12,20,75,17,15,2
12,20,76,10,15,-5
12,20,77,21,15,6
12,20,78,19,10,9
12,20,79,18,11,7
12,20,80,19,37,-18
12,20,81,19,16,3
12,20,82,13,9,4
12,20,83,22,6,16
12,20,84,23,19,4
12,20,85,15,20,-5
12,20,86,23,11,12
12,20,87,14,11,3
12,20,88,16,11,5
12,20,89,23,15,8
12,20,90,7,13,-6
12,20,91,21,4,17
12,20,92,18,5,13
12,20,93,17,18,-1
12,20,94,12,11,1
12,20,95,14,17,-3
12,20,96,33,16,17
12,20,97,11,15,-4
12,20,98,25,30,-5
12,20,99,3,10,-7
12,20,100,25,18,7
12,20,101,13,15,-2
12,20,102,14,15,-1
12,20,103,12,12,0
12,20,104,19,11,8
12,20,105,12,17,-5
12,20,106,10,17,-7
12,20,107,15,13,2
12,20,108,26,25,1
12,20,109,10,13,-3
12,20,110,21,15,6
12,20,111,19,18,1
12,20,112,16,11,5
12,20,113,10,18,-8
12,20,114,29,19,10
12,20,115,27,17,10
12,20,116,21,18,3
12,20,117,14,24,-10
12,20,118,15,12,3
12,20,119,25,14,11
12,20,120,20,14,6
12,20,121,8,13,-5
12,20,122,22,23,-1
12,20,123,12,17,-5
12,20,124,6,12,-6
12,20,125,14,15,-1
12,20,126,11,16,-5
12,20,127,14,15,-1
12,20,128,10,11,-1
12,20,129,18,12,6
12,20,130,18,22,-4
12,20,131,9,13,-4
12,20,132,23,13,10
12,20,133,34,17,17
12,20,134,13,18,-5
12,20,135,11,22,-11
12,20,136,14,22,-8
12,20,137,13,18,-5
12,20,138,9,20,-11
12,20,139,8,18,-10
12,20,140,23,8,15
12,20,141,16,10,6
12,20,142,3,1,2
12,20,143,18,13,5
12,20,144,36,24,12
12,20,145,28,10,18
12,20,146,8,1,7
12,20,147,10,9,1
12,20,148,18,16,2
12,20,149,14,12,2
12,20,150,18,22,-4
12,20,151,10,10,0
12,20,152,12,13,-1
12,20,153,26,20,6
12,20,154,15,21,-6
12,20,155,10,18,-8
12,20,156,20,19,1
12,20,157,20,18,2
12,20,158,17,23,-6
12,20,159,16,26,-10
12,20,160,13,11,2
12,20,161,21,17,4
12,20,162,22,8,14
12,20,163,14,17,-3
12,20,164,15,25,-10
12,20,165,27,15,12
12,20,166,28,12,16
12,20,167,17,10,7
12,20,168,26,21,5
12,20,169,9,8,1
12,20,170,13,7,6
12,20,171,18,33,-15
12,20,172,11,7,4
12,20,173,16,14,2
12,20,174,14,12,2
12,20,175,10,7,3
12,20,176,14,16,-2
12,20,177,15,17,-2
12,20,178,12,18,-6
12,20,179,19,10,9
12,20,180,13,16,-3
12,20,181,10,19,-9
12,20,182,16,23,-7
12,20,183,31,20,11
12,20,184,16,12,4
12,20,185,11,8,3
12,20,186,11,8,3
12,20,187,9,19,-10
12,20,188,30,3,27
12,20,189,7,5,2
12,20,190,16,16,0
12,20,191,11,11,0
12,20,192,16,11,5
12,20,193,14,16,-2
12,20,194,11,10,1
12,20,195,20,20,0
12,20,196,24,21,3
12,20,197,30,10,20
12,20,198,11,17,-6
12,20,199,11,11,0
12,20,200,17,17,0
12,20,201,20,12,8
12,20,202,8,5,3
12,20,203,11,11,0
12,20,204,12,5,7
12,20,205,27,18,9
12,20,206,15,12,3
12,20,207,26,20,6
12,20,208,15,7,8
12,20,209,21,17,4
12,20,210,13,6,7
12,20,211,22,10,12
12,20,212,32,21,11
12,20,213,8,15,-7
12,20,214,24,14,10
12,20,215,13,13,0
12,20,216,15,14,1
12,20,217,20,7,13
12,20,218,10,11,-1
12,20,219,19,20,-1
12,20,220,19,14,5
12,20,221,21,16,5
12,20,222,14,17,-3
12,20,223,17,5,12
12,20,224,15,24,-9
12,20,225,19,16,3
12,20,226,9,17,-8
12,20,227,13,8,5
12,20,228,19,19,0
12,20,229,21,10,11
12,20,230,20,18,2
12,20,231,16,25,-9
12,20,232,18,12,6
12,20,233,11,10,1
12,20,234,14,24,-10
12,20,235,21,23,-2
12,20,236,10,21,-11
12,20,237,11,11,0
12,20,238,14,9,5
12,20,239,15,14,1
12,20,240,14,7,7
12,20,241,17,9,8
12,20,242,14,15,-1
12,20,243,13,17,-4
12,20,244,10,19,-9
12,20,245,16,10,6
12,20,246,17,14,3
12,20,247,16,10,6
12,20,248,27,20,7
12,20,249,16,11,5
12,20,250,18,8,10
12,20,251,13,5,8
12,20,252,19,15,4
12,20,253,18,10,8
12,20,254,28,23,5
12,20,255,29,19,10
12,20,256,20,18,2
12,20,257,19,6,13
12,20,258,10,20,-10
12,20,259,19,12,7
12,20,260,12,17,-5
12,20,261,14,12,2
12,20,262,22,15,7
12,20,263,18,8,10
12,20,264,16,11,5
12,20,265,26,8,18
12,20,266,20,14,6
12,20,267,10,14,-4
12,20,268,8,12,-4
12,20,269,18,17,1
12,20,270,11,7,4
12,20,271,14,17,-3
12,20,272,12,9,3
12,20,273,17,14,3
12,20,274,21,11,10
12,20,275,13,22,-9
12,20,276,27,11,16
12,20,277,23,17,6
12,20,278,24,12,12
12,20,279,22,10,12
12,20,280,17,10,7
12,20,281,22,11,11
12,20,282,9,4,5
12,20,283,20,26,-6
12,20,284,18,15,3
12,20,285,23,22,1
12,20,286,29,12,17
12,20,287,12,16,-4
12,20,288,30,17,13
12,20,289,18,15,3
12,20,290,9,9,0
12,20,291,11,14,-3
12,20,292,19,10,9
12,20,293,19,31,-12
12,20,294,19,21,-2
12,20,295,20,14,6
12,20,296,19,13,6
12,20,297,20,22,-2
12,20,298,9,9,0
12,20,299,11,9,2
12,21,0,19,19,0
12,21,1,7,9,-2
12,21,2,11,11,0
12,21,3,20,10,10
12,21,4,12,11,1
12,21,5,29,27,2
12,21,6,19,17,2
12,21,7,29,13,16
12,21,8,11,25,-14
12,21,9,12,3,9
12,21,10,17,13,4
12,21,11,12,23,-11
12,21,12,13,9,4
12,21,13,9,8,1
12,21,14,25,22,3
12,21,15,17,20,-3
12,21,16,35,12,23
12,21,17,14,8,6
12,21,18,7,13,-6
12,21,19,10,14,-4
12,21,20,9,14,-5
12,21,21,27,12,15
12,21,22,13,19,-6
12,21,23,19,24,-5
12,21,24,22,9,13
12,21,25,11,9,2
12,21,26,9,6,3
12,21,27,21,25,-4
12,21,28,21,12,9
12,21,29,15,13,2
12,21,30,11,8,3
12,21,31,16,25,-9
12,21,32,29,15,14
12,21,33,17,12,5
12,21,34,5,16,-11
12,21,35,17,14,3
12,21,36,15,14,1
12,21,37,16,6,10
12,21,38,19,11,8
12,21,39,15,10,5
12,21,40,20,10,10
12,21,41,20,9,11
12,21,42,10,9,1
12,21,43,19,28,-9
12,21,44,7,9,-2
12,21,45,28,19,9
12,21,46,14,11,3
12,21,47,13,16,-3
12,21,48,15,17,-2
12,21,49,12,9,3
12,21,50,17,11,6
12,21,51,12,8,4
12,21,52,10,12,-2
12,21,53,10,17,-7
12,21,54,12,11,1
12,21,55,16,19,-3
12,21,56,13,17,-4
12,21,57,8,7,1
12,21,58,20,19,1
12,21,59,15,10,5
12,21,60,21,33,-12
12,21,61,24,29,-5
12,21,62,11,8,3
12,21,63,21,16,5
12,21,64,15,23,-8
12,21,65,8,23,-15
12,21,66,15,11,4
12,21,67,11,16,-5
12,21,68,14,11,3
12,21,69,13,21,-8
12,21,70,14,15,-1
12,21,71,17,17,0
12,21,72,29,15,14
12,21,73,10,8,2
12,21,74,13,14,-1
12,21,75,17,13,4
12,21,76,17,18,-1
12,21,77,10,18,-8
12,21,78,19,6,13
12,21,79,6,24,-18
12,21,80,9,10,-1
12,21,81,21,17,4
12,21,82,15,16,-1
12,21,83,16,18,-2
12,21,84,24,13,11
12,21,85,13,20,-7
12,21,86,17,7,10
12,21,87,14,10,4
12,21,88,5,14,-9
12,21,89,13,17,-4
12,21,90,13,12,1
12,21,91,10,20,-10
12,21,92,18,15,3
12,21,93,16,9,7
12,21,94,7,16,-9
12,21,95,42,21,21
12,21,96,13,19,-6
12,21,97,16,8,8
12,21,98,17,14,3
12,21,99,11,12,-1
12,21,100,19,12,7
12,21,101,21,20,1
12,21,102,14,7,7
12,21,103,19,12,7
12,21,104,19,16,3
12,21,105,29,21,8
12,21,106,31,13,18
12,21,107,18,18,0
12,21,108,23,18,5
12,21,109,13,15,-2
12,21,110,13,5,8
12,21,111,22,15,7
12,21,112,26,16,10
12,21,113,18,15,3
12,21,114,12,10,2
12,21,115,16,12,4
12,21,116,24,16,8
12,21,117,19,16,3
12,21,118,11,10,1
12,21,119,14,15,-1
12,21,120,21,21,0
12,21,121,12,13,-1
12,21,122,22,17,5
12,21,123,14,11,3
12,21,124,14,9,5
12,21,125,13,4,9
12,21,126,18,16,2
12,21,127,29,24,5
12,21,128,12,9,3
12,21,129,7,9,-2
12,21,130,32,8,24
12,21,131,26,28,-2
12,21,132,15,14,1
12,21,133,10,13,-3
12,21,134,18,11,7
12,21,135,18,14,4
12,21,136,13,6,7
12,21,137,4,6,-2
12,21,138,12,10,2
12,21,139,17,22,-5
12,21,140,15,11,4
12,21,141,19,17,2
12,21,142,25,18,7
12,21,143,22,7,15
12,21,144,18,17,1
12,21,145,18,24,-6
12,21,146,13,16,-3
12,21,147,17,29,-12
12,21,148,20,11,9
12,21,149,18,14,4
12,21,150,31,14,17
12,21,151,10,9,1
12,21,152,21,17,4
12,21,153,7,14,-7
12,21,154,18,15,3
12,21,155,17,9,8
12,21,156,20,12,8
12,21,157,9,10,-1
12,21,158,9,11,-2
12,21,159,11,12,-1
12,21,160,14,16,-2
12,21,161,21,7,14
12,21,162,21,19,2
12,21,163,26,8,18
12,21,164,22,22,0
12,21,165,21,21,0
12,21,166,16,11,5
12,21,167,20,14,6
12,21,168,15,21,-6
12,21,169,11,10,1
12,21,170,15,11,4
12,21,171,13,21,-8
12,21,172,11,7,4
12,21,173,25,25,0
12,21,174,19,11,8
12,21,175,16,10,6
12,21,176,32,17,15
12,21,177,19,17,2
12,21,178,18,10,8
12,21,179,28,18,10
12,21,180,32,14,18
12,21,181,17,12,5
12,21,182,13,11,2
12,21,183,17,26,-9
12,21,184,24,17,7
12,21,185,20,19,1
12,21,186,20,23,-3
12,21,187,17,14,3
12,21,188,8,13,-5
12,21,189,7,12,-5
12,21,190,14,11,3
12,21,191,14,14,0
12,21,192,18,21,-3
12,21,193,29,12,17
12,21,194,24,15,9
12,21,195,12,20,-8
12,21,196,8,6,2
12,21,197,25,15,10
12,21,198,15,9,6
12,21,199,16,16,0
12,21,200,12,13,-1
12,21,201,16,22,-6
12,21,202,17,12,5
12,21,203,11,9,2
12,21,204,7,11,-4
12,21,205,23,18,5
12,21,206,17,5,12
12,21,207,9,22,-13
12,21,208,12,11,1
12,21,209,15,15,0
12,21,210,5,5,0
12,21,211,19,28,-9
12,21,212,5,8,-3
12,21,213,18,18,0
12,21,214,12,17,-5
12,21,215,25,20,5
12,21,216,11,21,-10
12,21,217,6,6,0
12,21,218,18,20,-2
12,21,219,20,10,10
12,21,220,15,8,7
12,21,221,10,16,-6
12,21,222,9,13,-4
12,21,223,15,22,-7
12,21,224,11,10,1
12,21,225,26,18,8
12,21,226,19,16,3
12,21,227,17,12,5
12,21,228,23,13,10
12,21,229,15,8,7
12,21,230,28,16,12
12,21,231,28,16,12
12,21,232,5,18,-13
12,21,233,16,19,-3
12,21,234,13,11,2
12,21,235,12,16,-4
12,21,236,12,12,0
12,21,237,11,11,0
12,21,238,15,2,13
12,21,239,11,5,6
12,21,240,23,9,14
12,21,241,15,11,4
12,21,242,19,16,3
12,21,243,22,13,9
12,21,244,11,22,-11
12,21,245,21,5,16
12,21,246,21,16,5
12,21,247,15,22,-7
12,21,248,14,15,-1
12,21,249,16,10,6
12,21,250,10,13,-3
12,21,251,15,27,-12
12,21,252,20,17,3
12,21,253,19,15,4
12,21,254,8,12,-4
12,21,255,7,16,-9
12,21,256,13,13,0
12,21,257,7,20,-13
12,21,258,14,15,-1
12,21,259,15,7,8
12,21,260,16,12,4
12,21,261,19,17,2
12,21,262,18,11,7
12,21,263,26,9,17
12,21,264,15,10,5
12,21,265,18,14,4
12,21,266,8,16,-8
12,21,267,13,19,-6
12,21,268,7,7,0
12,21,269,18,19,-1
12,21,270,20,17,3
12,21,271,17,16,1
12,21,272,20,21,-1
12,21,273,16,12,4
12,21,274,15,11,4
12,21,275,27,17,10
12,21,276,23,11,12
12,21,277,21,34,-13
12,21,278,14,7,7
12,21,279,25,8,17
12,21,280,10,3,7
12,21,281,17,18,-1
12,21,282,10,15,-5
12,21,283,12,11,1
12,21,284,7,8,-1
12,21,285,11,8,3
12,21,286,11,20,-9
12,21,287,27,17,10
12,21,288,20,10,10
12,21,289,26,8,18
12,21,290,10,18,-8
12,21,291,5,13,-8
12,21,292,14,17,-3
12,21,293,19,8,11
12,21,294,4,11,-7
12,21,295,15,7,8
12,21,296,13,13,0
12,21,297,30,19,11
12,21,298,20,17,3
12,21,299,18,26,-8
12,22,0,10,18,-8
12,22,1,8,6,2
12,22,2,24,15,9
12,22,3,13,25,-12
12,22,4,19,19,0
12,22,5,15,20,-5
12,22,6,10,13,-3
12,22,7,9,26,-17
12,22,8,13,10,3
12,22,9,20,13,7
12,22,10,17,12,5
12,22,11,13,18,-5
12,22,12,20,18,2
12,22,13,22,25,-3
12,22,14,9,17,-8
12,22,15,25,14,11
12,22,16,22,10,12
12,22,17,17,4,13
12,22,18,14,17,-3
12,22,19,23,14,9
12,22,20,11,13,-2
12,22,21,9,17,-8
12,22,22,22,6,16
12,22,23,12,19,-7
12,22,24,6,9,-3
12,22,25,21,15,6
12,22,26,27,12,15
12,22,27,15,10,5
12,22,28,24,14,10
12,22,29,12,23,-11
12,22,30,13,16,-3
12,22,31,17,16,1
12,22,32,19,19,0
12,22,33,20,18,2
12,22,34,11,13,-2
12,22,35,17,13,4
12,22,36,13,29,-16
12,22,37,5,9,-4
12,22,38,18,12,6
12,22,39,20,16,4
12,22,40,21,17,4
12,22,41,17,17,0
12,22,42,10,12,-2
12,22,43,19,9,10
12,22,44,19,23,-4
12,22,45,8,35,-27
12,22,46,22,22,0
12,22,47,8,10,-2
12,22,48,21,14,7
12,22,49,11,4,7
12,22,50,25,15,10
12,22,51,13,13,0
12,22,52,20,10,10
12,22,53,22,8,14
12,22,54,13,3,10
12,22,55,18,15,3
12,22,56,22,11,11
12,22,57,22,19,3
12,22,58,2,8,-6
12,22,59,12,11,1
12,22,60,15,13,2
12,22,61,7,18,-11
12,22,62,10,12,-2
12,22,63,17,9,8
12,22,64,30,21,9
12,22,65,22,9,13
12,22,66,17,12,5
12,22,67,17,9,8
12,22,68,14,16,-2
12,22,69,10,21,-11
12,22,70,13,13,0
12,22,71,23,10,13
12,22,72,14,9,5
12,22,73,28,15,13
12,22,74,28,10,18
12,22,75,16,4,12
12,22,76,16,8,8
12,22,77,19,15,4
12,22,78,19,17,2
12,22,79,15,17,-2
12,22,80,17,22,-5
12,22,81,22,8,14
12,22,82,22,23,-1
12,22,83,15,10,5
12,22,84,25,6,19
12,22,85,21,15,6
12,22,86,18,15,3
12,22,87,14,14,0
12,22,88,19,11,8
12,22,89,16,11,5
12,22,90,20,18,2
12,22,91,9,23,-14
12,22,92,27,20,7
12,22,93,14,12,2
12,22,94,18,12,6
12,22,95,9,11,-2
12,22,96,13,12,1
12,22,97,24,24,0
12,22,98,16,15,1
12,22,99,17,16,1
12,22,100,13,10,3
12,22,101,8,24,-16
12,22,102,11,10,1
12,22,103,13,13,0
12,22,104,11,7,4
12,22,105,14,25,-11
12,22,106,20,18,2
12,22,107,26,16,10
12,22,108,21,16,5
12,22,109,24,9,15
12,22,110,24,22,2
12,22,111,32,10,22
12,22,112,31,19,12
12,22,113,21,9,12
12,22,114,22,5,17
12,22,115,19,15,4
12,22,116,7,4,3
12,22,117,9,17,-8
12,22,118,19,12,7
12,22,119,13,13,0
12,22,120,22,15,7
12,22,121,28,13,15
12,22,122,23,16,7
12,22,123,12,8,4
12,22,124,12,9,3
12,22,125,19,17,2
12,22,126,26,15,11
12,22,127,24,5,19
12,22,128,18,17,1
12,22,129,13,8,5
12,22,130,30,12,18
12,22,131,14,13,1
12,22,132,9,7,2
12,22,133,9,16,-7
12,22,134,19,11,8
12,22,135,12,18,-6
12,22,136,12,11,1
12,22,137,19,11,8
12,22,138,13,14,-1
12,22,139,20,7,13
12,22,140,11,5,6
12,22,141,20,13,7
12,22,142,16,21,-5
12,22,143,8,10,-2
12,22,144,29,17,12
12,22,145,19,17,2
12,22,146,8,12,-4
12,22,147,7,8,-1
12,22,148,18,11,7
12,22,149,20,2,18
12,22,150,24,22,2
12,22,151,9,25,-16
12,22,152,15,17,-2
12,22,153,18,22,-4
12,22,154,18,18,0
12,22,155,31,18,13
12,22,156,20,14,6
12,22,157,31,12,19
12,22,158,18,15,3
12,22,159,14,6,8
12,22,160,29,12,17
12,22,161,24,17,7
12,22,162,24,29,-5
12,22,163,27,12,15
12,22,164,15,13,2
12,22,165,25,12,13
12,22,166,11,4,7
12,22,167,13,18,-5
12,22,168,21,13,8
12,22,169,22,18,4
12,22,170,25,23,2
12,22,171,10,12,-2
12,22,172,17,14,3
12,22,173,14,12,2
12,22,174,3,8,-5
12,22,175,22,12,10
12,22,176,8,9,-1
12,22,177,12,11,1
12,22,178,10,15,-5
12,22,179,34,10,24
12,22,180,20,11,9
12,22,181,20,19,1
12,22,182,4,7,-3
12,22,183,12,18,-6
12,22,184,10,14,-4
12,22,185,21,9,12
12,22,186,11,20,-9
12,22,187,7,12,-5
12,22,188,20,9,11
12,22,189,18,9,9
12,22,190,16,11,5
12,22,191,16,13,3
12,22,192,10,19,-9
12,22,193,12,12,0
12,22,194,17,8,9
12,22,195,14,7,7
12,22,196,21,13,8
12,22,197,17,9,8
12,22,198,15,5,10
12,22,199,25,15,10
12,22,200,25,13,12
12,22,201,24,7,17
12,22,202,4,16,-12
12,22,203,14,10,4
12,22,204,28,22,6
12,22,205,19,18,1
12,22,206,7,9,-2
12,22,207,18,18,0
12,22,208,18,22,-4
12,22,209,14,18,-4
12,22,210,12,11,1
12,22,211,9,7,2
12,22,212,17,19,-2
12,22,213,16,17,-1
12,22,214,10,19,-9
12,22,215,23,11,12
12,22,216,17,11,6
12,22,217,24,17,7
12,22,218,16,13,3
12,22,219,13,14,-1
12,22,220,21,18,3
12,22,221,16,15,1
12,22,222,13,14,-1
12,22,223,8,2,6
12,22,224,17,12,5
12,22,225,7,4,3
12,22,226,18,16,2
12,22,227,17,11,6
12,22,228,13,11,2
12,22,229,14,9,5
12,22,230,8,18,-10
12,22,231,17,14,3
12,22,232,18,13,5
12,22,233,14,7,7
12,22,234,19,10,9
12,22,235,12,14,-2
12,22,236,15,18,-3
12,22,237,19,29,-10
12,22,238,14,15,-1
12,22,239,15,31,-16
12,22,240,10,13,-3
12,22,241,16,13,3
12,22,242,19,9,10
12,22,243,22,21,1
12,22,244,16,13,3
12,22,245,32,10,22
12,22,246,23,11,12
12,22,247,30,16,14
12,22,248,20,11,9
12,22,249,21,21,0
12,22,250,33,17,16
12,22,251,17,12,5
12,22,252,19,11,8
12,22,253,20,14,6
12,22,254,18,14,4
12,22,255,10,9,1
12,22,256,16,10,6
12,22,257,24,11,13
12,22,258,30,14,16
12,22,259,19,10,9
12,22,260,18,8,10
12,22,261,21,16,5
12,22,262,16,11,5
12,22,263,8,13,-5
12,22,264,14,5,9
12,22,265,23,15,8
12,22,266,5,12,-7
12,22,267,15,18,-3
12,22,268,25,15,10
12,22,269,14,12,2
12,22,270,29,20,9
12,22,271,5,14,-9
12,22,272,5,7,-2
12,22,273,21,20,1
12,22,274,22,12,10
12,22,275,11,13,-2
12,22,276,10,17,-7
12,22,277,17,7,10
12,22,278,15,19,-4
12,22,279,15,13,2
12,22,280,24,25,-1
12,22,281,32,14,18
12,22,282,8,4,4
12,22,283,25,24,1
12,22,284,32,15,17
12,22,285,5,3,2
12,22,286,6,9,-3
12,22,287,23,11,12
12,22,288,12,17,-5
12,22,289,11,20,-9
12,22,290,14,12,2
12,22,291,20,28,-8
12,22,292,24,10,14
12,22,293,22,9,13
12,22,294,9,6,3
12,22,295,14,6,8
12,22,296,17,9,8
12,22,297,15,11,4
12,22,298,30,12,18
12,22,299,18,22,-4
12,23,0,16,14,2
12,23,1,21,23,-2
12,23,2,20,15,5
12,23,3,21,15,6
12,23,4,13,7,6
12,23,5,11,10,1
12,23,6,16,11,5
12,23,7,5,5,0
12,23,8,22,17,5
12,23,9,13,8,5
12,23,10,23,12,11
12,23,11,17,29,-12
12,23,12,15,7,8
12,23,13,13,3,10
12,23,14,35,11,24
12,23,15,21,20,1
12,23,16,24,8,16
12,23,17,12,17,-5
12,23,18,25,14,11
12,23,19,15,16,-1
12,23,20,29,19,10
12,23,21,17,28,-11
12,23,22,17,16,1
12,23,23,17,12,5
12,23,24,21,26,-5
12,23,25,9,5,4
12,23,26,22,20,2
12,23,27,17,21,-4
12,23,28,18,8,10
12,23,29,15,14,1
12,23,30,26,24,2
12,23,31,7,10,-3
12,23,32,8,6,2
12,23,33,12,14,-2
12,23,34,31,17,14
12,23,35,19,7,12
12,23,36,28,14,14
12,23,37,12,8,4
12,23,38,10,20,-10
12,23,39,11,7,4
12,23,40,14,9,5
12,23,41,15,12,3
12,23,42,16,13,3
12,23,43,7,6,1
12,23,44,15,13,2
12,23,45,13,16,-3
12,23,46,21,21,0
12,23,47,21,16,5
12,23,48,18,14,4
12,23,49,25,15,10
12,23,50,25,7,18
12,23,51,14,21,-7
12,23,52,13,13,0
12,23,53,6,8,-2
12,23,54,14,12,2
12,23,55,16,10,6
12,23,56,12,4,8
12,23,57,17,15,2
12,23,58,20,15,5
12,23,59,3,15,-12
12,23,60,12,7,5
12,23,61,27,12,15
12,23,62,19,9,10
12,23,63,15,15,0
12,23,64,15,15,0
12,23,65,17,17,0
12,23,66,24,16,8
12,23,67,18,11,7
12,23,68,20,7,13
12,23,69,13,5,8
12,23,70,21,12,9
12,23,71,24,20,4
12,23,72,16,7,9
12,23,73,19,19,0
12,23,74,17,24,-7
12,23,75,10,10,0
12,23,76,15,13,2
12,23,77,12,10,2
12,23,78,19,24,-5
12,23,79,11,13,-2
12,23,80,21,25,-4
12,23,81,26,19,7
12,23,82,24,14,10
12,23,83,19,7,12
12,23,84,23,21,2
12,23,85,20,9,11
12,23,86,20,15,5
12,23,87,18,16,2
12,23,88,12,12,0
12,23,89,13,13,0
12,23,90,9,14,-5
12,23,91,16,15,1
12,23,92,10,12,-2
12,23,93,17,15,2
12,23,94,17,8,9
12,23,95,14,9,5
12,23,96,23,15,8
12,23,97,20,23,-3
12,23,98,26,21,5
12,23,99,18,9,9
12,23,100,13,15,-2
12,23,101,20,16,4
12,23,102,17,19,-2
12,23,103,16,22,-6
12,23,104,12,4,8
12,23,105,11,6,5
12,23,106,11,10,1
12,23,107,17,11,6
12,23,108,18,14,4
12,23,109,25,14,11
12,23,110,16,16,0
12,23,111,10,12,-2
12,23,112,12,7,5
12,23,113,27,14,13
12,23,114,18,11,7
12,23,115,26,14,12
12,23,116,26,10,16
12,23,117,21,6,15
12,23,118,15,7,8
12,23,119,17,12,5
12,23,120,25,13,12
12,23,121,21,11,10
12,23,122,18,20,-2
12,23,123,10,6,4
12,23,124,5,7,-2
12,23,125,19,11,8
12,23,126,12,16,-4
12,23,127,23,13,10
12,23,128,11,16,-5
12,23,129,16,9,7
12,23,130,15,12,3
12,23,131,12,2,10
12,23,132,16,27,-11
12,23,133,14,16,-2
12,23,134,28,17,11
12,23,135,27,26,1
12,23,136,22,6,16
12,23,137,11,13,-2
12,23,138,15,14,1
12,23,139,29,7,22
12,23,140,16,9,7
12,23,141,13,9,4
12,23,142,10,14,-4
12,23,143,9,10,-1
12,23,144,15,14,1
12,23,145,19,7,12
12,23,146,24,29,-5
12,23,147,13,10,3
12,23,148,27,20,7
12,23,149,10,13,-3
12,23,150,13,22,-9
12,23,151,9,8,1
12,23,152,8,13,-5
12,23,153,9,10,-1
12,23,154,10,14,-4
12,23,155,12,13,-1
12,23,156,18,15,3
12,23,157,21,19,2
12,23,158,16,16,0
12,23,159,16,19,-3
12,23,160,23,16,7
12,23,161,22,11,11
12,23,162,11,11,0
12,23,163,29,8,21
12,23,164,16,21,-5
12,23,165,25,17,8
12,23,166,18,14,4
12,23,167,21,16,5
12,23,168,19,18,1
12,23,169,18,12,6
12,23,170,31,17,14
12,23,171,24,17,7
12,23,172,11,16,-5
12,23,173,19,7,12
12,23,174,18,27,-9
12,23,175,22,14,8
12,23,176,15,19,-4
12,23,177,21,12,9
12,23,178,9,8,1
12,23,179,38,17,21
12,23,180,15,12,3
12,23,181,12,8,4
12,23,182,12,17,-5
12,23,183,11,12,-1
12,23,184,25,12,13
12,23,185,21,18,3
12,23,186,15,14,1
12,23,187,16,5,11
12,23,188,17,7,10
12,23,189,14,7,7
12,23,190,21,13,8
12,23,191,15,20,-5
12,23,192,10,9,1
12,23,193,4,8,-4
12,23,194,16,8,8
12,23,195,24,13,11
12,23,196,17,18,-1
12,23,197,15,21,-6
12,23,198,23,17,6
12,23,199,6,6,0
12,23,200,16,10,6
12,23,201,8,8,0
12,23,202,12,12,0
12,23,203,16,20,-4
12,23,204,22,20,2
12,23,205,16,16,0
12,23,206,24,12,12
12,23,207,29,18,11
12,23,208,21,27,-6
12,23,209,12,14,-2
12,23,210,22,11,11
12,23,211,23,22,1
12,23,212,18,2,16
12,23,213,18,15,3
12,23,214,18,16,2
12,23,215,17,12,5
12,23,216,23,16,7
12,23,217,20,18,2
12,23,218,12,10,2
12,23,219,16,16,0
12,23,220,27,12,15
12,23,221,25,29,-4
12,23,222,17,9,8
12,23,223,24,12,12
12,23,224,15,19,-4
12,23,225,17,10,7
12,23,226,18,5,13
12,23,227,14,5,9
12,23,228,17,10,7
12,23,229,18,6,12
12,23,230,9,18,-9
12,23,231,17,17,0
12,23,232,9,13,-4
12,23,233,11,13,-2
12,23,234,15,13,2
12,23,235,33,18,15
12,23,236,17,19,-2
12,23,237,16,10,6
12,23,238,15,8,7
12,23,239,10,5,5
12,23,240,11,13,-2
12,23,241,19,10,9
12,23,242,16,13,3
12,23,243,16,11,5
12,23,244,11,11,0
12,23,245,8,20,-12
12,23,246,15,21,-6
12,23,247,16,11,5
12,23,248,14,9,5
12,23,249,14,8,6
12,23,250,15,11,4
12,23,251,23,17,6
12,23,252,21,18,3
12,23,253,23,12,11
12,23,254,16,13,3
12,23,255,9,10,-1
12,23,256,10,8,2
12,23,257,25,10,15
12,23,258,19,17,2
12,23,259,16,14,2
12,23,260,16,14,2
12,23,261,31,17,14
12,23,262,18,9,9
12,23,263,22,4,18
12,23,264,18,11,7
12,23,265,9,14,-5
12,23,266,13,17,-4
12,23,267,20,17,3
12,23,268,22,27,-5
12,23,269,25,16,9
12,23,270,17,11,6
12,23,271,10,17,-7
12,23,272,17,30,-13
12,23,273,15,30,-15
12,23,274,13,11,2
12,23,275,19,20,-1
12,23,276,13,6,7
12,23,277,15,18,-3
12,23,278,19,19,0
12,23,279,30,20,10
12,23,280,8,7,1
12,23,281,26,13,13
12,23,282,17,13,4
12,23,283,26,18,8
12,23,284,23,9,14
12,23,285,25,9,16
12,23,286,21,23,-2
12,23,287,8,5,3
12,23,288,23,16,7
12,23,289,13,21,-8
12,23,290,18,4,14
12,23,291,22,18,4
12,23,292,12,21,-9
12,23,293,18,13,5
12,23,294,17,8,9
12,23,295,7,16,-9
12,23,296,20,12,8
12,23,297,13,10,3
12,23,298,17,20,-3
12,23,299,20,17,3
12,24,0,26,14,12
12,24,1,20,11,9
12,24,2,10,16,-6
12,24,3,13,11,2
12,24,4,19,17,2
12,24,5,3,4,-1
12,24,6,19,18,1
12,24,7,12,7,5
12,24,8,6,10,-4
12,24,9,15,15,0
12,24,10,13,17,-4
12,24,11,15,15,0
12,24,12,18,22,-4
12,24,13,22,15,7
12,24,14,12,10,2
12,24,15,23,15,8
12,24,16,26,22,4
12,24,17,11,15,-4
12,24,18,15,10,5
12,24,19,21,28,-7
12,24,20,18,14,4
12,24,21,24,4,20
12,24,22,14,14,0
12,24,23,16,6,10
12,24,24,33,16,17
12,24,25,7,7,0
12,24,26,18,15,3
12,24,27,25,13,12
12,24,28,21,13,8
12,24,29,14,7,7
12,24,30,25,15,10
12,24,31,13,6,7
12,24,32,12,6,6
12,24,33,6,15,-9
12,24,34,33,24,9
12,24,35,19,15,4
12,24,36,47,16,31
12,24,37,21,20,1
12,24,38,8,7,1
12,24,39,18,18,0
12,24,40,11,3,8
12,24,41,12,15,-3
12,24,42,5,5,0
12,24,43,25,28,-3
12,24,44,23,14,9
12,24,45,6,7,-1
12,24,46,14,8,6
12,24,47,19,9,10
12,24,48,14,9,5
12,24,49,20,12,8
12,24,50,21,4,17
12,24,51,23,13,10
12,24,52,14,8,6
12,24,53,14,7,7
12,24,54,26,17,9
12,24,55,18,13,5
12,24,56,19,26,-7
12,24,57,12,10,2
12,24,58,26,16,10
12,24,59,13,11,2
12,24,60,14,8,6
12,24,61,34,22,12
12,24,62,12,3,9
12,24,63,12,11,1
12,24,64,34,22,12
12,24,65,15,18,-3
12,24,66,8,13,-5
12,24,67,21,20,1
12,24,68,19,14,5
12,24,69,21,5,16
12,24,70,9,12,-3
12,24,71,11,6,5
12,24,72,13,14,-1
12,24,73,8,7,1
12,24,74,9,0,9
12,24,75,22,15,7
12,24,76,16,10,6
12,24,77,17,9,8
12,24,78,18,14,4
12,24,79,16,13,3
12,24,80,36,13,23
12,24,81,10,10,0
12,24,82,22,14,8
12,24,83,19,10,9
12,24,84,6,5,1
12,24,85,23,9,14
12,24,86,8,12,-4
12,24,87,12,20,-8
12,24,88,18,11,7
12,24,89,15,12,3
12,24,90,15,12,3
12,24,91,18,16,2
12,24,92,8,23,-15
12,24,93,8,12,-4
12,24,94,12,8,4
12,24,95,17,12,5
12,24,96,11,26,-15
12,24,97,11,11,0
12,24,98,14,14,0
12,24,99,23,22,1
12,24,100,9,17,-8
12,24,101,21,23,-2
12,24,102,13,11,2
12,24,103,20,10,10
12,24,104,21,10,11
12,24,105,18,12,6
12,24,106,18,8,10
12,24,107,14,18,-4
12,24,108,17,10,7
12,24,109,10,8,2
12,24,110,7,10,-3
12,24,111,23,11,12
12,24,112,11,14,-3
12,24,113,10,13,-3
12,24,114,13,16,-3
12,24,115,14,11,3
12,24,116,6,12,-6
12,24,117,7,19,-12
12,24,118,12,5,7
12,24,119,19,14,5
12,24,120,11,7,4
12,24,121,32,13,19
12,24,122,16,13,3
12,24,123,8,3,5
12,24,124,19,22,-3
12,24,125,23,16,7
12,24,126,21,8,13
12,24,127,16,10,6
12,24,128,12,9,3
12,24,129,8,4,4
12,24,130,10,6,4
12,24,131,8,14,-6
12,24,132,15,8,7
12,24,133,11,4,7
12,24,134,22,11,11
12,24,135,16,12,4
12,24,136,12,14,-2
12,24,137,33,17,16
12,24,138,12,20,-8
12,24,139,13,15,-2
12,24,140,16,13,3
12,24,141,22,17,5
12,24,142,17,22,-5
12,24,143,22,9,13
12,24,144,15,13,2
12,24,145,21,12,9
12,24,146,28,23,5
12,24,147,17,17,0
12,24,148,19,11,8
12,24,149,18,19,-1
12,24,150,23,8,15
12,24,151,19,20,-1
12,24,152,5,8,-3
12,24,153,15,17,-2
12,24,154,19,13,6
12,24,155,18,8,10
12,24,156,13,20,-7
12,24,157,16,6,10
12,24,158,11,15,-4
12,24,159,17,19,-2
12,24,160,23,16,7
12,24,161,14,17,-3
12,24,162,13,11,2
12,24,163,14,8,6
12,24,164,22,19,3
12,24,165,18,11,7
12,24,166,12,10,2
12,24,167,20,15,5
12,24,168,17,14,3
12,24,169,11,15,-4
12,24,170,16,21,-5
12,24,171,8,21,-13
12,24,172,25,9,16
12,24,173,5,15,-10
12,24,174,19,16,3
12,24,175,21,13,8
12,24,176,17,22,-5
12,24,177,15,25,-10
12,24,178,15,10,5
12,24,179,15,16,-1
12,24,180,12,8,4
12,24,181,18,23,-5
12,24,182,30,8,22
12,24,183,16,9,7
12,24,184,24,8,16
12,24,185,23,15,8
12,24,186,14,15,-1
12,24,187,11,7,4
12,24,188,24,16,8
12,24,189,10,13,-3
12,24,190,30,19,11
12,24,191,19,19,0
12,24,192,16,14,2
12,24,193,19,12,7
12,24,194,18,6,12
12,24,195,33,9,24
12,24,196,16,13,3
12,24,197,15,12,3
12,24,198,11,14,-3
12,24,199,20,13,7
12,24,200,20,15,5
12,24,201,15,2,13
12,24,202,11,9,2
12,24,203,27,16,11
12,24,204,6,5,1
12,24,205,25,22,3
12,24,206,13,10,3
12,24,207,22,11,11
12,24,208,13,11,2
12,24,209,8,10,-2
12,24,210,7,3,4
12,24,211,22,3,19
12,24,212,10,10,0
12,24,213,16,8,8
12,24,214,13,12,1
12,24,215,28,15,13
12,24,216,23,19,4
12,24,217,13,25,-12
12,24,218,24,19,5
12,24,219,19,18,1
12,24,220,11,12,-1
12,24,221,13,25,-12
12,24,222,19,26,-7
12,24,223,11,24,-13
12,24,224,22,7,15
12,24,225,14,11,3
12,24,226,8,7,1
12,24,227,6,8,-2
12,24,228,18,15,3
12,24,229,11,10,1
12,24,230,21,15,6
12,24,231,14,9,5
12,24,232,21,8,13
12,24,233,12,12,0
12,24,234,17,22,-5
12,24,235,20,14,6
12,24,236,19,13,6
12,24,237,19,15,4
12,24,238,5,11,-6
12,24,239,25,17,8
12,24,240,21,16,5
12,24,241,21,19,2
12,24,242,25,7,18
12,24,243,15,21,-6
12,24,244,12,14,-2
12,24,245,15,7,8
12,24,246,13,6,7
12,24,247,11,11,0
12,24,248,16,11,5
12,24,249,17,14,3
12,24,250,9,26,-17
12,24,251,19,11,8
12,24,252,11,11,0
12,24,253,19,12,7
12,24,254,18,8,10
12,24,255,13,21,-8
12,24,256,27,19,8
12,24,257,17,21,-4
12,24,258,21,20,1
12,24,259,22,7,15
12,24,260,16,19,-3
12,24,261,27,14,13
12,24,262,12,12,0
12,24,263,17,14,3
12,24,264,16,11,5
12,24,265,13,15,-2
12,24,266,15,8,7
12,24,267,6,18,-12
12,24,268,25,31,-6
12,24,269,12,3,9
12,24,270,11,14,-3
12,24,271,12,1,11
12,24,272,10,11,-1
12,24,273,15,8,7
12,24,274,20,8,12
12,24,275,8,13,-5
12,24,276,8,4,4
12,24,277,23,22,1
12,24,278,17,10,7
12,24,279,24,21,3
12,24,280,12,8,4
12,24,281,11,14,-3
12,24,282,15,10,5
12,24,283,6,11,-5
12,24,284,24,14,10
12,24,285,11,9,2
12,24,286,11,16,-5
12,24,287,14,15,-1
12,24,288,18,16,2
12,24,289,22,16,6
12,24,290,10,11,-1
12,24,291,18,13,5
12,24,292,18,12,6
12,24,293,10,16,-6
12,24,294,12,14,-2
12,24,295,17,8,9
12,24,296,12,10,2
12,24,297,18,13,5
12,24,298,13,28,-15
12,24,299,13,6,7
12,25,0,18,10,8
12,25,1,10,7,3
12,25,2,14,17,-3
12,25,3,26,15,11
12,25,4,14,12,2
12,25,5,17,8,9
12,25,6,18,18,0
12,25,7,13,8,5
12,25,8,16,4,12
12,25,9,11,14,-3
12,25,10,13,24,-11
12,25,11,16,9,7
12,25,12,21,19,2
12,25,13,22,17,5
12,25,14,5,6,-1
12,25,15,15,10,5
12,25,16,25,14,11
12,25,17,12,6,6
12,25,18,17,11,6
12,25,19,16,17,-1
12,25,20,24,18,6
12,25,21,21,7,14
12,25,22,14,12,2
12,25,23,18,19,-1
12,25,24,26,27,-1
12,25,25,25,9,16
12,25,26,23,16,7
12,25,27,1,4,-3
12,25,28,17,3,14
12,25,29,7,8,-1
12,25,30,20,13,7
12,25,31,17,16,1
12,25,32,6,9,-3
12,25,33,18,19,-1
12,25,34,13,23,-10
12,25,35,21,16,5
12,25,36,17,7,10
12,25,37,15,5,10
12,25,38,12,13,-1
12,25,39,16,17,-1
12,25,40,17,17,0
12,25,41,33,31,2
12,25,42,13,13,0
12,25,43,17,12,5
12,25,44,12,11,1
12,25,45,13,5,8
12,25,46,13,8,5
12,25,47,12,11,1
12,25,48,36,16,20
12,25,49,27,17,10
12,25,50,17,12,5
12,25,51,8,16,-8
12,25,52,12,24,-12
12,25,53,17,4,13
12,25,54,18,16,2
12,25,55,22,17,5
12,25,56,20,16,4
12,25,57,7,5,2
12,25,58,15,8,7
12,25,59,15,14,1
12,25,60,20,10,10
12,25,61,16,8,8
12,25,62,18,20,-2
12,25,63,21,12,9
12,25,64,27,9,18
12,25,65,18,16,2
12,25,66,26,13,13
12,25,67,18,15,3
12,25,68,18,10,8
12,25,69,25,16,9
12,25,70,23,10,13
12,25,71,22,7,15
12,25,72,9,14,-5
12,25,73,18,15,3
12,25,74,22,30,-8
12,25,75,6,11,-5
12,25,76,12,4,8
12,25,77,11,14,-3
12,25,78,12,22,-10
12,25,79,17,20,-3
12,25,80,9,13,-4
12,25,81,10,10,0
12,25,82,5,10,-5
12,25,83,22,8,14
12,25,84,16,23,-7
12,25,85,15,10,5
12,25,86,9,8,1
12,25,87,17,17,0
12,25,88,17,11,6
12,25,89,13,7,6
12,25,90,8,8,0
12,25,91,21,11,10
12,25,92,27,16,11
12,25,93,18,17,1
12,25,94,22,12,10
12,25,95,15,14,1
12,25,96,17,14,3
12,25,97,28,13,15
12,25,98,29,10,19
12,25,99,20,16,4
12,25,100,14,17,-3
12,25,101,9,7,2
12,25,102,16,12,4
12,25,103,32,23,9
12,25,104,22,7,15
12,25,105,9,5,4
12,25,106,14,14,0
12,25,107,24,9,15
12,25,108,16,12,4
12,25,109,20,8,12
12,25,110,25,18,7
12,25,111,28,17,11
12,25,112,10,9,1
12,25,113,25,17,8
12,25,114,15,16,-1
12,25,115,11,5,6
12,25,116,38,12,26
12,25,117,14,6,8
12,25,118,28,9,19
12,25,119,17,4,13
12,25,120,24,9,15
12,25,121,18,21,-3
12,25,122,22,23,-1
12,25,123,24,14,10
12,25,124,15,13,2
12,25,125,31,7,24
12,25,126,12,6,6
12,25,127,11,7,4
12,25,128,9,3,6
12,25,129,25,12,13
12,25,130,17,13,4
12,25,131,9,19,-10
12,25,132,20,20,0
12,25,133,26,21,5
12,25,134,16,3,13
12,25,135,13,5,8
12,25,136,11,11,0
12,25,137,17,4,13
12,25,138,22,12,10
12,25,139,17,17,0
12,25,140,25,11,14
12,25,141,35,13,22
12,25,142,16,14,2
12,25,143,16,4,12
12,25,144,21,22,-1
12,25,145,15,23,-8
12,25,146,20,21,-1
12,25,147,11,13,-2
12,25,148,13,8,5
12,25,149,10,12,-2
12,25,150,14,14,0
12,25,151,5,13,-8
12,25,152,22,15,7
12,25,153,14,17,-3
12,25,154,22,21,1
12,25,155,16,2,14
12,25,156,32,20,12
12,25,157,7,3,4
12,25,158,18,17,1
12,25,159,22,9,13
12,25,160,22,18,4
12,25,161,14,15,-1
12,25,162,11,15,-4
12,25,163,14,9,5
12,25,164,20,7,13
12,25,165,19,17,2
12,25,166,14,11,3
12,25,167,10,9,1
12,25,168,9,8,1
12,25,169,23,11,12
12,25,170,19,12,7
12,25,171,10,2,8
12,25,172,12,11,1
12,25,173,13,10,3
12,25,174,28,10,18
12,25,175,16,3,13
12,25,176,5,10,-5
12,25,177,15,7,8
12,25,178,25,16,9
12,25,179,16,12,4
12,25,180,17,16,1
12,25,181,17,9,8
12,25,182,19,8,11
12,25,183,16,15,1
12,25,184,19,18,1
12,25,185,12,4,8
12,25,186,14,5,9
12,25,187,14,13,1
12,25,188,13,4,9
12,25,189,13,12,1
12,25,190,25,21,4
12,25,191,6,8,-2
12,25,192,20,16,4
12,25,193,16,8,8
12,25,194,10,8,2
12,25,195,14,11,3
12,25,196,14,12,2
12,25,197,12,14,-2
12,25,198,23,11,12
12,25,199,21,15,6
12,25,200,26,10,16
12,25,201,14,6,8
12,25,202,27,8,19
12,25,203,41,20,21
12,25,204,17,11,6
12,25,205,21,3,18
12,25,206,26,20,6
12,25,207,28,10,18
12,25,208,10,14,-4
12,25,209,13,8,5
12,25,210,25,10,15
12,25,211,27,9,18
12,25,212,28,19,9
12,25,213,24,16,8
12,25,214,24,14,10
12,25,215,10,11,-1
12,25,216,18,8,10
12,25,217,10,10,0
12,25,218,15,8,7
12,25,219,8,13,-5
12,25,220,15,17,-2
12,25,221,24,9,15
12,25,222,13,15,-2
12,25,223,6,6,0
12,25,224,21,15,6
12,25,225,34,22,12
12,25,226,19,20,-1
12,25,227,20,14,6
12,25,228,14,14,0
12,25,229,17,7,10
12,25,230,12,2,10
12,25,231,12,8,4
12,25,232,25,10,15
12,25,233,22,14,8
12,25,234,24,13,11
12,25,235,10,9,1
12,25,236,17,9,8
12,25,237,28,24,4
12,25,238,19,8,11
12,25,239,16,14,2
12,25,240,18,9,9
12,25,241,9,10,-1
12,25,242,21,24,-3
12,25,243,18,14,4
12,25,244,11,8,3
12,25,245,11,4,7
12,25,246,19,11,8
12,25,247,29,17,12
12,25,248,26,16,10
12,25,249,23,16,7
12,25,250,8,11,-3
12,25,251,7,7,0
12,25,252,15,17,-2
12,25,253,13,13,0
12,25,254,26,14,12
12,25,255,17,14,3
12,25,256,15,13,2
12,25,257,20,14,6
12,25,258,15,15,0
12,25,259,23,22,1
12,25,260,9,10,-1
12,25,261,20,15,5
12,25,262,16,8,8
12,25,263,20,11,9
12,25,264,29,16,13
12,25,265,26,11,15
12,25,266,14,10,4
12,25,267,22,21,1
12,25,268,27,11,16
12,25,269,23,7,16
12,25,270,22,10,12
12,25,271,12,14,-2
12,25,272,20,13,7
12,25,273,20,11,9
12,25,274,20,15,5
12,25,275,14,8,6
12,25,276,21,16,5
12,25,277,20,17,3
12,25,278,15,12,3
12,25,279,16,15,1
12,25,280,9,7,2
12,25,281,14,13,1
12,25,282,17,8,9
12,25,283,16,27,-11
12,25,284,14,11,3
12,25,285,8,10,-2
12,25,286,26,15,11
12,25,287,18,19,-1
12,25,288,15,10,5
12,25,289,27,12,15
12,25,290,26,25,1
12,25,291,14,10,4
12,25,292,14,13,1
12,25,293,16,11,5
12,25,294,11,9,2
12,25,295,17,17,0
12,25,296,17,16,1
12,25,297,17,14,3
12,25,298,16,11,5
12,25,299,18,21,-3
12,26,0,16,9,7
12,26,1,15,14,1
12,26,2,6,10,-4
12,26,3,12,8,4
12,26,4,14,8,6
12,26,5,16,9,7
12,26,6,24,7,17
12,26,7,15,6,9
12,26,8,8,3,5
12,26,9,22,13,9
12,26,10,20,9,11
12,26,11,23,22,1
12,26,12,19,15,4
12,26,13,32,17,15
12,26,14,27,12,15
12,26,15,18,13,5
12,26,16,11,19,-8
12,26,17,27,19,8
12,26,18,14,4,10
12,26,19,21,24,-3
12,26,20,15,9,6
12,26,21,16,6,10
12,26,22,19,15,4
12,26,23,20,10,10
12,26,24,24,19,5
12,26,25,15,12,3
12,26,26,10,13,-3
12,26,27,14,15,-1
12,26,28,19,16,3
12,26,29,20,13,7
12,26,30,19,12,7
12,26,31,34,15,19
12,26,32,16,8,8
12,26,33,23,10,13
12,26,34,20,14,6
12,26,35,22,21,1
12,26,36,20,9,11
12,26,37,12,7,5
12,26,38,22,8,14
12,26,39,23,14,9
12,26,40,28,13,15
12,26,41,27,6,21
12,26,42,27,10,17
12,26,43,16,7,9
12,26,44,10,8,2
12,26,45,23,18,5
12,26,46,25,11,14
12,26,47,17,13,4
12,26,48,22,17,5
12,26,49,13,10,3
12,26,50,10,5,5
12,26,51,16,14,2
12,26,52,23,10,13
12,26,53,23,5,18
12,26,54,9,15,-6
12,26,55,14,10,4
12,26,56,16,18,-2
12,26,57,18,12,6
12,26,58,13,11,2
12,26,59,27,8,19
12,26,60,18,7,11
12,26,61,30,13,17
12,26,62,8,9,-1
12,26,63,16,9,7
12,26,64,15,16,-1
12,26,65,15,17,-2
12,26,66,15,14,1
12,26,67,16,13,3
12,26,68,20,15,5
12,26,69,23,16,7
12,26,70,30,18,12
12,26,71,23,30,-7
12,26,72,22,14,8
12,26,73,20,20,0
12,26,74,11,21,-10
12,26,75,18,19,-1
12,26,76,29,11,18
12,26,77,12,10,2
12,26,78,11,22,-11
12,26,79,16,10,6
12,26,80,12,5,7
12,26,81,13,6,7
12,26,82,16,11,5
12,26,83,21,4,17
12,26,84,7,5,2
12,26,85,12,7,5
12,26,86,20,14,6
12,26,87,18,19,-1
12,26,88,18,24,-6
12,26,89,19,4,15
12,26,90,22,10,12
12,26,91,14,19,-5
12,26,92,17,9,8
12,26,93,15,12,3
12,26,94,23,3,20
12,26,95,12,10,2
12,26,96,6,2,4
12,26,97,12,9,3
12,26,98,25,13,12
12,26,99,17,11,6
12,26,100,22,14,8
12,26,101,25,13,12
12,26,102,23,18,5
12,26,103,31,16,15
12,26,104,19,15,4
12,26,105,19,18,1
12,26,106,34,26,8
12,26,107,13,18,-5
12,26,108,15,7,8
12,26,109,8,11,-3
12,26,110,7,10,-3
12,26,111,17,9,8
12,26,112,6,5,1
12,26,113,7,12,-5
12,26,114,16,14,2
12,26,115,19,5,14
12,26,116,19,18,1
12,26,117,23,16,7
12,26,118,16,20,-4
12,26,119,19,5,14
12,26,120,9,9,0
12,26,121,8,8,0
12,26,122,21,11,10
12,26,123,21,16,5
12,26,124,16,17,-1
12,26,125,19,20,-1
12,26,126,22,22,0
12,26,127,15,7,8
12,26,128,22,9,13
12,26,129,31,16,15
12,26,130,20,19,1
12,26,131,22,15,7
12,26,132,11,8,3
12,26,133,16,11,5
12,26,134,15,21,-6
12,26,135,11,0,11
12,26,136,5,8,-3
12,26,137,20,11,9
12,26,138,12,6,6
12,26,139,26,14,12
12,26,140,35,13,22
12,26,141,16,7,9
12,26,142,8,13,-5
12,26,143,22,17,5
12,26,144,16,7,9
12,26,145,15,7,8
12,26,146,15,15,0
12,26,147,17,8,9
12,26,148,22,10,12
12,26,149,25,8,17
12,26,150,16,4,12
12,26,151,17,22,-5
12,26,152,16,6,10
12,26,153,16,19,-3
12,26,154,15,11,4
12,26,155,17,7,10
12,26,156,33,9,24
12,26,157,11,13,-2
12,26,158,19,5,14
12,26,159,28,6,22
12,26,160,2,14,-12
12,26,161,9,0,9
12,26,162,27,8,19
12,26,163,14,10,4
12,26,164,8,13,-5
12,26,165,18,24,-6
12,26,166,14,10,4
12,26,167,9,13,-4
12,26,168,34,15,19
12,26,169,14,21,-7
12,26,170,12,5,7
12,26,171,20,12,8
12,26,172,16,12,4
12,26,173,20,7,13
12,26,174,16,18,-2
12,26,175,15,8,7
12,26,176,21,18,3
12,26,177,16,16,0
12,26,178,13,14,-1
12,26,179,12,16,-4
12,26,180,19,12,7
12,26,181,15,13,2
12,26,182,22,15,7
12,26,183,13,10,3
12,26,184,18,12,6
12,26,185,27,19,8
12,26,186,10,8,2
12,26,187,7,10,-3
12,26,188,14,10,4
12,26,189,12,8,4
12,26,190,15,9,6
12,26,191,23,21,2
12,26,192,13,18,-5
12,26,193,5,8,-3
12,26,194,8,21,-13
12,26,195,15,10,5
12,26,196,18,15,3
12,26,197,8,2,6
12,26,198,20,18,2
12,26,199,22,18,4
12,26,200,21,11,10
12,26,201,13,12,1
12,26,202,7,3,4
12,26,203,29,8,21
12,26,204,15,12,3
12,26,205,16,8,8
12,26,206,22,24,-2
12,26,207,25,19,6
12,26,208,18,9,9
12,26,209,17,6,11
12,26,210,30,18,12
12,26,211,29,8,21
12,26,212,13,9,4
12,26,213,12,14,-2
12,26,214,26,11,15
12,26,215,16,11,5
12,26,216,30,17,13
12,26,217,23,9,14
12,26,218,28,14,14
12,26,219,14,5,9
12,26,220,7,10,-3
12,26,221,10,5,5
12,26,222,11,8,3
12,26,223,10,12,-2
12,26,224,25,11,14
12,26,225,26,12,14
12,26,226,19,17,2
12,26,227,20,16,4
12,26,228,9,25,-16
12,26,229,21,9,12
12,26,230,11,12,-1
12,26,231,11,11,0
12,26,232,12,17,-5
12,26,233,14,6,8
12,26,234,18,12,6
12,26,235,5,9,-4
12,26,236,17,23,-6
12,26,237,17,20,-3
12,26,238,10,13,-3
12,26,239,29,12,17
12,26,240,19,7,12
12,26,241,22,8,14
12,26,242,30,13,17
12,26,243,35,22,13
12,26,244,29,6,23
12,26,245,15,6,9
12,26,246,24,8,16
12,26,247,24,11,13
12,26,248,16,16,0
12,26,249,15,7,8
12,26,250,19,7,12
12,26,251,19,11,8
12,26,252,19,18,1
12,26,253,32,18,14
12,26,254,14,7,7
12,26,255,15,5,10
12,26,256,22,16,6
12,26,257,11,7,4
12,26,258,9,5,4
12,26,259,12,12,0
12,26,260,14,5,9
12,26,261,6,5,1
12,26,262,22,8,14
12,26,263,10,12,-2
12,26,264,16,14,2
12,26,265,12,11,1
12,26,266,18,4,14
12,26,267,13,21,-8
12,26,268,7,6,1
12,26,269,13,21,-8
12,26,270,16,9,7
12,26,271,19,12,7
12,26,272,12,9,3
12,26,273,28,13,15
12,26,274,16,12,4
12,26,275,19,11,8
12,26,276,22,10,12
12,26,277,28,8,20
12,26,278,16,13,3
12,26,279,28,19,9
12,26,280,17,7,10
12,26,281,15,12,3
12,26,282,8,7,1
12,26,283,12,11,1
12,26,284,5,3,2
12,26,285,19,8,11
12,26,286,9,13,-4
12,26,287,13,20,-7
12,26,288,8,12,-4
12,26,289,25,8,17
12,26,290,11,9,2
12,26,291,8,7,1
12,26,292,22,10,12
12,26,293,14,10,4
12,26,294,17,2,15
12,26,295,21,7,14
12,26,296,8,11,-3
12,26,297,21,24,-3
12,26,298,14,21,-7
12,26,299,29,9,20
12,27,0,21,12,9
12,27,1,23,18,5
12,27,2,17,7,10
12,27,3,17,5,12
12,27,4,11,7,4
12,27,5,7,4,3
12,27,6,16,10,6
12,27,7,21,22,-1
12,27,8,22,14,8
12,27,9,15,11,4
12,27,10,14,4,10
12,27,11,14,15,-1
12,27,12,14,15,-1
12,27,13,18,15,3
12,27,14,16,8,8
12,27,15,16,8,8
12,27,16,33,15,18
12,27,17,12,12,0
12,27,18,19,11,8
12,27,19,13,9,4
12,27,20,22,20,2
12,27,21,14,17,-3
12,27,22,23,14,9
12,27,23,7,8,-1
12,27,24,25,6,19
12,27,25,27,19,8
12,27,26,8,4,4
12,27,27,15,13,2
12,27,28,13,12,1
12,27,29,7,14,-7
12,27,30,12,6,6
12,27,31,30,12,18
12,27,32,26,9,17
12,27,33,20,3,17
12,27,34,29,17,12
12,27,35,25,18,7
12,27,36,11,11,0
12,27,37,22,14,8
12,27,38,14,10,4
12,27,39,27,13,14
12,27,40,12,9,3
12,27,41,13,15,-2
12,27,42,22,10,12
12,27,43,14,11,3
12,27,44,23,23,0
12,27,45,17,12,5
12,27,46,18,11,7
12,27,47,17,22,-5
12,27,48,21,17,4
12,27,49,20,11,9
12,27,50,12,21,-9
12,27,51,14,14,0
12,27,52,13,15,-2
12,27,53,7,5,2
12,27,54,11,7,4
12,27,55,10,15,-5
12,27,56,6,8,-2
12,27,57,19,10,9
12,27,58,19,12,7
12,27,59,17,17,0
12,27,60,14,7,7
12,27,61,14,11,3
12,27,62,12,13,-1
12,27,63,21,14,7
12,27,64,25,9,16
12,27,65,25,15,10
12,27,66,11,8,3
12,27,67,27,19,8
12,27,68,27,7,20
12,27,69,19,13,6
12,27,70,12,11,1
12,27,71,7,11,-4
12,27,72,22,13,9
12,27,73,21,17,4
12,27,74,17,14,3
12,27,75,21,13,8
12,27,76,11,13,-2
12,27,77,16,2,14
12,27,78,29,17,12
12,27,79,19,16,3
12,27,80,10,12,-2
12,27,81,9,7,2
12,27,82,24,28,-4
12,27,83,22,9,13
12,27,84,18,13,5
12,27,85,24,12,12
12,27,86,15,8,7
12,27,87,11,11,0
12,27,88,13,13,0
12,27,89,8,16,-8
12,27,90,14,11,3
12,27,91,12,9,3
12,27,92,25,19,6
12,27,93,28,6,22
12,27,94,21,15,6
12,27,95,18,13,5
12,27,96,27,14,13
12,27,97,15,6,9
12,27,98,13,8,5
12,27,99,13,16,-3
12,27,100,14,13,1
12,27,101,13,15,-2
12,27,102,18,14,4
12,27,103,20,12,8
12,27,104,18,8,10
12,27,105,28,24,4
12,27,106,3,7,-4
12,27,107,16,20,-4
12,27,108,18,14,4
12,27,109,21,26,-5
12,27,110,16,7,9
12,27,111,10,19,-9
12,27,112,15,14,1
12,27,113,10,16,-6
12,27,114,19,19,0
12,27,115,18,6,12
12,27,116,24,16,8
12,27,117,25,10,15
12,27,118,13,14,-1
12,27,119,22,10,12
12,27,120,30,18,12
12,27,121,12,19,-7
12,27,122,32,12,20
12,27,123,22,13,9
12,27,124,19,11,8
12,27,125,18,2,16
12,27,126,34,19,15
12,27,127,21,9,12
12,27,128,18,12,6
12,27,129,18,13,5
12,27,130,30,13,17
12,27,131,12,3,9
12,27,132,18,16,2
12,27,133,13,7,6
12,27,134,29,14,15
12,27,135,17,4,13
12,27,136,16,11,5
12,27,137,13,14,-1
12,27,138,15,12,3
12,27,139,19,4,15
12,27,140,32,19,13
12,27,141,10,5,5
12,27,142,23,25,-2
12,27,143,13,16,-3
12,27,144,8,16,-8
12,27,145,19,13,6
12,27,146,24,13,11
12,27,147,31,26,5
12,27,148,26,13,13
12,27,149,18,9,9
12,27,150,16,4,12
12,27,151,11,5,6
12,27,152,18,3,15
12,27,153,18,18,0
12,27,154,15,11,4
12,27,155,17,17,0
12,27,156,26,8,18
12,27,157,22,12,10
12,27,158,21,12,9
12,27,159,23,25,-2
12,27,160,16,15,1
12,27,161,14,6,8
12,27,162,11,11,0
12,27,163,16,18,-2
12,27,164,13,19,-6
12,27,165,29,9,20
12,27,166,15,19,-4
12,27,167,16,8,8
12,27,168,24,12,12
12,27,169,23,16,7
12,27,170,18,12,6
12,27,171,17,5,12
12,27,172,22,11,11
12,27,173,15,13,2
12,27,174,11,8,3
12,27,175,20,15,5
12,27,176,20,14,6
12,27,177,15,14,1
12,27,178,16,6,10
12,27,179,29,13,16
12,27,180,18,15,3
12,27,181,13,19,-6
12,27,182,16,16,0
12,27,183,26,10,16
12,27,184,17,15,2
12,27,185,23,20,3
12,27,186,10,8,2
12,27,187,6,27,-21
12,27,188,30,17,13
12,27,189,16,7,9
12,27,190,13,12,1
12,27,191,15,11,4
12,27,192,25,27,-2
12,27,193,16,14,2
12,27,194,20,9,11
12,27,195,11,10,1
12,27,196,12,14,-2
12,27,197,30,21,9
12,27,198,13,15,-2
12,27,199,15,5,10
12,27,200,19,15,4
12,27,201,8,15,-7
12,27,202,6,7,-1
12,27,203,16,5,11
12,27,204,19,17,2
12,27,205,19,12,7
12,27,206,13,9,4
12,27,207,17,8,9
12,27,208,26,21,5
12,27,209,25,14,11
12,27,210,12,6,6
12,27,211,17,6,11
12,27,212,9,8,1
12,27,213,21,8,13
12,27,214,23,13,10
12,27,215,23,27,-4
12,27,216,15,13,2
12,27,217,11,11,0
12,27,218,23,14,9
12,27,219,36,20,16
12,27,220,32,15,17
12,27,221,15,13,2
12,27,222,12,11,1
12,27,223,18,19,-1
12,27,224,22,18,4
12,27,225,12,15,-3
12,27,226,34,28,6
12,27,227,23,5,18
12,27,228,18,11,7
12,27,229,12,10,2
12,27,230,14,9,5
12,27,231,16,6,10
12,27,232,21,15,6
12,27,233,17,20,-3
12,27,234,6,2,4
12,27,235,15,9,6
12,27,236,14,15,-1
12,27,237,9,21,-12
12,27,238,11,8,3
12,27,239,9,13,-4
12,27,240,21,8,13
12,27,241,12,9,3
12,27,242,25,22,3
12,27,243,10,11,-1
12,27,244,19,1,18
12,27,245,18,11,7
12,27,246,15,3,12
12,27,247,24,12,12
12,27,248,12,10,2
12,27,249,19,8,11
12,27,250,23,9,14
12,27,251,9,10,-1
12,27,252,15,5,10
12,27,253,15,5,10
12,27,254,16,10,6
12,27,255,13,9,4
12,27,256,11,11,0
12,27,257,24,14,10
12,27,258,34,13,21
12,27,259,25,9,16
12,27,260,16,11,5
12,27,261,36,20,16
12,27,262,20,5,15
12,27,263,33,10,23
12,27,264,22,14,8
12,27,265,18,3,15
12,27,266,16,9,7
12,27,267,22,15,7
12,27,268,17,11,6
12,27,269,13,6,7
12,27,270,11,4,7
12,27,271,19,12,7
12,27,272,10,10,0
12,27,273,26,7,19
12,27,274,15,12,3
12,27,275,15,19,-4
12,27,276,17,8,9
12,27,277,25,14,11
12,27,278,15,25,-10
12,27,279,17,13,4
12,27,280,13,11,2
12,27,281,10,6,4
12,27,282,27,18,9
12,27,283,6,17,-11
12,27,284,16,8,8
12,27,285,14,13,1
12,27,286,30,15,15
12,27,287,31,5,26
12,27,288,22,6,16
12,27,289,14,7,7
12,27,290,10,13,-3
12,27,291,15,4,11
12,27,292,6,7,-1
12,27,293,14,12,2
12,27,294,19,12,7
12,27,295,18,9,9
12,27,296,21,10,11
12,27,297,32,21,11
12,27,298,27,17,10
12,27,299,16,10,6
12,28,0,16,14,2
12,28,1,15,10,5
12,28,2,39,11,28
12,28,3,5,14,-9
12,28,4,30,29,1
12,28,5,9,7,2
12,28,6,14,14,0
12,28,7,11,9,2
12,28,8,28,24,4
12,28,9,13,3,10
12,28,10,12,22,-10
12,28,11,24,4,20
12,28,12,17,17,0
12,28,13,20,9,11
12,28,14,15,3,12
12,28,15,21,11,10
12,28,16,20,14,6
12,28,17,11,4,7
12,28,18,13,11,2
12,28,19,19,8,11
12,28,20,23,11,12
12,28,21,13,13,0
12,28,22,24,18,6
12,28,23,13,11,2
12,28,24,11,12,-1
12,28,25,30,12,18
12,28,26,7,3,4
12,28,27,20,12,8
12,28,28,15,10,5
12,28,29,20,13,7
12,28,30,21,9,12
12,28,31,22,19,3
12,28,32,8,6,2
12,28,33,19,9,10
12,28,34,7,13,-6
12,28,35,11,4,7
12,28,36,22,13,9
12,28,37,23,10,13
12,28,38,21,8,13
12,28,39,25,11,14
12,28,40,17,16,1
12,28,41,22,12,10
12,28,42,11,12,-1
12,28,43,20,11,9
12,28,44,13,7,6
12,28,45,19,14,5
12,28,46,17,14,3
12,28,47,19,15,4
12,28,48,14,11,3
12,28,49,14,9,5
12,28,50,14,12,2
12,28,51,14,13,1
12,28,52,17,26,-9
12,28,53,8,7,1
12,28,54,24,14,10
12,28,55,14,9,5
12,28,56,29,28,1
12,28,57,17,8,9
12,28,58,22,20,2
12,28,59,15,8,7
12,28,60,8,9,-1
12,28,61,19,13,6
12,28,62,32,14,18
12,28,63,18,14,4
12,28,64,18,20,-2
12,28,65,27,19,8
12,28,66,26,8,18
12,28,67,21,12,9
12,28,68,22,9,13
12,28,69,9,4,5
12,28,70,10,5,5
12,28,71,26,20,6
12,28,72,23,5,18
12,28,73,13,12,1
12,28,74,11,11,0
12,28,75,12,7,5
12,28,76,22,7,15
12,28,77,22,22,0
12,28,78,23,12,11
12,28,79,16,6,10
12,28,80,18,10,8
12,28,81,27,11,16
12,28,82,14,14,0
12,28,83,14,9,5
12,28,84,9,8,1
12,28,85,19,10,9
12,28,86,23,4,19
12,28,87,13,12,1
12,28,88,31,19,12
12,28,89,11,16,-5
12,28,90,13,5,8
12,28,91,27,7,20
12,28,92,16,11,5
12,28,93,8,22,-14
12,28,94,28,8,20
12,28,95,18,5,13
12,28,96,25,6,19
12,28,97,13,9,4
12,28,98,14,4,10
12,28,99,19,9,10
12,28,100,21,12,9
12,28,101,21,13,8
12,28,102,16,13,3
12,28,103,17,9,8
12,28,104,28,10,18
12,28,105,23,6,17
12,28,106,13,7,6
12,28,107,10,11,-1
12,28,108,27,9,18
12,28,109,24,20,4
12,28,110,12,13,-1
12,28,111,23,15,8
12,28,112,12,6,6
12,28,113,31,12,19
12,28,114,5,14,-9
12,28,115,15,16,-1
12,28,116,18,12,6
12,28,117,6,7,-1
12,28,118,12,11,1
12,28,119,14,7,7
12,28,120,23,7,16
12,28,121,26,11,15
12,28,122,16,13,3
12,28,123,18,18,0
12,28,124,8,7,1
12,28,125,26,11,15
12,28,126,11,16,-5
12,28,127,23,15,8
12,28,128,33,16,17
12,28,129,15,7,8
12,28,130,20,10,10
12,28,131,15,9,6
12,28,132,22,18,4
12,28,133,19,7,12
12,28,134,12,7,5
12,28,135,10,12,-2
12,28,136,7,11,-4
12,28,137,11,15,-4
12,28,138,13,20,-7
12,28,139,19,14,5
12,28,140,27,19,8
12,28,141,20,11,9
12,28,142,16,10,6
12,28,143,16,18,-2
12,28,144,24,10,14
12,28,145,22,19,3
12,28,146,19,14,5
12,28,147,19,13,6
12,28,148,20,13,7
12,28,149,27,4,23
12,28,150,19,6,13
12,28,151,13,14,-1
12,28,152,15,11,4
12,28,153,25,26,-1
12,28,154,16,5,11
12,28,155,18,18,0
12,28,156,6,4,2
12,28,157,18,10,8
12,28,158,13,13,0
12,28,159,13,9,4
12,28,160,21,14,7
12,28,161,12,11,1
12,28,162,11,10,1
12,28,163,11,2,9
12,28,164,9,10,-1
12,28,165,7,12,-5
12,28,166,16,12,4
12,28,167,26,10,16
12,28,168,18,15,3
12,28,169,21,15,6
12,28,170,14,7,7
12,28,171,17,12,5
12,28,172,14,12,2
12,28,173,28,8,20
12,28,174,11,4,7
12,28,175,19,8,11
12,28,176,15,3,12
12,28,177,15,9,6
12,28,178,22,17,5
12,28,179,8,7,1
12,28,180,15,12,3
12,28,181,16,14,2
12,28,182,14,17,-3
12,28,183,10,12,-2
12,28,184,8,8,0
12,28,185,18,14,4
12,28,186,12,6,6
12,28,187,24,15,9
12,28,188,8,3,5
12,28,189,21,16,5
12,28,190,15,7,8
12,28,191,22,14,8
12,28,192,12,9,3
12,28,193,18,5,13
12,28,194,9,5,4
12,28,195,30,24,6
12,28,196,20,9,11
12,28,197,10,8,2
12,28,198,13,12,1
12,28,199,15,11,4
12,28,200,14,5,9
12,28,201,20,15,5
12,28,202,24,18,6
12,28,203,28,25,3
12,28,204,20,11,9
12,28,205,16,12,4
12,28,206,22,16,6
12,28,207,30,13,17
12,28,208,11,10,1
12,28,209,19,13,6
12,28,210,19,10,9
12,28,211,14,12,2
12,28,212,17,14,3
12,28,213,18,13,5
12,28,214,11,12,-1
12,28,215,14,15,-1
12,28,216,12,19,-7
12,28,217,13,10,3
12,28,218,18,7,11
12,28,219,21,6,15
12,28,220,16,13,3
12,28,221,10,3,7
12,28,222,4,6,-2
12,28,223,9,9,0
12,28,224,8,6,2
12,28,225,16,8,8
12,28,226,17,9,8
12,28,227,20,9,11
12,28,228,19,8,11
12,28,229,15,7,8
12,28,230,37,8,29
12,28,231,17,13,4
12,28,232,18,19,-1
12,28,233,13,5,8
12,28,234,24,12,12
12,28,235,30,14,16
12,28,236,21,10,11
12,28,237,18,7,11
12,28,238,10,6,4
12,28,239,11,9,2
12,28,240,23,13,10
12,28,241,22,24,-2
12,28,242,23,7,16
12,28,243,32,13,19
12,28,244,18,5,13
12,28,245,30,14,16
12,28,246,8,10,-2
12,28,247,14,10,4
12,28,248,15,4,11
12,28,249,8,5,3
12,28,250,21,10,11
12,28,251,7,6,1
12,28,252,24,12,12
12,28,253,15,12,3
12,28,254,16,18,-2
12,28,255,10,13,-3
12,28,256,21,9,12
12,28,257,21,19,2
12,28,258,25,6,19
12,28,259,19,18,1
12,28,260,16,10,6
12,28,261,19,10,9
12,28,262,25,10,15
12,28,263,18,11,7
12,28,264,21,14,7
12,28,265,11,10,1
12,28,266,10,9,1
12,28,267,18,8,10
12,28,268,24,9,15
12,28,269,20,12,8
12,28,270,18,6,12
12,28,271,19,8,11
12,28,272,14,8,6
12,28,273,16,4,12
12,28,274,12,12,0
12,28,275,13,19,-6
12,28,276,6,1,5
12,28,277,14,4,10
12,28,278,17,14,3
12,28,279,18,20,-2
12,28,280,15,11,4
12,28,281,16,17,-1
12,28,282,13,11,2
12,28,283,21,15,6
12,28,284,20,26,-6
12,28,285,6,10,-4
12,28,286,26,13,13
12,28,287,28,12,16
12,28,288,9,4,5
12,28,289,27,19,8
12,28,290,10,2,8
12,28,291,21,6,15
12,28,292,21,8,13
12,28,293,5,14,-9
12,28,294,12,11,1
12,28,295,8,9,-1
12,28,296,18,7,11
12,28,297,12,3,9
12,28,298,2,7,-5
12,28,299,28,18,10
12,29,0,24,11,13
12,29,1,4,15,-11
12,29,2,25,13,12
12,29,3,10,15,-5
12,29,4,4,6,-2
12,29,5,17,11,6
12,29,6,18,5,13
12,29,7,17,7,10
12,29,8,14,14,0
12,29,9,20,14,6
12,29,10,11,9,2
12,29,11,21,10,11
12,29,12,14,4,10
12,29,13,14,7,7
12,29,14,26,11,15
12,29,15,18,20,-2
12,29,16,16,10,6
12,29,17,18,13,5
12,29,18,17,6,11
12,29,19,15,7,8
12,29,20,11,9,2
12,29,21,18,9,9
12,29,22,10,12,-2
12,29,23,21,14,7
12,29,24,17,7,10
12,29,25,25,12,13
12,29,26,20,14,6
12,29,27,18,19,-1
12,29,28,24,9,15
12,29,29,19,8,11
12,29,30,17,16,1
12,29,31,33,19,14
12,29,32,17,8,9
12,29,33,14,19,-5
12,29,34,15,11,4
12,29,35,21,22,-1
12,29,36,17,12,5
12,29,37,10,21,-11
12,29,38,23,11,12
12,29,39,15,17,-2
12,29,40,22,8,14
12,29,41,22,10,12
12,29,42,15,5,10
12,29,43,21,11,10
12,29,44,14,17,-3
12,29,45,21,15,6
12,29,46,49,17,32
12,29,47,17,20,-3
12,29,48,24,15,9
12,29,49,18,8,10
12,29,50,13,7,6
12,29,51,8,12,-4
12,29,52,24,13,11
12,29,53,22,7,15
12,29,54,21,17,4
12,29,55,21,8,13
12,29,56,6,12,-6
12,29,57,9,10,-1
12,29,58,7,9,-2
12,29,59,12,8,4
12,29,60,14,14,0
12,29,61,7,17,-10
12,29,62,16,5,11
12,29,63,20,9,11
12,29,64,20,13,7
12,29,65,9,5,4
12,29,66,14,9,5
12,29,67,11,9,2
12,29,68,13,11,2
12,29,69,15,10,5
12,29,70,30,10,20
12,29,71,18,7,11
12,29,72,12,9,3
12,29,73,11,17,-6
12,29,74,15,14,1
12,29,75,19,16,3
12,29,76,24,8,16
12,29,77,15,16,-1
12,29,78,16,15,1
12,29,79,20,25,-5
12,29,80,35,10,25
12,29,81,30,11,19
12,29,82,14,13,1
12,29,83,12,4,8
12,29,84,17,9,8
12,29,85,24,22,2
12,29,86,19,30,-11
12,29,87,11,11,0
12,29,88,20,15,5
12,29,89,19,19,0
12,29,90,15,11,4
12,29,91,24,8,16
12,29,92,11,13,-2
12,29,93,15,5,10
12,29,94,10,7,3
12,29,95,19,13,6
12,29,96,26,13,13
12,29,97,13,10,3
12,29,98,14,6,8
12,29,99,12,8,4
12,29,100,16,10,6
12,29,101,16,13,3
12,29,102,27,10,17
12,29,103,17,6,11
12,29,104,12,17,-5
12,29,105,15,19,-4
12,29,106,18,12,6
12,29,107,31,14,17
12,29,108,9,6,3
12,29,109,15,12,3
12,29,110,26,13,13
12,29,111,12,17,-5
12,29,112,27,25,2
12,29,113,12,7,5
12,29,114,27,9,18
12,29,115,9,11,-2
12,29,116,13,23,-10
12,29,117,19,17,2
12,29,118,22,5,17
12,29,119,23,13,10
12,29,120,40,18,22
12,29,121,11,4,7
12,29,122,11,8,3
12,29,123,19,18,1
12,29,124,22,13,9
12,29,125,20,13,7
12,29,126,8,2,6
12,29,127,20,15,5
12,29,128,7,14,-7
12,29,129,17,6,11
12,29,130,23,11,12
12,29,131,20,17,3
12,29,132,12,13,-1
12,29,133,33,19,14
12,29,134,26,14,12
12,29,135,18,11,7
12,29,136,21,18,3
12,29,137,26,9,17
12,29,138,23,15,8
12,29,139,24,6,18
12,29,140,13,10,3
12,29,141,11,8,3
12,29,142,20,8,12
12,29,143,13,5,8
12,29,144,24,18,6
12,29,145,14,20,-6
12,29,146,16,2,14
12,29,147,5,4,1
12,29,148,19,10,9
12,29,149,12,8,4
12,29,150,11,5,6
12,29,151,22,5,17
12,29,152,15,12,3
12,29,153,17,7,10
12,29,154,13,10,3
12,29,155,26,22,4
12,29,156,15,6,9
12,29,157,16,9,7
12,29,158,16,10,6
12,29,159,21,12,9
12,29,160,16,3,13
12,29,161,31,17,14
12,29,162,11,11,0
12,29,163,12,9,3
12,29,164,16,23,-7
12,29,165,14,10,4
12,29,166,3,7,-4
12,29,167,14,10,4
12,29,168,20,11,9
12,29,169,21,10,11
12,29,170,16,9,7
12,29,171,26,19,7
12,29,172,17,8,9
12,29,173,21,17,4
12,29,174,11,16,-5
12,29,175,15,11,4
12,29,176,11,8,3
12,29,177,29,9,20
12,29,178,14,4,10
12,29,179,9,10,-1
12,29,180,27,16,11
12,29,181,25,9,16
12,29,182,18,7,11
12,29,183,19,17,2
12,29,184,11,12,-1
12,29,185,17,10,7
12,29,186,13,11,2
12,29,187,17,20,-3
12,29,188,25,18,7
12,29,189,7,3,4
12,29,190,7,14,-7
12,29,191,13,9,4
12,29,192,24,16,8
12,29,193,6,6,0
12,29,194,29,17,12
12,29,195,18,6,12
12,29,196,13,11,2
12,29,197,11,11,0
12,29,198,10,2,8
12,29,199,14,7,7
12,29,200,16,15,1
12,29,201,10,7,3
12,29,202,16,8,8
12,29,203,30,16,14
12,29,204,16,10,6
12,29,205,15,4,11
12,29,206,23,20,3
12,29,207,7,16,-9
12,29,208,17,9,8
12,29,209,18,11,7
12,29,210,15,14,1
12,29,211,16,10,6
12,29,212,13,5,8
12,29,213,14,5,9
12,29,214,32,11,21
12,29,215,15,6,9
12,29,216,14,15,-1
12,29,217,9,13,-4
12,29,218,25,9,16
12,29,219,12,6,6
12,29,220,21,13,8
12,29,221,24,16,8
12,29,222,20,11,9
12,29,223,13,15,-2
12,29,224,8,4,4
12,29,225,24,19,5
12,29,226,10,4,6
12,29,227,17,12,5
12,29,228,15,11,4
12,29,229,15,11,4
12,29,230,19,6,13
12,29,231,15,19,-4
12,29,232,13,6,7
12,29,233,25,9,16
12,29,234,14,10,4
12,29,235,16,19,-3
12,29,236,25,5,20
12,29,237,14,13,1
12,29,238,19,12,7
12,29,239,14,15,-1
12,29,240,21,9,12
12,29,241,19,16,3
12,29,242,11,5,6
12,29,243,17,20,-3
12,29,244,16,17,-1
12,29,245,14,13,1
12,29,246,14,19,-5
12,29,247,13,8,5
12,29,248,32,11,21
12,29,249,12,8,4
12,29,250,32,15,17
12,29,251,13,10,3
12,29,252,13,7,6
12,29,253,16,10,6
12,29,254,19,11,8
12,29,255,18,20,-2
12,29,256,11,7,4
12,29,257,27,12,15
12,29,258,11,6,5
12,29,259,24,14,10
12,29,260,17,14,3
12,29,261,26,6,20
12,29,262,15,11,4
12,29,263,33,16,17
12,29,264,14,5,9
12,29,265,11,7,4
12,29,266,32,18,14
12,29,267,19,11,8
12,29,268,26,15,11
12,29,269,13,15,-2
12,29,270,16,9,7
12,29,271,23,10,13
12,29,272,10,8,2
12,29,273,14,7,7
12,29,274,17,19,-2
12,29,275,39,15,24
12,29,276,11,25,-14
12,29,277,31,10,21
12,29,278,17,9,8
12,29,279,22,13,9
12,29,280,20,14,6
12,29,281,16,7,9
12,29,282,9,15,-6
12,29,283,19,11,8
12,29,284,20,17,3
12,29,285,10,7,3
12,29,286,18,8,10
12,29,287,24,11,13
12,29,288,18,18,0
12,29,289,13,14,-1
12,29,290,20,10,10
12,29,291,25,4,21
12,29,292,11,6,5
12,29,293,18,15,3
12,29,294,16,6,10
12,29,295,26,24,2
12,29,296,9,12,-3
12,29,297,6,7,-1
12,29,298,18,7,11
12,29,299,26,21,5
12,30,0,9,3,6
12,30,1,22,11,11
12,30,2,19,10,9
12,30,3,11,11,0
12,30,4,14,13,1
12,30,5,10,9,1
12,30,6,14,8,6
12,30,7,6,8,-2
12,30,8,23,7,16
12,30,9,8,5,3
12,30,10,4,4,0
12,30,11,13,13,0
12,30,12,26,16,10
12,30,13,18,11,7
12,30,14,26,13,13
12,30,15,28,12,16
12,30,16,13,18,-5
12,30,17,11,9,2
12,30,18,10,10,0
12,30,19,14,13,1
12,30,20,15,15,0
12,30,21,20,14,6
12,30,22,12,13,-1
12,30,23,18,9,9
12,30,24,9,15,-6
12,30,25,26,9,17
12,30,26,22,8,14
12,30,27,14,9,5
12,30,28,12,11,1
12,30,29,18,19,-1
12,30,30,19,9,10
12,30,31,18,4,14
12,30,32,24,10,14
12,30,33,23,3,20
12,30,34,25,5,20
12,30,35,12,3,9
12,30,36,24,8,16
12,30,37,17,11,6
12,30,38,16,1,15
12,30,39,30,26,4
12,30,40,18,13,5
12,30,41,24,17,7
12,30,42,21,8,13
12,30,43,16,14,2
12,30,44,11,11,0
12,30,45,18,16,2
12,30,46,21,8,13
12,30,47,15,17,-2
12,30,48,14,7,7
12,30,49,5,12,-7
12,30,50,9,8,1
12,30,51,14,9,5
12,30,52,20,8,12
12,30,53,15,5,10
12,30,54,23,11,12
12,30,55,21,17,4
12,30,56,6,8,-2
12,30,57,30,19,11
12,30,58,12,13,-1
12,30,59,31,11,20
12,30,60,32,18,14
12,30,61,14,15,-1
12,30,62,25,5,20
12,30,63,15,8,7
12,30,64,16,12,4
12,30,65,27,11,16
12,30,66,10,8,2
12,30,67,31,9,22
12,30,68,20,4,16
12,30,69,6,9,-3
12,30,70,18,7,11
12,30,71,32,24,8
12,30,72,18,10,8
12,30,73,16,9,7
12,30,74,14,9,5
12,30,75,22,13,9
12,30,76,16,6,10
12,30,77,28,13,15
12,30,78,13,13,0
12,30,79,11,12,-1
12,30,80,13,18,-5
12,30,81,24,16,8
12,30,82,6,3,3
12,30,83,23,13,10
12,30,84,25,12,13
12,30,85,17,14,3
12,30,86,7,12,-5
12,30,87,10,8,2
12,30,88,24,10,14
12,30,89,17,17,0
12,30,90,16,4,12
12,30,91,6,7,-1
12,30,92,10,5,5
12,30,93,19,14,5
12,30,94,2,9,-7
12,30,95,19,13,6
12,30,96,22,16,6
12,30,97,25,13,12
12,30,98,20,19,1
12,30,99,31,16,15
12,30,100,10,2,8
12,30,101,3,4,-1
12,30,102,14,22,-8
12,30,103,16,9,7
12,30,104,28,10,18
12,30,105,13,6,7
12,30,106,16,9,7
12,30,107,17,15,2
12,30,108,14,12,2
12,30,109,31,10,21
12,30,110,11,9,2
12,30,111,13,9,4
12,30,112,12,3,9
12,30,113,5,1,4
12,30,114,23,11,12
12,30,115,15,11,4
12,30,116,27,14,13
12,30,117,19,13,6
12,30,118,27,16,11
12,30,119,36,13,23
12,30,120,31,14,17
12,30,121,15,4,11
12,30,122,7,10,-3
12,30,123,10,5,5
12,30,124,6,5,1
12,30,125,23,16,7
12,30,126,8,7,1
12,30,127,17,15,2
12,30,128,32,9,23
12,30,129,1,7,-6
12,30,130,19,6,13
12,30,131,21,12,9
12,30,132,11,9,2
12,30,133,13,9,4
12,30,134,10,2,8
12,30,135,14,10,4
12,30,136,9,13,-4
12,30,137,20,13,7
12,30,138,11,18,-7
12,30,139,20,8,12
12,30,140,18,5,13
12,30,141,24,17,7
12,30,142,15,8,7
12,30,143,11,7,4
12,30,144,9,8,1
12,30,145,16,10,6
12,30,146,25,15,10
12,30,147,28,11,17
12,30,148,17,9,8
12,30,149,13,13,0
12,30,150,18,7,11
12,30,151,12,7,5
12,30,152,23,11,12
12,30,153,14,5,9
12,30,154,18,13,5
12,30,155,22,10,12
12,30,156,4,8,-4
12,30,157,9,6,3
12,30,158,20,5,15
12,30,159,13,10,3
12,30,160,24,5,19
12,30,161,15,6,9
12,30,162,8,6,2
12,30,163,18,15,3
12,30,164,20,10,10
12,30,165,13,4,9
12,30,166,16,12,4
12,30,167,12,13,-1
12,30,168,16,6,10
12,30,169,11,5,6
12,30,170,21,8,13
12,30,171,25,1,24
12,30,172,15,13,2
12,30,173,19,10,9
12,30,174,13,8,5
12,30,175,14,8,6
12,30,176,38,13,25
12,30,177,21,7,14
12,30,178,16,25,-9
12,30,179,11,4,7
12,30,180,13,13,0
12,30,181,35,14,21
12,30,182,22,10,12
12,30,183,30,22,8
12,30,184,19,16,3
12,30,185,26,14,12
12,30,186,16,19,-3
12,30,187,20,9,11
12,30,188,10,13,-3
12,30,189,10,6,4
12,30,190,15,11,4
12,30,191,15,10,5
12,30,192,17,9,8
12,30,193,12,6,6
12,30,194,7,15,-8
12,30,195,20,18,2
12,30,196,12,6,6
12,30,197,10,9,1
12,30,198,22,14,8
12,30,199,8,12,-4
12,30,200,14,13,1
12,30,201,10,12,-2
12,30,202,18,12,6
12,30,203,10,3,7
12,30,204,21,9,12
12,30,205,14,9,5
12,30,206,20,13,7
12,30,207,19,11,8
12,30,208,15,7,8
12,30,209,20,4,16
12,30,210,16,13,3
12,30,211,22,16,6
12,30,212,20,10,10
12,30,213,27,14,13
12,30,214,16,16,0
12,30,215,20,15,5
12,30,216,18,9,9
12,30,217,9,9,0
12,30,218,7,10,-3
12,30,219,10,11,-1
12,30,220,17,8,9
12,30,221,15,14,1
12,30,222,15,11,4
12,30,223,24,16,8
12,30,224,14,16,-2
12,30,225,17,17,0
12,30,226,19,17,2
12,30,227,15,8,7
12,30,228,23,13,10
12,30,229,13,8,5
12,30,230,14,8,6
12,30,231,18,5,13
12,30,232,15,8,7
12,30,233,14,10,4
12,30,234,4,7,-3
12,30,235,14,10,4
12,30,236,21,20,1
12,30,237,32,21,11
12,30,238,18,7,11
12,30,239,18,16,2
12,30,240,17,13,4
12,30,241,11,11,0
12,30,242,11,9,2
12,30,243,21,11,10
12,30,244,14,10,4
12,30,245,26,12,14
12,30,246,8,14,-6
12,30,247,20,13,7
12,30,248,10,18,-8
12,30,249,25,13,12
12,30,250,23,13,10
12,30,251,20,11,9
12,30,252,25,11,14
12,30,253,22,8,14
12,30,254,15,9,6
12,30,255,8,10,-2
12,30,256,22,12,10
12,30,257,17,16,1
12,30,258,12,5,7
12,30,259,29,8,21
12,30,260,24,5,19
12,30,261,33,21,12
12,30,262,15,13,2
12,30,263,21,5,16
12,30,264,19,24,-5
12,30,265,20,13,7
12,30,266,15,14,1
12,30,267,25,10,15
12,30,268,12,4,8
12,30,269,18,16,2
12,30,270,6,6,0
12,30,271,21,11,10
12,30,272,19,10,9
12,30,273,27,25,2
12,30,274,23,11,12
12,30,275,10,5,5
12,30,276,13,9,4
12,30,277,16,9,7
12,30,278,24,13,11
12,30,279,15,8,7
12,30,280,19,11,8
12,30,281,16,8,8
12,30,282,26,19,7
12,30,283,26,14,12
12,30,284,15,4,11
12,30,285,11,13,-2
12,30,286,15,5,10
12,30,287,17,10,7
12,30,288,19,10,9
12,30,289,20,17,3
12,30,290,18,4,14
12,30,291,6,8,-2
12,30,292,16,19,-3
12,30,293,26,21,5
12,30,294,19,9,10
12,30,295,12,2,10
12,30,296,26,18,8
12,30,297,24,13,11
12,30,298,25,15,10
12,30,299,12,10,2
13,1,0,6,21,-15
13,1,1,11,4,7
13,1,2,13,8,5
13,1,3,14,25,-11
13,1,4,5,31,-26
13,1,5,8,10,-2
13,1,6,6,6,0
13,1,7,8,16,-8
13,1,8,6,7,-1
13,1,9,8,17,-9
13,1,10,3,23,-20
13,1,11,13,7,6
13,1,12,11,18,-7
13,1,13,4,4,0
13,1,14,9,17,-8
13,1,15,6,11,-5
13,1,16,14,22,-8
13,1,17,24,19,5
13,1,18,12,27,-15
13,1,19,9,10,-1
13,1,20,11,17,-6
13,1,21,11,19,-8
13,1,22,10,17,-7
13,1,23,11,9,2
13,1,24,5,9,-4
13,1,25,11,18,-7
13,1,26,6,10,-4
13,1,27,10,13,-3
13,1,28,14,23,-9
13,1,29,18,27,-9
13,1,30,5,9,-4
13,1,31,10,17,-7
13,1,32,2,7,-5
13,1,33,8,12,-4
13,1,34,12,9,3
13,1,35,4,12,-8
13,1,36,6,9,-3
13,1,37,11,15,-4
13,1,38,12,4,8
13,1,39,9,22,-13
13,1,40,8,5,3
13,1,41,14,17,-3
13,1,42,3,8,-5
13,1,43,8,13,-5
13,1,44,8,9,-1
13,1,45,17,29,-12
13,1,46,18,10,8
13,1,47,6,11,-5
13,1,48,6,15,-9
13,1,49,5,14,-9
13,1,50,10,22,-12
13,1,51,8,18,-10
13,1,52,14,9,5
13,1,53,9,10,-1
13,1,54,2,8,-6
13,1,55,3,11,-8
13,1,56,4,20,-16
13,1,57,10,21,-11
13,1,58,10,21,-11
13,1,59,16,14,2
13,1,60,5,16,-11
13,1,61,7,13,-6
13,1,62,10,19,-9
13,1,63,13,11,2
13,1,64,4,28,-24
13,1,65,13,20,-7
13,1,66,5,14,-9
13,1,67,10,13,-3
13,1,68,18,25,-7
13,1,69,6,21,-15
13,1,70,11,11,0
13,1,71,8,25,-17
13,1,72,2,12,-10
13,1,73,9,18,-9
13,1,74,24,20,4
13,1,75,10,19,-9
13,1,76,6,16,-10
13,1,77,5,7,-2
13,1,78,10,19,-9
13,1,79,9,4,5
13,1,80,13,10,3
13,1,81,9,8,1
13,1,82,13,13,0
13,1,83,1,1,0
13,1,84,8,7,1
13,1,85,10,11,-1
13,1,86,6,22,-16
13,1,87,8,20,-12
13,1,88,9,13,-4
13,1,89,13,13,0
13,1,90,11,10,1
13,1,91,20,23,-3
13,1,92,8,11,-3
13,1,93,8,20,-12
13,1,94,14,13,1
13,1,95,10,6,4
13,1,96,18,16,2
13,1,97,2,10,-8
13,1,98,12,24,-12
13,1,99,5,12,-7
13,1,100,6,28,-22
13,1,101,7,19,-12
13,1,102,5,12,-7
13,1,103,5,13,-8
13,1,104,2,12,-10
13,1,105,5,12,-7
13,1,106,9,22,-13
13,1,107,9,19,-10
13,1,108,5,4,1
13,1,109,3,12,-9
13,1,110,7,8,-1
13,1,111,9,12,-3
13,1,112,8,4,4
13,1,113,10,35,-25
13,1,114,8,15,-7
13,1,115,10,7,3
13,1,116,11,17,-6
13,1,117,9,6,3
13,1,118,8,19,-11
13,1,119,19,12,7
13,1,120,15,10,5
13,1,121,7,17,-10
13,1,122,11,18,-7
13,1,123,15,15,0
13,1,124,2,9,-7
13,1,125,5,16,-11
13,1,126,6,7,-1
13,1,127,16,10,6
13,1,128,7,9,-2
13,1,129,9,7,2
13,1,130,7,10,-3
13,1,131,7,12,-5
13,1,132,10,25,-15
13,1,133,9,18,-9
13,1,134,9,12,-3
13,1,135,16,7,9
13,1,136,9,25,-16
13,1,137,18,23,-5
13,1,138,5,16,-11
13,1,139,6,7,-1
13,1,140,6,13,-7
13,1,141,23,8,15
13,1,142,11,28,-17
13,1,143,9,20,-11
13,1,144,7,12,-5
13,1,145,13,29,-16
13,1,146,8,18,-10
13,1,147,4,21,-17
13,1,148,5,9,-4
13,1,149,6,20,-14
13,1,150,5,9,-4
13,1,151,6,10,-4
13,1,152,7,19,-12
13,1,153,12,30,-18
13,1,154,3,20,-17
13,1,155,8,21,-13
13,1,156,8,12,-4
13,1,157,8,16,-8
13,1,158,6,15,-9
13,1,159,9,22,-13
13,1,160,7,5,2
13,1,161,6,19,-13
13,1,162,9,14,-5
13,1,163,11,20,-9
13,1,164,11,11,0
13,1,165,11,14,-3
13,1,166,8,17,-9
13,1,167,10,11,-1
13,1,168,13,18,-5
13,1,169,18,13,5
13,1,170,14,12,2
13,1,171,7,9,-2
13,1,172,9,12,-3
13,1,173,11,9,2
13,1,174,12,25,-13
13,1,175,14,15,-1
13,1,176,9,18,-9
13,1,177,9,10,-1
13,1,178,10,21,-11
13,1,179,6,12,-6
13,1,180,2,14,-12
13,1,181,5,9,-4
13,1,182,6,29,-23
13,1,183,6,8,-2
13,1,184,6,14,-8
13,1,185,6,17,-11
13,1,186,8,17,-9
13,1,187,3,6,-3
13,1,188,10,23,-13
13,1,189,7,14,-7
13,1,190,11,15,-4
13,1,191,18,22,-4
13,1,192,9,9,0
13,1,193,9,10,-1
13,1,194,4,7,-3
13,1,195,18,15,3
13,1,196,21,29,-8
13,1,197,4,22,-18
13,1,198,11,10,1
13,1,199,19,13,6
13,1,200,16,14,2
13,1,201,11,26,-15
13,1,202,7,10,-3
13,1,203,14,15,-1
13,1,204,10,6,4
13,1,205,4,10,-6
13,1,206,11,35,-24
13,1,207,14,19,-5
13,1,208,9,18,-9
13,1,209,27,13,14
13,1,210,12,24,-12
13,1,211,7,12,-5
13,1,212,4,4,0
13,1,213,10,16,-6
13,1,214,21,16,5
13,1,215,5,18,-13
13,1,216,6,10,-4
13,1,217,7,16,-9
13,1,218,23,18,5
13,1,219,14,10,4
13,1,220,7,14,-7
13,1,221,14,21,-7
13,1,222,4,16,-12
13,1,223,8,9,-1
13,1,224,2,28,-26
13,1,225,5,12,-7
13,1,226,6,6,0
13,1,227,9,8,1
13,1,228,1,14,-13
13,1,229,9,14,-5
13,1,230,10,27,-17
13,1,231,6,11,-5
13,1,232,9,13,-4
13,1,233,7,8,-1
13,1,234,7,17,-10
13,1,235,7,7,0
13,1,236,5,15,-10
13,1,237,7,23,-16
13,1,238,8,10,-2
13,1,239,12,14,-2
13,1,240,6,11,-5
13,1,241,13,27,-14
13,1,242,8,10,-2
13,1,243,3,7,-4
13,1,244,10,7,3
13,1,245,11,10,1
13,1,246,5,11,-6
13,1,247,3,14,-11
13,1,248,20,15,5
13,1,249,10,29,-19
13,1,250,1,5,-4
13,1,251,6,10,-4
13,1,252,9,10,-1
13,1,253,8,14,-6
13,1,254,7,29,-22
13,1,255,10,17,-7
13,1,256,12,18,-6
13,1,257,8,11,-3
13,1,258,14,11,3
13,1,259,11,12,-1
13,1,260,17,19,-2
13,1,261,8,13,-5
13,1,262,3,7,-4
13,1,263,14,9,5
13,1,264,7,15,-8
13,1,265,7,6,1
13,1,266,10,16,-6
13,1,267,5,13,-8
13,1,268,10,16,-6
13,1,269,9,37,-28
13,1,270,17,15,2
13,1,271,7,13,-6
13,1,272,9,15,-6
13,1,273,7,10,-3
13,1,274,10,13,-3
13,1,275,6,6,0
13,1,276,9,13,-4
13,1,277,15,19,-4
13,1,278,11,15,-4
13,1,279,7,5,2
13,1,280,8,9,-1
13,1,281,8,14,-6
13,1,282,11,22,-11
13,1,283,3,11,-8
13,1,284,5,6,-1
13,1,285,12,12,0
13,1,286,16,21,-5
13,1,287,7,19,-12
13,1,288,8,9,-1
13,1,289,15,18,-3
13,1,290,15,14,1
13,1,291,5,9,-4
13,1,292,10,12,-2
13,1,293,10,16,-6
13,1,294,7,20,-13
13,1,295,12,9,3
13,1,296,10,15,-5
13,1,297,15,9,6
13,1,298,3,12,-9
13,1,299,5,11,-6
13,2,0,11,9,2
13,2,1,12,11,1
13,2,2,8,10,-2
13,2,3,7,13,-6
13,2,4,8,29,-21
13,2,5,9,18,-9
13,2,6,6,22,-16
13,2,7,9,7,2
13,2,8,15,13,2
13,2,9,9,19,-10
13,2,10,6,11,-5
13,2,11,12,13,-1
13,2,12,10,16,-6
13,2,13,5,16,-11
13,2,14,9,8,1
13,2,15,6,9,-3
13,2,16,20,12,8
13,2,17,12,14,-2
13,2,18,2,11,-9
13,2,19,4,8,-4
13,2,20,9,12,-3
13,2,21,9,18,-9
13,2,22,6,22,-16
13,2,23,18,19,-1
13,2,24,9,22,-13
13,2,25,9,14,-5
13,2,26,4,23,-19
13,2,27,14,8,6
13,2,28,6,8,-2
13,2,29,5,7,-2
13,2,30,13,10,3
13,2,31,5,5,0
13,2,32,7,15,-8
13,2,33,4,25,-21
13,2,34,4,23,-19
13,2,35,20,17,3
13,2,36,4,6,-2
13,2,37,17,15,2
13,2,38,7,10,-3
13,2,39,6,13,-7
13,2,40,11,5,6
13,2,41,10,12,-2
13,2,42,9,3,6
13,2,43,4,9,-5
13,2,44,3,8,-5
13,2,45,18,16,2
13,2,46,7,8,-1
13,2,47,18,32,-14
13,2,48,16,18,-2
13,2,49,9,25,-16
13,2,50,4,8,-4
13,2,51,4,23,-19
13,2,52,17,26,-9
13,2,53,12,15,-3
13,2,54,7,12,-5
13,2,55,2,16,-14
13,2,56,19,22,-3
13,2,57,12,11,1
13,2,58,8,5,3
13,2,59,12,6,6
13,2,60,18,23,-5
13,2,61,8,17,-9
13,2,62,4,5,-1
13,2,63,4,9,-5
13,2,64,12,11,1
13,2,65,14,13,1
13,2,66,12,15,-3
13,2,67,10,17,-7
13,2,68,12,20,-8
13,2,69,9,14,-5
13,2,70,3,14,-11
13,2,71,10,17,-7
13,2,72,4,15,-11
13,2,73,12,16,-4
13,2,74,5,15,-10
13,2,75,13,10,3
13,2,76,12,20,-8
13,2,77,9,11,-2
13,2,78,13,24,-11
13,2,79,10,8,2
13,2,80,9,12,-3
13,2,81,3,4,-1
13,2,82,7,22,-15
13,2,83,12,19,-7
13,2,84,12,22,-10
13,2,85,16,24,-8
13,2,86,10,13,-3
13,2,87,5,11,-6
13,2,88,18,17,1
13,2,89,5,7,-2
13,2,90,3,17,-14
13,2,91,13,10,3
13,2,92,7,23,-16
13,2,93,12,16,-4
13,2,94,7,19,-12
13,2,95,13,10,3
13,2,96,12,12,0
13,2,97,10,21,-11
13,2,98,13,12,1
13,2,99,11,7,4
13,2,100,4,27,-23
13,2,101,5,18,-13
13,2,102,9,9,0
13,2,103,9,7,2
13,2,104,13,7,6
13,2,105,14,20,-6
13,2,106,13,18,-5
13,2,107,10,21,-11
13,2,108,10,14,-4
13,2,109,5,18,-13
13,2,110,8,15,-7
13,2,111,4,22,-18
13,2,112,12,15,-3
13,2,113,13,19,-6
13,2,114,4,14,-10
13,2,115,13,27,-14
13,2,116,8,9,-1
13,2,117,13,24,-11
13,2,118,8,41,-33
13,2,119,9,30,-21
13,2,120,11,30,-19
13,2,121,11,10,1
13,2,122,23,17,6
13,2,123,8,30,-22
13,2,124,19,15,4
13,2,125,13,19,-6
13,2,126,9,13,-4
13,2,127,11,14,-3
13,2,128,22,27,-5
13,2,129,13,4,9
13,2,130,10,17,-7
13,2,131,2,15,-13
13,2,132,7,14,-7
13,2,133,23,13,10
13,2,134,7,17,-10
13,2,135,8,29,-21
13,2,136,12,15,-3
13,2,137,15,27,-12
13,2,138,8,9,-1
13,2,139,6,12,-6
13,2,140,10,25,-15
13,2,141,4,7,-3
13,2,142,5,17,-12
13,2,143,12,6,6
13,2,144,7,14,-7
13,2,145,4,12,-8
13,2,146,15,17,-2
13,2,147,6,10,-4
13,2,148,11,14,-3
13,2,149,5,11,-6
13,2,150,7,12,-5
13,2,151,13,21,-8
13,2,152,7,18,-11
13,2,153,22,10,12
13,2,154,8,23,-15
13,2,155,2,22,-20
13,2,156,16,21,-5
13,2,157,16,12,4
13,2,158,17,24,-7
13,2,159,8,22,-14
13,2,160,11,28,-17
13,2,161,10,11,-1
13,2,162,7,19,-12
13,2,163,7,19,-12
13,2,164,21,16,5
13,2,165,5,8,-3
13,2,166,18,32,-14
13,2,167,9,13,-4
13,2,168,12,20,-8
13,2,169,8,7,1
13,2,170,15,20,-5
13,2,171,7,12,-5
13,2,172,10,18,-8
13,2,173,8,14,-6
13,2,174,12,23,-11
13,2,175,13,18,-5
13,2,176,13,11,2
13,2,177,6,14,-8
13,2,178,9,8,1
13,2,179,4,7,-3
13,2,180,7,8,-1
13,2,181,15,12,3
13,2,182,10,23,-13
13,2,183,15,8,7
13,2,184,4,6,-2
13,2,185,10,19,-9
13,2,186,16,27,-11
13,2,187,8,10,-2
13,2,188,17,12,5
13,2,189,15,17,-2
13,2,190,7,12,-5
13,2,191,9,12,-3
13,2,192,15,20,-5
13,2,193,7,16,-9
13,2,194,4,8,-4
13,2,195,8,11,-3
13,2,196,11,21,-10
13,2,197,10,8,2
13,2,198,14,11,3
13,2,199,10,17,-7
13,2,200,14,21,-7
13,2,201,14,14,0
13,2,202,7,12,-5
13,2,203,7,21,-14
13,2,204,14,22,-8
13,2,205,12,12,0
13,2,206,20,25,-5
13,2,207,7,8,-1
13,2,208,10,19,-9
13,2,209,15,10,5
13,2,210,6,14,-8
13,2,211,9,10,-1
13,2,212,3,18,-15
13,2,213,6,13,-7
13,2,214,18,25,-7
13,2,215,10,27,-17
13,2,216,3,9,-6
13,2,217,4,16,-12
13,2,218,4,9,-5
13,2,219,12,12,0
13,2,220,8,19,-11
13,2,221,12,23,-11
13,2,222,13,29,-16
13,2,223,1,11,-10
13,2,224,7,26,-19
13,2,225,7,11,-4
13,2,226,2,7,-5
13,2,227,15,20,-5
13,2,228,10,12,-2
13,2,229,7,9,-2
13,2,230,20,26,-6
13,2,231,15,23,-8
13,2,232,16,22,-6
13,2,233,9,16,-7
13,2,234,13,19,-6
13,2,235,3,16,-13
13,2,236,4,13,-9
13,2,237,7,14,-7
13,2,238,8,13,-5
13,2,239,12,17,-5
13,2,240,11,18,-7
13,2,241,9,15,-6
13,2,242,10,16,-6
13,2,243,16,20,-4
13,2,244,7,18,-11
13,2,245,9,12,-3
13,2,246,7,11,-4
13,2,247,16,6,10
13,2,248,7,12,-5
13,2,249,18,18,0
13,2,250,10,20,-10
13,2,251,3,5,-2
13,2,252,6,23,-17
13,2,253,3,11,-8
13,2,254,15,21,-6
13,2,255,9,27,-18
13,2,256,5,7,-2
13,2,257,6,14,-8
13,2,258,5,16,-11
13,2,259,5,10,-5
13,2,260,17,25,-8
13,2,261,10,9,1
13,2,262,10,28,-18
13,2,263,23,16,7
13,2,264,16,11,5
13,2,265,15,18,-3
13,2,266,8,3,5
13,2,267,10,15,-5
13,2,268,14,5,9
13,2,269,4,11,-7
13,2,270,9,13,-4
13,2,271,8,17,-9
13,2,272,6,16,-10
13,2,273,9,11,-2
13,2,274,7,8,-1
13,2,275,4,8,-4
13,2,276,8,19,-11
13,2,277,10,11,-1
13,2,278,11,23,-12
13,2,279,14,21,-7
13,2,280,8,23,-15
13,2,281,13,13,0
13,2,282,10,14,-4
13,2,283,9,13,-4
13,2,284,14,4,10
13,2,285,6,13,-7
13,2,286,9,17,-8
13,2,287,9,21,-12
13,2,288,6,10,-4
13,2,289,7,7,0
13,2,290,11,11,0
13,2,291,5,12,-7
13,2,292,13,21,-8
13,2,293,16,24,-8
13,2,294,1,2,-1
13,2,295,16,28,-12
13,2,296,7,21,-14
13,2,297,11,16,-5
13,2,298,8,21,-13
13,2,299,7,8,-1
13,3,0,13,24,-11
13,3,1,12,14,-2
13,3,2,12,14,-2
13,3,3,7,23,-16
13,3,4,9,15,-6
13,3,5,14,21,-7
13,3,6,12,7,5
13,3,7,10,14,-4
13,3,8,17,15,2
13,3,9,11,15,-4
13,3,10,9,14,-5
13,3,11,2,8,-6
13,3,12,18,20,-2
13,3,13,6,13,-7
13,3,14,17,21,-4
13,3,15,17,23,-6
13,3,16,4,17,-13
13,3,17,15,24,-9
13,3,18,20,23,-3
13,3,19,8,15,-7
13,3,20,3,14,-11
13,3,21,7,13,-6
13,3,22,9,9,0
13,3,23,15,15,0
13,3,24,26,24,2
13,3,25,13,12,1
13,3,26,4,2,2
13,3,27,17,26,-9
13,3,28,7,17,-10
13,3,29,11,14,-3
13,3,30,6,14,-8
13,3,31,9,11,-2
13,3,32,12,25,-13
13,3,33,14,13,1
13,3,34,8,11,-3
13,3,35,10,24,-14
13,3,36,13,30,-17
13,3,37,5,17,-12
13,3,38,3,11,-8
13,3,39,8,19,-11
13,3,40,3,6,-3
13,3,41,10,19,-9
13,3,42,11,16,-5
13,3,43,6,18,-12
13,3,44,12,15,-3
13,3,45,19,7,12
13,3,46,29,13,16
13,3,47,24,24,0
13,3,48,6,19,-13
13,3,49,12,23,-11
13,3,50,15,20,-5
13,3,51,8,11,-3
13,3,52,9,30,-21
13,3,53,17,13,4
13,3,54,8,19,-11
13,3,55,14,19,-5
13,3,56,5,12,-7
13,3,57,21,31,-10
13,3,58,16,15,1
13,3,59,14,11,3
13,3,60,7,10,-3
13,3,61,4,16,-12
13,3,62,7,11,-4
13,3,63,11,12,-1
13,3,64,7,15,-8
13,3,65,4,9,-5
13,3,66,20,27,-7
13,3,67,13,18,-5
13,3,68,16,11,5
13,3,69,15,15,0
13,3,70,8,8,0
13,3,71,6,32,-26
13,3,72,11,17,-6
13,3,73,8,16,-8
13,3,74,7,5,2
13,3,75,12,11,1
13,3,76,19,10,9
13,3,77,12,19,-7
13,3,78,12,9,3
13,3,79,23,19,4
13,3,80,19,15,4
13,3,81,19,23,-4
13,3,82,5,3,2
13,3,83,16,13,3
13,3,84,11,20,-9
13,3,85,8,20,-12
13,3,86,28,20,8
13,3,87,8,17,-9
13,3,88,10,17,-7
13,3,89,13,22,-9
13,3,90,11,6,5
13,3,91,14,20,-6
13,3,92,7,13,-6
13,3,93,16,18,-2
13,3,94,13,21,-8
13,3,95,3,14,-11
13,3,96,11,8,3
13,3,97,6,9,-3
13,3,98,26,16,10
13,3,99,7,13,-6
13,3,100,4,11,-7
13,3,101,16,13,3
13,3,102,17,19,-2
13,3,103,10,20,-10
13,3,104,15,27,-12
13,3,105,4,6,-2
13,3,106,6,9,-3
13,3,107,9,7,2
13,3,108,14,15,-1
13,3,109,12,19,-7
13,3,110,9,10,-1
13,3,111,9,23,-14
13,3,112,9,22,-13
13,3,113,6,19,-13
13,3,114,9,8,1
13,3,115,4,10,-6
13,3,116,3,14,-11
13,3,117,21,17,4
13,3,118,13,8,5
13,3,119,6,11,-5
13,3,120,13,6,7
13,3,121,8,18,-10
13,3,122,15,19,-4
13,3,123,24,26,-2
13,3,124,6,14,-8
13,3,125,17,25,-8
13,3,126,12,20,-8
13,3,127,10,18,-8
13,3,128,15,15,0
13,3,129,6,20,-14
13,3,130,11,13,-2
13,3,131,1,4,-3
13,3,132,14,27,-13
13,3,133,9,23,-14
13,3,134,17,34,-17
13,3,135,18,14,4
13,3,136,10,23,-13
13,3,137,20,24,-4
13,3,138,6,13,-7
13,3,139,12,11,1
13,3,140,4,11,-7
13,3,141,9,4,5
13,3,142,18,19,-1
13,3,143,6,12,-6
13,3,144,20,25,-5
13,3,145,11,9,2
13,3,146,11,22,-11
13,3,147,5,17,-12
13,3,148,22,23,-1
13,3,149,13,30,-17
13,3,150,11,17,-6
13,3,151,7,20,-13
13,3,152,16,21,-5
13,3,153,5,15,-10
13,3,154,8,8,0
13,3,155,5,26,-21
13,3,156,8,27,-19
13,3,157,17,21,-4
13,3,158,16,22,-6
13,3,159,20,44,-24
13,3,160,7,11,-4
13,3,161,18,18,0
13,3,162,18,15,3
13,3,163,11,25,-14
13,3,164,15,11,4
13,3,165,11,19,-8
13,3,166,3,14,-11
13,3,167,13,10,3
13,3,168,5,15,-10
13,3,169,9,10,-1
13,3,170,8,10,-2
13,3,171,7,27,-20
13,3,172,12,21,-9
13,3,173,10,18,-8
13,3,174,6,11,-5
13,3,175,5,11,-6
13,3,176,8,22,-14
13,3,177,3,15,-12
13,3,178,14,11,3
13,3,179,12,15,-3
13,3,180,8,13,-5
13,3,181,8,12,-4
13,3,182,13,7,6
13,3,183,8,19,-11
13,3,184,13,12,1
13,3,185,6,4,2
13,3,186,23,29,-6
13,3,187,9,18,-9
13,3,188,10,28,-18
13,3,189,7,11,-4
13,3,190,6,8,-2
13,3,191,14,8,6
13,3,192,12,10,2
13,3,193,4,6,-2
13,3,194,8,14,-6
13,3,195,19,19,0
13,3,196,9,15,-6
13,3,197,11,25,-14
13,3,198,17,12,5
13,3,199,8,17,-9
13,3,200,13,10,3
13,3,201,12,18,-6
13,3,202,4,10,-6
13,3,203,13,16,-3
13,3,204,11,9,2
13,3,205,19,13,6
13,3,206,8,17,-9
13,3,207,9,8,1
13,3,208,15,22,-7
13,3,209,12,21,-9
13,3,210,9,13,-4
13,3,211,9,20,-11
13,3,212,7,8,-1
13,3,213,12,21,-9
13,3,214,9,15,-6
13,3,215,9,8,1
13,3,216,22,18,4
13,3,217,9,35,-26
13,3,218,11,17,-6
13,3,219,13,36,-23
13,3,220,10,20,-10
13,3,221,10,15,-5
13,3,222,15,16,-1
13,3,223,3,15,-12
13,3,224,7,14,-7
13,3,225,12,16,-4
13,3,226,7,16,-9
13,3,227,17,21,-4
13,3,228,16,16,0
13,3,229,19,28,-9
13,3,230,13,17,-4
13,3,231,15,18,-3
13,3,232,5,12,-7
13,3,233,11,19,-8
13,3,234,9,34,-25
13,3,235,5,9,-4
13,3,236,9,14,-5
13,3,237,17,22,-5
13,3,238,10,12,-2
13,3,239,15,15,0
13,3,240,2,17,-15
13,3,241,17,26,-9
13,3,242,9,18,-9
13,3,243,4,12,-8
13,3,244,26,13,13
13,3,245,12,18,-6
13,3,246,4,5,-1
13,3,247,7,12,-5
13,3,248,20,20,0
13,3,249,15,20,-5
13,3,250,3,8,-5
13,3,251,1,15,-14
13,3,252,4,10,-6
13,3,253,7,5,2
13,3,254,23,32,-9
13,3,255,15,31,-16
13,3,256,10,21,-11
13,3,257,8,18,-10
13,3,258,13,14,-1
13,3,259,8,14,-6
13,3,260,6,13,-7
13,3,261,11,17,-6
13,3,262,15,15,0
13,3,263,10,19,-9
13,3,264,11,27,-16
13,3,265,19,10,9
13,3,266,10,24,-14
13,3,267,11,15,-4
13,3,268,6,15,-9
13,3,269,8,14,-6
13,3,270,8,19,-11
13,3,271,7,21,-14
13,3,272,12,23,-11
13,3,273,10,10,0
13,3,274,7,16,-9
13,3,275,4,10,-6
13,3,276,10,15,-5
13,3,277,11,24,-13
13,3,278,12,16,-4
13,3,279,18,24,-6
13,3,280,20,13,7
13,3,281,8,28,-20
13,3,282,5,7,-2
13,3,283,3,18,-15
13,3,284,14,22,-8
13,3,285,9,10,-1
13,3,286,26,11,15
13,3,287,14,16,-2
13,3,288,8,17,-9
13,3,289,16,19,-3
13,3,290,13,9,4
13,3,291,6,31,-25
13,3,292,6,20,-14
13,3,293,13,19,-6
13,3,294,12,23,-11
13,3,295,12,8,4
13,3,296,10,10,0
13,3,297,11,30,-19
13,3,298,11,10,1
13,3,299,15,20,-5
13,4,0,21,18,3
13,4,1,15,17,-2
13,4,2,7,23,-16
13,4,3,5,11,-6
13,4,4,13,10,3
13,4,5,6,27,-21
13,4,6,8,15,-7
13,4,7,17,31,-14
13,4,8,5,15,-10
13,4,9,5,14,-9
13,4,10,7,11,-4
13,4,11,11,24,-13
13,4,12,12,17,-5
13,4,13,10,21,-11
13,4,14,11,34,-23
13,4,15,7,12,-5
13,4,16,20,18,2
13,4,17,13,17,-4
13,4,18,13,30,-17
13,4,19,19,26,-7
13,4,20,11,14,-3
13,4,21,9,5,4
13,4,22,10,15,-5
13,4,23,15,13,2
13,4,24,6,8,-2
13,4,25,6,17,-11
13,4,26,24,12,12
13,4,27,9,17,-8
13,4,28,8,11,-3
13,4,29,9,7,2
13,4,30,12,24,-12
13,4,31,13,13,0
13,4,32,10,9,1
13,4,33,13,15,-2
13,4,34,11,15,-4
13,4,35,12,10,2
13,4,36,13,10,3
13,4,37,18,17,1
13,4,38,18,21,-3
13,4,39,13,13,0
13,4,40,2,25,-23
13,4,41,3,14,-11
13,4,42,7,18,-11
13,4,43,12,33,-21
13,4,44,9,23,-14
13,4,45,6,12,-6
13,4,46,9,15,-6
13,4,47,6,15,-9
13,4,48,12,18,-6
13,4,49,8,14,-6
13,4,50,18,12,6
13,4,51,11,12,-1
13,4,52,6,20,-14
13,4,53,12,20,-8
13,4,54,9,22,-13
13,4,55,13,29,-16
13,4,56,12,9,3
13,4,57,9,19,-10
13,4,58,17,21,-4
13,4,59,8,25,-17
13,4,60,14,19,-5
13,4,61,17,13,4
13,4,62,13,22,-9
13,4,63,20,26,-6
13,4,64,9,14,-5
13,4,65,14,21,-7
13,4,66,1,21,-20
13,4,67,6,15,-9
13,4,68,4,13,-9
13,4,69,11,20,-9
13,4,70,5,17,-12
13,4,71,23,11,12
13,4,72,22,31,-9
13,4,73,17,11,6
13,4,74,12,6,6
13,4,75,13,23,-10
13,4,76,12,34,-22
13,4,77,14,23,-9
13,4,78,11,14,-3
13,4,79,21,31,-10
13,4,80,19,21,-2
13,4,81,7,15,-8
13,4,82,2,5,-3
13,4,83,15,27,-12
13,4,84,5,13,-8
13,4,85,15,14,1
13,4,86,9,27,-18
13,4,87,13,21,-8
13,4,88,10,12,-2
13,4,89,11,18,-7
13,4,90,7,6,1
13,4,91,11,13,-2
13,4,92,12,23,-11
13,4,93,3,14,-11
13,4,94,14,18,-4
13,4,95,4,6,-2
13,4,96,15,29,-14
13,4,97,14,18,-4
13,4,98,18,21,-3
13,4,99,8,10,-2
13,4,100,14,31,-17
13,4,101,5,11,-6
13,4,102,7,11,-4
13,4,103,12,9,3
13,4,104,17,14,3
13,4,105,5,6,-1
13,4,106,9,9,0
13,4,107,14,9,5
13,4,108,11,13,-2
13,4,109,5,12,-7
13,4,110,9,10,-1
13,4,111,12,10,2
13,4,112,13,16,-3
13,4,113,15,10,5
13,4,114,16,46,-30
13,4,115,11,19,-8
13,4,116,13,24,-11
13,4,117,14,28,-14
13,4,118,14,15,-1
13,4,119,17,29,-12
13,4,120,13,22,-9
13,4,121,12,14,-2
13,4,122,7,23,-16
13,4,123,14,8,6
13,4,124,15,20,-5
13,4,125,7,16,-9
13,4,126,14,22,-8
13,4,127,11,15,-4
13,4,128,7,20,-13
13,4,129,15,24,-9
13,4,130,8,14,-6
13,4,131,7,16,-9
13,4,132,20,5,15
13,4,133,5,11,-6
13,4,134,13,14,-1
13,4,135,5,16,-11
13,4,136,13,26,-13
13,4,137,8,15,-7
13,4,138,8,9,-1
13,4,139,18,18,0
13,4,140,15,11,4
13,4,141,13,12,1
13,4,142,6,18,-12
13,4,143,11,12,-1
13,4,144,12,28,-16
13,4,145,10,11,-1
13,4,146,7,13,-6
13,4,147,14,7,7
13,4,148,5,16,-11
13,4,149,11,23,-12
13,4,150,16,19,-3
13,4,151,8,6,2
13,4,152,7,4,3
13,4,153,21,26,-5
13,4,154,15,17,-2
13,4,155,11,9,2
13,4,156,7,9,-2
13,4,157,5,9,-4
13,4,158,8,24,-16
13,4,159,14,35,-21
13,4,160,23,20,3
13,4,161,7,13,-6
13,4,162,10,19,-9
13,4,163,6,10,-4
13,4,164,22,34,-12
13,4,165,7,8,-1
13,4,166,7,8,-1
13,4,167,16,24,-8
13,4,168,2,12,-10
13,4,169,12,22,-10
13,4,170,7,16,-9
13,4,171,10,22,-12
13,4,172,7,9,-2
13,4,173,14,17,-3
13,4,174,17,22,-5
13,4,175,4,23,-19
13,4,176,8,21,-13
13,4,177,8,21,-13
13,4,178,10,18,-8
13,4,179,8,16,-8
13,4,180,14,16,-2
13,4,181,12,28,-16
13,4,182,15,16,-1
13,4,183,10,27,-17
13,4,184,9,13,-4
13,4,185,15,18,-3
13,4,186,24,20,4
13,4,187,10,6,4
13,4,188,10,16,-6
13,4,189,7,13,-6
13,4,190,18,10,8
13,4,191,11,14,-3
13,4,192,11,15,-4
13,4,193,7,11,-4
13,4,194,11,16,-5
13,4,195,14,23,-9
13,4,196,14,15,-1
13,4,197,15,18,-3
13,4,198,9,18,-9
13,4,199,13,15,-2
13,4,200,9,18,-9
13,4,201,2,13,-11
13,4,202,13,25,-12
13,4,203,9,7,2
13,4,204,9,22,-13
13,4,205,8,15,-7
13,4,206,11,26,-15
13,4,207,8,14,-6
13,4,208,10,17,-7
13,4,209,5,24,-19
13,4,210,6,11,-5
13,4,211,13,18,-5
13,4,212,7,10,-3
13,4,213,11,33,-22
13,4,214,13,27,-14
13,4,215,6,16,-10
13,4,216,16,5,11
13,4,217,13,17,-4
13,4,218,15,25,-10
13,4,219,5,10,-5
13,4,220,13,9,4
13,4,221,5,20,-15
13,4,222,3,22,-19
13,4,223,4,15,-11
13,4,224,16,21,-5
13,4,225,10,23,-13
13,4,226,12,18,-6
13,4,227,7,20,-13
13,4,228,16,30,-14
13,4,229,2,8,-6
13,4,230,10,17,-7
13,4,231,20,17,3
13,4,232,5,11,-6
13,4,233,12,15,-3
13,4,234,16,15,1
13,4,235,19,16,3
13,4,236,16,19,-3
13,4,237,15,16,-1
13,4,238,20,13,7
13,4,239,21,14,7
13,4,240,5,11,-6
13,4,241,5,15,-10
13,4,242,10,27,-17
13,4,243,4,19,-15
13,4,244,6,20,-14
13,4,245,8,20,-12
13,4,246,3,4,-1
13,4,247,22,32,-10
13,4,248,13,26,-13
13,4,249,18,33,-15
13,4,250,10,14,-4
13,4,251,24,22,2
13,4,252,3,10,-7
13,4,253,3,9,-6
13,4,254,9,13,-4
13,4,255,10,11,-1
13,4,256,11,7,4
13,4,257,7,16,-9
13,4,258,9,12,-3
13,4,259,1,13,-12
13,4,260,8,17,-9
13,4,261,4,6,-2
13,4,262,14,25,-11
13,4,263,6,20,-14
13,4,264,6,13,-7
13,4,265,8,19,-11
13,4,266,8,12,-4
13,4,267,11,14,-3
13,4,268,16,22,-6
13,4,269,10,17,-7
13,4,270,9,27,-18
13,4,271,9,25,-16
13,4,272,4,9,-5
13,4,273,3,13,-10
13,4,274,8,20,-12
13,4,275,4,24,-20
13,4,276,11,31,-20
13,4,277,14,6,8
13,4,278,11,17,-6
13,4,279,3,19,-16
13,4,280,13,19,-6
13,4,281,16,19,-3
13,4,282,7,7,0
13,4,283,16,9,7
13,4,284,14,20,-6
13,4,285,7,11,-4
13,4,286,4,14,-10
13,4,287,9,24,-15
13,4,288,6,14,-8
13,4,289,14,22,-8
13,4,290,4,16,-12
13,4,291,8,11,-3
13,4,292,11,13,-2
13,4,293,11,29,-18
13,4,294,11,19,-8
13,4,295,17,13,4
13,4,296,15,23,-8
13,4,297,8,11,-3
13,4,298,12,8,4
13,4,299,12,26,-14
13,5,0,6,5,1
13,5,1,8,21,-13
13,5,2,11,20,-9
13,5,3,18,13,5
13,5,4,4,12,-8
13,5,5,9,18,-9
13,5,6,8,24,-16
13,5,7,12,32,-20
13,5,8,9,14,-5
13,5,9,19,10,9
13,5,10,25,20,5
13,5,11,8,27,-19
13,5,12,18,19,-1
13,5,13,12,22,-10
13,5,14,14,10,4
13,5,15,3,12,-9
13,5,16,6,21,-15
13,5,17,23,19,4
13,5,18,5,13,-8
13,5,19,12,21,-9
13,5,20,13,19,-6
13,5,21,10,27,-17
13,5,22,4,12,-8
13,5,23,4,12,-8
13,5,24,5,15,-10
13,5,25,4,15,-11
13,5,26,15,16,-1
13,5,27,18,11,7
13,5,28,22,23,-1
13,5,29,14,16,-2
13,5,30,8,17,-9
13,5,31,13,19,-6
13,5,32,8,27,-19
13,5,33,10,23,-13
13,5,34,12,13,-1
13,5,35,13,17,-4
13,5,36,11,23,-12
13,5,37,7,9,-2
13,5,38,13,20,-7
13,5,39,7,7,0
13,5,40,12,15,-3
13,5,41,24,15,9
13,5,42,16,39,-23
13,5,43,8,15,-7
13,5,44,10,10,0
13,5,45,11,17,-6
13,5,46,16,15,1
13,5,47,15,20,-5
13,5,48,8,5,3
13,5,49,5,11,-6
13,5,50,12,19,-7
13,5,51,8,13,-5
13,5,52,16,17,-1
13,5,53,4,15,-11
13,5,54,13,16,-3
13,5,55,19,18,1
13,5,56,17,26,-9
13,5,57,16,23,-7
13,5,58,21,28,-7
13,5,59,7,17,-10
13,5,60,13,17,-4
13,5,61,11,8,3
13,5,62,11,26,-15
13,5,63,9,14,-5
13,5,64,10,6,4
13,5,65,23,22,1
13,5,66,12,16,-4
13,5,67,3,12,-9
13,5,68,12,33,-21
13,5,69,23,31,-8
13,5,70,21,37,-16
13,5,71,13,17,-4
13,5,72,10,12,-2
13,5,73,9,16,-7
13,5,74,10,23,-13
13,5,75,9,12,-3
13,5,76,4,9,-5
13,5,77,26,23,3
13,5,78,9,32,-23
13,5,79,19,31,-12
13,5,80,17,30,-13
13,5,81,9,21,-12
13,5,82,8,27,-19
13,5,83,8,16,-8
13,5,84,19,11,8
13,5,85,7,8,-1
13,5,86,11,14,-3
13,5,87,10,22,-12
13,5,88,10,16,-6
13,5,89,25,24,1
13,5,90,19,11,8
13,5,91,21,21,0
13,5,92,15,14,1
13,5,93,14,11,3
13,5,94,16,15,1
13,5,95,7,21,-14
13,5,96,26,20,6
13,5,97,10,12,-2
13,5,98,16,3,13
13,5,99,10,17,-7
13,5,100,4,14,-10
13,5,101,5,15,-10
13,5,102,11,16,-5
13,5,103,13,29,-16
13,5,104,3,13,-10
13,5,105,20,43,-23
13,5,106,14,5,9
13,5,107,7,15,-8
13,5,108,10,34,-24
13,5,109,17,29,-12
13,5,110,7,9,-2
13,5,111,7,15,-8
13,5,112,19,15,4
13,5,113,14,15,-1
13,5,114,15,35,-20
13,5,115,6,16,-10
13,5,116,11,12,-1
13,5,117,9,21,-12
13,5,118,8,14,-6
13,5,119,8,12,-4
13,5,120,5,16,-11
13,5,121,20,20,0
13,5,122,12,30,-18
13,5,123,11,18,-7
13,5,124,12,14,-2
13,5,125,13,21,-8
13,5,126,17,12,5
13,5,127,19,25,-6
13,5,128,13,14,-1
13,5,129,6,9,-3
13,5,130,13,5,8
13,5,131,8,12,-4
13,5,132,9,22,-13
13,5,133,16,34,-18
13,5,134,17,13,4
13,5,135,17,19,-2
13,5,136,7,12,-5
13,5,137,8,16,-8
13,5,138,19,14,5
13,5,139,12,22,-10
13,5,140,16,12,4
13,5,141,16,14,2
13,5,142,13,12,1
13,5,143,13,22,-9
13,5,144,16,25,-9
13,5,145,11,13,-2
13,5,146,19,17,2
13,5,147,18,28,-10
13,5,148,2,5,-3
13,5,149,9,13,-4
13,5,150,13,20,-7
13,5,151,13,16,-3
13,5,152,10,24,-14
13,5,153,10,12,-2
13,5,154,3,20,-17
13,5,155,1,6,-5
13,5,156,12,16,-4
13,5,157,19,28,-9
13,5,158,11,5,6
13,5,159,5,15,-10
13,5,160,15,7,8
13,5,161,24,29,-5
13,5,162,11,13,-2
13,5,163,15,8,7
13,5,164,6,17,-11
13,5,165,13,30,-17
13,5,166,16,15,1
13,5,167,7,25,-18
13,5,168,10,20,-10
13,5,169,18,22,-4
13,5,170,11,15,-4
13,5,171,4,19,-15
13,5,172,9,11,-2
13,5,173,12,26,-14
13,5,174,11,23,-12
13,5,175,14,17,-3
13,5,176,18,16,2
13,5,177,14,20,-6
13,5,178,15,30,-15
13,5,179,12,11,1
13,5,180,16,27,-11
13,5,181,12,23,-11
13,5,182,7,16,-9
13,5,183,8,22,-14
13,5,184,12,22,-10
13,5,185,17,17,0
13,5,186,8,32,-24
13,5,187,6,15,-9
13,5,188,11,43,-32
13,5,189,2,28,-26
13,5,190,16,14,2
13,5,191,12,15,-3
13,5,192,12,31,-19
13,5,193,14,14,0
13,5,194,11,19,-8
13,5,195,7,32,-25
13,5,196,19,21,-2
13,5,197,19,14,5
13,5,198,8,13,-5
13,5,199,5,4,1
13,5,200,9,21,-12
13,5,201,17,18,-1
13,5,202,8,16,-8
13,5,203,14,12,2
13,5,204,9,23,-14
13,5,205,15,24,-9
13,5,206,4,21,-17
13,5,207,14,25,-11
13,5,208,13,21,-8
13,5,209,6,14,-8
13,5,210,10,21,-11
13,5,211,4,22,-18
13,5,212,14,23,-9
13,5,213,13,22,-9
13,5,214,13,19,-6
13,5,215,33,19,14
13,5,216,27,18,9
13,5,217,16,19,-3
13,5,218,17,37,-20
13,5,219,20,28,-8
13,5,220,11,15,-4
13,5,221,8,38,-30
13,5,222,11,13,-2
13,5,223,12,22,-10
13,5,224,12,20,-8
13,5,225,6,13,-7
13,5,226,12,16,-4
13,5,227,11,20,-9
13,5,228,19,19,0
13,5,229,10,17,-7
13,5,230,17,35,-18
13,5,231,18,21,-3
13,5,232,17,26,-9
13,5,233,10,10,0
13,5,234,5,12,-7
13,5,235,16,38,-22
13,5,236,10,14,-4
13,5,237,10,11,-1
13,5,238,15,18,-3
13,5,239,16,8,8
13,5,240,5,13,-8
13,5,241,12,12,0
13,5,242,10,16,-6
13,5,243,20,13,7
13,5,244,26,35,-9
13,5,245,16,8,8
13,5,246,14,11,3
13,5,247,5,23,-18
13,5,248,10,23,-13
13,5,249,7,17,-10
13,5,250,13,19,-6
13,5,251,20,14,6
13,5,252,7,28,-21
13,5,253,14,10,4
13,5,254,5,9,-4
13,5,255,6,5,1
13,5,256,10,25,-15
13,5,257,12,20,-8
13,5,258,16,17,-1
13,5,259,16,15,1
13,5,260,15,8,7
13,5,261,11,16,-5
13,5,262,19,13,6
13,5,263,11,6,5
13,5,264,9,19,-10
13,5,265,18,14,4
13,5,266,18,25,-7
13,5,267,25,14,11
13,5,268,16,16,0
13,5,269,9,10,-1
13,5,270,7,15,-8
13,5,271,13,17,-4
13,5,272,18,25,-7
13,5,273,19,24,-5
13,5,274,10,13,-3
13,5,275,17,11,6
13,5,276,14,22,-8
13,5,277,4,24,-20
13,5,278,23,31,-8
13,5,279,13,18,-5
13,5,280,10,27,-17
13,5,281,10,18,-8
13,5,282,15,32,-17
13,5,283,10,12,-2
13,5,284,10,9,1
13,5,285,12,13,-1
13,5,286,6,16,-10
13,5,287,3,16,-13
13,5,288,18,14,4
13,5,289,18,13,5
13,5,290,7,13,-6
13,5,291,1,13,-12
13,5,292,12,23,-11
13,5,293,10,6,4
13,5,294,21,23,-2
13,5,295,12,15,-3
13,5,296,4,6,-2
13,5,297,10,21,-11
13,5,298,14,32,-18
13,5,299,9,13,-4
13,6,0,6,11,-5
13,6,1,11,23,-12
13,6,2,16,26,-10
13,6,3,9,43,-34
13,6,4,6,11,-5
13,6,5,16,15,1
13,6,6,9,5,4
13,6,7,15,23,-8
13,6,8,7,16,-9
13,6,9,3,15,-12
13,6,10,12,24,-12
13,6,11,10,18,-8
13,6,12,28,36,-8
13,6,13,14,27,-13
13,6,14,17,14,3
13,6,15,20,17,3
13,6,16,5,15,-10
13,6,17,10,16,-6
13,6,18,8,10,-2
13,6,19,10,12,-2
13,6,20,10,19,-9
13,6,21,7,6,1
13,6,22,17,16,1
13,6,23,14,30,-16
13,6,24,9,12,-3
13,6,25,15,13,2
13,6,26,4,12,-8
13,6,27,15,21,-6
13,6,28,21,18,3
13,6,29,12,12,0
13,6,30,24,21,3
13,6,31,29,36,-7
13,6,32,9,16,-7
13,6,33,6,21,-15
13,6,34,11,16,-5
13,6,35,18,16,2
13,6,36,7,24,-17
13,6,37,12,34,-22
13,6,38,20,22,-2
13,6,39,13,18,-5
13,6,40,25,23,2
13,6,41,15,10,5
13,6,42,11,42,-31
13,6,43,20,27,-7
13,6,44,17,17,0
13,6,45,7,22,-15
13,6,46,8,22,-14
13,6,47,8,19,-11
13,6,48,14,13,1
13,6,49,4,5,-1
13,6,50,10,19,-9
13,6,51,10,19,-9
13,6,52,16,20,-4
13,6,53,12,16,-4
13,6,54,20,20,0
13,6,55,9,29,-20
13,6,56,23,23,0
13,6,57,18,13,5
13,6,58,8,12,-4
13,6,59,13,16,-3
13,6,60,12,21,-9
13,6,61,6,17,-11
13,6,62,16,25,-9
13,6,63,8,11,-3
13,6,64,13,19,-6
13,6,65,9,37,-28
13,6,66,8,13,-5
13,6,67,12,12,0
13,6,68,12,10,2
13,6,69,5,14,-9
13,6,70,21,25,-4
13,6,71,4,27,-23
13,6,72,12,18,-6
13,6,73,6,12,-6
13,6,74,11,19,-8
13,6,75,16,6,10
13,6,76,23,13,10
13,6,77,15,32,-17
13,6,78,10,9,1
13,6,79,7,11,-4
13,6,80,7,9,-2
13,6,81,17,14,3
13,6,82,16,26,-10
13,6,83,8,9,-1
13,6,84,7,13,-6
13,6,85,1,4,-3
13,6,86,23,29,-6
13,6,87,16,28,-12
13,6,88,18,14,4
13,6,89,13,26,-13
13,6,90,6,17,-11
13,6,91,24,24,0
13,6,92,15,18,-3
13,6,93,6,8,-2
13,6,94,20,19,1
13,6,95,9,3,6
13,6,96,7,18,-11
13,6,97,15,16,-1
13,6,98,11,18,-7
13,6,99,12,17,-5
13,6,100,14,17,-3
13,6,101,21,22,-1
13,6,102,11,21,-10
13,6,103,22,21,1
13,6,104,15,14,1
13,6,105,4,11,-7
13,6,106,12,13,-1
13,6,107,9,16,-7
13,6,108,18,34,-16
13,6,109,14,15,-1
13,6,110,6,22,-16
13,6,111,8,16,-8
13,6,112,9,20,-11
13,6,113,11,6,5
13,6,114,14,14,0
13,6,115,10,14,-4
13,6,116,14,25,-11
13,6,117,11,15,-4
13,6,118,15,33,-18
13,6,119,20,35,-15
13,6,120,6,6,0
13,6,121,16,11,5
13,6,122,19,20,-1
13,6,123,9,16,-7
13,6,124,11,33,-22
13,6,125,13,31,-18
13,6,126,15,21,-6
13,6,127,4,17,-13
13,6,128,14,17,-3
13,6,129,6,16,-10
13,6,130,10,18,-8
13,6,131,8,11,-3
13,6,132,13,12,1
13,6,133,7,13,-6
13,6,134,9,8,1
13,6,135,15,19,-4
13,6,136,22,18,4
13,6,137,14,18,-4
13,6,138,3,6,-3
13,6,139,4,13,-9
13,6,140,10,9,1
13,6,141,14,17,-3
13,6,142,10,15,-5
13,6,143,8,33,-25
13,6,144,6,15,-9
13,6,145,9,13,-4
13,6,146,13,25,-12
13,6,147,9,19,-10
13,6,148,10,16,-6
13,6,149,9,17,-8
13,6,150,12,14,-2
13,6,151,18,12,6
13,6,152,15,15,0
13,6,153,17,10,7
13,6,154,11,8,3
13,6,155,10,14,-4
13,6,156,24,34,-10
13,6,157,9,9,0
13,6,158,4,21,-17
13,6,159,16,21,-5
13,6,160,14,33,-19
13,6,161,11,12,-1
13,6,162,13,10,3
13,6,163,5,21,-16
13,6,164,22,20,2
13,6,165,20,12,8
13,6,166,15,12,3
13,6,167,17,21,-4
13,6,168,13,21,-8
13,6,169,11,23,-12
13,6,170,15,21,-6
13,6,171,14,17,-3
13,6,172,13,20,-7
13,6,173,19,15,4
13,6,174,19,12,7
13,6,175,5,4,1
13,6,176,5,13,-8
13,6,177,22,21,1
13,6,178,13,36,-23
13,6,179,7,20,-13
13,6,180,12,17,-5
13,6,181,10,22,-12
13,6,182,4,7,-3
13,6,183,6,18,-12
13,6,184,8,18,-10
13,6,185,20,26,-6
13,6,186,14,19,-5
13,6,187,16,26,-10
13,6,188,11,19,-8
13,6,189,6,22,-16
13,6,190,13,13,0
13,6,191,15,18,-3
13,6,192,13,19,-6
13,6,193,9,16,-7
13,6,194,21,22,-1
13,6,195,32,18,14
13,6,196,14,18,-4
13,6,197,6,11,-5
13,6,198,14,26,-12
13,6,199,16,13,3
13,6,200,16,19,-3
13,6,201,12,28,-16
13,6,202,9,11,-2
13,6,203,8,12,-4
13,6,204,23,30,-7
13,6,205,10,11,-1
13,6,206,20,31,-11
13,6,207,12,16,-4
13,6,208,8,18,-10
13,6,209,15,13,2
13,6,210,10,15,-5
13,6,211,6,9,-3
13,6,212,13,22,-9
13,6,213,15,14,1
13,6,214,3,17,-14
13,6,215,15,15,0
13,6,216,7,13,-6
13,6,217,7,22,-15
13,6,218,10,23,-13
13,6,219,13,14,-1
13,6,220,15,25,-10
13,6,221,11,18,-7
13,6,222,10,31,-21
13,6,223,13,22,-9
13,6,224,10,25,-15
13,6,225,12,28,-16
13,6,226,11,26,-15
13,6,227,11,17,-6
13,6,228,18,24,-6
13,6,229,13,22,-9
13,6,230,4,11,-7
13,6,231,16,26,-10
13,6,232,20,14,6
13,6,233,7,15,-8
13,6,234,11,14,-3
13,6,235,6,11,-5
13,6,236,4,22,-18
13,6,237,15,18,-3
13,6,238,16,28,-12
13,6,239,9,9,0
13,6,240,7,27,-20
13,6,241,9,30,-21
13,6,242,8,23,-15
13,6,243,9,22,-13
13,6,244,14,10,4
13,6,245,16,16,0
13,6,246,15,16,-1
13,6,247,5,8,-3
13,6,248,20,14,6
13,6,249,9,17,-8
13,6,250,18,28,-10
13,6,251,6,17,-11
13,6,252,5,18,-13
13,6,253,19,20,-1
13,6,254,9,17,-8
13,6,255,3,13,-10
13,6,256,12,21,-9
13,6,257,8,8,0
13,6,258,4,17,-13
13,6,259,14,25,-11
13,6,260,12,13,-1
13,6,261,16,25,-9
13,6,262,3,16,-13
13,6,263,8,13,-5
13,6,264,12,9,3
13,6,265,2,14,-12
13,6,266,1,12,-11
13,6,267,22,17,5
13,6,268,13,26,-13
13,6,269,14,30,-16
13,6,270,15,15,0
13,6,271,15,15,0
13,6,272,10,16,-6
13,6,273,13,20,-7
13,6,274,18,22,-4
13,6,275,7,14,-7
13,6,276,7,14,-7
13,6,277,13,26,-13
13,6,278,15,8,7
13,6,279,16,16,0
13,6,280,13,14,-1
13,6,281,8,17,-9
13,6,282,21,31,-10
13,6,283,15,13,2
13,6,284,22,20,2
13,6,285,6,18,-12
13,6,286,13,12,1
13,6,287,13,13,0
13,6,288,15,24,-9
13,6,289,16,13,3
13,6,290,14,21,-7
13,6,291,5,9,-4
13,6,292,15,20,-5
13,6,293,19,35,-16
13,6,294,22,18,4
13,6,295,7,16,-9
13,6,296,12,22,-10
13,6,297,16,12,4
13,6,298,12,19,-7
13,6,299,13,11,2
13,7,0,10,18,-8
13,7,1,24,19,5
13,7,2,14,22,-8
13,7,3,11,20,-9
13,7,4,15,18,-3
13,7,5,20,19,1
13,7,6,17,21,-4
13,7,7,10,17,-7
13,7,8,19,19,0
13,7,9,6,17,-11
13,7,10,11,15,-4
13,7,11,20,26,-6
13,7,12,6,25,-19
13,7,13,10,18,-8
13,7,14,12,19,-7
13,7,15,10,21,-11
13,7,16,13,16,-3
13,7,17,20,19,1
13,7,18,4,15,-11
13,7,19,8,28,-20
13,7,20,3,6,-3
13,7,21,3,27,-24
13,7,22,5,7,-2
13,7,23,15,30,-15
13,7,24,10,14,-4
13,7,25,14,14,0
13,7,26,17,13,4
13,7,27,9,13,-4
13,7,28,22,28,-6
13,7,29,23,6,17
13,7,30,16,24,-8
13,7,31,5,7,-2
13,7,32,10,19,-9
13,7,33,11,13,-2
13,7,34,10,17,-7
13,7,35,10,6,4
13,7,36,10,17,-7
13,7,37,11,5,6
13,7,38,20,26,-6
13,7,39,16,27,-11
13,7,40,7,7,0
13,7,41,10,12,-2
13,7,42,18,16,2
13,7,43,8,4,4
13,7,44,8,10,-2
13,7,45,4,13,-9
13,7,46,15,9,6
13,7,47,7,20,-13
13,7,48,15,10,5
13,7,49,6,22,-16
13,7,50,14,15,-1
13,7,51,23,13,10
13,7,52,13,13,0
13,7,53,15,14,1
13,7,54,17,24,-7
13,7,55,8,15,-7
13,7,56,9,10,-1
13,7,57,15,12,3
13,7,58,9,20,-11
13,7,59,5,14,-9
13,7,60,17,13,4
13,7,61,20,28,-8
13,7,62,7,17,-10
13,7,63,12,7,5
13,7,64,8,11,-3
13,7,65,19,24,-5
13,7,66,13,21,-8
13,7,67,23,22,1
13,7,68,12,16,-4
13,7,69,16,10,6
13,7,70,5,20,-15
13,7,71,7,6,1
13,7,72,34,20,14
13,7,73,16,18,-2
13,7,74,25,34,-9
13,7,75,17,13,4
13,7,76,13,18,-5
13,7,77,15,17,-2
13,7,78,5,14,-9
13,7,79,3,9,-6
13,7,80,15,12,3
13,7,81,14,26,-12
13,7,82,17,12,5
13,7,83,12,22,-10
13,7,84,18,12,6
13,7,85,10,7,3
13,7,86,11,20,-9
13,7,87,13,14,-1
13,7,88,23,21,2
13,7,89,17,21,-4
13,7,90,13,18,-5
13,7,91,11,12,-1
13,7,92,5,9,-4
13,7,93,20,31,-11
13,7,94,9,13,-4
13,7,95,22,12,10
13,7,96,14,22,-8
13,7,97,11,12,-1
13,7,98,5,12,-7
13,7,99,17,21,-4
13,7,100,18,36,-18
13,7,101,12,15,-3
13,7,102,17,13,4
13,7,103,7,13,-6
13,7,104,13,14,-1
13,7,105,12,9,3
13,7,106,17,21,-4
13,7,107,5,13,-8
13,7,108,12,13,-1
13,7,109,14,14,0
13,7,110,7,24,-17
13,7,111,7,14,-7
13,7,112,15,34,-19
13,7,113,6,4,2
13,7,114,7,19,-12
13,7,115,8,37,-29
13,7,116,17,20,-3
13,7,117,21,11,10
13,7,118,14,21,-7
13,7,119,15,21,-6
13,7,120,18,18,0
13,7,121,10,4,6
13,7,122,8,26,-18
13,7,123,6,17,-11
13,7,124,17,23,-6
13,7,125,9,9,0
13,7,126,7,9,-2
13,7,127,9,30,-21
13,7,128,19,9,10
13,7,129,11,22,-11
13,7,130,13,17,-4
13,7,131,12,13,-1
13,7,132,10,9,1
13,7,133,11,14,-3
13,7,134,12,15,-3
13,7,135,14,17,-3
13,7,136,5,17,-12
13,7,137,15,18,-3
13,7,138,9,14,-5
13,7,139,17,25,-8
13,7,140,11,23,-12
13,7,141,5,9,-4
13,7,142,16,15,1
13,7,143,11,9,2
13,7,144,15,23,-8
13,7,145,28,21,7
13,7,146,17,19,-2
13,7,147,5,15,-10
13,7,148,13,17,-4
13,7,149,13,23,-10
13,7,150,9,14,-5
13,7,151,12,19,-7
13,7,152,13,12,1
13,7,153,12,15,-3
13,7,154,9,17,-8
13,7,155,21,24,-3
13,7,156,7,8,-1
13,7,157,20,9,11
13,7,158,8,7,1
13,7,159,11,13,-2
13,7,160,9,16,-7
13,7,161,6,18,-12
13,7,162,23,22,1
13,7,163,13,13,0
13,7,164,9,7,2
13,7,165,21,14,7
13,7,166,21,15,6
13,7,167,22,24,-2
13,7,168,23,15,8
13,7,169,8,18,-10
13,7,170,12,12,0
13,7,171,27,24,3
13,7,172,14,14,0
13,7,173,15,22,-7
13,7,174,9,12,-3
13,7,175,13,24,-11
13,7,176,11,22,-11
13,7,177,27,25,2
13,7,178,11,10,1
13,7,179,19,21,-2
13,7,180,13,14,-1
13,7,181,13,12,1
13,7,182,13,24,-11
13,7,183,10,29,-19
13,7,184,14,24,-10
13,7,185,23,13,10
13,7,186,27,28,-1
13,7,187,17,24,-7
13,7,188,21,14,7
13,7,189,17,6,11
13,7,190,12,24,-12
13,7,191,13,14,-1
13,7,192,12,23,-11
13,7,193,10,16,-6
13,7,194,9,20,-11
13,7,195,12,14,-2
13,7,196,12,12,0
13,7,197,20,31,-11
13,7,198,12,21,-9
13,7,199,17,22,-5
13,7,200,16,20,-4
13,7,201,24,31,-7
13,7,202,17,19,-2
13,7,203,15,32,-17
13,7,204,8,11,-3
13,7,205,8,10,-2
13,7,206,14,9,5
13,7,207,11,17,-6
13,7,208,15,12,3
13,7,209,6,13,-7
13,7,210,13,24,-11
13,7,211,17,31,-14
13,7,212,16,11,5
13,7,213,16,13,3
13,7,214,22,19,3
13,7,215,8,12,-4
13,7,216,12,23,-11
13,7,217,16,18,-2
13,7,218,8,16,-8
13,7,219,17,16,1
13,7,220,17,18,-1
13,7,221,30,22,8
13,7,222,16,21,-5
13,7,223,18,16,2
13,7,224,15,18,-3
13,7,225,3,7,-4
13,7,226,13,17,-4
13,7,227,14,14,0
13,7,228,7,20,-13
13,7,229,18,18,0
13,7,230,12,16,-4
13,7,231,6,11,-5
13,7,232,16,12,4
13,7,233,11,17,-6
13,7,234,15,14,1
13,7,235,16,36,-20
13,7,236,16,12,4
13,7,237,13,15,-2
13,7,238,15,18,-3
13,7,239,11,3,8
13,7,240,6,1,5
13,7,241,14,23,-9
13,7,242,18,17,1
13,7,243,12,10,2
13,7,244,14,21,-7
13,7,245,13,22,-9
13,7,246,16,25,-9
13,7,247,8,11,-3
13,7,248,20,22,-2
13,7,249,7,11,-4
13,7,250,11,16,-5
13,7,251,12,18,-6
13,7,252,14,21,-7
13,7,253,11,13,-2
13,7,254,15,29,-14
13,7,255,20,32,-12
13,7,256,9,14,-5
13,7,257,10,20,-10
13,7,258,10,18,-8
13,7,259,10,19,-9
13,7,260,13,18,-5
13,7,261,24,13,11
13,7,262,18,17,1
13,7,263,13,24,-11
13,7,264,10,3,7
13,7,265,18,26,-8
13,7,266,13,22,-9
13,7,267,20,20,0
13,7,268,17,24,-7
13,7,269,12,9,3
13,7,270,14,4,10
13,7,271,7,7,0
13,7,272,3,6,-3
13,7,273,12,11,1
13,7,274,11,11,0
13,7,275,8,36,-28
13,7,276,11,18,-7
13,7,277,11,13,-2
13,7,278,13,19,-6
13,7,279,15,14,1
13,7,280,16,20,-4
13,7,281,12,20,-8
13,7,282,11,17,-6
13,7,283,18,26,-8
13,7,284,11,15,-4
13,7,285,28,15,13
13,7,286,29,29,0
13,7,287,14,6,8
13,7,288,5,6,-1
13,7,289,7,3,4
13,7,290,12,22,-10
13,7,291,15,24,-9
13,7,292,10,23,-13
13,7,293,16,8,8
13,7,294,7,13,-6
13,7,295,16,15,1
13,7,296,12,17,-5
13,7,297,2,13,-11
13,7,298,11,16,-5
13,7,299,16,16,0
13,8,0,20,26,-6
13,8,1,7,5,2
13,8,2,21,22,-1
13,8,3,15,5,10
13,8,4,16,17,-1
13,8,5,16,24,-8
13,8,6,23,25,-2
13,8,7,2,19,-17
13,8,8,7,17,-10
13,8,9,10,18,-8
13,8,10,16,24,-8
13,8,11,10,12,-2
13,8,12,14,18,-4
13,8,13,18,23,-5
13,8,14,6,12,-6
13,8,15,16,21,-5
13,8,16,21,13,8
13,8,17,4,16,-12
13,8,18,21,23,-2
13,8,19,23,25,-2
13,8,20,16,16,0
13,8,21,10,9,1
13,8,22,10,18,-8
13,8,23,13,12,1
13,8,24,10,13,-3
13,8,25,13,15,-2
13,8,26,9,7,2
13,8,27,10,9,1
13,8,28,12,15,-3
13,8,29,0,5,-5
13,8,30,20,17,3
13,8,31,13,27,-14
13,8,32,14,17,-3
13,8,33,8,13,-5
13,8,34,11,8,3
13,8,35,11,10,1
13,8,36,6,6,0
13,8,37,8,9,-1
13,8,38,24,21,3
13,8,39,10,13,-3
13,8,40,20,4,16
13,8,41,12,19,-7
13,8,42,9,13,-4
13,8,43,10,9,1
13,8,44,10,8,2
13,8,45,4,15,-11
13,8,46,17,14,3
13,8,47,12,16,-4
13,8,48,15,16,-1
13,8,49,8,18,-10
13,8,50,13,22,-9
13,8,51,9,19,-10
13,8,52,10,17,-7
13,8,53,7,9,-2
13,8,54,12,14,-2
13,8,55,8,12,-4
13,8,56,7,5,2
13,8,57,11,16,-5
13,8,58,9,10,-1
13,8,59,7,17,-10
13,8,60,9,18,-9
13,8,61,12,17,-5
13,8,62,13,27,-14
13,8,63,14,17,-3
13,8,64,21,25,-4
13,8,65,24,22,2
13,8,66,16,22,-6
13,8,67,3,7,-4
13,8,68,9,7,2
13,8,69,15,21,-6
13,8,70,23,34,-11
13,8,71,12,22,-10
13,8,72,19,10,9
13,8,73,12,19,-7
13,8,74,15,20,-5
13,8,75,15,12,3
13,8,76,22,24,-2
13,8,77,11,19,-8
13,8,78,16,10,6
13,8,79,18,18,0
13,8,80,30,20,10
13,8,81,28,21,7
13,8,82,9,14,-5
13,8,83,11,22,-11
13,8,84,11,18,-7
13,8,85,16,17,-1
13,8,86,6,10,-4
13,8,87,19,26,-7
13,8,88,22,26,-4
13,8,89,6,17,-11
13,8,90,21,18,3
13,8,91,19,33,-14
13,8,92,22,19,3
13,8,93,14,15,-1
13,8,94,10,22,-12
13,8,95,2,17,-15
13,8,96,12,22,-10
13,8,97,12,17,-5
13,8,98,18,24,-6
13,8,99,14,21,-7
13,8,100,15,25,-10
13,8,101,18,15,3
13,8,102,5,18,-13
13,8,103,31,9,22
13,8,104,21,28,-7
13,8,105,6,8,-2
13,8,106,11,17,-6
13,8,107,20,19,1
13,8,108,6,11,-5
13,8,109,14,18,-4
13,8,110,18,28,-10
13,8,111,20,24,-4
13,8,112,10,18,-8
13,8,113,11,20,-9
13,8,114,11,14,-3
13,8,115,9,15,-6
13,8,116,12,18,-6
13,8,117,10,10,0
13,8,118,8,3,5
13,8,119,6,17,-11
13,8,120,10,20,-10
13,8,121,11,24,-13
13,8,122,15,22,-7
13,8,123,9,24,-15
13,8,124,10,13,-3
13,8,125,17,18,-1
13,8,126,14,21,-7
13,8,127,11,14,-3
13,8,128,22,31,-9
13,8,129,14,23,-9
13,8,130,9,30,-21
13,8,131,18,14,4
13,8,132,5,26,-21
13,8,133,6,15,-9
13,8,134,13,13,0
13,8,135,10,11,-1
13,8,136,19,16,3
13,8,137,12,10,2
13,8,138,4,13,-9
13,8,139,11,18,-7
13,8,140,10,19,-9
13,8,141,16,14,2
13,8,142,13,12,1
13,8,143,5,11,-6
13,8,144,8,10,-2
13,8,145,11,17,-6
13,8,146,9,10,-1
13,8,147,18,19,-1
13,8,148,14,15,-1
13,8,149,10,12,-2
13,8,150,19,16,3
13,8,151,15,18,-3
13,8,152,7,13,-6
13,8,153,10,10,0
13,8,154,5,23,-18
13,8,155,20,15,5
13,8,156,15,22,-7
13,8,157,15,29,-14
13,8,158,4,11,-7
13,8,159,15,10,5
13,8,160,8,30,-22
13,8,161,8,25,-17
13,8,162,17,31,-14
13,8,163,22,19,3
13,8,164,17,10,7
13,8,165,26,33,-7
13,8,166,14,16,-2
13,8,167,12,33,-21
13,8,168,8,9,-1
13,8,169,11,12,-1
13,8,170,20,22,-2
13,8,171,15,24,-9
13,8,172,15,9,6
13,8,173,15,24,-9
13,8,174,10,16,-6
13,8,175,6,14,-8
13,8,176,9,3,6
13,8,177,15,14,1
13,8,178,10,12,-2
13,8,179,6,19,-13
13,8,180,29,15,14
13,8,181,9,10,-1
13,8,182,22,31,-9
13,8,183,7,8,-1
13,8,184,7,17,-10
13,8,185,18,19,-1
13,8,186,20,19,1
13,8,187,11,13,-2
13,8,188,13,13,0
13,8,189,8,19,-11
13,8,190,7,25,-18
13,8,191,24,23,1
13,8,192,6,10,-4
13,8,193,12,14,-2
13,8,194,8,34,-26
13,8,195,17,21,-4
13,8,196,17,22,-5
13,8,197,13,9,4
13,8,198,23,22,1
13,8,199,20,22,-2
13,8,200,29,26,3
13,8,201,9,21,-12
13,8,202,7,11,-4
13,8,203,14,10,4
13,8,204,12,21,-9
13,8,205,12,19,-7
13,8,206,14,16,-2
13,8,207,15,28,-13
13,8,208,16,29,-13
13,8,209,11,13,-2
13,8,210,8,5,3
13,8,211,14,18,-4
13,8,212,20,24,-4
13,8,213,11,16,-5
13,8,214,20,17,3
13,8,215,8,12,-4
13,8,216,29,25,4
13,8,217,4,17,-13
13,8,218,16,18,-2
13,8,219,6,18,-12
13,8,220,11,29,-18
13,8,221,13,14,-1
13,8,222,16,18,-2
13,8,223,19,22,-3
13,8,224,14,26,-12
13,8,225,15,35,-20
13,8,226,17,11,6
13,8,227,12,24,-12
13,8,228,9,12,-3
13,8,229,11,21,-10
13,8,230,8,8,0
13,8,231,6,10,-4
13,8,232,5,21,-16
13,8,233,20,14,6
13,8,234,10,14,-4
13,8,235,9,26,-17
13,8,236,8,18,-10
13,8,237,14,18,-4
13,8,238,22,14,8
13,8,239,8,15,-7
13,8,240,19,14,5
13,8,241,10,15,-5
13,8,242,15,12,3
13,8,243,21,27,-6
13,8,244,12,16,-4
13,8,245,18,18,0
13,8,246,8,18,-10
13,8,247,10,14,-4
13,8,248,19,21,-2
13,8,249,15,18,-3
13,8,250,5,12,-7
13,8,251,12,23,-11
13,8,252,14,19,-5
13,8,253,23,19,4
13,8,254,11,16,-5
13,8,255,11,16,-5
13,8,256,10,13,-3
13,8,257,14,18,-4
13,8,258,26,33,-7
13,8,259,14,6,8
13,8,260,21,22,-1
13,8,261,12,18,-6
13,8,262,9,9,0
13,8,263,13,15,-2
13,8,264,21,21,0
13,8,265,7,17,-10
13,8,266,12,16,-4
13,8,267,21,26,-5
13,8,268,10,22,-12
13,8,269,10,9,1
13,8,270,5,7,-2
13,8,271,18,23,-5
13,8,272,6,12,-6
13,8,273,12,20,-8
13,8,274,13,20,-7
13,8,275,19,18,1
13,8,276,16,30,-14
13,8,277,15,18,-3
13,8,278,11,15,-4
13,8,279,9,18,-9
13,8,280,11,15,-4
13,8,281,10,10,0
13,8,282,16,18,-2
13,8,283,14,19,-5
13,8,284,24,35,-11
13,8,285,9,13,-4
13,8,286,17,16,1
13,8,287,22,17,5
13,8,288,15,25,-10
13,8,289,27,22,5
13,8,290,17,11,6
13,8,291,9,20,-11
13,8,292,5,17,-12
13,8,293,15,9,6
13,8,294,20,24,-4
13,8,295,10,15,-5
13,8,296,10,16,-6
13,8,297,31,18,13
13,8,298,10,18,-8
13,8,299,18,13,5
13,9,0,10,11,-1
13,9,1,18,29,-11
13,9,2,15,12,3
13,9,3,11,13,-2
13,9,4,6,31,-25
13,9,5,11,10,1
13,9,6,15,13,2
13,9,7,15,18,-3
13,9,8,6,14,-8
13,9,9,20,19,1
13,9,10,17,15,2
13,9,11,14,12,2
13,9,12,16,7,9
13,9,13,7,17,-10
13,9,14,21,15,6
13,9,15,15,20,-5
13,9,16,7,14,-7
13,9,17,7,3,4
13,9,18,24,14,10
13,9,19,9,22,-13
13,9,20,16,21,-5
13,9,21,12,25,-13
13,9,22,11,17,-6
13,9,23,6,12,-6
13,9,24,14,25,-11
13,9,25,16,13,3
13,9,26,11,18,-7
13,9,27,14,14,0
13,9,28,17,8,9
13,9,29,11,24,-13
13,9,30,16,20,-4
13,9,31,14,20,-6
13,9,32,20,14,6
13,9,33,19,30,-11
13,9,34,26,13,13
13,9,35,17,14,3
13,9,36,6,15,-9
13,9,37,26,20,6
13,9,38,15,8,7
13,9,39,17,32,-15
13,9,40,11,18,-7
13,9,41,13,16,-3
13,9,42,12,14,-2
13,9,43,19,9,10
13,9,44,11,16,-5
13,9,45,9,4,5
13,9,46,14,20,-6
13,9,47,13,23,-10
13,9,48,4,21,-17
13,9,49,9,8,1
13,9,50,3,10,-7
13,9,51,16,15,1
13,9,52,12,10,2
13,9,53,29,16,13
13,9,54,14,20,-6
13,9,55,9,11,-2
13,9,56,27,21,6
13,9,57,12,8,4
13,9,58,18,25,-7
13,9,59,14,19,-5
13,9,60,8,11,-3
13,9,61,12,16,-4
13,9,62,17,31,-14
13,9,63,5,15,-10
13,9,64,24,6,18
13,9,65,21,17,4
13,9,66,16,22,-6
13,9,67,5,19,-14
13,9,68,15,24,-9
13,9,69,6,15,-9
13,9,70,7,15,-8
13,9,71,12,13,-1
13,9,72,13,9,4
13,9,73,19,25,-6
13,9,74,5,9,-4
13,9,75,8,18,-10
13,9,76,13,22,-9
13,9,77,14,17,-3
13,9,78,21,25,-4
13,9,79,11,14,-3
13,9,80,11,6,5
13,9,81,16,41,-25
13,9,82,11,19,-8
13,9,83,12,19,-7
13,9,84,5,8,-3
13,9,85,14,7,7
13,9,86,12,20,-8
13,9,87,9,27,-18
13,9,88,7,17,-10
13,9,89,7,22,-15
13,9,90,20,12,8
13,9,91,22,17,5
13,9,92,32,16,16
13,9,93,15,15,0
13,9,94,13,17,-4
13,9,95,3,9,-6
13,9,96,11,10,1
13,9,97,14,24,-10
13,9,98,8,7,1
13,9,99,16,15,1
13,9,100,4,11,-7
13,9,101,8,12,-4
13,9,102,17,22,-5
13,9,103,12,14,-2
13,9,104,8,19,-11
13,9,105,22,21,1
13,9,106,17,22,-5
13,9,107,22,15,7
13,9,108,12,29,-17
13,9,109,10,33,-23
13,9,110,5,17,-12
13,9,111,5,15,-10
13,9,112,15,21,-6
13,9,113,24,16,8
13,9,114,4,9,-5
13,9,115,5,19,-14
13,9,116,7,16,-9
13,9,117,11,17,-6
13,9,118,11,9,2
13,9,119,13,21,-8
13,9,120,10,17,-7
13,9,121,7,12,-5
13,9,122,21,29,-8
13,9,123,23,16,7
13,9,124,11,17,-6
13,9,125,10,23,-13
13,9,126,5,22,-17
13,9,127,7,18,-11
13,9,128,10,13,-3
13,9,129,12,15,-3
13,9,130,12,21,-9
13,9,131,22,29,-7
13,9,132,17,19,-2
13,9,133,25,11,14
13,9,134,0,13,-13
13,9,135,10,12,-2
13,9,136,19,15,4
13,9,137,18,25,-7
13,9,138,12,19,-7
13,9,139,9,10,-1
13,9,140,15,18,-3
13,9,141,9,18,-9
13,9,142,24,11,13
13,9,143,13,24,-11
13,9,144,18,20,-2
13,9,145,22,18,4
13,9,146,14,21,-7
13,9,147,15,16,-1
13,9,148,5,14,-9
13,9,149,16,12,4
13,9,150,7,12,-5
13,9,151,13,11,2
13,9,152,10,18,-8
13,9,153,32,23,9
13,9,154,20,17,3
13,9,155,15,11,4
13,9,156,13,16,-3
13,9,157,12,9,3
13,9,158,12,24,-12
13,9,159,26,11,15
13,9,160,11,23,-12
13,9,161,13,17,-4
13,9,162,20,20,0
13,9,163,6,15,-9
13,9,164,27,36,-9
13,9,165,17,23,-6
13,9,166,27,20,7
13,9,167,15,16,-1
13,9,168,11,12,-1
13,9,169,14,8,6
13,9,170,20,11,9
13,9,171,15,19,-4
13,9,172,13,21,-8
13,9,173,10,4,6
13,9,174,7,13,-6
13,9,175,12,27,-15
13,9,176,15,15,0
13,9,177,14,16,-2
13,9,178,16,15,1
13,9,179,10,15,-5
13,9,180,15,9,6
13,9,181,10,3,7
13,9,182,10,15,-5
13,9,183,24,26,-2
13,9,184,20,19,1
13,9,185,14,12,2
13,9,186,10,12,-2
13,9,187,17,14,3
13,9,188,8,10,-2
13,9,189,6,9,-3
13,9,190,9,13,-4
13,9,191,17,17,0
13,9,192,13,22,-9
13,9,193,10,12,-2
13,9,194,15,16,-1
13,9,195,13,20,-7
13,9,196,15,17,-2
13,9,197,13,29,-16
13,9,198,10,12,-2
13,9,199,15,14,1
13,9,200,23,20,3
13,9,201,24,18,6
13,9,202,12,18,-6
13,9,203,25,16,9
13,9,204,10,36,-26
13,9,205,13,17,-4
13,9,206,12,10,2
13,9,207,20,15,5
13,9,208,3,8,-5
13,9,209,8,7,1
13,9,210,21,13,8
13,9,211,15,14,1
13,9,212,20,14,6
13,9,213,13,22,-9
13,9,214,22,21,1
13,9,215,13,13,0
13,9,216,24,15,9
13,9,217,8,10,-2
13,9,218,11,10,1
13,9,219,14,15,-1
13,9,220,15,23,-8
13,9,221,18,15,3
13,9,222,19,20,-1
13,9,223,5,8,-3
13,9,224,10,15,-5
13,9,225,13,15,-2
13,9,226,12,21,-9
13,9,227,10,22,-12
13,9,228,5,6,-1
13,9,229,10,14,-4
13,9,230,15,20,-5
13,9,231,16,23,-7
13,9,232,7,10,-3
13,9,233,14,14,0
13,9,234,20,15,5
13,9,235,22,15,7
13,9,236,10,23,-13
13,9,237,11,21,-10
13,9,238,29,13,16
13,9,239,14,29,-15
13,9,240,10,32,-22
13,9,241,13,19,-6
13,9,242,5,9,-4
13,9,243,12,20,-8
13,9,244,11,14,-3
13,9,245,12,19,-7
13,9,246,11,23,-12
13,9,247,8,22,-14
13,9,248,15,15,0
13,9,249,9,18,-9
13,9,250,10,17,-7
13,9,251,8,22,-14
13,9,252,6,20,-14
13,9,253,10,17,-7
13,9,254,13,10,3
13,9,255,18,21,-3
13,9,256,12,20,-8
13,9,257,12,18,-6
13,9,258,8,4,4
13,9,259,13,25,-12
13,9,260,17,10,7
13,9,261,17,30,-13
13,9,262,15,12,3
13,9,263,9,6,3
13,9,264,10,13,-3
13,9,265,23,20,3
13,9,266,23,14,9
13,9,267,10,14,-4
13,9,268,5,15,-10
13,9,269,12,17,-5
13,9,270,18,12,6
13,9,271,14,27,-13
13,9,272,6,27,-21
13,9,273,22,20,2
13,9,274,18,23,-5
13,9,275,11,10,1
13,9,276,14,15,-1
13,9,277,11,24,-13
13,9,278,12,10,2
13,9,279,14,13,1
13,9,280,14,30,-16
13,9,281,14,17,-3
13,9,282,16,15,1
13,9,283,22,15,7
13,9,284,11,14,-3
13,9,285,18,25,-7
13,9,286,10,13,-3
13,9,287,19,22,-3
13,9,288,4,5,-1
13,9,289,22,15,7
13,9,290,6,13,-7
13,9,291,16,22,-6
13,9,292,10,22,-12
13,9,293,13,15,-2
13,9,294,3,12,-9
13,9,295,11,10,1
13,9,296,21,11,10
13,9,297,17,12,5
13,9,298,25,24,1
13,9,299,4,17,-13
13,10,0,24,36,-12
13,10,1,19,22,-3
13,10,2,16,11,5
13,10,3,12,18,-6
13,10,4,18,20,-2
13,10,5,16,23,-7
13,10,6,16,6,10
13,10,7,23,16,7
13,10,8,9,17,-8
13,10,9,8,19,-11
13,10,10,21,22,-1
13,10,11,15,22,-7
13,10,12,11,21,-10
13,10,13,7,8,-1
13,10,14,9,16,-7
13,10,15,15,15,0
13,10,16,7,13,-6
13,10,17,8,22,-14
13,10,18,17,14,3
13,10,19,26,23,3
13,10,20,19,24,-5
13,10,21,23,35,-12
13,10,22,16,21,-5
13,10,23,12,30,-18
13,10,24,16,14,2
13,10,25,8,31,-23
13,10,26,10,16,-6
13,10,27,18,19,-1
13,10,28,19,20,-1
13,10,29,12,7,5
13,10,30,15,14,1
13,10,31,12,12,0
13,10,32,10,14,-4
13,10,33,15,17,-2
13,10,34,17,21,-4
13,10,35,7,20,-13
13,10,36,15,21,-6
13,10,37,19,19,0
13,10,38,25,25,0
13,10,39,8,19,-11
13,10,40,3,12,-9
13,10,41,8,26,-18
13,10,42,11,12,-1
13,10,43,13,3,10
13,10,44,26,24,2
13,10,45,16,11,5
13,10,46,10,14,-4
13,10,47,19,15,4
13,10,48,21,11,10
13,10,49,6,8,-2
13,10,50,11,27,-16
13,10,51,10,19,-9
13,10,52,12,24,-12
13,10,53,15,25,-10
13,10,54,9,12,-3
13,10,55,5,20,-15
13,10,56,18,9,9
13,10,57,10,8,2
13,10,58,17,29,-12
13,10,59,19,13,6
13,10,60,9,14,-5
13,10,61,13,22,-9
13,10,62,12,13,-1
13,10,63,13,15,-2
13,10,64,13,19,-6
13,10,65,21,20,1
13,10,66,24,12,12
13,10,67,19,20,-1
13,10,68,21,15,6
13,10,69,19,25,-6
13,10,70,7,18,-11
13,10,71,8,8,0
13,10,72,13,11,2
13,10,73,19,14,5
13,10,74,5,18,-13
13,10,75,13,12,1
13,10,76,13,16,-3
13,10,77,10,11,-1
13,10,78,13,12,1
13,10,79,22,26,-4
13,10,80,10,16,-6
13,10,81,13,20,-7
13,10,82,12,19,-7
13,10,83,9,15,-6
13,10,84,15,20,-5
13,10,85,11,28,-17
13,10,86,8,32,-24
13,10,87,18,23,-5
13,10,88,16,8,8
13,10,89,8,15,-7
13,10,90,21,22,-1
13,10,91,6,11,-5
13,10,92,12,13,-1
13,10,93,13,36,-23
13,10,94,16,11,5
13,10,95,10,12,-2
13,10,96,19,4,15
13,10,97,10,9,1
13,10,98,9,19,-10
13,10,99,15,25,-10
13,10,100,11,10,1
13,10,101,10,5,5
13,10,102,13,19,-6
13,10,103,12,11,1
13,10,104,13,11,2
13,10,105,14,17,-3
13,10,106,21,16,5
13,10,107,10,25,-15
13,10,108,11,7,4
13,10,109,15,15,0
13,10,110,20,15,5
13,10,111,6,17,-11
13,10,112,17,11,6
13,10,113,9,10,-1
13,10,114,16,13,3
13,10,115,15,30,-15
13,10,116,10,8,2
13,10,117,11,18,-7
13,10,118,14,20,-6
13,10,119,25,14,11
13,10,120,18,16,2
13,10,121,18,22,-4
13,10,122,16,17,-1
13,10,123,18,14,4
13,10,124,12,5,7
13,10,125,3,17,-14
13,10,126,11,11,0
13,10,127,5,15,-10
13,10,128,5,12,-7
13,10,129,11,29,-18
13,10,130,22,30,-8
13,10,131,10,15,-5
13,10,132,14,14,0
13,10,133,7,15,-8
13,10,134,12,26,-14
13,10,135,9,17,-8
13,10,136,21,13,8
13,10,137,12,9,3
13,10,138,20,28,-8
13,10,139,22,14,8
13,10,140,17,10,7
13,10,141,22,16,6
13,10,142,17,28,-11
13,10,143,12,27,-15
13,10,144,28,35,-7
13,10,145,8,10,-2
13,10,146,15,19,-4
13,10,147,13,22,-9
13,10,148,11,17,-6
13,10,149,22,24,-2
13,10,150,15,13,2
13,10,151,15,11,4
13,10,152,21,11,10
13,10,153,14,22,-8
13,10,154,8,12,-4
13,10,155,11,32,-21
13,10,156,21,22,-1
13,10,157,11,26,-15
13,10,158,21,33,-12
13,10,159,14,11,3
13,10,160,29,12,17
13,10,161,8,13,-5
13,10,162,14,12,2
13,10,163,11,13,-2
13,10,164,15,29,-14
13,10,165,6,21,-15
13,10,166,9,22,-13
13,10,167,12,19,-7
13,10,168,9,17,-8
13,10,169,19,15,4
13,10,170,14,18,-4
13,10,171,14,17,-3
13,10,172,10,17,-7
13,10,173,20,19,1
13,10,174,9,24,-15
13,10,175,20,26,-6
13,10,176,12,20,-8
13,10,177,15,12,3
13,10,178,14,15,-1
13,10,179,18,13,5
13,10,180,10,14,-4
13,10,181,8,19,-11
13,10,182,8,10,-2
13,10,183,12,6,6
13,10,184,15,9,6
13,10,185,5,16,-11
13,10,186,8,10,-2
13,10,187,18,12,6
13,10,188,8,12,-4
13,10,189,19,27,-8
13,10,190,17,17,0
13,10,191,19,8,11
13,10,192,14,11,3
13,10,193,13,10,3
13,10,194,13,18,-5
13,10,195,10,21,-11
13,10,196,18,25,-7
13,10,197,22,18,4
13,10,198,12,11,1
13,10,199,31,32,-1
13,10,200,11,9,2
13,10,201,16,18,-2
13,10,202,21,28,-7
13,10,203,15,7,8
13,10,204,13,15,-2
13,10,205,24,21,3
13,10,206,32,19,13
13,10,207,25,18,7
13,10,208,26,21,5
13,10,209,5,17,-12
13,10,210,11,17,-6
13,10,211,10,8,2
13,10,212,13,15,-2
13,10,213,8,13,-5
13,10,214,9,23,-14
13,10,215,7,15,-8
13,10,216,15,9,6
13,10,217,17,11,6
13,10,218,16,15,1
13,10,219,13,12,1
13,10,220,16,14,2
13,10,221,7,22,-15
13,10,222,22,19,3
13,10,223,13,18,-5
13,10,224,36,22,14
13,10,225,18,16,2
13,10,226,14,14,0
13,10,227,14,15,-1
13,10,228,19,16,3
13,10,229,10,7,3
13,10,230,8,18,-10
13,10,231,18,12,6
13,10,232,14,17,-3
13,10,233,4,20,-16
13,10,234,10,22,-12
13,10,235,7,16,-9
13,10,236,15,19,-4
13,10,237,19,31,-12
13,10,238,18,24,-6
13,10,239,14,16,-2
13,10,240,20,17,3
13,10,241,23,33,-10
13,10,242,10,5,5
13,10,243,25,18,7
13,10,244,10,14,-4
13,10,245,18,10,8
13,10,246,16,20,-4
13,10,247,20,16,4
13,10,248,9,12,-3
13,10,249,15,15,0
13,10,250,16,22,-6
13,10,251,22,14,8
13,10,252,20,13,7
13,10,253,9,8,1
13,10,254,14,24,-10
13,10,255,20,41,-21
13,10,256,8,26,-18
13,10,257,9,15,-6
13,10,258,16,24,-8
13,10,259,20,11,9
13,10,260,10,9,1
13,10,261,22,15,7
13,10,262,5,10,-5
13,10,263,16,20,-4
13,10,264,16,27,-11
13,10,265,27,30,-3
13,10,266,9,18,-9
13,10,267,18,20,-2
13,10,268,8,13,-5
13,10,269,18,21,-3
13,10,270,24,11,13
13,10,271,17,14,3
13,10,272,13,20,-7
13,10,273,8,15,-7
13,10,274,13,11,2
13,10,275,8,10,-2
13,10,276,6,16,-10
13,10,277,15,19,-4
13,10,278,18,34,-16
13,10,279,18,19,-1
13,10,280,11,22,-11
13,10,281,18,30,-12
13,10,282,14,11,3
13,10,283,19,20,-1
13,10,284,17,14,3
13,10,285,13,11,2
13,10,286,8,20,-12
13,10,287,22,28,-6
13,10,288,22,10,12
13,10,289,16,11,5
13,10,290,16,20,-4
13,10,291,16,16,0
13,10,292,15,13,2
13,10,293,24,28,-4
13,10,294,18,25,-7
13,10,295,9,2,7
13,10,296,21,39,-18
13,10,297,10,18,-8
13,10,298,25,23,2
13,10,299,18,12,6
13,11,0,0,8,-8
13,11,1,22,17,5
13,11,2,20,18,2
13,11,3,17,11,6
13,11,4,8,28,-20
13,11,5,14,18,-4
13,11,6,18,15,3
13,11,7,12,23,-11
13,11,8,8,15,-7
13,11,9,20,22,-2
13,11,10,7,12,-5
13,11,11,17,9,8
13,11,12,20,15,5
13,11,13,8,11,-3
13,11,14,17,8,9
13,11,15,13,17,-4
13,11,16,15,22,-7
13,11,17,15,23,-8
13,11,18,26,20,6
13,11,19,7,27,-20
13,11,20,14,10,4
13,11,21,18,10,8
13,11,22,11,24,-13
13,11,23,7,12,-5
13,11,24,8,13,-5
13,11,25,16,16,0
13,11,26,13,15,-2
13,11,27,11,19,-8
13,11,28,14,15,-1
13,11,29,13,20,-7
13,11,30,15,17,-2
13,11,31,17,16,1
13,11,32,12,17,-5
13,11,33,19,17,2
13,11,34,19,12,7
13,11,35,18,30,-12
13,11,36,26,19,7
13,11,37,12,25,-13
13,11,38,14,21,-7
13,11,39,22,20,2
13,11,40,15,16,-1
13,11,41,10,21,-11
13,11,42,3,12,-9
13,11,43,12,16,-4
13,11,44,14,28,-14
13,11,45,14,11,3
13,11,46,12,21,-9
13,11,47,19,16,3
13,11,48,11,31,-20
13,11,49,13,14,-1
13,11,50,8,14,-6
13,11,51,17,17,0
13,11,52,16,15,1
13,11,53,9,15,-6
13,11,54,12,18,-6
13,11,55,24,12,12
13,11,56,15,12,3
13,11,57,16,17,-1
13,11,58,9,16,-7
13,11,59,19,13,6
13,11,60,22,33,-11
13,11,61,9,19,-10
13,11,62,7,12,-5
13,11,63,4,26,-22
13,11,64,5,6,-1
13,11,65,15,19,-4
13,11,66,12,22,-10
13,11,67,16,18,-2
13,11,68,18,17,1
13,11,69,26,20,6
13,11,70,12,10,2
13,11,71,15,22,-7
13,11,72,10,9,1
13,11,73,5,13,-8
13,11,74,15,16,-1
13,11,75,19,31,-12
13,11,76,11,25,-14
13,11,77,11,13,-2
13,11,78,11,12,-1
13,11,79,21,21,0
13,11,80,14,6,8
13,11,81,16,30,-14
13,11,82,17,23,-6
13,11,83,12,15,-3
13,11,84,13,19,-6
13,11,85,14,20,-6
13,11,86,21,31,-10
13,11,87,11,15,-4
13,11,88,11,16,-5
13,11,89,18,22,-4
13,11,90,17,23,-6
13,11,91,18,18,0
13,11,92,16,14,2
13,11,93,16,13,3
13,11,94,12,12,0
13,11,95,14,22,-8
13,11,96,11,18,-7
13,11,97,14,20,-6
13,11,98,10,11,-1
13,11,99,8,24,-16
13,11,100,11,20,-9
13,11,101,6,25,-19
13,11,102,10,12,-2
13,11,103,8,10,-2
13,11,104,17,20,-3
13,11,105,11,11,0
13,11,106,16,10,6
13,11,107,27,16,11
13,11,108,14,13,1
13,11,109,11,18,-7
13,11,110,9,9,0
13,11,111,14,9,5
13,11,112,8,9,-1
13,11,113,7,19,-12
13,11,114,4,7,-3
13,11,115,19,9,10
13,11,116,11,12,-1
13,11,117,16,24,-8
13,11,118,22,16,6
13,11,119,16,15,1
13,11,120,25,12,13
13,11,121,11,13,-2
13,11,122,17,28,-11
13,11,123,9,19,-10
13,11,124,16,17,-1
13,11,125,9,11,-2
13,11,126,22,5,17
13,11,127,7,10,-3
13,11,128,18,15,3
13,11,129,23,16,7
13,11,130,17,14,3
13,11,131,20,28,-8
13,11,132,15,7,8
13,11,133,18,26,-8
13,11,134,13,17,-4
13,11,135,6,25,-19
13,11,136,22,22,0
13,11,137,11,13,-2
13,11,138,8,14,-6
13,11,139,24,16,8
13,11,140,18,33,-15
13,11,141,9,18,-9
13,11,142,10,10,0
13,11,143,24,19,5
13,11,144,17,16,1
13,11,145,16,31,-15
13,11,146,21,9,12
13,11,147,14,23,-9
13,11,148,9,20,-11
13,11,149,14,21,-7
13,11,150,20,11,9
13,11,151,10,12,-2
13,11,152,15,7,8
13,11,153,15,17,-2
13,11,154,13,28,-15
13,11,155,20,20,0
13,11,156,11,17,-6
13,11,157,18,19,-1
13,11,158,18,23,-5
13,11,159,19,16,3
13,11,160,14,15,-1
13,11,161,18,17,1
13,11,162,15,24,-9
13,11,163,7,19,-12
13,11,164,16,19,-3
13,11,165,13,23,-10
13,11,166,27,15,12
13,11,167,12,10,2
13,11,168,23,18,5
13,11,169,24,18,6
13,11,170,10,15,-5
13,11,171,12,20,-8
13,11,172,18,15,3
13,11,173,7,5,2
13,11,174,7,18,-11
13,11,175,26,18,8
13,11,176,7,8,-1
13,11,177,13,21,-8
13,11,178,9,20,-11
13,11,179,20,16,4
13,11,180,13,11,2
13,11,181,16,31,-15
13,11,182,16,14,2
13,11,183,8,10,-2
13,11,184,8,10,-2
13,11,185,35,14,21
13,11,186,11,21,-10
13,11,187,10,18,-8
13,11,188,10,18,-8
13,11,189,15,25,-10
13,11,190,25,32,-7
13,11,191,13,27,-14
13,11,192,22,26,-4
13,11,193,16,9,7
13,11,194,25,18,7
13,11,195,9,25,-16
13,11,196,9,18,-9
13,11,197,29,19,10
13,11,198,11,11,0
13,11,199,11,18,-7
13,11,200,9,22,-13
13,11,201,12,13,-1
13,11,202,11,12,-1
13,11,203,2,23,-21
13,11,204,21,14,7
13,11,205,12,26,-14
13,11,206,23,25,-2
13,11,207,15,13,2
13,11,208,13,13,0
13,11,209,5,7,-2
13,11,210,30,23,7
13,11,211,7,18,-11
13,11,212,11,18,-7
13,11,213,13,28,-15
13,11,214,22,17,5
13,11,215,14,13,1
13,11,216,17,17,0
13,11,217,10,8,2
13,11,218,16,18,-2
13,11,219,22,24,-2
13,11,220,15,18,-3
13,11,221,20,27,-7
13,11,222,13,31,-18
13,11,223,12,8,4
13,11,224,14,5,9
13,11,225,19,31,-12
13,11,226,7,21,-14
13,11,227,12,17,-5
13,11,228,7,12,-5
13,11,229,14,13,1
13,11,230,6,15,-9
13,11,231,15,15,0
13,11,232,22,27,-5
13,11,233,17,17,0
13,11,234,6,21,-15
13,11,235,11,12,-1
13,11,236,21,10,11
13,11,237,16,21,-5
13,11,238,8,21,-13
13,11,239,18,24,-6
13,11,240,9,13,-4
13,11,241,16,14,2
13,11,242,13,13,0
13,11,243,9,15,-6
13,11,244,18,9,9
13,11,245,18,15,3
13,11,246,7,18,-11
13,11,247,18,10,8
13,11,248,18,26,-8
13,11,249,17,19,-2
13,11,250,22,23,-1
13,11,251,18,19,-1
13,11,252,15,18,-3
13,11,253,14,15,-1
13,11,254,12,15,-3
13,11,255,19,17,2
13,11,256,15,15,0
13,11,257,13,21,-8
13,11,258,21,18,3
13,11,259,14,23,-9
13,11,260,18,16,2
13,11,261,12,17,-5
13,11,262,19,25,-6
13,11,263,17,18,-1
13,11,264,19,26,-7
13,11,265,15,10,5
13,11,266,13,19,-6
13,11,267,8,12,-4
13,11,268,14,16,-2
13,11,269,10,31,-21
13,11,270,14,16,-2
13,11,271,9,10,-1
13,11,272,16,8,8
13,11,273,22,14,8
13,11,274,16,15,1
13,11,275,20,16,4
13,11,276,19,28,-9
13,11,277,27,22,5
13,11,278,11,17,-6
13,11,279,18,27,-9
13,11,280,6,14,-8
13,11,281,11,16,-5
13,11,282,13,15,-2
13,11,283,8,10,-2
13,11,284,8,16,-8
13,11,285,22,18,4
13,11,286,22,15,7
13,11,287,11,22,-11
13,11,288,15,11,4
13,11,289,18,15,3
13,11,290,10,11,-1
13,11,291,10,18,-8
13,11,292,15,20,-5
13,11,293,15,22,-7
13,11,294,19,20,-1
13,11,295,18,20,-2
13,11,296,8,19,-11
13,11,297,16,24,-8
13,11,298,6,6,0
13,11,299,17,21,-4
13,12,0,15,27,-12
13,12,1,19,15,4
13,12,2,10,5,5
13,12,3,15,15,0
13,12,4,6,16,-10
13,12,5,10,12,-2
13,12,6,19,10,9
13,12,7,11,20,-9
13,12,8,19,17,2
13,12,9,19,14,5
13,12,10,8,23,-15
13,12,11,12,7,5
13,12,12,14,17,-3
13,12,13,15,14,1
13,12,14,18,16,2
13,12,15,12,10,2
13,12,16,15,12,3
13,12,17,22,20,2
13,12,18,19,21,-2
13,12,19,22,14,8
13,12,20,22,17,5
13,12,21,13,19,-6
13,12,22,8,9,-1
13,12,23,13,29,-16
13,12,24,12,7,5
13,12,25,13,23,-10
13,12,26,17,12,5
13,12,27,18,15,3
13,12,28,10,14,-4
13,12,29,11,12,-1
13,12,30,5,9,-4
13,12,31,9,19,-10
13,12,32,2,9,-7
13,12,33,18,16,2
13,12,34,5,13,-8
13,12,35,23,18,5
13,12,36,16,12,4
13,12,37,15,11,4
13,12,38,7,5,2
13,12,39,19,15,4
13,12,40,16,10,6
13,12,41,8,5,3
13,12,42,17,11,6
13,12,43,21,13,8
13,12,44,24,22,2
13,12,45,20,32,-12
13,12,46,15,18,-3
13,12,47,12,17,-5
13,12,48,25,15,10
13,12,49,17,12,5
13,12,50,21,10,11
13,12,51,6,13,-7
13,12,52,13,23,-10
13,12,53,19,24,-5
13,12,54,27,24,3
13,12,55,5,11,-6
13,12,56,20,15,5
13,12,57,12,17,-5
13,12,58,5,4,1
13,12,59,11,19,-8
13,12,60,17,24,-7
13,12,61,11,14,-3
13,12,62,19,17,2
13,12,63,9,15,-6
13,12,64,17,27,-10
13,12,65,9,10,-1
13,12,66,29,20,9
13,12,67,18,16,2
13,12,68,19,16,3
13,12,69,19,24,-5
13,12,70,15,13,2
13,12,71,24,22,2
13,12,72,14,17,-3
13,12,73,12,16,-4
13,12,74,20,20,0
13,12,75,23,21,2
13,12,76,11,22,-11
13,12,77,21,22,-1
13,12,78,19,13,6
13,12,79,13,15,-2
13,12,80,12,20,-8
13,12,81,12,20,-8
13,12,82,19,17,2
13,12,83,17,18,-1
13,12,84,14,12,2
13,12,85,19,27,-8
13,12,86,7,17,-10
13,12,87,23,14,9
13,12,88,20,16,4
13,12,89,34,13,21
13,12,90,5,11,-6
13,12,91,26,25,1
13,12,92,13,15,-2
13,12,93,25,28,-3
13,12,94,19,7,12
13,12,95,9,9,0
13,12,96,18,21,-3
13,12,97,17,11,6
13,12,98,12,28,-16
13,12,99,13,7,6
13,12,100,12,22,-10
13,12,101,11,18,-7
13,12,102,14,14,0
13,12,103,5,4,1
13,12,104,7,13,-6
13,12,105,20,11,9
13,12,106,19,20,-1
13,12,107,7,14,-7
13,12,108,24,17,7
13,12,109,8,18,-10
13,12,110,13,14,-1
13,12,111,11,11,0
13,12,112,13,15,-2
13,12,113,19,18,1
13,12,114,16,13,3
13,12,115,9,18,-9
13,12,116,17,23,-6
13,12,117,17,9,8
13,12,118,22,22,0
13,12,119,25,21,4
13,12,120,5,7,-2
13,12,121,10,13,-3
13,12,122,32,21,11
13,12,123,6,17,-11
13,12,124,20,19,1
13,12,125,17,30,-13
13,12,126,16,18,-2
13,12,127,26,18,8
13,12,128,14,12,2
13,12,129,12,14,-2
13,12,130,14,27,-13
13,12,131,22,22,0
13,12,132,13,14,-1
13,12,133,16,15,1
13,12,134,13,17,-4
13,12,135,22,13,9
13,12,136,14,11,3
13,12,137,17,32,-15
13,12,138,26,22,4
13,12,139,10,12,-2
13,12,140,15,20,-5
13,12,141,12,20,-8
13,12,142,4,12,-8
13,12,143,19,13,6
13,12,144,8,23,-15
13,12,145,10,12,-2
13,12,146,11,17,-6
13,12,147,24,21,3
13,12,148,11,13,-2
13,12,149,12,8,4
13,12,150,9,20,-11
13,12,151,10,15,-5
13,12,152,17,20,-3
13,12,153,26,13,13
13,12,154,14,16,-2
13,12,155,12,17,-5
13,12,156,25,28,-3
13,12,157,22,24,-2
13,12,158,14,13,1
13,12,159,19,20,-1
13,12,160,9,11,-2
13,12,161,15,20,-5
13,12,162,18,22,-4
13,12,163,20,27,-7
13,12,164,11,18,-7
13,12,165,4,19,-15
13,12,166,18,17,1
13,12,167,18,17,1
13,12,168,18,23,-5
13,12,169,14,20,-6
13,12,170,7,16,-9
13,12,171,13,17,-4
13,12,172,30,14,16
13,12,173,10,13,-3
13,12,174,11,13,-2
13,12,175,12,15,-3
13,12,176,21,14,7
13,12,177,4,15,-11
13,12,178,7,18,-11
13,12,179,16,34,-18
13,12,180,14,19,-5
13,12,181,7,15,-8
13,12,182,18,18,0
13,12,183,6,10,-4
13,12,184,15,8,7
13,12,185,20,17,3
13,12,186,11,28,-17
13,12,187,15,16,-1
13,12,188,23,34,-11
13,12,189,28,11,17
13,12,190,17,19,-2
13,12,191,16,16,0
13,12,192,28,29,-1
13,12,193,19,30,-11
13,12,194,13,20,-7
13,12,195,11,17,-6
13,12,196,11,30,-19
13,12,197,16,12,4
13,12,198,24,12,12
13,12,199,11,11,0
13,12,200,15,18,-3
13,12,201,8,17,-9
13,12,202,12,9,3
13,12,203,18,11,7
13,12,204,8,22,-14
13,12,205,23,23,0
13,12,206,19,11,8
13,12,207,10,15,-5
13,12,208,15,13,2
13,12,209,11,22,-11
13,12,210,14,14,0
13,12,211,11,13,-2
13,12,212,20,34,-14
13,12,213,14,10,4
13,12,214,3,8,-5
13,12,215,10,20,-10
13,12,216,14,15,-1
13,12,217,7,6,1
13,12,218,19,22,-3
13,12,219,15,19,-4
13,12,220,13,20,-7
13,12,221,17,10,7
13,12,222,13,20,-7
13,12,223,32,23,9
13,12,224,20,12,8
13,12,225,14,24,-10
13,12,226,8,12,-4
13,12,227,14,20,-6
13,12,228,16,17,-1
13,12,229,16,20,-4
13,12,230,0,10,-10
13,12,231,18,21,-3
13,12,232,30,10,20
13,12,233,24,19,5
13,12,234,13,17,-4
13,12,235,18,16,2
13,12,236,8,19,-11
13,12,237,12,10,2
13,12,238,16,18,-2
13,12,239,26,16,10
13,12,240,9,11,-2
13,12,241,17,16,1
13,12,242,9,5,4
13,12,243,19,14,5
13,12,244,21,15,6
13,12,245,7,15,-8
13,12,246,18,9,9
13,12,247,9,15,-6
13,12,248,9,12,-3
13,12,249,7,20,-13
13,12,250,14,12,2
13,12,251,7,17,-10
13,12,252,7,12,-5
13,12,253,20,19,1
13,12,254,20,22,-2
13,12,255,18,14,4
13,12,256,14,7,7
13,12,257,14,16,-2
13,12,258,9,22,-13
13,12,259,14,26,-12
13,12,260,23,18,5
13,12,261,19,8,11
13,12,262,10,12,-2
13,12,263,10,15,-5
13,12,264,28,19,9
13,12,265,11,8,3
13,12,266,16,15,1
13,12,267,19,16,3
13,12,268,8,11,-3
13,12,269,27,27,0
13,12,270,7,8,-1
13,12,271,20,14,6
13,12,272,15,22,-7
13,12,273,10,11,-1
13,12,274,10,19,-9
13,12,275,27,30,-3
13,12,276,14,7,7
13,12,277,21,22,-1
13,12,278,11,22,-11
13,12,279,15,17,-2
13,12,280,4,13,-9
13,12,281,10,14,-4
13,12,282,17,22,-5
13,12,283,12,21,-9
13,12,284,17,6,11
13,12,285,13,10,3
13,12,286,17,15,2
13,12,287,30,31,-1
13,12,288,12,22,-10
13,12,289,19,11,8
13,12,290,9,10,-1
13,12,291,8,9,-1
13,12,292,21,17,4
13,12,293,10,9,1
13,12,294,11,16,-5
13,12,295,17,12,5
13,12,296,17,15,2
13,12,297,13,9,4
13,12,298,8,19,-11
13,12,299,16,20,-4
13,13,0,11,20,-9
13,13,1,16,13,3
13,13,2,16,39,-23
13,13,3,34,25,9
13,13,4,13,9,4
13,13,5,14,15,-1
13,13,6,19,30,-11
13,13,7,6,15,-9
13,13,8,12,14,-2
13,13,9,19,22,-3
13,13,10,9,4,5
13,13,11,17,25,-8
13,13,12,9,20,-11
13,13,13,13,9,4
13,13,14,14,18,-4
13,13,15,22,23,-1
13,13,16,14,13,1
13,13,17,17,17,0
13,13,18,20,14,6
13,13,19,15,25,-10
13,13,20,11,10,1
13,13,21,19,22,-3
13,13,22,5,13,-8
13,13,23,10,25,-15
13,13,24,16,20,-4
13,13,25,18,29,-11
13,13,26,5,11,-6
13,13,27,15,21,-6
13,13,28,24,28,-4
13,13,29,16,16,0
13,13,30,9,22,-13
13,13,31,16,11,5
13,13,32,11,19,-8
13,13,33,9,12,-3
13,13,34,9,16,-7
13,13,35,13,11,2
13,13,36,10,14,-4
13,13,37,14,13,1
13,13,38,15,10,5
13,13,39,15,33,-18
13,13,40,10,15,-5
13,13,41,16,22,-6
13,13,42,19,15,4
13,13,43,15,16,-1
13,13,44,15,18,-3
13,13,45,11,16,-5
13,13,46,26,21,5
13,13,47,5,14,-9
13,13,48,11,17,-6
13,13,49,12,21,-9
13,13,50,15,12,3
13,13,51,12,22,-10
13,13,52,11,16,-5
13,13,53,10,14,-4
13,13,54,12,13,-1
13,13,55,15,7,8
13,13,56,11,16,-5
13,13,57,15,16,-1
13,13,58,16,16,0
13,13,59,11,16,-5
13,13,60,13,18,-5
13,13,61,6,10,-4
13,13,62,10,18,-8
13,13,63,14,19,-5
13,13,64,18,12,6
13,13,65,11,17,-6
13,13,66,7,6,1
13,13,67,15,11,4
13,13,68,12,16,-4
13,13,69,17,7,10
13,13,70,17,17,0
13,13,71,14,10,4
13,13,72,21,20,1
13,13,73,14,16,-2
13,13,74,9,13,-4
13,13,75,14,21,-7
13,13,76,13,21,-8
13,13,77,17,19,-2
13,13,78,10,15,-5
13,13,79,12,14,-2
13,13,80,6,12,-6
13,13,81,9,19,-10
13,13,82,7,14,-7
13,13,83,18,24,-6
13,13,84,9,11,-2
13,13,85,26,20,6
13,13,86,8,17,-9
13,13,87,13,17,-4
13,13,88,17,8,9
13,13,89,14,8,6
13,13,90,20,12,8
13,13,91,22,24,-2
13,13,92,19,19,0
13,13,93,13,7,6
13,13,94,21,13,8
13,13,95,9,36,-27
13,13,96,12,19,-7
13,13,97,16,9,7
13,13,98,13,19,-6
13,13,99,23,13,10
13,13,100,8,7,1
13,13,101,9,9,0
13,13,102,11,21,-10
13,13,103,14,12,2
13,13,104,18,23,-5
13,13,105,13,26,-13
13,13,106,17,25,-8
13,13,107,11,16,-5
13,13,108,22,17,5
13,13,109,19,38,-19
13,13,110,11,19,-8
13,13,111,19,28,-9
13,13,112,13,11,2
13,13,113,15,6,9
13,13,114,11,15,-4
13,13,115,21,23,-2
13,13,116,17,19,-2
13,13,117,6,13,-7
13,13,118,5,14,-9
13,13,119,14,17,-3
13,13,120,14,16,-2
13,13,121,23,23,0
13,13,122,7,17,-10
13,13,123,16,12,4
13,13,124,11,13,-2
13,13,125,14,15,-1
13,13,126,20,13,7
13,13,127,12,15,-3
13,13,128,13,10,3
13,13,129,12,10,2
13,13,130,20,20,0
13,13,131,14,30,-16
13,13,132,15,15,0
13,13,133,13,14,-1
13,13,134,14,18,-4
13,13,135,14,21,-7
13,13,136,21,19,2
13,13,137,10,16,-6
13,13,138,11,13,-2
13,13,139,22,21,1
13,13,140,16,14,2
13,13,141,7,11,-4
13,13,142,11,11,0
13,13,143,17,29,-12
13,13,144,11,15,-4
13,13,145,10,22,-12
13,13,146,11,14,-3
13,13,147,17,25,-8
13,13,148,5,14,-9
13,13,149,7,5,2
13,13,150,12,17,-5
13,13,151,8,28,-20
13,13,152,12,10,2
13,13,153,11,16,-5
13,13,154,13,11,2
13,13,155,20,28,-8
13,13,156,8,25,-17
13,13,157,5,4,1
13,13,158,13,6,7
13,13,159,21,22,-1
13,13,160,11,9,2
13,13,161,18,21,-3
13,13,162,24,30,-6
13,13,163,13,21,-8
13,13,164,12,24,-12
13,13,165,16,16,0
13,13,166,18,11,7
13,13,167,10,13,-3
13,13,168,21,19,2
13,13,169,19,28,-9
13,13,170,13,25,-12
13,13,171,9,17,-8
13,13,172,17,15,2
13,13,173,16,23,-7
13,13,174,15,17,-2
13,13,175,15,18,-3
13,13,176,22,19,3
13,13,177,8,15,-7
13,13,178,17,16,1
13,13,179,4,29,-25
13,13,180,14,25,-11
13,13,181,15,18,-3
13,13,182,15,11,4
13,13,183,16,17,-1
13,13,184,25,19,6
13,13,185,15,10,5
13,13,186,15,24,-9
13,13,187,5,12,-7
13,13,188,15,12,3
13,13,189,9,11,-2
13,13,190,13,14,-1
13,13,191,12,22,-10
13,13,192,14,20,-6
13,13,193,14,15,-1
13,13,194,14,12,2
13,13,195,13,13,0
13,13,196,17,14,3
13,13,197,2,16,-14
13,13,198,25,20,5
13,13,199,16,15,1
13,13,200,9,17,-8
13,13,201,6,25,-19
13,13,202,17,9,8
13,13,203,15,9,6
13,13,204,12,10,2
13,13,205,9,17,-8
13,13,206,14,13,1
13,13,207,12,19,-7
13,13,208,2,12,-10
13,13,209,13,17,-4
13,13,210,12,18,-6
13,13,211,17,24,-7
13,13,212,10,15,-5
13,13,213,13,24,-11
13,13,214,21,24,-3
13,13,215,18,22,-4
13,13,216,11,10,1
13,13,217,12,21,-9
13,13,218,22,42,-20
13,13,219,13,21,-8
13,13,220,30,16,14
13,13,221,15,20,-5
13,13,222,11,9,2
13,13,223,20,11,9
13,13,224,10,14,-4
13,13,225,10,7,3
13,13,226,13,12,1
13,13,227,13,10,3
13,13,228,10,8,2
13,13,229,16,18,-2
13,13,230,23,23,0
13,13,231,32,22,10
13,13,232,15,18,-3
13,13,233,22,20,2
13,13,234,16,18,-2
13,13,235,19,15,4
13,13,236,22,12,10
13,13,237,14,15,-1
13,13,238,5,8,-3
13,13,239,27,10,17
13,13,240,22,18,4
13,13,241,16,11,5
13,13,242,9,7,2
13,13,243,14,24,-10
13,13,244,3,11,-8
13,13,245,13,15,-2
13,13,246,10,23,-13
13,13,247,7,21,-14
13,13,248,13,20,-7
13,13,249,24,25,-1
13,13,250,5,12,-7
13,13,251,11,11,0
13,13,252,14,13,1
13,13,253,16,25,-9
13,13,254,10,16,-6
13,13,255,7,15,-8
13,13,256,13,19,-6
13,13,257,17,16,1
13,13,258,16,16,0
13,13,259,8,12,-4
13,13,260,18,17,1
13,13,261,31,29,2
13,13,262,13,29,-16
13,13,263,15,18,-3
13,13,264,25,18,7
13,13,265,20,6,14
13,13,266,10,20,-10
13,13,267,8,3,5
13,13,268,14,19,-5
13,13,269,20,15,5
13,13,270,11,16,-5
13,13,271,25,17,8
13,13,272,18,20,-2
13,13,273,6,13,-7
13,13,274,4,17,-13
13,13,275,16,22,-6
13,13,276,15,15,0
13,13,277,9,26,-17
13,13,278,24,16,8
13,13,279,12,14,-2
13,13,280,12,31,-19
13,13,281,10,18,-8
13,13,282,19,27,-8
13,13,283,12,20,-8
13,13,284,15,16,-1
13,13,285,5,7,-2
13,13,286,17,21,-4
13,13,287,23,39,-16
13,13,288,9,16,-7
13,13,289,11,13,-2
13,13,290,20,30,-10
13,13,291,6,15,-9
13,13,292,10,6,4
13,13,293,18,21,-3
13,13,294,28,30,-2
13,13,295,20,13,7
13,13,296,26,20,6
13,13,297,17,17,0
13,13,298,19,23,-4
13,13,299,10,24,-14
13,14,0,18,15,3
13,14,1,17,18,-1
13,14,2,28,15,13
13,14,3,9,25,-16
13,14,4,12,22,-10
13,14,5,23,22,1
13,14,6,20,8,12
13,14,7,18,12,6
13,14,8,13,11,2
13,14,9,17,14,3
13,14,10,11,19,-8
13,14,11,15,7,8
13,14,12,7,17,-10
13,14,13,18,17,1
13,14,14,11,9,2
13,14,15,19,25,-6
13,14,16,8,18,-10
13,14,17,8,19,-11
13,14,18,14,19,-5
13,14,19,36,4,32
13,14,20,16,10,6
13,14,21,11,22,-11
13,14,22,23,21,2
13,14,23,9,15,-6
13,14,24,20,18,2
13,14,25,23,13,10
13,14,26,10,24,-14
13,14,27,14,19,-5
13,14,28,11,21,-10
13,14,29,9,24,-15
13,14,30,10,12,-2
13,14,31,23,19,4
13,14,32,16,21,-5
13,14,33,22,19,3
13,14,34,7,18,-11
13,14,35,19,18,1
13,14,36,8,10,-2
13,14,37,5,12,-7
13,14,38,21,13,8
13,14,39,11,16,-5
13,14,40,13,8,5
13,14,41,9,26,-17
13,14,42,21,22,-1
13,14,43,10,19,-9
13,14,44,8,7,1
13,14,45,16,17,-1
13,14,46,9,13,-4
13,14,47,22,13,9
13,14,48,11,11,0
13,14,49,23,16,7
13,14,50,17,15,2
13,14,51,12,29,-17
13,14,52,6,5,1
13,14,53,20,15,5
13,14,54,12,18,-6
13,14,55,7,13,-6
13,14,56,16,19,-3
13,14,57,5,12,-7
13,14,58,10,27,-17
13,14,59,7,17,-10
13,14,60,13,17,-4
13,14,61,8,10,-2
13,14,62,18,19,-1
13,14,63,18,7,11
13,14,64,14,22,-8
13,14,65,13,10,3
13,14,66,9,6,3
13,14,67,16,8,8
13,14,68,16,14,2
13,14,69,28,32,-4
13,14,70,17,10,7
13,14,71,12,7,5
13,14,72,22,25,-3
13,14,73,16,18,-2
13,14,74,22,9,13
13,14,75,14,21,-7
13,14,76,5,12,-7
13,14,77,27,19,8
13,14,78,14,26,-12
13,14,79,6,13,-7
13,14,80,16,14,2
13,14,81,19,16,3
13,14,82,18,19,-1
13,14,83,14,13,1
13,14,84,11,7,4
13,14,85,12,18,-6
13,14,86,14,13,1
13,14,87,17,17,0
13,14,88,7,11,-4
13,14,89,17,27,-10
13,14,90,17,13,4
13,14,91,7,15,-8
13,14,92,18,9,9
13,14,93,16,13,3
13,14,94,11,12,-1
13,14,95,11,22,-11
13,14,96,20,9,11
13,14,97,12,15,-3
13,14,98,16,23,-7
13,14,99,14,19,-5
13,14,100,19,18,1
13,14,101,18,21,-3
13,14,102,18,16,2
13,14,103,9,10,-1
13,14,104,25,24,1
13,14,105,13,24,-11
13,14,106,19,11,8
13,14,107,8,15,-7
13,14,108,25,11,14
13,14,109,18,13,5
13,14,110,12,13,-1
13,14,111,14,10,4
13,14,112,11,13,-2
13,14,113,7,19,-12
13,14,114,20,19,1
13,14,115,14,9,5
13,14,116,16,14,2
13,14,117,28,19,9
13,14,118,14,28,-14
13,14,119,16,18,-2
13,14,120,23,14,9
13,14,121,18,10,8
13,14,122,19,14,5
13,14,123,15,9,6
13,14,124,17,18,-1
13,14,125,13,19,-6
13,14,126,1,9,-8
13,14,127,19,29,-10
13,14,128,10,20,-10
13,14,129,12,20,-8
13,14,130,19,16,3
13,14,131,15,20,-5
13,14,132,11,12,-1
13,14,133,13,16,-3
13,14,134,10,3,7
13,14,135,20,23,-3
13,14,136,14,11,3
13,14,137,15,17,-2
13,14,138,13,10,3
13,14,139,19,22,-3
13,14,140,16,14,2
13,14,141,11,16,-5
13,14,142,15,28,-13
13,14,143,26,12,14
13,14,144,21,15,6
13,14,145,8,15,-7
13,14,146,8,11,-3
13,14,147,19,20,-1
13,14,148,29,17,12
13,14,149,15,7,8
13,14,150,11,15,-4
13,14,151,23,27,-4
13,14,152,19,12,7
13,14,153,9,22,-13
13,14,154,10,6,4
13,14,155,18,8,10
13,14,156,22,18,4
13,14,157,21,14,7
13,14,158,8,13,-5
13,14,159,10,8,2
13,14,160,28,26,2
13,14,161,22,20,2
13,14,162,26,12,14
13,14,163,15,5,10
13,14,164,14,19,-5
13,14,165,19,12,7
13,14,166,25,20,5
13,14,167,7,22,-15
13,14,168,29,32,-3
13,14,169,11,10,1
13,14,170,16,9,7
13,14,171,10,11,-1
13,14,172,23,16,7
13,14,173,4,16,-12
13,14,174,14,13,1
13,14,175,13,13,0
13,14,176,13,11,2
13,14,177,17,14,3
13,14,178,20,8,12
13,14,179,16,12,4
13,14,180,18,12,6
13,14,181,18,16,2
13,14,182,13,26,-13
13,14,183,17,11,6
13,14,184,21,15,6
13,14,185,21,15,6
13,14,186,19,16,3
13,14,187,25,20,5
13,14,188,11,15,-4
13,14,189,9,13,-4
13,14,190,14,10,4
13,14,191,16,4,12
13,14,192,13,9,4
13,14,193,13,13,0
13,14,194,22,22,0
13,14,195,12,16,-4
13,14,196,23,29,-6
13,14,197,18,10,8
13,14,198,5,10,-5
13,14,199,21,16,5
13,14,200,13,36,-23
13,14,201,15,8,7
13,14,202,12,21,-9
13,14,203,23,22,1
13,14,204,16,9,7
13,14,205,12,13,-1
13,14,206,7,5,2
13,14,207,31,27,4
13,14,208,11,17,-6
13,14,209,8,11,-3
13,14,210,19,25,-6
13,14,211,18,35,-17
13,14,212,12,18,-6
13,14,213,18,21,-3
13,14,214,16,13,3
13,14,215,32,14,18
13,14,216,19,24,-5
13,14,217,9,3,6
13,14,218,13,18,-5
13,14,219,17,31,-14
13,14,220,11,20,-9
13,14,221,13,8,5
13,14,222,11,16,-5
13,14,223,10,27,-17
13,14,224,30,17,13
13,14,225,20,17,3
13,14,226,6,13,-7
13,14,227,18,23,-5
13,14,228,9,13,-4
13,14,229,22,29,-7
13,14,230,17,14,3
13,14,231,19,23,-4
13,14,232,11,20,-9
13,14,233,6,10,-4
13,14,234,14,6,8
13,14,235,20,25,-5
13,14,236,14,19,-5
13,14,237,25,17,8
13,14,238,15,19,-4
13,14,239,14,18,-4
13,14,240,21,31,-10
13,14,241,20,12,8
13,14,242,11,7,4
13,14,243,29,19,10
13,14,244,10,16,-6
13,14,245,10,15,-5
13,14,246,15,12,3
13,14,247,3,10,-7
13,14,248,15,18,-3
13,14,249,17,23,-6
13,14,250,12,23,-11
13,14,251,19,27,-8
13,14,252,28,20,8
13,14,253,20,26,-6
13,14,254,14,10,4
13,14,255,12,19,-7
13,14,256,5,13,-8
13,14,257,7,21,-14
13,14,258,13,27,-14
13,14,259,22,8,14
13,14,260,11,21,-10
13,14,261,16,12,4
13,14,262,14,9,5
13,14,263,11,23,-12
13,14,264,22,21,1
13,14,265,18,9,9
13,14,266,25,26,-1
13,14,267,11,17,-6
13,14,268,23,19,4
13,14,269,19,17,2
13,14,270,16,15,1
13,14,271,18,15,3
13,14,272,8,14,-6
13,14,273,17,27,-10
13,14,274,10,6,4
13,14,275,21,9,12
13,14,276,12,26,-14
13,14,277,9,19,-10
13,14,278,16,23,-7
13,14,279,19,18,1
13,14,280,21,16,5
13,14,281,17,22,-5
13,14,282,13,5,8
13,14,283,16,15,1
13,14,284,8,3,5
13,14,285,28,10,18
13,14,286,20,22,-2
13,14,287,24,15,9
13,14,288,7,8,-1
13,14,289,16,13,3
13,14,290,22,18,4
13,14,291,9,19,-10
13,14,292,6,17,-11
13,14,293,14,19,-5
13,14,294,7,14,-7
13,14,295,19,12,7
13,14,296,18,30,-12
13,14,297,23,13,10
13,14,298,29,34,-5
13,14,299,16,11,5
13,15,0,11,17,-6
13,15,1,22,27,-5
13,15,2,5,18,-13
13,15,3,16,7,9
13,15,4,14,4,10
13,15,5,13,12,1
13,15,6,24,14,10
13,15,7,2,3,-1
13,15,8,20,23,-3
13,15,9,7,9,-2
13,15,10,9,14,-5
13,15,11,17,12,5
13,15,12,16,11,5
13,15,13,23,19,4
13,15,14,26,20,6
13,15,15,13,9,4
13,15,16,8,11,-3
13,15,17,13,22,-9
13,15,18,17,8,9
13,15,19,18,16,2
13,15,20,20,17,3
13,15,21,7,8,-1
13,15,22,19,10,9
13,15,23,16,18,-2
13,15,24,13,14,-1
13,15,25,18,5,13
13,15,26,12,15,-3
13,15,27,38,16,22
13,15,28,9,14,-5
13,15,29,11,12,-1
13,15,30,5,6,-1
13,15,31,12,10,2
13,15,32,27,30,-3
13,15,33,14,20,-6
13,15,34,24,17,7
13,15,35,20,22,-2
13,15,36,23,20,3
13,15,37,22,10,12
13,15,38,21,13,8
13,15,39,25,14,11
13,15,40,12,30,-18
13,15,41,8,13,-5
13,15,42,15,17,-2
13,15,43,23,15,8
13,15,44,16,23,-7
13,15,45,14,15,-1
13,15,46,16,15,1
13,15,47,12,17,-5
13,15,48,22,13,9
13,15,49,14,11,3
13,15,50,8,14,-6
13,15,51,10,18,-8
13,15,52,21,26,-5
13,15,53,20,8,12
13,15,54,6,11,-5
13,15,55,15,13,2
13,15,56,13,26,-13
13,15,57,16,17,-1
13,15,58,15,6,9
13,15,59,15,9,6
13,15,60,16,11,5
13,15,61,15,12,3
13,15,62,28,17,11
13,15,63,20,14,6
13,15,64,21,15,6
13,15,65,29,13,16
13,15,66,15,9,6
13,15,67,9,10,-1
13,15,68,11,19,-8
13,15,69,11,12,-1
13,15,70,14,15,-1
13,15,71,15,23,-8
13,15,72,23,15,8
13,15,73,33,22,11
13,15,74,20,16,4
13,15,75,11,20,-9
13,15,76,16,23,-7
13,15,77,19,11,8
13,15,78,1,14,-13
13,15,79,17,11,6
13,15,80,20,26,-6
13,15,81,16,14,2
13,15,82,10,12,-2
13,15,83,18,18,0
13,15,84,11,15,-4
13,15,85,14,16,-2
13,15,86,19,14,5
13,15,87,17,15,2
13,15,88,7,23,-16
13,15,89,16,9,7
13,15,90,21,18,3
13,15,91,21,11,10
13,15,92,14,20,-6
13,15,93,15,28,-13
13,15,94,20,27,-7
13,15,95,7,15,-8
13,15,96,17,15,2
13,15,97,5,15,-10
13,15,98,14,22,-8
13,15,99,10,15,-5
13,15,100,1,8,-7
13,15,101,12,12,0
13,15,102,26,12,14
13,15,103,11,16,-5
13,15,104,11,21,-10
13,15,105,18,17,1
13,15,106,14,17,-3
13,15,107,25,15,10
13,15,108,11,22,-11
13,15,109,12,20,-8
13,15,110,19,10,9
13,15,111,13,24,-11
13,15,112,12,8,4
13,15,113,16,16,0
13,15,114,13,12,1
13,15,115,14,6,8
13,15,116,20,14,6
13,15,117,8,13,-5
13,15,118,11,10,1
13,15,119,16,13,3
13,15,120,6,12,-6
13,15,121,16,32,-16
13,15,122,21,25,-4
13,15,123,18,13,5
13,15,124,17,19,-2
13,15,125,13,10,3
13,15,126,10,8,2
13,15,127,11,6,5
13,15,128,16,36,-20
13,15,129,13,17,-4
13,15,130,18,6,12
13,15,131,20,24,-4
13,15,132,17,19,-2
13,15,133,17,16,1
13,15,134,10,13,-3
13,15,135,18,16,2
13,15,136,11,20,-9
13,15,137,36,30,6
13,15,138,15,14,1
13,15,139,18,34,-16
13,15,140,24,26,-2
13,15,141,16,9,7
13,15,142,15,12,3
13,15,143,12,14,-2
13,15,144,15,14,1
13,15,145,16,14,2
13,15,146,23,9,14
13,15,147,7,18,-11
13,15,148,14,10,4
13,15,149,13,33,-20
13,15,150,19,13,6
13,15,151,14,8,6
13,15,152,11,24,-13
13,15,153,14,10,4
13,15,154,14,14,0
13,15,155,18,21,-3
13,15,156,14,14,0
13,15,157,9,16,-7
13,15,158,18,14,4
13,15,159,11,7,4
13,15,160,31,26,5
13,15,161,11,11,0
13,15,162,12,9,3
13,15,163,20,16,4
13,15,164,23,24,-1
13,15,165,21,8,13
13,15,166,11,19,-8
13,15,167,14,24,-10
13,15,168,10,13,-3
13,15,169,15,6,9
13,15,170,15,10,5
13,15,171,14,15,-1
13,15,172,11,11,0
13,15,173,20,13,7
13,15,174,17,25,-8
13,15,175,19,8,11
13,15,176,23,17,6
13,15,177,28,19,9
13,15,178,15,9,6
13,15,179,26,23,3
13,15,180,22,15,7
13,15,181,18,21,-3
13,15,182,14,18,-4
13,15,183,11,41,-30
13,15,184,18,22,-4
13,15,185,16,11,5
13,15,186,13,10,3
13,15,187,15,12,3
13,15,188,24,11,13
13,15,189,27,20,7
13,15,190,15,15,0
13,15,191,16,26,-10
13,15,192,20,13,7
13,15,193,26,14,12
13,15,194,22,26,-4
13,15,195,17,15,2
13,15,196,17,14,3
13,15,197,27,21,6
13,15,198,24,11,13
13,15,199,20,19,1
13,15,200,17,20,-3
13,15,201,7,21,-14
13,15,202,18,34,-16
13,15,203,15,11,4
13,15,204,21,13,8
13,15,205,15,6,9
13,15,206,33,6,27
13,15,207,15,8,7
13,15,208,6,11,-5
13,15,209,11,13,-2
13,15,210,10,17,-7
13,15,211,14,12,2
13,15,212,18,20,-2
13,15,213,24,38,-14
13,15,214,9,18,-9
13,15,215,31,20,11
13,15,216,10,10,0
13,15,217,15,4,11
13,15,218,16,19,-3
13,15,219,10,13,-3
13,15,220,22,10,12
13,15,221,8,24,-16
13,15,222,10,17,-7
13,15,223,9,16,-7
13,15,224,11,17,-6
13,15,225,21,14,7
13,15,226,17,16,1
13,15,227,17,11,6
13,15,228,13,16,-3
13,15,229,11,12,-1
13,15,230,14,16,-2
13,15,231,10,14,-4
13,15,232,24,15,9
13,15,233,14,11,3
13,15,234,21,16,5
13,15,235,11,9,2
13,15,236,25,20,5
13,15,237,23,4,19
13,15,238,15,18,-3
13,15,239,11,9,2
13,15,240,29,25,4
13,15,241,19,14,5
13,15,242,8,24,-16
13,15,243,16,22,-6
13,15,244,15,10,5
13,15,245,12,6,6
13,15,246,11,16,-5
13,15,247,9,16,-7
13,15,248,21,17,4
13,15,249,10,12,-2
13,15,250,13,2,11
13,15,251,12,22,-10
13,15,252,28,23,5
13,15,253,15,28,-13
13,15,254,18,22,-4
13,15,255,13,19,-6
13,15,256,10,11,-1
13,15,257,7,8,-1
13,15,258,19,27,-8
13,15,259,11,12,-1
13,15,260,4,8,-4
13,15,261,21,11,10
13,15,262,11,21,-10
13,15,263,19,11,8
13,15,264,14,7,7
13,15,265,5,6,-1
13,15,266,15,16,-1
13,15,267,27,26,1
13,15,268,13,9,4
13,15,269,2,10,-8
13,15,270,9,7,2
13,15,271,23,14,9
13,15,272,8,12,-4
13,15,273,15,10,5
13,15,274,17,13,4
13,15,275,13,16,-3
13,15,276,14,26,-12
13,15,277,13,17,-4
13,15,278,16,6,10
13,15,279,11,16,-5
13,15,280,20,11,9
13,15,281,21,12,9
13,15,282,19,10,9
13,15,283,8,17,-9
13,15,284,11,20,-9
13,15,285,21,14,7
13,15,286,16,13,3
13,15,287,26,13,13
13,15,288,6,31,-25
13,15,289,17,4,13
13,15,290,31,32,-1
13,15,291,28,22,6
13,15,292,12,21,-9
13,15,293,19,14,5
13,15,294,19,26,-7
13,15,295,21,15,6
13,15,296,10,5,5
13,15,297,11,13,-2
13,15,298,6,7,-1
13,15,299,8,11,-3
13,16,0,9,12,-3
13,16,1,25,16,9
13,16,2,12,16,-4
13,16,3,21,26,-5
13,16,4,23,18,5
13,16,5,6,17,-11
13,16,6,21,17,4
13,16,7,20,15,5
13,16,8,11,3,8
13,16,9,15,7,8
13,16,10,18,24,-6
13,16,11,15,19,-4
13,16,12,13,16,-3
13,16,13,8,9,-1
13,16,14,17,9,8
13,16,15,14,7,7
13,16,16,23,15,8
13,16,17,14,27,-13
13,16,18,11,9,2
13,16,19,4,18,-14
13,16,20,17,20,-3
13,16,21,16,15,1
13,16,22,9,17,-8
13,16,23,14,18,-4
13,16,24,25,19,6
13,16,25,9,7,2
13,16,26,14,10,4
13,16,27,13,8,5
13,16,28,17,17,0
13,16,29,16,24,-8
13,16,30,16,20,-4
13,16,31,11,6,5
13,16,32,28,22,6
13,16,33,21,14,7
13,16,34,7,16,-9
13,16,35,19,26,-7
13,16,36,14,15,-1
13,16,37,4,21,-17
13,16,38,9,16,-7
13,16,39,14,8,6
13,16,40,23,14,9
13,16,41,29,11,18
13,16,42,14,11,3
13,16,43,20,12,8
13,16,44,17,7,10
13,16,45,21,17,4
13,16,46,15,26,-11
13,16,47,17,22,-5
13,16,48,16,19,-3
13,16,49,16,13,3
13,16,50,17,18,-1
13,16,51,14,18,-4
13,16,52,9,12,-3
13,16,53,17,15,2
13,16,54,11,10,1
13,16,55,21,17,4
13,16,56,9,14,-5
13,16,57,21,15,6
13,16,58,22,14,8
13,16,59,9,11,-2
13,16,60,17,12,5
13,16,61,17,9,8
13,16,62,18,23,-5
13,16,63,14,15,-1
13,16,64,12,8,4
13,16,65,2,17,-15
13,16,66,20,7,13
13,16,67,12,12,0
13,16,68,18,4,14
13,16,69,29,6,23
13,16,70,11,10,1
13,16,71,19,18,1
13,16,72,12,16,-4
13,16,73,7,11,-4
13,16,74,13,15,-2
13,16,75,21,14,7
13,16,76,24,13,11
13,16,77,7,10,-3
13,16,78,13,11,2
13,16,79,38,30,8
13,16,80,16,20,-4
13,16,81,17,8,9
13,16,82,10,28,-18
13,16,83,9,13,-4
13,16,84,14,12,2
13,16,85,21,16,5
13,16,86,12,14,-2
13,16,87,22,15,7
13,16,88,19,32,-13
13,16,89,8,3,5
13,16,90,24,11,13
13,16,91,14,14,0
13,16,92,17,9,8
13,16,93,13,11,2
13,16,94,16,15,1
13,16,95,5,5,0
13,16,96,17,13,4
13,16,97,19,10,9
13,16,98,19,12,7
13,16,99,16,19,-3
13,16,100,13,23,-10
13,16,101,24,21,3
13,16,102,16,19,-3
13,16,103,23,13,10
13,16,104,11,12,-1
13,16,105,12,10,2
13,16,106,27,14,13
13,16,107,16,12,4
13,16,108,16,16,0
13,16,109,20,13,7
13,16,110,26,21,5
13,16,111,14,18,-4
13,16,112,17,17,0
13,16,113,17,20,-3
13,16,114,25,25,0
13,16,115,18,21,-3
13,16,116,8,5,3
13,16,117,26,9,17
13,16,118,18,12,6
13,16,119,24,12,12
13,16,120,18,17,1
13,16,121,16,20,-4
13,16,122,14,22,-8
13,16,123,17,21,-4
13,16,124,20,15,5
13,16,125,8,16,-8
13,16,126,6,10,-4
13,16,127,19,16,3
13,16,128,32,23,9
13,16,129,9,11,-2
13,16,130,36,10,26
13,16,131,15,25,-10
13,16,132,10,3,7
13,16,133,29,19,10
13,16,134,14,14,0
13,16,135,14,15,-1
13,16,136,8,19,-11
13,16,137,22,22,0
13,16,138,11,10,1
13,16,139,10,23,-13
13,16,140,8,14,-6
13,16,141,12,24,-12
13,16,142,8,6,2
13,16,143,11,21,-10
13,16,144,14,19,-5
13,16,145,12,10,2
13,16,146,22,9,13
13,16,147,19,13,6
13,16,148,12,15,-3
13,16,149,16,13,3
13,16,150,19,23,-4
13,16,151,17,12,5
13,16,152,9,20,-11
13,16,153,11,13,-2
13,16,154,34,13,21
13,16,155,4,14,-10
13,16,156,16,4,12
13,16,157,11,11,0
13,16,158,8,11,-3
13,16,159,7,10,-3
13,16,160,20,15,5
13,16,161,11,17,-6
13,16,162,15,23,-8
13,16,163,20,19,1
13,16,164,16,13,3
13,16,165,11,13,-2
13,16,166,15,18,-3
13,16,167,14,14,0
13,16,168,14,13,1
13,16,169,10,10,0
13,16,170,15,17,-2
13,16,171,19,23,-4
13,16,172,17,15,2
13,16,173,14,13,1
13,16,174,16,17,-1
13,16,175,3,15,-12
13,16,176,17,18,-1
13,16,177,12,23,-11
13,16,178,7,7,0
13,16,179,33,21,12
13,16,180,14,10,4
13,16,181,13,19,-6
13,16,182,31,16,15
13,16,183,18,14,4
13,16,184,15,17,-2
13,16,185,10,11,-1
13,16,186,8,15,-7
13,16,187,14,21,-7
13,16,188,28,13,15
13,16,189,13,7,6
13,16,190,17,11,6
13,16,191,4,7,-3
13,16,192,22,13,9
13,16,193,13,11,2
13,16,194,13,12,1
13,16,195,14,11,3
13,16,196,21,22,-1
13,16,197,17,12,5
13,16,198,7,7,0
13,16,199,22,16,6
13,16,200,13,9,4
13,16,201,12,5,7
13,16,202,25,6,19
13,16,203,8,11,-3
13,16,204,24,11,13
13,16,205,13,9,4
13,16,206,21,20,1
13,16,207,24,18,6
13,16,208,32,23,9
13,16,209,14,22,-8
13,16,210,12,13,-1
13,16,211,6,23,-17
13,16,212,17,15,2
13,16,213,12,16,-4
13,16,214,29,14,15
13,16,215,8,28,-20
13,16,216,13,12,1
13,16,217,28,20,8
13,16,218,11,14,-3
13,16,219,14,13,1
13,16,220,25,18,7
13,16,221,18,14,4
13,16,222,15,11,4
13,16,223,12,14,-2
13,16,224,22,20,2
13,16,225,14,22,-8
13,16,226,22,13,9
13,16,227,23,20,3
13,16,228,13,18,-5
13,16,229,27,12,15
13,16,230,19,11,8
13,16,231,8,13,-5
13,16,232,17,13,4
13,16,233,23,16,7
13,16,234,14,12,2
13,16,235,11,6,5
13,16,236,15,23,-8
13,16,237,19,19,0
13,16,238,6,18,-12
13,16,239,14,10,4
13,16,240,4,11,-7
13,16,241,21,19,2
13,16,242,24,12,12
13,16,243,25,14,11
13,16,244,12,8,4
13,16,245,12,19,-7
13,16,246,5,8,-3
13,16,247,13,15,-2
13,16,248,9,10,-1
13,16,249,21,15,6
13,16,250,13,16,-3
13,16,251,7,10,-3
13,16,252,19,12,7
13,16,253,23,25,-2
13,16,254,9,8,1
13,16,255,9,15,-6
13,16,256,15,12,3
13,16,257,12,18,-6
13,16,258,11,10,1
13,16,259,6,19,-13
13,16,260,10,24,-14
13,16,261,14,15,-1
13,16,262,22,16,6
13,16,263,26,12,14
13,16,264,6,7,-1
13,16,265,14,16,-2
13,16,266,9,19,-10
13,16,267,18,20,-2
13,16,268,14,19,-5
13,16,269,10,5,5
13,16,270,8,9,-1
13,16,271,17,11,6
13,16,272,12,25,-13
13,16,273,20,21,-1
13,16,274,8,8,0
13,16,275,16,14,2
13,16,276,19,23,-4
13,16,277,16,24,-8
13,16,278,19,10,9
13,16,279,21,8,13
13,16,280,15,14,1
13,16,281,13,23,-10
13,16,282,11,10,1
13,16,283,16,19,-3
13,16,284,5,7,-2
13,16,285,9,13,-4
13,16,286,14,22,-8
13,16,287,20,17,3
13,16,288,14,13,1
13,16,289,15,15,0
13,16,290,16,8,8
13,16,291,10,16,-6
13,16,292,11,22,-11
13,16,293,11,7,4
13,16,294,11,8,3
13,16,295,21,16,5
13,16,296,17,14,3
13,16,297,18,20,-2
13,16,298,19,14,5
13,16,299,14,24,-10
13,17,0,15,14,1
13,17,1,27,14,13
13,17,2,24,13,11
13,17,3,33,28,5
13,17,4,11,11,0
13,17,5,23,19,4
13,17,6,13,22,-9
13,17,7,14,10,4
13,17,8,20,26,-6
13,17,9,21,14,7
13,17,10,13,22,-9
13,17,11,20,20,0
13,17,12,17,7,10
13,17,13,13,17,-4
13,17,14,21,21,0
13,17,15,19,16,3
13,17,16,26,24,2
13,17,17,3,6,-3
13,17,18,14,13,1
13,17,19,21,8,13
13,17,20,5,14,-9
13,17,21,6,8,-2
13,17,22,16,28,-12
13,17,23,13,23,-10
13,17,24,27,23,4
13,17,25,27,15,12
13,17,26,17,14,3
13,17,27,15,13,2
13,17,28,17,13,4
13,17,29,20,12,8
13,17,30,19,16,3
13,17,31,12,10,2
13,17,32,4,5,-1
13,17,33,19,12,7
13,17,34,23,16,7
13,17,35,14,9,5
13,17,36,11,11,0
13,17,37,6,21,-15
13,17,38,12,9,3
13,17,39,27,20,7
13,17,40,20,13,7
13,17,41,19,15,4
13,17,42,14,15,-1
13,17,43,23,9,14
13,17,44,35,21,14
13,17,45,30,10,20
13,17,46,24,21,3
13,17,47,5,10,-5
13,17,48,13,11,2
13,17,49,12,14,-2
13,17,50,12,21,-9
13,17,51,12,18,-6
13,17,52,10,7,3
13,17,53,23,12,11
13,17,54,34,24,10
13,17,55,28,21,7
13,17,56,14,19,-5
13,17,57,15,12,3
13,17,58,20,26,-6
13,17,59,27,26,1
13,17,60,11,10,1
13,17,61,7,13,-6
13,17,62,15,14,1
13,17,63,22,17,5
13,17,64,7,6,1
13,17,65,13,16,-3
13,17,66,17,15,2
13,17,67,19,16,3
13,17,68,11,11,0
13,17,69,25,20,5
13,17,70,7,8,-1
13,17,71,28,28,0
13,17,72,18,22,-4
13,17,73,18,9,9
13,17,74,19,10,9
13,17,75,24,18,6
13,17,76,15,12,3
13,17,77,6,21,-15
13,17,78,21,21,0
13,17,79,9,10,-1
13,17,80,29,14,15
13,17,81,30,22,8
13,17,82,11,24,-13
13,17,83,21,14,7
13,17,84,16,21,-5
13,17,85,32,20,12
13,17,86,18,13,5
13,17,87,8,6,2
13,17,88,23,22,1
13,17,89,28,11,17
13,17,90,19,15,4
13,17,91,17,8,9
13,17,92,21,17,4
13,17,93,14,9,5
13,17,94,10,13,-3
13,17,95,11,10,1
13,17,96,13,23,-10
13,17,97,21,15,6
13,17,98,19,13,6
13,17,99,12,19,-7
13,17,100,11,15,-4
13,17,101,8,21,-13
13,17,102,8,12,-4
13,17,103,2,9,-7
13,17,104,16,11,5
13,17,105,12,26,-14
13,17,106,20,25,-5
13,17,107,16,8,8
13,17,108,15,14,1
13,17,109,16,26,-10
13,17,110,22,12,10
13,17,111,15,15,0
13,17,112,14,14,0
13,17,113,12,9,3
13,17,114,13,13,0
13,17,115,17,18,-1
13,17,116,16,12,4
13,17,117,19,31,-12
13,17,118,12,24,-12
13,17,119,17,15,2
13,17,120,25,10,15
13,17,121,7,12,-5
13,17,122,12,10,2
13,17,123,10,13,-3
13,17,124,12,3,9
13,17,125,19,15,4
13,17,126,7,14,-7
13,17,127,16,6,10
13,17,128,14,15,-1
13,17,129,5,6,-1
13,17,130,18,19,-1
13,17,131,19,19,0
13,17,132,25,15,10
13,17,133,15,9,6
13,17,134,17,18,-1
13,17,135,15,15,0
13,17,136,16,10,6
13,17,137,23,27,-4
13,17,138,9,9,0
13,17,139,9,17,-8
13,17,140,23,17,6
13,17,141,12,8,4
13,17,142,11,24,-13
13,17,143,12,14,-2
13,17,144,25,25,0
13,17,145,12,9,3
13,17,146,17,19,-2
13,17,147,15,13,2
13,17,148,13,11,2
13,17,149,19,9,10
13,17,150,10,16,-6
13,17,151,9,9,0
13,17,152,21,16,5
13,17,153,6,11,-5
13,17,154,5,6,-1
13,17,155,14,12,2
13,17,156,11,17,-6
13,17,157,19,29,-10
13,17,158,27,15,12
13,17,159,13,16,-3
13,17,160,9,19,-10
13,17,161,18,10,8
13,17,162,15,17,-2
13,17,163,16,22,-6
13,17,164,8,8,0
13,17,165,25,19,6
13,17,166,16,29,-13
13,17,167,5,14,-9
13,17,168,18,21,-3
13,17,169,21,28,-7
13,17,170,6,7,-1
13,17,171,10,7,3
13,17,172,23,21,2
13,17,173,13,20,-7
13,17,174,19,11,8
13,17,175,17,13,4
13,17,176,12,10,2
13,17,177,10,14,-4
13,17,178,13,10,3
13,17,179,21,10,11
13,17,180,9,21,-12
13,17,181,23,18,5
13,17,182,22,23,-1
13,17,183,16,14,2
13,17,184,15,9,6
13,17,185,23,16,7
13,17,186,12,14,-2
13,17,187,22,21,1
13,17,188,11,19,-8
13,17,189,6,28,-22
13,17,190,10,2,8
13,17,191,23,26,-3
13,17,192,19,24,-5
13,17,193,31,16,15
13,17,194,12,9,3
13,17,195,19,14,5
13,17,196,21,23,-2
13,17,197,13,19,-6
13,17,198,28,14,14
13,17,199,11,11,0
13,17,200,11,10,1
13,17,201,12,10,2
13,17,202,16,8,8
13,17,203,23,7,16
13,17,204,14,16,-2
13,17,205,20,20,0
13,17,206,15,13,2
13,17,207,24,15,9
13,17,208,20,10,10
13,17,209,12,14,-2
13,17,210,5,12,-7
13,17,211,3,8,-5
13,17,212,18,16,2
13,17,213,10,14,-4
13,17,214,23,9,14
13,17,215,20,21,-1
13,17,216,16,15,1
13,17,217,11,13,-2
13,17,218,20,26,-6
13,17,219,13,23,-10
13,17,220,24,17,7
13,17,221,10,20,-10
13,17,222,12,17,-5
13,17,223,11,11,0
13,17,224,14,14,0
13,17,225,16,8,8
13,17,226,13,8,5
13,17,227,5,8,-3
13,17,228,12,25,-13
13,17,229,10,17,-7
13,17,230,17,17,0
13,17,231,19,20,-1
13,17,232,13,18,-5
13,17,233,11,14,-3
13,17,234,22,24,-2
13,17,235,12,13,-1
13,17,236,20,8,12
13,17,237,15,18,-3
13,17,238,30,20,10
13,17,239,13,6,7
13,17,240,6,4,2
13,17,241,20,9,11
13,17,242,4,8,-4
13,17,243,17,13,4
13,17,244,14,14,0
13,17,245,18,14,4
13,17,246,19,19,0
13,17,247,5,13,-8
13,17,248,12,8,4
13,17,249,25,25,0
13,17,250,21,33,-12
13,17,251,22,20,2
13,17,252,14,17,-3
13,17,253,19,7,12
13,17,254,13,13,0
13,17,255,9,6,3
13,17,256,26,8,18
13,17,257,20,19,1
13,17,258,17,12,5
13,17,259,21,17,4
13,17,260,13,15,-2
13,17,261,14,10,4
13,17,262,16,8,8
13,17,263,15,16,-1
13,17,264,20,14,6
13,17,265,11,13,-2
13,17,266,19,10,9
13,17,267,26,12,14
13,17,268,11,15,-4
13,17,269,23,35,-12
13,17,270,26,18,8
13,17,271,7,2,5
13,17,272,19,15,4
13,17,273,16,13,3
13,17,274,15,14,1
13,17,275,11,20,-9
13,17,276,30,18,12
13,17,277,14,23,-9
13,17,278,21,19,2
13,17,279,9,8,1
13,17,280,18,11,7
13,17,281,16,10,6
13,17,282,9,11,-2
13,17,283,11,18,-7
13,17,284,12,15,-3
13,17,285,16,21,-5
13,17,286,9,10,-1
13,17,287,13,17,-4
13,17,288,38,23,15
13,17,289,29,18,11
13,17,290,13,15,-2
13,17,291,14,10,4
13,17,292,11,10,1
13,17,293,22,24,-2
13,17,294,12,18,-6
13,17,295,25,17,8
13,17,296,21,14,7
13,17,297,18,12,6
13,17,298,28,23,5
13,17,299,13,11,2
13,18,0,11,22,-11
13,18,1,22,21,1
13,18,2,9,9,0
13,18,3,24,14,10
13,18,4,14,16,-2
13,18,5,19,15,4
13,18,6,25,11,14
13,18,7,19,13,6
13,18,8,24,35,-11
13,18,9,16,14,2
13,18,10,16,7,9
13,18,11,18,20,-2
13,18,12,11,21,-10
13,18,13,27,10,17
13,18,14,11,12,-1
13,18,15,13,10,3
13,18,16,12,7,5
13,18,17,8,20,-12
13,18,18,20,17,3
13,18,19,14,8,6
13,18,20,18,22,-4
13,18,21,7,10,-3
13,18,22,24,23,1
13,18,23,17,8,9
13,18,24,15,26,-11
13,18,25,21,21,0
13,18,26,21,17,4
13,18,27,13,13,0
13,18,28,7,8,-1
13,18,29,15,15,0
13,18,30,21,17,4
13,18,31,19,17,2
13,18,32,23,22,1
13,18,33,25,13,12
13,18,34,14,15,-1
13,18,35,26,18,8
13,18,36,14,5,9
13,18,37,19,24,-5
13,18,38,23,13,10
13,18,39,21,21,0
13,18,40,12,21,-9
13,18,41,9,17,-8
13,18,42,7,9,-2
13,18,43,18,5,13
13,18,44,18,12,6
13,18,45,17,8,9
13,18,46,11,3,8
13,18,47,32,15,17
13,18,48,9,20,-11
13,18,49,13,14,-1
13,18,50,20,13,7
13,18,51,16,10,6
13,18,52,16,26,-10
13,18,53,23,16,7
13,18,54,13,4,9
13,18,55,7,12,-5
13,18,56,5,2,3
13,18,57,5,18,-13
13,18,58,20,18,2
13,18,59,15,15,0
13,18,60,20,16,4
13,18,61,10,12,-2
13,18,62,13,21,-8
13,18,63,17,13,4
13,18,64,16,15,1
13,18,65,17,11,6
13,18,66,22,22,0
13,18,67,6,25,-19
13,18,68,33,15,18
13,18,69,20,17,3
13,18,70,4,9,-5
13,18,71,16,9,7
13,18,72,11,12,-1
13,18,73,20,11,9
13,18,74,11,16,-5
13,18,75,22,14,8
13,18,76,15,14,1
13,18,77,23,23,0
13,18,78,11,14,-3
13,18,79,10,23,-13
13,18,80,10,22,-12
13,18,81,13,10,3
13,18,82,13,16,-3
13,18,83,23,13,10
13,18,84,9,9,0
13,18,85,9,2,7
13,18,86,7,7,0
13,18,87,15,10,5
13,18,88,24,13,11
13,18,89,11,8,3
13,18,90,19,7,12
13,18,91,14,16,-2
13,18,92,9,9,0
13,18,93,30,19,11
13,18,94,10,11,-1
13,18,95,14,13,1
13,18,96,22,15,7
13,18,97,13,21,-8
13,18,98,18,21,-3
13,18,99,22,28,-6
13,18,100,11,10,1
13,18,101,19,8,11
13,18,102,25,22,3
13,18,103,12,9,3
13,18,104,22,12,10
13,18,105,16,27,-11
13,18,106,11,5,6
13,18,107,5,16,-11
13,18,108,14,13,1
13,18,109,5,10,-5
13,18,110,29,14,15
13,18,111,33,32,1
13,18,112,17,14,3
13,18,113,15,25,-10
13,18,114,14,14,0
13,18,115,23,13,10
13,18,116,14,13,1
13,18,117,13,15,-2
13,18,118,22,14,8
13,18,119,15,14,1
13,18,120,21,6,15
13,18,121,23,11,12
13,18,122,16,7,9
13,18,123,23,12,11
13,18,124,12,9,3
13,18,125,14,8,6
13,18,126,15,5,10
13,18,127,24,20,4
13,18,128,21,5,16
13,18,129,12,12,0
13,18,130,15,21,-6
13,18,131,18,8,10
13,18,132,24,12,12
13,18,133,23,10,13
13,18,134,28,30,-2
13,18,135,8,10,-2
13,18,136,22,9,13
13,18,137,14,15,-1
13,18,138,14,11,3
13,18,139,6,13,-7
13,18,140,8,9,-1
13,18,141,9,22,-13
13,18,142,15,13,2
13,18,143,14,11,3
13,18,144,15,12,3
13,18,145,35,17,18
13,18,146,15,20,-5
13,18,147,27,17,10
13,18,148,22,15,7
13,18,149,8,12,-4
13,18,150,28,17,11
13,18,151,12,11,1
13,18,152,8,15,-7
13,18,153,22,4,18
13,18,154,24,14,10
13,18,155,7,13,-6
13,18,156,14,14,0
13,18,157,11,13,-2
13,18,158,5,6,-1
13,18,159,12,12,0
13,18,160,20,19,1
13,18,161,14,17,-3
13,18,162,5,22,-17
13,18,163,3,24,-21
13,18,164,15,7,8
13,18,165,22,9,13
13,18,166,13,14,-1
13,18,167,19,17,2
13,18,168,16,19,-3
13,18,169,11,7,4
13,18,170,14,10,4
13,18,171,26,15,11
13,18,172,7,8,-1
13,18,173,30,19,11
13,18,174,39,25,14
13,18,175,14,6,8
13,18,176,20,6,14
13,18,177,12,9,3
13,18,178,15,7,8
13,18,179,17,17,0
13,18,180,14,21,-7
13,18,181,11,4,7
13,18,182,32,19,13
13,18,183,15,28,-13
13,18,184,19,24,-5
13,18,185,11,19,-8
13,18,186,17,8,9
13,18,187,22,16,6
13,18,188,30,17,13
13,18,189,22,18,4
13,18,190,12,19,-7
13,18,191,3,1,2
13,18,192,22,15,7
13,18,193,19,21,-2
13,18,194,14,5,9
13,18,195,6,14,-8
13,18,196,18,10,8
13,18,197,31,21,10
13,18,198,14,22,-8
13,18,199,11,9,2
13,18,200,11,11,0
13,18,201,19,18,1
13,18,202,16,21,-5
13,18,203,19,23,-4
13,18,204,20,13,7
13,18,205,18,13,5
13,18,206,25,16,9
13,18,207,11,7,4
13,18,208,13,8,5
13,18,209,26,9,17
13,18,210,21,21,0
13,18,211,17,11,6
13,18,212,19,22,-3
13,18,213,13,16,-3
13,18,214,15,13,2
13,18,215,22,15,7
13,18,216,21,22,-1
13,18,217,16,21,-5
13,18,218,9,22,-13
13,18,219,5,10,-5
13,18,220,22,22,0
13,18,221,9,17,-8
13,18,222,26,20,6
13,18,223,12,34,-22
13,18,224,15,10,5
13,18,225,5,9,-4
13,18,226,24,8,16
13,18,227,18,27,-9
13,18,228,15,16,-1
13,18,229,24,18,6
13,18,230,7,9,-2
13,18,231,15,6,9
13,18,232,27,21,6
13,18,233,19,18,1
13,18,234,31,13,18
13,18,235,17,13,4
13,18,236,15,6,9
13,18,237,8,24,-16
13,18,238,20,21,-1
13,18,239,15,7,8
13,18,240,16,19,-3
13,18,241,27,19,8
13,18,242,19,12,7
13,18,243,18,10,8
13,18,244,19,14,5
13,18,245,13,13,0
13,18,246,8,5,3
13,18,247,20,15,5
13,18,248,14,12,2
13,18,249,19,21,-2
13,18,250,19,14,5
13,18,251,3,9,-6
13,18,252,15,17,-2
13,18,253,21,19,2
13,18,254,27,12,15
13,18,255,9,10,-1
13,18,256,10,5,5
13,18,257,15,9,6
13,18,258,12,7,5
13,18,259,17,23,-6
13,18,260,24,21,3
13,18,261,14,19,-5
13,18,262,13,10,3
13,18,263,22,16,6
13,18,264,22,18,4
13,18,265,25,19,6
13,18,266,24,16,8
13,18,267,14,21,-7
13,18,268,18,15,3
13,18,269,12,8,4
13,18,270,9,3,6
13,18,271,13,14,-1
13,18,272,26,15,11
13,18,273,16,4,12
13,18,274,23,25,-2
13,18,275,27,19,8
13,18,276,20,12,8
13,18,277,14,11,3
13,18,278,19,14,5
13,18,279,16,11,5
13,18,280,23,14,9
13,18,281,16,12,4
13,18,282,10,8,2
13,18,283,15,13,2
13,18,284,18,12,6
13,18,285,26,20,6
13,18,286,9,11,-2
13,18,287,22,16,6
13,18,288,27,15,12
13,18,289,14,9,5
13,18,290,21,28,-7
13,18,291,7,12,-5
13,18,292,12,17,-5
13,18,293,14,7,7
13,18,294,15,15,0
13,18,295,18,16,2
13,18,296,15,19,-4
13,18,297,14,7,7
13,18,298,10,20,-10
13,18,299,20,9,11
13,19,0,24,26,-2
13,19,1,22,15,7
13,19,2,10,13,-3
13,19,3,16,18,-2
13,19,4,27,18,9
13,19,5,15,14,1
13,19,6,14,13,1
13,19,7,8,10,-2
13,19,8,25,18,7
13,19,9,15,14,1
13,19,10,9,14,-5
13,19,11,19,10,9
13,19,12,16,9,7
13,19,13,6,9,-3
13,19,14,18,0,18
13,19,15,18,7,11
13,19,16,25,24,1
13,19,17,20,34,-14
13,19,18,22,19,3
13,19,19,35,18,17
13,19,20,16,9,7
13,19,21,9,9,0
13,19,22,21,17,4
13,19,23,24,24,0
13,19,24,18,15,3
13,19,25,17,9,8
13,19,26,19,11,8
13,19,27,19,12,7
13,19,28,19,20,-1
13,19,29,22,21,1
13,19,30,25,7,18
13,19,31,19,12,7
13,19,32,19,15,4
13,19,33,8,14,-6
13,19,34,12,13,-1
13,19,35,15,29,-14
13,19,36,10,10,0
13,19,37,6,7,-1
13,19,38,15,11,4
13,19,39,12,2,10
13,19,40,20,16,4
13,19,41,14,15,-1
13,19,42,19,26,-7
13,19,43,12,16,-4
13,19,44,11,7,4
13,19,45,13,6,7
13,19,46,17,18,-1
13,19,47,12,16,-4
13,19,48,11,14,-3
13,19,49,20,13,7
13,19,50,9,13,-4
13,19,51,12,7,5
13,19,52,8,11,-3
13,19,53,30,30,0
13,19,54,14,14,0
13,19,55,14,17,-3
13,19,56,19,20,-1
13,19,57,10,20,-10
13,19,58,3,13,-10
13,19,59,23,14,9
13,19,60,11,6,5
13,19,61,23,9,14
13,19,62,12,9,3
13,19,63,6,10,-4
13,19,64,23,16,7
13,19,65,28,18,10
13,19,66,16,15,1
13,19,67,16,22,-6
13,19,68,13,12,1
13,19,69,18,18,0
13,19,70,11,19,-8
13,19,71,25,31,-6
13,19,72,15,6,9
13,19,73,13,6,7
13,19,74,12,18,-6
13,19,75,21,16,5
13,19,76,19,19,0
13,19,77,20,12,8
13,19,78,12,14,-2
13,19,79,11,19,-8
13,19,80,17,16,1
13,19,81,15,19,-4
13,19,82,13,9,4
13,19,83,13,12,1
13,19,84,20,26,-6
13,19,85,11,9,2
13,19,86,21,13,8
13,19,87,18,9,9
13,19,88,34,13,21
13,19,89,18,9,9
13,19,90,17,13,4
13,19,91,16,6,10
13,19,92,11,17,-6
13,19,93,7,14,-7
13,19,94,10,7,3
13,19,95,25,19,6
13,19,96,27,16,11
13,19,97,12,10,2
13,19,98,15,12,3
13,19,99,7,5,2
13,19,100,13,10,3
13,19,101,15,23,-8
13,19,102,18,18,0
13,19,103,10,13,-3
13,19,104,8,20,-12
13,19,105,8,10,-2
13,19,106,7,21,-14
13,19,107,8,9,-1
13,19,108,23,29,-6
13,19,109,21,11,10
13,19,110,16,18,-2
13,19,111,18,16,2
13,19,112,20,17,3
13,19,113,15,16,-1
13,19,114,20,13,7
13,19,115,17,17,0
13,19,116,8,12,-4
13,19,117,31,26,5
13,19,118,12,15,-3
13,19,119,15,15,0
13,19,120,15,15,0
13,19,121,10,13,-3
13,19,122,18,29,-11
13,19,123,26,14,12
13,19,124,9,7,2
13,19,125,14,14,0
13,19,126,15,19,-4
13,19,127,11,15,-4
13,19,128,15,19,-4
13,19,129,12,11,1
13,19,130,16,16,0
13,19,131,10,26,-16
13,19,132,15,21,-6
13,19,133,17,14,3
13,19,134,23,21,2
13,19,135,6,9,-3
13,19,136,25,19,6
13,19,137,25,17,8
13,19,138,22,15,7
13,19,139,12,25,-13
13,19,140,21,24,-3
13,19,141,15,18,-3
13,19,142,16,14,2
13,19,143,24,14,10
13,19,144,12,21,-9
13,19,145,6,10,-4
13,19,146,15,24,-9
13,19,147,14,11,3
13,19,148,5,13,-8
13,19,149,22,8,14
13,19,150,13,9,4
13,19,151,11,7,4
13,19,152,18,12,6
13,19,153,22,13,9
13,19,154,22,16,6
13,19,155,16,12,4
13,19,156,17,13,4
13,19,157,11,12,-1
13,19,158,19,12,7
13,19,159,22,12,10
13,19,160,18,25,-7
13,19,161,31,29,2
13,19,162,15,17,-2
13,19,163,18,26,-8
13,19,164,23,22,1
13,19,165,21,22,-1
13,19,166,12,13,-1
13,19,167,11,15,-4
13,19,168,12,12,0
13,19,169,16,13,3
13,19,170,18,21,-3
13,19,171,15,10,5
13,19,172,24,15,9
13,19,173,23,15,8
13,19,174,12,4,8
13,19,175,10,10,0
13,19,176,21,15,6
13,19,177,8,10,-2
13,19,178,13,24,-11
13,19,179,18,16,2
13,19,180,19,16,3
13,19,181,19,19,0
13,19,182,23,23,0
13,19,183,25,22,3
13,19,184,19,23,-4
13,19,185,5,19,-14
13,19,186,15,13,2
13,19,187,31,20,11
13,19,188,24,18,6
13,19,189,21,31,-10
13,19,190,17,11,6
13,19,191,18,14,4
13,19,192,30,14,16
13,19,193,8,17,-9
13,19,194,14,15,-1
13,19,195,12,7,5
13,19,196,10,9,1
13,19,197,20,17,3
13,19,198,10,19,-9
13,19,199,10,20,-10
13,19,200,8,8,0
13,19,201,10,16,-6
13,19,202,12,15,-3
13,19,203,15,12,3
13,19,204,7,9,-2
13,19,205,20,12,8
13,19,206,25,19,6
13,19,207,14,7,7
13,19,208,18,13,5
13,19,209,13,10,3
13,19,210,14,16,-2
13,19,211,26,16,10
13,19,212,12,13,-1
13,19,213,15,22,-7
13,19,214,17,20,-3
13,19,215,20,15,5
13,19,216,11,12,-1
13,19,217,6,15,-9
13,19,218,23,17,6
13,19,219,12,11,1
13,19,220,17,12,5
13,19,221,14,4,10
13,19,222,11,12,-1
13,19,223,11,22,-11
13,19,224,11,7,4
13,19,225,12,18,-6
13,19,226,12,10,2
13,19,227,5,18,-13
13,19,228,12,8,4
13,19,229,10,10,0
13,19,230,20,25,-5
13,19,231,13,10,3
13,19,232,25,32,-7
13,19,233,9,8,1
13,19,234,12,9,3
13,19,235,11,10,1
13,19,236,22,27,-5
13,19,237,11,11,0
13,19,238,11,11,0
13,19,239,13,15,-2
13,19,240,12,14,-2
13,19,241,20,9,11
13,19,242,19,11,8
13,19,243,12,13,-1
13,19,244,6,9,-3
13,19,245,9,9,0
13,19,246,16,13,3
13,19,247,17,13,4
13,19,248,11,18,-7
13,19,249,18,12,6
13,19,250,10,12,-2
13,19,251,14,3,11
13,19,252,16,11,5
13,19,253,11,17,-6
13,19,254,14,5,9
13,19,255,23,20,3
13,19,256,14,10,4
13,19,257,24,26,-2
13,19,258,18,20,-2
13,19,259,23,10,13
13,19,260,12,9,3
13,19,261,14,26,-12
13,19,262,21,19,2
13,19,263,13,11,2
13,19,264,15,21,-6
13,19,265,29,15,14
13,19,266,9,15,-6
13,19,267,11,18,-7
13,19,268,18,20,-2
13,19,269,23,20,3
13,19,270,6,11,-5
13,19,271,17,12,5
13,19,272,18,16,2
13,19,273,11,16,-5
13,19,274,11,12,-1
13,19,275,39,15,24
13,19,276,9,21,-12
13,19,277,10,21,-11
13,19,278,14,10,4
13,19,279,8,6,2
13,19,280,17,15,2
13,19,281,8,14,-6
13,19,282,13,14,-1
13,19,283,16,11,5
13,19,284,17,17,0
13,19,285,20,8,12
13,19,286,19,20,-1
13,19,287,22,23,-1
13,19,288,8,9,-1
13,19,289,4,11,-7
13,19,290,8,12,-4
13,19,291,5,8,-3
13,19,292,20,8,12
13,19,293,14,8,6
13,19,294,7,26,-19
13,19,295,6,8,-2
13,19,296,8,8,0
13,19,297,8,7,1
13,19,298,12,9,3
13,19,299,33,38,-5
13,20,0,16,20,-4
13,20,1,17,14,3
13,20,2,10,20,-10
13,20,3,18,10,8
13,20,4,25,12,13
13,20,5,9,14,-5
13,20,6,12,15,-3
13,20,7,20,11,9
13,20,8,22,17,5
13,20,9,9,14,-5
13,20,10,12,22,-10
13,20,11,19,15,4
13,20,12,17,21,-4
13,20,13,24,13,11
13,20,14,14,29,-15
13,20,15,9,18,-9
13,20,16,8,10,-2
13,20,17,18,18,0
13,20,18,13,21,-8
13,20,19,21,9,12
13,20,20,17,18,-1
13,20,21,20,4,16
13,20,22,15,9,6
13,20,23,17,20,-3
13,20,24,20,19,1
13,20,25,12,22,-10
13,20,26,18,20,-2
13,20,27,18,13,5
13,20,28,20,27,-7
13,20,29,12,10,2
13,20,30,14,16,-2
13,20,31,23,15,8
13,20,32,20,19,1
13,20,33,21,11,10
13,20,34,13,15,-2
13,20,35,12,12,0
13,20,36,12,10,2
13,20,37,17,18,-1
13,20,38,26,17,9
13,20,39,17,11,6
13,20,40,11,22,-11
13,20,41,18,42,-24
13,20,42,19,12,7
13,20,43,21,14,7
13,20,44,17,8,9
13,20,45,5,17,-12
13,20,46,20,22,-2
13,20,47,14,30,-16
13,20,48,11,5,6
13,20,49,21,11,10
13,20,50,10,10,0
13,20,51,16,24,-8
13,20,52,13,19,-6
13,20,53,12,11,1
13,20,54,22,12,10
13,20,55,22,21,1
13,20,56,14,25,-11
13,20,57,24,30,-6
13,20,58,14,22,-8
13,20,59,18,17,1
13,20,60,18,25,-7
13,20,61,15,11,4
13,20,62,12,12,0
13,20,63,8,12,-4
13,20,64,17,20,-3
13,20,65,12,14,-2
13,20,66,23,19,4
13,20,67,23,33,-10
13,20,68,14,14,0
13,20,69,19,13,6
13,20,70,20,13,7
13,20,71,22,26,-4
13,20,72,14,12,2
13,20,73,9,5,4
13,20,74,11,2,9
13,20,75,25,15,10
13,20,76,18,21,-3
13,20,77,21,13,8
13,20,78,11,9,2
13,20,79,25,18,7
13,20,80,19,21,-2
13,20,81,15,15,0
13,20,82,27,17,10
13,20,83,15,23,-8
13,20,84,15,24,-9
13,20,85,14,5,9
13,20,86,27,6,21
13,20,87,13,17,-4
13,20,88,31,15,16
13,20,89,21,18,3
13,20,90,13,19,-6
13,20,91,20,21,-1
13,20,92,25,13,12
13,20,93,6,6,0
13,20,94,12,20,-8
13,20,95,20,30,-10
13,20,96,33,13,20
13,20,97,26,17,9
13,20,98,12,20,-8
13,20,99,17,26,-9
13,20,100,17,23,-6
13,20,101,8,14,-6
13,20,102,21,13,8
13,20,103,14,17,-3
13,20,104,9,8,1
13,20,105,12,15,-3
13,20,106,26,13,13
13,20,107,17,11,6
13,20,108,13,19,-6
13,20,109,11,16,-5
13,20,110,15,4,11
13,20,111,20,22,-2
13,20,112,14,18,-4
13,20,113,18,11,7
13,20,114,17,22,-5
13,20,115,17,29,-12
13,20,116,15,16,-1
13,20,117,22,17,5
13,20,118,15,10,5
13,20,119,19,11,8
13,20,120,13,14,-1
13,20,121,25,16,9
13,20,122,17,0,17
13,20,123,23,19,4
13,20,124,9,23,-14
13,20,125,16,24,-8
13,20,126,20,11,9
13,20,127,26,13,13
13,20,128,16,12,4
13,20,129,17,22,-5
13,20,130,19,15,4
13,20,131,18,23,-5
13,20,132,8,10,-2
13,20,133,12,18,-6
13,20,134,10,15,-5
13,20,135,11,7,4
13,20,136,16,22,-6
13,20,137,10,10,0
13,20,138,12,22,-10
13,20,139,24,12,12
13,20,140,19,22,-3
13,20,141,16,7,9
13,20,142,24,15,9
13,20,143,15,20,-5
13,20,144,22,17,5
13,20,145,6,10,-4
13,20,146,11,18,-7
13,20,147,22,10,12
13,20,148,14,19,-5
13,20,149,25,8,17
13,20,150,7,6,1
13,20,151,4,4,0
13,20,152,22,26,-4
13,20,153,14,16,-2
13,20,154,17,12,5
13,20,155,11,11,0
13,20,156,13,21,-8
13,20,157,18,13,5
13,20,158,11,8,3
13,20,159,27,19,8
13,20,160,13,9,4
13,20,161,13,14,-1
13,20,162,10,8,2
13,20,163,27,15,12
13,20,164,18,16,2
13,20,165,9,13,-4
13,20,166,16,7,9
13,20,167,23,7,16
13,20,168,29,23,6
13,20,169,14,15,-1
13,20,170,28,16,12
13,20,171,9,5,4
13,20,172,25,11,14
13,20,173,8,15,-7
13,20,174,22,11,11
13,20,175,18,22,-4
13,20,176,23,28,-5
13,20,177,20,20,0
13,20,178,12,18,-6
13,20,179,13,11,2
13,20,180,19,15,4
13,20,181,15,14,1
13,20,182,26,9,17
13,20,183,32,17,15
13,20,184,11,8,3
13,20,185,19,16,3
13,20,186,23,18,5
13,20,187,19,12,7
13,20,188,19,17,2
13,20,189,33,25,8
13,20,190,13,11,2
13,20,191,8,16,-8
13,20,192,27,19,8
13,20,193,10,8,2
13,20,194,25,15,10
13,20,195,17,12,5
13,20,196,27,28,-1
13,20,197,17,13,4
13,20,198,8,9,-1
13,20,199,12,7,5
13,20,200,12,19,-7
13,20,201,8,23,-15
13,20,202,17,12,5
13,20,203,23,16,7
13,20,204,18,9,9
13,20,205,14,10,4
13,20,206,12,12,0
13,20,207,13,8,5
13,20,208,14,12,2
13,20,209,21,13,8
13,20,210,16,14,2
13,20,211,27,28,-1
13,20,212,13,20,-7
13,20,213,22,16,6
13,20,214,23,20,3
13,20,215,21,12,9
13,20,216,7,20,-13
13,20,217,17,24,-7
13,20,218,12,27,-15
13,20,219,21,14,7
13,20,220,13,22,-9
13,20,221,20,10,10
13,20,222,26,20,6
13,20,223,7,10,-3
13,20,224,6,20,-14
13,20,225,16,22,-6
13,20,226,16,7,9
13,20,227,12,16,-4
13,20,228,7,6,1
13,20,229,8,5,3
13,20,230,17,17,0
13,20,231,18,10,8
13,20,232,4,10,-6
13,20,233,13,16,-3
13,20,234,16,6,10
13,20,235,19,17,2
13,20,236,11,16,-5
13,20,237,26,15,11
13,20,238,9,7,2
13,20,239,31,13,18
13,20,240,11,8,3
13,20,241,20,15,5
13,20,242,14,7,7
13,20,243,19,15,4
13,20,244,9,10,-1
13,20,245,13,17,-4
13,20,246,15,16,-1
13,20,247,12,10,2
13,20,248,18,23,-5
13,20,249,17,13,4
13,20,250,25,13,12
13,20,251,19,10,9
13,20,252,19,15,4
13,20,253,18,29,-11
13,20,254,16,19,-3
13,20,255,22,20,2
13,20,256,17,16,1
13,20,257,21,14,7
13,20,258,16,11,5
13,20,259,18,17,1
13,20,260,10,5,5
13,20,261,17,18,-1
13,20,262,31,11,20
13,20,263,16,19,-3
13,20,264,31,17,14
13,20,265,18,7,11
13,20,266,2,11,-9
13,20,267,22,7,15
13,20,268,21,11,10
13,20,269,17,10,7
13,20,270,12,11,1
13,20,271,12,10,2
13,20,272,13,14,-1
13,20,273,15,21,-6
13,20,274,15,11,4
13,20,275,14,17,-3
13,20,276,10,16,-6
13,20,277,31,19,12
13,20,278,14,27,-13
13,20,279,15,13,2
13,20,280,18,20,-2
13,20,281,22,16,6
13,20,282,13,15,-2
13,20,283,9,15,-6
13,20,284,16,13,3
13,20,285,19,16,3
13,20,286,21,21,0
13,20,287,16,30,-14
13,20,288,17,23,-6
13,20,289,23,21,2
13,20,290,18,24,-6
13,20,291,6,12,-6
13,20,292,23,31,-8
13,20,293,16,14,2
13,20,294,17,26,-9
13,20,295,17,17,0
13,20,296,30,10,20
13,20,297,14,10,4
13,20,298,9,6,3
13,20,299,11,16,-5
13,21,0,12,24,-12
13,21,1,16,16,0
13,21,2,19,11,8
13,21,3,22,8,14
13,21,4,17,14,3
13,21,5,19,16,3
13,21,6,18,17,1
13,21,7,19,11,8
13,21,8,21,30,-9
13,21,9,16,11,5
13,21,10,16,10,6
13,21,11,24,21,3
13,21,12,20,23,-3
13,21,13,31,9,22
13,21,14,14,15,-1
13,21,15,19,11,8
13,21,16,13,18,-5
13,21,17,12,2,10
13,21,18,16,18,-2
13,21,19,11,10,1
13,21,20,20,7,13
13,21,21,23,13,10
13,21,22,20,16,4
13,21,23,21,19,2
13,21,24,4,15,-11
13,21,25,15,9,6
13,21,26,12,17,-5
13,21,27,21,11,10
13,21,28,9,8,1
13,21,29,16,10,6
13,21,30,11,16,-5
13,21,31,19,7,12
13,21,32,21,9,12
13,21,33,29,23,6
13,21,34,21,24,-3
13,21,35,26,18,8
13,21,36,15,7,8
13,21,37,8,9,-1
13,21,38,23,9,14
13,21,39,5,17,-12
13,21,40,14,16,-2
13,21,41,10,16,-6
13,21,42,22,23,-1
13,21,43,41,10,31
13,21,44,12,10,2
13,21,45,25,24,1
13,21,46,32,13,19
13,21,47,14,13,1
13,21,48,32,12,20
13,21,49,9,24,-15
13,21,50,12,18,-6
13,21,51,15,19,-4
13,21,52,25,10,15
13,21,53,11,14,-3
13,21,54,24,12,12
13,21,55,14,9,5
13,21,56,13,19,-6
13,21,57,19,11,8
13,21,58,16,8,8
13,21,59,14,22,-8
13,21,60,16,11,5
13,21,61,23,17,6
13,21,62,25,13,12
13,21,63,14,14,0
13,21,64,11,10,1
13,21,65,10,15,-5
13,21,66,24,10,14
13,21,67,25,14,11
13,21,68,16,16,0
13,21,69,8,10,-2
13,21,70,12,10,2
13,21,71,15,7,8
13,21,72,18,19,-1
13,21,73,24,17,7
13,21,74,21,21,0
13,21,75,17,12,5
13,21,76,11,12,-1
13,21,77,9,15,-6
13,21,78,18,8,10
13,21,79,16,16,0
13,21,80,30,19,11
13,21,81,16,14,2
13,21,82,12,9,3
13,21,83,9,10,-1
13,21,84,13,10,3
13,21,85,18,24,-6
13,21,86,13,8,5
13,21,87,19,9,10
13,21,88,13,6,7
13,21,89,12,14,-2
13,21,90,13,28,-15
13,21,91,24,12,12
13,21,92,23,15,8
13,21,93,28,17,11
13,21,94,20,20,0
13,21,95,21,16,5
13,21,96,20,22,-2
13,21,97,12,19,-7
13,21,98,15,13,2
13,21,99,19,19,0
13,21,100,12,11,1
13,21,101,13,9,4
13,21,102,14,14,0
13,21,103,16,14,2
13,21,104,12,9,3
13,21,105,15,13,2
13,21,106,21,11,10
13,21,107,6,4,2
13,21,108,29,17,12
13,21,109,16,8,8
13,21,110,20,8,12
13,21,111,12,13,-1
13,21,112,19,12,7
13,21,113,17,24,-7
13,21,114,27,14,13
13,21,115,13,10,3
13,21,116,19,18,1
13,21,117,16,15,1
13,21,118,8,12,-4
13,21,119,13,19,-6
13,21,120,15,16,-1
13,21,121,17,25,-8
13,21,122,14,15,-1
13,21,123,17,13,4
13,21,124,10,10,0
13,21,125,18,16,2
13,21,126,19,16,3
13,21,127,15,11,4
13,21,128,21,16,5
13,21,129,10,8,2
13,21,130,26,34,-8
13,21,131,27,12,15
13,21,132,11,20,-9
13,21,133,24,14,10
13,21,134,13,12,1
13,21,135,14,12,2
13,21,136,17,9,8
13,21,137,23,31,-8
13,21,138,21,15,6
13,21,139,19,12,7
13,21,140,15,8,7
13,21,141,8,16,-8
13,21,142,23,12,11
13,21,143,26,29,-3
13,21,144,12,8,4
13,21,145,23,15,8
13,21,146,12,10,2
13,21,147,16,16,0
13,21,148,12,9,3
13,21,149,18,12,6
13,21,150,21,25,-4
13,21,151,19,10,9
13,21,152,24,17,7
13,21,153,22,14,8
13,21,154,13,19,-6
13,21,155,12,15,-3
13,21,156,18,21,-3
13,21,157,14,12,2
13,21,158,19,14,5
13,21,159,12,15,-3
13,21,160,19,21,-2
13,21,161,7,15,-8
13,21,162,26,22,4
13,21,163,9,16,-7
13,21,164,19,12,7
13,21,165,11,18,-7
13,21,166,19,18,1
13,21,167,12,21,-9
13,21,168,20,18,2
13,21,169,22,19,3
13,21,170,12,9,3
13,21,171,13,18,-5
13,21,172,24,11,13
13,21,173,28,18,10
13,21,174,24,17,7
13,21,175,16,14,2
13,21,176,13,11,2
13,21,177,30,16,14
13,21,178,21,10,11
13,21,179,23,20,3
13,21,180,33,17,16
13,21,181,14,10,4
13,21,182,16,8,8
13,21,183,12,13,-1
13,21,184,9,9,0
13,21,185,11,11,0
13,21,186,26,19,7
13,21,187,11,10,1
13,21,188,19,20,-1
13,21,189,13,15,-2
13,21,190,37,14,23
13,21,191,17,10,7
13,21,192,27,13,14
13,21,193,25,13,12
13,21,194,23,11,12
13,21,195,17,21,-4
13,21,196,18,16,2
13,21,197,16,20,-4
13,21,198,9,6,3
13,21,199,20,20,0
13,21,200,16,16,0
13,21,201,9,1,8
13,21,202,14,17,-3
13,21,203,15,22,-7
13,21,204,19,14,5
13,21,205,22,6,16
13,21,206,12,8,4
13,21,207,14,11,3
13,21,208,22,11,11
13,21,209,16,16,0
13,21,210,9,16,-7
13,21,211,16,21,-5
13,21,212,17,19,-2
13,21,213,10,15,-5
13,21,214,27,26,1
13,21,215,19,5,14
13,21,216,6,20,-14
13,21,217,17,11,6
13,21,218,34,25,9
13,21,219,18,22,-4
13,21,220,12,11,1
13,21,221,7,15,-8
13,21,222,34,16,18
13,21,223,24,15,9
13,21,224,28,16,12
13,21,225,17,17,0
13,21,226,9,10,-1
13,21,227,14,9,5
13,21,228,24,23,1
13,21,229,7,7,0
13,21,230,19,14,5
13,21,231,21,12,9
13,21,232,14,20,-6
13,21,233,8,11,-3
13,21,234,9,14,-5
13,21,235,7,17,-10
13,21,236,22,15,7
13,21,237,16,12,4
13,21,238,15,13,2
13,21,239,12,15,-3
13,21,240,18,13,5
13,21,241,28,18,10
13,21,242,15,22,-7
13,21,243,17,18,-1
13,21,244,5,5,0
13,21,245,17,9,8
13,21,246,21,11,10
13,21,247,26,14,12
13,21,248,14,7,7
13,21,249,14,24,-10
13,21,250,12,14,-2
13,21,251,16,9,7
13,21,252,26,6,20
13,21,253,13,12,1
13,21,254,29,15,14
13,21,255,19,13,6
13,21,256,17,14,3
13,21,257,16,17,-1
13,21,258,22,12,10
13,21,259,17,16,1
13,21,260,15,17,-2
13,21,261,29,12,17
13,21,262,20,23,-3
13,21,263,16,13,3
13,21,264,20,22,-2
13,21,265,9,18,-9
13,21,266,13,17,-4
13,21,267,22,9,13
13,21,268,27,8,19
13,21,269,35,19,16
13,21,270,33,20,13
13,21,271,23,14,9
13,21,272,13,27,-14
13,21,273,15,17,-2
13,21,274,16,13,3
13,21,275,13,22,-9
13,21,276,19,5,14
13,21,277,19,14,5
13,21,278,14,16,-2
13,21,279,23,11,12
13,21,280,10,13,-3
13,21,281,19,19,0
13,21,282,24,25,-1
13,21,283,20,11,9
13,21,284,25,9,16
13,21,285,21,15,6
13,21,286,18,15,3
13,21,287,18,13,5
13,21,288,7,12,-5
13,21,289,19,18,1
13,21,290,21,24,-3
13,21,291,23,3,20
13,21,292,23,9,14
13,21,293,12,14,-2
13,21,294,18,12,6
13,21,295,25,15,10
13,21,296,30,14,16
13,21,297,20,19,1
13,21,298,17,21,-4
13,21,299,21,15,6
13,22,0,19,16,3
13,22,1,17,12,5
13,22,2,27,21,6
13,22,3,14,17,-3
13,22,4,7,6,1
13,22,5,19,9,10
13,22,6,6,10,-4
13,22,7,14,11,3
13,22,8,32,20,12
13,22,9,9,6,3
13,22,10,22,19,3
13,22,11,19,17,2
13,22,12,19,16,3
13,22,13,16,9,7
13,22,14,16,10,6
13,22,15,10,13,-3
13,22,16,18,23,-5
13,22,17,15,20,-5
13,22,18,23,20,3
13,22,19,16,12,4
13,22,20,28,27,1
13,22,21,6,12,-6
13,22,22,21,18,3
13,22,23,18,16,2
13,22,24,35,20,15
13,22,25,22,11,11
13,22,26,8,8,0
13,22,27,33,17,16
13,22,28,35,20,15
13,22,29,21,20,1
13,22,30,26,12,14
13,22,31,11,9,2
13,22,32,19,11,8
13,22,33,15,19,-4
13,22,34,13,11,2
13,22,35,21,17,4
13,22,36,14,13,1
13,22,37,16,15,1
13,22,38,18,22,-4
13,22,39,6,21,-15
13,22,40,11,8,3
13,22,41,22,4,18
13,22,42,7,12,-5
13,22,43,15,18,-3
13,22,44,14,7,7
13,22,45,15,17,-2
13,22,46,30,17,13
13,22,47,4,10,-6
13,22,48,28,9,19
13,22,49,15,12,3
13,22,50,18,14,4
13,22,51,17,11,6
13,22,52,26,10,16
13,22,53,16,22,-6
13,22,54,19,9,10
13,22,55,12,3,9
13,22,56,23,15,8
13,22,57,13,9,4
13,22,58,9,20,-11
13,22,59,19,22,-3
13,22,60,21,14,7
13,22,61,17,12,5
13,22,62,26,13,13
13,22,63,10,13,-3
13,22,64,18,26,-8
13,22,65,27,19,8
13,22,66,25,16,9
13,22,67,10,9,1
13,22,68,9,5,4
13,22,69,12,9,3
13,22,70,20,9,11
13,22,71,9,16,-7
13,22,72,23,22,1
13,22,73,20,10,10
13,22,74,28,11,17
13,22,75,21,23,-2
13,22,76,11,16,-5
13,22,77,11,11,0
13,22,78,13,19,-6
13,22,79,10,10,0
13,22,80,20,11,9
13,22,81,14,18,-4
13,22,82,17,14,3
13,22,83,5,6,-1
13,22,84,12,13,-1
13,22,85,21,7,14
13,22,86,18,17,1
13,22,87,12,24,-12
13,22,88,17,16,1
13,22,89,17,12,5
13,22,90,11,18,-7
13,22,91,10,20,-10
13,22,92,13,17,-4
13,22,93,12,13,-1
13,22,94,15,11,4
13,22,95,10,12,-2
13,22,96,24,15,9
13,22,97,21,11,10
13,22,98,11,12,-1
13,22,99,13,15,-2
13,22,100,15,17,-2
13,22,101,23,14,9
13,22,102,11,11,0
13,22,103,17,16,1
13,22,104,22,20,2
13,22,105,14,24,-10
13,22,106,8,20,-12
13,22,107,20,13,7
13,22,108,18,19,-1
13,22,109,10,4,6
13,22,110,19,18,1
13,22,111,12,27,-15
13,22,112,22,11,11
13,22,113,17,10,7
13,22,114,23,9,14
13,22,115,11,20,-9
13,22,116,28,17,11
13,22,117,16,17,-1
13,22,118,21,7,14
13,22,119,24,13,11
13,22,120,17,11,6
13,22,121,35,17,18
13,22,122,13,15,-2
13,22,123,15,6,9
13,22,124,16,12,4
13,22,125,11,7,4
13,22,126,9,5,4
13,22,127,20,14,6
13,22,128,13,24,-11
13,22,129,13,16,-3
13,22,130,14,21,-7
13,22,131,12,7,5
13,22,132,32,11,21
13,22,133,19,10,9
13,22,134,11,10,1
13,22,135,11,20,-9
13,22,136,17,3,14
13,22,137,17,10,7
13,22,138,27,19,8
13,22,139,8,27,-19
13,22,140,8,17,-9
13,22,141,13,9,4
13,22,142,10,12,-2
13,22,143,19,27,-8
13,22,144,9,8,1
13,22,145,21,16,5
13,22,146,7,4,3
13,22,147,18,21,-3
13,22,148,20,14,6
13,22,149,7,20,-13
13,22,150,33,33,0
13,22,151,29,18,11
13,22,152,15,11,4
13,22,153,19,12,7
13,22,154,15,14,1
13,22,155,28,19,9
13,22,156,17,12,5
13,22,157,20,14,6
13,22,158,16,23,-7
13,22,159,21,5,16
13,22,160,16,17,-1
13,22,161,17,20,-3
13,22,162,9,16,-7
13,22,163,28,23,5
13,22,164,14,11,3
13,22,165,19,14,5
13,22,166,10,10,0
13,22,167,10,15,-5
13,22,168,10,7,3
13,22,169,23,8,15
13,22,170,18,17,1
13,22,171,20,15,5
13,22,172,11,14,-3
13,22,173,10,10,0
13,22,174,10,8,2
13,22,175,19,8,11
13,22,176,15,9,6
13,22,177,18,15,3
13,22,178,26,17,9
13,22,179,19,23,-4
13,22,180,21,18,3
13,22,181,23,22,1
13,22,182,23,25,-2
13,22,183,6,10,-4
13,22,184,19,13,6
13,22,185,22,19,3
13,22,186,12,16,-4
13,22,187,15,13,2
13,22,188,19,9,10
13,22,189,31,14,17
13,22,190,23,14,9
13,22,191,10,12,-2
13,22,192,19,8,11
13,22,193,11,9,2
13,22,194,6,5,1
13,22,195,19,12,7
13,22,196,9,10,-1
13,22,197,30,8,22
13,22,198,22,12,10
13,22,199,16,6,10
13,22,200,28,13,15
13,22,201,13,16,-3
13,22,202,13,19,-6
13,22,203,15,20,-5
13,22,204,21,13,8
13,22,205,10,12,-2
13,22,206,15,18,-3
13,22,207,15,11,4
13,22,208,14,11,3
13,22,209,13,4,9
13,22,210,24,10,14
13,22,211,20,11,9
13,22,212,16,7,9
13,22,213,15,23,-8
13,22,214,25,17,8
13,22,215,18,12,6
13,22,216,28,20,8
13,22,217,8,20,-12
13,22,218,13,10,3
13,22,219,28,15,13
13,22,220,12,10,2
13,22,221,8,0,8
13,22,222,22,16,6
13,22,223,15,20,-5
13,22,224,18,23,-5
13,22,225,21,10,11
13,22,226,20,15,5
13,22,227,17,17,0
13,22,228,16,23,-7
13,22,229,18,14,4
13,22,230,6,14,-8
13,22,231,11,16,-5
13,22,232,11,10,1
13,22,233,28,13,15
13,22,234,19,23,-4
13,22,235,28,19,9
13,22,236,19,17,2
13,22,237,10,8,2
13,22,238,12,11,1
13,22,239,19,22,-3
13,22,240,8,9,-1
13,22,241,15,15,0
13,22,242,9,7,2
13,22,243,17,11,6
13,22,244,30,16,14
13,22,245,12,13,-1
13,22,246,17,11,6
13,22,247,8,15,-7
13,22,248,15,11,4
13,22,249,15,8,7
13,22,250,24,11,13
13,22,251,27,23,4
13,22,252,22,20,2
13,22,253,21,12,9
13,22,254,2,6,-4
13,22,255,12,12,0
13,22,256,20,15,5
13,22,257,13,7,6
13,22,258,20,19,1
13,22,259,20,9,11
13,22,260,15,10,5
13,22,261,20,10,10
13,22,262,32,16,16
13,22,263,27,11,16
13,22,264,21,14,7
13,22,265,37,21,16
13,22,266,10,11,-1
13,22,267,2,8,-6
13,22,268,29,19,10
13,22,269,14,7,7
13,22,270,4,11,-7
13,22,271,14,5,9
13,22,272,13,6,7
13,22,273,9,1,8
13,22,274,12,10,2
13,22,275,12,23,-11
13,22,276,25,23,2
13,22,277,28,34,-6
13,22,278,18,11,7
13,22,279,28,13,15
13,22,280,16,14,2
13,22,281,23,18,5
13,22,282,10,8,2
13,22,283,25,10,15
13,22,284,19,15,4
13,22,285,21,18,3
13,22,286,27,13,14
13,22,287,15,12,3
13,22,288,15,6,9
13,22,289,17,4,13
13,22,290,21,14,7
13,22,291,19,12,7
13,22,292,22,9,13
13,22,293,29,16,13
13,22,294,28,26,2
13,22,295,22,21,1
13,22,296,14,25,-11
13,22,297,18,13,5
13,22,298,19,12,7
13,22,299,17,16,1
13,23,0,27,17,10
13,23,1,20,26,-6
13,23,2,22,14,8
13,23,3,11,6,5
13,23,4,10,4,6
13,23,5,15,13,2
13,23,6,16,2,14
13,23,7,31,16,15
13,23,8,38,15,23
13,23,9,10,12,-2
13,23,10,17,14,3
13,23,11,12,21,-9
13,23,12,10,23,-13
13,23,13,18,7,11
13,23,14,14,12,2
13,23,15,16,7,9
13,23,16,15,18,-3
13,23,17,20,11,9
13,23,18,15,15,0
13,23,19,9,7,2
13,23,20,23,21,2
13,23,21,19,14,5
13,23,22,14,13,1
13,23,23,7,9,-2
13,23,24,18,8,10
13,23,25,23,18,5
13,23,26,11,5,6
13,23,27,16,29,-13
13,23,28,10,6,4
13,23,29,11,22,-11
13,23,30,27,20,7
13,23,31,25,10,15
13,23,32,20,23,-3
13,23,33,15,13,2
13,23,34,26,19,7
13,23,35,13,7,6
13,23,36,9,12,-3
13,23,37,14,15,-1
13,23,38,7,8,-1
13,23,39,14,11,3
13,23,40,19,16,3
13,23,41,17,7,10
13,23,42,21,12,9
13,23,43,7,12,-5
13,23,44,17,7,10
13,23,45,4,5,-1
13,23,46,21,20,1
13,23,47,12,13,-1
13,23,48,19,10,9
13,23,49,20,15,5
13,23,50,32,12,20
13,23,51,14,16,-2
13,23,52,10,15,-5
13,23,53,24,14,10
13,23,54,18,23,-5
13,23,55,28,18,10
13,23,56,9,16,-7
13,23,57,16,7,9
13,23,58,14,6,8
13,23,59,19,11,8
13,23,60,17,8,9
13,23,61,15,24,-9
13,23,62,21,19,2
13,23,63,34,13,21
13,23,64,23,15,8
13,23,65,12,6,6
13,23,66,17,9,8
13,23,67,9,9,0
13,23,68,19,24,-5
13,23,69,16,7,9
13,23,70,13,8,5
13,23,71,10,8,2
13,23,72,19,14,5
13,23,73,22,15,7
13,23,74,14,19,-5
13,23,75,22,5,17
13,23,76,12,6,6
13,23,77,11,11,0
13,23,78,26,13,13
13,23,79,6,11,-5
13,23,80,17,8,9
13,23,81,8,1,7
13,23,82,10,22,-12
13,23,83,9,18,-9
13,23,84,16,7,9
13,23,85,22,25,-3
13,23,86,14,12,2
13,23,87,12,16,-4
13,23,88,28,21,7
13,23,89,11,15,-4
13,23,90,11,8,3
13,23,91,12,15,-3
13,23,92,10,8,2
13,23,93,7,7,0
13,23,94,11,8,3
13,23,95,13,2,11
13,23,96,17,23,-6
13,23,97,8,10,-2
13,23,98,13,12,1
13,23,99,16,9,7
13,23,100,27,17,10
13,23,101,25,6,19
13,23,102,15,5,10
13,23,103,25,25,0
13,23,104,17,17,0
13,23,105,21,13,8
13,23,106,11,15,-4
13,23,107,16,15,1
13,23,108,20,12,8
13,23,109,11,16,-5
13,23,110,17,13,4
13,23,111,25,17,8
13,23,112,9,16,-7
13,23,113,16,15,1
13,23,114,20,11,9
13,23,115,14,13,1
13,23,116,16,14,2
13,23,117,14,16,-2
13,23,118,25,18,7
13,23,119,9,7,2
13,23,120,16,14,2
13,23,121,32,17,15
13,23,122,10,12,-2
13,23,123,26,12,14
13,23,124,14,10,4
13,23,125,26,16,10
13,23,126,20,19,1
13,23,127,24,5,19
13,23,128,15,22,-7
13,23,129,18,16,2
13,23,130,15,3,12
13,23,131,11,9,2
13,23,132,28,18,10
13,23,133,21,14,7
13,23,134,11,16,-5
13,23,135,25,11,14
13,23,136,20,18,2
13,23,137,26,18,8
13,23,138,18,10,8
13,23,139,10,6,4
13,23,140,22,20,2
13,23,141,11,8,3
13,23,142,23,15,8
13,23,143,18,16,2
13,23,144,20,13,7
13,23,145,21,15,6
13,23,146,16,21,-5
13,23,147,28,7,21
13,23,148,11,15,-4
13,23,149,24,19,5
13,23,150,11,8,3
13,23,151,17,15,2
13,23,152,14,4,10
13,23,153,19,24,-5
13,23,154,13,13,0
13,23,155,22,21,1
13,23,156,11,18,-7
13,23,157,27,20,7
13,23,158,8,10,-2
13,23,159,15,16,-1
13,23,160,14,12,2
13,23,161,3,18,-15
13,23,162,22,14,8
13,23,163,13,11,2
13,23,164,11,5,6
13,23,165,13,16,-3
13,23,166,8,6,2
13,23,167,11,16,-5
13,23,168,19,15,4
13,23,169,19,15,4
13,23,170,15,8,7
13,23,171,7,9,-2
13,23,172,9,13,-4
13,23,173,17,14,3
13,23,174,19,10,9
13,23,175,5,6,-1
13,23,176,17,22,-5
13,23,177,20,12,8
13,23,178,26,22,4
13,23,179,18,17,1
13,23,180,21,12,9
13,23,181,19,13,6
13,23,182,22,27,-5
13,23,183,18,13,5
13,23,184,19,16,3
13,23,185,11,9,2
13,23,186,16,8,8
13,23,187,30,11,19
13,23,188,21,7,14
13,23,189,22,12,10
13,23,190,19,9,10
13,23,191,15,5,10
13,23,192,11,11,0
13,23,193,21,25,-4
13,23,194,24,22,2
13,23,195,22,9,13
13,23,196,19,14,5
13,23,197,28,12,16
13,23,198,18,17,1
13,23,199,11,11,0
13,23,200,20,21,-1
13,23,201,10,12,-2
13,23,202,18,14,4
13,23,203,23,12,11
13,23,204,13,10,3
13,23,205,11,15,-4
13,23,206,20,14,6
13,23,207,7,7,0
13,23,208,17,10,7
13,23,209,20,20,0
13,23,210,22,7,15
13,23,211,19,15,4
13,23,212,13,6,7
13,23,213,39,19,20
13,23,214,26,28,-2
13,23,215,31,4,27
13,23,216,9,19,-10
13,23,217,13,15,-2
13,23,218,20,13,7
13,23,219,8,16,-8
13,23,220,6,11,-5
13,23,221,12,9,3
13,23,222,17,10,7
13,23,223,14,22,-8
13,23,224,31,19,12
13,23,225,12,5,7
13,23,226,13,21,-8
13,23,227,25,18,7
13,23,228,28,15,13
13,23,229,8,12,-4
13,23,230,14,12,2
13,23,231,8,2,6
13,23,232,17,11,6
13,23,233,29,11,18
13,23,234,10,15,-5
13,23,235,31,20,11
13,23,236,17,11,6
13,23,237,28,16,12
13,23,238,23,27,-4
13,23,239,19,17,2
13,23,240,11,14,-3
13,23,241,20,3,17
13,23,242,18,19,-1
13,23,243,25,18,7
13,23,244,27,16,11
13,23,245,20,29,-9
13,23,246,16,11,5
13,23,247,13,8,5
13,23,248,13,15,-2
13,23,249,18,14,4
13,23,250,26,18,8
13,23,251,30,20,10
13,23,252,22,17,5
13,23,253,14,8,6
13,23,254,22,22,0
13,23,255,18,10,8
13,23,256,9,13,-4
13,23,257,19,20,-1
13,23,258,17,15,2
13,23,259,17,10,7
13,23,260,18,20,-2
13,23,261,20,10,10
13,23,262,9,16,-7
13,23,263,24,17,7
13,23,264,17,8,9
13,23,265,18,22,-4
13,23,266,20,20,0
13,23,267,7,8,-1
13,23,268,13,9,4
13,23,269,18,10,8
13,23,270,22,7,15
13,23,271,13,17,-4
13,23,272,15,13,2
13,23,273,21,13,8
13,23,274,15,8,7
13,23,275,5,12,-7
13,23,276,17,10,7
13,23,277,28,8,20
13,23,278,22,10,12
13,23,279,22,19,3
13,23,280,18,12,6
13,23,281,8,8,0
13,23,282,15,14,1
13,23,283,25,15,10
13,23,284,19,6,13
13,23,285,14,7,7
13,23,286,27,21,6
13,23,287,38,23,15
13,23,288,10,8,2
13,23,289,22,10,12
13,23,290,13,10,3
13,23,291,26,31,-5
13,23,292,8,9,-1
13,23,293,20,15,5
13,23,294,22,16,6
13,23,295,17,13,4
13,23,296,12,12,0
13,23,297,13,9,4
13,23,298,22,25,-3
13,23,299,10,6,4
13,24,0,19,3,16
13,24,1,14,8,6
13,24,2,23,17,6
13,24,3,27,15,12
13,24,4,28,17,11
13,24,5,12,5,7
13,24,6,15,9,6
13,24,7,26,5,21
13,24,8,10,13,-3
13,24,9,22,15,7
13,24,10,9,13,-4
13,24,11,22,14,8
13,24,12,30,13,17
13,24,13,17,10,7
13,24,14,28,18,10
13,24,15,7,5,2
13,24,16,22,18,4
13,24,17,24,4,20
13,24,18,22,15,7
13,24,19,22,21,1
13,24,20,22,12,10
13,24,21,21,8,13
13,24,22,13,13,0
13,24,23,19,8,11
13,24,24,12,23,-11
13,24,25,25,15,10
13,24,26,18,27,-9
13,24,27,11,6,5
13,24,28,17,13,4
13,24,29,19,26,-7
13,24,30,13,21,-8
13,24,31,15,11,4
13,24,32,21,15,6
13,24,33,17,18,-1
13,24,34,16,14,2
13,24,35,11,17,-6
13,24,36,9,10,-1
13,24,37,23,22,1
13,24,38,22,10,12
13,24,39,15,8,7
13,24,40,11,11,0
13,24,41,12,11,1
13,24,42,12,8,4
13,24,43,23,15,8
13,24,44,21,9,12
13,24,45,16,13,3
13,24,46,27,17,10
13,24,47,17,12,5
13,24,48,14,10,4
13,24,49,27,16,11
13,24,50,12,11,1
13,24,51,15,10,5
13,24,52,23,13,10
13,24,53,19,19,0
13,24,54,22,29,-7
13,24,55,21,29,-8
13,24,56,12,22,-10
13,24,57,19,6,13
13,24,58,13,12,1
13,24,59,19,7,12
13,24,60,24,7,17
13,24,61,11,15,-4
13,24,62,28,11,17
13,24,63,20,11,9
13,24,64,9,15,-6
13,24,65,19,18,1
13,24,66,12,21,-9
13,24,67,10,8,2
13,24,68,22,14,8
13,24,69,12,13,-1
13,24,70,13,13,0
13,24,71,16,20,-4
13,24,72,18,2,16
13,24,73,22,16,6
13,24,74,13,13,0
13,24,75,24,16,8
13,24,76,10,12,-2
13,24,77,21,19,2
13,24,78,27,14,13
13,24,79,9,7,2
13,24,80,20,17,3
13,24,81,10,16,-6
13,24,82,21,17,4
13,24,83,19,11,8
13,24,84,12,10,2
13,24,85,19,7,12
13,24,86,15,16,-1
13,24,87,15,15,0
13,24,88,25,10,15
13,24,89,10,16,-6
13,24,90,11,18,-7
13,24,91,17,16,1
13,24,92,22,17,5
13,24,93,15,13,2
13,24,94,10,6,4
13,24,95,14,16,-2
13,24,96,12,14,-2
13,24,97,10,5,5
13,24,98,9,20,-11
13,24,99,22,7,15
13,24,100,12,12,0
13,24,101,6,10,-4
13,24,102,32,13,19
13,24,103,18,13,5
13,24,104,10,15,-5
13,24,105,28,22,6
13,24,106,4,4,0
13,24,107,15,8,7
13,24,108,14,13,1
13,24,109,31,17,14
13,24,110,7,14,-7
13,24,111,27,22,5
13,24,112,14,15,-1
13,24,113,16,10,6
13,24,114,14,18,-4
13,24,115,15,9,6
13,24,116,12,20,-8
13,24,117,14,22,-8
13,24,118,27,13,14
13,24,119,23,27,-4
13,24,120,23,23,0
13,24,121,27,23,4
13,24,122,13,14,-1
13,24,123,19,3,16
13,24,124,32,13,19
13,24,125,14,3,11
13,24,126,17,15,2
13,24,127,8,13,-5
13,24,128,18,12,6
13,24,129,18,8,10
13,24,130,6,9,-3
13,24,131,15,10,5
13,24,132,11,5,6
13,24,133,28,13,15
13,24,134,13,11,2
13,24,135,7,15,-8
13,24,136,25,10,15
13,24,137,16,16,0
13,24,138,19,21,-2
13,24,139,21,13,8
13,24,140,23,11,12
13,24,141,14,19,-5
13,24,142,15,7,8
13,24,143,18,5,13
13,24,144,23,10,13
13,24,145,13,10,3
13,24,146,16,5,11
13,24,147,19,11,8
13,24,148,27,17,10
13,24,149,28,16,12
13,24,150,14,13,1
13,24,151,18,4,14
13,24,152,19,11,8
13,24,153,4,5,-1
13,24,154,32,14,18
13,24,155,21,13,8
13,24,156,34,20,14
13,24,157,17,7,10
13,24,158,19,10,9
13,24,159,10,5,5
13,24,160,12,14,-2
13,24,161,17,8,9
13,24,162,12,8,4
13,24,163,10,8,2
13,24,164,24,18,6
13,24,165,11,4,7
13,24,166,24,16,8
13,24,167,19,17,2
13,24,168,13,23,-10
13,24,169,19,8,11
13,24,170,21,17,4
13,24,171,13,11,2
13,24,172,11,18,-7
13,24,173,12,19,-7
13,24,174,16,14,2
13,24,175,18,14,4
13,24,176,35,16,19
13,24,177,13,15,-2
13,24,178,25,14,11
13,24,179,20,10,10
13,24,180,28,8,20
13,24,181,13,8,5
13,24,182,28,7,21
13,24,183,14,13,1
13,24,184,14,9,5
13,24,185,23,17,6
13,24,186,43,14,29
13,24,187,18,5,13
13,24,188,8,11,-3
13,24,189,18,22,-4
13,24,190,13,12,1
13,24,191,22,16,6
13,24,192,18,14,4
13,24,193,16,12,4
13,24,194,9,16,-7
13,24,195,24,7,17
13,24,196,19,17,2
13,24,197,15,15,0
13,24,198,19,12,7
13,24,199,31,16,15
13,24,200,22,13,9
13,24,201,15,9,6
13,24,202,33,21,12
13,24,203,14,14,0
13,24,204,12,7,5
13,24,205,16,18,-2
13,24,206,26,11,15
13,24,207,13,16,-3
13,24,208,15,8,7
13,24,209,15,10,5
13,24,210,14,8,6
13,24,211,12,4,8
13,24,212,23,16,7
13,24,213,8,8,0
13,24,214,12,14,-2
13,24,215,15,13,2
13,24,216,15,9,6
13,24,217,15,6,9
13,24,218,9,7,2
13,24,219,8,7,1
13,24,220,21,11,10
13,24,221,13,13,0
13,24,222,10,13,-3
13,24,223,16,17,-1
13,24,224,18,12,6
13,24,225,33,29,4
13,24,226,12,15,-3
13,24,227,21,23,-2
13,24,228,17,12,5
13,24,229,34,16,18
13,24,230,9,18,-9
13,24,231,10,8,2
13,24,232,19,28,-9
13,24,233,11,16,-5
13,24,234,22,12,10
13,24,235,12,4,8
13,24,236,26,23,3
13,24,237,19,28,-9
13,24,238,28,24,4
13,24,239,24,24,0
13,24,240,18,12,6
13,24,241,13,22,-9
13,24,242,10,7,3
13,24,243,31,13,18
13,24,244,17,15,2
13,24,245,31,12,19
13,24,246,10,4,6
13,24,247,30,24,6
13,24,248,23,18,5
13,24,249,13,8,5
13,24,250,32,15,17
13,24,251,20,6,14
13,24,252,17,10,7
13,24,253,11,30,-19
13,24,254,12,9,3
13,24,255,18,16,2
13,24,256,15,9,6
13,24,257,15,10,5
13,24,258,17,6,11
13,24,259,5,8,-3
13,24,260,15,18,-3
13,24,261,18,10,8
13,24,262,23,21,2
13,24,263,17,16,1
13,24,264,19,14,5
13,24,265,15,18,-3
13,24,266,14,13,1
13,24,267,25,20,5
13,24,268,12,14,-2
13,24,269,18,9,9
13,24,270,11,11,0
13,24,271,8,12,-4
13,24,272,12,11,1
13,24,273,14,13,1
13,24,274,15,23,-8
13,24,275,13,9,4
13,24,276,20,15,5
13,24,277,8,13,-5
13,24,278,24,13,11
13,24,279,21,23,-2
13,24,280,14,17,-3
13,24,281,23,8,15
13,24,282,12,11,1
13,24,283,9,21,-12
13,24,284,14,11,3
13,24,285,21,5,16
13,24,286,23,8,15
13,24,287,10,13,-3
13,24,288,24,20,4
13,24,289,27,26,1
13,24,290,13,9,4
13,24,291,31,18,13
13,24,292,21,14,7
13,24,293,19,15,4
13,24,294,20,12,8
13,24,295,26,20,6
13,24,296,19,15,4
13,24,297,1,0,1
13,24,298,16,16,0
13,24,299,19,9,10
13,25,0,16,13,3
13,25,1,24,12,12
13,25,2,19,7,12
13,25,3,13,5,8
13,25,4,29,11,18
13,25,5,21,11,10
13,25,6,16,10,6
13,25,7,11,9,2
13,25,8,20,11,9
13,25,9,11,11,0
13,25,10,10,16,-6
13,25,11,20,17,3
13,25,12,30,25,5
13,25,13,19,12,7
13,25,14,10,11,-1
13,25,15,20,16,4
13,25,16,14,20,-6
13,25,17,13,9,4
13,25,18,19,7,12
13,25,19,13,18,-5
13,25,20,11,12,-1
13,25,21,18,12,6
13,25,22,18,9,9
13,25,23,11,9,2
13,25,24,17,16,1
13,25,25,6,4,2
13,25,26,4,12,-8
13,25,27,18,10,8
13,25,28,12,11,1
13,25,29,20,20,0
13,25,30,13,10,3
13,25,31,10,6,4
13,25,32,22,14,8
13,25,33,15,8,7
13,25,34,17,16,1
13,25,35,12,10,2
13,25,36,13,4,9
13,25,37,12,12,0
13,25,38,13,15,-2
13,25,39,24,10,14
13,25,40,16,10,6
13,25,41,15,17,-2
13,25,42,18,9,9
13,25,43,9,13,-4
13,25,44,10,10,0
13,25,45,23,4,19
13,25,46,26,20,6
13,25,47,23,2,21
13,25,48,13,19,-6
13,25,49,7,24,-17
13,25,50,8,6,2
13,25,51,21,11,10
13,25,52,11,9,2
13,25,53,19,12,7
13,25,54,21,9,12
13,25,55,17,9,8
13,25,56,21,13,8
13,25,57,10,21,-11
13,25,58,20,12,8
13,25,59,17,18,-1
13,25,60,28,10,18
13,25,61,9,22,-13
13,25,62,14,15,-1
13,25,63,9,15,-6
13,25,64,24,11,13
13,25,65,14,18,-4
13,25,66,16,13,3
13,25,67,23,12,11
13,25,68,17,10,7
13,25,69,19,15,4
13,25,70,12,13,-1
13,25,71,21,16,5
13,25,72,18,23,-5
13,25,73,20,4,16
13,25,74,18,2,16
13,25,75,27,8,19
13,25,76,20,12,8
13,25,77,20,11,9
13,25,78,17,11,6
13,25,79,12,11,1
13,25,80,12,17,-5
13,25,81,17,11,6
13,25,82,13,16,-3
13,25,83,21,5,16
13,25,84,24,22,2
13,25,85,36,26,10
13,25,86,17,9,8
13,25,87,15,9,6
13,25,88,12,15,-3
13,25,89,14,8,6
13,25,90,36,18,18
13,25,91,20,19,1
13,25,92,13,11,2
13,25,93,8,8,0
13,25,94,14,18,-4
13,25,95,27,15,12
13,25,96,6,22,-16
13,25,97,14,5,9
13,25,98,16,18,-2
13,25,99,13,8,5
13,25,100,10,7,3
13,25,101,16,12,4
13,25,102,12,17,-5
13,25,103,18,23,-5
13,25,104,7,10,-3
13,25,105,11,5,6
13,25,106,15,3,12
13,25,107,16,10,6
13,25,108,24,19,5
13,25,109,18,11,7
13,25,110,9,25,-16
13,25,111,19,23,-4
13,25,112,26,17,9
13,25,113,16,23,-7
13,25,114,17,5,12
13,25,115,17,15,2
13,25,116,11,9,2
13,25,117,18,12,6
13,25,118,16,21,-5
13,25,119,21,12,9
13,25,120,9,13,-4
13,25,121,20,27,-7
13,25,122,19,32,-13
13,25,123,22,15,7
13,25,124,18,19,-1
13,25,125,17,12,5
13,25,126,10,12,-2
13,25,127,11,19,-8
13,25,128,22,18,4
13,25,129,22,15,7
13,25,130,14,5,9
13,25,131,25,24,1
13,25,132,9,10,-1
13,25,133,16,14,2
13,25,134,12,6,6
13,25,135,21,14,7
13,25,136,22,16,6
13,25,137,25,17,8
13,25,138,11,14,-3
13,25,139,8,14,-6
13,25,140,17,15,2
13,25,141,17,10,7
13,25,142,27,12,15
13,25,143,27,15,12
13,25,144,17,17,0
13,25,145,12,15,-3
13,25,146,10,8,2
13,25,147,8,5,3
13,25,148,13,9,4
13,25,149,8,7,1
13,25,150,22,10,12
13,25,151,33,18,15
13,25,152,27,15,12
13,25,153,8,13,-5
13,25,154,19,10,9
13,25,155,15,10,5
13,25,156,24,10,14
13,25,157,13,18,-5
13,25,158,10,13,-3
13,25,159,15,18,-3
13,25,160,20,11,9
13,25,161,17,19,-2
13,25,162,30,20,10
13,25,163,16,13,3
13,25,164,6,7,-1
13,25,165,15,11,4
13,25,166,11,21,-10
13,25,167,17,11,6
13,25,168,5,6,-1
13,25,169,13,11,2
13,25,170,26,17,9
13,25,171,21,12,9
13,25,172,9,13,-4
13,25,173,15,11,4
13,25,174,10,9,1
13,25,175,23,9,14
13,25,176,15,16,-1
13,25,177,26,11,15
13,25,178,20,17,3
13,25,179,19,13,6
13,25,180,21,16,5
13,25,181,21,17,4
13,25,182,18,8,10
13,25,183,10,15,-5
13,25,184,12,10,2
13,25,185,10,8,2
13,25,186,17,31,-14
13,25,187,22,7,15
13,25,188,21,14,7
13,25,189,7,7,0
13,25,190,19,13,6
13,25,191,18,16,2
13,25,192,7,4,3
13,25,193,13,12,1
13,25,194,20,12,8
13,25,195,16,13,3
13,25,196,14,16,-2
13,25,197,24,7,17
13,25,198,11,14,-3
13,25,199,13,15,-2
13,25,200,25,14,11
13,25,201,24,16,8
13,25,202,21,12,9
13,25,203,16,16,0
13,25,204,13,18,-5
13,25,205,19,17,2
13,25,206,14,6,8
13,25,207,11,20,-9
13,25,208,25,8,17
13,25,209,32,18,14
13,25,210,7,5,2
13,25,211,17,14,3
13,25,212,19,11,8
13,25,213,22,15,7
13,25,214,19,13,6
13,25,215,11,13,-2
13,25,216,14,16,-2
13,25,217,21,11,10
13,25,218,17,13,4
13,25,219,25,11,14
13,25,220,27,21,6
13,25,221,20,8,12
13,25,222,7,15,-8
13,25,223,13,10,3
13,25,224,23,29,-6
13,25,225,15,10,5
13,25,226,27,14,13
13,25,227,26,11,15
13,25,228,23,13,10
13,25,229,25,4,21
13,25,230,8,13,-5
13,25,231,33,24,9
13,25,232,8,6,2
13,25,233,28,25,3
13,25,234,21,7,14
13,25,235,22,11,11
13,25,236,16,15,1
13,25,237,15,10,5
13,25,238,24,16,8
13,25,239,12,12,0
13,25,240,21,10,11
13,25,241,19,15,4
13,25,242,22,14,8
13,25,243,22,16,6
13,25,244,15,8,7
13,25,245,20,13,7
13,25,246,21,13,8
13,25,247,14,7,7
13,25,248,20,19,1
13,25,249,23,13,10
13,25,250,18,10,8
13,25,251,4,11,-7
13,25,252,18,13,5
13,25,253,18,6,12
13,25,254,16,12,4
13,25,255,17,6,11
13,25,256,7,8,-1
13,25,257,20,8,12
13,25,258,16,14,2
13,25,259,8,11,-3
13,25,260,9,4,5
13,25,261,22,17,5
13,25,262,21,12,9
13,25,263,23,18,5
13,25,264,9,10,-1
13,25,265,9,8,1
13,25,266,22,14,8
13,25,267,14,10,4
13,25,268,11,3,8
13,25,269,20,14,6
13,25,270,23,16,7
13,25,271,9,10,-1
13,25,272,15,11,4
13,25,273,16,7,9
13,25,274,21,17,4
13,25,275,20,22,-2
13,25,276,23,24,-1
13,25,277,24,16,8
13,25,278,22,9,13
13,25,279,18,16,2
13,25,280,18,19,-1
13,25,281,30,21,9
13,25,282,12,16,-4
13,25,283,9,15,-6
13,25,284,19,20,-1
13,25,285,19,15,4
13,25,286,17,8,9
13,25,287,16,9,7
13,25,288,13,9,4
13,25,289,19,10,9
13,25,290,32,12,20
13,25,291,4,3,1
13,25,292,21,20,1
13,25,293,4,5,-1
13,25,294,11,12,-1
13,25,295,15,17,-2
13,25,296,13,9,4
13,25,297,10,6,4
13,25,298,21,15,6
13,25,299,18,4,14
13,26,0,19,31,-12
13,26,1,19,6,13
13,26,2,20,30,-10
13,26,3,20,16,4
13,26,4,9,10,-1
13,26,5,30,10,20
13,26,6,15,19,-4
13,26,7,14,14,0
13,26,8,14,14,0
13,26,9,15,11,4
13,26,10,30,13,17
13,26,11,21,13,8
13,26,12,26,14,12
13,26,13,32,16,16
13,26,14,12,7,5
13,26,15,20,6,14
13,26,16,16,27,-11
13,26,17,31,17,14
13,26,18,12,12,0
13,26,19,12,15,-3
13,26,20,9,10,-1
13,26,21,27,19,8
13,26,22,13,1,12
13,26,23,7,5,2
13,26,24,22,11,11
13,26,25,16,8,8
13,26,26,16,14,2
13,26,27,13,8,5
13,26,28,12,9,3
13,26,29,11,4,7
13,26,30,32,15,17
13,26,31,28,12,16
13,26,32,18,14,4
13,26,33,23,14,9
13,26,34,20,15,5
13,26,35,19,28,-9
13,26,36,9,10,-1
13,26,37,15,10,5
13,26,38,15,6,9
13,26,39,19,14,5
13,26,40,2,1,1
13,26,41,19,11,8
13,26,42,9,11,-2
13,26,43,19,4,15
13,26,44,17,14,3
13,26,45,7,7,0
13,26,46,17,19,-2
13,26,47,13,17,-4
13,26,48,21,10,11
13,26,49,18,13,5
13,26,50,24,21,3
13,26,51,10,8,2
13,26,52,15,11,4
13,26,53,12,14,-2
13,26,54,9,3,6
13,26,55,9,6,3
13,26,56,25,22,3
13,26,57,11,9,2
13,26,58,13,11,2
13,26,59,12,6,6
13,26,60,6,6,0
13,26,61,25,11,14
13,26,62,24,25,-1
13,26,63,27,21,6
13,26,64,26,29,-3
13,26,65,13,18,-5
13,26,66,16,12,4
13,26,67,10,9,1
13,26,68,11,7,4
13,26,69,23,14,9
13,26,70,23,36,-13
13,26,71,26,19,7
13,26,72,6,7,-1
13,26,73,17,5,12
13,26,74,7,9,-2
13,26,75,20,17,3
13,26,76,16,8,8
13,26,77,16,9,7
13,26,78,15,11,4
13,26,79,10,7,3
13,26,80,18,15,3
13,26,81,18,12,6
13,26,82,12,9,3
13,26,83,25,15,10
13,26,84,13,21,-8
13,26,85,19,12,7
13,26,86,18,15,3
13,26,87,6,6,0
13,26,88,15,14,1
13,26,89,27,20,7
13,26,90,27,21,6
13,26,91,27,19,8
13,26,92,16,17,-1
13,26,93,18,6,12
13,26,94,21,16,5
13,26,95,17,13,4
13,26,96,33,12,21
13,26,97,23,20,3
13,26,98,15,21,-6
13,26,99,14,13,1
13,26,100,23,16,7
13,26,101,13,8,5
13,26,102,12,18,-6
13,26,103,34,9,25
13,26,104,18,13,5
13,26,105,21,13,8
13,26,106,14,13,1
13,26,107,14,18,-4
13,26,108,15,7,8
13,26,109,17,18,-1
13,26,110,17,8,9
13,26,111,27,13,14
13,26,112,21,15,6
13,26,113,16,10,6
13,26,114,9,19,-10
13,26,115,8,14,-6
13,26,116,21,19,2
13,26,117,27,13,14
13,26,118,5,6,-1
13,26,119,20,20,0
13,26,120,5,5,0
13,26,121,16,8,8
13,26,122,18,8,10
13,26,123,25,16,9
13,26,124,24,5,19
13,26,125,20,5,15
13,26,126,26,8,18
13,26,127,12,9,3
13,26,128,20,24,-4
13,26,129,14,16,-2
13,26,130,3,9,-6
13,26,131,29,13,16
13,26,132,29,9,20
13,26,133,11,17,-6
13,26,134,18,13,5
13,26,135,20,14,6
13,26,136,12,18,-6
13,26,137,31,6,25
13,26,138,24,21,3
13,26,139,10,6,4
13,26,140,15,9,6
13,26,141,15,10,5
13,26,142,20,11,9
13,26,143,23,21,2
13,26,144,13,16,-3
13,26,145,13,5,8
13,26,146,18,7,11
13,26,147,24,20,4
13,26,148,16,11,5
13,26,149,18,13,5
13,26,150,15,12,3
13,26,151,21,12,9
13,26,152,17,19,-2
13,26,153,12,9,3
13,26,154,13,8,5
13,26,155,10,14,-4
13,26,156,17,8,9
13,26,157,12,7,5
13,26,158,19,21,-2
13,26,159,14,22,-8
13,26,160,9,9,0
13,26,161,22,10,12
13,26,162,15,15,0
13,26,163,16,5,11
13,26,164,16,12,4
13,26,165,26,19,7
13,26,166,12,18,-6
13,26,167,12,14,-2
13,26,168,28,13,15
13,26,169,15,7,8
13,26,170,17,12,5
13,26,171,11,2,9
13,26,172,12,20,-8
13,26,173,15,13,2
13,26,174,18,10,8
13,26,175,11,7,4
13,26,176,17,12,5
13,26,177,16,11,5
13,26,178,12,13,-1
13,26,179,15,14,1
13,26,180,25,11,14
13,26,181,15,10,5
13,26,182,26,12,14
13,26,183,12,19,-7
13,26,184,24,12,12
13,26,185,20,13,7
13,26,186,15,12,3
13,26,187,6,5,1
13,26,188,29,20,9
13,26,189,13,12,1
13,26,190,13,17,-4
13,26,191,18,10,8
13,26,192,18,12,6
13,26,193,17,12,5
13,26,194,26,18,8
13,26,195,18,16,2
13,26,196,10,12,-2
13,26,197,15,5,10
13,26,198,10,20,-10
13,26,199,21,13,8
13,26,200,8,0,8
13,26,201,26,18,8
13,26,202,20,20,0
13,26,203,17,26,-9
13,26,204,14,15,-1
13,26,205,19,15,4
13,26,206,22,14,8
13,26,207,12,15,-3
13,26,208,11,8,3
13,26,209,17,9,8
13,26,210,20,23,-3
13,26,211,16,9,7
13,26,212,15,15,0
13,26,213,16,9,7
13,26,214,21,10,11
13,26,215,20,7,13
13,26,216,12,7,5
13,26,217,24,14,10
13,26,218,9,15,-6
13,26,219,15,13,2
13,26,220,27,13,14
13,26,221,27,20,7
13,26,222,12,27,-15
13,26,223,8,12,-4
13,26,224,8,12,-4
13,26,225,17,6,11
13,26,226,13,13,0
13,26,227,27,9,18
13,26,228,20,27,-7
13,26,229,21,20,1
13,26,230,26,20,6
13,26,231,8,26,-18
13,26,232,18,6,12
13,26,233,10,12,-2
13,26,234,26,10,16
13,26,235,26,10,16
13,26,236,20,12,8
13,26,237,8,9,-1
13,26,238,15,23,-8
13,26,239,27,13,14
13,26,240,15,19,-4
13,26,241,22,30,-8
13,26,242,24,14,10
13,26,243,17,16,1
13,26,244,5,8,-3
13,26,245,25,18,7
13,26,246,18,4,14
13,26,247,3,11,-8
13,26,248,12,6,6
13,26,249,7,8,-1
13,26,250,6,7,-1
13,26,251,17,17,0
13,26,252,17,18,-1
13,26,253,13,4,9
13,26,254,12,12,0
13,26,255,14,11,3
13,26,256,5,6,-1
13,26,257,27,24,3
13,26,258,26,9,17
13,26,259,11,9,2
13,26,260,22,10,12
13,26,261,9,13,-4
13,26,262,17,8,9
13,26,263,19,10,9
13,26,264,19,15,4
13,26,265,10,14,-4
13,26,266,8,9,-1
13,26,267,9,7,2
13,26,268,12,13,-1
13,26,269,19,10,9
13,26,270,14,7,7
13,26,271,8,14,-6
13,26,272,15,8,7
13,26,273,20,12,8
13,26,274,14,2,12
13,26,275,13,6,7
13,26,276,13,17,-4
13,26,277,8,14,-6
13,26,278,18,16,2
13,26,279,22,21,1
13,26,280,17,8,9
13,26,281,7,2,5
13,26,282,37,20,17
13,26,283,18,12,6
13,26,284,33,18,15
13,26,285,3,5,-2
13,26,286,20,7,13
13,26,287,15,13,2
13,26,288,15,11,4
13,26,289,10,9,1
13,26,290,10,4,6
13,26,291,12,4,8
13,26,292,14,11,3
13,26,293,25,18,7
13,26,294,17,3,14
13,26,295,15,4,11
13,26,296,26,15,11
13,26,297,21,8,13
13,26,298,7,9,-2
13,26,299,15,18,-3
13,27,0,17,17,0
13,27,1,17,16,1
13,27,2,26,14,12
13,27,3,16,11,5
13,27,4,26,12,14
13,27,5,15,7,8
13,27,6,14,5,9
13,27,7,12,14,-2
13,27,8,16,9,7
13,27,9,18,7,11
13,27,10,6,7,-1
13,27,11,25,6,19
13,27,12,18,15,3
13,27,13,29,17,12
13,27,14,6,4,2
13,27,15,24,8,16
13,27,16,21,6,15
13,27,17,17,4,13
13,27,18,13,6,7
13,27,19,22,10,12
13,27,20,16,9,7
13,27,21,26,17,9
13,27,22,20,13,7
13,27,23,13,22,-9
13,27,24,20,9,11
13,27,25,18,13,5
13,27,26,12,11,1
13,27,27,7,5,2
13,27,28,22,16,6
13,27,29,24,13,11
13,27,30,13,11,2
13,27,31,23,11,12
13,27,32,24,18,6
13,27,33,10,16,-6
13,27,34,7,9,-2
13,27,35,14,23,-9
13,27,36,14,13,1
13,27,37,19,11,8
13,27,38,21,15,6
13,27,39,22,6,16
13,27,40,17,23,-6
13,27,41,13,12,1
13,27,42,30,14,16
13,27,43,12,10,2
13,27,44,18,17,1
13,27,45,19,19,0
13,27,46,15,3,12
13,27,47,8,10,-2
13,27,48,14,11,3
13,27,49,11,13,-2
13,27,50,16,9,7
13,27,51,13,9,4
13,27,52,24,6,18
13,27,53,13,9,4
13,27,54,12,13,-1
13,27,55,17,15,2
13,27,56,11,14,-3
13,27,57,12,11,1
13,27,58,19,4,15
13,27,59,14,9,5
13,27,60,17,11,6
13,27,61,15,16,-1
13,27,62,11,10,1
13,27,63,20,10,10
13,27,64,10,7,3
13,27,65,13,16,-3
13,27,66,21,14,7
13,27,67,23,13,10
13,27,68,13,9,4
13,27,69,12,18,-6
13,27,70,17,11,6
13,27,71,25,20,5
13,27,72,35,11,24
13,27,73,18,16,2
13,27,74,16,10,6
13,27,75,25,16,9
13,27,76,12,9,3
13,27,77,13,23,-10
13,27,78,11,7,4
13,27,79,15,20,-5
13,27,80,22,16,6
13,27,81,17,10,7
13,27,82,14,14,0
13,27,83,11,10,1
13,27,84,13,9,4
13,27,85,26,11,15
13,27,86,29,16,13
13,27,87,20,10,10
13,27,88,15,13,2
13,27,89,25,19,6
13,27,90,18,8,10
13,27,91,12,4,8
13,27,92,15,4,11
13,27,93,20,9,11
13,27,94,12,5,7
13,27,95,14,5,9
13,27,96,14,6,8
13,27,97,17,9,8
13,27,98,17,12,5
13,27,99,18,11,7
13,27,100,18,17,1
13,27,101,11,10,1
13,27,102,22,14,8
13,27,103,12,4,8
13,27,104,15,24,-9
13,27,105,14,9,5
13,27,106,23,8,15
13,27,107,16,12,4
13,27,108,17,8,9
13,27,109,15,16,-1
13,27,110,22,9,13
13,27,111,15,18,-3
13,27,112,19,12,7
13,27,113,18,16,2
13,27,114,29,14,15
13,27,115,15,12,3
13,27,116,22,6,16
13,27,117,9,16,-7
13,27,118,20,7,13
13,27,119,17,9,8
13,27,120,30,15,15
13,27,121,16,11,5
13,27,122,23,20,3
13,27,123,13,2,11
13,27,124,23,9,14
13,27,125,24,10,14
13,27,126,20,14,6
13,27,127,14,4,10
13,27,128,17,12,5
13,27,129,28,18,10
13,27,130,18,5,13
13,27,131,9,14,-5
13,27,132,22,13,9
13,27,133,13,21,-8
13,27,134,14,10,4
13,27,135,12,16,-4
13,27,136,8,6,2
13,27,137,36,12,24
13,27,138,16,19,-3
13,27,139,27,15,12
13,27,140,13,8,5
13,27,141,17,15,2
13,27,142,15,7,8
13,27,143,13,9,4
13,27,144,4,9,-5
13,27,145,20,9,11
13,27,146,18,15,3
13,27,147,16,30,-14
13,27,148,8,12,-4
13,27,149,14,4,10
13,27,150,20,13,7
13,27,151,11,5,6
13,27,152,9,6,3
13,27,153,13,24,-11
13,27,154,8,16,-8
13,27,155,26,12,14
13,27,156,11,7,4
13,27,157,16,19,-3
13,27,158,21,18,3
13,27,159,23,23,0
13,27,160,28,5,23
13,27,161,9,7,2
13,27,162,25,9,16
13,27,163,19,12,7
13,27,164,20,8,12
13,27,165,17,9,8
13,27,166,9,4,5
13,27,167,13,10,3
13,27,168,11,10,1
13,27,169,21,11,10
13,27,170,28,6,22
13,27,171,22,11,11
13,27,172,9,8,1
13,27,173,10,20,-10
13,27,174,16,16,0
13,27,175,19,14,5
13,27,176,11,6,5
13,27,177,24,12,12
13,27,178,13,8,5
13,27,179,21,11,10
13,27,180,18,10,8
13,27,181,28,7,21
13,27,182,25,14,11
13,27,183,27,9,18
13,27,184,17,24,-7
13,27,185,16,16,0
13,27,186,26,7,19
13,27,187,21,14,7
13,27,188,11,5,6
13,27,189,10,4,6
13,27,190,20,10,10
13,27,191,31,15,16
13,27,192,11,9,2
13,27,193,25,12,13
13,27,194,14,8,6
13,27,195,11,7,4
13,27,196,25,19,6
13,27,197,17,15,2
13,27,198,16,12,4
13,27,199,15,14,1
13,27,200,10,10,0
13,27,201,17,10,7
13,27,202,24,17,7
13,27,203,28,15,13
13,27,204,18,18,0
13,27,205,31,14,17
13,27,206,12,12,0
13,27,207,24,10,14
13,27,208,14,11,3
13,27,209,27,5,22
13,27,210,16,12,4
13,27,211,18,13,5
13,27,212,36,16,20
13,27,213,31,17,14
13,27,214,22,21,1
13,27,215,18,20,-2
13,27,216,14,17,-3
13,27,217,26,15,11
13,27,218,17,19,-2
13,27,219,18,22,-4
13,27,220,36,14,22
13,27,221,30,8,22
13,27,222,13,9,4
13,27,223,23,21,2
13,27,224,12,9,3
13,27,225,17,14,3
13,27,226,9,6,3
13,27,227,23,5,18
13,27,228,14,10,4
13,27,229,15,17,-2
13,27,230,22,13,9
13,27,231,20,6,14
13,27,232,26,10,16
13,27,233,11,9,2
13,27,234,22,7,15
13,27,235,21,11,10
13,27,236,19,11,8
13,27,237,36,14,22
13,27,238,21,16,5
13,27,239,21,11,10
13,27,240,21,6,15
13,27,241,20,11,9
13,27,242,17,14,3
13,27,243,9,20,-11
13,27,244,16,12,4
13,27,245,15,7,8
13,27,246,9,11,-2
13,27,247,22,10,12
13,27,248,9,20,-11
13,27,249,9,28,-19
13,27,250,10,9,1
13,27,251,14,12,2
13,27,252,17,14,3
13,27,253,15,2,13
13,27,254,17,13,4
13,27,255,9,17,-8
13,27,256,18,19,-1
13,27,257,15,11,4
13,27,258,15,9,6
13,27,259,15,13,2
13,27,260,27,11,16
13,27,261,13,9,4
13,27,262,17,13,4
13,27,263,17,12,5
13,27,264,21,6,15
13,27,265,21,25,-4
13,27,266,22,7,15
13,27,267,12,7,5
13,27,268,19,14,5
13,27,269,16,24,-8
13,27,270,31,21,10
13,27,271,17,11,6
13,27,272,14,10,4
13,27,273,11,11,0
13,27,274,18,11,7
13,27,275,20,25,-5
13,27,276,11,18,-7
13,27,277,18,15,3
13,27,278,19,19,0
13,27,279,12,18,-6
13,27,280,11,7,4
13,27,281,14,10,4
13,27,282,13,7,6
13,27,283,18,16,2
13,27,284,22,7,15
13,27,285,9,15,-6
13,27,286,23,13,10
13,27,287,13,14,-1
13,27,288,12,8,4
13,27,289,22,7,15
13,27,290,19,11,8
13,27,291,9,15,-6
13,27,292,39,12,27
13,27,293,15,9,6
13,27,294,21,14,7
13,27,295,10,9,1
13,27,296,12,11,1
13,27,297,19,7,12
13,27,298,26,11,15
13,27,299,9,18,-9
13,28,0,25,21,4
13,28,1,24,23,1
13,28,2,27,18,9
13,28,3,29,12,17
13,28,4,15,9,6
13,28,5,9,8,1
13,28,6,25,13,12
13,28,7,23,10,13
13,28,8,19,3,16
13,28,9,10,11,-1
13,28,10,14,16,-2
13,28,11,15,11,4
13,28,12,24,14,10
13,28,13,20,8,12
13,28,14,6,2,4
13,28,15,13,6,7
13,28,16,31,16,15
13,28,17,23,9,14
13,28,18,30,6,24
13,28,19,21,9,12
13,28,20,14,5,9
13,28,21,21,13,8
13,28,22,6,13,-7
13,28,23,27,22,5
13,28,24,35,18,17
13,28,25,19,8,11
13,28,26,4,7,-3
13,28,27,11,11,0
13,28,28,11,17,-6
13,28,29,29,13,16
13,28,30,13,2,11
13,28,31,21,12,9
13,28,32,24,18,6
13,28,33,21,4,17
13,28,34,14,11,3
13,28,35,17,7,10
13,28,36,28,11,17
13,28,37,18,17,1
13,28,38,14,10,4
13,28,39,15,14,1
13,28,40,19,17,2
13,28,41,4,4,0
13,28,42,18,11,7
13,28,43,25,9,16
13,28,44,27,11,16
13,28,45,31,21,10
13,28,46,17,7,10
13,28,47,24,14,10
13,28,48,14,9,5
13,28,49,17,8,9
13,28,50,13,12,1
13,28,51,23,12,11
13,28,52,17,14,3
13,28,53,22,15,7
13,28,54,18,13,5
13,28,55,18,16,2
13,28,56,25,16,9
13,28,57,20,10,10
13,28,58,20,5,15
13,28,59,14,13,1
13,28,60,23,13,10
13,28,61,20,8,12
13,28,62,6,14,-8
13,28,63,24,20,4
13,28,64,17,17,0
13,28,65,16,19,-3
13,28,66,18,9,9
13,28,67,23,9,14
13,28,68,16,8,8
13,28,69,24,8,16
13,28,70,6,7,-1
13,28,71,31,22,9
13,28,72,24,10,14
13,28,73,26,16,10
13,28,74,20,13,7
13,28,75,21,15,6
13,28,76,22,15,7
13,28,77,2,10,-8
13,28,78,18,15,3
13,28,79,5,11,-6
13,28,80,17,4,13
13,28,81,21,9,12
13,28,82,18,11,7
13,28,83,22,9,13
13,28,84,14,12,2
13,28,85,29,9,20
13,28,86,14,17,-3
13,28,87,34,12,22
13,28,88,24,16,8
13,28,89,19,15,4
13,28,90,19,9,10
13,28,91,25,15,10
13,28,92,13,10,3
13,28,93,15,11,4
13,28,94,16,20,-4
13,28,95,20,5,15
13,28,96,17,13,4
13,28,97,20,7,13
13,28,98,26,15,11
13,28,99,22,6,16
13,28,100,25,7,18
13,28,101,17,7,10
13,28,102,16,4,12
13,28,103,22,11,11
13,28,104,19,14,5
13,28,105,15,8,7
13,28,106,21,8,13
13,28,107,38,9,29
13,28,108,20,25,-5
13,28,109,27,12,15
13,28,110,13,10,3
13,28,111,20,12,8
13,28,112,14,8,6
13,28,113,14,7,7
13,28,114,15,12,3
13,28,115,15,15,0
13,28,116,21,9,12
13,28,117,20,19,1
13,28,118,20,15,5
13,28,119,23,14,9
13,28,120,15,8,7
13,28,121,12,2,10
13,28,122,23,22,1
13,28,123,17,12,5
13,28,124,21,25,-4
13,28,125,9,7,2
13,28,126,22,4,18
13,28,127,21,20,1
13,28,128,30,17,13
13,28,129,27,15,12
13,28,130,8,17,-9
13,28,131,15,15,0
13,28,132,7,6,1
13,28,133,28,11,17
13,28,134,17,11,6
13,28,135,16,6,10
13,28,136,12,7,5
13,28,137,16,17,-1
13,28,138,13,10,3
13,28,139,7,14,-7
13,28,140,12,15,-3
13,28,141,34,8,26
13,28,142,9,15,-6
13,28,143,19,12,7
13,28,144,19,5,14
13,28,145,25,17,8
13,28,146,10,15,-5
13,28,147,17,12,5
13,28,148,16,4,12
13,28,149,29,6,23
13,28,150,18,12,6
13,28,151,14,13,1
13,28,152,17,12,5
13,28,153,23,19,4
13,28,154,9,4,5
13,28,155,14,3,11
13,28,156,11,12,-1
13,28,157,21,14,7
13,28,158,28,5,23
13,28,159,17,8,9
13,28,160,19,19,0
13,28,161,20,9,11
13,28,162,22,10,12
13,28,163,25,13,12
13,28,164,15,4,11
13,28,165,14,9,5
13,28,166,25,19,6
13,28,167,15,7,8
13,28,168,19,7,12
13,28,169,19,7,12
13,28,170,26,18,8
13,28,171,27,21,6
13,28,172,16,19,-3
13,28,173,7,18,-11
13,28,174,23,14,9
13,28,175,18,6,12
13,28,176,18,16,2
13,28,177,16,13,3
13,28,178,19,10,9
13,28,179,30,1,29
13,28,180,9,14,-5
13,28,181,15,5,10
13,28,182,14,11,3
13,28,183,26,12,14
13,28,184,26,11,15
13,28,185,18,12,6
13,28,186,11,9,2
13,28,187,8,18,-10
13,28,188,16,14,2
13,28,189,21,14,7
13,28,190,29,14,15
13,28,191,7,10,-3
13,28,192,10,5,5
13,28,193,27,15,12
13,28,194,5,16,-11
13,28,195,24,8,16
13,28,196,17,17,0
13,28,197,14,6,8
13,28,198,5,9,-4
13,28,199,19,12,7
13,28,200,28,19,9
13,28,201,11,8,3
13,28,202,20,9,11
13,28,203,20,4,16
13,28,204,8,6,2
13,28,205,16,6,10
13,28,206,13,4,9
13,28,207,20,5,15
13,28,208,13,12,1
13,28,209,16,8,8
13,28,210,14,18,-4
13,28,211,16,5,11
13,28,212,26,14,12
13,28,213,21,5,16
13,28,214,8,12,-4
13,28,215,9,7,2
13,28,216,22,9,13
13,28,217,8,10,-2
13,28,218,14,11,3
13,28,219,24,19,5
13,28,220,25,16,9
13,28,221,8,9,-1
13,28,222,18,15,3
13,28,223,20,11,9
13,28,224,23,8,15
13,28,225,22,7,15
13,28,226,9,4,5
13,28,227,28,15,13
13,28,228,21,3,18
13,28,229,20,22,-2
13,28,230,12,9,3
13,28,231,18,10,8
13,28,232,17,8,9
13,28,233,26,5,21
13,28,234,28,10,18
13,28,235,34,14,20
13,28,236,30,21,9
13,28,237,20,13,7
13,28,238,10,10,0
13,28,239,32,10,22
13,28,240,10,9,1
13,28,241,6,9,-3
13,28,242,20,6,14
13,28,243,18,8,10
13,28,244,16,14,2
13,28,245,14,7,7
13,28,246,21,19,2
13,28,247,10,15,-5
13,28,248,10,9,1
13,28,249,22,12,10
13,28,250,15,3,12
13,28,251,11,8,3
13,28,252,25,21,4
13,28,253,20,13,7
13,28,254,16,13,3
13,28,255,18,9,9
13,28,256,22,10,12
13,28,257,9,8,1
13,28,258,15,14,1
13,28,259,13,14,-1
13,28,260,22,15,7
13,28,261,22,8,14
13,28,262,18,10,8
13,28,263,13,17,-4
13,28,264,15,12,3
13,28,265,12,6,6
13,28,266,19,15,4
13,28,267,15,16,-1
13,28,268,19,7,12
13,28,269,7,10,-3
13,28,270,9,4,5
13,28,271,14,11,3
13,28,272,20,9,11
13,28,273,20,13,7
13,28,274,18,8,10
13,28,275,18,19,-1
13,28,276,21,8,13
13,28,277,19,15,4
13,28,278,22,6,16
13,28,279,19,4,15
13,28,280,22,11,11
13,28,281,11,8,3
13,28,282,8,11,-3
13,28,283,21,18,3
13,28,284,13,10,3
13,28,285,21,17,4
13,28,286,13,17,-4
13,28,287,14,18,-4
13,28,288,28,26,2
13,28,289,17,13,4
13,28,290,18,15,3
13,28,291,19,15,4
13,28,292,11,8,3
13,28,293,19,12,7
13,28,294,16,22,-6
13,28,295,26,5,21
13,28,296,20,16,4
13,28,297,14,12,2
13,28,298,14,17,-3
13,28,299,22,12,10
13,29,0,17,14,3
13,29,1,12,18,-6
13,29,2,35,14,21
13,29,3,16,12,4
13,29,4,3,4,-1
13,29,5,16,9,7
13,29,6,15,10,5
13,29,7,17,11,6
13,29,8,24,17,7
13,29,9,23,9,14
13,29,10,8,10,-2
13,29,11,27,15,12
13,29,12,4,9,-5
13,29,13,16,16,0
13,29,14,7,2,5
13,29,15,16,20,-4
13,29,16,16,8,8
13,29,17,13,9,4
13,29,18,27,12,15
13,29,19,19,17,2
13,29,20,15,20,-5
13,29,21,14,10,4
13,29,22,11,12,-1
13,29,23,28,8,20
13,29,24,15,13,2
13,29,25,19,11,8
13,29,26,21,6,15
13,29,27,17,5,12
13,29,28,32,13,19
13,29,29,24,16,8
13,29,30,16,17,-1
13,29,31,25,9,16
13,29,32,12,15,-3
13,29,33,21,10,11
13,29,34,22,20,2
13,29,35,21,17,4
13,29,36,17,15,2
13,29,37,14,8,6
13,29,38,20,12,8
13,29,39,14,10,4
13,29,40,23,19,4
13,29,41,18,9,9
13,29,42,14,19,-5
13,29,43,21,18,3
13,29,44,18,0,18
13,29,45,18,19,-1
13,29,46,6,4,2
13,29,47,13,10,3
13,29,48,17,10,7
13,29,49,15,10,5
13,29,50,19,4,15
13,29,51,28,9,19
13,29,52,15,3,12
13,29,53,16,7,9
13,29,54,24,15,9
13,29,55,5,12,-7
13,29,56,20,18,2
13,29,57,16,15,1
13,29,58,19,22,-3
13,29,59,21,8,13
13,29,60,6,13,-7
13,29,61,12,11,1
13,29,62,13,5,8
13,29,63,14,6,8
13,29,64,2,10,-8
13,29,65,16,17,-1
13,29,66,19,8,11
13,29,67,13,17,-4
13,29,68,18,29,-11
13,29,69,11,9,2
13,29,70,15,19,-4
13,29,71,13,9,4
13,29,72,5,9,-4
13,29,73,14,8,6
13,29,74,18,6,12
13,29,75,36,13,23
13,29,76,11,4,7
13,29,77,10,7,3
13,29,78,22,13,9
13,29,79,15,16,-1
13,29,80,11,11,0
13,29,81,15,5,10
13,29,82,23,13,10
13,29,83,16,18,-2
13,29,84,22,14,8
13,29,85,24,6,18
13,29,86,13,14,-1
13,29,87,10,13,-3
13,29,88,22,20,2
13,29,89,18,17,1
13,29,90,24,13,11
13,29,91,13,10,3
13,29,92,9,15,-6
13,29,93,19,14,5
13,29,94,21,4,17
13,29,95,25,9,16
13,29,96,10,10,0
13,29,97,24,18,6
13,29,98,37,8,29
13,29,99,16,11,5
13,29,100,23,17,6
13,29,101,18,8,10
13,29,102,18,12,6
13,29,103,18,5,13
13,29,104,17,8,9
13,29,105,15,16,-1
13,29,106,13,11,2
13,29,107,16,9,7
13,29,108,21,12,9
13,29,109,23,5,18
13,29,110,11,19,-8
13,29,111,10,8,2
13,29,112,18,8,10
13,29,113,12,13,-1
13,29,114,5,14,-9
13,29,115,17,13,4
13,29,116,21,27,-6
13,29,117,16,8,8
13,29,118,12,19,-7
13,29,119,25,21,4
13,29,120,18,10,8
13,29,121,32,26,6
13,29,122,25,10,15
13,29,123,13,6,7
13,29,124,16,9,7
13,29,125,17,10,7
13,29,126,11,16,-5
13,29,127,25,7,18
13,29,128,18,13,5
13,29,129,19,5,14
13,29,130,16,8,8
13,29,131,11,16,-5
13,29,132,25,11,14
13,29,133,16,22,-6
13,29,134,25,17,8
13,29,135,7,17,-10
13,29,136,17,10,7
13,29,137,20,12,8
13,29,138,21,16,5
13,29,139,27,11,16
13,29,140,30,2,28
13,29,141,15,16,-1
13,29,142,17,5,12
13,29,143,15,15,0
13,29,144,19,9,10
13,29,145,26,11,15
13,29,146,21,13,8
13,29,147,14,15,-1
13,29,148,6,11,-5
13,29,149,17,13,4
13,29,150,20,7,13
13,29,151,15,17,-2
13,29,152,17,11,6
13,29,153,27,5,22
13,29,154,20,20,0
13,29,155,13,2,11
13,29,156,9,6,3
13,29,157,8,3,5
13,29,158,5,3,2
13,29,159,15,18,-3
13,29,160,3,4,-1
13,29,161,36,7,29
13,29,162,17,16,1
13,29,163,18,25,-7
13,29,164,18,13,5
13,29,165,15,16,-1
13,29,166,13,11,2
13,29,167,28,20,8
13,29,168,17,8,9
13,29,169,18,10,8
13,29,170,22,20,2
13,29,171,18,6,12
13,29,172,14,20,-6
13,29,173,24,17,7
13,29,174,17,15,2
13,29,175,19,19,0
13,29,176,17,10,7
13,29,177,29,7,22
13,29,178,22,11,11
13,29,179,25,27,-2
13,29,180,20,14,6
13,29,181,11,9,2
13,29,182,13,16,-3
13,29,183,14,8,6
13,29,184,20,22,-2
13,29,185,21,14,7
13,29,186,18,5,13
13,29,187,24,19,5
13,29,188,12,14,-2
13,29,189,16,5,11
13,29,190,14,14,0
13,29,191,26,11,15
13,29,192,20,11,9
13,29,193,18,14,4
13,29,194,24,10,14
13,29,195,35,16,19
13,29,196,17,7,10
13,29,197,20,12,8
13,29,198,22,11,11
13,29,199,20,22,-2
13,29,200,24,23,1
13,29,201,14,14,0
13,29,202,9,13,-4
13,29,203,6,2,4
13,29,204,14,4,10
13,29,205,8,11,-3
13,29,206,14,9,5
13,29,207,23,10,13
13,29,208,19,19,0
13,29,209,30,13,17
13,29,210,14,16,-2
13,29,211,13,14,-1
13,29,212,37,10,27
13,29,213,14,15,-1
13,29,214,24,18,6
13,29,215,14,9,5
13,29,216,7,9,-2
13,29,217,28,14,14
13,29,218,13,14,-1
13,29,219,21,19,2
13,29,220,20,7,13
13,29,221,21,8,13
13,29,222,26,12,14
13,29,223,20,13,7
13,29,224,11,9,2
13,29,225,17,7,10
13,29,226,22,12,10
13,29,227,18,9,9
13,29,228,22,19,3
13,29,229,25,4,21
13,29,230,11,7,4
13,29,231,6,7,-1
13,29,232,33,13,20
13,29,233,17,13,4
13,29,234,27,21,6
13,29,235,23,7,16
13,29,236,25,6,19
13,29,237,10,9,1
13,29,238,21,7,14
13,29,239,22,12,10
13,29,240,16,7,9
13,29,241,12,10,2
13,29,242,24,9,15
13,29,243,12,3,9
13,29,244,22,12,10
13,29,245,29,19,10
13,29,246,19,13,6
13,29,247,17,12,5
13,29,248,8,16,-8
13,29,249,18,6,12
13,29,250,11,15,-4
13,29,251,14,10,4
13,29,252,14,14,0
13,29,253,15,11,4
13,29,254,20,9,11
13,29,255,31,14,17
13,29,256,13,6,7
13,29,257,14,10,4
13,29,258,13,9,4
13,29,259,17,6,11
13,29,260,7,6,1
13,29,261,17,17,0
13,29,262,21,7,14
13,29,263,10,12,-2
13,29,264,15,8,7
13,29,265,16,12,4
13,29,266,20,15,5
13,29,267,25,16,9
13,29,268,25,9,16
13,29,269,18,20,-2
13,29,270,13,11,2
13,29,271,18,1,17
13,29,272,19,6,13
13,29,273,19,10,9
13,29,274,5,4,1
13,29,275,28,26,2
13,29,276,12,24,-12
13,29,277,20,12,8
13,29,278,17,10,7
13,29,279,27,16,11
13,29,280,7,5,2
13,29,281,17,7,10
13,29,282,21,16,5
13,29,283,24,17,7
13,29,284,24,14,10
13,29,285,18,12,6
13,29,286,12,15,-3
13,29,287,19,12,7
13,29,288,16,10,6
13,29,289,31,18,13
13,29,290,13,7,6
13,29,291,22,21,1
13,29,292,13,15,-2
13,29,293,20,13,7
13,29,294,31,10,21
13,29,295,19,15,4
13,29,296,23,16,7
13,29,297,17,16,1
13,29,298,22,7,15
13,29,299,6,3,3
13,30,0,39,3,36
13,30,1,15,14,1
13,30,2,18,16,2
13,30,3,13,5,8
13,30,4,15,12,3
13,30,5,14,3,11
13,30,6,19,12,7
13,30,7,16,8,8
13,30,8,12,6,6
13,30,9,17,8,9
13,30,10,32,15,17
13,30,11,12,8,4
13,30,12,17,11,6
13,30,13,5,20,-15
13,30,14,15,11,4
13,30,15,10,14,-4
13,30,16,19,13,6
13,30,17,11,6,5
13,30,18,29,13,16
13,30,19,20,23,-3
13,30,20,17,15,2
13,30,21,11,8,3
13,30,22,17,19,-2
13,30,23,7,13,-6
13,30,24,12,8,4
13,30,25,29,11,18
13,30,26,24,22,2
13,30,27,21,16,5
13,30,28,27,12,15
13,30,29,21,7,14
13,30,30,13,10,3
13,30,31,12,11,1
13,30,32,17,12,5
13,30,33,22,17,5
13,30,34,15,18,-3
13,30,35,19,18,1
13,30,36,23,16,7
13,30,37,16,3,13
13,30,38,20,8,12
13,30,39,30,7,23
13,30,40,30,17,13
13,30,41,15,11,4
13,30,42,32,18,14
13,30,43,39,16,23
13,30,44,22,9,13
13,30,45,11,11,0
13,30,46,14,6,8
13,30,47,16,4,12
13,30,48,10,15,-5
13,30,49,23,15,8
13,30,50,16,9,7
13,30,51,25,21,4
13,30,52,18,6,12
13,30,53,14,17,-3
13,30,54,13,9,4
13,30,55,21,10,11
13,30,56,13,20,-7
13,30,57,24,16,8
13,30,58,16,9,7
13,30,59,27,17,10
13,30,60,22,7,15
13,30,61,26,6,20
13,30,62,24,11,13
13,30,63,19,15,4
13,30,64,23,10,13
13,30,65,11,5,6
13,30,66,15,12,3
13,30,67,10,7,3
13,30,68,21,6,15
13,30,69,10,14,-4
13,30,70,18,12,6
13,30,71,17,15,2
13,30,72,12,3,9
13,30,73,21,31,-10
13,30,74,8,6,2
13,30,75,12,13,-1
13,30,76,24,26,-2
13,30,77,22,6,16
13,30,78,14,10,4
13,30,79,22,9,13
13,30,80,25,13,12
13,30,81,25,18,7
13,30,82,19,14,5
13,30,83,28,3,25
13,30,84,16,12,4
13,30,85,22,23,-1
13,30,86,30,18,12
13,30,87,14,15,-1
13,30,88,25,16,9
13,30,89,8,6,2
13,30,90,24,12,12
13,30,91,19,23,-4
13,30,92,6,15,-9
13,30,93,23,10,13
13,30,94,29,17,12
13,30,95,13,10,3
13,30,96,24,16,8
13,30,97,18,10,8
13,30,98,13,8,5
13,30,99,24,10,14
13,30,100,17,6,11
13,30,101,21,11,10
13,30,102,21,7,14
13,30,103,7,18,-11
13,30,104,13,8,5
13,30,105,24,22,2
13,30,106,15,9,6
13,30,107,28,7,21
13,30,108,9,9,0
13,30,109,23,7,16
13,30,110,25,10,15
13,30,111,13,5,8
13,30,112,33,11,22
13,30,113,18,19,-1
13,30,114,7,11,-4
13,30,115,30,12,18
13,30,116,4,4,0
13,30,117,23,20,3
13,30,118,31,18,13
13,30,119,32,15,17
13,30,120,15,4,11
13,30,121,15,21,-6
13,30,122,19,11,8
13,30,123,14,12,2
13,30,124,16,13,3
13,30,125,23,9,14
13,30,126,17,11,6
13,30,127,15,14,1
13,30,128,18,12,6
13,30,129,8,8,0
13,30,130,13,4,9
13,30,131,17,17,0
13,30,132,9,4,5
13,30,133,25,10,15
13,30,134,21,12,9
13,30,135,13,3,10
13,30,136,23,19,4
13,30,137,26,14,12
13,30,138,22,9,13
13,30,139,16,5,11
13,30,140,10,2,8
13,30,141,12,15,-3
13,30,142,19,10,9
13,30,143,16,11,5
13,30,144,20,16,4
13,30,145,18,21,-3
13,30,146,20,10,10
13,30,147,21,13,8
13,30,148,16,8,8
13,30,149,25,15,10
13,30,150,11,20,-9
13,30,151,29,7,22
13,30,152,18,15,3
13,30,153,12,15,-3
13,30,154,21,24,-3
13,30,155,14,22,-8
13,30,156,17,3,14
13,30,157,16,9,7
13,30,158,10,14,-4
13,30,159,22,14,8
13,30,160,10,14,-4
13,30,161,17,16,1
13,30,162,19,16,3
13,30,163,22,6,16
13,30,164,17,13,4
13,30,165,12,11,1
13,30,166,11,20,-9
13,30,167,13,10,3
13,30,168,25,22,3
13,30,169,21,12,9
13,30,170,32,24,8
13,30,171,19,18,1
13,30,172,17,16,1
13,30,173,16,13,3
13,30,174,21,11,10
13,30,175,20,14,6
13,30,176,18,7,11
13,30,177,17,3,14
13,30,178,20,8,12
13,30,179,9,4,5
13,30,180,14,3,11
13,30,181,29,11,18
13,30,182,22,19,3
13,30,183,16,14,2
13,30,184,15,15,0
13,30,185,14,13,1
13,30,186,36,14,22
13,30,187,7,7,0
13,30,188,19,22,-3
13,30,189,19,5,14
13,30,190,14,13,1
13,30,191,17,11,6
13,30,192,20,11,9
13,30,193,25,7,18
13,30,194,15,16,-1
13,30,195,20,15,5
13,30,196,13,9,4
13,30,197,20,6,14
13,30,198,22,10,12
13,30,199,13,8,5
13,30,200,27,7,20
13,30,201,6,11,-5
13,30,202,20,15,5
13,30,203,17,12,5
13,30,204,36,13,23
13,30,205,23,10,13
13,30,206,13,15,-2
13,30,207,31,12,19
13,30,208,27,17,10
13,30,209,19,8,11
13,30,210,10,9,1
13,30,211,10,9,1
13,30,212,14,5,9
13,30,213,24,12,12
13,30,214,14,12,2
13,30,215,13,14,-1
13,30,216,11,4,7
13,30,217,17,7,10
13,30,218,33,15,18
13,30,219,20,14,6
13,30,220,16,13,3
13,30,221,21,17,4
13,30,222,24,15,9
13,30,223,14,13,1
13,30,224,19,7,12
13,30,225,14,8,6
13,30,226,18,6,12
13,30,227,22,8,14
13,30,228,20,4,16
13,30,229,21,10,11
13,30,230,12,11,1
13,30,231,19,10,9
13,30,232,14,4,10
13,30,233,15,14,1
13,30,234,8,3,5
13,30,235,16,5,11
13,30,236,17,13,4
13,30,237,14,13,1
13,30,238,17,11,6
13,30,239,16,15,1
13,30,240,13,9,4
13,30,241,6,3,3
13,30,242,33,12,21
13,30,243,28,9,19
13,30,244,7,12,-5
13,30,245,18,11,7
13,30,246,13,17,-4
13,30,247,13,5,8
13,30,248,19,10,9
13,30,249,31,14,17
13,30,250,25,10,15
13,30,251,10,7,3
13,30,252,22,17,5
13,30,253,19,11,8
13,30,254,23,22,1
13,30,255,23,10,13
13,30,256,9,6,3
13,30,257,13,10,3
13,30,258,13,4,9
13,30,259,31,14,17
13,30,260,17,6,11
13,30,261,15,6,9
13,30,262,14,14,0
13,30,263,17,13,4
13,30,264,11,11,0
13,30,265,22,13,9
13,30,266,7,5,2
13,30,267,9,7,2
13,30,268,10,18,-8
13,30,269,31,15,16
13,30,270,22,5,17
13,30,271,16,12,4
13,30,272,8,3,5
13,30,273,19,12,7
13,30,274,27,17,10
13,30,275,29,19,10
13,30,276,10,7,3
13,30,277,26,23,3
13,30,278,13,3,10
13,30,279,16,13,3
13,30,280,24,11,13
13,30,281,19,8,11
13,30,282,25,3,22
13,30,283,17,10,7
13,30,284,35,6,29
13,30,285,27,16,11
13,30,286,12,3,9
13,30,287,32,19,13
13,30,288,12,18,-6
13,30,289,28,7,21
13,30,290,22,9,13
13,30,291,26,13,13
13,30,292,20,7,13
13,30,293,19,8,11
13,30,294,24,11,13
13,30,295,25,14,11
13,30,296,18,15,3
13,30,297,14,9,5
13,30,298,24,12,12
13,30,299,8,7,1
14,1,0,7,16,-9
14,1,1,1,6,-5
14,1,2,4,5,-1
14,1,3,2,5,-3
14,1,4,4,20,-16
14,1,5,9,15,-6
14,1,6,2,13,-11
14,1,7,13,11,2
14,1,8,3,19,-16
14,1,9,11,24,-13
14,1,10,12,16,-4
14,1,11,16,19,-3
14,1,12,7,17,-10
14,1,13,7,15,-8
14,1,14,7,19,-12
14,1,15,4,22,-18
14,1,16,6,11,-5
14,1,17,9,11,-2
14,1,18,15,15,0
14,1,19,27,20,7
14,1,20,14,21,-7
14,1,21,11,15,-4
14,1,22,18,21,-3
14,1,23,10,14,-4
14,1,24,2,2,0
14,1,25,5,13,-8
14,1,26,12,18,-6
14,1,27,6,12,-6
14,1,28,5,12,-7
14,1,29,6,33,-27
14,1,30,9,5,4
14,1,31,13,17,-4
14,1,32,5,15,-10
14,1,33,9,16,-7
14,1,34,12,9,3
14,1,35,4,12,-8
14,1,36,11,20,-9
14,1,37,2,4,-2
14,1,38,5,17,-12
14,1,39,10,15,-5
14,1,40,4,4,0
14,1,41,4,19,-15
14,1,42,3,7,-4
14,1,43,10,17,-7
14,1,44,15,20,-5
14,1,45,15,13,2
14,1,46,10,8,2
14,1,47,10,13,-3
14,1,48,9,21,-12
14,1,49,9,15,-6
14,1,50,1,9,-8
14,1,51,14,23,-9
14,1,52,13,23,-10
14,1,53,9,18,-9
14,1,54,4,8,-4
14,1,55,8,17,-9
14,1,56,9,12,-3
14,1,57,8,11,-3
14,1,58,15,19,-4
14,1,59,5,9,-4
14,1,60,7,6,1
14,1,61,9,14,-5
14,1,62,5,14,-9
14,1,63,14,12,2
14,1,64,12,17,-5
14,1,65,9,15,-6
14,1,66,5,22,-17
14,1,67,7,12,-5
14,1,68,9,16,-7
14,1,69,11,20,-9
14,1,70,15,14,1
14,1,71,16,9,7
14,1,72,13,24,-11
14,1,73,6,14,-8
14,1,74,10,14,-4
14,1,75,11,13,-2
14,1,76,6,9,-3
14,1,77,14,11,3
14,1,78,7,23,-16
14,1,79,20,29,-9
14,1,80,2,16,-14
14,1,81,6,12,-6
14,1,82,13,23,-10
14,1,83,20,16,4
14,1,84,1,6,-5
14,1,85,20,22,-2
14,1,86,6,15,-9
14,1,87,3,21,-18
14,1,88,9,15,-6
14,1,89,2,13,-11
14,1,90,22,22,0
14,1,91,7,17,-10
14,1,92,8,11,-3
14,1,93,6,13,-7
14,1,94,12,23,-11
14,1,95,17,11,6
14,1,96,2,20,-18
14,1,97,5,7,-2
14,1,98,12,19,-7
14,1,99,7,12,-5
14,1,100,5,13,-8
14,1,101,8,11,-3
14,1,102,3,9,-6
14,1,103,8,15,-7
14,1,104,8,18,-10
14,1,105,6,12,-6
14,1,106,12,24,-12
14,1,107,4,4,0
14,1,108,7,9,-2
14,1,109,9,15,-6
14,1,110,5,10,-5
14,1,111,6,15,-9
14,1,112,6,12,-6
14,1,113,2,16,-14
14,1,114,24,10,14
14,1,115,10,16,-6
14,1,116,21,21,0
14,1,117,10,28,-18
14,1,118,22,23,-1
14,1,119,5,9,-4
14,1,120,10,15,-5
14,1,121,9,18,-9
14,1,122,2,11,-9
14,1,123,4,15,-11
14,1,124,10,19,-9
14,1,125,4,12,-8
14,1,126,13,15,-2
14,1,127,5,18,-13
14,1,128,4,20,-16
14,1,129,11,8,3
14,1,130,9,14,-5
14,1,131,8,20,-12
14,1,132,13,20,-7
14,1,133,7,10,-3
14,1,134,1,16,-15
14,1,135,8,13,-5
14,1,136,8,12,-4
14,1,137,6,15,-9
14,1,138,5,19,-14
14,1,139,8,14,-6
14,1,140,6,21,-15
14,1,141,3,6,-3
14,1,142,4,2,2
14,1,143,7,12,-5
14,1,144,6,9,-3
14,1,145,4,11,-7
14,1,146,10,33,-23
14,1,147,22,22,0
14,1,148,12,10,2
14,1,149,15,32,-17
14,1,150,22,14,8
14,1,151,6,8,-2
14,1,152,5,16,-11
14,1,153,10,15,-5
14,1,154,11,15,-4
14,1,155,6,19,-13
14,1,156,17,20,-3
14,1,157,25,11,14
14,1,158,9,8,1
14,1,159,9,21,-12
14,1,160,17,22,-5
14,1,161,16,21,-5
14,1,162,10,11,-1
14,1,163,9,11,-2
14,1,164,9,12,-3
14,1,165,13,17,-4
14,1,166,11,10,1
14,1,167,7,6,1
14,1,168,11,23,-12
14,1,169,2,11,-9
14,1,170,5,5,0
14,1,171,18,13,5
14,1,172,8,9,-1
14,1,173,7,12,-5
14,1,174,18,12,6
14,1,175,10,14,-4
14,1,176,4,18,-14
14,1,177,9,16,-7
14,1,178,6,12,-6
14,1,179,4,15,-11
14,1,180,13,19,-6
14,1,181,10,26,-16
14,1,182,4,17,-13
14,1,183,11,16,-5
14,1,184,3,11,-8
14,1,185,5,16,-11
14,1,186,6,14,-8
14,1,187,15,28,-13
14,1,188,7,17,-10
14,1,189,13,12,1
14,1,190,10,12,-2
14,1,191,13,20,-7
14,1,192,8,15,-7
14,1,193,6,13,-7
14,1,194,9,12,-3
14,1,195,9,12,-3
14,1,196,6,21,-15
14,1,197,12,22,-10
14,1,198,9,13,-4
14,1,199,5,10,-5
14,1,200,14,16,-2
14,1,201,4,16,-12
14,1,202,6,9,-3
14,1,203,8,17,-9
14,1,204,9,10,-1
14,1,205,5,21,-16
14,1,206,14,20,-6
14,1,207,10,12,-2
14,1,208,3,12,-9
14,1,209,10,12,-2
14,1,210,13,24,-11
14,1,211,14,9,5
14,1,212,7,17,-10
14,1,213,24,11,13
14,1,214,15,15,0
14,1,215,8,26,-18
14,1,216,8,17,-9
14,1,217,9,10,-1
14,1,218,9,18,-9
14,1,219,5,9,-4
14,1,220,9,12,-3
14,1,221,9,8,1
14,1,222,13,15,-2
14,1,223,7,6,1
14,1,224,10,16,-6
14,1,225,6,20,-14
14,1,226,3,10,-7
14,1,227,9,13,-4
14,1,228,8,12,-4
14,1,229,4,5,-1
14,1,230,14,10,4
14,1,231,8,12,-4
14,1,232,7,22,-15
14,1,233,15,16,-1
14,1,234,10,7,3
14,1,235,9,25,-16
14,1,236,4,7,-3
14,1,237,14,19,-5
14,1,238,13,13,0
14,1,239,2,8,-6
14,1,240,18,21,-3
14,1,241,6,31,-25
14,1,242,5,16,-11
14,1,243,8,4,4
14,1,244,3,18,-15
14,1,245,6,12,-6
14,1,246,10,25,-15
14,1,247,17,33,-16
14,1,248,14,25,-11
14,1,249,5,8,-3
14,1,250,6,12,-6
14,1,251,8,9,-1
14,1,252,13,17,-4
14,1,253,15,13,2
14,1,254,12,15,-3
14,1,255,6,15,-9
14,1,256,8,10,-2
14,1,257,2,15,-13
14,1,258,8,14,-6
14,1,259,17,11,6
14,1,260,6,11,-5
14,1,261,12,23,-11
14,1,262,12,11,1
14,1,263,13,5,8
14,1,264,4,11,-7
14,1,265,13,17,-4
14,1,266,10,18,-8
14,1,267,10,19,-9
14,1,268,14,21,-7
14,1,269,12,22,-10
14,1,270,9,8,1
14,1,271,6,12,-6
14,1,272,6,14,-8
14,1,273,4,13,-9
14,1,274,10,13,-3
14,1,275,8,19,-11
14,1,276,9,19,-10
14,1,277,10,12,-2
14,1,278,7,18,-11
14,1,279,13,12,1
14,1,280,10,14,-4
14,1,281,7,11,-4
14,1,282,3,12,-9
14,1,283,3,16,-13
14,1,284,14,14,0
14,1,285,11,15,-4
14,1,286,15,16,-1
14,1,287,6,7,-1
14,1,288,5,10,-5
14,1,289,6,17,-11
14,1,290,9,7,2
14,1,291,8,13,-5
14,1,292,15,6,9
14,1,293,8,9,-1
14,1,294,19,18,1
14,1,295,9,19,-10
14,1,296,12,18,-6
14,1,297,9,14,-5
14,1,298,9,11,-2
14,1,299,11,10,1
14,2,0,13,24,-11
14,2,1,10,23,-13
14,2,2,11,15,-4
14,2,3,8,20,-12
14,2,4,16,10,6
14,2,5,8,9,-1
14,2,6,16,20,-4
14,2,7,7,8,-1
14,2,8,13,18,-5
14,2,9,9,10,-1
14,2,10,10,7,3
14,2,11,8,8,0
14,2,12,9,20,-11
14,2,13,1,10,-9
14,2,14,9,17,-8
14,2,15,8,24,-16
14,2,16,6,9,-3
14,2,17,2,4,-2
14,2,18,13,20,-7
14,2,19,13,13,0
14,2,20,4,15,-11
14,2,21,7,5,2
14,2,22,7,20,-13
14,2,23,10,15,-5
14,2,24,13,16,-3
14,2,25,10,18,-8
14,2,26,22,24,-2
14,2,27,12,16,-4
14,2,28,12,18,-6
14,2,29,8,13,-5
14,2,30,11,12,-1
14,2,31,11,20,-9
14,2,32,16,8,8
14,2,33,12,31,-19
14,2,34,14,18,-4
14,2,35,6,22,-16
14,2,36,14,13,1
14,2,37,8,7,1
14,2,38,13,16,-3
14,2,39,9,9,0
14,2,40,4,10,-6
14,2,41,7,12,-5
14,2,42,7,26,-19
14,2,43,16,17,-1
14,2,44,8,19,-11
14,2,45,11,12,-1
14,2,46,11,15,-4
14,2,47,5,12,-7
14,2,48,15,15,0
14,2,49,10,27,-17
14,2,50,18,18,0
14,2,51,9,11,-2
14,2,52,3,21,-18
14,2,53,5,19,-14
14,2,54,22,17,5
14,2,55,14,4,10
14,2,56,5,18,-13
14,2,57,1,11,-10
14,2,58,13,26,-13
14,2,59,5,14,-9
14,2,60,5,27,-22
14,2,61,11,11,0
14,2,62,13,14,-1
14,2,63,15,22,-7
14,2,64,5,15,-10
14,2,65,10,17,-7
14,2,66,13,10,3
14,2,67,1,23,-22
14,2,68,6,15,-9
14,2,69,16,15,1
14,2,70,6,27,-21
14,2,71,7,9,-2
14,2,72,12,16,-4
14,2,73,11,22,-11
14,2,74,17,14,3
14,2,75,3,20,-17
14,2,76,10,14,-4
14,2,77,11,31,-20
14,2,78,2,14,-12
14,2,79,15,19,-4
14,2,80,11,13,-2
14,2,81,21,15,6
14,2,82,6,13,-7
14,2,83,16,21,-5
14,2,84,8,19,-11
14,2,85,12,23,-11
14,2,86,9,25,-16
14,2,87,8,23,-15
14,2,88,17,21,-4
14,2,89,18,25,-7
14,2,90,9,20,-11
14,2,91,16,24,-8
14,2,92,12,17,-5
14,2,93,9,17,-8
14,2,94,7,27,-20
14,2,95,7,5,2
14,2,96,6,26,-20
14,2,97,7,11,-4
14,2,98,7,22,-15
14,2,99,10,16,-6
14,2,100,9,19,-10
14,2,101,12,21,-9
14,2,102,4,9,-5
14,2,103,11,20,-9
14,2,104,12,11,1
14,2,105,10,19,-9
14,2,106,4,8,-4
14,2,107,14,13,1
14,2,108,6,22,-16
14,2,109,15,16,-1
14,2,110,25,25,0
14,2,111,7,15,-8
14,2,112,9,8,1
14,2,113,5,1,4
14,2,114,18,26,-8
14,2,115,13,18,-5
14,2,116,8,21,-13
14,2,117,5,18,-13
14,2,118,13,25,-12
14,2,119,3,18,-15
14,2,120,4,24,-20
14,2,121,4,16,-12
14,2,122,4,18,-14
14,2,123,9,8,1
14,2,124,12,10,2
14,2,125,9,4,5
14,2,126,3,8,-5
14,2,127,13,21,-8
14,2,128,3,7,-4
14,2,129,11,12,-1
14,2,130,15,10,5
14,2,131,13,23,-10
14,2,132,5,16,-11
14,2,133,11,15,-4
14,2,134,12,23,-11
14,2,135,8,13,-5
14,2,136,10,14,-4
14,2,137,8,28,-20
14,2,138,7,23,-16
14,2,139,14,17,-3
14,2,140,8,20,-12
14,2,141,17,16,1
14,2,142,1,3,-2
14,2,143,15,21,-6
14,2,144,12,28,-16
14,2,145,12,17,-5
14,2,146,11,5,6
14,2,147,8,19,-11
14,2,148,8,25,-17
14,2,149,5,8,-3
14,2,150,6,12,-6
14,2,151,10,15,-5
14,2,152,8,12,-4
14,2,153,10,27,-17
14,2,154,3,19,-16
14,2,155,12,11,1
14,2,156,4,14,-10
14,2,157,10,24,-14
14,2,158,8,16,-8
14,2,159,5,4,1
14,2,160,5,14,-9
14,2,161,10,17,-7
14,2,162,16,7,9
14,2,163,9,14,-5
14,2,164,9,24,-15
14,2,165,5,4,1
14,2,166,8,19,-11
14,2,167,16,15,1
14,2,168,13,13,0
14,2,169,10,19,-9
14,2,170,10,12,-2
14,2,171,6,18,-12
14,2,172,5,18,-13
14,2,173,9,15,-6
14,2,174,15,13,2
14,2,175,10,25,-15
14,2,176,8,17,-9
14,2,177,6,4,2
14,2,178,3,13,-10
14,2,179,10,17,-7
14,2,180,8,9,-1
14,2,181,5,4,1
14,2,182,11,8,3
14,2,183,13,14,-1
14,2,184,6,11,-5
14,2,185,12,28,-16
14,2,186,2,3,-1
14,2,187,3,21,-18
14,2,188,16,45,-29
14,2,189,10,17,-7
14,2,190,6,11,-5
14,2,191,13,18,-5
14,2,192,6,6,0
14,2,193,7,23,-16
14,2,194,14,28,-14
14,2,195,17,19,-2
14,2,196,10,10,0
14,2,197,6,15,-9
14,2,198,11,15,-4
14,2,199,19,15,4
14,2,200,8,14,-6
14,2,201,6,15,-9
14,2,202,8,21,-13
14,2,203,9,7,2
14,2,204,15,24,-9
14,2,205,5,17,-12
14,2,206,10,23,-13
14,2,207,14,18,-4
14,2,208,19,15,4
14,2,209,12,24,-12
14,2,210,16,30,-14
14,2,211,8,21,-13
14,2,212,10,13,-3
14,2,213,9,17,-8
14,2,214,13,12,1
14,2,215,15,12,3
14,2,216,7,11,-4
14,2,217,9,15,-6
14,2,218,16,18,-2
14,2,219,17,28,-11
14,2,220,7,18,-11
14,2,221,9,8,1
14,2,222,6,9,-3
14,2,223,10,19,-9
14,2,224,12,14,-2
14,2,225,5,9,-4
14,2,226,11,29,-18
14,2,227,13,11,2
14,2,228,19,15,4
14,2,229,15,17,-2
14,2,230,16,24,-8
14,2,231,11,22,-11
14,2,232,4,20,-16
14,2,233,4,14,-10
14,2,234,14,25,-11
14,2,235,12,11,1
14,2,236,12,8,4
14,2,237,9,32,-23
14,2,238,3,9,-6
14,2,239,18,18,0
14,2,240,12,17,-5
14,2,241,6,15,-9
14,2,242,10,15,-5
14,2,243,11,13,-2
14,2,244,16,15,1
14,2,245,6,9,-3
14,2,246,11,18,-7
14,2,247,14,19,-5
14,2,248,14,18,-4
14,2,249,11,17,-6
14,2,250,8,18,-10
14,2,251,10,13,-3
14,2,252,8,11,-3
14,2,253,11,20,-9
14,2,254,9,22,-13
14,2,255,20,20,0
14,2,256,8,8,0
14,2,257,8,10,-2
14,2,258,8,8,0
14,2,259,7,9,-2
14,2,260,5,8,-3
14,2,261,19,22,-3
14,2,262,9,13,-4
14,2,263,7,6,1
14,2,264,6,8,-2
14,2,265,6,20,-14
14,2,266,24,19,5
14,2,267,9,48,-39
14,2,268,12,22,-10
14,2,269,7,10,-3
14,2,270,10,17,-7
14,2,271,9,17,-8
14,2,272,5,26,-21
14,2,273,7,9,-2
14,2,274,4,14,-10
14,2,275,12,20,-8
14,2,276,7,14,-7
14,2,277,7,27,-20
14,2,278,21,9,12
14,2,279,11,15,-4
14,2,280,9,15,-6
14,2,281,4,24,-20
14,2,282,6,8,-2
14,2,283,17,19,-2
14,2,284,10,19,-9
14,2,285,15,10,5
14,2,286,7,19,-12
14,2,287,9,22,-13
14,2,288,13,13,0
14,2,289,9,15,-6
14,2,290,12,17,-5
14,2,291,12,13,-1
14,2,292,9,23,-14
14,2,293,10,16,-6
14,2,294,19,28,-9
14,2,295,10,24,-14
14,2,296,6,21,-15
14,2,297,12,20,-8
14,2,298,10,13,-3
14,2,299,19,23,-4
14,3,0,6,12,-6
14,3,1,6,11,-5
14,3,2,7,23,-16
14,3,3,14,20,-6
14,3,4,10,5,5
14,3,5,13,16,-3
14,3,6,3,9,-6
14,3,7,9,9,0
14,3,8,7,20,-13
14,3,9,6,18,-12
14,3,10,10,31,-21
14,3,11,14,29,-15
14,3,12,14,21,-7
14,3,13,6,27,-21
14,3,14,20,25,-5
14,3,15,20,18,2
14,3,16,14,21,-7
14,3,17,9,10,-1
14,3,18,17,28,-11
14,3,19,13,13,0
14,3,20,15,10,5
14,3,21,10,22,-12
14,3,22,7,18,-11
14,3,23,21,28,-7
14,3,24,8,16,-8
14,3,25,6,21,-15
14,3,26,18,19,-1
14,3,27,5,17,-12
14,3,28,6,17,-11
14,3,29,7,4,3
14,3,30,11,27,-16
14,3,31,10,13,-3
14,3,32,8,23,-15
14,3,33,16,17,-1
14,3,34,15,28,-13
14,3,35,15,13,2
14,3,36,13,27,-14
14,3,37,7,21,-14
14,3,38,15,20,-5
14,3,39,14,11,3
14,3,40,15,11,4
14,3,41,17,13,4
14,3,42,13,7,6
14,3,43,8,15,-7
14,3,44,8,19,-11
14,3,45,4,19,-15
14,3,46,8,8,0
14,3,47,11,29,-18
14,3,48,6,18,-12
14,3,49,13,24,-11
14,3,50,11,13,-2
14,3,51,6,9,-3
14,3,52,17,23,-6
14,3,53,14,24,-10
14,3,54,1,18,-17
14,3,55,9,14,-5
14,3,56,5,5,0
14,3,57,16,21,-5
14,3,58,13,25,-12
14,3,59,15,15,0
14,3,60,9,11,-2
14,3,61,6,13,-7
14,3,62,13,13,0
14,3,63,9,23,-14
14,3,64,3,6,-3
14,3,65,11,22,-11
14,3,66,18,25,-7
14,3,67,16,19,-3
14,3,68,11,20,-9
14,3,69,11,31,-20
14,3,70,7,16,-9
14,3,71,10,20,-10
14,3,72,3,15,-12
14,3,73,14,28,-14
14,3,74,17,27,-10
14,3,75,6,12,-6
14,3,76,17,17,0
14,3,77,11,17,-6
14,3,78,12,14,-2
14,3,79,12,19,-7
14,3,80,12,26,-14
14,3,81,14,13,1
14,3,82,14,8,6
14,3,83,16,17,-1
14,3,84,15,15,0
14,3,85,12,22,-10
14,3,86,8,15,-7
14,3,87,16,12,4
14,3,88,10,11,-1
14,3,89,12,24,-12
14,3,90,10,20,-10
14,3,91,28,28,0
14,3,92,6,17,-11
14,3,93,7,14,-7
14,3,94,8,19,-11
14,3,95,11,27,-16
14,3,96,13,22,-9
14,3,97,17,30,-13
14,3,98,12,25,-13
14,3,99,10,19,-9
14,3,100,8,6,2
14,3,101,17,21,-4
14,3,102,7,10,-3
14,3,103,27,24,3
14,3,104,16,21,-5
14,3,105,11,26,-15
14,3,106,16,19,-3
14,3,107,16,28,-12
14,3,108,6,15,-9
14,3,109,5,18,-13
14,3,110,6,9,-3
14,3,111,14,23,-9
14,3,112,1,19,-18
14,3,113,7,14,-7
14,3,114,8,6,2
14,3,115,5,13,-8
14,3,116,11,14,-3
14,3,117,5,8,-3
14,3,118,8,26,-18
14,3,119,4,14,-10
14,3,120,7,7,0
14,3,121,14,28,-14
14,3,122,11,20,-9
14,3,123,6,16,-10
14,3,124,8,8,0
14,3,125,5,3,2
14,3,126,6,17,-11
14,3,127,14,11,3
14,3,128,9,29,-20
14,3,129,18,25,-7
14,3,130,13,28,-15
14,3,131,12,14,-2
14,3,132,14,19,-5
14,3,133,17,14,3
14,3,134,16,19,-3
14,3,135,8,11,-3
14,3,136,10,3,7
14,3,137,6,19,-13
14,3,138,11,14,-3
14,3,139,9,12,-3
14,3,140,2,15,-13
14,3,141,10,20,-10
14,3,142,10,21,-11
14,3,143,8,20,-12
14,3,144,33,17,16
14,3,145,2,15,-13
14,3,146,2,8,-6
14,3,147,10,21,-11
14,3,148,12,23,-11
14,3,149,15,22,-7
14,3,150,13,20,-7
14,3,151,12,25,-13
14,3,152,14,15,-1
14,3,153,8,12,-4
14,3,154,20,28,-8
14,3,155,7,24,-17
14,3,156,5,22,-17
14,3,157,13,10,3
14,3,158,7,27,-20
14,3,159,14,25,-11
14,3,160,7,9,-2
14,3,161,16,10,6
14,3,162,3,7,-4
14,3,163,5,8,-3
14,3,164,10,20,-10
14,3,165,8,22,-14
14,3,166,7,16,-9
14,3,167,9,20,-11
14,3,168,5,10,-5
14,3,169,9,23,-14
14,3,170,20,22,-2
14,3,171,10,16,-6
14,3,172,8,17,-9
14,3,173,5,27,-22
14,3,174,20,33,-13
14,3,175,2,15,-13
14,3,176,15,20,-5
14,3,177,12,13,-1
14,3,178,10,7,3
14,3,179,16,27,-11
14,3,180,24,17,7
14,3,181,14,18,-4
14,3,182,10,19,-9
14,3,183,9,10,-1
14,3,184,13,16,-3
14,3,185,12,12,0
14,3,186,2,4,-2
14,3,187,6,6,0
14,3,188,19,32,-13
14,3,189,13,11,2
14,3,190,17,10,7
14,3,191,10,20,-10
14,3,192,12,15,-3
14,3,193,10,23,-13
14,3,194,19,12,7
14,3,195,2,25,-23
14,3,196,11,18,-7
14,3,197,8,26,-18
14,3,198,11,19,-8
14,3,199,5,11,-6
14,3,200,6,17,-11
14,3,201,10,22,-12
14,3,202,14,21,-7
14,3,203,11,18,-7
14,3,204,8,18,-10
14,3,205,6,12,-6
14,3,206,12,27,-15
14,3,207,15,20,-5
14,3,208,11,14,-3
14,3,209,10,8,2
14,3,210,10,32,-22
14,3,211,8,6,2
14,3,212,12,15,-3
14,3,213,13,18,-5
14,3,214,8,17,-9
14,3,215,5,10,-5
14,3,216,9,11,-2
14,3,217,22,16,6
14,3,218,24,15,9
14,3,219,19,16,3
14,3,220,10,27,-17
14,3,221,10,17,-7
14,3,222,7,11,-4
14,3,223,2,14,-12
14,3,224,5,19,-14
14,3,225,7,24,-17
14,3,226,12,10,2
14,3,227,9,19,-10
14,3,228,2,9,-7
14,3,229,15,17,-2
14,3,230,4,4,0
14,3,231,8,14,-6
14,3,232,9,22,-13
14,3,233,5,10,-5
14,3,234,17,11,6
14,3,235,9,11,-2
14,3,236,12,11,1
14,3,237,15,23,-8
14,3,238,3,13,-10
14,3,239,4,8,-4
14,3,240,6,16,-10
14,3,241,7,14,-7
14,3,242,10,10,0
14,3,243,10,10,0
14,3,244,15,14,1
14,3,245,2,2,0
14,3,246,8,8,0
14,3,247,14,21,-7
14,3,248,11,15,-4
14,3,249,17,17,0
14,3,250,3,5,-2
14,3,251,24,32,-8
14,3,252,17,20,-3
14,3,253,7,13,-6
14,3,254,10,15,-5
14,3,255,18,21,-3
14,3,256,5,16,-11
14,3,257,10,27,-17
14,3,258,11,17,-6
14,3,259,16,13,3
14,3,260,12,30,-18
14,3,261,17,18,-1
14,3,262,12,15,-3
14,3,263,17,18,-1
14,3,264,10,17,-7
14,3,265,7,6,1
14,3,266,23,24,-1
14,3,267,8,1,7
14,3,268,13,20,-7
14,3,269,14,19,-5
14,3,270,3,12,-9
14,3,271,14,15,-1
14,3,272,8,16,-8
14,3,273,15,17,-2
14,3,274,16,21,-5
14,3,275,12,18,-6
14,3,276,10,27,-17
14,3,277,15,23,-8
14,3,278,13,13,0
14,3,279,5,13,-8
14,3,280,7,19,-12
14,3,281,10,13,-3
14,3,282,18,8,10
14,3,283,9,18,-9
14,3,284,10,17,-7
14,3,285,9,19,-10
14,3,286,11,21,-10
14,3,287,9,16,-7
14,3,288,18,26,-8
14,3,289,13,13,0
14,3,290,21,11,10
14,3,291,15,28,-13
14,3,292,13,21,-8
14,3,293,5,11,-6
14,3,294,9,20,-11
14,3,295,13,11,2
14,3,296,6,11,-5
14,3,297,13,12,1
14,3,298,8,24,-16
14,3,299,13,27,-14
14,4,0,9,11,-2
14,4,1,22,14,8
14,4,2,18,29,-11
14,4,3,14,16,-2
14,4,4,8,20,-12
14,4,5,12,26,-14
14,4,6,15,28,-13
14,4,7,14,22,-8
14,4,8,7,19,-12
14,4,9,4,11,-7
14,4,10,8,12,-4
14,4,11,16,15,1
14,4,12,14,20,-6
14,4,13,12,13,-1
14,4,14,16,32,-16
14,4,15,10,9,1
14,4,16,6,18,-12
14,4,17,11,33,-22
14,4,18,6,17,-11
14,4,19,16,55,-39
14,4,20,11,25,-14
14,4,21,17,19,-2
14,4,22,9,12,-3
14,4,23,11,30,-19
14,4,24,14,26,-12
14,4,25,9,10,-1
14,4,26,2,13,-11
14,4,27,9,19,-10
14,4,28,14,27,-13
14,4,29,11,10,1
14,4,30,5,7,-2
14,4,31,14,18,-4
14,4,32,8,23,-15
14,4,33,6,10,-4
14,4,34,10,16,-6
14,4,35,13,10,3
14,4,36,14,29,-15
14,4,37,8,26,-18
14,4,38,4,25,-21
14,4,39,12,10,2
14,4,40,14,17,-3
14,4,41,11,15,-4
14,4,42,11,21,-10
14,4,43,9,14,-5
14,4,44,5,12,-7
14,4,45,11,21,-10
14,4,46,9,13,-4
14,4,47,12,22,-10
14,4,48,13,18,-5
14,4,49,20,20,0
14,4,50,11,14,-3
14,4,51,13,15,-2
14,4,52,15,16,-1
14,4,53,11,8,3
14,4,54,13,24,-11
14,4,55,6,17,-11
14,4,56,9,17,-8
14,4,57,7,16,-9
14,4,58,16,22,-6
14,4,59,4,3,1
14,4,60,15,14,1
14,4,61,12,16,-4
14,4,62,13,19,-6
14,4,63,5,12,-7
14,4,64,11,10,1
14,4,65,15,21,-6
14,4,66,15,21,-6
14,4,67,17,11,6
14,4,68,16,14,2
14,4,69,15,43,-28
14,4,70,9,9,0
14,4,71,10,14,-4
14,4,72,21,29,-8
14,4,73,8,13,-5
14,4,74,14,27,-13
14,4,75,14,25,-11
14,4,76,3,8,-5
14,4,77,12,16,-4
14,4,78,8,8,0
14,4,79,9,13,-4
14,4,80,13,11,2
14,4,81,16,17,-1
14,4,82,5,14,-9
14,4,83,13,26,-13
14,4,84,11,14,-3
14,4,85,14,16,-2
14,4,86,14,21,-7
14,4,87,6,16,-10
14,4,88,6,14,-8
14,4,89,7,12,-5
14,4,90,2,5,-3
14,4,91,16,11,5
14,4,92,19,31,-12
14,4,93,8,25,-17
14,4,94,2,7,-5
14,4,95,6,4,2
14,4,96,20,19,1
14,4,97,26,21,5
14,4,98,5,12,-7
14,4,99,9,18,-9
14,4,100,12,10,2
14,4,101,9,12,-3
14,4,102,13,16,-3
14,4,103,5,8,-3
14,4,104,6,22,-16
14,4,105,18,21,-3
14,4,106,9,16,-7
14,4,107,4,17,-13
14,4,108,10,17,-7
14,4,109,13,8,5
14,4,110,19,20,-1
14,4,111,11,24,-13
14,4,112,10,18,-8
14,4,113,10,28,-18
14,4,114,13,21,-8
14,4,115,13,23,-10
14,4,116,24,26,-2
14,4,117,11,20,-9
14,4,118,7,14,-7
14,4,119,8,22,-14
14,4,120,9,10,-1
14,4,121,11,16,-5
14,4,122,13,30,-17
14,4,123,14,21,-7
14,4,124,4,4,0
14,4,125,17,28,-11
14,4,126,16,42,-26
14,4,127,9,26,-17
14,4,128,7,13,-6
14,4,129,7,4,3
14,4,130,5,14,-9
14,4,131,14,20,-6
14,4,132,8,20,-12
14,4,133,9,20,-11
14,4,134,5,19,-14
14,4,135,4,20,-16
14,4,136,2,10,-8
14,4,137,8,15,-7
14,4,138,11,19,-8
14,4,139,12,24,-12
14,4,140,12,15,-3
14,4,141,19,16,3
14,4,142,11,18,-7
14,4,143,12,22,-10
14,4,144,8,13,-5
14,4,145,11,30,-19
14,4,146,21,24,-3
14,4,147,6,8,-2
14,4,148,9,14,-5
14,4,149,17,13,4
14,4,150,10,13,-3
14,4,151,14,18,-4
14,4,152,23,25,-2
14,4,153,2,18,-16
14,4,154,5,18,-13
14,4,155,9,16,-7
14,4,156,4,21,-17
14,4,157,9,7,2
14,4,158,12,5,7
14,4,159,19,17,2
14,4,160,10,13,-3
14,4,161,18,20,-2
14,4,162,16,24,-8
14,4,163,21,18,3
14,4,164,5,24,-19
14,4,165,18,25,-7
14,4,166,5,15,-10
14,4,167,11,13,-2
14,4,168,5,10,-5
14,4,169,23,30,-7
14,4,170,18,23,-5
14,4,171,14,20,-6
14,4,172,8,24,-16
14,4,173,9,22,-13
14,4,174,17,12,5
14,4,175,3,9,-6
14,4,176,24,14,10
14,4,177,12,31,-19
14,4,178,10,12,-2
14,4,179,16,11,5
14,4,180,5,15,-10
14,4,181,16,12,4
14,4,182,16,15,1
14,4,183,8,14,-6
14,4,184,11,9,2
14,4,185,21,15,6
14,4,186,4,8,-4
14,4,187,10,14,-4
14,4,188,21,9,12
14,4,189,4,12,-8
14,4,190,11,8,3
14,4,191,7,7,0
14,4,192,2,15,-13
14,4,193,13,21,-8
14,4,194,19,32,-13
14,4,195,12,17,-5
14,4,196,14,15,-1
14,4,197,22,21,1
14,4,198,12,22,-10
14,4,199,9,12,-3
14,4,200,10,19,-9
14,4,201,14,25,-11
14,4,202,8,17,-9
14,4,203,8,16,-8
14,4,204,6,9,-3
14,4,205,20,28,-8
14,4,206,14,13,1
14,4,207,9,10,-1
14,4,208,11,16,-5
14,4,209,8,12,-4
14,4,210,13,8,5
14,4,211,7,14,-7
14,4,212,14,19,-5
14,4,213,15,28,-13
14,4,214,2,15,-13
14,4,215,11,18,-7
14,4,216,18,26,-8
14,4,217,7,18,-11
14,4,218,10,14,-4
14,4,219,10,16,-6
14,4,220,10,13,-3
14,4,221,6,22,-16
14,4,222,16,21,-5
14,4,223,8,23,-15
14,4,224,8,25,-17
14,4,225,13,12,1
14,4,226,12,20,-8
14,4,227,10,20,-10
14,4,228,6,32,-26
14,4,229,9,21,-12
14,4,230,9,15,-6
14,4,231,7,30,-23
14,4,232,4,15,-11
14,4,233,4,5,-1
14,4,234,10,12,-2
14,4,235,5,16,-11
14,4,236,19,30,-11
14,4,237,11,24,-13
14,4,238,14,30,-16
14,4,239,14,11,3
14,4,240,13,18,-5
14,4,241,9,22,-13
14,4,242,7,8,-1
14,4,243,6,27,-21
14,4,244,8,17,-9
14,4,245,12,17,-5
14,4,246,10,25,-15
14,4,247,18,12,6
14,4,248,15,13,2
14,4,249,18,35,-17
14,4,250,13,14,-1
14,4,251,16,30,-14
14,4,252,9,16,-7
14,4,253,9,32,-23
14,4,254,4,22,-18
14,4,255,5,11,-6
14,4,256,11,10,1
14,4,257,11,20,-9
14,4,258,3,10,-7
14,4,259,10,10,0
14,4,260,24,18,6
14,4,261,1,18,-17
14,4,262,8,29,-21
14,4,263,4,14,-10
14,4,264,13,19,-6
14,4,265,14,17,-3
14,4,266,10,21,-11
14,4,267,7,10,-3
14,4,268,10,12,-2
14,4,269,6,17,-11
14,4,270,1,12,-11
14,4,271,5,13,-8
14,4,272,4,12,-8
14,4,273,8,14,-6
14,4,274,12,15,-3
14,4,275,12,14,-2
14,4,276,15,12,3
14,4,277,9,27,-18
14,4,278,7,16,-9
14,4,279,9,18,-9
14,4,280,19,22,-3
14,4,281,7,6,1
14,4,282,2,12,-10
14,4,283,9,17,-8
14,4,284,16,8,8
14,4,285,7,17,-10
14,4,286,12,20,-8
14,4,287,12,18,-6
14,4,288,7,11,-4
14,4,289,4,8,-4
14,4,290,15,10,5
14,4,291,8,24,-16
14,4,292,9,9,0
14,4,293,13,21,-8
14,4,294,7,30,-23
14,4,295,10,12,-2
14,4,296,9,5,4
14,4,297,9,17,-8
14,4,298,8,17,-9
14,4,299,20,13,7
14,5,0,17,20,-3
14,5,1,5,21,-16
14,5,2,6,33,-27
14,5,3,23,28,-5
14,5,4,10,10,0
14,5,5,21,9,12
14,5,6,5,31,-26
14,5,7,5,22,-17
14,5,8,11,14,-3
14,5,9,13,22,-9
14,5,10,9,15,-6
14,5,11,14,14,0
14,5,12,10,32,-22
14,5,13,14,7,7
14,5,14,15,20,-5
14,5,15,12,16,-4
14,5,16,8,4,4
14,5,17,10,12,-2
14,5,18,17,15,2
14,5,19,3,3,0
14,5,20,11,17,-6
14,5,21,30,25,5
14,5,22,7,3,4
14,5,23,11,13,-2
14,5,24,10,24,-14
14,5,25,18,35,-17
14,5,26,17,4,13
14,5,27,6,22,-16
14,5,28,16,19,-3
14,5,29,10,10,0
14,5,30,8,13,-5
14,5,31,20,22,-2
14,5,32,16,17,-1
14,5,33,22,17,5
14,5,34,7,13,-6
14,5,35,6,15,-9
14,5,36,10,26,-16
14,5,37,14,23,-9
14,5,38,8,7,1
14,5,39,10,12,-2
14,5,40,20,21,-1
14,5,41,4,9,-5
14,5,42,12,19,-7
14,5,43,9,15,-6
14,5,44,15,31,-16
14,5,45,11,10,1
14,5,46,8,17,-9
14,5,47,11,24,-13
14,5,48,16,22,-6
14,5,49,14,22,-8
14,5,50,12,14,-2
14,5,51,15,14,1
14,5,52,8,21,-13
14,5,53,12,16,-4
14,5,54,11,14,-3
14,5,55,6,12,-6
14,5,56,19,11,8
14,5,57,7,14,-7
14,5,58,11,22,-11
14,5,59,11,18,-7
14,5,60,9,29,-20
14,5,61,13,32,-19
14,5,62,10,10,0
14,5,63,8,21,-13
14,5,64,7,11,-4
14,5,65,7,17,-10
14,5,66,12,23,-11
14,5,67,2,5,-3
14,5,68,17,26,-9
14,5,69,13,23,-10
14,5,70,9,9,0
14,5,71,29,24,5
14,5,72,16,14,2
14,5,73,11,25,-14
14,5,74,17,13,4
14,5,75,7,20,-13
14,5,76,11,14,-3
14,5,77,25,34,-9
14,5,78,4,15,-11
14,5,79,16,27,-11
14,5,80,19,26,-7
14,5,81,18,32,-14
14,5,82,14,24,-10
14,5,83,5,18,-13
14,5,84,11,15,-4
14,5,85,11,24,-13
14,5,86,19,9,10
14,5,87,13,32,-19
14,5,88,19,16,3
14,5,89,20,21,-1
14,5,90,11,21,-10
14,5,91,21,25,-4
14,5,92,7,14,-7
14,5,93,7,3,4
14,5,94,15,12,3
14,5,95,14,13,1
14,5,96,21,20,1
14,5,97,14,19,-5
14,5,98,8,17,-9
14,5,99,14,14,0
14,5,100,11,12,-1
14,5,101,20,13,7
14,5,102,9,18,-9
14,5,103,6,8,-2
14,5,104,19,14,5
14,5,105,6,8,-2
14,5,106,10,23,-13
14,5,107,11,12,-1
14,5,108,11,23,-12
14,5,109,8,24,-16
14,5,110,16,16,0
14,5,111,13,19,-6
14,5,112,5,15,-10
14,5,113,13,25,-12
14,5,114,4,6,-2
14,5,115,5,12,-7
14,5,116,5,22,-17
14,5,117,19,15,4
14,5,118,10,15,-5
14,5,119,10,13,-3
14,5,120,9,12,-3
14,5,121,9,17,-8
14,5,122,8,19,-11
14,5,123,7,18,-11
14,5,124,12,26,-14
14,5,125,12,18,-6
14,5,126,27,30,-3
14,5,127,8,18,-10
14,5,128,17,27,-10
14,5,129,15,16,-1
14,5,130,10,19,-9
14,5,131,9,26,-17
14,5,132,23,23,0
14,5,133,12,11,1
14,5,134,23,16,7
14,5,135,8,22,-14
14,5,136,12,17,-5
14,5,137,16,33,-17
14,5,138,21,22,-1
14,5,139,14,8,6
14,5,140,13,23,-10
14,5,141,12,32,-20
14,5,142,6,9,-3
14,5,143,11,15,-4
14,5,144,8,16,-8
14,5,145,18,17,1
14,5,146,13,29,-16
14,5,147,16,14,2
14,5,148,5,15,-10
14,5,149,22,22,0
14,5,150,9,7,2
14,5,151,14,17,-3
14,5,152,10,18,-8
14,5,153,5,14,-9
14,5,154,10,15,-5
14,5,155,7,5,2
14,5,156,16,21,-5
14,5,157,11,21,-10
14,5,158,12,21,-9
14,5,159,23,26,-3
14,5,160,15,13,2
14,5,161,28,29,-1
14,5,162,16,19,-3
14,5,163,20,20,0
14,5,164,13,20,-7
14,5,165,9,7,2
14,5,166,15,38,-23
14,5,167,7,17,-10
14,5,168,23,15,8
14,5,169,9,14,-5
14,5,170,11,18,-7
14,5,171,13,12,1
14,5,172,3,12,-9
14,5,173,9,8,1
14,5,174,13,18,-5
14,5,175,4,10,-6
14,5,176,11,17,-6
14,5,177,10,10,0
14,5,178,25,25,0
14,5,179,5,19,-14
14,5,180,10,13,-3
14,5,181,12,10,2
14,5,182,15,13,2
14,5,183,22,21,1
14,5,184,7,23,-16
14,5,185,10,7,3
14,5,186,7,5,2
14,5,187,8,19,-11
14,5,188,15,20,-5
14,5,189,10,24,-14
14,5,190,26,23,3
14,5,191,10,15,-5
14,5,192,10,23,-13
14,5,193,18,30,-12
14,5,194,8,18,-10
14,5,195,10,22,-12
14,5,196,8,6,2
14,5,197,5,23,-18
14,5,198,9,17,-8
14,5,199,7,17,-10
14,5,200,13,17,-4
14,5,201,11,24,-13
14,5,202,11,4,7
14,5,203,6,8,-2
14,5,204,9,16,-7
14,5,205,11,25,-14
14,5,206,3,26,-23
14,5,207,8,10,-2
14,5,208,5,21,-16
14,5,209,10,7,3
14,5,210,4,5,-1
14,5,211,4,13,-9
14,5,212,12,20,-8
14,5,213,10,21,-11
14,5,214,6,4,2
14,5,215,7,6,1
14,5,216,7,8,-1
14,5,217,15,24,-9
14,5,218,8,19,-11
14,5,219,18,18,0
14,5,220,13,13,0
14,5,221,10,13,-3
14,5,222,11,19,-8
14,5,223,14,14,0
14,5,224,7,9,-2
14,5,225,10,12,-2
14,5,226,11,17,-6
14,5,227,24,20,4
14,5,228,4,12,-8
14,5,229,9,11,-2
14,5,230,23,27,-4
14,5,231,12,18,-6
14,5,232,13,9,4
14,5,233,9,20,-11
14,5,234,10,16,-6
14,5,235,3,12,-9
14,5,236,9,12,-3
14,5,237,11,26,-15
14,5,238,15,14,1
14,5,239,3,10,-7
14,5,240,9,18,-9
14,5,241,16,13,3
14,5,242,14,20,-6
14,5,243,8,11,-3
14,5,244,14,27,-13
14,5,245,17,12,5
14,5,246,6,30,-24
14,5,247,11,13,-2
14,5,248,7,8,-1
14,5,249,12,30,-18
14,5,250,17,23,-6
14,5,251,4,17,-13
14,5,252,8,17,-9
14,5,253,18,24,-6
14,5,254,11,17,-6
14,5,255,13,9,4
14,5,256,17,24,-7
14,5,257,21,21,0
14,5,258,7,9,-2
14,5,259,4,11,-7
14,5,260,12,18,-6
14,5,261,0,14,-14
14,5,262,9,21,-12
14,5,263,20,20,0
14,5,264,12,13,-1
14,5,265,17,27,-10
14,5,266,12,19,-7
14,5,267,14,21,-7
14,5,268,16,19,-3
14,5,269,4,19,-15
14,5,270,18,22,-4
14,5,271,4,5,-1
14,5,272,12,14,-2
14,5,273,11,24,-13
14,5,274,16,16,0
14,5,275,10,7,3
14,5,276,9,13,-4
14,5,277,2,4,-2
14,5,278,19,14,5
14,5,279,23,31,-8
14,5,280,7,12,-5
14,5,281,11,10,1
14,5,282,15,20,-5
14,5,283,12,26,-14
14,5,284,14,23,-9
14,5,285,5,8,-3
14,5,286,12,9,3
14,5,287,6,13,-7
14,5,288,4,10,-6
14,5,289,11,8,3
14,5,290,9,15,-6
14,5,291,7,17,-10
14,5,292,11,16,-5
14,5,293,14,13,1
14,5,294,8,15,-7
14,5,295,8,18,-10
14,5,296,16,20,-4
14,5,297,2,7,-5
14,5,298,10,21,-11
14,5,299,13,13,0
14,6,0,15,11,4
14,6,1,26,23,3
14,6,2,7,16,-9
14,6,3,6,11,-5
14,6,4,18,22,-4
14,6,5,1,11,-10
14,6,6,10,31,-21
14,6,7,16,15,1
14,6,8,7,20,-13
14,6,9,7,27,-20
14,6,10,7,18,-11
14,6,11,15,24,-9
14,6,12,4,10,-6
14,6,13,20,25,-5
14,6,14,4,21,-17
14,6,15,14,20,-6
14,6,16,10,15,-5
14,6,17,14,32,-18
14,6,18,10,22,-12
14,6,19,14,8,6
14,6,20,7,17,-10
14,6,21,22,21,1
14,6,22,20,24,-4
14,6,23,11,22,-11
14,6,24,12,16,-4
14,6,25,7,16,-9
14,6,26,8,22,-14
14,6,27,10,8,2
14,6,28,17,17,0
14,6,29,20,31,-11
14,6,30,11,27,-16
14,6,31,5,13,-8
14,6,32,14,13,1
14,6,33,9,18,-9
14,6,34,14,7,7
14,6,35,9,15,-6
14,6,36,8,10,-2
14,6,37,14,19,-5
14,6,38,25,21,4
14,6,39,22,15,7
14,6,40,5,14,-9
14,6,41,20,24,-4
14,6,42,6,19,-13
14,6,43,19,9,10
14,6,44,9,11,-2
14,6,45,13,15,-2
14,6,46,8,15,-7
14,6,47,11,18,-7
14,6,48,12,21,-9
14,6,49,14,23,-9
14,6,50,6,7,-1
14,6,51,11,8,3
14,6,52,6,21,-15
14,6,53,8,17,-9
14,6,54,22,39,-17
14,6,55,14,15,-1
14,6,56,12,13,-1
14,6,57,13,18,-5
14,6,58,6,13,-7
14,6,59,14,19,-5
14,6,60,18,19,-1
14,6,61,8,7,1
14,6,62,10,25,-15
14,6,63,25,20,5
14,6,64,12,16,-4
14,6,65,26,30,-4
14,6,66,17,22,-5
14,6,67,10,31,-21
14,6,68,12,13,-1
14,6,69,21,28,-7
14,6,70,11,25,-14
14,6,71,10,17,-7
14,6,72,15,14,1
14,6,73,15,21,-6
14,6,74,10,14,-4
14,6,75,11,11,0
14,6,76,9,23,-14
14,6,77,8,10,-2
14,6,78,11,16,-5
14,6,79,18,21,-3
14,6,80,13,11,2
14,6,81,8,16,-8
14,6,82,12,16,-4
14,6,83,14,10,4
14,6,84,16,11,5
14,6,85,20,19,1
14,6,86,16,37,-21
14,6,87,14,22,-8
14,6,88,6,12,-6
14,6,89,1,24,-23
14,6,90,18,21,-3
14,6,91,6,11,-5
14,6,92,6,11,-5
14,6,93,12,10,2
14,6,94,7,18,-11
14,6,95,13,26,-13
14,6,96,8,31,-23
14,6,97,16,22,-6
14,6,98,10,42,-32
14,6,99,15,18,-3
14,6,100,22,41,-19
14,6,101,6,13,-7
14,6,102,10,22,-12
14,6,103,14,19,-5
14,6,104,9,15,-6
14,6,105,20,29,-9
14,6,106,16,25,-9
14,6,107,3,16,-13
14,6,108,11,27,-16
14,6,109,15,33,-18
14,6,110,20,14,6
14,6,111,17,33,-16
14,6,112,4,12,-8
14,6,113,7,15,-8
14,6,114,26,21,5
14,6,115,25,9,16
14,6,116,19,26,-7
14,6,117,5,22,-17
14,6,118,14,15,-1
14,6,119,11,17,-6
14,6,120,9,15,-6
14,6,121,12,28,-16
14,6,122,20,29,-9
14,6,123,19,20,-1
14,6,124,5,16,-11
14,6,125,13,34,-21
14,6,126,2,10,-8
14,6,127,11,17,-6
14,6,128,16,21,-5
14,6,129,6,18,-12
14,6,130,6,14,-8
14,6,131,22,17,5
14,6,132,9,17,-8
14,6,133,6,10,-4
14,6,134,9,7,2
14,6,135,16,17,-1
14,6,136,16,22,-6
14,6,137,18,13,5
14,6,138,5,18,-13
14,6,139,23,27,-4
14,6,140,12,20,-8
14,6,141,13,12,1
14,6,142,12,16,-4
14,6,143,16,19,-3
14,6,144,18,16,2
14,6,145,24,31,-7
14,6,146,23,22,1
14,6,147,15,20,-5
14,6,148,13,16,-3
14,6,149,13,18,-5
14,6,150,18,23,-5
14,6,151,25,27,-2
14,6,152,14,7,7
14,6,153,14,17,-3
14,6,154,8,13,-5
14,6,155,11,22,-11
14,6,156,8,13,-5
14,6,157,16,18,-2
14,6,158,21,12,9
14,6,159,10,13,-3
14,6,160,17,15,2
14,6,161,12,10,2
14,6,162,16,22,-6
14,6,163,7,21,-14
14,6,164,15,8,7
14,6,165,22,23,-1
14,6,166,15,16,-1
14,6,167,9,16,-7
14,6,168,22,33,-11
14,6,169,17,21,-4
14,6,170,16,22,-6
14,6,171,11,18,-7
14,6,172,12,23,-11
14,6,173,10,13,-3
14,6,174,20,28,-8
14,6,175,21,13,8
14,6,176,15,15,0
14,6,177,5,15,-10
14,6,178,10,20,-10
14,6,179,9,23,-14
14,6,180,18,18,0
14,6,181,12,24,-12
14,6,182,9,14,-5
14,6,183,5,9,-4
14,6,184,11,25,-14
14,6,185,10,28,-18
14,6,186,8,17,-9
14,6,187,8,18,-10
14,6,188,9,15,-6
14,6,189,3,7,-4
14,6,190,15,16,-1
14,6,191,12,22,-10
14,6,192,17,19,-2
14,6,193,14,16,-2
14,6,194,17,27,-10
14,6,195,15,24,-9
14,6,196,16,23,-7
14,6,197,14,16,-2
14,6,198,13,7,6
14,6,199,5,29,-24
14,6,200,14,17,-3
14,6,201,21,16,5
14,6,202,6,25,-19
14,6,203,14,18,-4
14,6,204,6,20,-14
14,6,205,11,17,-6
14,6,206,27,22,5
14,6,207,6,8,-2
14,6,208,11,11,0
14,6,209,11,18,-7
14,6,210,26,18,8
14,6,211,21,12,9
14,6,212,16,28,-12
14,6,213,11,18,-7
14,6,214,5,30,-25
14,6,215,11,20,-9
14,6,216,7,7,0
14,6,217,17,16,1
14,6,218,10,31,-21
14,6,219,13,14,-1
14,6,220,17,30,-13
14,6,221,17,31,-14
14,6,222,6,22,-16
14,6,223,4,18,-14
14,6,224,11,14,-3
14,6,225,18,24,-6
14,6,226,14,17,-3
14,6,227,14,13,1
14,6,228,13,16,-3
14,6,229,8,17,-9
14,6,230,15,30,-15
14,6,231,7,13,-6
14,6,232,9,18,-9
14,6,233,10,30,-20
14,6,234,12,17,-5
14,6,235,18,21,-3
14,6,236,16,12,4
14,6,237,9,14,-5
14,6,238,30,35,-5
14,6,239,6,19,-13
14,6,240,3,4,-1
14,6,241,15,22,-7
14,6,242,20,24,-4
14,6,243,15,25,-10
14,6,244,16,27,-11
14,6,245,25,23,2
14,6,246,8,7,1
14,6,247,12,21,-9
14,6,248,9,14,-5
14,6,249,8,14,-6
14,6,250,15,17,-2
14,6,251,9,28,-19
14,6,252,22,24,-2
14,6,253,11,18,-7
14,6,254,13,20,-7
14,6,255,9,23,-14
14,6,256,7,10,-3
14,6,257,7,6,1
14,6,258,10,13,-3
14,6,259,14,25,-11
14,6,260,6,26,-20
14,6,261,15,7,8
14,6,262,7,6,1
14,6,263,9,15,-6
14,6,264,15,19,-4
14,6,265,17,21,-4
14,6,266,11,27,-16
14,6,267,12,16,-4
14,6,268,10,21,-11
14,6,269,16,24,-8
14,6,270,16,19,-3
14,6,271,7,16,-9
14,6,272,16,14,2
14,6,273,19,20,-1
14,6,274,1,11,-10
14,6,275,27,29,-2
14,6,276,23,20,3
14,6,277,12,22,-10
14,6,278,11,15,-4
14,6,279,5,23,-18
14,6,280,19,40,-21
14,6,281,14,32,-18
14,6,282,10,38,-28
14,6,283,13,24,-11
14,6,284,16,10,6
14,6,285,15,11,4
14,6,286,8,16,-8
14,6,287,14,46,-32
14,6,288,6,8,-2
14,6,289,14,25,-11
14,6,290,10,15,-5
14,6,291,5,14,-9
14,6,292,15,25,-10
14,6,293,6,8,-2
14,6,294,11,17,-6
14,6,295,11,42,-31
14,6,296,9,20,-11
14,6,297,4,24,-20
14,6,298,10,15,-5
14,6,299,8,14,-6
14,7,0,10,6,4
14,7,1,8,23,-15
14,7,2,9,15,-6
14,7,3,23,27,-4
14,7,4,15,17,-2
14,7,5,16,40,-24
14,7,6,14,21,-7
14,7,7,11,29,-18
14,7,8,10,20,-10
14,7,9,5,19,-14
14,7,10,3,16,-13
14,7,11,9,20,-11
14,7,12,12,9,3
14,7,13,9,19,-10
14,7,14,23,12,11
14,7,15,15,11,4
14,7,16,9,15,-6
14,7,17,14,16,-2
14,7,18,9,21,-12
14,7,19,16,16,0
14,7,20,17,38,-21
14,7,21,14,21,-7
14,7,22,6,15,-9
14,7,23,15,14,1
14,7,24,15,26,-11
14,7,25,9,28,-19
14,7,26,14,17,-3
14,7,27,17,29,-12
14,7,28,9,8,1
14,7,29,10,24,-14
14,7,30,6,21,-15
14,7,31,9,22,-13
14,7,32,11,15,-4
14,7,33,7,20,-13
14,7,34,19,23,-4
14,7,35,19,16,3
14,7,36,12,23,-11
14,7,37,9,14,-5
14,7,38,11,10,1
14,7,39,9,28,-19
14,7,40,11,14,-3
14,7,41,9,22,-13
14,7,42,9,14,-5
14,7,43,14,17,-3
14,7,44,7,23,-16
14,7,45,10,26,-16
14,7,46,10,27,-17
14,7,47,12,15,-3
14,7,48,14,28,-14
14,7,49,22,23,-1
14,7,50,14,17,-3
14,7,51,17,20,-3
14,7,52,21,19,2
14,7,53,9,12,-3
14,7,54,15,14,1
14,7,55,10,11,-1
14,7,56,20,23,-3
14,7,57,23,17,6
14,7,58,21,18,3
14,7,59,12,23,-11
14,7,60,13,19,-6
14,7,61,6,11,-5
14,7,62,13,16,-3
14,7,63,10,30,-20
14,7,64,15,20,-5
14,7,65,13,11,2
14,7,66,8,6,2
14,7,67,11,30,-19
14,7,68,8,11,-3
14,7,69,17,20,-3
14,7,70,23,12,11
14,7,71,19,14,5
14,7,72,13,28,-15
14,7,73,13,22,-9
14,7,74,3,10,-7
14,7,75,9,16,-7
14,7,76,7,17,-10
14,7,77,13,16,-3
14,7,78,8,6,2
14,7,79,7,14,-7
14,7,80,12,16,-4
14,7,81,18,23,-5
14,7,82,6,14,-8
14,7,83,5,13,-8
14,7,84,11,16,-5
14,7,85,10,13,-3
14,7,86,11,20,-9
14,7,87,13,22,-9
14,7,88,9,10,-1
14,7,89,9,21,-12
14,7,90,13,15,-2
14,7,91,18,17,1
14,7,92,14,29,-15
14,7,93,18,22,-4
14,7,94,14,22,-8
14,7,95,13,40,-27
14,7,96,9,30,-21
14,7,97,9,23,-14
14,7,98,18,6,12
14,7,99,6,22,-16
14,7,100,11,22,-11
14,7,101,14,19,-5
14,7,102,11,11,0
14,7,103,4,9,-5
14,7,104,14,25,-11
14,7,105,9,9,0
14,7,106,12,10,2
14,7,107,10,26,-16
14,7,108,9,19,-10
14,7,109,27,36,-9
14,7,110,10,19,-9
14,7,111,20,20,0
14,7,112,11,24,-13
14,7,113,15,33,-18
14,7,114,12,29,-17
14,7,115,11,16,-5
14,7,116,15,14,1
14,7,117,15,25,-10
14,7,118,6,8,-2
14,7,119,12,20,-8
14,7,120,8,31,-23
14,7,121,15,9,6
14,7,122,11,22,-11
14,7,123,11,15,-4
14,7,124,9,20,-11
14,7,125,9,28,-19
14,7,126,5,13,-8
14,7,127,7,10,-3
14,7,128,7,19,-12
14,7,129,18,19,-1
14,7,130,10,17,-7
14,7,131,6,9,-3
14,7,132,19,29,-10
14,7,133,16,19,-3
14,7,134,19,20,-1
14,7,135,19,11,8
14,7,136,29,13,16
14,7,137,12,22,-10
14,7,138,8,16,-8
14,7,139,7,20,-13
14,7,140,10,10,0
14,7,141,9,19,-10
14,7,142,15,9,6
14,7,143,12,16,-4
14,7,144,14,23,-9
14,7,145,15,32,-17
14,7,146,11,28,-17
14,7,147,15,16,-1
14,7,148,6,20,-14
14,7,149,9,25,-16
14,7,150,15,28,-13
14,7,151,17,37,-20
14,7,152,13,16,-3
14,7,153,13,26,-13
14,7,154,15,20,-5
14,7,155,13,14,-1
14,7,156,6,19,-13
14,7,157,4,19,-15
14,7,158,21,19,2
14,7,159,3,2,1
14,7,160,19,20,-1
14,7,161,11,13,-2
14,7,162,12,15,-3
14,7,163,17,9,8
14,7,164,7,17,-10
14,7,165,10,13,-3
14,7,166,5,23,-18
14,7,167,21,13,8
14,7,168,13,11,2
14,7,169,16,15,1
14,7,170,13,13,0
14,7,171,15,13,2
14,7,172,14,7,7
14,7,173,12,29,-17
14,7,174,15,20,-5
14,7,175,15,18,-3
14,7,176,16,19,-3
14,7,177,16,28,-12
14,7,178,8,16,-8
14,7,179,12,31,-19
14,7,180,10,10,0
14,7,181,9,27,-18
14,7,182,11,34,-23
14,7,183,14,14,0
14,7,184,20,11,9
14,7,185,13,21,-8
14,7,186,27,13,14
14,7,187,22,12,10
14,7,188,9,23,-14
14,7,189,13,11,2
14,7,190,19,22,-3
14,7,191,9,28,-19
14,7,192,12,20,-8
14,7,193,5,15,-10
14,7,194,17,28,-11
14,7,195,6,15,-9
14,7,196,15,26,-11
14,7,197,14,23,-9
14,7,198,6,11,-5
14,7,199,14,21,-7
14,7,200,12,6,6
14,7,201,18,17,1
14,7,202,12,12,0
14,7,203,7,12,-5
14,7,204,13,22,-9
14,7,205,9,20,-11
14,7,206,15,10,5
14,7,207,18,18,0
14,7,208,11,16,-5
14,7,209,5,11,-6
14,7,210,16,22,-6
14,7,211,15,13,2
14,7,212,3,4,-1
14,7,213,3,11,-8
14,7,214,8,14,-6
14,7,215,14,25,-11
14,7,216,15,16,-1
14,7,217,25,18,7
14,7,218,13,24,-11
14,7,219,13,30,-17
14,7,220,12,26,-14
14,7,221,15,21,-6
14,7,222,7,26,-19
14,7,223,5,15,-10
14,7,224,11,17,-6
14,7,225,15,24,-9
14,7,226,4,18,-14
14,7,227,19,21,-2
14,7,228,6,9,-3
14,7,229,9,9,0
14,7,230,8,33,-25
14,7,231,19,37,-18
14,7,232,17,14,3
14,7,233,5,30,-25
14,7,234,8,9,-1
14,7,235,17,17,0
14,7,236,8,19,-11
14,7,237,18,8,10
14,7,238,9,14,-5
14,7,239,6,14,-8
14,7,240,18,19,-1
14,7,241,9,11,-2
14,7,242,15,23,-8
14,7,243,6,10,-4
14,7,244,10,19,-9
14,7,245,14,23,-9
14,7,246,13,14,-1
14,7,247,11,15,-4
14,7,248,16,11,5
14,7,249,16,21,-5
14,7,250,20,23,-3
14,7,251,16,20,-4
14,7,252,17,24,-7
14,7,253,16,26,-10
14,7,254,7,5,2
14,7,255,17,14,3
14,7,256,15,12,3
14,7,257,18,23,-5
14,7,258,14,35,-21
14,7,259,14,24,-10
14,7,260,8,18,-10
14,7,261,16,22,-6
14,7,262,15,22,-7
14,7,263,17,24,-7
14,7,264,8,2,6
14,7,265,13,17,-4
14,7,266,4,9,-5
14,7,267,14,28,-14
14,7,268,9,14,-5
14,7,269,20,28,-8
14,7,270,6,8,-2
14,7,271,17,26,-9
14,7,272,11,13,-2
14,7,273,10,21,-11
14,7,274,12,18,-6
14,7,275,12,11,1
14,7,276,11,33,-22
14,7,277,9,15,-6
14,7,278,12,12,0
14,7,279,10,8,2
14,7,280,16,26,-10
14,7,281,8,14,-6
14,7,282,6,26,-20
14,7,283,19,20,-1
14,7,284,19,42,-23
14,7,285,12,14,-2
14,7,286,17,22,-5
14,7,287,4,11,-7
14,7,288,23,21,2
14,7,289,5,11,-6
14,7,290,13,15,-2
14,7,291,5,8,-3
14,7,292,24,35,-11
14,7,293,17,25,-8
14,7,294,8,13,-5
14,7,295,7,14,-7
14,7,296,10,21,-11
14,7,297,15,9,6
14,7,298,13,21,-8
14,7,299,9,16,-7
14,8,0,18,11,7
14,8,1,13,13,0
14,8,2,12,24,-12
14,8,3,25,24,1
14,8,4,14,27,-13
14,8,5,6,9,-3
14,8,6,11,16,-5
14,8,7,4,12,-8
14,8,8,14,9,5
14,8,9,20,26,-6
14,8,10,19,24,-5
14,8,11,5,5,0
14,8,12,23,18,5
14,8,13,16,17,-1
14,8,14,21,22,-1
14,8,15,16,24,-8
14,8,16,19,23,-4
14,8,17,4,8,-4
14,8,18,23,24,-1
14,8,19,11,16,-5
14,8,20,14,23,-9
14,8,21,9,8,1
14,8,22,11,31,-20
14,8,23,11,22,-11
14,8,24,13,12,1
14,8,25,13,22,-9
14,8,26,11,26,-15
14,8,27,8,10,-2
14,8,28,13,28,-15
14,8,29,9,25,-16
14,8,30,12,13,-1
14,8,31,14,18,-4
14,8,32,14,15,-1
14,8,33,9,14,-5
14,8,34,9,8,1
14,8,35,4,10,-6
14,8,36,19,27,-8
14,8,37,13,13,0
14,8,38,10,35,-25
14,8,39,14,24,-10
14,8,40,6,12,-6
14,8,41,18,17,1
14,8,42,6,9,-3
14,8,43,14,22,-8
14,8,44,18,10,8
14,8,45,13,12,1
14,8,46,22,30,-8
14,8,47,17,12,5
14,8,48,7,9,-2
14,8,49,14,10,4
14,8,50,14,16,-2
14,8,51,8,18,-10
14,8,52,13,23,-10
14,8,53,10,18,-8
14,8,54,15,22,-7
14,8,55,14,22,-8
14,8,56,17,14,3
14,8,57,12,13,-1
14,8,58,10,21,-11
14,8,59,13,24,-11
14,8,60,13,5,8
14,8,61,17,19,-2
14,8,62,15,18,-3
14,8,63,14,27,-13
14,8,64,6,12,-6
14,8,65,11,18,-7
14,8,66,7,26,-19
14,8,67,17,16,1
14,8,68,18,29,-11
14,8,69,7,26,-19
14,8,70,16,9,7
14,8,71,20,34,-14
14,8,72,15,17,-2
14,8,73,23,18,5
14,8,74,19,24,-5
14,8,75,13,12,1
14,8,76,17,26,-9
14,8,77,14,23,-9
14,8,78,12,20,-8
14,8,79,30,28,2
14,8,80,10,12,-2
14,8,81,8,6,2
14,8,82,7,16,-9
14,8,83,6,17,-11
14,8,84,5,16,-11
14,8,85,6,27,-21
14,8,86,16,24,-8
14,8,87,16,9,7
14,8,88,13,14,-1
14,8,89,18,24,-6
14,8,90,9,15,-6
14,8,91,9,17,-8
14,8,92,13,23,-10
14,8,93,17,26,-9
14,8,94,9,25,-16
14,8,95,9,12,-3
14,8,96,15,19,-4
14,8,97,18,27,-9
14,8,98,4,23,-19
14,8,99,8,9,-1
14,8,100,12,13,-1
14,8,101,22,29,-7
14,8,102,15,9,6
14,8,103,14,36,-22
14,8,104,12,16,-4
14,8,105,7,15,-8
14,8,106,14,14,0
14,8,107,17,14,3
14,8,108,12,29,-17
14,8,109,8,12,-4
14,8,110,8,15,-7
14,8,111,9,21,-12
14,8,112,20,28,-8
14,8,113,9,22,-13
14,8,114,10,21,-11
14,8,115,19,24,-5
14,8,116,10,23,-13
14,8,117,13,11,2
14,8,118,11,15,-4
14,8,119,16,24,-8
14,8,120,14,19,-5
14,8,121,6,23,-17
14,8,122,13,22,-9
14,8,123,15,11,4
14,8,124,10,19,-9
14,8,125,8,14,-6
14,8,126,18,15,3
14,8,127,13,13,0
14,8,128,9,10,-1
14,8,129,9,18,-9
14,8,130,5,19,-14
14,8,131,16,14,2
14,8,132,11,29,-18
14,8,133,5,15,-10
14,8,134,18,30,-12
14,8,135,15,29,-14
14,8,136,10,18,-8
14,8,137,11,12,-1
14,8,138,15,6,9
14,8,139,15,18,-3
14,8,140,16,15,1
14,8,141,22,25,-3
14,8,142,9,11,-2
14,8,143,15,17,-2
14,8,144,14,8,6
14,8,145,15,31,-16
14,8,146,17,20,-3
14,8,147,18,26,-8
14,8,148,14,15,-1
14,8,149,16,10,6
14,8,150,10,19,-9
14,8,151,3,19,-16
14,8,152,12,27,-15
14,8,153,10,22,-12
14,8,154,26,29,-3
14,8,155,13,26,-13
14,8,156,13,16,-3
14,8,157,12,13,-1
14,8,158,19,34,-15
14,8,159,9,20,-11
14,8,160,20,25,-5
14,8,161,13,22,-9
14,8,162,10,27,-17
14,8,163,14,10,4
14,8,164,25,20,5
14,8,165,26,23,3
14,8,166,17,17,0
14,8,167,11,15,-4
14,8,168,4,10,-6
14,8,169,13,11,2
14,8,170,9,9,0
14,8,171,12,30,-18
14,8,172,11,8,3
14,8,173,21,19,2
14,8,174,6,8,-2
14,8,175,5,14,-9
14,8,176,21,26,-5
14,8,177,8,14,-6
14,8,178,13,12,1
14,8,179,19,24,-5
14,8,180,16,14,2
14,8,181,16,19,-3
14,8,182,12,9,3
14,8,183,20,19,1
14,8,184,9,12,-3
14,8,185,13,22,-9
14,8,186,14,25,-11
14,8,187,5,12,-7
14,8,188,25,31,-6
14,8,189,7,11,-4
14,8,190,9,24,-15
14,8,191,13,16,-3
14,8,192,16,21,-5
14,8,193,9,18,-9
14,8,194,11,15,-4
14,8,195,16,13,3
14,8,196,16,15,1
14,8,197,3,6,-3
14,8,198,17,20,-3
14,8,199,6,21,-15
14,8,200,10,37,-27
14,8,201,26,14,12
14,8,202,10,15,-5
14,8,203,6,7,-1
14,8,204,15,17,-2
14,8,205,6,32,-26
14,8,206,18,22,-4
14,8,207,15,25,-10
14,8,208,18,16,2
14,8,209,18,31,-13
14,8,210,10,15,-5
14,8,211,12,16,-4
14,8,212,12,17,-5
14,8,213,12,34,-22
14,8,214,17,17,0
14,8,215,18,35,-17
14,8,216,15,18,-3
14,8,217,10,14,-4
14,8,218,10,26,-16
14,8,219,27,30,-3
14,8,220,5,19,-14
14,8,221,20,26,-6
14,8,222,12,11,1
14,8,223,5,16,-11
14,8,224,7,15,-8
14,8,225,9,14,-5
14,8,226,13,21,-8
14,8,227,22,31,-9
14,8,228,16,11,5
14,8,229,8,23,-15
14,8,230,18,21,-3
14,8,231,11,7,4
14,8,232,27,24,3
14,8,233,10,21,-11
14,8,234,18,22,-4
14,8,235,11,12,-1
14,8,236,4,11,-7
14,8,237,11,13,-2
14,8,238,20,14,6
14,8,239,14,15,-1
14,8,240,14,13,1
14,8,241,7,16,-9
14,8,242,7,20,-13
14,8,243,13,28,-15
14,8,244,16,11,5
14,8,245,14,16,-2
14,8,246,9,12,-3
14,8,247,11,14,-3
14,8,248,17,36,-19
14,8,249,12,18,-6
14,8,250,19,8,11
14,8,251,11,22,-11
14,8,252,12,11,1
14,8,253,16,23,-7
14,8,254,17,24,-7
14,8,255,14,13,1
14,8,256,6,26,-20
14,8,257,4,20,-16
14,8,258,23,23,0
14,8,259,14,10,4
14,8,260,12,24,-12
14,8,261,10,16,-6
14,8,262,16,7,9
14,8,263,10,9,1
14,8,264,18,30,-12
14,8,265,14,28,-14
14,8,266,12,19,-7
14,8,267,31,19,12
14,8,268,20,22,-2
14,8,269,11,2,9
14,8,270,8,11,-3
14,8,271,11,23,-12
14,8,272,22,23,-1
14,8,273,6,22,-16
14,8,274,17,21,-4
14,8,275,14,22,-8
14,8,276,13,14,-1
14,8,277,7,18,-11
14,8,278,11,24,-13
14,8,279,10,21,-11
14,8,280,6,13,-7
14,8,281,15,10,5
14,8,282,11,9,2
14,8,283,14,12,2
14,8,284,24,35,-11
14,8,285,7,14,-7
14,8,286,8,16,-8
14,8,287,18,11,7
14,8,288,9,12,-3
14,8,289,20,23,-3
14,8,290,6,16,-10
14,8,291,7,7,0
14,8,292,7,18,-11
14,8,293,7,19,-12
14,8,294,23,14,9
14,8,295,17,24,-7
14,8,296,12,20,-8
14,8,297,11,28,-17
14,8,298,18,20,-2
14,8,299,13,18,-5
14,9,0,16,21,-5
14,9,1,19,30,-11
14,9,2,15,36,-21
14,9,3,13,8,5
14,9,4,9,12,-3
14,9,5,7,10,-3
14,9,6,8,17,-9
14,9,7,8,13,-5
14,9,8,14,26,-12
14,9,9,11,12,-1
14,9,10,10,43,-33
14,9,11,21,17,4
14,9,12,16,11,5
14,9,13,32,24,8
14,9,14,8,19,-11
14,9,15,12,18,-6
14,9,16,10,33,-23
14,9,17,13,9,4
14,9,18,11,9,2
14,9,19,15,31,-16
14,9,20,13,13,0
14,9,21,10,8,2
14,9,22,21,18,3
14,9,23,13,9,4
14,9,24,10,18,-8
14,9,25,10,10,0
14,9,26,16,15,1
14,9,27,13,44,-31
14,9,28,11,16,-5
14,9,29,16,14,2
14,9,30,21,28,-7
14,9,31,15,17,-2
14,9,32,9,17,-8
14,9,33,7,23,-16
14,9,34,8,12,-4
14,9,35,8,15,-7
14,9,36,11,14,-3
14,9,37,1,15,-14
14,9,38,12,11,1
14,9,39,14,14,0
14,9,40,28,23,5
14,9,41,12,13,-1
14,9,42,12,22,-10
14,9,43,15,11,4
14,9,44,3,5,-2
14,9,45,17,15,2
14,9,46,4,10,-6
14,9,47,20,20,0
14,9,48,10,12,-2
14,9,49,24,15,9
14,9,50,7,11,-4
14,9,51,8,13,-5
14,9,52,10,16,-6
14,9,53,11,11,0
14,9,54,8,9,-1
14,9,55,7,14,-7
14,9,56,5,15,-10
14,9,57,11,15,-4
14,9,58,18,19,-1
14,9,59,14,17,-3
14,9,60,19,20,-1
14,9,61,12,9,3
14,9,62,10,21,-11
14,9,63,12,20,-8
14,9,64,20,22,-2
14,9,65,15,22,-7
14,9,66,20,16,4
14,9,67,20,15,5
14,9,68,18,13,5
14,9,69,20,8,12
14,9,70,15,35,-20
14,9,71,14,24,-10
14,9,72,7,15,-8
14,9,73,21,20,1
14,9,74,14,32,-18
14,9,75,21,31,-10
14,9,76,13,28,-15
14,9,77,14,24,-10
14,9,78,14,12,2
14,9,79,16,20,-4
14,9,80,14,7,7
14,9,81,10,14,-4
14,9,82,15,13,2
14,9,83,13,19,-6
14,9,84,14,24,-10
14,9,85,9,10,-1
14,9,86,12,11,1
14,9,87,12,8,4
14,9,88,18,10,8
14,9,89,17,12,5
14,9,90,17,13,4
14,9,91,8,11,-3
14,9,92,21,25,-4
14,9,93,7,16,-9
14,9,94,13,29,-16
14,9,95,11,12,-1
14,9,96,10,14,-4
14,9,97,9,20,-11
14,9,98,10,20,-10
14,9,99,14,15,-1
14,9,100,12,15,-3
14,9,101,16,29,-13
14,9,102,25,24,1
14,9,103,22,19,3
14,9,104,6,17,-11
14,9,105,17,18,-1
14,9,106,11,24,-13
14,9,107,7,8,-1
14,9,108,12,18,-6
14,9,109,18,21,-3
14,9,110,16,22,-6
14,9,111,13,26,-13
14,9,112,17,24,-7
14,9,113,5,9,-4
14,9,114,8,24,-16
14,9,115,18,25,-7
14,9,116,24,8,16
14,9,117,11,19,-8
14,9,118,18,18,0
14,9,119,9,19,-10
14,9,120,17,30,-13
14,9,121,15,20,-5
14,9,122,7,6,1
14,9,123,8,12,-4
14,9,124,24,18,6
14,9,125,15,31,-16
14,9,126,12,20,-8
14,9,127,9,7,2
14,9,128,10,14,-4
14,9,129,11,15,-4
14,9,130,19,14,5
14,9,131,10,27,-17
14,9,132,8,16,-8
14,9,133,7,10,-3
14,9,134,8,16,-8
14,9,135,13,32,-19
14,9,136,8,12,-4
14,9,137,11,16,-5
14,9,138,17,21,-4
14,9,139,6,15,-9
14,9,140,16,16,0
14,9,141,6,12,-6
14,9,142,23,20,3
14,9,143,11,29,-18
14,9,144,12,21,-9
14,9,145,13,8,5
14,9,146,11,22,-11
14,9,147,16,17,-1
14,9,148,15,9,6
14,9,149,9,16,-7
14,9,150,12,17,-5
14,9,151,9,5,4
14,9,152,19,8,11
14,9,153,8,17,-9
14,9,154,18,28,-10
14,9,155,19,13,6
14,9,156,17,21,-4
14,9,157,12,16,-4
14,9,158,11,9,2
14,9,159,9,16,-7
14,9,160,22,21,1
14,9,161,12,15,-3
14,9,162,10,9,1
14,9,163,19,20,-1
14,9,164,17,13,4
14,9,165,15,10,5
14,9,166,13,14,-1
14,9,167,20,26,-6
14,9,168,26,10,16
14,9,169,11,15,-4
14,9,170,24,12,12
14,9,171,19,11,8
14,9,172,17,13,4
14,9,173,14,12,2
14,9,174,15,17,-2
14,9,175,15,29,-14
14,9,176,11,14,-3
14,9,177,13,22,-9
14,9,178,8,13,-5
14,9,179,20,13,7
14,9,180,8,5,3
14,9,181,3,21,-18
14,9,182,11,9,2
14,9,183,14,20,-6
14,9,184,10,21,-11
14,9,185,12,24,-12
14,9,186,22,19,3
14,9,187,13,23,-10
14,9,188,24,24,0
14,9,189,10,12,-2
14,9,190,17,23,-6
14,9,191,10,8,2
14,9,192,17,26,-9
14,9,193,20,24,-4
14,9,194,20,23,-3
14,9,195,18,30,-12
14,9,196,16,17,-1
14,9,197,13,15,-2
14,9,198,17,23,-6
14,9,199,17,41,-24
14,9,200,14,13,1
14,9,201,15,17,-2
14,9,202,10,16,-6
14,9,203,16,18,-2
14,9,204,3,7,-4
14,9,205,12,21,-9
14,9,206,13,19,-6
14,9,207,20,12,8
14,9,208,8,20,-12
14,9,209,18,10,8
14,9,210,7,15,-8
14,9,211,12,13,-1
14,9,212,21,18,3
14,9,213,15,13,2
14,9,214,12,11,1
14,9,215,22,29,-7
14,9,216,18,14,4
14,9,217,8,14,-6
14,9,218,16,22,-6
14,9,219,14,24,-10
14,9,220,9,15,-6
14,9,221,18,18,0
14,9,222,12,12,0
14,9,223,13,24,-11
14,9,224,12,12,0
14,9,225,3,7,-4
14,9,226,13,19,-6
14,9,227,9,8,1
14,9,228,12,20,-8
14,9,229,23,15,8
14,9,230,5,12,-7
14,9,231,9,17,-8
14,9,232,11,12,-1
14,9,233,15,16,-1
14,9,234,24,19,5
14,9,235,13,26,-13
14,9,236,15,18,-3
14,9,237,8,15,-7
14,9,238,15,28,-13
14,9,239,19,26,-7
14,9,240,14,22,-8
14,9,241,17,7,10
14,9,242,8,19,-11
14,9,243,24,17,7
14,9,244,16,19,-3
14,9,245,18,23,-5
14,9,246,19,15,4
14,9,247,9,23,-14
14,9,248,16,24,-8
14,9,249,11,11,0
14,9,250,12,17,-5
14,9,251,12,23,-11
14,9,252,12,10,2
14,9,253,14,27,-13
14,9,254,10,15,-5
14,9,255,6,24,-18
14,9,256,6,12,-6
14,9,257,9,22,-13
14,9,258,14,28,-14
14,9,259,12,17,-5
14,9,260,23,19,4
14,9,261,5,14,-9
14,9,262,11,12,-1
14,9,263,24,11,13
14,9,264,16,15,1
14,9,265,17,12,5
14,9,266,10,9,1
14,9,267,7,17,-10
14,9,268,8,17,-9
14,9,269,20,26,-6
14,9,270,14,18,-4
14,9,271,13,17,-4
14,9,272,11,18,-7
14,9,273,12,19,-7
14,9,274,16,12,4
14,9,275,22,25,-3
14,9,276,5,22,-17
14,9,277,21,15,6
14,9,278,31,19,12
14,9,279,10,13,-3
14,9,280,12,20,-8
14,9,281,22,20,2
14,9,282,17,26,-9
14,9,283,10,3,7
14,9,284,17,13,4
14,9,285,15,10,5
14,9,286,10,20,-10
14,9,287,11,15,-4
14,9,288,11,13,-2
14,9,289,11,12,-1
14,9,290,20,25,-5
14,9,291,7,14,-7
14,9,292,16,13,3
14,9,293,18,20,-2
14,9,294,10,16,-6
14,9,295,14,32,-18
14,9,296,8,1,7
14,9,297,10,19,-9
14,9,298,18,15,3
14,9,299,8,12,-4
14,10,0,1,33,-32
14,10,1,26,31,-5
14,10,2,18,11,7
14,10,3,9,11,-2
14,10,4,17,17,0
14,10,5,5,10,-5
14,10,6,13,15,-2
14,10,7,13,22,-9
14,10,8,11,21,-10
14,10,9,14,17,-3
14,10,10,6,6,0
14,10,11,31,21,10
14,10,12,20,9,11
14,10,13,15,17,-2
14,10,14,19,31,-12
14,10,15,13,8,5
14,10,16,10,23,-13
14,10,17,12,15,-3
14,10,18,17,17,0
14,10,19,15,9,6
14,10,20,12,13,-1
14,10,21,7,10,-3
14,10,22,9,17,-8
14,10,23,6,20,-14
14,10,24,10,8,2
14,10,25,11,9,2
14,10,26,19,30,-11
14,10,27,20,25,-5
14,10,28,26,23,3
14,10,29,8,10,-2
14,10,30,6,9,-3
14,10,31,25,24,1
14,10,32,16,17,-1
14,10,33,16,23,-7
14,10,34,16,18,-2
14,10,35,7,20,-13
14,10,36,20,21,-1
14,10,37,8,18,-10
14,10,38,10,27,-17
14,10,39,5,16,-11
14,10,40,20,22,-2
14,10,41,14,23,-9
14,10,42,16,17,-1
14,10,43,6,5,1
14,10,44,21,8,13
14,10,45,10,6,4
14,10,46,15,8,7
14,10,47,9,14,-5
14,10,48,13,11,2
14,10,49,8,15,-7
14,10,50,4,16,-12
14,10,51,7,16,-9
14,10,52,19,8,11
14,10,53,8,16,-8
14,10,54,17,25,-8
14,10,55,18,19,-1
14,10,56,9,29,-20
14,10,57,27,35,-8
14,10,58,3,11,-8
14,10,59,20,21,-1
14,10,60,21,13,8
14,10,61,12,27,-15
14,10,62,15,19,-4
14,10,63,34,35,-1
14,10,64,14,27,-13
14,10,65,11,10,1
14,10,66,9,25,-16
14,10,67,10,30,-20
14,10,68,14,20,-6
14,10,69,15,30,-15
14,10,70,13,12,1
14,10,71,18,26,-8
14,10,72,15,9,6
14,10,73,18,28,-10
14,10,74,8,18,-10
14,10,75,20,17,3
14,10,76,14,13,1
14,10,77,18,19,-1
14,10,78,18,16,2
14,10,79,11,19,-8
14,10,80,1,10,-9
14,10,81,4,14,-10
14,10,82,14,20,-6
14,10,83,17,20,-3
14,10,84,19,12,7
14,10,85,27,14,13
14,10,86,12,16,-4
14,10,87,15,22,-7
14,10,88,25,17,8
14,10,89,12,12,0
14,10,90,11,9,2
14,10,91,18,23,-5
14,10,92,12,17,-5
14,10,93,15,21,-6
14,10,94,12,17,-5
14,10,95,11,13,-2
14,10,96,7,33,-26
14,10,97,16,17,-1
14,10,98,4,6,-2
14,10,99,16,33,-17
14,10,100,12,20,-8
14,10,101,17,14,3
14,10,102,12,14,-2
14,10,103,20,10,10
14,10,104,16,22,-6
14,10,105,8,8,0
14,10,106,16,13,3
14,10,107,9,11,-2
14,10,108,18,9,9
14,10,109,17,12,5
14,10,110,17,17,0
14,10,111,12,21,-9
14,10,112,15,27,-12
14,10,113,14,21,-7
14,10,114,8,19,-11
14,10,115,15,14,1
14,10,116,9,11,-2
14,10,117,22,20,2
14,10,118,13,12,1
14,10,119,18,10,8
14,10,120,9,13,-4
14,10,121,11,7,4
14,10,122,20,22,-2
14,10,123,10,15,-5
14,10,124,11,12,-1
14,10,125,10,16,-6
14,10,126,12,14,-2
14,10,127,26,23,3
14,10,128,19,10,9
14,10,129,13,17,-4
14,10,130,20,16,4
14,10,131,4,16,-12
14,10,132,4,15,-11
14,10,133,17,14,3
14,10,134,11,38,-27
14,10,135,15,22,-7
14,10,136,16,11,5
14,10,137,15,32,-17
14,10,138,8,23,-15
14,10,139,11,23,-12
14,10,140,11,19,-8
14,10,141,9,12,-3
14,10,142,6,7,-1
14,10,143,5,15,-10
14,10,144,20,16,4
14,10,145,6,13,-7
14,10,146,10,10,0
14,10,147,4,5,-1
14,10,148,20,8,12
14,10,149,18,23,-5
14,10,150,15,14,1
14,10,151,11,9,2
14,10,152,15,29,-14
14,10,153,7,7,0
14,10,154,22,25,-3
14,10,155,13,15,-2
14,10,156,26,27,-1
14,10,157,9,23,-14
14,10,158,6,23,-17
14,10,159,10,24,-14
14,10,160,11,18,-7
14,10,161,19,10,9
14,10,162,17,14,3
14,10,163,13,12,1
14,10,164,15,22,-7
14,10,165,19,11,8
14,10,166,6,11,-5
14,10,167,5,10,-5
14,10,168,7,17,-10
14,10,169,11,26,-15
14,10,170,18,14,4
14,10,171,17,17,0
14,10,172,18,16,2
14,10,173,19,19,0
14,10,174,17,16,1
14,10,175,22,17,5
14,10,176,10,7,3
14,10,177,14,29,-15
14,10,178,7,11,-4
14,10,179,19,19,0
14,10,180,24,24,0
14,10,181,11,18,-7
14,10,182,15,12,3
14,10,183,14,17,-3
14,10,184,11,14,-3
14,10,185,11,7,4
14,10,186,20,16,4
14,10,187,14,16,-2
14,10,188,20,18,2
14,10,189,20,16,4
14,10,190,8,14,-6
14,10,191,24,18,6
14,10,192,15,20,-5
14,10,193,16,31,-15
14,10,194,26,16,10
14,10,195,11,32,-21
14,10,196,19,5,14
14,10,197,6,17,-11
14,10,198,10,17,-7
14,10,199,17,29,-12
14,10,200,7,12,-5
14,10,201,17,5,12
14,10,202,20,19,1
14,10,203,11,17,-6
14,10,204,20,23,-3
14,10,205,16,14,2
14,10,206,9,13,-4
14,10,207,16,25,-9
14,10,208,13,10,3
14,10,209,16,10,6
14,10,210,8,12,-4
14,10,211,11,13,-2
14,10,212,3,6,-3
14,10,213,17,22,-5
14,10,214,9,12,-3
14,10,215,5,5,0
14,10,216,17,21,-4
14,10,217,15,25,-10
14,10,218,26,13,13
14,10,219,11,17,-6
14,10,220,12,16,-4
14,10,221,14,18,-4
14,10,222,17,20,-3
14,10,223,7,24,-17
14,10,224,12,13,-1
14,10,225,15,15,0
14,10,226,11,17,-6
14,10,227,5,19,-14
14,10,228,19,27,-8
14,10,229,9,10,-1
14,10,230,20,23,-3
14,10,231,8,11,-3
14,10,232,19,23,-4
14,10,233,13,18,-5
14,10,234,14,9,5
14,10,235,7,16,-9
14,10,236,19,18,1
14,10,237,13,11,2
14,10,238,12,20,-8
14,10,239,13,18,-5
14,10,240,19,10,9
14,10,241,17,24,-7
14,10,242,9,10,-1
14,10,243,2,13,-11
14,10,244,11,14,-3
14,10,245,20,18,2
14,10,246,10,13,-3
14,10,247,20,17,3
14,10,248,8,19,-11
14,10,249,7,20,-13
14,10,250,12,9,3
14,10,251,19,19,0
14,10,252,15,23,-8
14,10,253,24,18,6
14,10,254,21,29,-8
14,10,255,12,11,1
14,10,256,9,15,-6
14,10,257,6,18,-12
14,10,258,5,12,-7
14,10,259,15,10,5
14,10,260,9,9,0
14,10,261,14,11,3
14,10,262,14,21,-7
14,10,263,11,14,-3
14,10,264,15,17,-2
14,10,265,10,19,-9
14,10,266,10,23,-13
14,10,267,14,14,0
14,10,268,21,25,-4
14,10,269,16,23,-7
14,10,270,11,22,-11
14,10,271,14,12,2
14,10,272,3,12,-9
14,10,273,5,16,-11
14,10,274,13,22,-9
14,10,275,17,22,-5
14,10,276,27,19,8
14,10,277,16,22,-6
14,10,278,16,11,5
14,10,279,16,26,-10
14,10,280,15,11,4
14,10,281,21,13,8
14,10,282,13,17,-4
14,10,283,5,14,-9
14,10,284,21,21,0
14,10,285,12,9,3
14,10,286,9,12,-3
14,10,287,14,15,-1
14,10,288,16,12,4
14,10,289,4,9,-5
14,10,290,10,12,-2
14,10,291,16,11,5
14,10,292,6,10,-4
14,10,293,11,16,-5
14,10,294,18,8,10
14,10,295,17,28,-11
14,10,296,9,24,-15
14,10,297,23,35,-12
14,10,298,22,25,-3
14,10,299,13,15,-2
14,11,0,21,28,-7
14,11,1,11,11,0
14,11,2,17,51,-34
14,11,3,20,19,1
14,11,4,11,20,-9
14,11,5,14,20,-6
14,11,6,11,22,-11
14,11,7,5,20,-15
14,11,8,15,9,6
14,11,9,13,10,3
14,11,10,6,10,-4
14,11,11,18,12,6
14,11,12,24,20,4
14,11,13,14,9,5
14,11,14,10,10,0
14,11,15,6,12,-6
14,11,16,9,12,-3
14,11,17,10,19,-9
14,11,18,21,37,-16
14,11,19,15,21,-6
14,11,20,22,21,1
14,11,21,14,27,-13
14,11,22,15,28,-13
14,11,23,17,28,-11
14,11,24,19,12,7
14,11,25,24,9,15
14,11,26,10,9,1
14,11,27,6,15,-9
14,11,28,11,12,-1
14,11,29,17,17,0
14,11,30,10,14,-4
14,11,31,2,20,-18
14,11,32,9,18,-9
14,11,33,10,13,-3
14,11,34,12,16,-4
14,11,35,30,17,13
14,11,36,17,19,-2
14,11,37,5,5,0
14,11,38,5,12,-7
14,11,39,8,8,0
14,11,40,19,20,-1
14,11,41,12,19,-7
14,11,42,6,10,-4
14,11,43,18,16,2
14,11,44,12,21,-9
14,11,45,11,30,-19
14,11,46,12,10,2
14,11,47,9,14,-5
14,11,48,13,19,-6
14,11,49,17,19,-2
14,11,50,12,12,0
14,11,51,7,20,-13
14,11,52,12,10,2
14,11,53,5,11,-6
14,11,54,3,15,-12
14,11,55,11,18,-7
14,11,56,17,17,0
14,11,57,5,7,-2
14,11,58,13,18,-5
14,11,59,11,14,-3
14,11,60,8,8,0
14,11,61,18,14,4
14,11,62,11,20,-9
14,11,63,11,21,-10
14,11,64,15,23,-8
14,11,65,14,18,-4
14,11,66,14,6,8
14,11,67,10,10,0
14,11,68,14,19,-5
14,11,69,17,9,8
14,11,70,7,10,-3
14,11,71,22,23,-1
14,11,72,10,15,-5
14,11,73,15,7,8
14,11,74,7,18,-11
14,11,75,10,18,-8
14,11,76,11,18,-7
14,11,77,12,15,-3
14,11,78,14,17,-3
14,11,79,20,17,3
14,11,80,11,19,-8
14,11,81,17,17,0
14,11,82,16,10,6
14,11,83,8,5,3
14,11,84,9,13,-4
14,11,85,13,18,-5
14,11,86,10,23,-13
14,11,87,9,22,-13
14,11,88,9,15,-6
14,11,89,9,15,-6
14,11,90,10,7,3
14,11,91,14,16,-2
14,11,92,8,8,0
14,11,93,10,12,-2
14,11,94,21,17,4
14,11,95,12,23,-11
14,11,96,22,13,9
14,11,97,14,9,5
14,11,98,18,33,-15
14,11,99,20,19,1
14,11,100,12,14,-2
14,11,101,21,19,2
14,11,102,14,7,7
14,11,103,16,20,-4
14,11,104,16,30,-14
14,11,105,10,12,-2
14,11,106,15,5,10
14,11,107,6,13,-7
14,11,108,26,19,7
14,11,109,14,17,-3
14,11,110,23,16,7
14,11,111,12,16,-4
14,11,112,11,21,-10
14,11,113,14,5,9
14,11,114,10,11,-1
14,11,115,13,14,-1
14,11,116,11,16,-5
14,11,117,13,8,5
14,11,118,27,30,-3
14,11,119,13,22,-9
14,11,120,6,17,-11
14,11,121,18,8,10
14,11,122,19,21,-2
14,11,123,17,23,-6
14,11,124,11,11,0
14,11,125,5,31,-26
14,11,126,17,9,8
14,11,127,22,14,8
14,11,128,14,14,0
14,11,129,8,11,-3
14,11,130,10,23,-13
14,11,131,25,16,9
14,11,132,14,25,-11
14,11,133,22,22,0
14,11,134,10,24,-14
14,11,135,14,21,-7
14,11,136,13,27,-14
14,11,137,4,4,0
14,11,138,14,16,-2
14,11,139,26,30,-4
14,11,140,9,24,-15
14,11,141,14,21,-7
14,11,142,15,23,-8
14,11,143,14,10,4
14,11,144,10,14,-4
14,11,145,11,12,-1
14,11,146,21,15,6
14,11,147,15,19,-4
14,11,148,11,12,-1
14,11,149,9,7,2
14,11,150,14,14,0
14,11,151,7,12,-5
14,11,152,19,15,4
14,11,153,25,17,8
14,11,154,11,33,-22
14,11,155,15,8,7
14,11,156,15,25,-10
14,11,157,10,13,-3
14,11,158,5,16,-11
14,11,159,29,22,7
14,11,160,9,12,-3
14,11,161,14,14,0
14,11,162,15,16,-1
14,11,163,17,25,-8
14,11,164,9,15,-6
14,11,165,12,16,-4
14,11,166,14,20,-6
14,11,167,21,13,8
14,11,168,13,12,1
14,11,169,17,12,5
14,11,170,21,18,3
14,11,171,22,29,-7
14,11,172,9,18,-9
14,11,173,11,17,-6
14,11,174,10,16,-6
14,11,175,11,23,-12
14,11,176,11,28,-17
14,11,177,21,13,8
14,11,178,5,7,-2
14,11,179,15,13,2
14,11,180,16,18,-2
14,11,181,16,12,4
14,11,182,12,15,-3
14,11,183,14,20,-6
14,11,184,19,15,4
14,11,185,15,11,4
14,11,186,7,6,1
14,11,187,15,19,-4
14,11,188,17,11,6
14,11,189,3,8,-5
14,11,190,4,10,-6
14,11,191,16,17,-1
14,11,192,17,16,1
14,11,193,15,18,-3
14,11,194,7,18,-11
14,11,195,17,4,13
14,11,196,12,23,-11
14,11,197,13,16,-3
14,11,198,16,33,-17
14,11,199,16,23,-7
14,11,200,9,21,-12
14,11,201,13,12,1
14,11,202,15,30,-15
14,11,203,13,9,4
14,11,204,28,17,11
14,11,205,10,14,-4
14,11,206,12,12,0
14,11,207,9,15,-6
14,11,208,9,16,-7
14,11,209,10,12,-2
14,11,210,13,13,0
14,11,211,10,18,-8
14,11,212,9,10,-1
14,11,213,5,5,0
14,11,214,20,20,0
14,11,215,6,20,-14
14,11,216,18,18,0
14,11,217,14,17,-3
14,11,218,19,22,-3
14,11,219,18,26,-8
14,11,220,22,8,14
14,11,221,6,15,-9
14,11,222,29,26,3
14,11,223,8,30,-22
14,11,224,9,29,-20
14,11,225,24,18,6
14,11,226,16,22,-6
14,11,227,19,15,4
14,11,228,14,21,-7
14,11,229,11,13,-2
14,11,230,14,17,-3
14,11,231,15,18,-3
14,11,232,6,9,-3
14,11,233,18,19,-1
14,11,234,10,18,-8
14,11,235,16,9,7
14,11,236,21,36,-15
14,11,237,7,18,-11
14,11,238,26,13,13
14,11,239,11,12,-1
14,11,240,19,19,0
14,11,241,9,22,-13
14,11,242,14,22,-8
14,11,243,7,21,-14
14,11,244,17,24,-7
14,11,245,28,24,4
14,11,246,7,13,-6
14,11,247,14,22,-8
14,11,248,10,18,-8
14,11,249,17,21,-4
14,11,250,16,16,0
14,11,251,11,25,-14
14,11,252,15,12,3
14,11,253,17,20,-3
14,11,254,13,21,-8
14,11,255,5,6,-1
14,11,256,23,22,1
14,11,257,17,15,2
14,11,258,8,12,-4
14,11,259,22,18,4
14,11,260,16,20,-4
14,11,261,20,5,15
14,11,262,15,20,-5
14,11,263,15,13,2
14,11,264,29,24,5
14,11,265,9,13,-4
14,11,266,3,8,-5
14,11,267,15,13,2
14,11,268,10,7,3
14,11,269,15,20,-5
14,11,270,12,21,-9
14,11,271,9,16,-7
14,11,272,9,22,-13
14,11,273,7,22,-15
14,11,274,18,23,-5
14,11,275,15,18,-3
14,11,276,19,9,10
14,11,277,18,10,8
14,11,278,14,9,5
14,11,279,13,17,-4
14,11,280,13,16,-3
14,11,281,13,18,-5
14,11,282,27,21,6
14,11,283,15,9,6
14,11,284,13,14,-1
14,11,285,13,13,0
14,11,286,15,10,5
14,11,287,17,33,-16
14,11,288,16,25,-9
14,11,289,10,23,-13
14,11,290,12,29,-17
14,11,291,12,12,0
14,11,292,13,14,-1
14,11,293,15,17,-2
14,11,294,9,19,-10
14,11,295,12,25,-13
14,11,296,3,8,-5
14,11,297,33,20,13
14,11,298,19,29,-10
14,11,299,13,28,-15
14,12,0,11,19,-8
14,12,1,14,13,1
14,12,2,17,27,-10
14,12,3,14,18,-4
14,12,4,6,6,0
14,12,5,11,12,-1
14,12,6,20,16,4
14,12,7,5,20,-15
14,12,8,15,21,-6
14,12,9,11,16,-5
14,12,10,15,18,-3
14,12,11,21,26,-5
14,12,12,14,6,8
14,12,13,17,11,6
14,12,14,11,15,-4
14,12,15,16,17,-1
14,12,16,13,17,-4
14,12,17,12,15,-3
14,12,18,17,17,0
14,12,19,8,7,1
14,12,20,6,11,-5
14,12,21,21,10,11
14,12,22,9,20,-11
14,12,23,28,16,12
14,12,24,15,15,0
14,12,25,21,26,-5
14,12,26,19,21,-2
14,12,27,13,19,-6
14,12,28,8,7,1
14,12,29,30,11,19
14,12,30,12,11,1
14,12,31,9,13,-4
14,12,32,17,22,-5
14,12,33,13,19,-6
14,12,34,13,20,-7
14,12,35,16,18,-2
14,12,36,7,20,-13
14,12,37,13,14,-1
14,12,38,4,13,-9
14,12,39,8,7,1
14,12,40,12,15,-3
14,12,41,14,20,-6
14,12,42,19,18,1
14,12,43,23,33,-10
14,12,44,18,31,-13
14,12,45,15,27,-12
14,12,46,17,18,-1
14,12,47,8,16,-8
14,12,48,18,20,-2
14,12,49,14,8,6
14,12,50,18,19,-1
14,12,51,20,13,7
14,12,52,12,18,-6
14,12,53,17,13,4
14,12,54,10,17,-7
14,12,55,19,11,8
14,12,56,22,17,5
14,12,57,11,12,-1
14,12,58,7,15,-8
14,12,59,17,19,-2
14,12,60,18,9,9
14,12,61,16,22,-6
14,12,62,14,17,-3
14,12,63,14,26,-12
14,12,64,18,23,-5
14,12,65,14,13,1
14,12,66,13,11,2
14,12,67,16,29,-13
14,12,68,18,19,-1
14,12,69,15,19,-4
14,12,70,3,20,-17
14,12,71,13,8,5
14,12,72,23,13,10
14,12,73,10,16,-6
14,12,74,13,17,-4
14,12,75,9,16,-7
14,12,76,20,9,11
14,12,77,25,22,3
14,12,78,9,10,-1
14,12,79,4,8,-4
14,12,80,11,16,-5
14,12,81,12,19,-7
14,12,82,20,35,-15
14,12,83,20,22,-2
14,12,84,9,22,-13
14,12,85,22,16,6
14,12,86,20,12,8
14,12,87,6,19,-13
14,12,88,14,11,3
14,12,89,11,19,-8
14,12,90,7,12,-5
14,12,91,15,13,2
14,12,92,18,15,3
14,12,93,18,13,5
14,12,94,6,15,-9
14,12,95,8,19,-11
14,12,96,19,21,-2
14,12,97,11,10,1
14,12,98,19,24,-5
14,12,99,12,28,-16
14,12,100,12,20,-8
14,12,101,18,27,-9
14,12,102,6,2,4
14,12,103,22,19,3
14,12,104,17,10,7
14,12,105,5,8,-3
14,12,106,6,12,-6
14,12,107,14,22,-8
14,12,108,17,13,4
14,12,109,10,5,5
14,12,110,18,26,-8
14,12,111,11,22,-11
14,12,112,11,13,-2
14,12,113,26,28,-2
14,12,114,12,13,-1
14,12,115,23,13,10
14,12,116,9,12,-3
14,12,117,15,13,2
14,12,118,27,26,1
14,12,119,8,13,-5
14,12,120,17,29,-12
14,12,121,14,28,-14
14,12,122,24,14,10
14,12,123,16,16,0
14,12,124,9,8,1
14,12,125,19,9,10
14,12,126,26,18,8
14,12,127,11,19,-8
14,12,128,15,21,-6
14,12,129,24,22,2
14,12,130,12,12,0
14,12,131,21,28,-7
14,12,132,13,14,-1
14,12,133,20,24,-4
14,12,134,15,14,1
14,12,135,11,11,0
14,12,136,15,13,2
14,12,137,15,17,-2
14,12,138,7,10,-3
14,12,139,12,26,-14
14,12,140,10,15,-5
14,12,141,18,13,5
14,12,142,19,10,9
14,12,143,14,12,2
14,12,144,15,28,-13
14,12,145,10,17,-7
14,12,146,10,9,1
14,12,147,12,15,-3
14,12,148,16,10,6
14,12,149,18,12,6
14,12,150,22,15,7
14,12,151,21,13,8
14,12,152,23,6,17
14,12,153,9,11,-2
14,12,154,11,10,1
14,12,155,23,20,3
14,12,156,10,8,2
14,12,157,5,5,0
14,12,158,11,13,-2
14,12,159,17,12,5
14,12,160,10,9,1
14,12,161,9,21,-12
14,12,162,20,11,9
14,12,163,22,24,-2
14,12,164,14,7,7
14,12,165,16,21,-5
14,12,166,20,23,-3
14,12,167,19,24,-5
14,12,168,12,8,4
14,12,169,30,25,5
14,12,170,14,15,-1
14,12,171,11,25,-14
14,12,172,9,10,-1
14,12,173,11,15,-4
14,12,174,17,15,2
14,12,175,14,24,-10
14,12,176,16,15,1
14,12,177,17,25,-8
14,12,178,5,14,-9
14,12,179,13,14,-1
14,12,180,23,17,6
14,12,181,6,18,-12
14,12,182,12,16,-4
14,12,183,17,17,0
14,12,184,8,12,-4
14,12,185,15,19,-4
14,12,186,10,8,2
14,12,187,12,17,-5
14,12,188,7,23,-16
14,12,189,21,34,-13
14,12,190,9,18,-9
14,12,191,7,21,-14
14,12,192,7,25,-18
14,12,193,16,12,4
14,12,194,16,21,-5
14,12,195,22,17,5
14,12,196,17,19,-2
14,12,197,10,12,-2
14,12,198,24,22,2
14,12,199,26,18,8
14,12,200,15,7,8
14,12,201,10,10,0
14,12,202,15,15,0
14,12,203,20,10,10
14,12,204,15,16,-1
14,12,205,32,24,8
14,12,206,22,21,1
14,12,207,19,23,-4
14,12,208,16,26,-10
14,12,209,16,22,-6
14,12,210,21,17,4
14,12,211,19,15,4
14,12,212,18,14,4
14,12,213,19,12,7
14,12,214,6,3,3
14,12,215,14,19,-5
14,12,216,10,18,-8
14,12,217,10,24,-14
14,12,218,16,19,-3
14,12,219,10,14,-4
14,12,220,11,7,4
14,12,221,12,12,0
14,12,222,11,11,0
14,12,223,14,17,-3
14,12,224,17,15,2
14,12,225,15,32,-17
14,12,226,14,12,2
14,12,227,9,9,0
14,12,228,17,20,-3
14,12,229,14,17,-3
14,12,230,16,22,-6
14,12,231,28,18,10
14,12,232,10,24,-14
14,12,233,17,11,6
14,12,234,22,16,6
14,12,235,6,11,-5
14,12,236,13,20,-7
14,12,237,11,6,5
14,12,238,11,11,0
14,12,239,18,30,-12
14,12,240,22,10,12
14,12,241,22,17,5
14,12,242,17,15,2
14,12,243,13,18,-5
14,12,244,9,13,-4
14,12,245,22,9,13
14,12,246,11,11,0
14,12,247,19,22,-3
14,12,248,11,16,-5
14,12,249,15,13,2
14,12,250,18,16,2
14,12,251,5,16,-11
14,12,252,10,13,-3
14,12,253,19,16,3
14,12,254,7,8,-1
14,12,255,10,15,-5
14,12,256,21,18,3
14,12,257,3,9,-6
14,12,258,11,17,-6
14,12,259,9,15,-6
14,12,260,7,5,2
14,12,261,18,15,3
14,12,262,3,6,-3
14,12,263,24,10,14
14,12,264,27,13,14
14,12,265,20,26,-6
14,12,266,10,18,-8
14,12,267,14,12,2
14,12,268,13,17,-4
14,12,269,34,16,18
14,12,270,24,12,12
14,12,271,16,10,6
14,12,272,18,19,-1
14,12,273,9,6,3
14,12,274,15,10,5
14,12,275,11,10,1
14,12,276,33,13,20
14,12,277,10,16,-6
14,12,278,10,11,-1
14,12,279,10,25,-15
14,12,280,12,10,2
14,12,281,13,13,0
14,12,282,24,25,-1
14,12,283,12,36,-24
14,12,284,18,27,-9
14,12,285,13,25,-12
14,12,286,9,16,-7
14,12,287,12,21,-9
14,12,288,16,15,1
14,12,289,19,19,0
14,12,290,14,2,12
14,12,291,15,9,6
14,12,292,21,18,3
14,12,293,18,9,9
14,12,294,5,7,-2
14,12,295,22,15,7
14,12,296,21,12,9
14,12,297,14,21,-7
14,12,298,17,17,0
14,12,299,28,18,10
14,13,0,18,21,-3
14,13,1,16,16,0
14,13,2,16,18,-2
14,13,3,24,8,16
14,13,4,18,6,12
14,13,5,18,18,0
14,13,6,16,7,9
14,13,7,18,26,-8
14,13,8,5,15,-10
14,13,9,15,22,-7
14,13,10,17,14,3
14,13,11,13,25,-12
14,13,12,11,19,-8
14,13,13,14,27,-13
14,13,14,14,12,2
14,13,15,19,12,7
14,13,16,9,14,-5
14,13,17,6,16,-10
14,13,18,8,10,-2
14,13,19,15,11,4
14,13,20,8,26,-18
14,13,21,8,10,-2
14,13,22,29,28,1
14,13,23,18,15,3
14,13,24,14,26,-12
14,13,25,21,19,2
14,13,26,28,16,12
14,13,27,15,16,-1
14,13,28,25,17,8
14,13,29,10,13,-3
14,13,30,15,7,8
14,13,31,13,10,3
14,13,32,7,14,-7
14,13,33,10,26,-16
14,13,34,12,19,-7
14,13,35,28,20,8
14,13,36,18,11,7
14,13,37,15,20,-5
14,13,38,17,27,-10
14,13,39,25,11,14
14,13,40,18,11,7
14,13,41,17,27,-10
14,13,42,14,19,-5
14,13,43,8,25,-17
14,13,44,35,28,7
14,13,45,17,18,-1
14,13,46,17,18,-1
14,13,47,20,14,6
14,13,48,23,30,-7
14,13,49,26,13,13
14,13,50,13,22,-9
14,13,51,10,14,-4
14,13,52,13,20,-7
14,13,53,15,21,-6
14,13,54,18,10,8
14,13,55,15,21,-6
14,13,56,18,23,-5
14,13,57,13,10,3
14,13,58,6,23,-17
14,13,59,12,17,-5
14,13,60,12,13,-1
14,13,61,20,14,6
14,13,62,25,19,6
14,13,63,4,19,-15
14,13,64,6,26,-20
14,13,65,8,28,-20
14,13,66,7,6,1
14,13,67,12,15,-3
14,13,68,17,20,-3
14,13,69,18,17,1
14,13,70,9,12,-3
14,13,71,10,14,-4
14,13,72,24,18,6
14,13,73,15,16,-1
14,13,74,5,10,-5
14,13,75,9,20,-11
14,13,76,11,33,-22
14,13,77,21,13,8
14,13,78,24,9,15
14,13,79,16,15,1
14,13,80,6,14,-8
14,13,81,22,19,3
14,13,82,21,14,7
14,13,83,13,8,5
14,13,84,18,16,2
14,13,85,17,12,5
14,13,86,9,14,-5
14,13,87,28,20,8
14,13,88,14,11,3
14,13,89,15,26,-11
14,13,90,7,12,-5
14,13,91,12,18,-6
14,13,92,8,12,-4
14,13,93,18,12,6
14,13,94,11,14,-3
14,13,95,16,8,8
14,13,96,12,17,-5
14,13,97,19,20,-1
14,13,98,8,18,-10
14,13,99,9,8,1
14,13,100,5,8,-3
14,13,101,23,17,6
14,13,102,23,15,8
14,13,103,8,21,-13
14,13,104,17,15,2
14,13,105,13,10,3
14,13,106,21,15,6
14,13,107,13,13,0
14,13,108,10,12,-2
14,13,109,9,11,-2
14,13,110,9,13,-4
14,13,111,24,20,4
14,13,112,17,13,4
14,13,113,12,17,-5
14,13,114,13,17,-4
14,13,115,7,20,-13
14,13,116,28,15,13
14,13,117,8,19,-11
14,13,118,14,16,-2
14,13,119,5,19,-14
14,13,120,12,11,1
14,13,121,8,21,-13
14,13,122,19,31,-12
14,13,123,9,13,-4
14,13,124,31,24,7
14,13,125,13,16,-3
14,13,126,14,23,-9
14,13,127,22,17,5
14,13,128,11,12,-1
14,13,129,12,17,-5
14,13,130,5,9,-4
14,13,131,17,23,-6
14,13,132,16,17,-1
14,13,133,25,13,12
14,13,134,16,20,-4
14,13,135,36,17,19
14,13,136,19,23,-4
14,13,137,12,6,6
14,13,138,13,10,3
14,13,139,19,16,3
14,13,140,24,28,-4
14,13,141,11,25,-14
14,13,142,16,18,-2
14,13,143,15,13,2
14,13,144,14,17,-3
14,13,145,14,27,-13
14,13,146,10,19,-9
14,13,147,13,14,-1
14,13,148,26,18,8
14,13,149,16,19,-3
14,13,150,16,23,-7
14,13,151,18,12,6
14,13,152,13,8,5
14,13,153,24,22,2
14,13,154,9,11,-2
14,13,155,15,20,-5
14,13,156,8,10,-2
14,13,157,4,11,-7
14,13,158,21,30,-9
14,13,159,12,9,3
14,13,160,10,6,4
14,13,161,23,15,8
14,13,162,19,25,-6
14,13,163,29,23,6
14,13,164,24,21,3
14,13,165,22,18,4
14,13,166,20,13,7
14,13,167,14,5,9
14,13,168,16,25,-9
14,13,169,14,19,-5
14,13,170,4,8,-4
14,13,171,19,30,-11
14,13,172,16,13,3
14,13,173,4,8,-4
14,13,174,7,18,-11
14,13,175,11,21,-10
14,13,176,13,15,-2
14,13,177,9,19,-10
14,13,178,19,18,1
14,13,179,7,13,-6
14,13,180,10,14,-4
14,13,181,12,18,-6
14,13,182,13,20,-7
14,13,183,10,14,-4
14,13,184,22,24,-2
14,13,185,18,16,2
14,13,186,14,22,-8
14,13,187,9,20,-11
14,13,188,18,10,8
14,13,189,14,17,-3
14,13,190,14,10,4
14,13,191,25,24,1
14,13,192,9,10,-1
14,13,193,15,23,-8
14,13,194,8,21,-13
14,13,195,18,32,-14
14,13,196,9,13,-4
14,13,197,17,14,3
14,13,198,38,28,10
14,13,199,18,20,-2
14,13,200,8,9,-1
14,13,201,13,18,-5
14,13,202,18,24,-6
14,13,203,16,19,-3
14,13,204,9,35,-26
14,13,205,11,11,0
14,13,206,21,24,-3
14,13,207,27,23,4
14,13,208,15,11,4
14,13,209,20,17,3
14,13,210,17,26,-9
14,13,211,14,21,-7
14,13,212,11,16,-5
14,13,213,15,21,-6
14,13,214,16,21,-5
14,13,215,27,17,10
14,13,216,11,19,-8
14,13,217,19,19,0
14,13,218,9,28,-19
14,13,219,12,16,-4
14,13,220,24,19,5
14,13,221,10,11,-1
14,13,222,7,14,-7
14,13,223,24,20,4
14,13,224,21,33,-12
14,13,225,11,21,-10
14,13,226,15,20,-5
14,13,227,18,29,-11
14,13,228,8,12,-4
14,13,229,18,14,4
14,13,230,13,21,-8
14,13,231,9,16,-7
14,13,232,9,11,-2
14,13,233,11,7,4
14,13,234,16,14,2
14,13,235,9,10,-1
14,13,236,13,20,-7
14,13,237,23,12,11
14,13,238,18,25,-7
14,13,239,12,20,-8
14,13,240,19,20,-1
14,13,241,17,22,-5
14,13,242,18,11,7
14,13,243,21,27,-6
14,13,244,19,16,3
14,13,245,10,11,-1
14,13,246,18,24,-6
14,13,247,6,17,-11
14,13,248,18,33,-15
14,13,249,28,23,5
14,13,250,30,16,14
14,13,251,12,17,-5
14,13,252,9,13,-4
14,13,253,19,14,5
14,13,254,19,20,-1
14,13,255,10,20,-10
14,13,256,14,8,6
14,13,257,6,20,-14
14,13,258,23,22,1
14,13,259,16,20,-4
14,13,260,25,17,8
14,13,261,17,12,5
14,13,262,21,17,4
14,13,263,18,23,-5
14,13,264,13,17,-4
14,13,265,15,10,5
14,13,266,9,12,-3
14,13,267,16,13,3
14,13,268,31,22,9
14,13,269,14,21,-7
14,13,270,21,23,-2
14,13,271,14,15,-1
14,13,272,16,15,1
14,13,273,9,25,-16
14,13,274,26,27,-1
14,13,275,19,17,2
14,13,276,17,18,-1
14,13,277,18,14,4
14,13,278,29,16,13
14,13,279,22,5,17
14,13,280,18,19,-1
14,13,281,23,8,15
14,13,282,21,10,11
14,13,283,20,13,7
14,13,284,16,14,2
14,13,285,14,20,-6
14,13,286,24,22,2
14,13,287,15,13,2
14,13,288,21,11,10
14,13,289,17,8,9
14,13,290,19,34,-15
14,13,291,19,13,6
14,13,292,13,11,2
14,13,293,5,16,-11
14,13,294,20,14,6
14,13,295,13,15,-2
14,13,296,20,23,-3
14,13,297,34,24,10
14,13,298,12,8,4
14,13,299,19,15,4
14,14,0,7,22,-15
14,14,1,8,10,-2
14,14,2,14,8,6
14,14,3,18,13,5
14,14,4,23,20,3
14,14,5,17,19,-2
14,14,6,13,10,3
14,14,7,9,9,0
14,14,8,13,22,-9
14,14,9,17,18,-1
14,14,10,17,27,-10
14,14,11,15,17,-2
14,14,12,18,12,6
14,14,13,8,15,-7
14,14,14,34,8,26
14,14,15,25,21,4
14,14,16,12,19,-7
14,14,17,18,15,3
14,14,18,14,16,-2
14,14,19,12,18,-6
14,14,20,9,15,-6
14,14,21,21,16,5
14,14,22,18,12,6
14,14,23,10,22,-12
14,14,24,25,18,7
14,14,25,12,24,-12
14,14,26,15,10,5
14,14,27,14,9,5
14,14,28,11,20,-9
14,14,29,20,17,3
14,14,30,16,13,3
14,14,31,10,9,1
14,14,32,8,18,-10
14,14,33,17,16,1
14,14,34,22,16,6
14,14,35,7,20,-13
14,14,36,23,19,4
14,14,37,22,12,10
14,14,38,18,13,5
14,14,39,19,17,2
14,14,40,26,26,0
14,14,41,12,20,-8
14,14,42,19,30,-11
14,14,43,11,12,-1
14,14,44,23,19,4
14,14,45,9,20,-11
14,14,46,20,21,-1
14,14,47,13,21,-8
14,14,48,21,24,-3
14,14,49,31,20,11
14,14,50,3,8,-5
14,14,51,14,19,-5
14,14,52,7,16,-9
14,14,53,15,18,-3
14,14,54,11,8,3
14,14,55,17,23,-6
14,14,56,9,10,-1
14,14,57,14,13,1
14,14,58,9,12,-3
14,14,59,7,17,-10
14,14,60,2,12,-10
14,14,61,12,32,-20
14,14,62,7,18,-11
14,14,63,5,7,-2
14,14,64,19,20,-1
14,14,65,7,4,3
14,14,66,17,34,-17
14,14,67,9,11,-2
14,14,68,21,15,6
14,14,69,13,20,-7
14,14,70,11,13,-2
14,14,71,19,22,-3
14,14,72,18,18,0
14,14,73,19,18,1
14,14,74,21,23,-2
14,14,75,18,28,-10
14,14,76,18,18,0
14,14,77,17,19,-2
14,14,78,23,26,-3
14,14,79,14,14,0
14,14,80,6,16,-10
14,14,81,8,16,-8
14,14,82,9,10,-1
14,14,83,35,22,13
14,14,84,5,14,-9
14,14,85,20,6,14
14,14,86,18,10,8
14,14,87,21,19,2
14,14,88,23,30,-7
14,14,89,17,36,-19
14,14,90,12,9,3
14,14,91,17,25,-8
14,14,92,9,16,-7
14,14,93,15,16,-1
14,14,94,17,18,-1
14,14,95,12,20,-8
14,14,96,10,9,1
14,14,97,10,17,-7
14,14,98,21,18,3
14,14,99,11,23,-12
14,14,100,30,18,12
14,14,101,8,11,-3
14,14,102,17,8,9
14,14,103,13,15,-2
14,14,104,4,11,-7
14,14,105,31,26,5
14,14,106,16,7,9
14,14,107,21,14,7
14,14,108,15,18,-3
14,14,109,14,11,3
14,14,110,28,21,7
14,14,111,17,30,-13
14,14,112,18,22,-4
14,14,113,7,11,-4
14,14,114,19,16,3
14,14,115,20,15,5
14,14,116,14,14,0
14,14,117,14,18,-4
14,14,118,18,21,-3
14,14,119,21,14,7
14,14,120,9,14,-5
14,14,121,10,16,-6
14,14,122,16,20,-4
14,14,123,15,11,4
14,14,124,32,25,7
14,14,125,19,15,4
14,14,126,10,18,-8
14,14,127,5,16,-11
14,14,128,5,11,-6
14,14,129,13,13,0
14,14,130,13,9,4
14,14,131,5,12,-7
14,14,132,17,9,8
14,14,133,6,3,3
14,14,134,5,9,-4
14,14,135,10,11,-1
14,14,136,26,5,21
14,14,137,17,9,8
14,14,138,9,9,0
14,14,139,20,22,-2
14,14,140,19,6,13
14,14,141,12,12,0
14,14,142,25,20,5
14,14,143,25,25,0
14,14,144,11,10,1
14,14,145,19,15,4
14,14,146,28,12,16
14,14,147,13,19,-6
14,14,148,14,15,-1
14,14,149,11,30,-19
14,14,150,14,8,6
14,14,151,9,19,-10
14,14,152,10,15,-5
14,14,153,19,36,-17
14,14,154,5,12,-7
14,14,155,14,4,10
14,14,156,9,15,-6
14,14,157,24,17,7
14,14,158,25,18,7
14,14,159,8,24,-16
14,14,160,8,10,-2
14,14,161,9,10,-1
14,14,162,18,11,7
14,14,163,17,21,-4
14,14,164,17,20,-3
14,14,165,22,19,3
14,14,166,11,27,-16
14,14,167,15,17,-2
14,14,168,13,14,-1
14,14,169,11,11,0
14,14,170,13,24,-11
14,14,171,19,17,2
14,14,172,12,24,-12
14,14,173,7,4,3
14,14,174,19,13,6
14,14,175,10,9,1
14,14,176,19,27,-8
14,14,177,20,18,2
14,14,178,18,18,0
14,14,179,10,12,-2
14,14,180,8,17,-9
14,14,181,12,30,-18
14,14,182,18,21,-3
14,14,183,7,9,-2
14,14,184,10,15,-5
14,14,185,13,23,-10
14,14,186,26,12,14
14,14,187,14,19,-5
14,14,188,11,17,-6
14,14,189,16,14,2
14,14,190,25,19,6
14,14,191,9,16,-7
14,14,192,10,17,-7
14,14,193,10,13,-3
14,14,194,7,6,1
14,14,195,5,10,-5
14,14,196,21,9,12
14,14,197,9,5,4
14,14,198,17,7,10
14,14,199,16,10,6
14,14,200,16,20,-4
14,14,201,16,21,-5
14,14,202,28,5,23
14,14,203,12,14,-2
14,14,204,15,22,-7
14,14,205,13,16,-3
14,14,206,13,17,-4
14,14,207,4,23,-19
14,14,208,12,20,-8
14,14,209,14,12,2
14,14,210,21,20,1
14,14,211,9,18,-9
14,14,212,7,12,-5
14,14,213,10,17,-7
14,14,214,17,19,-2
14,14,215,5,14,-9
14,14,216,22,17,5
14,14,217,18,17,1
14,14,218,17,18,-1
14,14,219,15,16,-1
14,14,220,16,26,-10
14,14,221,12,17,-5
14,14,222,11,16,-5
14,14,223,8,16,-8
14,14,224,18,21,-3
14,14,225,4,18,-14
14,14,226,21,30,-9
14,14,227,21,14,7
14,14,228,11,18,-7
14,14,229,11,14,-3
14,14,230,18,28,-10
14,14,231,12,23,-11
14,14,232,25,31,-6
14,14,233,22,32,-10
14,14,234,15,39,-24
14,14,235,14,19,-5
14,14,236,12,21,-9
14,14,237,18,16,2
14,14,238,14,10,4
14,14,239,16,12,4
14,14,240,22,23,-1
14,14,241,15,15,0
14,14,242,14,11,3
14,14,243,12,20,-8
14,14,244,26,24,2
14,14,245,17,11,6
14,14,246,17,15,2
14,14,247,5,16,-11
14,14,248,11,5,6
14,14,249,23,15,8
14,14,250,7,16,-9
14,14,251,6,13,-7
14,14,252,19,17,2
14,14,253,19,12,7
14,14,254,8,13,-5
14,14,255,17,25,-8
14,14,256,9,12,-3
14,14,257,8,22,-14
14,14,258,16,18,-2
14,14,259,36,25,11
14,14,260,9,9,0
14,14,261,13,11,2
14,14,262,10,9,1
14,14,263,21,10,11
14,14,264,17,21,-4
14,14,265,12,12,0
14,14,266,12,18,-6
14,14,267,16,14,2
14,14,268,18,11,7
14,14,269,10,20,-10
14,14,270,12,30,-18
14,14,271,13,12,1
14,14,272,13,21,-8
14,14,273,26,22,4
14,14,274,28,13,15
14,14,275,25,12,13
14,14,276,15,15,0
14,14,277,8,21,-13
14,14,278,5,28,-23
14,14,279,15,14,1
14,14,280,18,16,2
14,14,281,12,9,3
14,14,282,21,14,7
14,14,283,7,4,3
14,14,284,21,24,-3
14,14,285,10,13,-3
14,14,286,15,29,-14
14,14,287,6,10,-4
14,14,288,22,22,0
14,14,289,12,17,-5
14,14,290,15,21,-6
14,14,291,19,17,2
14,14,292,15,9,6
14,14,293,17,16,1
14,14,294,27,25,2
14,14,295,16,15,1
14,14,296,13,26,-13
14,14,297,12,15,-3
14,14,298,12,20,-8
14,14,299,13,7,6
14,15,0,10,16,-6
14,15,1,12,10,2
14,15,2,17,29,-12
14,15,3,13,20,-7
14,15,4,12,7,5
14,15,5,17,14,3
14,15,6,15,17,-2
14,15,7,6,8,-2
14,15,8,23,16,7
14,15,9,6,13,-7
14,15,10,19,19,0
14,15,11,15,17,-2
14,15,12,20,25,-5
14,15,13,12,22,-10
14,15,14,20,27,-7
14,15,15,6,20,-14
14,15,16,9,22,-13
14,15,17,7,19,-12
14,15,18,7,11,-4
14,15,19,14,18,-4
14,15,20,26,10,16
14,15,21,11,8,3
14,15,22,19,16,3
14,15,23,10,10,0
14,15,24,15,12,3
14,15,25,20,23,-3
14,15,26,17,8,9
14,15,27,6,10,-4
14,15,28,9,13,-4
14,15,29,8,5,3
14,15,30,8,28,-20
14,15,31,15,11,4
14,15,32,14,18,-4
14,15,33,11,8,3
14,15,34,17,25,-8
14,15,35,10,21,-11
14,15,36,21,32,-11
14,15,37,26,18,8
14,15,38,19,13,6
14,15,39,28,24,4
14,15,40,13,9,4
14,15,41,13,16,-3
14,15,42,6,15,-9
14,15,43,15,18,-3
14,15,44,22,29,-7
14,15,45,6,11,-5
14,15,46,9,12,-3
14,15,47,8,19,-11
14,15,48,13,16,-3
14,15,49,24,21,3
14,15,50,6,7,-1
14,15,51,20,11,9
14,15,52,16,11,5
14,15,53,18,30,-12
14,15,54,19,12,7
14,15,55,26,18,8
14,15,56,17,12,5
14,15,57,12,12,0
14,15,58,21,19,2
14,15,59,13,12,1
14,15,60,20,21,-1
14,15,61,26,18,8
14,15,62,18,8,10
14,15,63,11,11,0
14,15,64,15,16,-1
14,15,65,33,23,10
14,15,66,9,23,-14
14,15,67,16,8,8
14,15,68,8,6,2
14,15,69,19,11,8
14,15,70,23,8,15
14,15,71,15,12,3
14,15,72,23,13,10
14,15,73,15,19,-4
14,15,74,13,18,-5
14,15,75,20,3,17
14,15,76,16,8,8
14,15,77,17,34,-17
14,15,78,10,14,-4
14,15,79,16,14,2
14,15,80,10,15,-5
14,15,81,16,14,2
14,15,82,20,21,-1
14,15,83,13,20,-7
14,15,84,22,9,13
14,15,85,16,6,10
14,15,86,11,16,-5
14,15,87,32,23,9
14,15,88,18,17,1
14,15,89,12,5,7
14,15,90,10,13,-3
14,15,91,19,22,-3
14,15,92,15,4,11
14,15,93,14,10,4
14,15,94,21,9,12
14,15,95,24,26,-2
14,15,96,20,11,9
14,15,97,8,9,-1
14,15,98,11,10,1
14,15,99,9,18,-9
14,15,100,8,17,-9
14,15,101,15,17,-2
14,15,102,12,19,-7
14,15,103,24,13,11
14,15,104,16,30,-14
14,15,105,23,26,-3
14,15,106,12,8,4
14,15,107,13,15,-2
14,15,108,28,25,3
14,15,109,11,6,5
14,15,110,18,26,-8
14,15,111,12,10,2
14,15,112,15,18,-3
14,15,113,24,21,3
14,15,114,21,7,14
14,15,115,17,17,0
14,15,116,20,24,-4
14,15,117,15,22,-7
14,15,118,11,10,1
14,15,119,18,5,13
14,15,120,19,37,-18
14,15,121,26,14,12
14,15,122,14,16,-2
14,15,123,17,21,-4
14,15,124,19,23,-4
14,15,125,30,19,11
14,15,126,14,15,-1
14,15,127,23,22,1
14,15,128,18,17,1
14,15,129,20,19,1
14,15,130,16,19,-3
14,15,131,26,16,10
14,15,132,8,20,-12
14,15,133,10,29,-19
14,15,134,17,10,7
14,15,135,11,20,-9
14,15,136,14,34,-20
14,15,137,11,9,2
14,15,138,16,20,-4
14,15,139,22,12,10
14,15,140,15,15,0
14,15,141,11,15,-4
14,15,142,26,30,-4
14,15,143,8,23,-15
14,15,144,21,16,5
14,15,145,4,16,-12
14,15,146,13,13,0
14,15,147,15,20,-5
14,15,148,14,10,4
14,15,149,21,15,6
14,15,150,10,11,-1
14,15,151,16,17,-1
14,15,152,19,16,3
14,15,153,11,12,-1
14,15,154,6,12,-6
14,15,155,14,9,5
14,15,156,8,20,-12
14,15,157,18,15,3
14,15,158,11,13,-2
14,15,159,20,9,11
14,15,160,12,7,5
14,15,161,13,16,-3
14,15,162,13,17,-4
14,15,163,22,9,13
14,15,164,11,16,-5
14,15,165,7,14,-7
14,15,166,14,12,2
14,15,167,11,15,-4
14,15,168,31,16,15
14,15,169,8,23,-15
14,15,170,6,15,-9
14,15,171,30,21,9
14,15,172,18,13,5
14,15,173,15,15,0
14,15,174,23,29,-6
14,15,175,18,14,4
14,15,176,10,28,-18
14,15,177,15,12,3
14,15,178,7,19,-12
14,15,179,28,17,11
14,15,180,14,13,1
14,15,181,17,28,-11
14,15,182,14,19,-5
14,15,183,6,16,-10
14,15,184,8,9,-1
14,15,185,23,26,-3
14,15,186,24,28,-4
14,15,187,2,12,-10
14,15,188,13,14,-1
14,15,189,10,24,-14
14,15,190,12,8,4
14,15,191,12,18,-6
14,15,192,13,15,-2
14,15,193,12,14,-2
14,15,194,24,13,11
14,15,195,14,13,1
14,15,196,12,17,-5
14,15,197,12,18,-6
14,15,198,14,11,3
14,15,199,25,19,6
14,15,200,22,12,10
14,15,201,21,9,12
14,15,202,26,18,8
14,15,203,16,16,0
14,15,204,15,6,9
14,15,205,13,19,-6
14,15,206,15,12,3
14,15,207,6,7,-1
14,15,208,13,17,-4
14,15,209,23,25,-2
14,15,210,14,15,-1
14,15,211,11,7,4
14,15,212,16,16,0
14,15,213,13,16,-3
14,15,214,22,22,0
14,15,215,27,18,9
14,15,216,14,25,-11
14,15,217,19,9,10
14,15,218,19,15,4
14,15,219,10,22,-12
14,15,220,12,26,-14
14,15,221,9,19,-10
14,15,222,2,14,-12
14,15,223,13,9,4
14,15,224,25,17,8
14,15,225,22,22,0
14,15,226,13,16,-3
14,15,227,19,20,-1
14,15,228,13,17,-4
14,15,229,4,15,-11
14,15,230,10,14,-4
14,15,231,11,18,-7
14,15,232,12,11,1
14,15,233,14,8,6
14,15,234,12,12,0
14,15,235,13,22,-9
14,15,236,11,12,-1
14,15,237,17,39,-22
14,15,238,23,26,-3
14,15,239,17,18,-1
14,15,240,20,19,1
14,15,241,13,17,-4
14,15,242,18,12,6
14,15,243,10,6,4
14,15,244,24,16,8
14,15,245,16,12,4
14,15,246,21,12,9
14,15,247,7,23,-16
14,15,248,15,15,0
14,15,249,21,12,9
14,15,250,13,13,0
14,15,251,7,7,0
14,15,252,10,28,-18
14,15,253,11,14,-3
14,15,254,21,14,7
14,15,255,14,22,-8
14,15,256,10,10,0
14,15,257,10,21,-11
14,15,258,15,14,1
14,15,259,8,9,-1
14,15,260,8,5,3
14,15,261,18,15,3
14,15,262,12,17,-5
14,15,263,12,19,-7
14,15,264,15,16,-1
14,15,265,10,10,0
14,15,266,11,15,-4
14,15,267,20,10,10
14,15,268,8,9,-1
14,15,269,20,7,13
14,15,270,15,19,-4
14,15,271,10,26,-16
14,15,272,25,21,4
14,15,273,12,22,-10
14,15,274,19,14,5
14,15,275,7,13,-6
14,15,276,18,9,9
14,15,277,21,7,14
14,15,278,18,29,-11
14,15,279,23,11,12
14,15,280,10,15,-5
14,15,281,20,11,9
14,15,282,18,16,2
14,15,283,27,8,19
14,15,284,13,26,-13
14,15,285,3,9,-6
14,15,286,27,26,1
14,15,287,18,22,-4
14,15,288,12,11,1
14,15,289,18,17,1
14,15,290,11,9,2
14,15,291,11,21,-10
14,15,292,13,16,-3
14,15,293,21,11,10
14,15,294,32,15,17
14,15,295,21,24,-3
14,15,296,23,19,4
14,15,297,8,16,-8
14,15,298,23,12,11
14,15,299,11,19,-8
14,16,0,22,16,6
14,16,1,13,20,-7
14,16,2,14,11,3
14,16,3,23,16,7
14,16,4,12,16,-4
14,16,5,8,19,-11
14,16,6,15,16,-1
14,16,7,26,17,9
14,16,8,28,20,8
14,16,9,25,15,10
14,16,10,15,9,6
14,16,11,19,20,-1
14,16,12,14,13,1
14,16,13,24,9,15
14,16,14,13,22,-9
14,16,15,13,26,-13
14,16,16,10,14,-4
14,16,17,15,18,-3
14,16,18,10,21,-11
14,16,19,12,15,-3
14,16,20,12,17,-5
14,16,21,22,25,-3
14,16,22,19,21,-2
14,16,23,6,14,-8
14,16,24,18,17,1
14,16,25,16,20,-4
14,16,26,8,20,-12
14,16,27,20,18,2
14,16,28,15,19,-4
14,16,29,9,28,-19
14,16,30,15,17,-2
14,16,31,20,25,-5
14,16,32,5,14,-9
14,16,33,13,18,-5
14,16,34,13,13,0
14,16,35,14,13,1
14,16,36,17,14,3
14,16,37,16,19,-3
14,16,38,13,12,1
14,16,39,21,18,3
14,16,40,20,22,-2
14,16,41,7,10,-3
14,16,42,13,14,-1
14,16,43,20,20,0
14,16,44,22,15,7
14,16,45,8,16,-8
14,16,46,9,11,-2
14,16,47,14,14,0
14,16,48,10,15,-5
14,16,49,18,29,-11
14,16,50,12,18,-6
14,16,51,20,13,7
14,16,52,9,7,2
14,16,53,13,19,-6
14,16,54,10,11,-1
14,16,55,20,17,3
14,16,56,8,19,-11
14,16,57,20,14,6
14,16,58,20,18,2
14,16,59,29,22,7
14,16,60,20,10,10
14,16,61,6,15,-9
14,16,62,21,14,7
14,16,63,11,17,-6
14,16,64,25,22,3
14,16,65,12,8,4
14,16,66,27,13,14
14,16,67,19,11,8
14,16,68,19,13,6
14,16,69,14,11,3
14,16,70,28,20,8
14,16,71,15,13,2
14,16,72,30,31,-1
14,16,73,30,30,0
14,16,74,28,32,-4
14,16,75,14,22,-8
14,16,76,12,15,-3
14,16,77,24,9,15
14,16,78,14,11,3
14,16,79,8,9,-1
14,16,80,16,11,5
14,16,81,14,27,-13
14,16,82,16,12,4
14,16,83,14,23,-9
14,16,84,11,17,-6
14,16,85,21,19,2
14,16,86,10,12,-2
14,16,87,9,15,-6
14,16,88,15,14,1
14,16,89,18,16,2
14,16,90,7,12,-5
14,16,91,21,19,2
14,16,92,19,14,5
14,16,93,26,12,14
14,16,94,16,39,-23
14,16,95,19,10,9
14,16,96,25,18,7
14,16,97,22,19,3
14,16,98,10,17,-7
14,16,99,12,12,0
14,16,100,16,23,-7
14,16,101,14,21,-7
14,16,102,17,19,-2
14,16,103,14,29,-15
14,16,104,16,21,-5
14,16,105,15,16,-1
14,16,106,23,24,-1
14,16,107,11,6,5
14,16,108,18,19,-1
14,16,109,17,16,1
14,16,110,11,13,-2
14,16,111,19,15,4
14,16,112,12,14,-2
14,16,113,14,9,5
14,16,114,14,22,-8
14,16,115,6,11,-5
14,16,116,13,5,8
14,16,117,17,17,0
14,16,118,1,15,-14
14,16,119,13,14,-1
14,16,120,13,11,2
14,16,121,14,11,3
14,16,122,19,20,-1
14,16,123,23,7,16
14,16,124,24,24,0
14,16,125,24,22,2
14,16,126,13,10,3
14,16,127,15,14,1
14,16,128,13,23,-10
14,16,129,22,24,-2
14,16,130,14,8,6
14,16,131,18,25,-7
14,16,132,14,20,-6
14,16,133,14,17,-3
14,16,134,22,26,-4
14,16,135,14,12,2
14,16,136,17,19,-2
14,16,137,10,9,1
14,16,138,22,9,13
14,16,139,7,16,-9
14,16,140,6,11,-5
14,16,141,20,15,5
14,16,142,11,14,-3
14,16,143,15,8,7
14,16,144,17,16,1
14,16,145,11,9,2
14,16,146,12,21,-9
14,16,147,5,10,-5
14,16,148,21,15,6
14,16,149,8,17,-9
14,16,150,27,9,18
14,16,151,18,20,-2
14,16,152,23,18,5
14,16,153,16,17,-1
14,16,154,16,18,-2
14,16,155,14,11,3
14,16,156,12,14,-2
14,16,157,14,21,-7
14,16,158,25,20,5
14,16,159,30,17,13
14,16,160,20,20,0
14,16,161,15,11,4
14,16,162,20,10,10
14,16,163,5,16,-11
14,16,164,15,8,7
14,16,165,21,26,-5
14,16,166,6,12,-6
14,16,167,11,6,5
14,16,168,12,7,5
14,16,169,9,15,-6
14,16,170,10,15,-5
14,16,171,6,10,-4
14,16,172,20,19,1
14,16,173,11,6,5
14,16,174,22,11,11
14,16,175,10,15,-5
14,16,176,24,17,7
14,16,177,34,24,10
14,16,178,9,6,3
14,16,179,15,10,5
14,16,180,12,10,2
14,16,181,21,15,6
14,16,182,9,18,-9
14,16,183,18,7,11
14,16,184,25,21,4
14,16,185,9,13,-4
14,16,186,9,27,-18
14,16,187,19,13,6
14,16,188,10,20,-10
14,16,189,14,14,0
14,16,190,11,30,-19
14,16,191,13,12,1
14,16,192,16,22,-6
14,16,193,17,18,-1
14,16,194,5,13,-8
14,16,195,20,18,2
14,16,196,18,9,9
14,16,197,13,20,-7
14,16,198,12,18,-6
14,16,199,22,21,1
14,16,200,18,11,7
14,16,201,14,13,1
14,16,202,5,7,-2
14,16,203,15,11,4
14,16,204,21,18,3
14,16,205,14,16,-2
14,16,206,21,9,12
14,16,207,18,12,6
14,16,208,14,11,3
14,16,209,11,10,1
14,16,210,8,9,-1
14,16,211,15,22,-7
14,16,212,12,23,-11
14,16,213,18,17,1
14,16,214,20,23,-3
14,16,215,10,18,-8
14,16,216,9,15,-6
14,16,217,9,14,-5
14,16,218,14,20,-6
14,16,219,14,12,2
14,16,220,5,8,-3
14,16,221,13,13,0
14,16,222,24,19,5
14,16,223,11,14,-3
14,16,224,11,15,-4
14,16,225,21,20,1
14,16,226,10,7,3
14,16,227,9,15,-6
14,16,228,11,10,1
14,16,229,15,7,8
14,16,230,5,12,-7
14,16,231,12,9,3
14,16,232,17,13,4
14,16,233,13,32,-19
14,16,234,25,18,7
14,16,235,14,11,3
14,16,236,22,19,3
14,16,237,17,17,0
14,16,238,13,15,-2
14,16,239,10,20,-10
14,16,240,16,17,-1
14,16,241,29,21,8
14,16,242,12,17,-5
14,16,243,21,9,12
14,16,244,19,17,2
14,16,245,11,11,0
14,16,246,17,16,1
14,16,247,19,27,-8
14,16,248,7,8,-1
14,16,249,5,11,-6
14,16,250,10,10,0
14,16,251,19,19,0
14,16,252,15,11,4
14,16,253,7,16,-9
14,16,254,17,19,-2
14,16,255,18,16,2
14,16,256,23,21,2
14,16,257,15,14,1
14,16,258,28,17,11
14,16,259,12,17,-5
14,16,260,14,7,7
14,16,261,18,18,0
14,16,262,10,19,-9
14,16,263,4,2,2
14,16,264,9,16,-7
14,16,265,21,19,2
14,16,266,14,15,-1
14,16,267,19,25,-6
14,16,268,6,17,-11
14,16,269,9,12,-3
14,16,270,20,16,4
14,16,271,9,18,-9
14,16,272,19,21,-2
14,16,273,11,9,2
14,16,274,21,17,4
14,16,275,22,19,3
14,16,276,25,18,7
14,16,277,23,15,8
14,16,278,14,20,-6
14,16,279,14,19,-5
14,16,280,5,30,-25
14,16,281,18,29,-11
14,16,282,21,15,6
14,16,283,12,11,1
14,16,284,11,5,6
14,16,285,20,7,13
14,16,286,11,14,-3
14,16,287,13,16,-3
14,16,288,5,21,-16
14,16,289,5,19,-14
14,16,290,23,25,-2
14,16,291,18,21,-3
14,16,292,26,13,13
14,16,293,11,12,-1
14,16,294,10,14,-4
14,16,295,10,7,3
14,16,296,26,15,11
14,16,297,6,19,-13
14,16,298,5,17,-12
14,16,299,7,7,0
14,17,0,15,20,-5
14,17,1,12,11,1
14,17,2,30,26,4
14,17,3,16,12,4
14,17,4,21,16,5
14,17,5,31,28,3
14,17,6,10,19,-9
14,17,7,17,13,4
14,17,8,12,11,1
14,17,9,13,13,0
14,17,10,16,12,4
14,17,11,13,13,0
14,17,12,19,25,-6
14,17,13,35,24,11
14,17,14,20,11,9
14,17,15,29,11,18
14,17,16,17,24,-7
14,17,17,19,15,4
14,17,18,18,17,1
14,17,19,28,26,2
14,17,20,12,18,-6
14,17,21,13,15,-2
14,17,22,20,12,8
14,17,23,12,12,0
14,17,24,5,15,-10
14,17,25,22,16,6
14,17,26,23,18,5
14,17,27,11,9,2
14,17,28,10,29,-19
14,17,29,16,11,5
14,17,30,12,5,7
14,17,31,20,12,8
14,17,32,23,17,6
14,17,33,8,5,3
14,17,34,19,10,9
14,17,35,14,2,12
14,17,36,9,11,-2
14,17,37,24,16,8
14,17,38,21,12,9
14,17,39,10,2,8
14,17,40,15,13,2
14,17,41,27,14,13
14,17,42,15,29,-14
14,17,43,7,29,-22
14,17,44,26,12,14
14,17,45,17,20,-3
14,17,46,13,24,-11
14,17,47,12,6,6
14,17,48,14,9,5
14,17,49,18,14,4
14,17,50,21,16,5
14,17,51,7,12,-5
14,17,52,13,18,-5
14,17,53,19,12,7
14,17,54,23,21,2
14,17,55,11,8,3
14,17,56,5,10,-5
14,17,57,20,31,-11
14,17,58,10,11,-1
14,17,59,22,13,9
14,17,60,13,12,1
14,17,61,23,24,-1
14,17,62,10,10,0
14,17,63,26,13,13
14,17,64,12,33,-21
14,17,65,16,9,7
14,17,66,9,8,1
14,17,67,15,7,8
14,17,68,15,11,4
14,17,69,13,30,-17
14,17,70,15,11,4
14,17,71,14,8,6
14,17,72,15,15,0
14,17,73,13,10,3
14,17,74,21,12,9
14,17,75,15,26,-11
14,17,76,16,14,2
14,17,77,8,12,-4
14,17,78,9,13,-4
14,17,79,23,13,10
14,17,80,22,4,18
14,17,81,30,36,-6
14,17,82,20,27,-7
14,17,83,6,10,-4
14,17,84,11,29,-18
14,17,85,22,19,3
14,17,86,11,18,-7
14,17,87,29,12,17
14,17,88,17,16,1
14,17,89,13,4,9
14,17,90,13,14,-1
14,17,91,10,12,-2
14,17,92,17,7,10
14,17,93,15,10,5
14,17,94,20,7,13
14,17,95,18,12,6
14,17,96,21,10,11
14,17,97,7,8,-1
14,17,98,19,22,-3
14,17,99,28,14,14
14,17,100,21,21,0
14,17,101,12,21,-9
14,17,102,4,16,-12
14,17,103,29,23,6
14,17,104,4,13,-9
14,17,105,18,20,-2
14,17,106,20,17,3
14,17,107,22,14,8
14,17,108,11,17,-6
14,17,109,15,18,-3
14,17,110,11,14,-3
14,17,111,5,12,-7
14,17,112,22,24,-2
14,17,113,11,18,-7
14,17,114,18,12,6
14,17,115,17,15,2
14,17,116,29,18,11
14,17,117,13,11,2
14,17,118,7,9,-2
14,17,119,18,16,2
14,17,120,6,8,-2
14,17,121,10,9,1
14,17,122,32,12,20
14,17,123,22,10,12
14,17,124,10,17,-7
14,17,125,10,13,-3
14,17,126,13,12,1
14,17,127,15,14,1
14,17,128,24,22,2
14,17,129,10,18,-8
14,17,130,15,28,-13
14,17,131,20,12,8
14,17,132,11,14,-3
14,17,133,14,7,7
14,17,134,27,20,7
14,17,135,7,15,-8
14,17,136,9,7,2
14,17,137,17,17,0
14,17,138,22,15,7
14,17,139,23,18,5
14,17,140,30,16,14
14,17,141,13,27,-14
14,17,142,20,20,0
14,17,143,11,22,-11
14,17,144,14,13,1
14,17,145,14,10,4
14,17,146,2,7,-5
14,17,147,16,23,-7
14,17,148,13,15,-2
14,17,149,9,4,5
14,17,150,21,16,5
14,17,151,17,12,5
14,17,152,9,9,0
14,17,153,12,20,-8
14,17,154,14,12,2
14,17,155,13,18,-5
14,17,156,19,13,6
14,17,157,26,13,13
14,17,158,21,24,-3
14,17,159,15,16,-1
14,17,160,10,33,-23
14,17,161,13,18,-5
14,17,162,15,7,8
14,17,163,24,21,3
14,17,164,15,11,4
14,17,165,15,14,1
14,17,166,15,9,6
14,17,167,17,12,5
14,17,168,7,3,4
14,17,169,15,6,9
14,17,170,17,13,4
14,17,171,19,15,4
14,17,172,15,12,3
14,17,173,8,10,-2
14,17,174,11,12,-1
14,17,175,21,21,0
14,17,176,12,12,0
14,17,177,19,14,5
14,17,178,15,30,-15
14,17,179,11,12,-1
14,17,180,12,15,-3
14,17,181,16,9,7
14,17,182,16,16,0
14,17,183,7,18,-11
14,17,184,11,14,-3
14,17,185,15,6,9
14,17,186,17,17,0
14,17,187,18,9,9
14,17,188,11,7,4
14,17,189,21,14,7
14,17,190,29,23,6
14,17,191,13,11,2
14,17,192,14,15,-1
14,17,193,15,16,-1
14,17,194,20,8,12
14,17,195,7,14,-7
14,17,196,18,7,11
14,17,197,11,28,-17
14,17,198,18,12,6
14,17,199,19,10,9
14,17,200,11,12,-1
14,17,201,16,31,-15
14,17,202,15,13,2
14,17,203,15,14,1
14,17,204,7,19,-12
14,17,205,15,13,2
14,17,206,13,17,-4
14,17,207,20,22,-2
14,17,208,12,14,-2
14,17,209,30,10,20
14,17,210,21,19,2
14,17,211,7,10,-3
14,17,212,23,21,2
14,17,213,26,14,12
14,17,214,26,20,6
14,17,215,20,17,3
14,17,216,15,19,-4
14,17,217,17,19,-2
14,17,218,22,17,5
14,17,219,15,22,-7
14,17,220,18,13,5
14,17,221,17,10,7
14,17,222,4,14,-10
14,17,223,15,19,-4
14,17,224,20,27,-7
14,17,225,11,11,0
14,17,226,23,13,10
14,17,227,10,18,-8
14,17,228,18,16,2
14,17,229,17,15,2
14,17,230,21,21,0
14,17,231,17,20,-3
14,17,232,21,23,-2
14,17,233,18,16,2
14,17,234,19,7,12
14,17,235,9,9,0
14,17,236,21,15,6
14,17,237,8,19,-11
14,17,238,10,14,-4
14,17,239,33,19,14
14,17,240,10,17,-7
14,17,241,17,14,3
14,17,242,23,19,4
14,17,243,29,13,16
14,17,244,12,16,-4
14,17,245,9,15,-6
14,17,246,26,20,6
14,17,247,10,10,0
14,17,248,27,10,17
14,17,249,18,9,9
14,17,250,12,18,-6
14,17,251,15,15,0
14,17,252,27,12,15
14,17,253,21,10,11
14,17,254,20,25,-5
14,17,255,16,3,13
14,17,256,24,17,7
14,17,257,8,14,-6
14,17,258,15,6,9
14,17,259,10,21,-11
14,17,260,11,11,0
14,17,261,23,20,3
14,17,262,13,20,-7
14,17,263,26,16,10
14,17,264,8,20,-12
14,17,265,17,14,3
14,17,266,11,15,-4
14,17,267,22,18,4
14,17,268,21,17,4
14,17,269,23,6,17
14,17,270,17,17,0
14,17,271,13,22,-9
14,17,272,10,14,-4
14,17,273,13,13,0
14,17,274,16,14,2
14,17,275,21,17,4
14,17,276,20,11,9
14,17,277,5,7,-2
14,17,278,8,12,-4
14,17,279,26,22,4
14,17,280,20,18,2
14,17,281,22,14,8
14,17,282,16,7,9
14,17,283,16,14,2
14,17,284,13,13,0
14,17,285,11,16,-5
14,17,286,18,15,3
14,17,287,13,12,1
14,17,288,9,5,4
14,17,289,8,11,-3
14,17,290,8,25,-17
14,17,291,17,14,3
14,17,292,9,12,-3
14,17,293,14,10,4
14,17,294,14,19,-5
14,17,295,17,33,-16
14,17,296,19,13,6
14,17,297,14,10,4
14,17,298,27,11,16
14,17,299,20,8,12
14,18,0,13,8,5
14,18,1,15,11,4
14,18,2,19,9,10
14,18,3,23,14,9
14,18,4,8,17,-9
14,18,5,18,18,0
14,18,6,17,20,-3
14,18,7,23,15,8
14,18,8,16,14,2
14,18,9,17,18,-1
14,18,10,28,21,7
14,18,11,12,16,-4
14,18,12,10,16,-6
14,18,13,16,33,-17
14,18,14,9,27,-18
14,18,15,18,14,4
14,18,16,23,22,1
14,18,17,25,23,2
14,18,18,10,4,6
14,18,19,12,13,-1
14,18,20,9,17,-8
14,18,21,21,15,6
14,18,22,11,2,9
14,18,23,22,7,15
14,18,24,11,15,-4
14,18,25,15,8,7
14,18,26,8,10,-2
14,18,27,16,12,4
14,18,28,21,20,1
14,18,29,26,12,14
14,18,30,17,17,0
14,18,31,16,14,2
14,18,32,25,19,6
14,18,33,19,12,7
14,18,34,19,12,7
14,18,35,16,12,4
14,18,36,12,19,-7
14,18,37,20,17,3
14,18,38,11,21,-10
14,18,39,19,19,0
14,18,40,16,14,2
14,18,41,13,16,-3
14,18,42,19,15,4
14,18,43,17,18,-1
14,18,44,18,10,8
14,18,45,18,13,5
14,18,46,21,24,-3
14,18,47,6,6,0
14,18,48,6,8,-2
14,18,49,13,17,-4
14,18,50,13,19,-6
14,18,51,16,16,0
14,18,52,11,24,-13
14,18,53,16,14,2
14,18,54,19,15,4
14,18,55,8,7,1
14,18,56,5,13,-8
14,18,57,24,15,9
14,18,58,11,21,-10
14,18,59,21,14,7
14,18,60,16,30,-14
14,18,61,18,16,2
14,18,62,38,13,25
14,18,63,25,13,12
14,18,64,17,17,0
14,18,65,11,16,-5
14,18,66,16,12,4
14,18,67,6,11,-5
14,18,68,16,11,5
14,18,69,10,18,-8
14,18,70,16,11,5
14,18,71,25,12,13
14,18,72,12,16,-4
14,18,73,15,17,-2
14,18,74,19,19,0
14,18,75,6,10,-4
14,18,76,22,7,15
14,18,77,27,19,8
14,18,78,17,13,4
14,18,79,14,9,5
14,18,80,20,11,9
14,18,81,16,18,-2
14,18,82,15,9,6
14,18,83,25,20,5
14,18,84,14,24,-10
14,18,85,36,9,27
14,18,86,8,9,-1
14,18,87,17,13,4
14,18,88,14,16,-2
14,18,89,16,9,7
14,18,90,13,14,-1
14,18,91,14,14,0
14,18,92,16,29,-13
14,18,93,16,32,-16
14,18,94,19,18,1
14,18,95,19,19,0
14,18,96,17,27,-10
14,18,97,21,19,2
14,18,98,11,15,-4
14,18,99,21,20,1
14,18,100,12,5,7
14,18,101,15,18,-3
14,18,102,27,13,14
14,18,103,19,14,5
14,18,104,22,17,5
14,18,105,16,15,1
14,18,106,22,19,3
14,18,107,13,9,4
14,18,108,9,12,-3
14,18,109,20,13,7
14,18,110,14,10,4
14,18,111,11,10,1
14,18,112,16,11,5
14,18,113,15,19,-4
14,18,114,7,15,-8
14,18,115,11,13,-2
14,18,116,7,12,-5
14,18,117,11,8,3
14,18,118,15,13,2
14,18,119,10,10,0
14,18,120,22,19,3
14,18,121,14,14,0
14,18,122,21,14,7
14,18,123,19,15,4
14,18,124,27,23,4
14,18,125,27,19,8
14,18,126,23,8,15
14,18,127,20,13,7
14,18,128,13,13,0
14,18,129,13,18,-5
14,18,130,17,14,3
14,18,131,15,23,-8
14,18,132,17,19,-2
14,18,133,12,18,-6
14,18,134,19,26,-7
14,18,135,17,20,-3
14,18,136,20,19,1
14,18,137,26,13,13
14,18,138,26,7,19
14,18,139,12,9,3
14,18,140,7,17,-10
14,18,141,22,24,-2
14,18,142,16,11,5
14,18,143,18,26,-8
14,18,144,18,6,12
14,18,145,25,16,9
14,18,146,25,24,1
14,18,147,23,14,9
14,18,148,15,24,-9
14,18,149,15,10,5
14,18,150,20,8,12
14,18,151,20,11,9
14,18,152,21,12,9
14,18,153,21,12,9
14,18,154,6,10,-4
14,18,155,7,24,-17
14,18,156,20,4,16
14,18,157,11,7,4
14,18,158,22,15,7
14,18,159,14,13,1
14,18,160,8,11,-3
14,18,161,19,17,2
14,18,162,10,11,-1
14,18,163,23,22,1
14,18,164,13,20,-7
14,18,165,17,18,-1
14,18,166,15,10,5
14,18,167,31,7,24
14,18,168,16,9,7
14,18,169,12,13,-1
14,18,170,5,8,-3
14,18,171,15,12,3
14,18,172,11,11,0
14,18,173,16,16,0
14,18,174,23,14,9
14,18,175,12,11,1
14,18,176,24,16,8
14,18,177,20,13,7
14,18,178,16,18,-2
14,18,179,22,11,11
14,18,180,10,4,6
14,18,181,27,20,7
14,18,182,20,9,11
14,18,183,23,23,0
14,18,184,17,13,4
14,18,185,30,20,10
14,18,186,14,25,-11
14,18,187,8,14,-6
14,18,188,18,14,4
14,18,189,11,22,-11
14,18,190,18,16,2
14,18,191,26,7,19
14,18,192,17,13,4
14,18,193,18,17,1
14,18,194,11,14,-3
14,18,195,11,18,-7
14,18,196,17,12,5
14,18,197,14,12,2
14,18,198,18,20,-2
14,18,199,10,15,-5
14,18,200,9,14,-5
14,18,201,6,7,-1
14,18,202,14,17,-3
14,18,203,13,26,-13
14,18,204,21,15,6
14,18,205,9,13,-4
14,18,206,22,30,-8
14,18,207,12,10,2
14,18,208,13,8,5
14,18,209,22,24,-2
14,18,210,27,30,-3
14,18,211,9,6,3
14,18,212,4,11,-7
14,18,213,10,16,-6
14,18,214,13,24,-11
14,18,215,19,21,-2
14,18,216,18,9,9
14,18,217,10,13,-3
14,18,218,22,20,2
14,18,219,5,6,-1
14,18,220,22,14,8
14,18,221,16,16,0
14,18,222,17,12,5
14,18,223,22,11,11
14,18,224,24,27,-3
14,18,225,18,24,-6
14,18,226,12,10,2
14,18,227,19,11,8
14,18,228,26,10,16
14,18,229,20,16,4
14,18,230,15,13,2
14,18,231,9,7,2
14,18,232,14,11,3
14,18,233,17,11,6
14,18,234,11,18,-7
14,18,235,13,13,0
14,18,236,11,28,-17
14,18,237,18,23,-5
14,18,238,13,15,-2
14,18,239,12,10,2
14,18,240,8,8,0
14,18,241,20,30,-10
14,18,242,21,26,-5
14,18,243,23,29,-6
14,18,244,19,33,-14
14,18,245,15,7,8
14,18,246,7,13,-6
14,18,247,23,13,10
14,18,248,12,17,-5
14,18,249,6,12,-6
14,18,250,11,5,6
14,18,251,34,17,17
14,18,252,21,10,11
14,18,253,16,18,-2
14,18,254,9,9,0
14,18,255,15,9,6
14,18,256,16,8,8
14,18,257,11,8,3
14,18,258,10,20,-10
14,18,259,7,3,4
14,18,260,27,16,11
14,18,261,22,23,-1
14,18,262,15,25,-10
14,18,263,14,15,-1
14,18,264,11,12,-1
14,18,265,17,11,6
14,18,266,12,11,1
14,18,267,28,12,16
14,18,268,11,17,-6
14,18,269,10,9,1
14,18,270,27,21,6
14,18,271,18,18,0
14,18,272,16,23,-7
14,18,273,20,23,-3
14,18,274,7,12,-5
14,18,275,23,16,7
14,18,276,12,12,0
14,18,277,16,19,-3
14,18,278,18,23,-5
14,18,279,18,9,9
14,18,280,25,16,9
14,18,281,16,13,3
14,18,282,22,24,-2
14,18,283,18,19,-1
14,18,284,14,19,-5
14,18,285,11,14,-3
14,18,286,18,10,8
14,18,287,14,23,-9
14,18,288,18,29,-11
14,18,289,13,14,-1
14,18,290,14,8,6
14,18,291,20,26,-6
14,18,292,14,8,6
14,18,293,21,4,17
14,18,294,22,23,-1
14,18,295,7,11,-4
14,18,296,11,16,-5
14,18,297,9,22,-13
14,18,298,17,9,8
14,18,299,20,19,1
14,19,0,21,24,-3
14,19,1,15,18,-3
14,19,2,6,5,1
14,19,3,24,19,5
14,19,4,10,16,-6
14,19,5,12,9,3
14,19,6,20,28,-8
14,19,7,21,15,6
14,19,8,24,12,12
14,19,9,25,20,5
14,19,10,4,17,-13
14,19,11,19,17,2
14,19,12,12,13,-1
14,19,13,19,21,-2
14,19,14,11,19,-8
14,19,15,8,10,-2
14,19,16,19,17,2
14,19,17,21,11,10
14,19,18,21,10,11
14,19,19,16,17,-1
14,19,20,16,19,-3
14,19,21,7,14,-7
14,19,22,5,10,-5
14,19,23,24,27,-3
14,19,24,22,13,9
14,19,25,9,13,-4
14,19,26,24,12,12
14,19,27,20,12,8
14,19,28,15,5,10
14,19,29,18,16,2
14,19,30,15,22,-7
14,19,31,10,12,-2
14,19,32,15,23,-8
14,19,33,21,11,10
14,19,34,25,13,12
14,19,35,7,8,-1
14,19,36,20,13,7
14,19,37,6,10,-4
14,19,38,17,12,5
14,19,39,14,0,14
14,19,40,24,20,4
14,19,41,14,15,-1
14,19,42,13,16,-3
14,19,43,22,9,13
14,19,44,18,22,-4
14,19,45,7,6,1
14,19,46,12,8,4
14,19,47,22,15,7
14,19,48,16,19,-3
14,19,49,9,13,-4
14,19,50,12,13,-1
14,19,51,10,8,2
14,19,52,29,18,11
14,19,53,18,24,-6
14,19,54,17,18,-1
14,19,55,11,9,2
14,19,56,12,14,-2
14,19,57,30,32,-2
14,19,58,18,21,-3
14,19,59,20,22,-2
14,19,60,9,14,-5
14,19,61,0,11,-11
14,19,62,14,15,-1
14,19,63,13,13,0
14,19,64,18,12,6
14,19,65,30,12,18
14,19,66,14,7,7
14,19,67,21,27,-6
14,19,68,14,15,-1
14,19,69,19,23,-4
14,19,70,21,15,6
14,19,71,20,13,7
14,19,72,22,14,8
14,19,73,17,23,-6
14,19,74,7,10,-3
14,19,75,17,22,-5
14,19,76,17,10,7
14,19,77,16,9,7
14,19,78,11,20,-9
14,19,79,8,11,-3
14,19,80,24,18,6
14,19,81,9,14,-5
14,19,82,12,12,0
14,19,83,18,15,3
14,19,84,18,17,1
14,19,85,19,15,4
14,19,86,13,11,2
14,19,87,15,13,2
14,19,88,27,29,-2
14,19,89,23,22,1
14,19,90,18,21,-3
14,19,91,17,15,2
14,19,92,6,9,-3
14,19,93,36,20,16
14,19,94,15,23,-8
14,19,95,14,25,-11
14,19,96,18,12,6
14,19,97,7,21,-14
14,19,98,13,17,-4
14,19,99,21,13,8
14,19,100,19,25,-6
14,19,101,19,16,3
14,19,102,16,13,3
14,19,103,9,12,-3
14,19,104,16,18,-2
14,19,105,7,6,1
14,19,106,24,14,10
14,19,107,22,15,7
14,19,108,15,14,1
14,19,109,8,14,-6
14,19,110,13,17,-4
14,19,111,20,23,-3
14,19,112,4,12,-8
14,19,113,17,17,0
14,19,114,9,15,-6
14,19,115,15,16,-1
14,19,116,8,17,-9
14,19,117,7,5,2
14,19,118,8,18,-10
14,19,119,13,20,-7
14,19,120,7,9,-2
14,19,121,8,9,-1
14,19,122,10,20,-10
14,19,123,23,12,11
14,19,124,12,15,-3
14,19,125,10,16,-6
14,19,126,26,30,-4
14,19,127,22,23,-1
14,19,128,12,12,0
14,19,129,19,21,-2
14,19,130,23,28,-5
14,19,131,11,12,-1
14,19,132,15,15,0
14,19,133,22,14,8
14,19,134,22,21,1
14,19,135,23,5,18
14,19,136,13,13,0
14,19,137,13,6,7
14,19,138,30,14,16
14,19,139,12,11,1
14,19,140,17,23,-6
14,19,141,15,6,9
14,19,142,12,24,-12
14,19,143,8,11,-3
14,19,144,19,15,4
14,19,145,21,23,-2
14,19,146,13,16,-3
14,19,147,17,14,3
14,19,148,17,21,-4
14,19,149,4,7,-3
14,19,150,15,13,2
14,19,151,20,18,2
14,19,152,12,4,8
14,19,153,10,23,-13
14,19,154,14,23,-9
14,19,155,16,10,6
14,19,156,11,21,-10
14,19,157,7,9,-2
14,19,158,18,17,1
14,19,159,19,13,6
14,19,160,10,22,-12
14,19,161,25,19,6
14,19,162,30,22,8
14,19,163,12,18,-6
14,19,164,9,11,-2
14,19,165,6,10,-4
14,19,166,11,16,-5
14,19,167,24,19,5
14,19,168,9,4,5
14,19,169,13,12,1
14,19,170,11,6,5
14,19,171,14,12,2
14,19,172,14,20,-6
14,19,173,19,15,4
14,19,174,13,13,0
14,19,175,8,12,-4
14,19,176,14,14,0
14,19,177,27,7,20
14,19,178,18,14,4
14,19,179,11,16,-5
14,19,180,11,9,2
14,19,181,12,5,7
14,19,182,13,15,-2
14,19,183,22,10,12
14,19,184,24,25,-1
14,19,185,12,8,4
14,19,186,17,16,1
14,19,187,8,8,0
14,19,188,13,29,-16
14,19,189,13,17,-4
14,19,190,25,24,1
14,19,191,16,19,-3
14,19,192,20,21,-1
14,19,193,11,17,-6
14,19,194,12,18,-6
14,19,195,30,20,10
14,19,196,17,5,12
14,19,197,14,12,2
14,19,198,15,22,-7
14,19,199,13,20,-7
14,19,200,20,15,5
14,19,201,13,11,2
14,19,202,14,16,-2
14,19,203,13,16,-3
14,19,204,10,18,-8
14,19,205,21,23,-2
14,19,206,22,32,-10
14,19,207,16,25,-9
14,19,208,9,15,-6
14,19,209,23,21,2
14,19,210,19,15,4
14,19,211,18,12,6
14,19,212,15,15,0
14,19,213,12,19,-7
14,19,214,18,15,3
14,19,215,18,7,11
14,19,216,13,10,3
14,19,217,18,21,-3
14,19,218,17,10,7
14,19,219,14,14,0
14,19,220,19,20,-1
14,19,221,22,15,7
14,19,222,18,6,12
14,19,223,6,14,-8
14,19,224,19,13,6
14,19,225,6,3,3
14,19,226,18,31,-13
14,19,227,19,13,6
14,19,228,15,7,8
14,19,229,8,23,-15
14,19,230,24,17,7
14,19,231,15,18,-3
14,19,232,12,11,1
14,19,233,14,16,-2
14,19,234,14,17,-3
14,19,235,12,20,-8
14,19,236,11,14,-3
14,19,237,12,10,2
14,19,238,13,15,-2
14,19,239,12,7,5
14,19,240,6,13,-7
14,19,241,7,5,2
14,19,242,16,6,10
14,19,243,24,15,9
14,19,244,12,7,5
14,19,245,6,14,-8
14,19,246,19,9,10
14,19,247,10,15,-5
14,19,248,24,24,0
14,19,249,42,14,28
14,19,250,6,8,-2
14,19,251,10,11,-1
14,19,252,13,13,0
14,19,253,15,14,1
14,19,254,14,28,-14
14,19,255,10,9,1
14,19,256,23,13,10
14,19,257,12,20,-8
14,19,258,16,17,-1
14,19,259,13,18,-5
14,19,260,12,0,12
14,19,261,3,7,-4
14,19,262,18,10,8
14,19,263,15,15,0
14,19,264,9,28,-19
14,19,265,7,2,5
14,19,266,21,23,-2
14,19,267,13,14,-1
14,19,268,11,16,-5
14,19,269,25,12,13
14,19,270,26,12,14
14,19,271,16,10,6
14,19,272,15,13,2
14,19,273,20,14,6
14,19,274,10,12,-2
14,19,275,19,15,4
14,19,276,19,20,-1
14,19,277,9,12,-3
14,19,278,17,13,4
14,19,279,14,16,-2
14,19,280,17,15,2
14,19,281,23,8,15
14,19,282,13,15,-2
14,19,283,11,18,-7
14,19,284,18,11,7
14,19,285,28,19,9
14,19,286,11,7,4
14,19,287,20,13,7
14,19,288,14,15,-1
14,19,289,12,10,2
14,19,290,29,13,16
14,19,291,10,9,1
14,19,292,33,21,12
14,19,293,25,4,21
14,19,294,26,20,6
14,19,295,17,10,7
14,19,296,16,8,8
14,19,297,6,9,-3
14,19,298,21,17,4
14,19,299,18,25,-7
14,20,0,15,8,7
14,20,1,10,19,-9
14,20,2,29,14,15
14,20,3,23,15,8
14,20,4,15,14,1
14,20,5,28,17,11
14,20,6,16,24,-8
14,20,7,18,14,4
14,20,8,15,13,2
14,20,9,19,30,-11
14,20,10,15,13,2
14,20,11,26,28,-2
14,20,12,7,4,3
14,20,13,12,17,-5
14,20,14,20,13,7
14,20,15,11,6,5
14,20,16,8,18,-10
14,20,17,8,12,-4
14,20,18,24,16,8
14,20,19,25,10,15
14,20,20,20,27,-7
14,20,21,28,12,16
14,20,22,20,14,6
14,20,23,20,9,11
14,20,24,15,23,-8
14,20,25,17,28,-11
14,20,26,7,8,-1
14,20,27,22,17,5
14,20,28,18,12,6
14,20,29,7,6,1
14,20,30,28,19,9
14,20,31,17,11,6
14,20,32,20,7,13
14,20,33,28,15,13
14,20,34,20,22,-2
14,20,35,20,21,-1
14,20,36,18,20,-2
14,20,37,26,22,4
14,20,38,17,9,8
14,20,39,16,17,-1
14,20,40,9,15,-6
14,20,41,34,18,16
14,20,42,15,14,1
14,20,43,20,9,11
14,20,44,11,13,-2
14,20,45,24,8,16
14,20,46,18,22,-4
14,20,47,17,12,5
14,20,48,23,15,8
14,20,49,14,26,-12
14,20,50,27,9,18
14,20,51,22,18,4
14,20,52,16,5,11
14,20,53,10,15,-5
14,20,54,14,12,2
14,20,55,21,24,-3
14,20,56,17,9,8
14,20,57,12,13,-1
14,20,58,15,16,-1
14,20,59,27,15,12
14,20,60,5,14,-9
14,20,61,21,15,6
14,20,62,21,15,6
14,20,63,12,17,-5
14,20,64,21,9,12
14,20,65,17,20,-3
14,20,66,8,19,-11
14,20,67,20,28,-8
14,20,68,12,15,-3
14,20,69,17,10,7
14,20,70,25,17,8
14,20,71,17,15,2
14,20,72,24,14,10
14,20,73,17,24,-7
14,20,74,21,17,4
14,20,75,15,10,5
14,20,76,25,18,7
14,20,77,13,22,-9
14,20,78,14,19,-5
14,20,79,24,24,0
14,20,80,9,4,5
14,20,81,21,11,10
14,20,82,7,16,-9
14,20,83,24,19,5
14,20,84,16,21,-5
14,20,85,19,18,1
14,20,86,4,18,-14
14,20,87,31,14,17
14,20,88,22,12,10
14,20,89,18,17,1
14,20,90,23,15,8
14,20,91,12,19,-7
14,20,92,19,17,2
14,20,93,15,15,0
14,20,94,15,19,-4
14,20,95,21,20,1
14,20,96,15,19,-4
14,20,97,29,13,16
14,20,98,12,6,6
14,20,99,26,21,5
14,20,100,19,16,3
14,20,101,29,17,12
14,20,102,13,15,-2
14,20,103,10,13,-3
14,20,104,22,22,0
14,20,105,17,17,0
14,20,106,20,7,13
14,20,107,5,18,-13
14,20,108,18,17,1
14,20,109,10,10,0
14,20,110,29,9,20
14,20,111,7,21,-14
14,20,112,13,19,-6
14,20,113,22,14,8
14,20,114,16,12,4
14,20,115,21,13,8
14,20,116,26,22,4
14,20,117,26,19,7
14,20,118,10,12,-2
14,20,119,23,12,11
14,20,120,16,11,5
14,20,121,12,18,-6
14,20,122,22,14,8
14,20,123,17,11,6
14,20,124,18,14,4
14,20,125,43,15,28
14,20,126,19,18,1
14,20,127,16,10,6
14,20,128,28,29,-1
14,20,129,16,17,-1
14,20,130,18,30,-12
14,20,131,18,15,3
14,20,132,15,14,1
14,20,133,18,11,7
14,20,134,16,11,5
14,20,135,19,17,2
14,20,136,29,14,15
14,20,137,24,28,-4
14,20,138,23,19,4
14,20,139,12,18,-6
14,20,140,31,19,12
14,20,141,27,15,12
14,20,142,19,19,0
14,20,143,16,22,-6
14,20,144,24,15,9
14,20,145,10,6,4
14,20,146,21,15,6
14,20,147,16,13,3
14,20,148,19,17,2
14,20,149,15,15,0
14,20,150,11,13,-2
14,20,151,6,17,-11
14,20,152,14,16,-2
14,20,153,6,12,-6
14,20,154,20,14,6
14,20,155,13,20,-7
14,20,156,16,9,7
14,20,157,12,6,6
14,20,158,14,7,7
14,20,159,21,8,13
14,20,160,3,7,-4
14,20,161,13,26,-13
14,20,162,17,16,1
14,20,163,24,14,10
14,20,164,21,21,0
14,20,165,15,13,2
14,20,166,19,5,14
14,20,167,6,2,4
14,20,168,24,12,12
14,20,169,24,19,5
14,20,170,11,5,6
14,20,171,32,32,0
14,20,172,18,16,2
14,20,173,23,22,1
14,20,174,15,7,8
14,20,175,7,13,-6
14,20,176,11,14,-3
14,20,177,21,10,11
14,20,178,15,30,-15
14,20,179,15,6,9
14,20,180,24,6,18
14,20,181,12,16,-4
14,20,182,10,11,-1
14,20,183,18,14,4
14,20,184,16,21,-5
14,20,185,24,7,17
14,20,186,19,16,3
14,20,187,13,12,1
14,20,188,16,14,2
14,20,189,10,9,1
14,20,190,10,14,-4
14,20,191,24,15,9
14,20,192,17,12,5
14,20,193,22,20,2
14,20,194,10,18,-8
14,20,195,21,19,2
14,20,196,15,4,11
14,20,197,12,20,-8
14,20,198,6,6,0
14,20,199,23,11,12
14,20,200,9,8,1
14,20,201,12,11,1
14,20,202,20,2,18
14,20,203,19,20,-1
14,20,204,21,2,19
14,20,205,12,17,-5
14,20,206,10,14,-4
14,20,207,17,21,-4
14,20,208,25,11,14
14,20,209,20,23,-3
14,20,210,9,16,-7
14,20,211,23,11,12
14,20,212,12,16,-4
14,20,213,11,15,-4
14,20,214,17,9,8
14,20,215,19,12,7
14,20,216,5,16,-11
14,20,217,11,13,-2
14,20,218,32,23,9
14,20,219,16,29,-13
14,20,220,21,22,-1
14,20,221,26,14,12
14,20,222,18,28,-10
14,20,223,10,14,-4
14,20,224,8,15,-7
14,20,225,15,10,5
14,20,226,19,12,7
14,20,227,11,13,-2
14,20,228,19,10,9
14,20,229,17,17,0
14,20,230,9,9,0
14,20,231,17,13,4
14,20,232,19,22,-3
14,20,233,20,11,9
14,20,234,14,18,-4
14,20,235,23,21,2
14,20,236,6,5,1
14,20,237,25,17,8
14,20,238,16,16,0
14,20,239,14,12,2
14,20,240,5,17,-12
14,20,241,26,12,14
14,20,242,12,24,-12
14,20,243,13,16,-3
14,20,244,14,8,6
14,20,245,13,13,0
14,20,246,12,16,-4
14,20,247,20,7,13
14,20,248,7,13,-6
14,20,249,20,13,7
14,20,250,21,12,9
14,20,251,17,16,1
14,20,252,16,17,-1
14,20,253,5,13,-8
14,20,254,11,17,-6
14,20,255,16,11,5
14,20,256,15,17,-2
14,20,257,20,21,-1
14,20,258,21,14,7
14,20,259,13,7,6
14,20,260,8,14,-6
14,20,261,14,18,-4
14,20,262,8,10,-2
14,20,263,13,11,2
14,20,264,11,25,-14
14,20,265,7,14,-7
14,20,266,20,13,7
14,20,267,10,7,3
14,20,268,8,15,-7
14,20,269,22,16,6
14,20,270,16,9,7
14,20,271,24,13,11
14,20,272,26,21,5
14,20,273,14,21,-7
14,20,274,14,10,4
14,20,275,18,13,5
14,20,276,18,16,2
14,20,277,19,20,-1
14,20,278,12,7,5
14,20,279,21,6,15
14,20,280,5,7,-2
14,20,281,12,15,-3
14,20,282,10,11,-1
14,20,283,12,7,5
14,20,284,24,13,11
14,20,285,14,11,3
14,20,286,8,11,-3
14,20,287,10,8,2
14,20,288,16,30,-14
14,20,289,29,16,13
14,20,290,13,15,-2
14,20,291,8,17,-9
14,20,292,11,11,0
14,20,293,16,9,7
14,20,294,20,17,3
14,20,295,8,8,0
14,20,296,16,13,3
14,20,297,26,26,0
14,20,298,28,26,2
14,20,299,26,13,13
14,21,0,13,16,-3
14,21,1,13,1,12
14,21,2,28,18,10
14,21,3,9,17,-8
14,21,4,19,10,9
14,21,5,12,14,-2
14,21,6,17,14,3
14,21,7,6,7,-1
14,21,8,10,17,-7
14,21,9,13,13,0
14,21,10,20,7,13
14,21,11,12,13,-1
14,21,12,12,7,5
14,21,13,17,19,-2
14,21,14,13,14,-1
14,21,15,21,25,-4
14,21,16,17,16,1
14,21,17,23,21,2
14,21,18,21,13,8
14,21,19,14,16,-2
14,21,20,26,15,11
14,21,21,16,26,-10
14,21,22,20,26,-6
14,21,23,20,22,-2
14,21,24,15,9,6
14,21,25,8,16,-8
14,21,26,21,10,11
14,21,27,19,6,13
14,21,28,17,16,1
14,21,29,10,15,-5
14,21,30,23,20,3
14,21,31,14,8,6
14,21,32,18,25,-7
14,21,33,11,17,-6
14,21,34,22,22,0
14,21,35,29,22,7
14,21,36,26,25,1
14,21,37,8,8,0
14,21,38,13,13,0
14,21,39,25,17,8
14,21,40,32,17,15
14,21,41,18,4,14
14,21,42,16,14,2
14,21,43,16,14,2
14,21,44,16,16,0
14,21,45,8,17,-9
14,21,46,13,31,-18
14,21,47,23,14,9
14,21,48,11,12,-1
14,21,49,16,27,-11
14,21,50,15,19,-4
14,21,51,10,6,4
14,21,52,13,10,3
14,21,53,15,8,7
14,21,54,27,18,9
14,21,55,20,18,2
14,21,56,11,14,-3
14,21,57,7,8,-1
14,21,58,9,6,3
14,21,59,39,14,25
14,21,60,15,16,-1
14,21,61,19,10,9
14,21,62,14,11,3
14,21,63,15,26,-11
14,21,64,17,14,3
14,21,65,11,12,-1
14,21,66,11,14,-3
14,21,67,20,14,6
14,21,68,20,26,-6
14,21,69,18,14,4
14,21,70,20,17,3
14,21,71,20,24,-4
14,21,72,19,11,8
14,21,73,27,12,15
14,21,74,13,18,-5
14,21,75,11,11,0
14,21,76,13,14,-1
14,21,77,9,6,3
14,21,78,10,16,-6
14,21,79,15,10,5
14,21,80,22,19,3
14,21,81,27,16,11
14,21,82,9,15,-6
14,21,83,30,13,17
14,21,84,13,8,5
14,21,85,21,11,10
14,21,86,16,28,-12
14,21,87,18,6,12
14,21,88,18,20,-2
14,21,89,9,24,-15
14,21,90,23,26,-3
14,21,91,14,21,-7
14,21,92,13,14,-1
14,21,93,8,14,-6
14,21,94,11,4,7
14,21,95,12,9,3
14,21,96,10,9,1
14,21,97,16,15,1
14,21,98,11,11,0
14,21,99,12,21,-9
14,21,100,9,14,-5
14,21,101,24,13,11
14,21,102,19,18,1
14,21,103,17,6,11
14,21,104,14,9,5
14,21,105,14,17,-3
14,21,106,13,15,-2
14,21,107,5,8,-3
14,21,108,24,18,6
14,21,109,10,14,-4
14,21,110,24,14,10
14,21,111,23,12,11
14,21,112,8,12,-4
14,21,113,12,11,1
14,21,114,18,14,4
14,21,115,11,11,0
14,21,116,14,18,-4
14,21,117,8,11,-3
14,21,118,8,12,-4
14,21,119,13,12,1
14,21,120,11,5,6
14,21,121,13,13,0
14,21,122,11,16,-5
14,21,123,28,23,5
14,21,124,14,2,12
14,21,125,14,12,2
14,21,126,23,16,7
14,21,127,8,6,2
14,21,128,18,19,-1
14,21,129,12,11,1
14,21,130,21,14,7
14,21,131,13,23,-10
14,21,132,18,14,4
14,21,133,18,12,6
14,21,134,20,22,-2
14,21,135,13,6,7
14,21,136,3,7,-4
14,21,137,21,13,8
14,21,138,7,14,-7
14,21,139,18,16,2
14,21,140,22,18,4
14,21,141,13,9,4
14,21,142,11,11,0
14,21,143,27,19,8
14,21,144,18,8,10
14,21,145,26,22,4
14,21,146,21,6,15
14,21,147,22,9,13
14,21,148,10,10,0
14,21,149,6,11,-5
14,21,150,10,22,-12
14,21,151,22,22,0
14,21,152,10,22,-12
14,21,153,13,11,2
14,21,154,16,12,4
14,21,155,20,13,7
14,21,156,26,23,3
14,21,157,24,15,9
14,21,158,13,7,6
14,21,159,24,26,-2
14,21,160,17,7,10
14,21,161,28,18,10
14,21,162,10,17,-7
14,21,163,9,15,-6
14,21,164,9,4,5
14,21,165,11,15,-4
14,21,166,28,23,5
14,21,167,23,13,10
14,21,168,17,29,-12
14,21,169,27,11,16
14,21,170,25,18,7
14,21,171,11,12,-1
14,21,172,15,10,5
14,21,173,18,12,6
14,21,174,23,15,8
14,21,175,14,5,9
14,21,176,13,6,7
14,21,177,12,21,-9
14,21,178,15,22,-7
14,21,179,17,18,-1
14,21,180,8,15,-7
14,21,181,17,9,8
14,21,182,12,29,-17
14,21,183,12,16,-4
14,21,184,16,10,6
14,21,185,28,21,7
14,21,186,9,10,-1
14,21,187,20,15,5
14,21,188,13,24,-11
14,21,189,26,19,7
14,21,190,23,12,11
14,21,191,14,10,4
14,21,192,6,12,-6
14,21,193,16,14,2
14,21,194,20,14,6
14,21,195,13,13,0
14,21,196,18,15,3
14,21,197,25,13,12
14,21,198,26,24,2
14,21,199,13,12,1
14,21,200,20,14,6
14,21,201,14,15,-1
14,21,202,7,16,-9
14,21,203,19,16,3
14,21,204,13,10,3
14,21,205,30,24,6
14,21,206,12,11,1
14,21,207,9,13,-4
14,21,208,16,17,-1
14,21,209,13,14,-1
14,21,210,18,17,1
14,21,211,12,25,-13
14,21,212,15,8,7
14,21,213,20,11,9
14,21,214,19,12,7
14,21,215,17,15,2
14,21,216,21,22,-1
14,21,217,24,14,10
14,21,218,11,14,-3
14,21,219,8,19,-11
14,21,220,15,9,6
14,21,221,15,15,0
14,21,222,15,4,11
14,21,223,9,17,-8
14,21,224,27,18,9
14,21,225,30,9,21
14,21,226,16,7,9
14,21,227,12,16,-4
14,21,228,22,15,7
14,21,229,14,14,0
14,21,230,7,6,1
14,21,231,30,19,11
14,21,232,23,10,13
14,21,233,20,21,-1
14,21,234,13,21,-8
14,21,235,19,10,9
14,21,236,15,11,4
14,21,237,13,7,6
14,21,238,8,5,3
14,21,239,20,5,15
14,21,240,9,12,-3
14,21,241,19,19,0
14,21,242,12,9,3
14,21,243,19,23,-4
14,21,244,5,21,-16
14,21,245,10,14,-4
14,21,246,10,11,-1
14,21,247,11,20,-9
14,21,248,14,15,-1
14,21,249,18,18,0
14,21,250,3,7,-4
14,21,251,10,24,-14
14,21,252,4,7,-3
14,21,253,24,7,17
14,21,254,17,11,6
14,21,255,13,10,3
14,21,256,16,18,-2
14,21,257,14,23,-9
14,21,258,10,17,-7
14,21,259,19,20,-1
14,21,260,22,13,9
14,21,261,14,10,4
14,21,262,21,24,-3
14,21,263,21,10,11
14,21,264,6,11,-5
14,21,265,24,22,2
14,21,266,16,12,4
14,21,267,6,16,-10
14,21,268,7,3,4
14,21,269,10,8,2
14,21,270,21,22,-1
14,21,271,9,12,-3
14,21,272,14,20,-6
14,21,273,15,11,4
14,21,274,18,20,-2
14,21,275,14,22,-8
14,21,276,15,25,-10
14,21,277,18,26,-8
14,21,278,8,12,-4
14,21,279,18,10,8
14,21,280,30,18,12
14,21,281,4,5,-1
14,21,282,18,11,7
14,21,283,6,5,1
14,21,284,13,12,1
14,21,285,18,18,0
14,21,286,14,14,0
14,21,287,15,12,3
14,21,288,18,23,-5
14,21,289,23,18,5
14,21,290,11,13,-2
14,21,291,8,11,-3
14,21,292,18,20,-2
14,21,293,15,14,1
14,21,294,30,10,20
14,21,295,31,12,19
14,21,296,32,15,17
14,21,297,25,13,12
14,21,298,20,11,9
14,21,299,18,14,4
14,22,0,26,18,8
14,22,1,18,15,3
14,22,2,12,9,3
14,22,3,24,22,2
14,22,4,13,10,3
14,22,5,19,16,3
14,22,6,14,11,3
14,22,7,14,17,-3
14,22,8,17,9,8
14,22,9,11,16,-5
14,22,10,18,12,6
14,22,11,29,15,14
14,22,12,13,10,3
14,22,13,15,18,-3
14,22,14,25,11,14
14,22,15,14,18,-4
14,22,16,10,17,-7
14,22,17,12,22,-10
14,22,18,12,24,-12
14,22,19,13,9,4
14,22,20,11,6,5
14,22,21,22,14,8
14,22,22,13,9,4
14,22,23,18,15,3
14,22,24,23,7,16
14,22,25,24,11,13
14,22,26,16,13,3
14,22,27,19,9,10
14,22,28,19,32,-13
14,22,29,9,12,-3
14,22,30,15,13,2
14,22,31,16,11,5
14,22,32,28,28,0
14,22,33,12,5,7
14,22,34,31,26,5
14,22,35,17,12,5
14,22,36,10,17,-7
14,22,37,5,5,0
14,22,38,19,5,14
14,22,39,21,9,12
14,22,40,16,23,-7
14,22,41,16,9,7
14,22,42,19,6,13
14,22,43,16,7,9
14,22,44,13,15,-2
14,22,45,16,16,0
14,22,46,24,18,6
14,22,47,14,22,-8
14,22,48,24,24,0
14,22,49,21,12,9
14,22,50,18,13,5
14,22,51,12,18,-6
14,22,52,21,15,6
14,22,53,13,21,-8
14,22,54,10,11,-1
14,22,55,26,10,16
14,22,56,10,9,1
14,22,57,13,14,-1
14,22,58,21,15,6
14,22,59,23,18,5
14,22,60,13,17,-4
14,22,61,10,12,-2
14,22,62,10,7,3
14,22,63,13,19,-6
14,22,64,9,12,-3
14,22,65,19,16,3
14,22,66,20,28,-8
14,22,67,17,10,7
14,22,68,14,5,9
14,22,69,20,9,11
14,22,70,14,28,-14
14,22,71,8,7,1
14,22,72,11,13,-2
14,22,73,21,17,4
14,22,74,22,22,0
14,22,75,15,15,0
14,22,76,23,9,14
14,22,77,6,16,-10
14,22,78,17,19,-2
14,22,79,24,24,0
14,22,80,12,12,0
14,22,81,21,18,3
14,22,82,12,23,-11
14,22,83,19,18,1
14,22,84,15,22,-7
14,22,85,19,14,5
14,22,86,15,19,-4
14,22,87,18,2,16
14,22,88,15,9,6
14,22,89,24,11,13
14,22,90,21,15,6
14,22,91,31,18,13
14,22,92,19,11,8
14,22,93,14,9,5
14,22,94,15,14,1
14,22,95,16,16,0
14,22,96,14,12,2
14,22,97,15,13,2
14,22,98,18,17,1
14,22,99,3,4,-1
14,22,100,20,15,5
14,22,101,24,5,19
14,22,102,31,10,21
14,22,103,10,7,3
14,22,104,19,9,10
14,22,105,19,14,5
14,22,106,10,13,-3
14,22,107,39,7,32
14,22,108,17,15,2
14,22,109,28,19,9
14,22,110,22,18,4
14,22,111,23,17,6
14,22,112,15,19,-4
14,22,113,9,3,6
14,22,114,18,14,4
14,22,115,16,21,-5
14,22,116,14,11,3
14,22,117,6,6,0
14,22,118,18,23,-5
14,22,119,15,14,1
14,22,120,24,8,16
14,22,121,16,14,2
14,22,122,25,26,-1
14,22,123,25,15,10
14,22,124,10,9,1
14,22,125,14,10,4
14,22,126,19,12,7
14,22,127,22,10,12
14,22,128,11,4,7
14,22,129,12,19,-7
14,22,130,28,37,-9
14,22,131,15,6,9
14,22,132,8,6,2
14,22,133,16,20,-4
14,22,134,13,5,8
14,22,135,25,21,4
14,22,136,11,4,7
14,22,137,13,10,3
14,22,138,15,8,7
14,22,139,14,16,-2
14,22,140,11,11,0
14,22,141,27,16,11
14,22,142,18,19,-1
14,22,143,15,12,3
14,22,144,16,26,-10
14,22,145,20,8,12
14,22,146,14,21,-7
14,22,147,25,7,18
14,22,148,10,11,-1
14,22,149,13,13,0
14,22,150,8,15,-7
14,22,151,22,14,8
14,22,152,16,8,8
14,22,153,17,11,6
14,22,154,19,16,3
14,22,155,21,4,17
14,22,156,22,24,-2
14,22,157,24,12,12
14,22,158,14,10,4
14,22,159,12,10,2
14,22,160,19,10,9
14,22,161,23,17,6
14,22,162,11,4,7
14,22,163,35,16,19
14,22,164,9,10,-1
14,22,165,27,24,3
14,22,166,5,10,-5
14,22,167,21,9,12
14,22,168,18,9,9
14,22,169,17,27,-10
14,22,170,18,24,-6
14,22,171,19,26,-7
14,22,172,21,9,12
14,22,173,24,25,-1
14,22,174,21,18,3
14,22,175,22,30,-8
14,22,176,17,17,0
14,22,177,26,11,15
14,22,178,15,12,3
14,22,179,10,5,5
14,22,180,11,3,8
14,22,181,10,14,-4
14,22,182,13,10,3
14,22,183,19,11,8
14,22,184,16,11,5
14,22,185,15,18,-3
14,22,186,12,8,4
14,22,187,17,15,2
14,22,188,10,18,-8
14,22,189,29,22,7
14,22,190,19,6,13
14,22,191,27,18,9
14,22,192,13,18,-5
14,22,193,21,19,2
14,22,194,10,7,3
14,22,195,16,13,3
14,22,196,9,5,4
14,22,197,17,19,-2
14,22,198,20,17,3
14,22,199,11,10,1
14,22,200,25,28,-3
14,22,201,14,18,-4
14,22,202,17,13,4
14,22,203,12,17,-5
14,22,204,17,10,7
14,22,205,8,26,-18
14,22,206,10,15,-5
14,22,207,26,13,13
14,22,208,7,11,-4
14,22,209,14,5,9
14,22,210,14,8,6
14,22,211,17,13,4
14,22,212,17,19,-2
14,22,213,21,31,-10
14,22,214,16,17,-1
14,22,215,13,13,0
14,22,216,14,24,-10
14,22,217,17,14,3
14,22,218,20,21,-1
14,22,219,16,8,8
14,22,220,13,14,-1
14,22,221,13,18,-5
14,22,222,10,11,-1
14,22,223,16,30,-14
14,22,224,10,8,2
14,22,225,19,22,-3
14,22,226,24,7,17
14,22,227,17,6,11
14,22,228,8,6,2
14,22,229,9,18,-9
14,22,230,13,20,-7
14,22,231,13,7,6
14,22,232,24,12,12
14,22,233,18,5,13
14,22,234,15,9,6
14,22,235,12,9,3
14,22,236,23,15,8
14,22,237,13,6,7
14,22,238,18,3,15
14,22,239,20,5,15
14,22,240,7,13,-6
14,22,241,19,7,12
14,22,242,18,13,5
14,22,243,15,16,-1
14,22,244,10,11,-1
14,22,245,8,14,-6
14,22,246,8,10,-2
14,22,247,16,21,-5
14,22,248,10,16,-6
14,22,249,14,14,0
14,22,250,16,18,-2
14,22,251,17,12,5
14,22,252,20,21,-1
14,22,253,22,14,8
14,22,254,24,18,6
14,22,255,13,16,-3
14,22,256,12,15,-3
14,22,257,15,18,-3
14,22,258,12,12,0
14,22,259,12,18,-6
14,22,260,16,16,0
14,22,261,27,21,6
14,22,262,24,24,0
14,22,263,10,4,6
14,22,264,4,7,-3
14,22,265,15,24,-9
14,22,266,16,12,4
14,22,267,23,21,2
14,22,268,17,11,6
14,22,269,26,19,7
14,22,270,21,14,7
14,22,271,18,16,2
14,22,272,12,8,4
14,22,273,10,13,-3
14,22,274,13,15,-2
14,22,275,15,13,2
14,22,276,6,12,-6
14,22,277,25,20,5
14,22,278,23,21,2
14,22,279,21,12,9
14,22,280,17,10,7
14,22,281,10,17,-7
14,22,282,16,15,1
14,22,283,19,15,4
14,22,284,18,26,-8
14,22,285,18,22,-4
14,22,286,18,10,8
14,22,287,14,6,8
14,22,288,12,22,-10
14,22,289,19,15,4
14,22,290,23,18,5
14,22,291,23,13,10
14,22,292,15,26,-11
14,22,293,21,8,13
14,22,294,30,21,9
14,22,295,29,14,15
14,22,296,9,18,-9
14,22,297,14,17,-3
14,22,298,15,10,5
14,22,299,16,10,6
14,23,0,22,23,-1
14,23,1,13,14,-1
14,23,2,25,14,11
14,23,3,20,18,2
14,23,4,19,13,6
14,23,5,19,25,-6
14,23,6,7,5,2
14,23,7,12,17,-5
14,23,8,16,18,-2
14,23,9,17,6,11
14,23,10,6,3,3
14,23,11,6,5,1
14,23,12,18,10,8
14,23,13,26,12,14
14,23,14,18,25,-7
14,23,15,33,17,16
14,23,16,20,8,12
14,23,17,12,16,-4
14,23,18,20,6,14
14,23,19,11,16,-5
14,23,20,24,14,10
14,23,21,10,14,-4
14,23,22,10,4,6
14,23,23,12,17,-5
14,23,24,31,24,7
14,23,25,28,12,16
14,23,26,15,8,7
14,23,27,21,21,0
14,23,28,15,12,3
14,23,29,18,26,-8
14,23,30,14,15,-1
14,23,31,19,13,6
14,23,32,11,13,-2
14,23,33,20,14,6
14,23,34,16,11,5
14,23,35,24,11,13
14,23,36,7,21,-14
14,23,37,17,8,9
14,23,38,23,11,12
14,23,39,16,11,5
14,23,40,16,11,5
14,23,41,13,20,-7
14,23,42,11,15,-4
14,23,43,9,9,0
14,23,44,22,2,20
14,23,45,19,23,-4
14,23,46,10,25,-15
14,23,47,18,14,4
14,23,48,16,16,0
14,23,49,11,9,2
14,23,50,10,14,-4
14,23,51,34,16,18
14,23,52,16,12,4
14,23,53,16,12,4
14,23,54,18,19,-1
14,23,55,9,4,5
14,23,56,26,11,15
14,23,57,16,14,2
14,23,58,18,12,6
14,23,59,15,12,3
14,23,60,15,16,-1
14,23,61,7,13,-6
14,23,62,14,7,7
14,23,63,9,10,-1
14,23,64,15,15,0
14,23,65,16,11,5
14,23,66,14,17,-3
14,23,67,23,5,18
14,23,68,27,9,18
14,23,69,19,23,-4
14,23,70,24,16,8
14,23,71,15,14,1
14,23,72,25,19,6
14,23,73,26,16,10
14,23,74,9,14,-5
14,23,75,16,21,-5
14,23,76,17,14,3
14,23,77,13,9,4
14,23,78,17,10,7
14,23,79,12,18,-6
14,23,80,11,15,-4
14,23,81,15,7,8
14,23,82,10,19,-9
14,23,83,10,7,3
14,23,84,11,16,-5
14,23,85,19,12,7
14,23,86,20,8,12
14,23,87,18,3,15
14,23,88,19,17,2
14,23,89,13,18,-5
14,23,90,26,12,14
14,23,91,12,21,-9
14,23,92,14,8,6
14,23,93,14,19,-5
14,23,94,22,13,9
14,23,95,7,13,-6
14,23,96,17,28,-11
14,23,97,31,21,10
14,23,98,12,15,-3
14,23,99,21,4,17
14,23,100,13,14,-1
14,23,101,12,13,-1
14,23,102,10,11,-1
14,23,103,9,12,-3
14,23,104,16,16,0
14,23,105,18,9,9
14,23,106,15,12,3
14,23,107,22,25,-3
14,23,108,29,8,21
14,23,109,20,15,5
14,23,110,11,7,4
14,23,111,13,11,2
14,23,112,17,8,9
14,23,113,12,7,5
14,23,114,10,15,-5
14,23,115,22,12,10
14,23,116,14,11,3
14,23,117,21,16,5
14,23,118,7,15,-8
14,23,119,15,13,2
14,23,120,11,6,5
14,23,121,8,14,-6
14,23,122,9,25,-16
14,23,123,22,16,6
14,23,124,17,18,-1
14,23,125,29,18,11
14,23,126,14,16,-2
14,23,127,18,21,-3
14,23,128,18,18,0
14,23,129,12,18,-6
14,23,130,13,13,0
14,23,131,11,16,-5
14,23,132,21,22,-1
14,23,133,14,9,5
14,23,134,13,11,2
14,23,135,23,18,5
14,23,136,18,16,2
14,23,137,15,8,7
14,23,138,23,11,12
14,23,139,20,6,14
14,23,140,13,7,6
14,23,141,6,3,3
14,23,142,12,6,6
14,23,143,15,18,-3
14,23,144,14,15,-1
14,23,145,20,13,7
14,23,146,15,11,4
14,23,147,23,22,1
14,23,148,12,6,6
14,23,149,13,9,4
14,23,150,22,22,0
14,23,151,18,10,8
14,23,152,20,18,2
14,23,153,8,7,1
14,23,154,23,16,7
14,23,155,7,6,1
14,23,156,17,8,9
14,23,157,17,11,6
14,23,158,18,14,4
14,23,159,11,16,-5
14,23,160,12,7,5
14,23,161,11,10,1
14,23,162,7,7,0
14,23,163,19,14,5
14,23,164,20,8,12
14,23,165,11,10,1
14,23,166,11,12,-1
14,23,167,13,10,3
14,23,168,21,15,6
14,23,169,23,22,1
14,23,170,17,15,2
14,23,171,20,22,-2
14,23,172,18,13,5
14,23,173,17,16,1
14,23,174,13,13,0
14,23,175,5,10,-5
14,23,176,17,19,-2
14,23,177,33,24,9
14,23,178,12,17,-5
14,23,179,18,14,4
14,23,180,16,10,6
14,23,181,23,10,13
14,23,182,14,17,-3
14,23,183,31,8,23
14,23,184,22,9,13
14,23,185,23,6,17
14,23,186,23,11,12
14,23,187,26,7,19
14,23,188,9,12,-3
14,23,189,18,15,3
14,23,190,13,10,3
14,23,191,23,15,8
14,23,192,13,9,4
14,23,193,26,11,15
14,23,194,15,6,9
14,23,195,17,14,3
14,23,196,11,4,7
14,23,197,20,8,12
14,23,198,15,16,-1
14,23,199,38,15,23
14,23,200,23,12,11
14,23,201,16,25,-9
14,23,202,15,6,9
14,23,203,27,25,2
14,23,204,20,15,5
14,23,205,15,16,-1
14,23,206,6,7,-1
14,23,207,22,10,12
14,23,208,11,5,6
14,23,209,19,11,8
14,23,210,24,19,5
14,23,211,14,31,-17
14,23,212,11,18,-7
14,23,213,13,15,-2
14,23,214,19,19,0
14,23,215,12,10,2
14,23,216,19,13,6
14,23,217,13,8,5
14,23,218,14,3,11
14,23,219,15,9,6
14,23,220,10,17,-7
14,23,221,21,11,10
14,23,222,26,19,7
14,23,223,12,15,-3
14,23,224,22,10,12
14,23,225,19,21,-2
14,23,226,13,11,2
14,23,227,11,17,-6
14,23,228,11,19,-8
14,23,229,8,10,-2
14,23,230,30,10,20
14,23,231,18,14,4
14,23,232,15,15,0
14,23,233,12,15,-3
14,23,234,16,9,7
14,23,235,20,16,4
14,23,236,12,11,1
14,23,237,16,15,1
14,23,238,26,17,9
14,23,239,17,13,4
14,23,240,17,10,7
14,23,241,16,18,-2
14,23,242,26,25,1
14,23,243,9,7,2
14,23,244,17,21,-4
14,23,245,8,6,2
14,23,246,25,17,8
14,23,247,5,17,-12
14,23,248,22,17,5
14,23,249,14,12,2
14,23,250,28,15,13
14,23,251,10,12,-2
14,23,252,11,19,-8
14,23,253,20,14,6
14,23,254,18,8,10
14,23,255,18,17,1
14,23,256,2,7,-5
14,23,257,22,18,4
14,23,258,14,16,-2
14,23,259,20,9,11
14,23,260,19,14,5
14,23,261,19,17,2
14,23,262,20,14,6
14,23,263,5,6,-1
14,23,264,27,26,1
14,23,265,13,10,3
14,23,266,23,8,15
14,23,267,18,15,3
14,23,268,29,20,9
14,23,269,21,11,10
14,23,270,23,25,-2
14,23,271,15,24,-9
14,23,272,13,13,0
14,23,273,9,12,-3
14,23,274,19,20,-1
14,23,275,12,20,-8
14,23,276,17,7,10
14,23,277,20,13,7
14,23,278,13,31,-18
14,23,279,11,6,5
14,23,280,8,14,-6
14,23,281,24,30,-6
14,23,282,19,13,6
14,23,283,17,14,3
14,23,284,7,12,-5
14,23,285,21,12,9
14,23,286,14,10,4
14,23,287,26,18,8
14,23,288,11,19,-8
14,23,289,27,22,5
14,23,290,6,10,-4
14,23,291,10,4,6
14,23,292,20,15,5
14,23,293,19,4,15
14,23,294,13,12,1
14,23,295,12,8,4
14,23,296,23,6,17
14,23,297,12,21,-9
14,23,298,22,22,0
14,23,299,11,15,-4
14,24,0,22,14,8
14,24,1,11,30,-19
14,24,2,16,17,-1
14,24,3,8,10,-2
14,24,4,14,12,2
14,24,5,18,8,10
14,24,6,9,13,-4
14,24,7,9,10,-1
14,24,8,26,21,5
14,24,9,10,14,-4
14,24,10,14,16,-2
14,24,11,23,16,7
14,24,12,15,4,11
14,24,13,25,8,17
14,24,14,19,15,4
14,24,15,26,13,13
14,24,16,15,24,-9
14,24,17,20,15,5
14,24,18,14,6,8
14,24,19,13,6,7
14,24,20,5,12,-7
14,24,21,20,28,-8
14,24,22,12,15,-3
14,24,23,11,9,2
14,24,24,17,18,-1
14,24,25,16,22,-6
14,24,26,20,19,1
14,24,27,21,18,3
14,24,28,22,14,8
14,24,29,17,15,2
14,24,30,20,11,9
14,24,31,18,6,12
14,24,32,18,15,3
14,24,33,13,14,-1
14,24,34,8,8,0
14,24,35,16,8,8
14,24,36,15,10,5
14,24,37,26,19,7
14,24,38,19,7,12
14,24,39,15,14,1
14,24,40,17,18,-1
14,24,41,16,18,-2
14,24,42,15,10,5
14,24,43,18,22,-4
14,24,44,25,17,8
14,24,45,17,3,14
14,24,46,10,9,1
14,24,47,15,19,-4
14,24,48,25,7,18
14,24,49,21,21,0
14,24,50,24,12,12
14,24,51,14,17,-3
14,24,52,5,9,-4
14,24,53,8,17,-9
14,24,54,18,7,11
14,24,55,17,13,4
14,24,56,26,23,3
14,24,57,19,10,9
14,24,58,16,6,10
14,24,59,6,6,0
14,24,60,23,12,11
14,24,61,12,10,2
14,24,62,16,11,5
14,24,63,13,10,3
14,24,64,22,15,7
14,24,65,20,6,14
14,24,66,22,11,11
14,24,67,17,6,11
14,24,68,9,12,-3
14,24,69,9,11,-2
14,24,70,14,22,-8
14,24,71,26,27,-1
14,24,72,18,14,4
14,24,73,16,17,-1
14,24,74,27,13,14
14,24,75,10,9,1
14,24,76,21,9,12
14,24,77,10,10,0
14,24,78,9,6,3
14,24,79,17,25,-8
14,24,80,16,7,9
14,24,81,7,17,-10
14,24,82,15,12,3
14,24,83,11,10,1
14,24,84,17,17,0
14,24,85,5,12,-7
14,24,86,14,21,-7
14,24,87,17,11,6
14,24,88,5,8,-3
14,24,89,20,12,8
14,24,90,21,15,6
14,24,91,17,17,0
14,24,92,10,9,1
14,24,93,20,28,-8
14,24,94,24,8,16
14,24,95,19,9,10
14,24,96,29,13,16
14,24,97,13,11,2
14,24,98,25,5,20
14,24,99,13,6,7
14,24,100,9,8,1
14,24,101,10,15,-5
14,24,102,13,13,0
14,24,103,16,11,5
14,24,104,18,14,4
14,24,105,13,10,3
14,24,106,14,3,11
14,24,107,17,9,8
14,24,108,21,12,9
14,24,109,27,21,6
14,24,110,6,13,-7
14,24,111,5,14,-9
14,24,112,16,7,9
14,24,113,13,7,6
14,24,114,29,16,13
14,24,115,20,11,9
14,24,116,25,9,16
14,24,117,11,8,3
14,24,118,13,14,-1
14,24,119,29,22,7
14,24,120,23,15,8
14,24,121,11,9,2
14,24,122,10,10,0
14,24,123,36,16,20
14,24,124,17,13,4
14,24,125,17,16,1
14,24,126,17,6,11
14,24,127,14,15,-1
14,24,128,6,8,-2
14,24,129,16,8,8
14,24,130,13,7,6
14,24,131,14,20,-6
14,24,132,23,19,4
14,24,133,21,7,14
14,24,134,21,13,8
14,24,135,19,14,5
14,24,136,12,9,3
14,24,137,16,13,3
14,24,138,23,17,6
14,24,139,16,21,-5
14,24,140,15,12,3
14,24,141,16,14,2
14,24,142,22,14,8
14,24,143,9,13,-4
14,24,144,26,17,9
14,24,145,15,10,5
14,24,146,12,12,0
14,24,147,17,23,-6
14,24,148,13,12,1
14,24,149,11,8,3
14,24,150,35,15,20
14,24,151,11,10,1
14,24,152,21,7,14
14,24,153,13,17,-4
14,24,154,14,9,5
14,24,155,32,11,21
14,24,156,18,20,-2
14,24,157,40,9,31
14,24,158,9,18,-9
14,24,159,12,9,3
14,24,160,15,16,-1
14,24,161,21,9,12
14,24,162,7,8,-1
14,24,163,17,11,6
14,24,164,10,6,4
14,24,165,13,15,-2
14,24,166,18,17,1
14,24,167,8,13,-5
14,24,168,18,6,12
14,24,169,11,9,2
14,24,170,8,10,-2
14,24,171,11,12,-1
14,24,172,26,11,15
14,24,173,14,7,7
14,24,174,10,9,1
14,24,175,20,14,6
14,24,176,28,16,12
14,24,177,17,6,11
14,24,178,11,14,-3
14,24,179,27,12,15
14,24,180,12,7,5
14,24,181,15,9,6
14,24,182,20,4,16
14,24,183,13,7,6
14,24,184,13,22,-9
14,24,185,22,18,4
14,24,186,18,11,7
14,24,187,22,9,13
14,24,188,41,23,18
14,24,189,23,14,9
14,24,190,13,13,0
14,24,191,29,17,12
14,24,192,13,5,8
14,24,193,20,15,5
14,24,194,9,10,-1
14,24,195,16,14,2
14,24,196,8,20,-12
14,24,197,18,29,-11
14,24,198,9,4,5
14,24,199,8,6,2
14,24,200,41,15,26
14,24,201,18,11,7
14,24,202,16,20,-4
14,24,203,18,16,2
14,24,204,23,20,3
14,24,205,13,11,2
14,24,206,19,23,-4
14,24,207,27,9,18
14,24,208,21,10,11
14,24,209,21,7,14
14,24,210,27,27,0
14,24,211,9,14,-5
14,24,212,21,9,12
14,24,213,20,22,-2
14,24,214,27,20,7
14,24,215,13,19,-6
14,24,216,27,18,9
14,24,217,9,9,0
14,24,218,14,14,0
14,24,219,7,7,0
14,24,220,29,14,15
14,24,221,16,10,6
14,24,222,9,13,-4
14,24,223,14,14,0
14,24,224,20,15,5
14,24,225,28,21,7
14,24,226,13,13,0
14,24,227,18,11,7
14,24,228,13,9,4
14,24,229,10,7,3
14,24,230,16,11,5
14,24,231,12,18,-6
14,24,232,9,14,-5
14,24,233,14,27,-13
14,24,234,6,13,-7
14,24,235,21,10,11
14,24,236,21,14,7
14,24,237,27,24,3
14,24,238,17,21,-4
14,24,239,22,10,12
14,24,240,14,5,9
14,24,241,19,10,9
14,24,242,23,10,13
14,24,243,24,14,10
14,24,244,42,9,33
14,24,245,25,23,2
14,24,246,11,10,1
14,24,247,11,11,0
14,24,248,11,10,1
14,24,249,7,14,-7
14,24,250,19,6,13
14,24,251,8,6,2
14,24,252,10,10,0
14,24,253,24,17,7
14,24,254,23,16,7
14,24,255,14,17,-3
14,24,256,24,12,12
14,24,257,11,14,-3
14,24,258,14,11,3
14,24,259,21,18,3
14,24,260,17,15,2
14,24,261,28,15,13
14,24,262,9,14,-5
14,24,263,10,12,-2
14,24,264,7,6,1
14,24,265,20,9,11
14,24,266,11,10,1
14,24,267,14,19,-5
14,24,268,21,23,-2
14,24,269,14,5,9
14,24,270,14,11,3
14,24,271,27,14,13
14,24,272,13,11,2
14,24,273,15,16,-1
14,24,274,13,11,2
14,24,275,12,15,-3
14,24,276,21,15,6
14,24,277,26,11,15
14,24,278,14,25,-11
14,24,279,22,22,0
14,24,280,7,8,-1
14,24,281,14,11,3
14,24,282,5,18,-13
14,24,283,15,11,4
14,24,284,15,6,9
14,24,285,13,7,6
14,24,286,16,20,-4
14,24,287,17,11,6
14,24,288,14,15,-1
14,24,289,22,11,11
14,24,290,21,24,-3
14,24,291,14,6,8
14,24,292,13,8,5
14,24,293,12,7,5
14,24,294,17,22,-5
14,24,295,16,9,7
14,24,296,27,14,13
14,24,297,9,15,-6
14,24,298,15,21,-6
14,24,299,20,13,7
14,25,0,15,9,6
14,25,1,11,7,4
14,25,2,25,8,17
14,25,3,10,7,3
14,25,4,17,23,-6
14,25,5,9,10,-1
14,25,6,16,19,-3
14,25,7,11,16,-5
14,25,8,12,17,-5
14,25,9,14,11,3
14,25,10,18,8,10
14,25,11,22,11,11
14,25,12,13,11,2
14,25,13,18,5,13
14,25,14,25,16,9
14,25,15,23,12,11
14,25,16,15,20,-5
14,25,17,18,14,4
14,25,18,12,10,2
14,25,19,19,7,12
14,25,20,27,13,14
14,25,21,12,14,-2
14,25,22,17,11,6
14,25,23,19,10,9
14,25,24,26,16,10
14,25,25,18,11,7
14,25,26,21,18,3
14,25,27,17,17,0
14,25,28,17,11,6
14,25,29,8,7,1
14,25,30,14,12,2
14,25,31,9,4,5
14,25,32,16,10,6
14,25,33,27,9,18
14,25,34,11,15,-4
14,25,35,22,7,15
14,25,36,20,13,7
14,25,37,18,8,10
14,25,38,13,10,3
14,25,39,19,10,9
14,25,40,8,6,2
14,25,41,34,6,28
14,25,42,11,6,5
14,25,43,5,10,-5
14,25,44,12,11,1
14,25,45,20,23,-3
14,25,46,6,9,-3
14,25,47,11,14,-3
14,25,48,17,10,7
14,25,49,14,10,4
14,25,50,34,10,24
14,25,51,22,11,11
14,25,52,23,7,16
14,25,53,13,8,5
14,25,54,18,30,-12
14,25,55,8,15,-7
14,25,56,16,11,5
14,25,57,20,18,2
14,25,58,13,15,-2
14,25,59,7,9,-2
14,25,60,21,15,6
14,25,61,17,21,-4
14,25,62,22,13,9
14,25,63,32,6,26
14,25,64,17,6,11
14,25,65,21,11,10
14,25,66,15,9,6
14,25,67,27,16,11
14,25,68,31,17,14
14,25,69,8,14,-6
14,25,70,15,13,2
14,25,71,11,13,-2
14,25,72,13,14,-1
14,25,73,23,20,3
14,25,74,20,12,8
14,25,75,22,16,6
14,25,76,21,14,7
14,25,77,12,8,4
14,25,78,17,12,5
14,25,79,24,6,18
14,25,80,29,8,21
14,25,81,8,12,-4
14,25,82,9,7,2
14,25,83,16,10,6
14,25,84,21,13,8
14,25,85,16,13,3
14,25,86,12,12,0
14,25,87,16,20,-4
14,25,88,15,8,7
14,25,89,23,18,5
14,25,90,10,13,-3
14,25,91,12,12,0
14,25,92,15,11,4
14,25,93,21,8,13
14,25,94,15,6,9
14,25,95,18,6,12
14,25,96,13,13,0
14,25,97,11,6,5
14,25,98,15,23,-8
14,25,99,6,12,-6
14,25,100,10,12,-2
14,25,101,11,6,5
14,25,102,9,11,-2
14,25,103,12,7,5
14,25,104,27,17,10
14,25,105,19,6,13
14,25,106,14,14,0
14,25,107,16,9,7
14,25,108,26,13,13
14,25,109,27,21,6
14,25,110,14,12,2
14,25,111,22,12,10
14,25,112,12,3,9
14,25,113,9,12,-3
14,25,114,19,9,10
14,25,115,20,13,7
14,25,116,28,24,4
14,25,117,16,12,4
14,25,118,16,8,8
14,25,119,9,6,3
14,25,120,11,11,0
14,25,121,22,16,6
14,25,122,17,14,3
14,25,123,25,15,10
14,25,124,9,20,-11
14,25,125,11,19,-8
14,25,126,13,11,2
14,25,127,16,18,-2
14,25,128,16,17,-1
14,25,129,22,13,9
14,25,130,20,14,6
14,25,131,15,17,-2
14,25,132,3,5,-2
14,25,133,14,14,0
14,25,134,27,14,13
14,25,135,14,17,-3
14,25,136,13,12,1
14,25,137,14,6,8
14,25,138,10,19,-9
14,25,139,25,10,15
14,25,140,6,20,-14
14,25,141,19,8,11
14,25,142,18,7,11
14,25,143,12,10,2
14,25,144,13,16,-3
14,25,145,14,11,3
14,25,146,13,14,-1
14,25,147,20,12,8
14,25,148,8,8,0
14,25,149,30,15,15
14,25,150,10,9,1
14,25,151,25,6,19
14,25,152,16,4,12
14,25,153,16,21,-5
14,25,154,12,4,8
14,25,155,24,8,16
14,25,156,13,10,3
14,25,157,21,17,4
14,25,158,30,12,18
14,25,159,19,5,14
14,25,160,14,18,-4
14,25,161,16,12,4
14,25,162,16,26,-10
14,25,163,8,16,-8
14,25,164,28,12,16
14,25,165,24,14,10
14,25,166,18,12,6
14,25,167,20,15,5
14,25,168,11,4,7
14,25,169,14,14,0
14,25,170,10,4,6
14,25,171,15,5,10
14,25,172,14,8,6
14,25,173,23,12,11
14,25,174,24,12,12
14,25,175,10,9,1
14,25,176,18,22,-4
14,25,177,17,13,4
14,25,178,10,5,5
14,25,179,21,18,3
14,25,180,10,13,-3
14,25,181,21,9,12
14,25,182,8,8,0
14,25,183,26,12,14
14,25,184,26,13,13
14,25,185,6,5,1
14,25,186,13,6,7
14,25,187,10,12,-2
14,25,188,21,16,5
14,25,189,22,11,11
14,25,190,19,11,8
14,25,191,17,16,1
14,25,192,16,20,-4
14,25,193,17,18,-1
14,25,194,23,8,15
14,25,195,17,13,4
14,25,196,18,8,10
14,25,197,16,10,6
14,25,198,24,19,5
14,25,199,19,5,14
14,25,200,29,30,-1
14,25,201,11,18,-7
14,25,202,17,21,-4
14,25,203,22,12,10
14,25,204,12,7,5
14,25,205,18,2,16
14,25,206,17,17,0
14,25,207,17,7,10
14,25,208,24,7,17
14,25,209,13,6,7
14,25,210,18,18,0
14,25,211,16,14,2
14,25,212,14,17,-3
14,25,213,22,7,15
14,25,214,14,5,9
14,25,215,18,18,0
14,25,216,24,10,14
14,25,217,7,9,-2
14,25,218,10,16,-6
14,25,219,14,14,0
14,25,220,13,11,2
14,25,221,20,9,11
14,25,222,9,11,-2
14,25,223,14,15,-1
14,25,224,29,18,11
14,25,225,18,11,7
14,25,226,26,17,9
14,25,227,19,23,-4
14,25,228,16,11,5
14,25,229,15,20,-5
14,25,230,21,20,1
14,25,231,25,12,13
14,25,232,22,13,9
14,25,233,26,8,18
14,25,234,25,23,2
14,25,235,13,16,-3
14,25,236,7,11,-4
14,25,237,21,27,-6
14,25,238,13,11,2
14,25,239,27,25,2
14,25,240,11,11,0
14,25,241,5,17,-12
14,25,242,23,30,-7
14,25,243,23,13,10
14,25,244,18,7,11
14,25,245,21,8,13
14,25,246,11,6,5
14,25,247,13,14,-1
14,25,248,19,27,-8
14,25,249,10,10,0
14,25,250,22,13,9
14,25,251,29,13,16
14,25,252,30,15,15
14,25,253,25,20,5
14,25,254,17,17,0
14,25,255,11,22,-11
14,25,256,13,11,2
14,25,257,15,9,6
14,25,258,13,12,1
14,25,259,18,13,5
14,25,260,13,9,4
14,25,261,9,17,-8
14,25,262,23,29,-6
14,25,263,10,16,-6
14,25,264,15,6,9
14,25,265,14,15,-1
14,25,266,33,14,19
14,25,267,17,4,13
14,25,268,26,11,15
14,25,269,25,6,19
14,25,270,15,8,7
14,25,271,10,12,-2
14,25,272,11,17,-6
14,25,273,28,29,-1
14,25,274,8,6,2
14,25,275,9,11,-2
14,25,276,12,9,3
14,25,277,23,17,6
14,25,278,14,14,0
14,25,279,13,3,10
14,25,280,18,20,-2
14,25,281,17,8,9
14,25,282,23,36,-13
14,25,283,19,16,3
14,25,284,25,19,6
14,25,285,20,13,7
14,25,286,13,13,0
14,25,287,22,21,1
14,25,288,18,15,3
14,25,289,25,5,20
14,25,290,18,21,-3
14,25,291,17,7,10
14,25,292,13,1,12
14,25,293,14,12,2
14,25,294,23,13,10
14,25,295,25,13,12
14,25,296,8,7,1
14,25,297,13,5,8
14,25,298,12,15,-3
14,25,299,24,10,14
14,26,0,14,11,3
14,26,1,16,13,3
14,26,2,21,16,5
14,26,3,16,11,5
14,26,4,30,17,13
14,26,5,11,14,-3
14,26,6,7,6,1
14,26,7,17,15,2
14,26,8,20,10,10
14,26,9,14,12,2
14,26,10,23,12,11
14,26,11,20,16,4
14,26,12,21,23,-2
14,26,13,8,13,-5
14,26,14,10,4,6
14,26,15,18,12,6
14,26,16,20,12,8
14,26,17,13,12,1
14,26,18,17,9,8
14,26,19,15,23,-8
14,26,20,12,13,-1
14,26,21,19,15,4
14,26,22,11,8,3
14,26,23,19,14,5
14,26,24,26,28,-2
14,26,25,17,23,-6
14,26,26,11,5,6
14,26,27,21,16,5
14,26,28,20,26,-6
14,26,29,16,7,9
14,26,30,26,12,14
14,26,31,26,8,18
14,26,32,24,8,16
14,26,33,18,14,4
14,26,34,9,8,1
14,26,35,23,21,2
14,26,36,16,10,6
14,26,37,25,12,13
14,26,38,16,9,7
14,26,39,21,11,10
14,26,40,27,15,12
14,26,41,16,16,0
14,26,42,19,8,11
14,26,43,18,13,5
14,26,44,22,14,8
14,26,45,14,8,6
14,26,46,12,5,7
14,26,47,25,13,12
14,26,48,18,20,-2
14,26,49,20,13,7
14,26,50,14,16,-2
14,26,51,18,21,-3
14,26,52,21,13,8
14,26,53,16,17,-1
14,26,54,10,10,0
14,26,55,30,19,11
14,26,56,13,7,6
14,26,57,13,9,4
14,26,58,15,11,4
14,26,59,10,16,-6
14,26,60,11,13,-2
14,26,61,17,17,0
14,26,62,19,20,-1
14,26,63,31,25,6
14,26,64,12,16,-4
14,26,65,19,16,3
14,26,66,16,14,2
14,26,67,20,18,2
14,26,68,20,17,3
14,26,69,15,7,8
14,26,70,19,21,-2
14,26,71,20,15,5
14,26,72,14,7,7
14,26,73,20,14,6
14,26,74,8,12,-4
14,26,75,17,17,0
14,26,76,10,17,-7
14,26,77,5,15,-10
14,26,78,14,18,-4
14,26,79,21,10,11
14,26,80,26,12,14
14,26,81,12,8,4
14,26,82,18,14,4
14,26,83,26,9,17
14,26,84,11,10,1
14,26,85,15,23,-8
14,26,86,46,20,26
14,26,87,14,1,13
14,26,88,20,20,0
14,26,89,27,6,21
14,26,90,13,6,7
14,26,91,13,11,2
14,26,92,14,6,8
14,26,93,9,4,5
14,26,94,5,3,2
14,26,95,10,1,9
14,26,96,12,6,6
14,26,97,12,9,3
14,26,98,19,19,0
14,26,99,13,12,1
14,26,100,21,8,13
14,26,101,20,9,11
14,26,102,18,16,2
14,26,103,23,12,11
14,26,104,19,11,8
14,26,105,5,11,-6
14,26,106,22,18,4
14,26,107,20,12,8
14,26,108,21,10,11
14,26,109,10,7,3
14,26,110,25,12,13
14,26,111,6,16,-10
14,26,112,19,12,7
14,26,113,14,13,1
14,26,114,10,15,-5
14,26,115,17,11,6
14,26,116,19,22,-3
14,26,117,28,16,12
14,26,118,14,11,3
14,26,119,8,16,-8
14,26,120,11,19,-8
14,26,121,15,13,2
14,26,122,21,11,10
14,26,123,26,19,7
14,26,124,22,13,9
14,26,125,19,3,16
14,26,126,28,20,8
14,26,127,18,15,3
14,26,128,15,11,4
14,26,129,14,13,1
14,26,130,9,14,-5
14,26,131,18,21,-3
14,26,132,15,18,-3
14,26,133,12,8,4
14,26,134,17,14,3
14,26,135,25,15,10
14,26,136,15,6,9
14,26,137,18,16,2
14,26,138,28,6,22
14,26,139,9,13,-4
14,26,140,30,5,25
14,26,141,11,14,-3
14,26,142,14,25,-11
14,26,143,6,10,-4
14,26,144,12,13,-1
14,26,145,14,1,13
14,26,146,16,9,7
14,26,147,22,14,8
14,26,148,17,14,3
14,26,149,9,12,-3
14,26,150,25,13,12
14,26,151,15,11,4
14,26,152,20,16,4
14,26,153,6,8,-2
14,26,154,16,8,8
14,26,155,16,21,-5
14,26,156,14,16,-2
14,26,157,16,7,9
14,26,158,20,9,11
14,26,159,38,14,24
14,26,160,5,2,3
14,26,161,9,6,3
14,26,162,2,5,-3
14,26,163,20,20,0
14,26,164,31,14,17
14,26,165,20,4,16
14,26,166,21,11,10
14,26,167,12,6,6
14,26,168,10,14,-4
14,26,169,15,13,2
14,26,170,22,10,12
14,26,171,22,10,12
14,26,172,23,12,11
14,26,173,13,11,2
14,26,174,11,9,2
14,26,175,20,4,16
14,26,176,21,17,4
14,26,177,21,24,-3
14,26,178,11,5,6
14,26,179,15,6,9
14,26,180,19,12,7
14,26,181,9,9,0
14,26,182,14,6,8
14,26,183,34,6,28
14,26,184,22,10,12
14,26,185,17,12,5
14,26,186,3,6,-3
14,26,187,13,14,-1
14,26,188,26,10,16
14,26,189,16,3,13
14,26,190,15,12,3
14,26,191,11,6,5
14,26,192,27,10,17
14,26,193,19,6,13
14,26,194,22,11,11
14,26,195,19,19,0
14,26,196,16,7,9
14,26,197,13,10,3
14,26,198,4,14,-10
14,26,199,18,14,4
14,26,200,7,9,-2
14,26,201,20,12,8
14,26,202,8,8,0
14,26,203,17,13,4
14,26,204,11,18,-7
14,26,205,26,16,10
14,26,206,21,17,4
14,26,207,35,21,14
14,26,208,20,3,17
14,26,209,20,18,2
14,26,210,30,16,14
14,26,211,20,4,16
14,26,212,6,6,0
14,26,213,14,12,2
14,26,214,13,22,-9
14,26,215,14,6,8
14,26,216,14,11,3
14,26,217,25,18,7
14,26,218,23,9,14
14,26,219,13,11,2
14,26,220,16,17,-1
14,26,221,17,6,11
14,26,222,26,15,11
14,26,223,17,13,4
14,26,224,19,17,2
14,26,225,9,7,2
14,26,226,15,3,12
14,26,227,9,11,-2
14,26,228,15,12,3
14,26,229,22,14,8
14,26,230,18,7,11
14,26,231,8,7,1
14,26,232,30,9,21
14,26,233,21,14,7
14,26,234,16,19,-3
14,26,235,12,5,7
14,26,236,19,19,0
14,26,237,16,18,-2
14,26,238,20,11,9
14,26,239,9,5,4
14,26,240,23,11,12
14,26,241,20,8,12
14,26,242,28,18,10
14,26,243,6,9,-3
14,26,244,18,11,7
14,26,245,15,4,11
14,26,246,24,18,6
14,26,247,15,7,8
14,26,248,14,7,7
14,26,249,19,18,1
14,26,250,16,11,5
14,26,251,15,9,6
14,26,252,17,15,2
14,26,253,12,25,-13
14,26,254,12,10,2
14,26,255,23,9,14
14,26,256,11,4,7
14,26,257,32,13,19
14,26,258,8,7,1
14,26,259,17,16,1
14,26,260,19,9,10
14,26,261,16,10,6
14,26,262,12,14,-2
14,26,263,13,19,-6
14,26,264,21,12,9
14,26,265,16,18,-2
14,26,266,29,19,10
14,26,267,39,18,21
14,26,268,13,22,-9
14,26,269,11,7,4
14,26,270,30,16,14
14,26,271,26,22,4
14,26,272,16,18,-2
14,26,273,15,11,4
14,26,274,14,3,11
14,26,275,17,9,8
14,26,276,23,14,9
14,26,277,21,15,6
14,26,278,17,17,0
14,26,279,15,9,6
14,26,280,19,10,9
14,26,281,27,15,12
14,26,282,11,6,5
14,26,283,5,9,-4
14,26,284,31,20,11
14,26,285,17,10,7
14,26,286,24,20,4
14,26,287,16,18,-2
14,26,288,10,10,0
14,26,289,16,10,6
14,26,290,12,9,3
14,26,291,16,16,0
14,26,292,15,15,0
14,26,293,21,11,10
14,26,294,17,23,-6
14,26,295,17,17,0
14,26,296,23,10,13
14,26,297,13,7,6
14,26,298,24,21,3
14,26,299,15,16,-1
14,27,0,13,11,2
14,27,1,21,9,12
14,27,2,13,5,8
14,27,3,16,13,3
14,27,4,9,3,6
14,27,5,20,18,2
14,27,6,29,13,16
14,27,7,20,13,7
14,27,8,14,23,-9
14,27,9,13,18,-5
14,27,10,21,13,8
14,27,11,23,7,16
14,27,12,23,10,13
14,27,13,19,8,11
14,27,14,12,2,10
14,27,15,17,16,1
14,27,16,9,11,-2
14,27,17,8,11,-3
14,27,18,17,8,9
14,27,19,14,10,4
14,27,20,20,9,11
14,27,21,33,16,17
14,27,22,12,15,-3
14,27,23,11,5,6
14,27,24,15,16,-1
14,27,25,17,5,12
14,27,26,16,8,8
14,27,27,4,5,-1
14,27,28,12,13,-1
14,27,29,16,8,8
14,27,30,10,10,0
14,27,31,16,12,4
14,27,32,26,17,9
14,27,33,18,14,4
14,27,34,20,11,9
14,27,35,7,19,-12
14,27,36,7,5,2
14,27,37,25,19,6
14,27,38,17,11,6
14,27,39,28,9,19
14,27,40,18,13,5
14,27,41,15,8,7
14,27,42,20,18,2
14,27,43,18,13,5
14,27,44,16,20,-4
14,27,45,23,13,10
14,27,46,12,16,-4
14,27,47,18,9,9
14,27,48,28,12,16
14,27,49,8,9,-1
14,27,50,11,15,-4
14,27,51,11,9,2
14,27,52,12,10,2
14,27,53,17,19,-2
14,27,54,35,12,23
14,27,55,15,10,5
14,27,56,28,10,18
14,27,57,18,10,8
14,27,58,11,21,-10
14,27,59,21,16,5
14,27,60,11,13,-2
14,27,61,20,19,1
14,27,62,20,14,6
14,27,63,20,11,9
14,27,64,31,24,7
14,27,65,17,14,3
14,27,66,23,15,8
14,27,67,19,6,13
14,27,68,19,20,-1
14,27,69,9,14,-5
14,27,70,21,16,5
14,27,71,2,7,-5
14,27,72,20,15,5
14,27,73,17,10,7
14,27,74,14,18,-4
14,27,75,14,28,-14
14,27,76,17,11,6
14,27,77,13,11,2
14,27,78,17,11,6
14,27,79,9,12,-3
14,27,80,17,8,9
14,27,81,12,14,-2
14,27,82,17,13,4
14,27,83,10,4,6
14,27,84,9,12,-3
14,27,85,31,19,12
14,27,86,5,10,-5
14,27,87,28,23,5
14,27,88,23,15,8
14,27,89,16,19,-3
14,27,90,21,12,9
14,27,91,14,14,0
14,27,92,13,9,4
14,27,93,23,14,9
14,27,94,14,7,7
14,27,95,15,7,8
14,27,96,19,20,-1
14,27,97,13,15,-2
14,27,98,37,17,20
14,27,99,34,13,21
14,27,100,21,17,4
14,27,101,16,10,6
14,27,102,22,13,9
14,27,103,20,17,3
14,27,104,21,17,4
14,27,105,14,23,-9
14,27,106,11,7,4
14,27,107,21,23,-2
14,27,108,20,8,12
14,27,109,20,17,3
14,27,110,15,7,8
14,27,111,11,16,-5
14,27,112,23,4,19
14,27,113,12,14,-2
14,27,114,11,11,0
14,27,115,22,18,4
14,27,116,11,22,-11
14,27,117,12,16,-4
14,27,118,19,9,10
14,27,119,8,16,-8
14,27,120,21,14,7
14,27,121,29,12,17
14,27,122,22,20,2
14,27,123,27,12,15
14,27,124,13,24,-11
14,27,125,28,24,4
14,27,126,15,16,-1
14,27,127,9,9,0
14,27,128,15,12,3
14,27,129,21,16,5
14,27,130,18,10,8
14,27,131,3,14,-11
14,27,132,8,14,-6
14,27,133,16,7,9
14,27,134,12,8,4
14,27,135,21,10,11
14,27,136,25,8,17
14,27,137,16,16,0
14,27,138,16,16,0
14,27,139,19,9,10
14,27,140,16,10,6
14,27,141,30,28,2
14,27,142,9,7,2
14,27,143,23,10,13
14,27,144,12,19,-7
14,27,145,22,6,16
14,27,146,3,5,-2
14,27,147,18,22,-4
14,27,148,20,20,0
14,27,149,16,17,-1
14,27,150,11,13,-2
14,27,151,14,6,8
14,27,152,27,15,12
14,27,153,18,4,14
14,27,154,15,10,5
14,27,155,19,9,10
14,27,156,17,4,13
14,27,157,16,15,1
14,27,158,10,8,2
14,27,159,25,5,20
14,27,160,19,13,6
14,27,161,14,10,4
14,27,162,13,8,5
14,27,163,16,14,2
14,27,164,21,8,13
14,27,165,12,15,-3
14,27,166,29,12,17
14,27,167,13,11,2
14,27,168,9,8,1
14,27,169,8,12,-4
14,27,170,23,16,7
14,27,171,18,21,-3
14,27,172,4,14,-10
14,27,173,15,12,3
14,27,174,19,11,8
14,27,175,24,15,9
14,27,176,13,10,3
14,27,177,32,34,-2
14,27,178,10,12,-2
14,27,179,5,10,-5
14,27,180,7,6,1
14,27,181,16,11,5
14,27,182,6,12,-6
14,27,183,14,12,2
14,27,184,16,7,9
14,27,185,15,14,1
14,27,186,14,11,3
14,27,187,23,9,14
14,27,188,15,11,4
14,27,189,23,18,5
14,27,190,28,5,23
14,27,191,14,10,4
14,27,192,6,6,0
14,27,193,18,14,4
14,27,194,20,7,13
14,27,195,19,11,8
14,27,196,10,12,-2
14,27,197,26,13,13
14,27,198,10,5,5
14,27,199,14,9,5
14,27,200,20,15,5
14,27,201,8,17,-9
14,27,202,17,9,8
14,27,203,13,11,2
14,27,204,13,13,0
14,27,205,14,6,8
14,27,206,17,16,1
14,27,207,18,12,6
14,27,208,21,25,-4
14,27,209,26,15,11
14,27,210,23,3,20
14,27,211,13,16,-3
14,27,212,22,14,8
14,27,213,19,16,3
14,27,214,13,21,-8
14,27,215,16,10,6
14,27,216,32,18,14
14,27,217,15,5,10
14,27,218,14,13,1
14,27,219,20,26,-6
14,27,220,10,6,4
14,27,221,29,17,12
14,27,222,20,14,6
14,27,223,31,13,18
14,27,224,20,16,4
14,27,225,37,10,27
14,27,226,17,7,10
14,27,227,19,8,11
14,27,228,24,11,13
14,27,229,22,17,5
14,27,230,15,14,1
14,27,231,12,13,-1
14,27,232,18,9,9
14,27,233,24,16,8
14,27,234,14,8,6
14,27,235,17,4,13
14,27,236,10,6,4
14,27,237,21,8,13
14,27,238,28,11,17
14,27,239,29,9,20
14,27,240,14,8,6
14,27,241,27,8,19
14,27,242,16,8,8
14,27,243,7,7,0
14,27,244,19,23,-4
14,27,245,14,9,5
14,27,246,13,20,-7
14,27,247,10,6,4
14,27,248,27,16,11
14,27,249,11,16,-5
14,27,250,9,14,-5
14,27,251,6,18,-12
14,27,252,6,7,-1
14,27,253,8,12,-4
14,27,254,17,4,13
14,27,255,14,7,7
14,27,256,15,5,10
14,27,257,17,8,9
14,27,258,17,15,2
14,27,259,23,22,1
14,27,260,20,5,15
14,27,261,12,14,-2
14,27,262,8,13,-5
14,27,263,21,13,8
14,27,264,34,10,24
14,27,265,14,11,3
14,27,266,18,21,-3
14,27,267,7,11,-4
14,27,268,24,26,-2
14,27,269,23,13,10
14,27,270,23,8,15
14,27,271,25,9,16
14,27,272,18,16,2
14,27,273,36,20,16
14,27,274,16,15,1
14,27,275,4,12,-8
14,27,276,18,9,9
14,27,277,16,4,12
14,27,278,14,9,5
14,27,279,30,15,15
14,27,280,11,8,3
14,27,281,19,13,6
14,27,282,9,7,2
14,27,283,19,23,-4
14,27,284,35,16,19
14,27,285,12,7,5
14,27,286,14,19,-5
14,27,287,21,14,7
14,27,288,20,18,2
14,27,289,3,13,-10
14,27,290,19,14,5
14,27,291,10,15,-5
14,27,292,21,20,1
14,27,293,11,12,-1
14,27,294,19,16,3
14,27,295,15,22,-7
14,27,296,26,7,19
14,27,297,28,16,12
14,27,298,13,15,-2
14,27,299,13,8,5
14,28,0,14,6,8
14,28,1,17,9,8
14,28,2,26,10,16
14,28,3,13,20,-7
14,28,4,19,19,0
14,28,5,12,13,-1
14,28,6,11,10,1
14,28,7,17,9,8
14,28,8,8,3,5
14,28,9,15,9,6
14,28,10,10,6,4
14,28,11,6,9,-3
14,28,12,24,12,12
14,28,13,18,11,7
14,28,14,29,11,18
14,28,15,12,10,2
14,28,16,31,14,17
14,28,17,16,7,9
14,28,18,21,20,1
14,28,19,9,3,6
14,28,20,12,6,6
14,28,21,21,18,3
14,28,22,12,6,6
14,28,23,19,15,4
14,28,24,14,6,8
14,28,25,9,15,-6
14,28,26,17,16,1
14,28,27,18,15,3
14,28,28,18,10,8
14,28,29,15,9,6
14,28,30,9,6,3
14,28,31,14,24,-10
14,28,32,14,18,-4
14,28,33,18,9,9
14,28,34,10,8,2
14,28,35,18,15,3
14,28,36,13,3,10
14,28,37,10,17,-7
14,28,38,17,13,4
14,28,39,14,18,-4
14,28,40,9,4,5
14,28,41,11,18,-7
14,28,42,20,16,4
14,28,43,13,16,-3
14,28,44,20,13,7
14,28,45,12,11,1
14,28,46,27,12,15
14,28,47,20,10,10
14,28,48,12,9,3
14,28,49,22,13,9
14,28,50,18,10,8
14,28,51,20,23,-3
14,28,52,11,13,-2
14,28,53,12,13,-1
14,28,54,24,14,10
14,28,55,21,15,6
14,28,56,24,9,15
14,28,57,16,10,6
14,28,58,27,21,6
14,28,59,12,7,5
14,28,60,22,15,7
14,28,61,5,9,-4
14,28,62,8,6,2
14,28,63,26,15,11
14,28,64,11,10,1
14,28,65,36,14,22
14,28,66,9,14,-5
14,28,67,13,2,11
14,28,68,14,10,4
14,28,69,16,17,-1
14,28,70,19,17,2
14,28,71,20,13,7
14,28,72,18,11,7
14,28,73,15,13,2
14,28,74,25,18,7
14,28,75,8,4,4
14,28,76,14,10,4
14,28,77,20,15,5
14,28,78,18,18,0
14,28,79,10,11,-1
14,28,80,20,13,7
14,28,81,19,12,7
14,28,82,17,12,5
14,28,83,15,10,5
14,28,84,5,7,-2
14,28,85,23,15,8
14,28,86,13,6,7
14,28,87,17,18,-1
14,28,88,12,13,-1
14,28,89,22,13,9
14,28,90,11,8,3
14,28,91,10,9,1
14,28,92,13,12,1
14,28,93,15,10,5
14,28,94,6,7,-1
14,28,95,25,17,8
14,28,96,10,8,2
14,28,97,18,14,4
14,28,98,10,25,-15
14,28,99,26,18,8
14,28,100,15,12,3
14,28,101,17,9,8
14,28,102,16,11,5
14,28,103,9,4,5
14,28,104,11,13,-2
14,28,105,15,5,10
14,28,106,7,4,3
14,28,107,19,15,4
14,28,108,15,27,-12
14,28,109,29,20,9
14,28,110,9,9,0
14,28,111,32,15,17
14,28,112,19,15,4
14,28,113,18,12,6
14,28,114,22,4,18
14,28,115,15,25,-10
14,28,116,8,8,0
14,28,117,13,4,9
14,28,118,15,15,0
14,28,119,12,13,-1
14,28,120,23,8,15
14,28,121,19,14,5
14,28,122,6,11,-5
14,28,123,9,15,-6
14,28,124,13,9,4
14,28,125,19,9,10
14,28,126,22,27,-5
14,28,127,15,12,3
14,28,128,20,6,14
14,28,129,23,11,12
14,28,130,10,9,1
14,28,131,17,10,7
14,28,132,13,13,0
14,28,133,29,22,7
14,28,134,12,19,-7
14,28,135,21,23,-2
14,28,136,23,9,14
14,28,137,12,10,2
14,28,138,9,11,-2
14,28,139,18,10,8
14,28,140,14,25,-11
14,28,141,12,12,0
14,28,142,10,2,8
14,28,143,12,16,-4
14,28,144,27,12,15
14,28,145,28,25,3
14,28,146,20,14,6
14,28,147,19,7,12
14,28,148,12,18,-6
14,28,149,12,7,5
14,28,150,22,7,15
14,28,151,20,15,5
14,28,152,22,14,8
14,28,153,30,16,14
14,28,154,14,11,3
14,28,155,17,13,4
14,28,156,24,17,7
14,28,157,36,11,25
14,28,158,9,13,-4
14,28,159,20,16,4
14,28,160,24,16,8
14,28,161,25,21,4
14,28,162,38,20,18
14,28,163,14,9,5
14,28,164,16,12,4
14,28,165,25,12,13
14,28,166,17,8,9
14,28,167,15,16,-1
14,28,168,7,11,-4
14,28,169,20,12,8
14,28,170,13,18,-5
14,28,171,12,13,-1
14,28,172,22,7,15
14,28,173,23,13,10
14,28,174,17,18,-1
14,28,175,21,12,9
14,28,176,21,10,11
14,28,177,18,20,-2
14,28,178,12,14,-2
14,28,179,20,7,13
14,28,180,24,16,8
14,28,181,10,20,-10
14,28,182,25,7,18
14,28,183,17,13,4
14,28,184,11,11,0
14,28,185,27,25,2
14,28,186,10,13,-3
14,28,187,13,10,3
14,28,188,6,14,-8
14,28,189,20,13,7
14,28,190,13,9,4
14,28,191,21,18,3
14,28,192,18,3,15
14,28,193,30,27,3
14,28,194,14,4,10
14,28,195,21,18,3
14,28,196,12,14,-2
14,28,197,14,7,7
14,28,198,18,10,8
14,28,199,31,23,8
14,28,200,17,10,7
14,28,201,30,22,8
14,28,202,22,13,9
14,28,203,28,21,7
14,28,204,11,11,0
14,28,205,18,16,2
14,28,206,10,7,3
14,28,207,20,8,12
14,28,208,10,5,5
14,28,209,20,17,3
14,28,210,12,13,-1
14,28,211,26,15,11
14,28,212,12,9,3
14,28,213,19,16,3
14,28,214,15,12,3
14,28,215,19,16,3
14,28,216,22,20,2
14,28,217,10,5,5
14,28,218,7,12,-5
14,28,219,11,24,-13
14,28,220,16,15,1
14,28,221,17,21,-4
14,28,222,16,21,-5
14,28,223,13,11,2
14,28,224,15,16,-1
14,28,225,17,18,-1
14,28,226,4,14,-10
14,28,227,13,23,-10
14,28,228,16,10,6
14,28,229,19,8,11
14,28,230,13,9,4
14,28,231,17,11,6
14,28,232,17,13,4
14,28,233,14,9,5
14,28,234,17,11,6
14,28,235,14,10,4
14,28,236,18,6,12
14,28,237,15,12,3
14,28,238,9,10,-1
14,28,239,20,19,1
14,28,240,20,14,6
14,28,241,17,22,-5
14,28,242,14,14,0
14,28,243,11,14,-3
14,28,244,30,22,8
14,28,245,23,19,4
14,28,246,12,18,-6
14,28,247,5,12,-7
14,28,248,21,8,13
14,28,249,19,7,12
14,28,250,12,12,0
14,28,251,20,6,14
14,28,252,14,10,4
14,28,253,7,15,-8
14,28,254,13,11,2
14,28,255,12,5,7
14,28,256,19,19,0
14,28,257,15,12,3
14,28,258,27,13,14
14,28,259,18,7,11
14,28,260,27,11,16
14,28,261,19,20,-1
14,28,262,12,12,0
14,28,263,12,16,-4
14,28,264,18,15,3
14,28,265,20,15,5
14,28,266,18,19,-1
14,28,267,2,6,-4
14,28,268,15,13,2
14,28,269,20,15,5
14,28,270,22,13,9
14,28,271,13,14,-1
14,28,272,15,6,9
14,28,273,26,14,12
14,28,274,14,17,-3
14,28,275,42,12,30
14,28,276,19,15,4
14,28,277,15,2,13
14,28,278,10,7,3
14,28,279,20,14,6
14,28,280,21,9,12
14,28,281,12,6,6
14,28,282,17,16,1
14,28,283,23,11,12
14,28,284,21,12,9
14,28,285,6,11,-5
14,28,286,15,5,10
14,28,287,11,14,-3
14,28,288,8,10,-2
14,28,289,11,11,0
14,28,290,17,5,12
14,28,291,21,14,7
14,28,292,21,16,5
14,28,293,14,14,0
14,28,294,20,14,6
14,28,295,12,11,1
14,28,296,10,3,7
14,28,297,26,25,1
14,28,298,14,16,-2
14,28,299,10,12,-2
14,29,0,14,2,12
14,29,1,24,16,8
14,29,2,26,10,16
14,29,3,18,11,7
14,29,4,26,13,13
14,29,5,19,10,9
14,29,6,11,4,7
14,29,7,27,14,13
14,29,8,11,14,-3
14,29,9,17,13,4
14,29,10,18,9,9
14,29,11,13,4,9
14,29,12,16,5,11
14,29,13,20,10,10
14,29,14,22,4,18
14,29,15,27,8,19
14,29,16,17,13,4
14,29,17,9,8,1
14,29,18,8,14,-6
14,29,19,23,13,10
14,29,20,18,20,-2
14,29,21,18,7,11
14,29,22,8,22,-14
14,29,23,15,14,1
14,29,24,25,11,14
14,29,25,12,10,2
14,29,26,18,11,7
14,29,27,13,16,-3
14,29,28,23,13,10
14,29,29,22,10,12
14,29,30,18,9,9
14,29,31,19,19,0
14,29,32,15,5,10
14,29,33,24,13,11
14,29,34,20,10,10
14,29,35,16,20,-4
14,29,36,7,6,1
14,29,37,25,16,9
14,29,38,18,17,1
14,29,39,20,11,9
14,29,40,15,8,7
14,29,41,8,7,1
14,29,42,10,17,-7
14,29,43,14,9,5
14,29,44,12,6,6
14,29,45,14,7,7
14,29,46,30,8,22
14,29,47,8,16,-8
14,29,48,17,11,6
14,29,49,27,24,3
14,29,50,24,8,16
14,29,51,21,17,4
14,29,52,24,10,14
14,29,53,15,14,1
14,29,54,14,12,2
14,29,55,24,7,17
14,29,56,17,9,8
14,29,57,23,6,17
14,29,58,11,6,5
14,29,59,9,14,-5
14,29,60,16,17,-1
14,29,61,14,7,7
14,29,62,10,5,5
14,29,63,18,8,10
14,29,64,18,7,11
14,29,65,8,11,-3
14,29,66,35,20,15
14,29,67,21,6,15
14,29,68,16,10,6
14,29,69,25,12,13
14,29,70,17,16,1
14,29,71,13,13,0
14,29,72,7,3,4
14,29,73,10,7,3
14,29,74,7,6,1
14,29,75,12,6,6
14,29,76,13,11,2
14,29,77,20,17,3
14,29,78,13,16,-3
14,29,79,36,21,15
14,29,80,27,14,13
14,29,81,23,8,15
14,29,82,28,5,23
14,29,83,37,15,22
14,29,84,21,8,13
14,29,85,10,12,-2
14,29,86,19,7,12
14,29,87,23,13,10
14,29,88,21,8,13
14,29,89,6,6,0
14,29,90,28,13,15
14,29,91,20,8,12
14,29,92,13,1,12
14,29,93,27,13,14
14,29,94,29,10,19
14,29,95,12,9,3
14,29,96,12,10,2
14,29,97,19,13,6
14,29,98,3,15,-12
14,29,99,21,9,12
14,29,100,15,4,11
14,29,101,23,4,19
14,29,102,11,12,-1
14,29,103,9,14,-5
14,29,104,23,12,11
14,29,105,10,10,0
14,29,106,18,15,3
14,29,107,7,5,2
14,29,108,36,10,26
14,29,109,17,10,7
14,29,110,25,15,10
14,29,111,15,11,4
14,29,112,26,12,14
14,29,113,12,7,5
14,29,114,15,17,-2
14,29,115,18,8,10
14,29,116,16,11,5
14,29,117,17,15,2
14,29,118,29,13,16
14,29,119,19,16,3
14,29,120,25,12,13
14,29,121,13,15,-2
14,29,122,11,10,1
14,29,123,23,15,8
14,29,124,8,2,6
14,29,125,9,13,-4
14,29,126,16,13,3
14,29,127,14,15,-1
14,29,128,8,4,4
14,29,129,14,19,-5
14,29,130,20,23,-3
14,29,131,15,11,4
14,29,132,20,20,0
14,29,133,20,18,2
14,29,134,12,7,5
14,29,135,15,9,6
14,29,136,20,11,9
14,29,137,32,12,20
14,29,138,28,13,15
14,29,139,24,21,3
14,29,140,19,20,-1
14,29,141,21,15,6
14,29,142,16,4,12
14,29,143,24,5,19
14,29,144,26,17,9
14,29,145,10,1,9
14,29,146,24,10,14
14,29,147,9,3,6
14,29,148,7,14,-7
14,29,149,15,7,8
14,29,150,16,10,6
14,29,151,31,5,26
14,29,152,15,7,8
14,29,153,10,12,-2
14,29,154,26,13,13
14,29,155,22,5,17
14,29,156,9,14,-5
14,29,157,14,8,6
14,29,158,15,11,4
14,29,159,24,6,18
14,29,160,14,8,6
14,29,161,17,13,4
14,29,162,16,7,9
14,29,163,16,9,7
14,29,164,13,14,-1
14,29,165,21,16,5
14,29,166,14,14,0
14,29,167,12,4,8
14,29,168,24,9,15
14,29,169,26,14,12
14,29,170,16,7,9
14,29,171,10,13,-3
14,29,172,18,7,11
14,29,173,24,14,10
14,29,174,18,7,11
14,29,175,18,5,13
14,29,176,15,13,2
14,29,177,6,7,-1
14,29,178,19,17,2
14,29,179,28,13,15
14,29,180,21,12,9
14,29,181,8,5,3
14,29,182,33,18,15
14,29,183,29,12,17
14,29,184,22,12,10
14,29,185,16,26,-10
14,29,186,16,14,2
14,29,187,17,19,-2
14,29,188,29,17,12
14,29,189,12,12,0
14,29,190,27,12,15
14,29,191,16,17,-1
14,29,192,33,6,27
14,29,193,19,3,16
14,29,194,18,11,7
14,29,195,22,16,6
14,29,196,18,22,-4
14,29,197,14,15,-1
14,29,198,18,12,6
14,29,199,11,13,-2
14,29,200,6,4,2
14,29,201,10,5,5
14,29,202,18,17,1
14,29,203,15,17,-2
14,29,204,8,6,2
14,29,205,11,15,-4
14,29,206,17,8,9
14,29,207,7,10,-3
14,29,208,25,18,7
14,29,209,16,6,10
14,29,210,14,15,-1
14,29,211,21,21,0
14,29,212,21,10,11
14,29,213,20,13,7
14,29,214,23,13,10
14,29,215,12,11,1
14,29,216,17,12,5
14,29,217,22,4,18
14,29,218,8,7,1
14,29,219,8,2,6
14,29,220,15,6,9
14,29,221,17,12,5
14,29,222,19,12,7
14,29,223,15,13,2
14,29,224,23,18,5
14,29,225,25,23,2
14,29,226,15,23,-8
14,29,227,12,10,2
14,29,228,15,13,2
14,29,229,27,13,14
14,29,230,16,3,13
14,29,231,15,4,11
14,29,232,9,1,8
14,29,233,12,9,3
14,29,234,20,13,7
14,29,235,14,15,-1
14,29,236,17,8,9
14,29,237,24,5,19
14,29,238,39,10,29
14,29,239,32,12,20
14,29,240,9,11,-2
14,29,241,20,15,5
14,29,242,14,9,5
14,29,243,16,6,10
14,29,244,11,5,6
14,29,245,20,9,11
14,29,246,28,14,14
14,29,247,17,9,8
14,29,248,19,15,4
14,29,249,14,17,-3
14,29,250,19,10,9
14,29,251,23,20,3
14,29,252,29,12,17
14,29,253,20,17,3
14,29,254,16,9,7
14,29,255,18,11,7
14,29,256,19,6,13
14,29,257,25,14,11
14,29,258,27,12,15
14,29,259,19,6,13
14,29,260,23,20,3
14,29,261,10,5,5
14,29,262,21,18,3
14,29,263,6,13,-7
14,29,264,14,13,1
14,29,265,26,15,11
14,29,266,21,16,5
14,29,267,22,13,9
14,29,268,17,9,8
14,29,269,11,11,0
14,29,270,14,4,10
14,29,271,23,10,13
14,29,272,17,19,-2
14,29,273,13,12,1
14,29,274,16,11,5
14,29,275,13,13,0
14,29,276,12,17,-5
14,29,277,16,12,4
14,29,278,23,13,10
14,29,279,17,17,0
14,29,280,16,12,4
14,29,281,18,11,7
14,29,282,7,3,4
14,29,283,14,9,5
14,29,284,15,12,3
14,29,285,12,3,9
14,29,286,9,6,3
14,29,287,15,7,8
14,29,288,12,3,9
14,29,289,26,15,11
14,29,290,5,4,1
14,29,291,18,14,4
14,29,292,5,9,-4
14,29,293,33,17,16
14,29,294,21,15,6
14,29,295,12,7,5
14,29,296,20,12,8
14,29,297,15,12,3
14,29,298,16,17,-1
14,29,299,21,13,8
14,30,0,12,11,1
14,30,1,18,16,2
14,30,2,31,26,5
14,30,3,23,8,15
14,30,4,12,18,-6
14,30,5,30,24,6
14,30,6,25,22,3
14,30,7,14,7,7
14,30,8,18,5,13
14,30,9,14,12,2
14,30,10,13,6,7
14,30,11,19,9,10
14,30,12,6,13,-7
14,30,13,21,10,11
14,30,14,17,14,3
14,30,15,23,17,6
14,30,16,8,7,1
14,30,17,36,12,24
14,30,18,8,17,-9
14,30,19,18,11,7
14,30,20,14,10,4
14,30,21,20,15,5
14,30,22,22,4,18
14,30,23,11,11,0
14,30,24,25,15,10
14,30,25,15,6,9
14,30,26,17,15,2
14,30,27,16,16,0
14,30,28,16,5,11
14,30,29,16,12,4
14,30,30,12,15,-3
14,30,31,20,9,11
14,30,32,16,17,-1
14,30,33,17,18,-1
14,30,34,17,10,7
14,30,35,16,9,7
14,30,36,11,11,0
14,30,37,26,11,15
14,30,38,14,11,3
14,30,39,9,2,7
14,30,40,25,15,10
14,30,41,18,8,10
14,30,42,19,11,8
14,30,43,13,5,8
14,30,44,11,18,-7
14,30,45,24,18,6
14,30,46,21,10,11
14,30,47,19,4,15
14,30,48,8,3,5
14,30,49,26,17,9
14,30,50,15,19,-4
14,30,51,21,18,3
14,30,52,17,11,6
14,30,53,22,16,6
14,30,54,18,12,6
14,30,55,16,14,2
14,30,56,22,15,7
14,30,57,15,13,2
14,30,58,14,4,10
14,30,59,23,17,6
14,30,60,13,16,-3
14,30,61,9,13,-4
14,30,62,21,10,11
14,30,63,13,18,-5
14,30,64,17,7,10
14,30,65,23,11,12
14,30,66,16,18,-2
14,30,67,19,16,3
14,30,68,28,11,17
14,30,69,12,11,1
14,30,70,22,11,11
14,30,71,30,16,14
14,30,72,12,11,1
14,30,73,21,16,5
14,30,74,12,5,7
14,30,75,12,9,3
14,30,76,15,14,1
14,30,77,16,18,-2
14,30,78,22,14,8
14,30,79,17,8,9
14,30,80,21,13,8
14,30,81,21,6,15
14,30,82,7,11,-4
14,30,83,18,13,5
14,30,84,27,12,15
14,30,85,28,9,19
14,30,86,15,6,9
14,30,87,18,5,13
14,30,88,13,14,-1
14,30,89,17,2,15
14,30,90,15,14,1
14,30,91,22,17,5
14,30,92,5,3,2
14,30,93,12,10,2
14,30,94,9,14,-5
14,30,95,13,4,9
14,30,96,12,7,5
14,30,97,14,10,4
14,30,98,13,13,0
14,30,99,19,12,7
14,30,100,23,10,13
14,30,101,25,13,12
14,30,102,13,12,1
14,30,103,13,12,1
14,30,104,11,7,4
14,30,105,25,28,-3
14,30,106,20,16,4
14,30,107,12,16,-4
14,30,108,20,6,14
14,30,109,23,13,10
14,30,110,12,10,2
14,30,111,15,4,11
14,30,112,16,7,9
14,30,113,14,9,5
14,30,114,14,20,-6
14,30,115,26,11,15
14,30,116,21,13,8
14,30,117,16,16,0
14,30,118,11,6,5
14,30,119,19,10,9
14,30,120,10,7,3
14,30,121,16,12,4
14,30,122,20,13,7
14,30,123,16,11,5
14,30,124,24,13,11
14,30,125,18,8,10
14,30,126,21,12,9
14,30,127,30,13,17
14,30,128,21,10,11
14,30,129,9,11,-2
14,30,130,20,4,16
14,30,131,21,16,5
14,30,132,26,7,19
14,30,133,7,5,2
14,30,134,12,17,-5
14,30,135,10,6,4
14,30,136,12,16,-4
14,30,137,25,14,11
14,30,138,17,7,10
14,30,139,28,11,17
14,30,140,13,5,8
14,30,141,30,22,8
14,30,142,26,15,11
14,30,143,11,13,-2
14,30,144,13,20,-7
14,30,145,21,10,11
14,30,146,21,6,15
14,30,147,25,23,2
14,30,148,16,11,5
14,30,149,25,13,12
14,30,150,8,6,2
14,30,151,14,15,-1
14,30,152,20,5,15
14,30,153,15,5,10
14,30,154,23,13,10
14,30,155,25,17,8
14,30,156,14,12,2
14,30,157,20,18,2
14,30,158,17,14,3
14,30,159,24,9,15
14,30,160,9,8,1
14,30,161,18,12,6
14,30,162,23,16,7
14,30,163,7,4,3
14,30,164,11,9,2
14,30,165,7,9,-2
14,30,166,13,5,8
14,30,167,11,14,-3
14,30,168,23,9,14
14,30,169,20,14,6
14,30,170,29,25,4
14,30,171,15,11,4
14,30,172,22,17,5
14,30,173,16,21,-5
14,30,174,22,25,-3
14,30,175,12,16,-4
14,30,176,21,19,2
14,30,177,13,9,4
14,30,178,19,10,9
14,30,179,23,16,7
14,30,180,15,6,9
14,30,181,34,20,14
14,30,182,20,9,11
14,30,183,20,6,14
14,30,184,15,20,-5
14,30,185,19,4,15
14,30,186,15,11,4
14,30,187,15,10,5
14,30,188,22,14,8
14,30,189,15,2,13
14,30,190,18,6,12
14,30,191,16,5,11
14,30,192,26,2,24
14,30,193,15,8,7
14,30,194,26,12,14
14,30,195,24,15,9
14,30,196,23,13,10
14,30,197,21,13,8
14,30,198,14,3,11
14,30,199,22,14,8
14,30,200,28,10,18
14,30,201,25,5,20
14,30,202,27,10,17
14,30,203,10,6,4
14,30,204,18,16,2
14,30,205,8,8,0
14,30,206,32,14,18
14,30,207,19,9,10
14,30,208,19,19,0
14,30,209,6,7,-1
14,30,210,16,8,8
14,30,211,20,18,2
14,30,212,19,9,10
14,30,213,15,5,10
14,30,214,28,12,16
14,30,215,29,14,15
14,30,216,14,11,3
14,30,217,18,17,1
14,30,218,21,22,-1
14,30,219,37,10,27
14,30,220,18,8,10
14,30,221,14,15,-1
14,30,222,19,12,7
14,30,223,22,11,11
14,30,224,10,7,3
14,30,225,16,14,2
14,30,226,7,3,4
14,30,227,21,11,10
14,30,228,18,10,8
14,30,229,15,10,5
14,30,230,21,11,10
14,30,231,12,7,5
14,30,232,22,4,18
14,30,233,23,11,12
14,30,234,19,13,6
14,30,235,30,10,20
14,30,236,12,8,4
14,30,237,10,3,7
14,30,238,20,12,8
14,30,239,13,6,7
14,30,240,24,12,12
14,30,241,17,10,7
14,30,242,25,14,11
14,30,243,21,13,8
14,30,244,19,14,5
14,30,245,15,8,7
14,30,246,13,3,10
14,30,247,17,12,5
14,30,248,17,16,1
14,30,249,12,20,-8
14,30,250,16,8,8
14,30,251,5,8,-3
14,30,252,13,10,3
14,30,253,14,5,9
14,30,254,9,13,-4
14,30,255,20,11,9
14,30,256,28,15,13
14,30,257,15,15,0
14,30,258,13,14,-1
14,30,259,12,5,7
14,30,260,6,15,-9
14,30,261,12,11,1
14,30,262,13,9,4
14,30,263,22,13,9
14,30,264,5,7,-2
14,30,265,22,18,4
14,30,266,12,6,6
14,30,267,19,11,8
14,30,268,21,19,2
14,30,269,16,3,13
14,30,270,18,18,0
14,30,271,11,13,-2
14,30,272,21,15,6
14,30,273,14,25,-11
14,30,274,12,14,-2
14,30,275,16,7,9
14,30,276,4,4,0
14,30,277,9,11,-2
14,30,278,33,11,22
14,30,279,32,8,24
14,30,280,15,17,-2
14,30,281,32,13,19
14,30,282,16,10,6
14,30,283,19,16,3
14,30,284,24,10,14
14,30,285,15,12,3
14,30,286,19,23,-4
14,30,287,18,12,6
14,30,288,13,12,1
14,30,289,13,15,-2
14,30,290,16,13,3
14,30,291,20,10,10
14,30,292,7,4,3
14,30,293,22,12,10
14,30,294,36,20,16
14,30,295,16,10,6
14,30,296,14,12,2
14,30,297,19,16,3
14,30,298,22,11,11
14,30,299,12,14,-2
15,1,0,3,11,-8
15,1,1,20,16,4
15,1,2,5,13,-8
15,1,3,13,24,-11
15,1,4,9,9,0
15,1,5,7,17,-10
15,1,6,8,17,-9
15,1,7,10,20,-10
15,1,8,14,12,2
15,1,9,8,5,3
15,1,10,7,15,-8
15,1,11,11,17,-6
15,1,12,5,13,-8
15,1,13,9,18,-9
15,1,14,12,28,-16
15,1,15,3,8,-5
15,1,16,16,11,5
15,1,17,7,23,-16
15,1,18,10,15,-5
15,1,19,7,13,-6
15,1,20,10,11,-1
15,1,21,13,14,-1
15,1,22,4,10,-6
15,1,23,13,8,5
15,1,24,5,7,-2
15,1,25,12,29,-17
15,1,26,13,13,0
15,1,27,9,22,-13
15,1,28,15,11,4
15,1,29,4,6,-2
15,1,30,14,18,-4
15,1,31,12,14,-2
15,1,32,8,9,-1
15,1,33,19,26,-7
15,1,34,2,20,-18
15,1,35,9,12,-3
15,1,36,13,23,-10
15,1,37,14,19,-5
15,1,38,16,15,1
15,1,39,3,11,-8
15,1,40,10,17,-7
15,1,41,8,14,-6
15,1,42,14,14,0
15,1,43,15,17,-2
15,1,44,17,22,-5
15,1,45,11,13,-2
15,1,46,23,22,1
15,1,47,10,28,-18
15,1,48,16,17,-1
15,1,49,12,21,-9
15,1,50,9,9,0
15,1,51,8,13,-5
15,1,52,10,18,-8
15,1,53,6,15,-9
15,1,54,17,20,-3
15,1,55,3,9,-6
15,1,56,7,8,-1
15,1,57,11,20,-9
15,1,58,6,10,-4
15,1,59,25,23,2
15,1,60,13,15,-2
15,1,61,11,13,-2
15,1,62,9,12,-3
15,1,63,7,32,-25
15,1,64,7,10,-3
15,1,65,6,20,-14
15,1,66,3,2,1
15,1,67,9,14,-5
15,1,68,9,13,-4
15,1,69,16,21,-5
15,1,70,5,11,-6
15,1,71,5,14,-9
15,1,72,6,9,-3
15,1,73,7,9,-2
15,1,74,8,22,-14
15,1,75,10,8,2
15,1,76,7,12,-5
15,1,77,6,15,-9
15,1,78,5,17,-12
15,1,79,7,16,-9
15,1,80,10,16,-6
15,1,81,4,15,-11
15,1,82,6,7,-1
15,1,83,4,7,-3
15,1,84,9,16,-7
15,1,85,4,9,-5
15,1,86,8,10,-2
15,1,87,11,22,-11
15,1,88,19,16,3
15,1,89,9,15,-6
15,1,90,6,25,-19
15,1,91,7,8,-1
15,1,92,10,9,1
15,1,93,2,8,-6
15,1,94,7,11,-4
15,1,95,7,16,-9
15,1,96,13,14,-1
15,1,97,9,17,-8
15,1,98,9,22,-13
15,1,99,9,25,-16
15,1,100,14,23,-9
15,1,101,6,14,-8
15,1,102,7,14,-7
15,1,103,7,18,-11
15,1,104,1,14,-13
15,1,105,8,14,-6
15,1,106,5,15,-10
15,1,107,21,21,0
15,1,108,13,20,-7
15,1,109,11,18,-7
15,1,110,8,15,-7
15,1,111,6,11,-5
15,1,112,15,17,-2
15,1,113,0,11,-11
15,1,114,9,18,-9
15,1,115,7,18,-11
15,1,116,7,14,-7
15,1,117,7,10,-3
15,1,118,4,7,-3
15,1,119,15,14,1
15,1,120,9,19,-10
15,1,121,11,24,-13
15,1,122,17,11,6
15,1,123,9,6,3
15,1,124,10,25,-15
15,1,125,7,11,-4
15,1,126,8,26,-18
15,1,127,6,11,-5
15,1,128,13,15,-2
15,1,129,9,15,-6
15,1,130,6,16,-10
15,1,131,8,7,1
15,1,132,2,19,-17
15,1,133,8,22,-14
15,1,134,12,14,-2
15,1,135,13,21,-8
15,1,136,7,11,-4
15,1,137,7,29,-22
15,1,138,5,21,-16
15,1,139,8,5,3
15,1,140,5,15,-10
15,1,141,4,4,0
15,1,142,9,10,-1
15,1,143,12,28,-16
15,1,144,4,14,-10
15,1,145,3,6,-3
15,1,146,18,22,-4
15,1,147,12,20,-8
15,1,148,5,9,-4
15,1,149,3,13,-10
15,1,150,20,13,7
15,1,151,4,4,0
15,1,152,7,15,-8
15,1,153,8,17,-9
15,1,154,6,22,-16
15,1,155,9,14,-5
15,1,156,13,19,-6
15,1,157,5,19,-14
15,1,158,10,16,-6
15,1,159,6,14,-8
15,1,160,14,21,-7
15,1,161,8,12,-4
15,1,162,8,18,-10
15,1,163,7,25,-18
15,1,164,4,16,-12
15,1,165,10,19,-9
15,1,166,21,10,11
15,1,167,10,18,-8
15,1,168,9,20,-11
15,1,169,11,28,-17
15,1,170,7,13,-6
15,1,171,13,23,-10
15,1,172,7,16,-9
15,1,173,5,5,0
15,1,174,3,10,-7
15,1,175,4,16,-12
15,1,176,2,12,-10
15,1,177,8,12,-4
15,1,178,12,18,-6
15,1,179,3,5,-2
15,1,180,2,8,-6
15,1,181,5,8,-3
15,1,182,2,11,-9
15,1,183,8,16,-8
15,1,184,7,14,-7
15,1,185,8,1,7
15,1,186,8,9,-1
15,1,187,8,24,-16
15,1,188,7,6,1
15,1,189,10,23,-13
15,1,190,10,12,-2
15,1,191,16,17,-1
15,1,192,4,14,-10
15,1,193,11,19,-8
15,1,194,11,15,-4
15,1,195,6,15,-9
15,1,196,18,15,3
15,1,197,19,16,3
15,1,198,15,14,1
15,1,199,10,22,-12
15,1,200,16,16,0
15,1,201,5,6,-1
15,1,202,16,14,2
15,1,203,6,5,1
15,1,204,7,18,-11
15,1,205,5,11,-6
15,1,206,4,12,-8
15,1,207,15,26,-11
15,1,208,11,10,1
15,1,209,13,15,-2
15,1,210,5,4,1
15,1,211,6,11,-5
15,1,212,8,9,-1
15,1,213,1,13,-12
15,1,214,10,23,-13
15,1,215,3,5,-2
15,1,216,18,26,-8
15,1,217,5,25,-20
15,1,218,5,13,-8
15,1,219,16,20,-4
15,1,220,13,14,-1
15,1,221,5,8,-3
15,1,222,9,12,-3
15,1,223,23,27,-4
15,1,224,6,15,-9
15,1,225,19,20,-1
15,1,226,11,14,-3
15,1,227,9,12,-3
15,1,228,16,23,-7
15,1,229,8,15,-7
15,1,230,26,25,1
15,1,231,4,7,-3
15,1,232,8,12,-4
15,1,233,6,13,-7
15,1,234,6,18,-12
15,1,235,14,17,-3
15,1,236,12,24,-12
15,1,237,12,11,1
15,1,238,9,19,-10
15,1,239,3,15,-12
15,1,240,2,21,-19
15,1,241,12,21,-9
15,1,242,7,10,-3
15,1,243,11,21,-10
15,1,244,15,14,1
15,1,245,8,18,-10
15,1,246,5,19,-14
15,1,247,18,20,-2
15,1,248,8,23,-15
15,1,249,14,26,-12
15,1,250,15,14,1
15,1,251,11,18,-7
15,1,252,12,13,-1
15,1,253,9,22,-13
15,1,254,7,12,-5
15,1,255,8,17,-9
15,1,256,8,16,-8
15,1,257,14,19,-5
15,1,258,7,15,-8
15,1,259,7,20,-13
15,1,260,14,20,-6
15,1,261,12,24,-12
15,1,262,11,19,-8
15,1,263,14,21,-7
15,1,264,15,18,-3
15,1,265,8,13,-5
15,1,266,5,12,-7
15,1,267,16,20,-4
15,1,268,4,19,-15
15,1,269,12,12,0
15,1,270,12,8,4
15,1,271,6,24,-18
15,1,272,11,20,-9
15,1,273,8,10,-2
15,1,274,8,7,1
15,1,275,9,27,-18
15,1,276,9,17,-8
15,1,277,7,22,-15
15,1,278,7,12,-5
15,1,279,7,7,0
15,1,280,11,13,-2
15,1,281,9,12,-3
15,1,282,6,12,-6
15,1,283,10,20,-10
15,1,284,11,21,-10
15,1,285,8,17,-9
15,1,286,12,25,-13
15,1,287,17,14,3
15,1,288,9,15,-6
15,1,289,17,20,-3
15,1,290,7,14,-7
15,1,291,11,19,-8
15,1,292,12,5,7
15,1,293,11,15,-4
15,1,294,8,6,2
15,1,295,9,21,-12
15,1,296,23,23,0
15,1,297,18,15,3
15,1,298,9,7,2
15,1,299,4,8,-4
15,2,0,5,6,-1
15,2,1,2,25,-23
15,2,2,13,18,-5
15,2,3,12,13,-1
15,2,4,8,12,-4
15,2,5,11,15,-4
15,2,6,14,17,-3
15,2,7,14,19,-5
15,2,8,20,29,-9
15,2,9,7,19,-12
15,2,10,14,17,-3
15,2,11,18,22,-4
15,2,12,7,14,-7
15,2,13,16,17,-1
15,2,14,5,16,-11
15,2,15,5,7,-2
15,2,16,5,12,-7
15,2,17,3,21,-18
15,2,18,8,10,-2
15,2,19,15,15,0
15,2,20,5,14,-9
15,2,21,7,17,-10
15,2,22,6,9,-3
15,2,23,9,14,-5
15,2,24,16,18,-2
15,2,25,8,17,-9
15,2,26,12,12,0
15,2,27,7,13,-6
15,2,28,10,13,-3
15,2,29,2,9,-7
15,2,30,17,25,-8
15,2,31,20,24,-4
15,2,32,4,18,-14
15,2,33,15,21,-6
15,2,34,9,17,-8
15,2,35,15,24,-9
15,2,36,7,15,-8
15,2,37,3,10,-7
15,2,38,4,13,-9
15,2,39,9,5,4
15,2,40,8,12,-4
15,2,41,18,10,8
15,2,42,9,17,-8
15,2,43,7,20,-13
15,2,44,11,8,3
15,2,45,8,12,-4
15,2,46,4,19,-15
15,2,47,3,7,-4
15,2,48,8,17,-9
15,2,49,8,5,3
15,2,50,18,16,2
15,2,51,4,11,-7
15,2,52,5,15,-10
15,2,53,13,24,-11
15,2,54,4,7,-3
15,2,55,11,15,-4
15,2,56,10,11,-1
15,2,57,6,9,-3
15,2,58,8,11,-3
15,2,59,7,9,-2
15,2,60,15,28,-13
15,2,61,7,13,-6
15,2,62,17,17,0
15,2,63,15,14,1
15,2,64,9,10,-1
15,2,65,14,17,-3
15,2,66,19,19,0
15,2,67,11,19,-8
15,2,68,8,8,0
15,2,69,3,15,-12
15,2,70,11,16,-5
15,2,71,13,19,-6
15,2,72,9,22,-13
15,2,73,2,15,-13
15,2,74,8,20,-12
15,2,75,6,24,-18
15,2,76,6,15,-9
15,2,77,6,20,-14
15,2,78,5,6,-1
15,2,79,11,14,-3
15,2,80,11,12,-1
15,2,81,12,12,0
15,2,82,10,22,-12
15,2,83,9,29,-20
15,2,84,13,17,-4
15,2,85,6,18,-12
15,2,86,9,15,-6
15,2,87,3,1,2
15,2,88,6,17,-11
15,2,89,5,13,-8
15,2,90,11,8,3
15,2,91,2,14,-12
15,2,92,12,26,-14
15,2,93,14,20,-6
15,2,94,11,17,-6
15,2,95,12,15,-3
15,2,96,9,13,-4
15,2,97,2,8,-6
15,2,98,0,12,-12
15,2,99,13,11,2
15,2,100,4,9,-5
15,2,101,15,22,-7
15,2,102,14,14,0
15,2,103,11,12,-1
15,2,104,2,29,-27
15,2,105,7,5,2
15,2,106,12,20,-8
15,2,107,9,18,-9
15,2,108,4,25,-21
15,2,109,7,18,-11
15,2,110,14,6,8
15,2,111,7,18,-11
15,2,112,16,17,-1
15,2,113,17,16,1
15,2,114,19,23,-4
15,2,115,11,7,4
15,2,116,11,17,-6
15,2,117,8,11,-3
15,2,118,10,33,-23
15,2,119,5,13,-8
15,2,120,3,20,-17
15,2,121,14,15,-1
15,2,122,12,18,-6
15,2,123,5,16,-11
15,2,124,16,13,3
15,2,125,6,12,-6
15,2,126,11,11,0
15,2,127,8,25,-17
15,2,128,23,23,0
15,2,129,6,15,-9
15,2,130,5,16,-11
15,2,131,9,14,-5
15,2,132,9,17,-8
15,2,133,7,7,0
15,2,134,10,27,-17
15,2,135,6,2,4
15,2,136,11,13,-2
15,2,137,8,19,-11
15,2,138,8,18,-10
15,2,139,11,11,0
15,2,140,6,17,-11
15,2,141,15,19,-4
15,2,142,4,19,-15
15,2,143,10,10,0
15,2,144,5,11,-6
15,2,145,16,27,-11
15,2,146,14,10,4
15,2,147,19,29,-10
15,2,148,13,9,4
15,2,149,6,19,-13
15,2,150,6,4,2
15,2,151,15,15,0
15,2,152,8,23,-15
15,2,153,4,15,-11
15,2,154,10,17,-7
15,2,155,8,21,-13
15,2,156,16,31,-15
15,2,157,4,7,-3
15,2,158,9,17,-8
15,2,159,12,26,-14
15,2,160,6,12,-6
15,2,161,7,14,-7
15,2,162,11,26,-15
15,2,163,18,15,3
15,2,164,9,16,-7
15,2,165,10,17,-7
15,2,166,3,26,-23
15,2,167,12,12,0
15,2,168,17,12,5
15,2,169,8,14,-6
15,2,170,7,7,0
15,2,171,6,12,-6
15,2,172,6,10,-4
15,2,173,12,28,-16
15,2,174,9,13,-4
15,2,175,8,24,-16
15,2,176,7,22,-15
15,2,177,21,22,-1
15,2,178,8,6,2
15,2,179,20,28,-8
15,2,180,9,14,-5
15,2,181,7,22,-15
15,2,182,16,41,-25
15,2,183,12,11,1
15,2,184,7,12,-5
15,2,185,10,4,6
15,2,186,16,14,2
15,2,187,10,19,-9
15,2,188,8,8,0
15,2,189,4,13,-9
15,2,190,17,18,-1
15,2,191,8,17,-9
15,2,192,10,38,-28
15,2,193,11,17,-6
15,2,194,12,15,-3
15,2,195,12,15,-3
15,2,196,15,18,-3
15,2,197,11,10,1
15,2,198,10,15,-5
15,2,199,10,25,-15
15,2,200,13,23,-10
15,2,201,12,12,0
15,2,202,4,14,-10
15,2,203,13,7,6
15,2,204,9,8,1
15,2,205,11,20,-9
15,2,206,10,23,-13
15,2,207,6,22,-16
15,2,208,14,20,-6
15,2,209,23,22,1
15,2,210,3,12,-9
15,2,211,16,14,2
15,2,212,10,9,1
15,2,213,10,12,-2
15,2,214,16,13,3
15,2,215,8,12,-4
15,2,216,4,11,-7
15,2,217,11,16,-5
15,2,218,9,14,-5
15,2,219,5,13,-8
15,2,220,12,15,-3
15,2,221,13,17,-4
15,2,222,9,16,-7
15,2,223,6,28,-22
15,2,224,8,20,-12
15,2,225,6,11,-5
15,2,226,10,28,-18
15,2,227,8,11,-3
15,2,228,9,13,-4
15,2,229,11,10,1
15,2,230,23,27,-4
15,2,231,10,15,-5
15,2,232,9,16,-7
15,2,233,7,26,-19
15,2,234,2,20,-18
15,2,235,5,9,-4
15,2,236,14,16,-2
15,2,237,15,14,1
15,2,238,6,11,-5
15,2,239,11,15,-4
15,2,240,8,18,-10
15,2,241,18,8,10
15,2,242,19,24,-5
15,2,243,14,29,-15
15,2,244,12,12,0
15,2,245,15,8,7
15,2,246,9,22,-13
15,2,247,12,12,0
15,2,248,7,10,-3
15,2,249,5,16,-11
15,2,250,3,12,-9
15,2,251,4,20,-16
15,2,252,8,9,-1
15,2,253,7,5,2
15,2,254,10,17,-7
15,2,255,7,37,-30
15,2,256,4,7,-3
15,2,257,15,16,-1
15,2,258,7,22,-15
15,2,259,6,13,-7
15,2,260,9,11,-2
15,2,261,12,26,-14
15,2,262,5,13,-8
15,2,263,7,8,-1
15,2,264,5,4,1
15,2,265,20,22,-2
15,2,266,4,15,-11
15,2,267,6,13,-7
15,2,268,10,25,-15
15,2,269,7,20,-13
15,2,270,8,9,-1
15,2,271,5,27,-22
15,2,272,3,7,-4
15,2,273,6,18,-12
15,2,274,12,16,-4
15,2,275,10,11,-1
15,2,276,6,14,-8
15,2,277,12,23,-11
15,2,278,7,12,-5
15,2,279,15,20,-5
15,2,280,15,28,-13
15,2,281,3,14,-11
15,2,282,5,13,-8
15,2,283,6,15,-9
15,2,284,11,19,-8
15,2,285,5,20,-15
15,2,286,2,11,-9
15,2,287,17,25,-8
15,2,288,14,24,-10
15,2,289,6,19,-13
15,2,290,8,18,-10
15,2,291,15,11,4
15,2,292,4,12,-8
15,2,293,10,13,-3
15,2,294,8,17,-9
15,2,295,8,18,-10
15,2,296,10,15,-5
15,2,297,6,16,-10
15,2,298,3,16,-13
15,2,299,2,14,-12
15,3,0,11,17,-6
15,3,1,13,22,-9
15,3,2,5,21,-16
15,3,3,10,28,-18
15,3,4,7,21,-14
15,3,5,12,15,-3
15,3,6,9,18,-9
15,3,7,21,24,-3
15,3,8,12,20,-8
15,3,9,15,19,-4
15,3,10,12,38,-26
15,3,11,8,20,-12
15,3,12,13,19,-6
15,3,13,5,4,1
15,3,14,15,19,-4
15,3,15,12,22,-10
15,3,16,8,14,-6
15,3,17,2,15,-13
15,3,18,11,16,-5
15,3,19,8,8,0
15,3,20,7,12,-5
15,3,21,14,22,-8
15,3,22,8,23,-15
15,3,23,17,17,0
15,3,24,6,29,-23
15,3,25,8,6,2
15,3,26,7,7,0
15,3,27,17,12,5
15,3,28,3,17,-14
15,3,29,11,25,-14
15,3,30,9,12,-3
15,3,31,16,13,3
15,3,32,12,13,-1
15,3,33,5,15,-10
15,3,34,12,17,-5
15,3,35,3,12,-9
15,3,36,12,11,1
15,3,37,22,16,6
15,3,38,7,19,-12
15,3,39,9,19,-10
15,3,40,5,29,-24
15,3,41,6,17,-11
15,3,42,13,24,-11
15,3,43,14,5,9
15,3,44,12,21,-9
15,3,45,10,18,-8
15,3,46,9,18,-9
15,3,47,9,8,1
15,3,48,13,15,-2
15,3,49,4,18,-14
15,3,50,2,18,-16
15,3,51,19,25,-6
15,3,52,4,7,-3
15,3,53,11,14,-3
15,3,54,6,9,-3
15,3,55,10,9,1
15,3,56,15,25,-10
15,3,57,9,21,-12
15,3,58,6,12,-6
15,3,59,2,19,-17
15,3,60,11,23,-12
15,3,61,3,5,-2
15,3,62,6,16,-10
15,3,63,6,29,-23
15,3,64,13,21,-8
15,3,65,15,15,0
15,3,66,15,17,-2
15,3,67,5,13,-8
15,3,68,10,10,0
15,3,69,18,24,-6
15,3,70,9,28,-19
15,3,71,7,14,-7
15,3,72,16,22,-6
15,3,73,9,21,-12
15,3,74,7,17,-10
15,3,75,11,14,-3
15,3,76,7,7,0
15,3,77,19,26,-7
15,3,78,13,14,-1
15,3,79,5,11,-6
15,3,80,17,25,-8
15,3,81,6,10,-4
15,3,82,7,14,-7
15,3,83,6,22,-16
15,3,84,15,22,-7
15,3,85,13,14,-1
15,3,86,3,18,-15
15,3,87,15,40,-25
15,3,88,13,29,-16
15,3,89,9,24,-15
15,3,90,10,22,-12
15,3,91,20,20,0
15,3,92,12,25,-13
15,3,93,4,19,-15
15,3,94,8,21,-13
15,3,95,4,18,-14
15,3,96,5,2,3
15,3,97,9,9,0
15,3,98,6,15,-9
15,3,99,5,18,-13
15,3,100,16,14,2
15,3,101,10,18,-8
15,3,102,17,20,-3
15,3,103,8,21,-13
15,3,104,7,15,-8
15,3,105,6,26,-20
15,3,106,14,23,-9
15,3,107,12,8,4
15,3,108,9,16,-7
15,3,109,14,18,-4
15,3,110,12,23,-11
15,3,111,15,26,-11
15,3,112,18,14,4
15,3,113,10,14,-4
15,3,114,9,20,-11
15,3,115,11,11,0
15,3,116,6,18,-12
15,3,117,5,9,-4
15,3,118,15,16,-1
15,3,119,8,16,-8
15,3,120,15,12,3
15,3,121,6,33,-27
15,3,122,13,34,-21
15,3,123,6,17,-11
15,3,124,11,19,-8
15,3,125,9,11,-2
15,3,126,13,24,-11
15,3,127,2,9,-7
15,3,128,2,19,-17
15,3,129,13,15,-2
15,3,130,10,13,-3
15,3,131,12,16,-4
15,3,132,13,14,-1
15,3,133,11,22,-11
15,3,134,1,14,-13
15,3,135,11,9,2
15,3,136,1,5,-4
15,3,137,17,12,5
15,3,138,14,17,-3
15,3,139,1,8,-7
15,3,140,10,20,-10
15,3,141,1,12,-11
15,3,142,12,18,-6
15,3,143,8,19,-11
15,3,144,6,12,-6
15,3,145,2,14,-12
15,3,146,4,6,-2
15,3,147,8,12,-4
15,3,148,11,11,0
15,3,149,9,15,-6
15,3,150,6,7,-1
15,3,151,22,17,5
15,3,152,23,31,-8
15,3,153,15,15,0
15,3,154,16,21,-5
15,3,155,7,17,-10
15,3,156,4,5,-1
15,3,157,11,13,-2
15,3,158,14,19,-5
15,3,159,12,19,-7
15,3,160,6,13,-7
15,3,161,12,19,-7
15,3,162,13,27,-14
15,3,163,22,31,-9
15,3,164,12,16,-4
15,3,165,5,15,-10
15,3,166,12,6,6
15,3,167,14,24,-10
15,3,168,7,21,-14
15,3,169,3,7,-4
15,3,170,3,12,-9
15,3,171,15,20,-5
15,3,172,8,13,-5
15,3,173,9,20,-11
15,3,174,5,34,-29
15,3,175,6,19,-13
15,3,176,8,34,-26
15,3,177,11,16,-5
15,3,178,4,7,-3
15,3,179,16,17,-1
15,3,180,14,14,0
15,3,181,10,9,1
15,3,182,16,19,-3
15,3,183,23,33,-10
15,3,184,11,17,-6
15,3,185,17,18,-1
15,3,186,14,18,-4
15,3,187,10,19,-9
15,3,188,19,20,-1
15,3,189,10,13,-3
15,3,190,4,21,-17
15,3,191,6,8,-2
15,3,192,5,16,-11
15,3,193,12,17,-5
15,3,194,10,19,-9
15,3,195,19,24,-5
15,3,196,9,7,2
15,3,197,8,17,-9
15,3,198,14,16,-2
15,3,199,14,32,-18
15,3,200,10,19,-9
15,3,201,12,30,-18
15,3,202,1,3,-2
15,3,203,7,14,-7
15,3,204,10,18,-8
15,3,205,20,23,-3
15,3,206,9,20,-11
15,3,207,13,15,-2
15,3,208,11,27,-16
15,3,209,8,18,-10
15,3,210,6,12,-6
15,3,211,9,9,0
15,3,212,4,15,-11
15,3,213,2,16,-14
15,3,214,1,10,-9
15,3,215,11,21,-10
15,3,216,7,13,-6
15,3,217,24,30,-6
15,3,218,12,13,-1
15,3,219,8,17,-9
15,3,220,13,22,-9
15,3,221,13,31,-18
15,3,222,8,17,-9
15,3,223,10,17,-7
15,3,224,10,24,-14
15,3,225,13,25,-12
15,3,226,14,9,5
15,3,227,12,23,-11
15,3,228,2,9,-7
15,3,229,14,11,3
15,3,230,6,18,-12
15,3,231,12,12,0
15,3,232,8,16,-8
15,3,233,9,17,-8
15,3,234,12,17,-5
15,3,235,6,12,-6
15,3,236,4,12,-8
15,3,237,19,18,1
15,3,238,9,8,1
15,3,239,13,12,1
15,3,240,7,23,-16
15,3,241,11,10,1
15,3,242,9,22,-13
15,3,243,8,12,-4
15,3,244,2,12,-10
15,3,245,19,22,-3
15,3,246,3,12,-9
15,3,247,8,20,-12
15,3,248,9,13,-4
15,3,249,7,11,-4
15,3,250,10,14,-4
15,3,251,11,23,-12
15,3,252,15,12,3
15,3,253,10,33,-23
15,3,254,23,25,-2
15,3,255,10,7,3
15,3,256,12,24,-12
15,3,257,11,16,-5
15,3,258,13,23,-10
15,3,259,6,14,-8
15,3,260,3,12,-9
15,3,261,6,8,-2
15,3,262,0,9,-9
15,3,263,10,16,-6
15,3,264,10,15,-5
15,3,265,6,10,-4
15,3,266,16,19,-3
15,3,267,11,19,-8
15,3,268,12,16,-4
15,3,269,6,8,-2
15,3,270,14,13,1
15,3,271,10,17,-7
15,3,272,11,22,-11
15,3,273,15,25,-10
15,3,274,6,8,-2
15,3,275,12,16,-4
15,3,276,16,11,5
15,3,277,5,15,-10
15,3,278,14,23,-9
15,3,279,6,13,-7
15,3,280,5,16,-11
15,3,281,5,14,-9
15,3,282,9,24,-15
15,3,283,11,32,-21
15,3,284,9,16,-7
15,3,285,15,25,-10
15,3,286,17,23,-6
15,3,287,8,12,-4
15,3,288,2,18,-16
15,3,289,12,16,-4
15,3,290,5,20,-15
15,3,291,7,18,-11
15,3,292,5,7,-2
15,3,293,11,20,-9
15,3,294,10,11,-1
15,3,295,10,25,-15
15,3,296,19,15,4
15,3,297,9,12,-3
15,3,298,11,5,6
15,3,299,18,28,-10
15,4,0,13,26,-13
15,4,1,23,31,-8
15,4,2,4,12,-8
15,4,3,12,18,-6
15,4,4,15,13,2
15,4,5,7,25,-18
15,4,6,6,36,-30
15,4,7,12,33,-21
15,4,8,2,11,-9
15,4,9,17,12,5
15,4,10,11,12,-1
15,4,11,6,20,-14
15,4,12,7,21,-14
15,4,13,12,18,-6
15,4,14,12,31,-19
15,4,15,7,16,-9
15,4,16,5,20,-15
15,4,17,9,9,0
15,4,18,12,12,0
15,4,19,13,21,-8
15,4,20,11,21,-10
15,4,21,5,19,-14
15,4,22,5,7,-2
15,4,23,13,22,-9
15,4,24,14,18,-4
15,4,25,15,13,2
15,4,26,20,22,-2
15,4,27,15,14,1
15,4,28,17,19,-2
15,4,29,16,17,-1
15,4,30,12,19,-7
15,4,31,16,16,0
15,4,32,12,38,-26
15,4,33,5,9,-4
15,4,34,13,23,-10
15,4,35,9,12,-3
15,4,36,12,12,0
15,4,37,4,16,-12
15,4,38,9,21,-12
15,4,39,9,14,-5
15,4,40,7,10,-3
15,4,41,16,35,-19
15,4,42,12,10,2
15,4,43,12,28,-16
15,4,44,17,17,0
15,4,45,12,12,0
15,4,46,14,19,-5
15,4,47,14,17,-3
15,4,48,17,19,-2
15,4,49,7,7,0
15,4,50,15,22,-7
15,4,51,6,15,-9
15,4,52,8,13,-5
15,4,53,16,15,1
15,4,54,5,6,-1
15,4,55,11,24,-13
15,4,56,7,22,-15
15,4,57,18,18,0
15,4,58,18,29,-11
15,4,59,11,17,-6
15,4,60,14,21,-7
15,4,61,19,26,-7
15,4,62,11,11,0
15,4,63,14,17,-3
15,4,64,3,9,-6
15,4,65,10,10,0
15,4,66,8,16,-8
15,4,67,12,29,-17
15,4,68,15,22,-7
15,4,69,11,10,1
15,4,70,16,13,3
15,4,71,26,15,11
15,4,72,9,20,-11
15,4,73,6,16,-10
15,4,74,17,20,-3
15,4,75,5,14,-9
15,4,76,19,11,8
15,4,77,15,13,2
15,4,78,6,4,2
15,4,79,13,10,3
15,4,80,10,22,-12
15,4,81,13,8,5
15,4,82,13,22,-9
15,4,83,5,15,-10
15,4,84,22,21,1
15,4,85,13,13,0
15,4,86,12,18,-6
15,4,87,11,19,-8
15,4,88,4,16,-12
15,4,89,14,18,-4
15,4,90,6,7,-1
15,4,91,9,8,1
15,4,92,19,31,-12
15,4,93,5,10,-5
15,4,94,15,26,-11
15,4,95,21,18,3
15,4,96,6,19,-13
15,4,97,11,10,1
15,4,98,10,35,-25
15,4,99,12,12,0
15,4,100,2,6,-4
15,4,101,9,30,-21
15,4,102,13,22,-9
15,4,103,5,9,-4
15,4,104,7,12,-5
15,4,105,12,16,-4
15,4,106,12,20,-8
15,4,107,13,29,-16
15,4,108,9,12,-3
15,4,109,11,12,-1
15,4,110,12,21,-9
15,4,111,9,14,-5
15,4,112,15,12,3
15,4,113,8,10,-2
15,4,114,4,21,-17
15,4,115,7,22,-15
15,4,116,8,28,-20
15,4,117,9,22,-13
15,4,118,14,16,-2
15,4,119,13,10,3
15,4,120,10,31,-21
15,4,121,3,30,-27
15,4,122,14,14,0
15,4,123,23,26,-3
15,4,124,9,16,-7
15,4,125,17,23,-6
15,4,126,5,13,-8
15,4,127,7,4,3
15,4,128,9,14,-5
15,4,129,4,8,-4
15,4,130,15,19,-4
15,4,131,12,24,-12
15,4,132,19,30,-11
15,4,133,13,24,-11
15,4,134,19,23,-4
15,4,135,16,18,-2
15,4,136,3,31,-28
15,4,137,7,12,-5
15,4,138,12,13,-1
15,4,139,17,14,3
15,4,140,15,22,-7
15,4,141,15,16,-1
15,4,142,5,19,-14
15,4,143,10,8,2
15,4,144,9,25,-16
15,4,145,12,19,-7
15,4,146,14,11,3
15,4,147,15,22,-7
15,4,148,10,10,0
15,4,149,13,11,2
15,4,150,7,9,-2
15,4,151,14,15,-1
15,4,152,6,30,-24
15,4,153,10,15,-5
15,4,154,13,16,-3
15,4,155,2,14,-12
15,4,156,8,11,-3
15,4,157,21,23,-2
15,4,158,11,14,-3
15,4,159,2,7,-5
15,4,160,12,19,-7
15,4,161,7,18,-11
15,4,162,12,22,-10
15,4,163,5,18,-13
15,4,164,15,21,-6
15,4,165,10,8,2
15,4,166,4,11,-7
15,4,167,5,23,-18
15,4,168,13,22,-9
15,4,169,15,19,-4
15,4,170,3,12,-9
15,4,171,14,25,-11
15,4,172,12,30,-18
15,4,173,13,18,-5
15,4,174,3,20,-17
15,4,175,12,18,-6
15,4,176,24,25,-1
15,4,177,8,18,-10
15,4,178,4,25,-21
15,4,179,16,24,-8
15,4,180,5,13,-8
15,4,181,14,17,-3
15,4,182,12,36,-24
15,4,183,10,24,-14
15,4,184,14,18,-4
15,4,185,6,15,-9
15,4,186,15,20,-5
15,4,187,3,17,-14
15,4,188,14,32,-18
15,4,189,10,33,-23
15,4,190,10,28,-18
15,4,191,3,16,-13
15,4,192,22,23,-1
15,4,193,8,13,-5
15,4,194,12,27,-15
15,4,195,11,12,-1
15,4,196,15,13,2
15,4,197,11,10,1
15,4,198,15,29,-14
15,4,199,7,16,-9
15,4,200,12,18,-6
15,4,201,14,27,-13
15,4,202,9,28,-19
15,4,203,9,23,-14
15,4,204,6,12,-6
15,4,205,7,5,2
15,4,206,25,27,-2
15,4,207,9,11,-2
15,4,208,21,12,9
15,4,209,19,31,-12
15,4,210,11,17,-6
15,4,211,12,22,-10
15,4,212,11,16,-5
15,4,213,6,17,-11
15,4,214,13,19,-6
15,4,215,7,17,-10
15,4,216,7,15,-8
15,4,217,24,18,6
15,4,218,12,10,2
15,4,219,8,11,-3
15,4,220,12,25,-13
15,4,221,9,25,-16
15,4,222,5,14,-9
15,4,223,18,20,-2
15,4,224,16,26,-10
15,4,225,11,17,-6
15,4,226,17,18,-1
15,4,227,21,15,6
15,4,228,5,6,-1
15,4,229,12,21,-9
15,4,230,11,16,-5
15,4,231,12,23,-11
15,4,232,13,20,-7
15,4,233,7,19,-12
15,4,234,3,6,-3
15,4,235,9,18,-9
15,4,236,0,11,-11
15,4,237,23,22,1
15,4,238,10,24,-14
15,4,239,16,19,-3
15,4,240,9,23,-14
15,4,241,9,14,-5
15,4,242,10,20,-10
15,4,243,3,11,-8
15,4,244,9,12,-3
15,4,245,10,27,-17
15,4,246,9,13,-4
15,4,247,6,13,-7
15,4,248,5,13,-8
15,4,249,9,40,-31
15,4,250,8,4,4
15,4,251,9,19,-10
15,4,252,17,11,6
15,4,253,4,13,-9
15,4,254,15,27,-12
15,4,255,13,13,0
15,4,256,9,14,-5
15,4,257,12,15,-3
15,4,258,11,12,-1
15,4,259,18,42,-24
15,4,260,7,8,-1
15,4,261,3,10,-7
15,4,262,4,15,-11
15,4,263,11,11,0
15,4,264,8,18,-10
15,4,265,7,12,-5
15,4,266,10,20,-10
15,4,267,26,23,3
15,4,268,13,29,-16
15,4,269,13,8,5
15,4,270,17,20,-3
15,4,271,9,16,-7
15,4,272,12,18,-6
15,4,273,17,16,1
15,4,274,15,28,-13
15,4,275,7,13,-6
15,4,276,7,25,-18
15,4,277,22,21,1
15,4,278,8,13,-5
15,4,279,6,11,-5
15,4,280,10,28,-18
15,4,281,10,9,1
15,4,282,6,20,-14
15,4,283,14,10,4
15,4,284,12,22,-10
15,4,285,11,30,-19
15,4,286,26,27,-1
15,4,287,20,7,13
15,4,288,8,33,-25
15,4,289,11,12,-1
15,4,290,6,16,-10
15,4,291,2,11,-9
15,4,292,23,33,-10
15,4,293,7,21,-14
15,4,294,8,23,-15
15,4,295,20,28,-8
15,4,296,5,17,-12
15,4,297,10,11,-1
15,4,298,11,20,-9
15,4,299,10,28,-18
15,5,0,13,18,-5
15,5,1,9,30,-21
15,5,2,8,16,-8
15,5,3,9,19,-10
15,5,4,16,18,-2
15,5,5,8,8,0
15,5,6,6,7,-1
15,5,7,17,13,4
15,5,8,13,12,1
15,5,9,12,13,-1
15,5,10,10,18,-8
15,5,11,8,20,-12
15,5,12,1,10,-9
15,5,13,11,23,-12
15,5,14,7,8,-1
15,5,15,12,19,-7
15,5,16,11,18,-7
15,5,17,12,14,-2
15,5,18,14,11,3
15,5,19,14,15,-1
15,5,20,15,15,0
15,5,21,12,13,-1
15,5,22,19,12,7
15,5,23,14,13,1
15,5,24,10,16,-6
15,5,25,17,24,-7
15,5,26,11,23,-12
15,5,27,9,14,-5
15,5,28,17,22,-5
15,5,29,19,12,7
15,5,30,12,19,-7
15,5,31,8,33,-25
15,5,32,8,16,-8
15,5,33,14,14,0
15,5,34,10,25,-15
15,5,35,7,17,-10
15,5,36,11,13,-2
15,5,37,12,22,-10
15,5,38,8,18,-10
15,5,39,13,23,-10
15,5,40,15,14,1
15,5,41,12,25,-13
15,5,42,8,23,-15
15,5,43,4,14,-10
15,5,44,11,14,-3
15,5,45,14,17,-3
15,5,46,5,11,-6
15,5,47,6,31,-25
15,5,48,10,12,-2
15,5,49,13,8,5
15,5,50,8,7,1
15,5,51,7,18,-11
15,5,52,7,16,-9
15,5,53,14,25,-11
15,5,54,19,20,-1
15,5,55,19,29,-10
15,5,56,9,14,-5
15,5,57,20,26,-6
15,5,58,14,29,-15
15,5,59,4,20,-16
15,5,60,6,12,-6
15,5,61,15,21,-6
15,5,62,3,7,-4
15,5,63,17,21,-4
15,5,64,7,22,-15
15,5,65,8,12,-4
15,5,66,10,20,-10
15,5,67,12,26,-14
15,5,68,8,21,-13
15,5,69,28,20,8
15,5,70,7,12,-5
15,5,71,17,27,-10
15,5,72,13,23,-10
15,5,73,7,8,-1
15,5,74,8,16,-8
15,5,75,10,18,-8
15,5,76,13,22,-9
15,5,77,23,15,8
15,5,78,10,17,-7
15,5,79,8,31,-23
15,5,80,14,22,-8
15,5,81,8,14,-6
15,5,82,13,14,-1
15,5,83,12,28,-16
15,5,84,17,30,-13
15,5,85,16,15,1
15,5,86,13,14,-1
15,5,87,8,21,-13
15,5,88,16,21,-5
15,5,89,13,24,-11
15,5,90,13,24,-11
15,5,91,14,13,1
15,5,92,7,14,-7
15,5,93,6,19,-13
15,5,94,16,36,-20
15,5,95,8,13,-5
15,5,96,14,15,-1
15,5,97,8,15,-7
15,5,98,20,19,1
15,5,99,13,14,-1
15,5,100,9,13,-4
15,5,101,6,15,-9
15,5,102,11,17,-6
15,5,103,11,29,-18
15,5,104,16,15,1
15,5,105,8,5,3
15,5,106,13,29,-16
15,5,107,14,22,-8
15,5,108,18,17,1
15,5,109,7,17,-10
15,5,110,13,32,-19
15,5,111,9,32,-23
15,5,112,30,14,16
15,5,113,20,22,-2
15,5,114,4,18,-14
15,5,115,10,18,-8
15,5,116,14,36,-22
15,5,117,11,12,-1
15,5,118,4,10,-6
15,5,119,12,17,-5
15,5,120,17,23,-6
15,5,121,10,6,4
15,5,122,11,8,3
15,5,123,12,10,2
15,5,124,6,24,-18
15,5,125,7,13,-6
15,5,126,22,31,-9
15,5,127,12,13,-1
15,5,128,3,9,-6
15,5,129,17,20,-3
15,5,130,13,13,0
15,5,131,20,15,5
15,5,132,14,16,-2
15,5,133,19,13,6
15,5,134,17,25,-8
15,5,135,6,13,-7
15,5,136,20,25,-5
15,5,137,15,13,2
15,5,138,4,23,-19
15,5,139,14,30,-16
15,5,140,13,26,-13
15,5,141,8,17,-9
15,5,142,15,24,-9
15,5,143,11,6,5
15,5,144,7,16,-9
15,5,145,3,16,-13
15,5,146,9,11,-2
15,5,147,14,14,0
15,5,148,3,19,-16
15,5,149,17,14,3
15,5,150,16,15,1
15,5,151,12,17,-5
15,5,152,6,21,-15
15,5,153,13,28,-15
15,5,154,9,16,-7
15,5,155,13,4,9
15,5,156,8,12,-4
15,5,157,21,33,-12
15,5,158,4,15,-11
15,5,159,11,17,-6
15,5,160,6,13,-7
15,5,161,11,17,-6
15,5,162,10,26,-16
15,5,163,24,29,-5
15,5,164,5,14,-9
15,5,165,12,22,-10
15,5,166,15,16,-1
15,5,167,12,30,-18
15,5,168,15,12,3
15,5,169,8,16,-8
15,5,170,10,14,-4
15,5,171,20,23,-3
15,5,172,7,34,-27
15,5,173,9,22,-13
15,5,174,11,22,-11
15,5,175,3,7,-4
15,5,176,10,7,3
15,5,177,15,21,-6
15,5,178,3,14,-11
15,5,179,25,32,-7
15,5,180,16,31,-15
15,5,181,15,16,-1
15,5,182,11,27,-16
15,5,183,9,10,-1
15,5,184,15,12,3
15,5,185,6,13,-7
15,5,186,12,34,-22
15,5,187,9,20,-11
15,5,188,8,22,-14
15,5,189,5,10,-5
15,5,190,4,11,-7
15,5,191,10,23,-13
15,5,192,16,33,-17
15,5,193,9,22,-13
15,5,194,6,9,-3
15,5,195,8,28,-20
15,5,196,13,32,-19
15,5,197,3,10,-7
15,5,198,12,25,-13
15,5,199,6,13,-7
15,5,200,10,19,-9
15,5,201,11,20,-9
15,5,202,10,13,-3
15,5,203,4,18,-14
15,5,204,10,19,-9
15,5,205,7,9,-2
15,5,206,14,15,-1
15,5,207,11,15,-4
15,5,208,9,6,3
15,5,209,9,19,-10
15,5,210,23,15,8
15,5,211,6,24,-18
15,5,212,8,27,-19
15,5,213,17,18,-1
15,5,214,8,17,-9
15,5,215,5,11,-6
15,5,216,7,20,-13
15,5,217,7,16,-9
15,5,218,19,27,-8
15,5,219,17,18,-1
15,5,220,8,18,-10
15,5,221,10,24,-14
15,5,222,12,17,-5
15,5,223,9,21,-12
15,5,224,1,12,-11
15,5,225,10,21,-11
15,5,226,8,17,-9
15,5,227,2,15,-13
15,5,228,5,9,-4
15,5,229,8,18,-10
15,5,230,17,20,-3
15,5,231,23,25,-2
15,5,232,24,23,1
15,5,233,20,33,-13
15,5,234,25,27,-2
15,5,235,12,29,-17
15,5,236,17,23,-6
15,5,237,17,32,-15
15,5,238,14,12,2
15,5,239,31,36,-5
15,5,240,13,15,-2
15,5,241,16,25,-9
15,5,242,7,17,-10
15,5,243,9,7,2
15,5,244,19,25,-6
15,5,245,16,18,-2
15,5,246,11,22,-11
15,5,247,12,25,-13
15,5,248,16,23,-7
15,5,249,9,18,-9
15,5,250,12,16,-4
15,5,251,6,21,-15
15,5,252,15,10,5
15,5,253,15,29,-14
15,5,254,11,11,0
15,5,255,18,18,0
15,5,256,10,27,-17
15,5,257,12,13,-1
15,5,258,20,19,1
15,5,259,9,15,-6
15,5,260,12,18,-6
15,5,261,6,11,-5
15,5,262,7,9,-2
15,5,263,11,4,7
15,5,264,9,11,-2
15,5,265,4,16,-12
15,5,266,14,32,-18
15,5,267,14,43,-29
15,5,268,9,14,-5
15,5,269,13,3,10
15,5,270,17,22,-5
15,5,271,22,29,-7
15,5,272,11,19,-8
15,5,273,18,27,-9
15,5,274,14,22,-8
15,5,275,9,32,-23
15,5,276,8,20,-12
15,5,277,6,12,-6
15,5,278,17,24,-7
15,5,279,6,19,-13
15,5,280,19,11,8
15,5,281,8,16,-8
15,5,282,15,4,11
15,5,283,12,15,-3
15,5,284,7,12,-5
15,5,285,10,15,-5
15,5,286,7,15,-8
15,5,287,17,24,-7
15,5,288,9,16,-7
15,5,289,10,30,-20
15,5,290,13,12,1
15,5,291,16,17,-1
15,5,292,9,5,4
15,5,293,17,17,0
15,5,294,11,26,-15
15,5,295,16,21,-5
15,5,296,12,6,6
15,5,297,5,19,-14
15,5,298,21,18,3
15,5,299,8,29,-21
15,6,0,8,14,-6
15,6,1,24,30,-6
15,6,2,8,28,-20
15,6,3,8,14,-6
15,6,4,13,15,-2
15,6,5,8,15,-7
15,6,6,12,19,-7
15,6,7,15,17,-2
15,6,8,8,9,-1
15,6,9,8,19,-11
15,6,10,19,28,-9
15,6,11,13,16,-3
15,6,12,12,22,-10
15,6,13,10,20,-10
15,6,14,12,27,-15
15,6,15,18,24,-6
15,6,16,8,13,-5
15,6,17,6,8,-2
15,6,18,0,15,-15
15,6,19,5,15,-10
15,6,20,5,16,-11
15,6,21,12,24,-12
15,6,22,10,22,-12
15,6,23,12,26,-14
15,6,24,4,13,-9
15,6,25,13,23,-10
15,6,26,21,33,-12
15,6,27,8,15,-7
15,6,28,8,12,-4
15,6,29,12,17,-5
15,6,30,27,19,8
15,6,31,6,16,-10
15,6,32,25,34,-9
15,6,33,3,11,-8
15,6,34,3,23,-20
15,6,35,17,18,-1
15,6,36,16,23,-7
15,6,37,7,12,-5
15,6,38,8,24,-16
15,6,39,6,11,-5
15,6,40,11,13,-2
15,6,41,11,19,-8
15,6,42,23,22,1
15,6,43,5,21,-16
15,6,44,15,12,3
15,6,45,21,12,9
15,6,46,13,14,-1
15,6,47,10,11,-1
15,6,48,17,24,-7
15,6,49,20,20,0
15,6,50,13,17,-4
15,6,51,11,18,-7
15,6,52,20,18,2
15,6,53,15,17,-2
15,6,54,10,19,-9
15,6,55,3,28,-25
15,6,56,4,15,-11
15,6,57,21,22,-1
15,6,58,8,16,-8
15,6,59,9,28,-19
15,6,60,12,16,-4
15,6,61,8,10,-2
15,6,62,11,8,3
15,6,63,15,24,-9
15,6,64,10,19,-9
15,6,65,10,21,-11
15,6,66,11,10,1
15,6,67,24,29,-5
15,6,68,7,17,-10
15,6,69,16,23,-7
15,6,70,12,20,-8
15,6,71,5,20,-15
15,6,72,5,20,-15
15,6,73,13,24,-11
15,6,74,15,14,1
15,6,75,14,35,-21
15,6,76,5,12,-7
15,6,77,7,15,-8
15,6,78,10,10,0
15,6,79,10,16,-6
15,6,80,12,22,-10
15,6,81,9,18,-9
15,6,82,12,12,0
15,6,83,10,18,-8
15,6,84,6,18,-12
15,6,85,13,20,-7
15,6,86,3,12,-9
15,6,87,7,16,-9
15,6,88,14,19,-5
15,6,89,13,9,4
15,6,90,13,16,-3
15,6,91,2,3,-1
15,6,92,17,18,-1
15,6,93,18,18,0
15,6,94,18,32,-14
15,6,95,13,5,8
15,6,96,15,28,-13
15,6,97,16,16,0
15,6,98,7,11,-4
15,6,99,19,22,-3
15,6,100,13,18,-5
15,6,101,18,20,-2
15,6,102,17,25,-8
15,6,103,17,17,0
15,6,104,10,8,2
15,6,105,8,27,-19
15,6,106,6,24,-18
15,6,107,10,14,-4
15,6,108,13,20,-7
15,6,109,13,8,5
15,6,110,11,9,2
15,6,111,13,22,-9
15,6,112,7,17,-10
15,6,113,11,14,-3
15,6,114,19,31,-12
15,6,115,13,18,-5
15,6,116,11,20,-9
15,6,117,15,16,-1
15,6,118,11,13,-2
15,6,119,13,22,-9
15,6,120,8,18,-10
15,6,121,5,9,-4
15,6,122,10,25,-15
15,6,123,15,12,3
15,6,124,13,15,-2
15,6,125,18,16,2
15,6,126,13,20,-7
15,6,127,18,18,0
15,6,128,13,15,-2
15,6,129,4,18,-14
15,6,130,10,24,-14
15,6,131,11,19,-8
15,6,132,5,25,-20
15,6,133,16,24,-8
15,6,134,9,13,-4
15,6,135,8,15,-7
15,6,136,14,19,-5
15,6,137,19,15,4
15,6,138,13,5,8
15,6,139,6,13,-7
15,6,140,17,13,4
15,6,141,16,26,-10
15,6,142,13,27,-14
15,6,143,10,19,-9
15,6,144,14,21,-7
15,6,145,10,22,-12
15,6,146,7,22,-15
15,6,147,10,11,-1
15,6,148,19,16,3
15,6,149,11,38,-27
15,6,150,13,10,3
15,6,151,9,7,2
15,6,152,13,17,-4
15,6,153,24,20,4
15,6,154,12,9,3
15,6,155,21,27,-6
15,6,156,9,4,5
15,6,157,13,20,-7
15,6,158,30,24,6
15,6,159,15,19,-4
15,6,160,13,14,-1
15,6,161,14,23,-9
15,6,162,11,14,-3
15,6,163,22,23,-1
15,6,164,7,18,-11
15,6,165,14,38,-24
15,6,166,15,26,-11
15,6,167,11,23,-12
15,6,168,12,15,-3
15,6,169,22,15,7
15,6,170,21,19,2
15,6,171,14,33,-19
15,6,172,9,13,-4
15,6,173,14,27,-13
15,6,174,10,16,-6
15,6,175,29,21,8
15,6,176,12,13,-1
15,6,177,20,20,0
15,6,178,16,25,-9
15,6,179,9,19,-10
15,6,180,6,16,-10
15,6,181,11,20,-9
15,6,182,9,22,-13
15,6,183,12,13,-1
15,6,184,9,11,-2
15,6,185,19,14,5
15,6,186,4,19,-15
15,6,187,8,9,-1
15,6,188,6,17,-11
15,6,189,29,35,-6
15,6,190,1,15,-14
15,6,191,18,22,-4
15,6,192,7,17,-10
15,6,193,9,10,-1
15,6,194,8,21,-13
15,6,195,13,10,3
15,6,196,6,0,6
15,6,197,6,16,-10
15,6,198,5,11,-6
15,6,199,16,14,2
15,6,200,2,7,-5
15,6,201,12,12,0
15,6,202,5,12,-7
15,6,203,12,22,-10
15,6,204,14,26,-12
15,6,205,17,13,4
15,6,206,5,19,-14
15,6,207,11,18,-7
15,6,208,12,26,-14
15,6,209,10,24,-14
15,6,210,10,21,-11
15,6,211,11,8,3
15,6,212,9,15,-6
15,6,213,13,12,1
15,6,214,13,20,-7
15,6,215,14,16,-2
15,6,216,10,20,-10
15,6,217,12,3,9
15,6,218,4,16,-12
15,6,219,13,14,-1
15,6,220,10,26,-16
15,6,221,11,14,-3
15,6,222,22,19,3
15,6,223,10,17,-7
15,6,224,9,19,-10
15,6,225,15,19,-4
15,6,226,13,14,-1
15,6,227,12,30,-18
15,6,228,11,30,-19
15,6,229,13,19,-6
15,6,230,19,18,1
15,6,231,7,20,-13
15,6,232,19,12,7
15,6,233,15,11,4
15,6,234,13,19,-6
15,6,235,15,16,-1
15,6,236,16,9,7
15,6,237,15,21,-6
15,6,238,11,13,-2
15,6,239,10,8,2
15,6,240,18,14,4
15,6,241,5,15,-10
15,6,242,12,17,-5
15,6,243,12,28,-16
15,6,244,22,14,8
15,6,245,6,20,-14
15,6,246,9,14,-5
15,6,247,13,15,-2
15,6,248,13,13,0
15,6,249,9,20,-11
15,6,250,14,16,-2
15,6,251,8,14,-6
15,6,252,8,26,-18
15,6,253,10,26,-16
15,6,254,8,17,-9
15,6,255,13,31,-18
15,6,256,8,23,-15
15,6,257,22,20,2
15,6,258,6,17,-11
15,6,259,22,28,-6
15,6,260,9,15,-6
15,6,261,13,17,-4
15,6,262,16,20,-4
15,6,263,8,37,-29
15,6,264,15,11,4
15,6,265,13,4,9
15,6,266,16,12,4
15,6,267,16,35,-19
15,6,268,11,21,-10
15,6,269,4,13,-9
15,6,270,21,24,-3
15,6,271,8,9,-1
15,6,272,12,26,-14
15,6,273,17,31,-14
15,6,274,9,21,-12
15,6,275,20,19,1
15,6,276,7,17,-10
15,6,277,8,17,-9
15,6,278,12,10,2
15,6,279,14,19,-5
15,6,280,7,17,-10
15,6,281,9,21,-12
15,6,282,16,17,-1
15,6,283,15,30,-15
15,6,284,9,11,-2
15,6,285,6,24,-18
15,6,286,24,18,6
15,6,287,27,36,-9
15,6,288,18,18,0
15,6,289,12,17,-5
15,6,290,6,13,-7
15,6,291,5,20,-15
15,6,292,19,22,-3
15,6,293,15,24,-9
15,6,294,9,12,-3
15,6,295,17,9,8
15,6,296,19,26,-7
15,6,297,7,13,-6
15,6,298,11,15,-4
15,6,299,15,22,-7
15,7,0,10,15,-5
15,7,1,8,21,-13
15,7,2,19,18,1
15,7,3,12,23,-11
15,7,4,9,16,-7
15,7,5,12,13,-1
15,7,6,8,16,-8
15,7,7,9,24,-15
15,7,8,12,17,-5
15,7,9,5,29,-24
15,7,10,15,25,-10
15,7,11,15,12,3
15,7,12,11,12,-1
15,7,13,11,29,-18
15,7,14,9,20,-11
15,7,15,18,22,-4
15,7,16,17,22,-5
15,7,17,9,14,-5
15,7,18,19,21,-2
15,7,19,7,6,1
15,7,20,20,37,-17
15,7,21,11,12,-1
15,7,22,15,17,-2
15,7,23,14,25,-11
15,7,24,8,11,-3
15,7,25,13,19,-6
15,7,26,9,14,-5
15,7,27,23,31,-8
15,7,28,23,24,-1
15,7,29,16,23,-7
15,7,30,16,31,-15
15,7,31,14,17,-3
15,7,32,6,15,-9
15,7,33,16,19,-3
15,7,34,5,13,-8
15,7,35,8,10,-2
15,7,36,21,13,8
15,7,37,12,20,-8
15,7,38,17,16,1
15,7,39,3,15,-12
15,7,40,17,17,0
15,7,41,17,25,-8
15,7,42,15,17,-2
15,7,43,6,15,-9
15,7,44,5,3,2
15,7,45,11,23,-12
15,7,46,7,32,-25
15,7,47,12,27,-15
15,7,48,5,17,-12
15,7,49,7,13,-6
15,7,50,5,11,-6
15,7,51,8,11,-3
15,7,52,14,14,0
15,7,53,13,7,6
15,7,54,10,19,-9
15,7,55,21,26,-5
15,7,56,14,15,-1
15,7,57,7,13,-6
15,7,58,15,29,-14
15,7,59,11,3,8
15,7,60,4,11,-7
15,7,61,16,34,-18
15,7,62,23,31,-8
15,7,63,9,12,-3
15,7,64,17,28,-11
15,7,65,9,13,-4
15,7,66,12,14,-2
15,7,67,10,34,-24
15,7,68,2,8,-6
15,7,69,9,8,1
15,7,70,12,10,2
15,7,71,10,16,-6
15,7,72,19,23,-4
15,7,73,21,18,3
15,7,74,16,5,11
15,7,75,8,20,-12
15,7,76,6,16,-10
15,7,77,8,11,-3
15,7,78,16,27,-11
15,7,79,14,25,-11
15,7,80,6,12,-6
15,7,81,14,18,-4
15,7,82,9,25,-16
15,7,83,13,21,-8
15,7,84,21,43,-22
15,7,85,16,17,-1
15,7,86,12,19,-7
15,7,87,23,30,-7
15,7,88,10,12,-2
15,7,89,13,11,2
15,7,90,17,13,4
15,7,91,8,19,-11
15,7,92,14,13,1
15,7,93,17,11,6
15,7,94,7,14,-7
15,7,95,16,29,-13
15,7,96,12,22,-10
15,7,97,12,22,-10
15,7,98,10,19,-9
15,7,99,12,14,-2
15,7,100,21,26,-5
15,7,101,8,20,-12
15,7,102,15,23,-8
15,7,103,6,17,-11
15,7,104,8,14,-6
15,7,105,11,30,-19
15,7,106,18,32,-14
15,7,107,17,12,5
15,7,108,14,22,-8
15,7,109,8,12,-4
15,7,110,7,15,-8
15,7,111,7,5,2
15,7,112,19,28,-9
15,7,113,14,23,-9
15,7,114,23,18,5
15,7,115,8,28,-20
15,7,116,14,11,3
15,7,117,7,4,3
15,7,118,7,15,-8
15,7,119,12,18,-6
15,7,120,10,9,1
15,7,121,6,19,-13
15,7,122,20,18,2
15,7,123,5,16,-11
15,7,124,9,29,-20
15,7,125,15,14,1
15,7,126,1,13,-12
15,7,127,18,26,-8
15,7,128,7,9,-2
15,7,129,6,15,-9
15,7,130,9,24,-15
15,7,131,15,31,-16
15,7,132,15,19,-4
15,7,133,8,16,-8
15,7,134,5,10,-5
15,7,135,6,38,-32
15,7,136,8,14,-6
15,7,137,12,12,0
15,7,138,4,13,-9
15,7,139,17,21,-4
15,7,140,14,12,2
15,7,141,22,41,-19
15,7,142,11,32,-21
15,7,143,7,23,-16
15,7,144,20,24,-4
15,7,145,15,14,1
15,7,146,15,10,5
15,7,147,10,15,-5
15,7,148,7,12,-5
15,7,149,14,25,-11
15,7,150,11,1,10
15,7,151,10,22,-12
15,7,152,21,17,4
15,7,153,8,18,-10
15,7,154,8,20,-12
15,7,155,10,16,-6
15,7,156,12,27,-15
15,7,157,19,26,-7
15,7,158,10,21,-11
15,7,159,9,24,-15
15,7,160,8,26,-18
15,7,161,14,14,0
15,7,162,11,15,-4
15,7,163,18,17,1
15,7,164,4,21,-17
15,7,165,8,23,-15
15,7,166,14,31,-17
15,7,167,6,16,-10
15,7,168,9,31,-22
15,7,169,12,24,-12
15,7,170,13,22,-9
15,7,171,9,21,-12
15,7,172,16,24,-8
15,7,173,11,18,-7
15,7,174,9,27,-18
15,7,175,13,14,-1
15,7,176,11,21,-10
15,7,177,18,16,2
15,7,178,15,11,4
15,7,179,13,12,1
15,7,180,15,15,0
15,7,181,15,17,-2
15,7,182,14,20,-6
15,7,183,6,16,-10
15,7,184,13,15,-2
15,7,185,24,24,0
15,7,186,9,10,-1
15,7,187,13,16,-3
15,7,188,13,18,-5
15,7,189,9,18,-9
15,7,190,11,12,-1
15,7,191,14,16,-2
15,7,192,9,7,2
15,7,193,12,23,-11
15,7,194,15,27,-12
15,7,195,9,11,-2
15,7,196,17,29,-12
15,7,197,12,13,-1
15,7,198,11,17,-6
15,7,199,14,32,-18
15,7,200,17,15,2
15,7,201,7,18,-11
15,7,202,13,18,-5
15,7,203,4,21,-17
15,7,204,8,22,-14
15,7,205,14,19,-5
15,7,206,10,8,2
15,7,207,13,11,2
15,7,208,5,27,-22
15,7,209,18,28,-10
15,7,210,8,20,-12
15,7,211,20,25,-5
15,7,212,12,25,-13
15,7,213,7,15,-8
15,7,214,8,13,-5
15,7,215,17,10,7
15,7,216,18,27,-9
15,7,217,20,24,-4
15,7,218,7,13,-6
15,7,219,25,22,3
15,7,220,18,23,-5
15,7,221,20,18,2
15,7,222,13,28,-15
15,7,223,9,24,-15
15,7,224,24,31,-7
15,7,225,15,15,0
15,7,226,20,15,5
15,7,227,8,15,-7
15,7,228,15,25,-10
15,7,229,15,18,-3
15,7,230,10,31,-21
15,7,231,13,16,-3
15,7,232,10,17,-7
15,7,233,7,17,-10
15,7,234,23,18,5
15,7,235,21,26,-5
15,7,236,7,19,-12
15,7,237,9,13,-4
15,7,238,7,14,-7
15,7,239,5,14,-9
15,7,240,17,27,-10
15,7,241,8,14,-6
15,7,242,21,20,1
15,7,243,21,16,5
15,7,244,6,20,-14
15,7,245,17,26,-9
15,7,246,12,18,-6
15,7,247,14,17,-3
15,7,248,8,24,-16
15,7,249,7,17,-10
15,7,250,21,35,-14
15,7,251,10,21,-11
15,7,252,7,16,-9
15,7,253,3,9,-6
15,7,254,10,25,-15
15,7,255,9,10,-1
15,7,256,28,19,9
15,7,257,19,20,-1
15,7,258,13,29,-16
15,7,259,19,15,4
15,7,260,4,8,-4
15,7,261,25,18,7
15,7,262,13,17,-4
15,7,263,12,16,-4
15,7,264,11,14,-3
15,7,265,14,23,-9
15,7,266,9,12,-3
15,7,267,17,25,-8
15,7,268,12,14,-2
15,7,269,10,13,-3
15,7,270,8,11,-3
15,7,271,13,25,-12
15,7,272,10,10,0
15,7,273,16,30,-14
15,7,274,12,13,-1
15,7,275,14,12,2
15,7,276,11,24,-13
15,7,277,16,15,1
15,7,278,9,17,-8
15,7,279,14,13,1
15,7,280,22,19,3
15,7,281,20,16,4
15,7,282,15,20,-5
15,7,283,11,12,-1
15,7,284,11,8,3
15,7,285,14,11,3
15,7,286,6,7,-1
15,7,287,11,21,-10
15,7,288,11,17,-6
15,7,289,11,26,-15
15,7,290,10,22,-12
15,7,291,10,10,0
15,7,292,7,8,-1
15,7,293,16,18,-2
15,7,294,11,10,1
15,7,295,11,24,-13
15,7,296,8,15,-7
15,7,297,14,14,0
15,7,298,10,26,-16
15,7,299,25,25,0
15,8,0,15,9,6
15,8,1,10,24,-14
15,8,2,12,17,-5
15,8,3,14,19,-5
15,8,4,13,25,-12
15,8,5,9,26,-17
15,8,6,11,22,-11
15,8,7,14,20,-6
15,8,8,26,18,8
15,8,9,9,31,-22
15,8,10,25,10,15
15,8,11,17,16,1
15,8,12,9,11,-2
15,8,13,17,26,-9
15,8,14,14,27,-13
15,8,15,10,22,-12
15,8,16,11,7,4
15,8,17,11,11,0
15,8,18,14,29,-15
15,8,19,25,22,3
15,8,20,20,23,-3
15,8,21,10,11,-1
15,8,22,19,17,2
15,8,23,15,20,-5
15,8,24,5,17,-12
15,8,25,12,9,3
15,8,26,21,25,-4
15,8,27,13,19,-6
15,8,28,5,6,-1
15,8,29,8,12,-4
15,8,30,1,13,-12
15,8,31,13,15,-2
15,8,32,16,11,5
15,8,33,16,18,-2
15,8,34,13,21,-8
15,8,35,12,21,-9
15,8,36,15,12,3
15,8,37,15,16,-1
15,8,38,30,19,11
15,8,39,17,19,-2
15,8,40,5,11,-6
15,8,41,13,6,7
15,8,42,26,46,-20
15,8,43,11,12,-1
15,8,44,23,17,6
15,8,45,13,16,-3
15,8,46,10,6,4
15,8,47,13,17,-4
15,8,48,6,7,-1
15,8,49,7,20,-13
15,8,50,13,17,-4
15,8,51,12,21,-9
15,8,52,5,13,-8
15,8,53,9,18,-9
15,8,54,19,17,2
15,8,55,13,16,-3
15,8,56,9,17,-8
15,8,57,13,16,-3
15,8,58,15,13,2
15,8,59,20,27,-7
15,8,60,9,6,3
15,8,61,7,19,-12
15,8,62,11,10,1
15,8,63,6,10,-4
15,8,64,12,14,-2
15,8,65,19,15,4
15,8,66,19,29,-10
15,8,67,8,26,-18
15,8,68,15,17,-2
15,8,69,19,29,-10
15,8,70,10,16,-6
15,8,71,13,22,-9
15,8,72,15,10,5
15,8,73,3,20,-17
15,8,74,10,18,-8
15,8,75,15,12,3
15,8,76,9,21,-12
15,8,77,19,24,-5
15,8,78,18,22,-4
15,8,79,13,27,-14
15,8,80,18,18,0
15,8,81,24,19,5
15,8,82,13,9,4
15,8,83,11,17,-6
15,8,84,10,14,-4
15,8,85,2,7,-5
15,8,86,10,11,-1
15,8,87,10,16,-6
15,8,88,14,15,-1
15,8,89,11,12,-1
15,8,90,19,21,-2
15,8,91,21,15,6
15,8,92,11,21,-10
15,8,93,12,20,-8
15,8,94,21,21,0
15,8,95,20,17,3
15,8,96,12,22,-10
15,8,97,18,26,-8
15,8,98,15,25,-10
15,8,99,18,18,0
15,8,100,15,27,-12
15,8,101,15,34,-19
15,8,102,15,13,2
15,8,103,24,18,6
15,8,104,13,8,5
15,8,105,5,15,-10
15,8,106,8,9,-1
15,8,107,15,25,-10
15,8,108,12,27,-15
15,8,109,6,21,-15
15,8,110,12,17,-5
15,8,111,15,26,-11
15,8,112,7,22,-15
15,8,113,16,22,-6
15,8,114,15,17,-2
15,8,115,13,15,-2
15,8,116,14,23,-9
15,8,117,7,10,-3
15,8,118,17,20,-3
15,8,119,17,13,4
15,8,120,16,8,8
15,8,121,19,33,-14
15,8,122,13,14,-1
15,8,123,17,18,-1
15,8,124,11,11,0
15,8,125,7,17,-10
15,8,126,5,13,-8
15,8,127,5,23,-18
15,8,128,16,13,3
15,8,129,13,24,-11
15,8,130,26,14,12
15,8,131,9,10,-1
15,8,132,19,12,7
15,8,133,12,31,-19
15,8,134,3,16,-13
15,8,135,9,14,-5
15,8,136,5,7,-2
15,8,137,16,15,1
15,8,138,23,9,14
15,8,139,12,13,-1
15,8,140,13,10,3
15,8,141,11,21,-10
15,8,142,17,15,2
15,8,143,16,29,-13
15,8,144,16,24,-8
15,8,145,8,18,-10
15,8,146,14,22,-8
15,8,147,13,17,-4
15,8,148,13,15,-2
15,8,149,15,9,6
15,8,150,5,16,-11
15,8,151,21,13,8
15,8,152,20,30,-10
15,8,153,10,26,-16
15,8,154,9,9,0
15,8,155,6,9,-3
15,8,156,16,27,-11
15,8,157,15,18,-3
15,8,158,6,8,-2
15,8,159,16,18,-2
15,8,160,17,25,-8
15,8,161,3,13,-10
15,8,162,14,20,-6
15,8,163,13,39,-26
15,8,164,7,13,-6
15,8,165,10,40,-30
15,8,166,12,26,-14
15,8,167,9,15,-6
15,8,168,16,14,2
15,8,169,10,20,-10
15,8,170,9,15,-6
15,8,171,7,35,-28
15,8,172,15,26,-11
15,8,173,23,18,5
15,8,174,11,24,-13
15,8,175,7,15,-8
15,8,176,18,29,-11
15,8,177,3,13,-10
15,8,178,10,21,-11
15,8,179,7,17,-10
15,8,180,7,13,-6
15,8,181,5,9,-4
15,8,182,12,20,-8
15,8,183,16,16,0
15,8,184,25,25,0
15,8,185,9,22,-13
15,8,186,8,14,-6
15,8,187,14,37,-23
15,8,188,15,22,-7
15,8,189,10,15,-5
15,8,190,19,21,-2
15,8,191,10,7,3
15,8,192,17,17,0
15,8,193,12,21,-9
15,8,194,20,21,-1
15,8,195,3,13,-10
15,8,196,13,15,-2
15,8,197,12,23,-11
15,8,198,16,14,2
15,8,199,19,24,-5
15,8,200,14,17,-3
15,8,201,8,6,2
15,8,202,14,16,-2
15,8,203,11,21,-10
15,8,204,16,7,9
15,8,205,9,22,-13
15,8,206,22,10,12
15,8,207,10,18,-8
15,8,208,24,34,-10
15,8,209,20,22,-2
15,8,210,12,20,-8
15,8,211,7,8,-1
15,8,212,15,19,-4
15,8,213,14,20,-6
15,8,214,8,21,-13
15,8,215,10,19,-9
15,8,216,10,6,4
15,8,217,9,18,-9
15,8,218,16,10,6
15,8,219,9,24,-15
15,8,220,14,26,-12
15,8,221,14,24,-10
15,8,222,19,21,-2
15,8,223,22,39,-17
15,8,224,15,15,0
15,8,225,11,14,-3
15,8,226,33,22,11
15,8,227,7,22,-15
15,8,228,12,17,-5
15,8,229,16,24,-8
15,8,230,19,35,-16
15,8,231,7,15,-8
15,8,232,12,20,-8
15,8,233,15,14,1
15,8,234,10,10,0
15,8,235,13,13,0
15,8,236,18,28,-10
15,8,237,8,12,-4
15,8,238,7,15,-8
15,8,239,10,21,-11
15,8,240,11,13,-2
15,8,241,14,14,0
15,8,242,23,27,-4
15,8,243,20,23,-3
15,8,244,19,31,-12
15,8,245,15,24,-9
15,8,246,14,13,1
15,8,247,17,15,2
15,8,248,11,10,1
15,8,249,22,26,-4
15,8,250,11,17,-6
15,8,251,15,10,5
15,8,252,17,30,-13
15,8,253,12,33,-21
15,8,254,10,13,-3
15,8,255,10,13,-3
15,8,256,18,11,7
15,8,257,9,37,-28
15,8,258,15,20,-5
15,8,259,21,30,-9
15,8,260,12,20,-8
15,8,261,8,35,-27
15,8,262,8,12,-4
15,8,263,11,24,-13
15,8,264,15,15,0
15,8,265,9,25,-16
15,8,266,9,18,-9
15,8,267,7,21,-14
15,8,268,16,25,-9
15,8,269,15,15,0
15,8,270,13,26,-13
15,8,271,6,15,-9
15,8,272,13,7,6
15,8,273,18,30,-12
15,8,274,19,26,-7
15,8,275,17,15,2
15,8,276,5,13,-8
15,8,277,6,26,-20
15,8,278,11,19,-8
15,8,279,15,19,-4
15,8,280,14,22,-8
15,8,281,10,13,-3
15,8,282,6,18,-12
15,8,283,16,17,-1
15,8,284,13,34,-21
15,8,285,9,8,1
15,8,286,4,26,-22
15,8,287,12,14,-2
15,8,288,12,24,-12
15,8,289,5,16,-11
15,8,290,8,20,-12
15,8,291,12,15,-3
15,8,292,12,15,-3
15,8,293,16,14,2
15,8,294,20,36,-16
15,8,295,14,17,-3
15,8,296,15,24,-9
15,8,297,9,23,-14
15,8,298,11,11,0
15,8,299,11,10,1
15,9,0,12,20,-8
15,9,1,31,26,5
15,9,2,8,23,-15
15,9,3,4,18,-14
15,9,4,14,23,-9
15,9,5,8,24,-16
15,9,6,16,18,-2
15,9,7,5,9,-4
15,9,8,15,16,-1
15,9,9,11,16,-5
15,9,10,11,7,4
15,9,11,9,13,-4
15,9,12,18,40,-22
15,9,13,15,18,-3
15,9,14,16,30,-14
15,9,15,9,19,-10
15,9,16,14,6,8
15,9,17,22,13,9
15,9,18,20,25,-5
15,9,19,10,14,-4
15,9,20,12,25,-13
15,9,21,17,22,-5
15,9,22,23,29,-6
15,9,23,9,25,-16
15,9,24,4,8,-4
15,9,25,13,30,-17
15,9,26,7,18,-11
15,9,27,11,16,-5
15,9,28,12,13,-1
15,9,29,14,12,2
15,9,30,5,11,-6
15,9,31,15,17,-2
15,9,32,14,22,-8
15,9,33,19,16,3
15,9,34,11,24,-13
15,9,35,18,30,-12
15,9,36,15,10,5
15,9,37,12,15,-3
15,9,38,17,22,-5
15,9,39,12,15,-3
15,9,40,20,20,0
15,9,41,22,16,6
15,9,42,11,10,1
15,9,43,22,19,3
15,9,44,10,17,-7
15,9,45,11,13,-2
15,9,46,11,16,-5
15,9,47,17,26,-9
15,9,48,11,23,-12
15,9,49,13,27,-14
15,9,50,12,11,1
15,9,51,12,28,-16
15,9,52,19,25,-6
15,9,53,5,10,-5
15,9,54,13,20,-7
15,9,55,20,15,5
15,9,56,11,19,-8
15,9,57,16,24,-8
15,9,58,7,18,-11
15,9,59,11,11,0
15,9,60,24,28,-4
15,9,61,15,14,1
15,9,62,13,16,-3
15,9,63,3,13,-10
15,9,64,9,22,-13
15,9,65,4,8,-4
15,9,66,11,21,-10
15,9,67,21,20,1
15,9,68,12,11,1
15,9,69,7,22,-15
15,9,70,9,23,-14
15,9,71,21,21,0
15,9,72,12,18,-6
15,9,73,27,35,-8
15,9,74,24,25,-1
15,9,75,6,7,-1
15,9,76,11,12,-1
15,9,77,23,20,3
15,9,78,24,20,4
15,9,79,21,28,-7
15,9,80,15,28,-13
15,9,81,11,7,4
15,9,82,20,28,-8
15,9,83,21,23,-2
15,9,84,11,17,-6
15,9,85,8,19,-11
15,9,86,30,29,1
15,9,87,13,29,-16
15,9,88,8,13,-5
15,9,89,14,28,-14
15,9,90,12,14,-2
15,9,91,9,22,-13
15,9,92,9,24,-15
15,9,93,23,21,2
15,9,94,23,10,13
15,9,95,8,16,-8
15,9,96,8,17,-9
15,9,97,17,24,-7
15,9,98,19,15,4
15,9,99,14,13,1
15,9,100,15,30,-15
15,9,101,19,18,1
15,9,102,11,15,-4
15,9,103,22,28,-6
15,9,104,16,33,-17
15,9,105,23,11,12
15,9,106,11,7,4
15,9,107,18,25,-7
15,9,108,16,30,-14
15,9,109,12,22,-10
15,9,110,10,21,-11
15,9,111,11,11,0
15,9,112,24,14,10
15,9,113,9,18,-9
15,9,114,17,16,1
15,9,115,15,14,1
15,9,116,18,23,-5
15,9,117,22,19,3
15,9,118,27,22,5
15,9,119,18,32,-14
15,9,120,12,9,3
15,9,121,10,8,2
15,9,122,17,23,-6
15,9,123,10,18,-8
15,9,124,8,5,3
15,9,125,6,14,-8
15,9,126,14,9,5
15,9,127,24,20,4
15,9,128,20,18,2
15,9,129,22,34,-12
15,9,130,9,17,-8
15,9,131,13,21,-8
15,9,132,9,15,-6
15,9,133,9,19,-10
15,9,134,17,20,-3
15,9,135,17,25,-8
15,9,136,11,18,-7
15,9,137,8,26,-18
15,9,138,23,29,-6
15,9,139,9,6,3
15,9,140,8,16,-8
15,9,141,11,10,1
15,9,142,8,14,-6
15,9,143,9,13,-4
15,9,144,7,18,-11
15,9,145,17,16,1
15,9,146,9,17,-8
15,9,147,17,21,-4
15,9,148,22,27,-5
15,9,149,16,11,5
15,9,150,8,17,-9
15,9,151,11,18,-7
15,9,152,7,26,-19
15,9,153,14,12,2
15,9,154,10,19,-9
15,9,155,11,6,5
15,9,156,14,34,-20
15,9,157,22,9,13
15,9,158,20,22,-2
15,9,159,8,13,-5
15,9,160,15,11,4
15,9,161,12,16,-4
15,9,162,13,16,-3
15,9,163,18,22,-4
15,9,164,15,27,-12
15,9,165,11,34,-23
15,9,166,10,18,-8
15,9,167,8,18,-10
15,9,168,22,30,-8
15,9,169,14,24,-10
15,9,170,14,18,-4
15,9,171,22,23,-1
15,9,172,25,22,3
15,9,173,16,8,8
15,9,174,14,26,-12
15,9,175,20,24,-4
15,9,176,6,10,-4
15,9,177,15,19,-4
15,9,178,30,21,9
15,9,179,9,14,-5
15,9,180,7,13,-6
15,9,181,8,16,-8
15,9,182,12,11,1
15,9,183,16,19,-3
15,9,184,13,18,-5
15,9,185,10,11,-1
15,9,186,13,9,4
15,9,187,10,16,-6
15,9,188,8,17,-9
15,9,189,10,21,-11
15,9,190,4,17,-13
15,9,191,14,11,3
15,9,192,10,18,-8
15,9,193,16,10,6
15,9,194,10,28,-18
15,9,195,20,24,-4
15,9,196,7,18,-11
15,9,197,13,20,-7
15,9,198,10,14,-4
15,9,199,13,13,0
15,9,200,20,20,0
15,9,201,13,31,-18
15,9,202,13,15,-2
15,9,203,11,22,-11
15,9,204,17,19,-2
15,9,205,25,36,-11
15,9,206,6,17,-11
15,9,207,8,14,-6
15,9,208,13,20,-7
15,9,209,11,27,-16
15,9,210,7,17,-10
15,9,211,14,19,-5
15,9,212,11,23,-12
15,9,213,11,19,-8
15,9,214,7,19,-12
15,9,215,5,11,-6
15,9,216,4,11,-7
15,9,217,19,23,-4
15,9,218,5,26,-21
15,9,219,8,14,-6
15,9,220,23,23,0
15,9,221,20,28,-8
15,9,222,8,18,-10
15,9,223,14,27,-13
15,9,224,11,8,3
15,9,225,7,9,-2
15,9,226,9,15,-6
15,9,227,7,19,-12
15,9,228,13,10,3
15,9,229,11,20,-9
15,9,230,7,9,-2
15,9,231,22,37,-15
15,9,232,15,16,-1
15,9,233,9,26,-17
15,9,234,15,21,-6
15,9,235,13,6,7
15,9,236,18,42,-24
15,9,237,11,15,-4
15,9,238,10,18,-8
15,9,239,12,11,1
15,9,240,11,10,1
15,9,241,9,12,-3
15,9,242,7,19,-12
15,9,243,19,13,6
15,9,244,9,17,-8
15,9,245,20,11,9
15,9,246,22,25,-3
15,9,247,12,18,-6
15,9,248,18,31,-13
15,9,249,13,11,2
15,9,250,11,23,-12
15,9,251,17,15,2
15,9,252,3,15,-12
15,9,253,18,23,-5
15,9,254,11,5,6
15,9,255,14,14,0
15,9,256,10,14,-4
15,9,257,26,19,7
15,9,258,10,15,-5
15,9,259,16,20,-4
15,9,260,12,24,-12
15,9,261,18,29,-11
15,9,262,6,13,-7
15,9,263,21,16,5
15,9,264,13,23,-10
15,9,265,12,15,-3
15,9,266,13,13,0
15,9,267,6,15,-9
15,9,268,10,16,-6
15,9,269,3,16,-13
15,9,270,10,13,-3
15,9,271,20,32,-12
15,9,272,9,19,-10
15,9,273,9,19,-10
15,9,274,5,13,-8
15,9,275,12,31,-19
15,9,276,10,31,-21
15,9,277,15,24,-9
15,9,278,22,24,-2
15,9,279,20,17,3
15,9,280,12,19,-7
15,9,281,15,19,-4
15,9,282,23,14,9
15,9,283,11,23,-12
15,9,284,19,18,1
15,9,285,11,26,-15
15,9,286,12,10,2
15,9,287,4,10,-6
15,9,288,16,23,-7
15,9,289,14,13,1
15,9,290,21,16,5
15,9,291,6,15,-9
15,9,292,20,14,6
15,9,293,12,13,-1
15,9,294,7,23,-16
15,9,295,11,24,-13
15,9,296,6,17,-11
15,9,297,15,27,-12
15,9,298,20,25,-5
15,9,299,13,24,-11
15,10,0,6,17,-11
15,10,1,9,16,-7
15,10,2,12,28,-16
15,10,3,21,19,2
15,10,4,16,16,0
15,10,5,16,11,5
15,10,6,10,12,-2
15,10,7,11,19,-8
15,10,8,4,9,-5
15,10,9,16,15,1
15,10,10,13,16,-3
15,10,11,9,13,-4
15,10,12,15,22,-7
15,10,13,12,14,-2
15,10,14,21,34,-13
15,10,15,21,22,-1
15,10,16,18,20,-2
15,10,17,12,18,-6
15,10,18,21,21,0
15,10,19,18,18,0
15,10,20,8,24,-16
15,10,21,16,21,-5
15,10,22,14,18,-4
15,10,23,10,31,-21
15,10,24,12,21,-9
15,10,25,15,17,-2
15,10,26,15,25,-10
15,10,27,17,15,2
15,10,28,5,11,-6
15,10,29,16,26,-10
15,10,30,18,24,-6
15,10,31,11,21,-10
15,10,32,25,24,1
15,10,33,11,16,-5
15,10,34,16,16,0
15,10,35,21,9,12
15,10,36,15,9,6
15,10,37,8,25,-17
15,10,38,16,25,-9
15,10,39,9,13,-4
15,10,40,11,10,1
15,10,41,12,17,-5
15,10,42,10,17,-7
15,10,43,9,8,1
15,10,44,5,10,-5
15,10,45,13,4,9
15,10,46,19,12,7
15,10,47,7,17,-10
15,10,48,13,14,-1
15,10,49,20,20,0
15,10,50,25,19,6
15,10,51,17,26,-9
15,10,52,10,18,-8
15,10,53,4,21,-17
15,10,54,17,5,12
15,10,55,14,38,-24
15,10,56,11,25,-14
15,10,57,10,18,-8
15,10,58,15,16,-1
15,10,59,17,18,-1
15,10,60,4,13,-9
15,10,61,12,12,0
15,10,62,17,20,-3
15,10,63,8,7,1
15,10,64,5,8,-3
15,10,65,19,9,10
15,10,66,15,21,-6
15,10,67,6,14,-8
15,10,68,22,17,5
15,10,69,8,14,-6
15,10,70,5,7,-2
15,10,71,11,12,-1
15,10,72,13,19,-6
15,10,73,5,12,-7
15,10,74,27,22,5
15,10,75,7,13,-6
15,10,76,23,12,11
15,10,77,17,12,5
15,10,78,14,12,2
15,10,79,12,6,6
15,10,80,8,13,-5
15,10,81,18,17,1
15,10,82,25,25,0
15,10,83,23,23,0
15,10,84,11,10,1
15,10,85,12,22,-10
15,10,86,21,13,8
15,10,87,10,24,-14
15,10,88,17,13,4
15,10,89,11,13,-2
15,10,90,15,17,-2
15,10,91,6,16,-10
15,10,92,15,17,-2
15,10,93,9,16,-7
15,10,94,4,22,-18
15,10,95,15,8,7
15,10,96,9,12,-3
15,10,97,16,32,-16
15,10,98,8,12,-4
15,10,99,15,6,9
15,10,100,14,25,-11
15,10,101,8,31,-23
15,10,102,7,17,-10
15,10,103,12,25,-13
15,10,104,22,41,-19
15,10,105,6,18,-12
15,10,106,8,26,-18
15,10,107,17,14,3
15,10,108,15,5,10
15,10,109,14,21,-7
15,10,110,6,12,-6
15,10,111,10,23,-13
15,10,112,13,27,-14
15,10,113,9,11,-2
15,10,114,15,10,5
15,10,115,11,18,-7
15,10,116,10,16,-6
15,10,117,5,17,-12
15,10,118,8,16,-8
15,10,119,11,18,-7
15,10,120,15,17,-2
15,10,121,4,18,-14
15,10,122,10,21,-11
15,10,123,10,19,-9
15,10,124,20,27,-7
15,10,125,13,19,-6
15,10,126,13,26,-13
15,10,127,12,17,-5
15,10,128,10,11,-1
15,10,129,17,13,4
15,10,130,9,19,-10
15,10,131,5,7,-2
15,10,132,13,8,5
15,10,133,9,18,-9
15,10,134,22,28,-6
15,10,135,17,8,9
15,10,136,14,22,-8
15,10,137,16,27,-11
15,10,138,14,10,4
15,10,139,20,19,1
15,10,140,12,12,0
15,10,141,11,32,-21
15,10,142,15,11,4
15,10,143,14,23,-9
15,10,144,11,11,0
15,10,145,5,14,-9
15,10,146,20,18,2
15,10,147,11,26,-15
15,10,148,25,8,17
15,10,149,9,20,-11
15,10,150,32,32,0
15,10,151,11,23,-12
15,10,152,15,25,-10
15,10,153,16,15,1
15,10,154,15,16,-1
15,10,155,17,18,-1
15,10,156,4,22,-18
15,10,157,18,23,-5
15,10,158,9,18,-9
15,10,159,8,8,0
15,10,160,3,9,-6
15,10,161,8,15,-7
15,10,162,13,11,2
15,10,163,18,32,-14
15,10,164,17,20,-3
15,10,165,11,19,-8
15,10,166,9,21,-12
15,10,167,15,11,4
15,10,168,9,37,-28
15,10,169,11,22,-11
15,10,170,20,15,5
15,10,171,13,11,2
15,10,172,16,19,-3
15,10,173,9,35,-26
15,10,174,14,22,-8
15,10,175,7,31,-24
15,10,176,14,10,4
15,10,177,10,23,-13
15,10,178,11,1,10
15,10,179,12,18,-6
15,10,180,2,9,-7
15,10,181,16,10,6
15,10,182,18,18,0
15,10,183,6,5,1
15,10,184,12,10,2
15,10,185,13,14,-1
15,10,186,26,20,6
15,10,187,20,16,4
15,10,188,4,22,-18
15,10,189,23,31,-8
15,10,190,18,15,3
15,10,191,9,9,0
15,10,192,19,20,-1
15,10,193,17,25,-8
15,10,194,20,35,-15
15,10,195,16,24,-8
15,10,196,14,9,5
15,10,197,10,13,-3
15,10,198,10,10,0
15,10,199,10,25,-15
15,10,200,25,13,12
15,10,201,15,29,-14
15,10,202,26,19,7
15,10,203,11,23,-12
15,10,204,11,14,-3
15,10,205,16,17,-1
15,10,206,14,20,-6
15,10,207,21,25,-4
15,10,208,10,19,-9
15,10,209,26,33,-7
15,10,210,5,19,-14
15,10,211,17,20,-3
15,10,212,11,16,-5
15,10,213,6,19,-13
15,10,214,20,24,-4
15,10,215,3,9,-6
15,10,216,17,30,-13
15,10,217,17,25,-8
15,10,218,21,21,0
15,10,219,18,22,-4
15,10,220,15,13,2
15,10,221,22,18,4
15,10,222,13,14,-1
15,10,223,17,19,-2
15,10,224,28,17,11
15,10,225,15,30,-15
15,10,226,22,26,-4
15,10,227,14,16,-2
15,10,228,13,30,-17
15,10,229,8,3,5
15,10,230,11,19,-8
15,10,231,10,9,1
15,10,232,13,23,-10
15,10,233,6,23,-17
15,10,234,10,24,-14
15,10,235,13,17,-4
15,10,236,14,23,-9
15,10,237,12,18,-6
15,10,238,9,14,-5
15,10,239,13,26,-13
15,10,240,10,23,-13
15,10,241,13,22,-9
15,10,242,19,20,-1
15,10,243,6,16,-10
15,10,244,6,6,0
15,10,245,19,18,1
15,10,246,14,14,0
15,10,247,10,14,-4
15,10,248,16,36,-20
15,10,249,12,16,-4
15,10,250,13,20,-7
15,10,251,6,15,-9
15,10,252,19,25,-6
15,10,253,25,17,8
15,10,254,10,19,-9
15,10,255,13,26,-13
15,10,256,12,17,-5
15,10,257,13,26,-13
15,10,258,13,17,-4
15,10,259,16,21,-5
15,10,260,7,26,-19
15,10,261,14,12,2
15,10,262,13,20,-7
15,10,263,10,16,-6
15,10,264,19,17,2
15,10,265,10,18,-8
15,10,266,7,15,-8
15,10,267,6,16,-10
15,10,268,18,19,-1
15,10,269,12,14,-2
15,10,270,16,28,-12
15,10,271,15,19,-4
15,10,272,16,36,-20
15,10,273,7,11,-4
15,10,274,11,16,-5
15,10,275,19,14,5
15,10,276,8,27,-19
15,10,277,20,22,-2
15,10,278,8,21,-13
15,10,279,21,20,1
15,10,280,18,14,4
15,10,281,30,13,17
15,10,282,7,12,-5
15,10,283,10,10,0
15,10,284,10,7,3
15,10,285,13,26,-13
15,10,286,16,27,-11
15,10,287,25,22,3
15,10,288,15,21,-6
15,10,289,18,23,-5
15,10,290,17,16,1
15,10,291,11,13,-2
15,10,292,6,19,-13
15,10,293,22,12,10
15,10,294,8,29,-21
15,10,295,19,31,-12
15,10,296,7,27,-20
15,10,297,10,23,-13
15,10,298,21,20,1
15,10,299,17,30,-13
15,11,0,23,22,1
15,11,1,11,22,-11
15,11,2,12,18,-6
15,11,3,11,15,-4
15,11,4,15,22,-7
15,11,5,17,17,0
15,11,6,7,22,-15
15,11,7,14,26,-12
15,11,8,14,26,-12
15,11,9,25,13,12
15,11,10,26,20,6
15,11,11,19,31,-12
15,11,12,13,8,5
15,11,13,11,13,-2
15,11,14,15,3,12
15,11,15,15,24,-9
15,11,16,12,20,-8
15,11,17,18,16,2
15,11,18,22,21,1
15,11,19,5,9,-4
15,11,20,8,14,-6
15,11,21,13,8,5
15,11,22,6,25,-19
15,11,23,6,7,-1
15,11,24,2,20,-18
15,11,25,7,19,-12
15,11,26,3,15,-12
15,11,27,20,18,2
15,11,28,13,12,1
15,11,29,16,18,-2
15,11,30,9,21,-12
15,11,31,12,22,-10
15,11,32,6,21,-15
15,11,33,12,21,-9
15,11,34,15,19,-4
15,11,35,14,22,-8
15,11,36,15,19,-4
15,11,37,20,19,1
15,11,38,19,24,-5
15,11,39,12,16,-4
15,11,40,14,18,-4
15,11,41,17,10,7
15,11,42,15,15,0
15,11,43,17,18,-1
15,11,44,7,12,-5
15,11,45,23,27,-4
15,11,46,12,12,0
15,11,47,16,15,1
15,11,48,19,15,4
15,11,49,7,13,-6
15,11,50,8,13,-5
15,11,51,23,22,1
15,11,52,21,21,0
15,11,53,16,23,-7
15,11,54,9,24,-15
15,11,55,5,8,-3
15,11,56,9,12,-3
15,11,57,17,11,6
15,11,58,14,30,-16
15,11,59,8,10,-2
15,11,60,11,20,-9
15,11,61,11,15,-4
15,11,62,13,22,-9
15,11,63,2,18,-16
15,11,64,11,19,-8
15,11,65,7,13,-6
15,11,66,27,27,0
15,11,67,22,21,1
15,11,68,23,13,10
15,11,69,14,19,-5
15,11,70,20,19,1
15,11,71,13,16,-3
15,11,72,6,10,-4
15,11,73,28,36,-8
15,11,74,16,14,2
15,11,75,16,32,-16
15,11,76,9,16,-7
15,11,77,17,15,2
15,11,78,13,14,-1
15,11,79,11,11,0
15,11,80,18,15,3
15,11,81,20,24,-4
15,11,82,14,17,-3
15,11,83,7,11,-4
15,11,84,19,8,11
15,11,85,8,14,-6
15,11,86,8,15,-7
15,11,87,4,16,-12
15,11,88,11,22,-11
15,11,89,13,21,-8
15,11,90,17,14,3
15,11,91,10,13,-3
15,11,92,20,12,8
15,11,93,7,15,-8
15,11,94,23,12,11
15,11,95,20,33,-13
15,11,96,15,10,5
15,11,97,19,20,-1
15,11,98,10,17,-7
15,11,99,14,21,-7
15,11,100,21,15,6
15,11,101,13,18,-5
15,11,102,12,24,-12
15,11,103,11,13,-2
15,11,104,8,13,-5
15,11,105,9,15,-6
15,11,106,11,15,-4
15,11,107,9,10,-1
15,11,108,9,13,-4
15,11,109,11,12,-1
15,11,110,10,16,-6
15,11,111,13,18,-5
15,11,112,12,9,3
15,11,113,12,20,-8
15,11,114,12,23,-11
15,11,115,10,16,-6
15,11,116,9,11,-2
15,11,117,15,15,0
15,11,118,28,17,11
15,11,119,15,14,1
15,11,120,12,21,-9
15,11,121,11,14,-3
15,11,122,21,21,0
15,11,123,14,14,0
15,11,124,14,18,-4
15,11,125,23,19,4
15,11,126,7,18,-11
15,11,127,30,21,9
15,11,128,12,7,5
15,11,129,7,9,-2
15,11,130,11,7,4
15,11,131,11,10,1
15,11,132,6,28,-22
15,11,133,17,16,1
15,11,134,10,14,-4
15,11,135,16,17,-1
15,11,136,8,23,-15
15,11,137,17,12,5
15,11,138,7,14,-7
15,11,139,13,21,-8
15,11,140,13,10,3
15,11,141,8,11,-3
15,11,142,16,23,-7
15,11,143,11,27,-16
15,11,144,19,20,-1
15,11,145,11,13,-2
15,11,146,12,17,-5
15,11,147,9,12,-3
15,11,148,20,20,0
15,11,149,7,18,-11
15,11,150,16,16,0
15,11,151,12,22,-10
15,11,152,16,18,-2
15,11,153,22,23,-1
15,11,154,22,14,8
15,11,155,5,12,-7
15,11,156,12,16,-4
15,11,157,12,25,-13
15,11,158,20,24,-4
15,11,159,8,16,-8
15,11,160,5,5,0
15,11,161,6,17,-11
15,11,162,21,24,-3
15,11,163,20,21,-1
15,11,164,31,18,13
15,11,165,6,17,-11
15,11,166,10,14,-4
15,11,167,22,16,6
15,11,168,22,8,14
15,11,169,10,14,-4
15,11,170,19,9,10
15,11,171,15,17,-2
15,11,172,19,28,-9
15,11,173,17,19,-2
15,11,174,17,20,-3
15,11,175,16,28,-12
15,11,176,14,5,9
15,11,177,9,21,-12
15,11,178,14,22,-8
15,11,179,9,13,-4
15,11,180,10,8,2
15,11,181,7,14,-7
15,11,182,15,28,-13
15,11,183,16,12,4
15,11,184,18,21,-3
15,11,185,13,17,-4
15,11,186,13,24,-11
15,11,187,11,20,-9
15,11,188,12,26,-14
15,11,189,13,24,-11
15,11,190,16,17,-1
15,11,191,17,30,-13
15,11,192,8,12,-4
15,11,193,8,6,2
15,11,194,16,20,-4
15,11,195,17,13,4
15,11,196,13,12,1
15,11,197,16,26,-10
15,11,198,8,17,-9
15,11,199,12,17,-5
15,11,200,16,18,-2
15,11,201,8,12,-4
15,11,202,10,17,-7
15,11,203,18,16,2
15,11,204,10,13,-3
15,11,205,14,15,-1
15,11,206,18,17,1
15,11,207,15,23,-8
15,11,208,20,14,6
15,11,209,19,24,-5
15,11,210,39,23,16
15,11,211,15,11,4
15,11,212,24,13,11
15,11,213,9,15,-6
15,11,214,20,17,3
15,11,215,6,11,-5
15,11,216,8,10,-2
15,11,217,9,19,-10
15,11,218,7,20,-13
15,11,219,7,14,-7
15,11,220,16,12,4
15,11,221,8,19,-11
15,11,222,21,31,-10
15,11,223,7,35,-28
15,11,224,10,22,-12
15,11,225,12,24,-12
15,11,226,17,12,5
15,11,227,13,19,-6
15,11,228,6,17,-11
15,11,229,16,17,-1
15,11,230,18,17,1
15,11,231,13,27,-14
15,11,232,19,17,2
15,11,233,18,18,0
15,11,234,16,22,-6
15,11,235,10,13,-3
15,11,236,26,12,14
15,11,237,8,26,-18
15,11,238,11,18,-7
15,11,239,17,20,-3
15,11,240,16,7,9
15,11,241,17,18,-1
15,11,242,8,13,-5
15,11,243,12,15,-3
15,11,244,14,31,-17
15,11,245,13,12,1
15,11,246,15,21,-6
15,11,247,9,11,-2
15,11,248,12,17,-5
15,11,249,19,14,5
15,11,250,13,17,-4
15,11,251,12,22,-10
15,11,252,21,23,-2
15,11,253,11,13,-2
15,11,254,16,20,-4
15,11,255,14,19,-5
15,11,256,15,23,-8
15,11,257,9,19,-10
15,11,258,21,30,-9
15,11,259,8,17,-9
15,11,260,11,16,-5
15,11,261,13,20,-7
15,11,262,22,14,8
15,11,263,10,17,-7
15,11,264,6,8,-2
15,11,265,18,20,-2
15,11,266,24,22,2
15,11,267,7,25,-18
15,11,268,10,16,-6
15,11,269,25,27,-2
15,11,270,13,12,1
15,11,271,17,23,-6
15,11,272,12,21,-9
15,11,273,16,10,6
15,11,274,16,28,-12
15,11,275,11,41,-30
15,11,276,23,15,8
15,11,277,11,18,-7
15,11,278,9,7,2
15,11,279,5,8,-3
15,11,280,3,25,-22
15,11,281,22,25,-3
15,11,282,17,35,-18
15,11,283,11,13,-2
15,11,284,16,13,3
15,11,285,9,24,-15
15,11,286,19,19,0
15,11,287,20,29,-9
15,11,288,19,20,-1
15,11,289,15,23,-8
15,11,290,13,32,-19
15,11,291,10,12,-2
15,11,292,10,10,0
15,11,293,15,28,-13
15,11,294,11,18,-7
15,11,295,13,23,-10
15,11,296,12,10,2
15,11,297,15,25,-10
15,11,298,14,20,-6
15,11,299,12,7,5
15,12,0,12,19,-7
15,12,1,21,14,7
15,12,2,23,13,10
15,12,3,9,25,-16
15,12,4,8,19,-11
15,12,5,15,18,-3
15,12,6,15,18,-3
15,12,7,16,10,6
15,12,8,17,23,-6
15,12,9,20,21,-1
15,12,10,10,16,-6
15,12,11,2,12,-10
15,12,12,13,24,-11
15,12,13,18,16,2
15,12,14,16,15,1
15,12,15,14,10,4
15,12,16,16,23,-7
15,12,17,19,10,9
15,12,18,16,28,-12
15,12,19,9,26,-17
15,12,20,6,18,-12
15,12,21,6,2,4
15,12,22,24,21,3
15,12,23,11,37,-26
15,12,24,12,10,2
15,12,25,14,7,7
15,12,26,14,20,-6
15,12,27,32,16,16
15,12,28,12,6,6
15,12,29,18,19,-1
15,12,30,22,21,1
15,12,31,7,14,-7
15,12,32,19,19,0
15,12,33,12,19,-7
15,12,34,23,30,-7
15,12,35,16,22,-6
15,12,36,21,13,8
15,12,37,14,11,3
15,12,38,16,5,11
15,12,39,13,21,-8
15,12,40,12,14,-2
15,12,41,16,28,-12
15,12,42,14,26,-12
15,12,43,21,14,7
15,12,44,16,25,-9
15,12,45,7,20,-13
15,12,46,17,15,2
15,12,47,13,24,-11
15,12,48,10,16,-6
15,12,49,19,20,-1
15,12,50,12,17,-5
15,12,51,11,22,-11
15,12,52,24,24,0
15,12,53,15,18,-3
15,12,54,16,22,-6
15,12,55,24,19,5
15,12,56,11,8,3
15,12,57,11,22,-11
15,12,58,12,9,3
15,12,59,16,26,-10
15,12,60,14,20,-6
15,12,61,21,16,5
15,12,62,10,11,-1
15,12,63,8,26,-18
15,12,64,17,16,1
15,12,65,10,16,-6
15,12,66,18,12,6
15,12,67,13,12,1
15,12,68,15,18,-3
15,12,69,13,36,-23
15,12,70,4,18,-14
15,12,71,13,16,-3
15,12,72,13,11,2
15,12,73,24,20,4
15,12,74,8,24,-16
15,12,75,20,21,-1
15,12,76,7,21,-14
15,12,77,11,13,-2
15,12,78,15,17,-2
15,12,79,21,16,5
15,12,80,29,18,11
15,12,81,15,19,-4
15,12,82,7,9,-2
15,12,83,32,33,-1
15,12,84,11,6,5
15,12,85,13,25,-12
15,12,86,16,11,5
15,12,87,12,23,-11
15,12,88,11,12,-1
15,12,89,26,27,-1
15,12,90,13,20,-7
15,12,91,27,22,5
15,12,92,22,13,9
15,12,93,7,10,-3
15,12,94,20,42,-22
15,12,95,14,25,-11
15,12,96,11,13,-2
15,12,97,12,13,-1
15,12,98,11,11,0
15,12,99,9,12,-3
15,12,100,9,12,-3
15,12,101,7,10,-3
15,12,102,17,14,3
15,12,103,22,27,-5
15,12,104,10,20,-10
15,12,105,5,10,-5
15,12,106,15,12,3
15,12,107,19,11,8
15,12,108,14,16,-2
15,12,109,10,15,-5
15,12,110,17,14,3
15,12,111,23,23,0
15,12,112,17,19,-2
15,12,113,8,14,-6
15,12,114,19,13,6
15,12,115,10,18,-8
15,12,116,14,13,1
15,12,117,17,22,-5
15,12,118,7,11,-4
15,12,119,17,19,-2
15,12,120,11,4,7
15,12,121,21,23,-2
15,12,122,13,15,-2
15,12,123,5,11,-6
15,12,124,14,7,7
15,12,125,24,24,0
15,12,126,17,15,2
15,12,127,30,10,20
15,12,128,18,15,3
15,12,129,1,13,-12
15,12,130,16,16,0
15,12,131,27,42,-15
15,12,132,9,26,-17
15,12,133,7,8,-1
15,12,134,19,22,-3
15,12,135,10,19,-9
15,12,136,13,22,-9
15,12,137,17,19,-2
15,12,138,20,28,-8
15,12,139,11,20,-9
15,12,140,10,22,-12
15,12,141,12,20,-8
15,12,142,5,5,0
15,12,143,4,16,-12
15,12,144,29,22,7
15,12,145,11,12,-1
15,12,146,21,14,7
15,12,147,14,18,-4
15,12,148,16,18,-2
15,12,149,14,19,-5
15,12,150,12,21,-9
15,12,151,5,7,-2
15,12,152,24,25,-1
15,12,153,13,14,-1
15,12,154,10,11,-1
15,12,155,4,12,-8
15,12,156,10,8,2
15,12,157,12,22,-10
15,12,158,10,6,4
15,12,159,22,27,-5
15,12,160,18,15,3
15,12,161,13,17,-4
15,12,162,16,24,-8
15,12,163,20,23,-3
15,12,164,11,16,-5
15,12,165,12,5,7
15,12,166,21,19,2
15,12,167,8,23,-15
15,12,168,13,19,-6
15,12,169,23,25,-2
15,12,170,10,28,-18
15,12,171,17,13,4
15,12,172,8,6,2
15,12,173,21,9,12
15,12,174,8,25,-17
15,12,175,8,10,-2
15,12,176,9,11,-2
15,12,177,25,25,0
15,12,178,19,17,2
15,12,179,15,29,-14
15,12,180,22,28,-6
15,12,181,8,18,-10
15,12,182,24,14,10
15,12,183,12,24,-12
15,12,184,23,24,-1
15,12,185,12,17,-5
15,12,186,10,12,-2
15,12,187,13,7,6
15,12,188,15,9,6
15,12,189,12,4,8
15,12,190,8,10,-2
15,12,191,23,22,1
15,12,192,15,9,6
15,12,193,12,11,1
15,12,194,18,19,-1
15,12,195,11,22,-11
15,12,196,10,18,-8
15,12,197,16,11,5
15,12,198,7,12,-5
15,12,199,11,19,-8
15,12,200,16,26,-10
15,12,201,13,12,1
15,12,202,9,16,-7
15,12,203,14,18,-4
15,12,204,19,30,-11
15,12,205,8,15,-7
15,12,206,17,12,5
15,12,207,23,10,13
15,12,208,13,12,1
15,12,209,24,19,5
15,12,210,5,35,-30
15,12,211,20,17,3
15,12,212,24,16,8
15,12,213,30,26,4
15,12,214,11,21,-10
15,12,215,19,14,5
15,12,216,21,20,1
15,12,217,15,17,-2
15,12,218,20,18,2
15,12,219,12,9,3
15,12,220,20,20,0
15,12,221,14,18,-4
15,12,222,11,30,-19
15,12,223,13,15,-2
15,12,224,9,6,3
15,12,225,8,12,-4
15,12,226,12,20,-8
15,12,227,5,17,-12
15,12,228,6,14,-8
15,12,229,18,16,2
15,12,230,14,20,-6
15,12,231,6,15,-9
15,12,232,22,24,-2
15,12,233,20,19,1
15,12,234,16,15,1
15,12,235,13,18,-5
15,12,236,19,23,-4
15,12,237,29,14,15
15,12,238,17,10,7
15,12,239,11,12,-1
15,12,240,14,14,0
15,12,241,15,15,0
15,12,242,8,19,-11
15,12,243,7,29,-22
15,12,244,26,23,3
15,12,245,13,17,-4
15,12,246,16,19,-3
15,12,247,20,21,-1
15,12,248,13,16,-3
15,12,249,15,17,-2
15,12,250,14,12,2
15,12,251,9,13,-4
15,12,252,23,16,7
15,12,253,19,13,6
15,12,254,16,13,3
15,12,255,25,12,13
15,12,256,15,16,-1
15,12,257,12,15,-3
15,12,258,14,5,9
15,12,259,11,17,-6
15,12,260,15,10,5
15,12,261,13,11,2
15,12,262,15,22,-7
15,12,263,13,17,-4
15,12,264,14,17,-3
15,12,265,27,14,13
15,12,266,5,10,-5
15,12,267,14,10,4
15,12,268,24,34,-10
15,12,269,17,18,-1
15,12,270,15,16,-1
15,12,271,15,18,-3
15,12,272,12,11,1
15,12,273,7,21,-14
15,12,274,15,14,1
15,12,275,14,31,-17
15,12,276,16,14,2
15,12,277,14,20,-6
15,12,278,11,9,2
15,12,279,14,26,-12
15,12,280,9,24,-15
15,12,281,19,24,-5
15,12,282,12,18,-6
15,12,283,21,21,0
15,12,284,15,10,5
15,12,285,14,10,4
15,12,286,8,13,-5
15,12,287,26,20,6
15,12,288,11,17,-6
15,12,289,9,15,-6
15,12,290,10,13,-3
15,12,291,15,10,5
15,12,292,11,21,-10
15,12,293,9,13,-4
15,12,294,8,20,-12
15,12,295,5,4,1
15,12,296,15,7,8
15,12,297,18,9,9
15,12,298,6,13,-7
15,12,299,19,16,3
15,13,0,5,19,-14
15,13,1,12,17,-5
15,13,2,18,28,-10
15,13,3,12,9,3
15,13,4,16,26,-10
15,13,5,12,15,-3
15,13,6,21,16,5
15,13,7,15,16,-1
15,13,8,24,23,1
15,13,9,10,22,-12
15,13,10,15,17,-2
15,13,11,12,10,2
15,13,12,9,19,-10
15,13,13,20,14,6
15,13,14,40,32,8
15,13,15,15,23,-8
15,13,16,13,15,-2
15,13,17,14,13,1
15,13,18,7,9,-2
15,13,19,9,18,-9
15,13,20,14,21,-7
15,13,21,18,24,-6
15,13,22,13,26,-13
15,13,23,9,14,-5
15,13,24,26,18,8
15,13,25,8,10,-2
15,13,26,17,8,9
15,13,27,15,20,-5
15,13,28,23,22,1
15,13,29,10,22,-12
15,13,30,12,14,-2
15,13,31,6,13,-7
15,13,32,13,27,-14
15,13,33,8,19,-11
15,13,34,9,20,-11
15,13,35,12,22,-10
15,13,36,18,15,3
15,13,37,9,17,-8
15,13,38,21,17,4
15,13,39,13,34,-21
15,13,40,17,19,-2
15,13,41,12,18,-6
15,13,42,14,17,-3
15,13,43,17,18,-1
15,13,44,16,26,-10
15,13,45,11,17,-6
15,13,46,24,21,3
15,13,47,13,23,-10
15,13,48,16,24,-8
15,13,49,20,23,-3
15,13,50,13,23,-10
15,13,51,13,23,-10
15,13,52,21,23,-2
15,13,53,22,12,10
15,13,54,7,10,-3
15,13,55,12,17,-5
15,13,56,18,12,6
15,13,57,7,19,-12
15,13,58,13,20,-7
15,13,59,12,16,-4
15,13,60,20,23,-3
15,13,61,19,25,-6
15,13,62,11,23,-12
15,13,63,10,16,-6
15,13,64,20,8,12
15,13,65,10,18,-8
15,13,66,6,16,-10
15,13,67,4,28,-24
15,13,68,20,16,4
15,13,69,17,20,-3
15,13,70,16,19,-3
15,13,71,24,19,5
15,13,72,22,17,5
15,13,73,20,23,-3
15,13,74,21,23,-2
15,13,75,17,14,3
15,13,76,18,14,4
15,13,77,14,17,-3
15,13,78,22,18,4
15,13,79,7,6,1
15,13,80,26,30,-4
15,13,81,19,17,2
15,13,82,17,14,3
15,13,83,9,17,-8
15,13,84,20,20,0
15,13,85,14,12,2
15,13,86,22,18,4
15,13,87,7,14,-7
15,13,88,5,21,-16
15,13,89,22,13,9
15,13,90,18,22,-4
15,13,91,12,13,-1
15,13,92,13,15,-2
15,13,93,9,9,0
15,13,94,35,15,20
15,13,95,13,8,5
15,13,96,21,14,7
15,13,97,7,9,-2
15,13,98,13,11,2
15,13,99,16,22,-6
15,13,100,3,8,-5
15,13,101,9,8,1
15,13,102,23,29,-6
15,13,103,19,19,0
15,13,104,23,24,-1
15,13,105,21,24,-3
15,13,106,7,18,-11
15,13,107,14,18,-4
15,13,108,12,9,3
15,13,109,16,18,-2
15,13,110,15,13,2
15,13,111,15,9,6
15,13,112,12,22,-10
15,13,113,26,23,3
15,13,114,9,17,-8
15,13,115,13,13,0
15,13,116,13,17,-4
15,13,117,15,14,1
15,13,118,13,14,-1
15,13,119,14,14,0
15,13,120,27,18,9
15,13,121,13,10,3
15,13,122,19,11,8
15,13,123,12,24,-12
15,13,124,22,14,8
15,13,125,12,18,-6
15,13,126,15,14,1
15,13,127,16,15,1
15,13,128,11,15,-4
15,13,129,18,12,6
15,13,130,22,15,7
15,13,131,13,22,-9
15,13,132,24,28,-4
15,13,133,5,12,-7
15,13,134,14,25,-11
15,13,135,14,15,-1
15,13,136,27,23,4
15,13,137,11,11,0
15,13,138,10,20,-10
15,13,139,4,14,-10
15,13,140,17,26,-9
15,13,141,9,19,-10
15,13,142,10,14,-4
15,13,143,10,15,-5
15,13,144,20,21,-1
15,13,145,16,23,-7
15,13,146,4,10,-6
15,13,147,16,9,7
15,13,148,19,23,-4
15,13,149,12,6,6
15,13,150,20,34,-14
15,13,151,18,17,1
15,13,152,16,35,-19
15,13,153,14,16,-2
15,13,154,8,9,-1
15,13,155,21,29,-8
15,13,156,21,7,14
15,13,157,22,18,4
15,13,158,10,24,-14
15,13,159,19,21,-2
15,13,160,17,24,-7
15,13,161,16,16,0
15,13,162,24,17,7
15,13,163,14,10,4
15,13,164,20,31,-11
15,13,165,6,16,-10
15,13,166,13,29,-16
15,13,167,9,14,-5
15,13,168,21,12,9
15,13,169,25,23,2
15,13,170,25,28,-3
15,13,171,13,13,0
15,13,172,5,10,-5
15,13,173,13,18,-5
15,13,174,14,15,-1
15,13,175,15,11,4
15,13,176,8,20,-12
15,13,177,11,20,-9
15,13,178,11,17,-6
15,13,179,17,22,-5
15,13,180,14,26,-12
15,13,181,18,21,-3
15,13,182,11,20,-9
15,13,183,8,24,-16
15,13,184,7,23,-16
15,13,185,10,18,-8
15,13,186,20,23,-3
15,13,187,21,30,-9
15,13,188,7,4,3
15,13,189,27,22,5
15,13,190,13,33,-20
15,13,191,24,18,6
15,13,192,7,11,-4
15,13,193,17,16,1
15,13,194,10,20,-10
15,13,195,5,23,-18
15,13,196,15,35,-20
15,13,197,11,15,-4
15,13,198,8,8,0
15,13,199,20,17,3
15,13,200,23,18,5
15,13,201,17,27,-10
15,13,202,13,11,2
15,13,203,7,9,-2
15,13,204,19,16,3
15,13,205,18,13,5
15,13,206,17,15,2
15,13,207,10,18,-8
15,13,208,13,18,-5
15,13,209,6,14,-8
15,13,210,9,15,-6
15,13,211,13,17,-4
15,13,212,19,21,-2
15,13,213,17,7,10
15,13,214,9,3,6
15,13,215,19,11,8
15,13,216,9,24,-15
15,13,217,12,25,-13
15,13,218,30,26,4
15,13,219,22,29,-7
15,13,220,24,23,1
15,13,221,25,23,2
15,13,222,15,18,-3
15,13,223,10,15,-5
15,13,224,16,16,0
15,13,225,17,23,-6
15,13,226,33,8,25
15,13,227,15,9,6
15,13,228,30,12,18
15,13,229,31,26,5
15,13,230,7,6,1
15,13,231,16,18,-2
15,13,232,23,16,7
15,13,233,13,13,0
15,13,234,23,22,1
15,13,235,20,21,-1
15,13,236,24,17,7
15,13,237,8,26,-18
15,13,238,10,8,2
15,13,239,11,19,-8
15,13,240,12,26,-14
15,13,241,19,10,9
15,13,242,14,14,0
15,13,243,16,22,-6
15,13,244,16,13,3
15,13,245,7,7,0
15,13,246,11,16,-5
15,13,247,14,19,-5
15,13,248,20,22,-2
15,13,249,13,14,-1
15,13,250,19,17,2
15,13,251,16,23,-7
15,13,252,14,28,-14
15,13,253,22,18,4
15,13,254,20,15,5
15,13,255,17,15,2
15,13,256,7,18,-11
15,13,257,5,21,-16
15,13,258,24,30,-6
15,13,259,15,23,-8
15,13,260,17,20,-3
15,13,261,12,31,-19
15,13,262,5,14,-9
15,13,263,12,20,-8
15,13,264,23,27,-4
15,13,265,15,16,-1
15,13,266,3,18,-15
15,13,267,14,10,4
15,13,268,13,5,8
15,13,269,14,20,-6
15,13,270,18,21,-3
15,13,271,26,21,5
15,13,272,9,18,-9
15,13,273,11,27,-16
15,13,274,14,15,-1
15,13,275,8,10,-2
15,13,276,18,26,-8
15,13,277,6,18,-12
15,13,278,12,14,-2
15,13,279,16,23,-7
15,13,280,16,19,-3
15,13,281,18,8,10
15,13,282,19,21,-2
15,13,283,14,16,-2
15,13,284,20,17,3
15,13,285,16,16,0
15,13,286,22,27,-5
15,13,287,13,16,-3
15,13,288,5,13,-8
15,13,289,8,4,4
15,13,290,15,12,3
15,13,291,20,21,-1
15,13,292,21,9,12
15,13,293,13,25,-12
15,13,294,9,3,6
15,13,295,14,21,-7
15,13,296,26,18,8
15,13,297,16,12,4
15,13,298,15,12,3
15,13,299,18,17,1
15,14,0,16,35,-19
15,14,1,13,9,4
15,14,2,16,20,-4
15,14,3,17,7,10
15,14,4,6,19,-13
15,14,5,4,9,-5
15,14,6,10,19,-9
15,14,7,10,13,-3
15,14,8,12,20,-8
15,14,9,35,23,12
15,14,10,9,12,-3
15,14,11,12,14,-2
15,14,12,15,15,0
15,14,13,25,6,19
15,14,14,8,13,-5
15,14,15,7,12,-5
15,14,16,15,15,0
15,14,17,8,14,-6
15,14,18,11,14,-3
15,14,19,15,7,8
15,14,20,22,20,2
15,14,21,10,22,-12
15,14,22,6,8,-2
15,14,23,10,13,-3
15,14,24,10,11,-1
15,14,25,17,20,-3
15,14,26,17,15,2
15,14,27,15,18,-3
15,14,28,13,17,-4
15,14,29,13,17,-4
15,14,30,13,15,-2
15,14,31,12,17,-5
15,14,32,13,15,-2
15,14,33,15,13,2
15,14,34,10,19,-9
15,14,35,8,16,-8
15,14,36,15,16,-1
15,14,37,21,20,1
15,14,38,8,17,-9
15,14,39,12,15,-3
15,14,40,15,14,1
15,14,41,17,18,-1
15,14,42,14,9,5
15,14,43,10,22,-12
15,14,44,16,17,-1
15,14,45,15,14,1
15,14,46,19,13,6
15,14,47,17,29,-12
15,14,48,5,27,-22
15,14,49,7,9,-2
15,14,50,10,20,-10
15,14,51,18,25,-7
15,14,52,14,22,-8
15,14,53,17,23,-6
15,14,54,18,16,2
15,14,55,29,29,0
15,14,56,16,16,0
15,14,57,18,26,-8
15,14,58,20,16,4
15,14,59,23,20,3
15,14,60,18,25,-7
15,14,61,5,21,-16
15,14,62,27,11,16
15,14,63,9,10,-1
15,14,64,15,19,-4
15,14,65,8,18,-10
15,14,66,19,19,0
15,14,67,7,14,-7
15,14,68,11,10,1
15,14,69,26,12,14
15,14,70,10,4,6
15,14,71,29,17,12
15,14,72,17,20,-3
15,14,73,11,10,1
15,14,74,15,13,2
15,14,75,13,25,-12
15,14,76,14,11,3
15,14,77,12,23,-11
15,14,78,12,14,-2
15,14,79,12,13,-1
15,14,80,22,29,-7
15,14,81,17,21,-4
15,14,82,23,21,2
15,14,83,13,16,-3
15,14,84,17,16,1
15,14,85,12,13,-1
15,14,86,20,23,-3
15,14,87,14,12,2
15,14,88,12,8,4
15,14,89,21,25,-4
15,14,90,4,20,-16
15,14,91,15,13,2
15,14,92,26,26,0
15,14,93,16,12,4
15,14,94,22,12,10
15,14,95,10,13,-3
15,14,96,14,10,4
15,14,97,9,12,-3
15,14,98,11,11,0
15,14,99,12,10,2
15,14,100,9,14,-5
15,14,101,14,16,-2
15,14,102,12,9,3
15,14,103,4,14,-10
15,14,104,16,18,-2
15,14,105,18,25,-7
15,14,106,13,20,-7
15,14,107,25,20,5
15,14,108,13,5,8
15,14,109,13,17,-4
15,14,110,19,13,6
15,14,111,14,11,3
15,14,112,14,16,-2
15,14,113,17,21,-4
15,14,114,12,27,-15
15,14,115,13,12,1
15,14,116,9,22,-13
15,14,117,13,16,-3
15,14,118,12,17,-5
15,14,119,16,9,7
15,14,120,12,12,0
15,14,121,12,15,-3
15,14,122,11,25,-14
15,14,123,23,20,3
15,14,124,9,34,-25
15,14,125,12,8,4
15,14,126,14,21,-7
15,14,127,9,17,-8
15,14,128,13,16,-3
15,14,129,19,24,-5
15,14,130,16,15,1
15,14,131,17,15,2
15,14,132,11,13,-2
15,14,133,12,22,-10
15,14,134,15,21,-6
15,14,135,22,22,0
15,14,136,21,36,-15
15,14,137,14,20,-6
15,14,138,19,14,5
15,14,139,16,17,-1
15,14,140,16,25,-9
15,14,141,13,22,-9
15,14,142,12,14,-2
15,14,143,11,21,-10
15,14,144,20,15,5
15,14,145,16,20,-4
15,14,146,24,23,1
15,14,147,14,9,5
15,14,148,24,24,0
15,14,149,10,8,2
15,14,150,17,23,-6
15,14,151,11,18,-7
15,14,152,10,8,2
15,14,153,16,21,-5
15,14,154,12,17,-5
15,14,155,17,13,4
15,14,156,18,11,7
15,14,157,19,11,8
15,14,158,10,11,-1
15,14,159,20,12,8
15,14,160,14,13,1
15,14,161,8,11,-3
15,14,162,17,7,10
15,14,163,6,14,-8
15,14,164,18,3,15
15,14,165,4,7,-3
15,14,166,18,20,-2
15,14,167,11,9,2
15,14,168,14,20,-6
15,14,169,21,22,-1
15,14,170,22,11,11
15,14,171,21,15,6
15,14,172,16,20,-4
15,14,173,7,14,-7
15,14,174,12,14,-2
15,14,175,5,10,-5
15,14,176,10,16,-6
15,14,177,21,23,-2
15,14,178,16,13,3
15,14,179,22,30,-8
15,14,180,14,23,-9
15,14,181,17,16,1
15,14,182,12,18,-6
15,14,183,22,5,17
15,14,184,9,9,0
15,14,185,4,17,-13
15,14,186,8,9,-1
15,14,187,25,14,11
15,14,188,16,18,-2
15,14,189,15,18,-3
15,14,190,22,13,9
15,14,191,13,11,2
15,14,192,26,22,4
15,14,193,11,37,-26
15,14,194,19,17,2
15,14,195,11,15,-4
15,14,196,33,18,15
15,14,197,13,15,-2
15,14,198,10,12,-2
15,14,199,12,9,3
15,14,200,7,13,-6
15,14,201,9,11,-2
15,14,202,12,22,-10
15,14,203,12,12,0
15,14,204,13,8,5
15,14,205,9,12,-3
15,14,206,16,16,0
15,14,207,14,23,-9
15,14,208,23,27,-4
15,14,209,29,36,-7
15,14,210,19,16,3
15,14,211,17,17,0
15,14,212,16,21,-5
15,14,213,26,21,5
15,14,214,28,24,4
15,14,215,25,30,-5
15,14,216,10,19,-9
15,14,217,19,16,3
15,14,218,9,4,5
15,14,219,17,17,0
15,14,220,13,18,-5
15,14,221,27,16,11
15,14,222,7,17,-10
15,14,223,21,14,7
15,14,224,16,15,1
15,14,225,11,15,-4
15,14,226,15,21,-6
15,14,227,4,16,-12
15,14,228,10,15,-5
15,14,229,15,10,5
15,14,230,12,22,-10
15,14,231,15,32,-17
15,14,232,18,20,-2
15,14,233,7,6,1
15,14,234,13,16,-3
15,14,235,7,8,-1
15,14,236,15,14,1
15,14,237,27,22,5
15,14,238,20,26,-6
15,14,239,13,16,-3
15,14,240,26,28,-2
15,14,241,13,16,-3
15,14,242,20,21,-1
15,14,243,9,14,-5
15,14,244,13,14,-1
15,14,245,6,19,-13
15,14,246,7,20,-13
15,14,247,9,10,-1
15,14,248,15,25,-10
15,14,249,8,11,-3
15,14,250,18,12,6
15,14,251,11,10,1
15,14,252,16,17,-1
15,14,253,11,13,-2
15,14,254,9,9,0
15,14,255,12,19,-7
15,14,256,13,16,-3
15,14,257,11,20,-9
15,14,258,10,19,-9
15,14,259,22,18,4
15,14,260,12,7,5
15,14,261,24,24,0
15,14,262,12,12,0
15,14,263,10,14,-4
15,14,264,18,29,-11
15,14,265,8,17,-9
15,14,266,11,17,-6
15,14,267,14,27,-13
15,14,268,14,13,1
15,14,269,8,18,-10
15,14,270,13,17,-4
15,14,271,17,14,3
15,14,272,17,20,-3
15,14,273,13,5,8
15,14,274,16,23,-7
15,14,275,9,31,-22
15,14,276,27,22,5
15,14,277,7,6,1
15,14,278,17,19,-2
15,14,279,26,23,3
15,14,280,16,23,-7
15,14,281,18,13,5
15,14,282,13,10,3
15,14,283,6,13,-7
15,14,284,12,6,6
15,14,285,14,16,-2
15,14,286,22,18,4
15,14,287,14,35,-21
15,14,288,15,33,-18
15,14,289,11,16,-5
15,14,290,10,31,-21
15,14,291,17,14,3
15,14,292,14,13,1
15,14,293,14,29,-15
15,14,294,13,28,-15
15,14,295,18,20,-2
15,14,296,10,10,0
15,14,297,7,21,-14
15,14,298,5,29,-24
15,14,299,25,15,10
15,15,0,9,10,-1
15,15,1,9,10,-1
15,15,2,12,14,-2
15,15,3,4,23,-19
15,15,4,25,26,-1
15,15,5,14,14,0
15,15,6,16,17,-1
15,15,7,16,10,6
15,15,8,26,29,-3
15,15,9,9,18,-9
15,15,10,22,32,-10
15,15,11,9,24,-15
15,15,12,14,23,-9
15,15,13,15,14,1
15,15,14,20,11,9
15,15,15,9,5,4
15,15,16,6,21,-15
15,15,17,7,21,-14
15,15,18,12,12,0
15,15,19,7,15,-8
15,15,20,18,16,2
15,15,21,20,12,8
15,15,22,7,28,-21
15,15,23,9,26,-17
15,15,24,8,12,-4
15,15,25,21,8,13
15,15,26,17,17,0
15,15,27,19,15,4
15,15,28,7,19,-12
15,15,29,5,15,-10
15,15,30,9,10,-1
15,15,31,16,21,-5
15,15,32,29,21,8
15,15,33,19,17,2
15,15,34,17,23,-6
15,15,35,9,27,-18
15,15,36,16,12,4
15,15,37,12,9,3
15,15,38,26,17,9
15,15,39,17,18,-1
15,15,40,12,15,-3
15,15,41,11,27,-16
15,15,42,4,6,-2
15,15,43,20,17,3
15,15,44,15,10,5
15,15,45,19,11,8
15,15,46,13,20,-7
15,15,47,18,11,7
15,15,48,15,16,-1
15,15,49,18,13,5
15,15,50,16,28,-12
15,15,51,7,13,-6
15,15,52,15,20,-5
15,15,53,15,13,2
15,15,54,22,10,12
15,15,55,10,8,2
15,15,56,6,20,-14
15,15,57,18,16,2
15,15,58,15,17,-2
15,15,59,11,17,-6
15,15,60,22,11,11
15,15,61,11,15,-4
15,15,62,16,17,-1
15,15,63,29,13,16
15,15,64,8,8,0
15,15,65,9,18,-9
15,15,66,5,10,-5
15,15,67,12,14,-2
15,15,68,9,8,1
15,15,69,13,11,2
15,15,70,15,19,-4
15,15,71,14,29,-15
15,15,72,8,9,-1
15,15,73,10,8,2
15,15,74,15,5,10
15,15,75,14,21,-7
15,15,76,19,16,3
15,15,77,23,22,1
15,15,78,10,8,2
15,15,79,3,16,-13
15,15,80,20,20,0
15,15,81,7,23,-16
15,15,82,13,23,-10
15,15,83,21,14,7
15,15,84,24,16,8
15,15,85,10,10,0
15,15,86,8,10,-2
15,15,87,9,8,1
15,15,88,23,26,-3
15,15,89,13,25,-12
15,15,90,5,20,-15
15,15,91,13,4,9
15,15,92,14,12,2
15,15,93,18,16,2
15,15,94,22,23,-1
15,15,95,8,24,-16
15,15,96,10,15,-5
15,15,97,18,7,11
15,15,98,2,16,-14
15,15,99,23,15,8
15,15,100,13,9,4
15,15,101,10,17,-7
15,15,102,15,17,-2
15,15,103,13,23,-10
15,15,104,21,26,-5
15,15,105,7,14,-7
15,15,106,11,15,-4
15,15,107,14,16,-2
15,15,108,23,18,5
15,15,109,12,21,-9
15,15,110,5,19,-14
15,15,111,9,19,-10
15,15,112,12,20,-8
15,15,113,8,16,-8
15,15,114,22,11,11
15,15,115,25,16,9
15,15,116,12,12,0
15,15,117,10,18,-8
15,15,118,14,15,-1
15,15,119,22,17,5
15,15,120,12,14,-2
15,15,121,13,13,0
15,15,122,19,6,13
15,15,123,14,11,3
15,15,124,18,17,1
15,15,125,17,11,6
15,15,126,18,18,0
15,15,127,19,15,4
15,15,128,1,9,-8
15,15,129,28,15,13
15,15,130,8,16,-8
15,15,131,6,7,-1
15,15,132,11,10,1
15,15,133,16,11,5
15,15,134,14,15,-1
15,15,135,11,15,-4
15,15,136,12,20,-8
15,15,137,18,17,1
15,15,138,10,18,-8
15,15,139,11,14,-3
15,15,140,7,17,-10
15,15,141,13,12,1
15,15,142,3,13,-10
15,15,143,4,22,-18
15,15,144,9,11,-2
15,15,145,24,16,8
15,15,146,8,12,-4
15,15,147,9,13,-4
15,15,148,12,19,-7
15,15,149,15,22,-7
15,15,150,9,7,2
15,15,151,11,11,0
15,15,152,19,23,-4
15,15,153,11,15,-4
15,15,154,14,19,-5
15,15,155,7,6,1
15,15,156,10,11,-1
15,15,157,6,10,-4
15,15,158,11,20,-9
15,15,159,16,13,3
15,15,160,13,10,3
15,15,161,18,15,3
15,15,162,13,20,-7
15,15,163,31,14,17
15,15,164,11,5,6
15,15,165,28,13,15
15,15,166,15,27,-12
15,15,167,13,12,1
15,15,168,11,17,-6
15,15,169,16,22,-6
15,15,170,12,20,-8
15,15,171,15,16,-1
15,15,172,6,25,-19
15,15,173,14,15,-1
15,15,174,15,10,5
15,15,175,19,12,7
15,15,176,26,34,-8
15,15,177,16,23,-7
15,15,178,18,13,5
15,15,179,17,15,2
15,15,180,16,19,-3
15,15,181,16,21,-5
15,15,182,4,12,-8
15,15,183,24,18,6
15,15,184,20,19,1
15,15,185,12,15,-3
15,15,186,24,21,3
15,15,187,5,13,-8
15,15,188,10,19,-9
15,15,189,11,16,-5
15,15,190,20,15,5
15,15,191,20,21,-1
15,15,192,3,6,-3
15,15,193,17,20,-3
15,15,194,19,13,6
15,15,195,2,10,-8
15,15,196,15,15,0
15,15,197,4,14,-10
15,15,198,20,33,-13
15,15,199,23,16,7
15,15,200,16,18,-2
15,15,201,10,17,-7
15,15,202,11,17,-6
15,15,203,21,32,-11
15,15,204,17,11,6
15,15,205,16,16,0
15,15,206,17,12,5
15,15,207,8,10,-2
15,15,208,11,3,8
15,15,209,16,19,-3
15,15,210,14,16,-2
15,15,211,23,25,-2
15,15,212,7,10,-3
15,15,213,8,23,-15
15,15,214,12,10,2
15,15,215,16,9,7
15,15,216,14,22,-8
15,15,217,16,17,-1
15,15,218,19,8,11
15,15,219,14,21,-7
15,15,220,23,26,-3
15,15,221,13,23,-10
15,15,222,13,18,-5
15,15,223,19,11,8
15,15,224,10,12,-2
15,15,225,15,21,-6
15,15,226,17,19,-2
15,15,227,18,13,5
15,15,228,14,15,-1
15,15,229,13,9,4
15,15,230,19,14,5
15,15,231,9,17,-8
15,15,232,16,11,5
15,15,233,5,10,-5
15,15,234,8,9,-1
15,15,235,18,23,-5
15,15,236,8,13,-5
15,15,237,13,19,-6
15,15,238,13,13,0
15,15,239,20,19,1
15,15,240,11,8,3
15,15,241,21,19,2
15,15,242,16,25,-9
15,15,243,15,8,7
15,15,244,20,15,5
15,15,245,14,23,-9
15,15,246,16,14,2
15,15,247,17,29,-12
15,15,248,13,19,-6
15,15,249,5,8,-3
15,15,250,21,19,2
15,15,251,9,8,1
15,15,252,5,7,-2
15,15,253,15,10,5
15,15,254,13,15,-2
15,15,255,13,18,-5
15,15,256,23,18,5
15,15,257,14,14,0
15,15,258,16,5,11
15,15,259,9,15,-6
15,15,260,23,11,12
15,15,261,11,7,4
15,15,262,8,14,-6
15,15,263,17,27,-10
15,15,264,19,14,5
15,15,265,17,22,-5
15,15,266,11,20,-9
15,15,267,15,15,0
15,15,268,15,26,-11
15,15,269,7,11,-4
15,15,270,26,15,11
15,15,271,13,17,-4
15,15,272,13,28,-15
15,15,273,16,9,7
15,15,274,12,16,-4
15,15,275,11,16,-5
15,15,276,23,17,6
15,15,277,7,11,-4
15,15,278,3,14,-11
15,15,279,20,14,6
15,15,280,13,16,-3
15,15,281,6,13,-7
15,15,282,21,12,9
15,15,283,13,19,-6
15,15,284,11,13,-2
15,15,285,11,19,-8
15,15,286,13,14,-1
15,15,287,15,15,0
15,15,288,12,18,-6
15,15,289,12,13,-1
15,15,290,26,23,3
15,15,291,15,21,-6
15,15,292,13,23,-10
15,15,293,7,13,-6
15,15,294,9,19,-10
15,15,295,9,15,-6
15,15,296,10,15,-5
15,15,297,6,15,-9
15,15,298,14,12,2
15,15,299,16,16,0
15,16,0,20,19,1
15,16,1,8,20,-12
15,16,2,17,17,0
15,16,3,6,10,-4
15,16,4,19,17,2
15,16,5,10,15,-5
15,16,6,3,0,3
15,16,7,15,15,0
15,16,8,9,10,-1
15,16,9,17,11,6
15,16,10,26,16,10
15,16,11,7,9,-2
15,16,12,11,4,7
15,16,13,21,17,4
15,16,14,14,11,3
15,16,15,20,6,14
15,16,16,23,8,15
15,16,17,21,26,-5
15,16,18,14,5,9
15,16,19,8,12,-4
15,16,20,12,10,2
15,16,21,13,11,2
15,16,22,8,11,-3
15,16,23,12,14,-2
15,16,24,15,5,10
15,16,25,16,28,-12
15,16,26,24,20,4
15,16,27,9,10,-1
15,16,28,12,15,-3
15,16,29,13,22,-9
15,16,30,17,11,6
15,16,31,6,12,-6
15,16,32,12,19,-7
15,16,33,16,12,4
15,16,34,18,26,-8
15,16,35,12,19,-7
15,16,36,19,22,-3
15,16,37,10,20,-10
15,16,38,11,10,1
15,16,39,7,8,-1
15,16,40,19,14,5
15,16,41,20,19,1
15,16,42,12,4,8
15,16,43,16,10,6
15,16,44,14,12,2
15,16,45,14,21,-7
15,16,46,16,9,7
15,16,47,8,7,1
15,16,48,13,8,5
15,16,49,21,18,3
15,16,50,15,11,4
15,16,51,25,25,0
15,16,52,27,18,9
15,16,53,15,12,3
15,16,54,23,25,-2
15,16,55,25,18,7
15,16,56,15,29,-14
15,16,57,12,3,9
15,16,58,18,9,9
15,16,59,19,16,3
15,16,60,6,4,2
15,16,61,18,22,-4
15,16,62,13,18,-5
15,16,63,11,18,-7
15,16,64,14,14,0
15,16,65,14,20,-6
15,16,66,7,14,-7
15,16,67,21,17,4
15,16,68,7,10,-3
15,16,69,15,20,-5
15,16,70,12,8,4
15,16,71,18,14,4
15,16,72,10,7,3
15,16,73,22,19,3
15,16,74,16,10,6
15,16,75,21,12,9
15,16,76,13,11,2
15,16,77,16,15,1
15,16,78,21,7,14
15,16,79,7,16,-9
15,16,80,11,12,-1
15,16,81,15,10,5
15,16,82,10,20,-10
15,16,83,18,5,13
15,16,84,21,19,2
15,16,85,10,23,-13
15,16,86,13,17,-4
15,16,87,22,10,12
15,16,88,2,5,-3
15,16,89,23,23,0
15,16,90,21,11,10
15,16,91,16,12,4
15,16,92,14,23,-9
15,16,93,11,10,1
15,16,94,14,8,6
15,16,95,18,26,-8
15,16,96,13,5,8
15,16,97,19,27,-8
15,16,98,13,18,-5
15,16,99,20,20,0
15,16,100,13,20,-7
15,16,101,15,13,2
15,16,102,9,10,-1
15,16,103,15,19,-4
15,16,104,18,13,5
15,16,105,5,17,-12
15,16,106,8,3,5
15,16,107,15,21,-6
15,16,108,15,10,5
15,16,109,25,12,13
15,16,110,16,9,7
15,16,111,19,11,8
15,16,112,10,16,-6
15,16,113,8,13,-5
15,16,114,18,27,-9
15,16,115,10,15,-5
15,16,116,10,10,0
15,16,117,11,15,-4
15,16,118,15,11,4
15,16,119,18,18,0
15,16,120,10,18,-8
15,16,121,9,15,-6
15,16,122,19,17,2
15,16,123,13,13,0
15,16,124,2,10,-8
15,16,125,17,8,9
15,16,126,9,7,2
15,16,127,26,20,6
15,16,128,11,14,-3
15,16,129,5,10,-5
15,16,130,31,34,-3
15,16,131,10,12,-2
15,16,132,17,12,5
15,16,133,3,11,-8
15,16,134,11,18,-7
15,16,135,12,5,7
15,16,136,19,10,9
15,16,137,13,16,-3
15,16,138,17,30,-13
15,16,139,15,15,0
15,16,140,12,3,9
15,16,141,12,23,-11
15,16,142,16,9,7
15,16,143,18,15,3
15,16,144,6,22,-16
15,16,145,21,15,6
15,16,146,8,12,-4
15,16,147,14,23,-9
15,16,148,12,18,-6
15,16,149,30,19,11
15,16,150,15,16,-1
15,16,151,29,22,7
15,16,152,11,17,-6
15,16,153,17,18,-1
15,16,154,17,26,-9
15,16,155,21,20,1
15,16,156,17,12,5
15,16,157,8,13,-5
15,16,158,23,13,10
15,16,159,18,11,7
15,16,160,21,11,10
15,16,161,13,8,5
15,16,162,18,22,-4
15,16,163,11,16,-5
15,16,164,7,12,-5
15,16,165,13,21,-8
15,16,166,6,24,-18
15,16,167,21,23,-2
15,16,168,9,12,-3
15,16,169,9,9,0
15,16,170,6,9,-3
15,16,171,18,19,-1
15,16,172,4,11,-7
15,16,173,17,14,3
15,16,174,11,9,2
15,16,175,14,21,-7
15,16,176,16,14,2
15,16,177,11,17,-6
15,16,178,16,21,-5
15,16,179,6,8,-2
15,16,180,17,26,-9
15,16,181,24,20,4
15,16,182,6,21,-15
15,16,183,13,7,6
15,16,184,24,14,10
15,16,185,26,36,-10
15,16,186,17,22,-5
15,16,187,27,32,-5
15,16,188,16,15,1
15,16,189,10,18,-8
15,16,190,20,19,1
15,16,191,17,20,-3
15,16,192,12,13,-1
15,16,193,19,11,8
15,16,194,14,13,1
15,16,195,16,7,9
15,16,196,11,19,-8
15,16,197,21,17,4
15,16,198,17,27,-10
15,16,199,25,17,8
15,16,200,15,16,-1
15,16,201,13,16,-3
15,16,202,15,12,3
15,16,203,18,16,2
15,16,204,15,14,1
15,16,205,14,11,3
15,16,206,18,16,2
15,16,207,15,18,-3
15,16,208,10,16,-6
15,16,209,14,23,-9
15,16,210,10,10,0
15,16,211,14,15,-1
15,16,212,25,8,17
15,16,213,13,23,-10
15,16,214,11,15,-4
15,16,215,12,4,8
15,16,216,7,10,-3
15,16,217,16,30,-14
15,16,218,20,27,-7
15,16,219,9,11,-2
15,16,220,29,17,12
15,16,221,18,25,-7
15,16,222,18,13,5
15,16,223,9,10,-1
15,16,224,23,26,-3
15,16,225,9,10,-1
15,16,226,18,11,7
15,16,227,11,34,-23
15,16,228,11,12,-1
15,16,229,26,14,12
15,16,230,12,24,-12
15,16,231,20,19,1
15,16,232,15,10,5
15,16,233,9,13,-4
15,16,234,16,14,2
15,16,235,9,15,-6
15,16,236,5,8,-3
15,16,237,15,11,4
15,16,238,9,15,-6
15,16,239,16,14,2
15,16,240,17,30,-13
15,16,241,17,22,-5
15,16,242,26,14,12
15,16,243,24,17,7
15,16,244,16,17,-1
15,16,245,29,23,6
15,16,246,13,10,3
15,16,247,22,18,4
15,16,248,13,10,3
15,16,249,16,22,-6
15,16,250,23,25,-2
15,16,251,19,17,2
15,16,252,9,11,-2
15,16,253,19,22,-3
15,16,254,16,21,-5
15,16,255,20,15,5
15,16,256,13,10,3
15,16,257,8,14,-6
15,16,258,20,12,8
15,16,259,7,9,-2
15,16,260,23,6,17
15,16,261,22,21,1
15,16,262,20,20,0
15,16,263,22,14,8
15,16,264,17,31,-14
15,16,265,12,11,1
15,16,266,14,14,0
15,16,267,4,15,-11
15,16,268,10,21,-11
15,16,269,19,12,7
15,16,270,24,19,5
15,16,271,19,17,2
15,16,272,8,17,-9
15,16,273,16,14,2
15,16,274,22,20,2
15,16,275,13,1,12
15,16,276,19,28,-9
15,16,277,25,12,13
15,16,278,17,9,8
15,16,279,16,13,3
15,16,280,19,6,13
15,16,281,21,24,-3
15,16,282,11,3,8
15,16,283,11,6,5
15,16,284,12,16,-4
15,16,285,16,12,4
15,16,286,21,18,3
15,16,287,15,27,-12
15,16,288,12,11,1
15,16,289,11,13,-2
15,16,290,24,19,5
15,16,291,13,15,-2
15,16,292,15,9,6
15,16,293,9,10,-1
15,16,294,11,23,-12
15,16,295,11,15,-4
15,16,296,16,11,5
15,16,297,15,10,5
15,16,298,12,14,-2
15,16,299,19,18,1
15,17,0,17,7,10
15,17,1,20,14,6
15,17,2,21,28,-7
15,17,3,29,12,17
15,17,4,21,16,5
15,17,5,31,21,10
15,17,6,6,11,-5
15,17,7,22,14,8
15,17,8,22,38,-16
15,17,9,12,13,-1
15,17,10,24,19,5
15,17,11,4,6,-2
15,17,12,19,11,8
15,17,13,17,26,-9
15,17,14,16,11,5
15,17,15,20,10,10
15,17,16,14,12,2
15,17,17,15,9,6
15,17,18,14,15,-1
15,17,19,19,18,1
15,17,20,14,11,3
15,17,21,14,16,-2
15,17,22,8,13,-5
15,17,23,13,15,-2
15,17,24,27,12,15
15,17,25,4,22,-18
15,17,26,18,11,7
15,17,27,19,22,-3
15,17,28,11,8,3
15,17,29,17,13,4
15,17,30,14,9,5
15,17,31,12,11,1
15,17,32,14,23,-9
15,17,33,14,19,-5
15,17,34,12,9,3
15,17,35,14,12,2
15,17,36,18,16,2
15,17,37,16,19,-3
15,17,38,4,13,-9
15,17,39,23,29,-6
15,17,40,9,24,-15
15,17,41,20,19,1
15,17,42,20,19,1
15,17,43,16,21,-5
15,17,44,10,12,-2
15,17,45,17,23,-6
15,17,46,15,12,3
15,17,47,5,10,-5
15,17,48,16,14,2
15,17,49,16,16,0
15,17,50,6,1,5
15,17,51,15,15,0
15,17,52,23,18,5
15,17,53,15,32,-17
15,17,54,10,19,-9
15,17,55,10,16,-6
15,17,56,14,15,-1
15,17,57,18,20,-2
15,17,58,22,24,-2
15,17,59,9,26,-17
15,17,60,16,32,-16
15,17,61,19,18,1
15,17,62,17,21,-4
15,17,63,19,20,-1
15,17,64,21,24,-3
15,17,65,3,18,-15
15,17,66,8,8,0
15,17,67,15,13,2
15,17,68,13,25,-12
15,17,69,16,20,-4
15,17,70,13,31,-18
15,17,71,16,6,10
15,17,72,19,16,3
15,17,73,18,14,4
15,17,74,18,21,-3
15,17,75,19,7,12
15,17,76,10,18,-8
15,17,77,27,19,8
15,17,78,10,13,-3
15,17,79,12,14,-2
15,17,80,15,18,-3
15,17,81,5,3,2
15,17,82,17,29,-12
15,17,83,15,17,-2
15,17,84,18,24,-6
15,17,85,24,22,2
15,17,86,18,16,2
15,17,87,7,10,-3
15,17,88,11,14,-3
15,17,89,14,17,-3
15,17,90,9,21,-12
15,17,91,9,7,2
15,17,92,16,11,5
15,17,93,24,9,15
15,17,94,10,8,2
15,17,95,15,14,1
15,17,96,17,11,6
15,17,97,28,9,19
15,17,98,31,14,17
15,17,99,14,15,-1
15,17,100,16,19,-3
15,17,101,14,15,-1
15,17,102,20,22,-2
15,17,103,30,13,17
15,17,104,20,17,3
15,17,105,11,22,-11
15,17,106,9,13,-4
15,17,107,17,19,-2
15,17,108,12,19,-7
15,17,109,11,8,3
15,17,110,12,17,-5
15,17,111,18,12,6
15,17,112,8,7,1
15,17,113,12,16,-4
15,17,114,18,18,0
15,17,115,21,19,2
15,17,116,25,17,8
15,17,117,12,14,-2
15,17,118,14,22,-8
15,17,119,18,24,-6
15,17,120,15,12,3
15,17,121,8,7,1
15,17,122,14,10,4
15,17,123,13,13,0
15,17,124,15,9,6
15,17,125,12,9,3
15,17,126,12,10,2
15,17,127,8,11,-3
15,17,128,7,11,-4
15,17,129,14,11,3
15,17,130,25,11,14
15,17,131,13,9,4
15,17,132,8,11,-3
15,17,133,5,5,0
15,17,134,17,7,10
15,17,135,14,20,-6
15,17,136,20,12,8
15,17,137,12,19,-7
15,17,138,11,12,-1
15,17,139,15,19,-4
15,17,140,34,8,26
15,17,141,19,10,9
15,17,142,2,11,-9
15,17,143,13,12,1
15,17,144,12,15,-3
15,17,145,16,20,-4
15,17,146,14,10,4
15,17,147,18,14,4
15,17,148,6,24,-18
15,17,149,16,7,9
15,17,150,6,10,-4
15,17,151,14,20,-6
15,17,152,23,19,4
15,17,153,22,15,7
15,17,154,5,22,-17
15,17,155,20,24,-4
15,17,156,5,9,-4
15,17,157,27,17,10
15,17,158,15,11,4
15,17,159,17,19,-2
15,17,160,17,26,-9
15,17,161,10,21,-11
15,17,162,13,12,1
15,17,163,14,11,3
15,17,164,16,12,4
15,17,165,14,15,-1
15,17,166,22,9,13
15,17,167,8,13,-5
15,17,168,14,10,4
15,17,169,12,15,-3
15,17,170,15,5,10
15,17,171,15,13,2
15,17,172,19,17,2
15,17,173,23,14,9
15,17,174,20,15,5
15,17,175,23,14,9
15,17,176,17,9,8
15,17,177,13,11,2
15,17,178,8,16,-8
15,17,179,12,8,4
15,17,180,14,18,-4
15,17,181,17,8,9
15,17,182,15,19,-4
15,17,183,3,10,-7
15,17,184,26,16,10
15,17,185,13,18,-5
15,17,186,24,26,-2
15,17,187,18,16,2
15,17,188,21,17,4
15,17,189,10,20,-10
15,17,190,12,6,6
15,17,191,18,16,2
15,17,192,7,13,-6
15,17,193,26,28,-2
15,17,194,12,11,1
15,17,195,10,15,-5
15,17,196,12,3,9
15,17,197,19,24,-5
15,17,198,22,9,13
15,17,199,18,20,-2
15,17,200,9,8,1
15,17,201,20,16,4
15,17,202,11,32,-21
15,17,203,15,8,7
15,17,204,20,10,10
15,17,205,15,6,9
15,17,206,9,13,-4
15,17,207,23,20,3
15,17,208,11,13,-2
15,17,209,14,16,-2
15,17,210,15,17,-2
15,17,211,26,19,7
15,17,212,7,5,2
15,17,213,13,23,-10
15,17,214,7,10,-3
15,17,215,19,12,7
15,17,216,17,14,3
15,17,217,6,17,-11
15,17,218,22,15,7
15,17,219,15,11,4
15,17,220,12,13,-1
15,17,221,16,15,1
15,17,222,10,18,-8
15,17,223,11,16,-5
15,17,224,6,11,-5
15,17,225,5,14,-9
15,17,226,14,13,1
15,17,227,11,11,0
15,17,228,8,10,-2
15,17,229,12,18,-6
15,17,230,12,11,1
15,17,231,15,20,-5
15,17,232,17,22,-5
15,17,233,17,7,10
15,17,234,11,18,-7
15,17,235,15,12,3
15,17,236,6,9,-3
15,17,237,12,23,-11
15,17,238,6,7,-1
15,17,239,13,22,-9
15,17,240,13,11,2
15,17,241,15,12,3
15,17,242,15,11,4
15,17,243,24,21,3
15,17,244,4,16,-12
15,17,245,9,21,-12
15,17,246,31,14,17
15,17,247,24,11,13
15,17,248,11,9,2
15,17,249,28,21,7
15,17,250,10,4,6
15,17,251,13,20,-7
15,17,252,12,20,-8
15,17,253,14,20,-6
15,17,254,17,14,3
15,17,255,18,17,1
15,17,256,22,7,15
15,17,257,11,8,3
15,17,258,8,18,-10
15,17,259,19,28,-9
15,17,260,23,18,5
15,17,261,29,19,10
15,17,262,5,8,-3
15,17,263,7,18,-11
15,17,264,4,23,-19
15,17,265,15,8,7
15,17,266,4,17,-13
15,17,267,13,17,-4
15,17,268,15,13,2
15,17,269,15,8,7
15,17,270,13,12,1
15,17,271,20,28,-8
15,17,272,8,13,-5
15,17,273,13,18,-5
15,17,274,2,11,-9
15,17,275,15,14,1
15,17,276,13,17,-4
15,17,277,18,25,-7
15,17,278,13,6,7
15,17,279,14,17,-3
15,17,280,17,6,11
15,17,281,12,12,0
15,17,282,14,16,-2
15,17,283,10,12,-2
15,17,284,19,14,5
15,17,285,19,25,-6
15,17,286,16,16,0
15,17,287,23,13,10
15,17,288,16,10,6
15,17,289,14,11,3
15,17,290,12,14,-2
15,17,291,18,17,1
15,17,292,2,7,-5
15,17,293,19,11,8
15,17,294,16,22,-6
15,17,295,20,13,7
15,17,296,16,5,11
15,17,297,21,20,1
15,17,298,11,2,9
15,17,299,23,18,5
15,18,0,10,5,5
15,18,1,11,21,-10
15,18,2,20,15,5
15,18,3,18,24,-6
15,18,4,20,24,-4
15,18,5,13,7,6
15,18,6,17,8,9
15,18,7,11,14,-3
15,18,8,22,30,-8
15,18,9,13,25,-12
15,18,10,19,21,-2
15,18,11,12,12,0
15,18,12,9,22,-13
15,18,13,25,14,11
15,18,14,26,9,17
15,18,15,21,15,6
15,18,16,9,13,-4
15,18,17,20,16,4
15,18,18,16,15,1
15,18,19,21,23,-2
15,18,20,10,7,3
15,18,21,7,3,4
15,18,22,24,10,14
15,18,23,21,12,9
15,18,24,33,18,15
15,18,25,7,15,-8
15,18,26,19,15,4
15,18,27,22,27,-5
15,18,28,23,17,6
15,18,29,6,5,1
15,18,30,15,6,9
15,18,31,16,19,-3
15,18,32,21,2,19
15,18,33,12,9,3
15,18,34,8,20,-12
15,18,35,22,15,7
15,18,36,10,13,-3
15,18,37,19,17,2
15,18,38,23,18,5
15,18,39,9,14,-5
15,18,40,12,22,-10
15,18,41,12,16,-4
15,18,42,16,10,6
15,18,43,14,11,3
15,18,44,8,14,-6
15,18,45,11,12,-1
15,18,46,14,5,9
15,18,47,8,8,0
15,18,48,17,12,5
15,18,49,17,11,6
15,18,50,12,17,-5
15,18,51,18,16,2
15,18,52,27,12,15
15,18,53,26,23,3
15,18,54,16,25,-9
15,18,55,16,22,-6
15,18,56,7,14,-7
15,18,57,15,12,3
15,18,58,10,17,-7
15,18,59,23,10,13
15,18,60,14,9,5
15,18,61,12,18,-6
15,18,62,11,14,-3
15,18,63,17,14,3
15,18,64,8,17,-9
15,18,65,23,14,9
15,18,66,7,15,-8
15,18,67,9,4,5
15,18,68,15,11,4
15,18,69,23,17,6
15,18,70,14,16,-2
15,18,71,22,14,8
15,18,72,16,19,-3
15,18,73,17,11,6
15,18,74,14,19,-5
15,18,75,25,28,-3
15,18,76,14,9,5
15,18,77,16,8,8
15,18,78,19,14,5
15,18,79,22,13,9
15,18,80,9,9,0
15,18,81,21,21,0
15,18,82,29,26,3
15,18,83,21,4,17
15,18,84,13,17,-4
15,18,85,9,14,-5
15,18,86,19,16,3
15,18,87,23,19,4
15,18,88,7,11,-4
15,18,89,19,13,6
15,18,90,21,12,9
15,18,91,14,12,2
15,18,92,10,11,-1
15,18,93,38,17,21
15,18,94,14,11,3
15,18,95,22,25,-3
15,18,96,17,7,10
15,18,97,14,17,-3
15,18,98,14,24,-10
15,18,99,11,0,11
15,18,100,17,20,-3
15,18,101,11,17,-6
15,18,102,10,20,-10
15,18,103,23,20,3
15,18,104,16,23,-7
15,18,105,13,14,-1
15,18,106,11,14,-3
15,18,107,14,22,-8
15,18,108,19,13,6
15,18,109,18,35,-17
15,18,110,20,16,4
15,18,111,21,10,11
15,18,112,10,3,7
15,18,113,15,16,-1
15,18,114,15,20,-5
15,18,115,18,4,14
15,18,116,20,12,8
15,18,117,8,9,-1
15,18,118,19,10,9
15,18,119,19,17,2
15,18,120,17,14,3
15,18,121,8,11,-3
15,18,122,21,14,7
15,18,123,28,13,15
15,18,124,19,16,3
15,18,125,22,5,17
15,18,126,8,9,-1
15,18,127,18,8,10
15,18,128,12,22,-10
15,18,129,9,28,-19
15,18,130,12,16,-4
15,18,131,27,8,19
15,18,132,20,11,9
15,18,133,31,10,21
15,18,134,8,18,-10
15,18,135,13,12,1
15,18,136,8,4,4
15,18,137,18,11,7
15,18,138,9,5,4
15,18,139,13,12,1
15,18,140,15,22,-7
15,18,141,12,10,2
15,18,142,8,9,-1
15,18,143,16,19,-3
15,18,144,10,12,-2
15,18,145,10,14,-4
15,18,146,10,8,2
15,18,147,13,10,3
15,18,148,15,16,-1
15,18,149,7,18,-11
15,18,150,24,13,11
15,18,151,16,11,5
15,18,152,21,17,4
15,18,153,12,22,-10
15,18,154,10,15,-5
15,18,155,18,11,7
15,18,156,15,11,4
15,18,157,15,17,-2
15,18,158,21,17,4
15,18,159,14,21,-7
15,18,160,16,16,0
15,18,161,18,10,8
15,18,162,17,12,5
15,18,163,12,9,3
15,18,164,22,15,7
15,18,165,9,11,-2
15,18,166,14,23,-9
15,18,167,15,18,-3
15,18,168,16,9,7
15,18,169,10,9,1
15,18,170,19,15,4
15,18,171,22,21,1
15,18,172,16,11,5
15,18,173,16,5,11
15,18,174,9,8,1
15,18,175,17,16,1
15,18,176,20,16,4
15,18,177,17,6,11
15,18,178,13,6,7
15,18,179,10,8,2
15,18,180,17,16,1
15,18,181,20,18,2
15,18,182,10,33,-23
15,18,183,13,15,-2
15,18,184,19,18,1
15,18,185,15,13,2
15,18,186,11,8,3
15,18,187,12,10,2
15,18,188,11,6,5
15,18,189,16,15,1
15,18,190,8,18,-10
15,18,191,21,13,8
15,18,192,16,18,-2
15,18,193,13,18,-5
15,18,194,12,19,-7
15,18,195,7,13,-6
15,18,196,16,9,7
15,18,197,20,24,-4
15,18,198,20,11,9
15,18,199,18,19,-1
15,18,200,14,17,-3
15,18,201,25,17,8
15,18,202,25,17,8
15,18,203,15,7,8
15,18,204,11,22,-11
15,18,205,12,11,1
15,18,206,24,22,2
15,18,207,24,11,13
15,18,208,8,11,-3
15,18,209,19,12,7
15,18,210,12,20,-8
15,18,211,7,18,-11
15,18,212,19,19,0
15,18,213,14,24,-10
15,18,214,17,15,2
15,18,215,18,13,5
15,18,216,5,11,-6
15,18,217,7,11,-4
15,18,218,13,17,-4
15,18,219,12,18,-6
15,18,220,5,7,-2
15,18,221,13,14,-1
15,18,222,27,18,9
15,18,223,8,19,-11
15,18,224,3,4,-1
15,18,225,12,9,3
15,18,226,14,11,3
15,18,227,23,12,11
15,18,228,9,26,-17
15,18,229,11,19,-8
15,18,230,23,16,7
15,18,231,11,13,-2
15,18,232,19,14,5
15,18,233,22,11,11
15,18,234,18,6,12
15,18,235,15,20,-5
15,18,236,13,11,2
15,18,237,14,11,3
15,18,238,8,28,-20
15,18,239,9,13,-4
15,18,240,14,24,-10
15,18,241,17,21,-4
15,18,242,9,8,1
15,18,243,15,6,9
15,18,244,14,9,5
15,18,245,21,10,11
15,18,246,21,25,-4
15,18,247,7,13,-6
15,18,248,17,14,3
15,18,249,13,14,-1
15,18,250,12,13,-1
15,18,251,14,15,-1
15,18,252,12,14,-2
15,18,253,10,12,-2
15,18,254,17,9,8
15,18,255,4,3,1
15,18,256,11,25,-14
15,18,257,12,28,-16
15,18,258,15,12,3
15,18,259,14,4,10
15,18,260,15,12,3
15,18,261,21,19,2
15,18,262,11,9,2
15,18,263,10,10,0
15,18,264,14,5,9
15,18,265,10,4,6
15,18,266,19,17,2
15,18,267,17,16,1
15,18,268,8,11,-3
15,18,269,30,18,12
15,18,270,19,16,3
15,18,271,16,22,-6
15,18,272,5,5,0
15,18,273,13,14,-1
15,18,274,21,19,2
15,18,275,8,16,-8
15,18,276,18,11,7
15,18,277,19,13,6
15,18,278,29,13,16
15,18,279,18,10,8
15,18,280,19,15,4
15,18,281,13,21,-8
15,18,282,9,9,0
15,18,283,20,19,1
15,18,284,17,12,5
15,18,285,17,9,8
15,18,286,11,16,-5
15,18,287,13,16,-3
15,18,288,19,19,0
15,18,289,20,16,4
15,18,290,12,16,-4
15,18,291,19,19,0
15,18,292,12,10,2
15,18,293,21,12,9
15,18,294,11,14,-3
15,18,295,15,18,-3
15,18,296,20,17,3
15,18,297,6,12,-6
15,18,298,21,26,-5
15,18,299,17,17,0
15,19,0,19,13,6
15,19,1,12,8,4
15,19,2,21,27,-6
15,19,3,24,21,3
15,19,4,12,18,-6
15,19,5,19,10,9
15,19,6,22,18,4
15,19,7,10,12,-2
15,19,8,10,13,-3
15,19,9,11,7,4
15,19,10,18,17,1
15,19,11,14,11,3
15,19,12,18,10,8
15,19,13,8,14,-6
15,19,14,12,12,0
15,19,15,18,23,-5
15,19,16,10,9,1
15,19,17,15,11,4
15,19,18,21,18,3
15,19,19,10,4,6
15,19,20,13,17,-4
15,19,21,9,16,-7
15,19,22,14,20,-6
15,19,23,13,35,-22
15,19,24,12,27,-15
15,19,25,11,9,2
15,19,26,26,11,15
15,19,27,15,15,0
15,19,28,18,17,1
15,19,29,9,13,-4
15,19,30,11,18,-7
15,19,31,17,6,11
15,19,32,11,8,3
15,19,33,16,9,7
15,19,34,22,23,-1
15,19,35,24,8,16
15,19,36,17,18,-1
15,19,37,15,17,-2
15,19,38,20,20,0
15,19,39,8,12,-4
15,19,40,23,17,6
15,19,41,16,23,-7
15,19,42,29,16,13
15,19,43,19,16,3
15,19,44,14,9,5
15,19,45,14,15,-1
15,19,46,21,22,-1
15,19,47,13,25,-12
15,19,48,3,10,-7
15,19,49,10,12,-2
15,19,50,35,18,17
15,19,51,11,19,-8
15,19,52,10,14,-4
15,19,53,19,14,5
15,19,54,27,26,1
15,19,55,13,13,0
15,19,56,22,28,-6
15,19,57,19,16,3
15,19,58,9,13,-4
15,19,59,18,11,7
15,19,60,6,14,-8
15,19,61,15,19,-4
15,19,62,18,20,-2
15,19,63,10,19,-9
15,19,64,12,16,-4
15,19,65,18,25,-7
15,19,66,19,10,9
15,19,67,40,17,23
15,19,68,18,3,15
15,19,69,20,23,-3
15,19,70,22,24,-2
15,19,71,29,11,18
15,19,72,9,24,-15
15,19,73,13,11,2
15,19,74,11,12,-1
15,19,75,12,17,-5
15,19,76,17,15,2
15,19,77,25,13,12
15,19,78,18,18,0
15,19,79,22,22,0
15,19,80,14,10,4
15,19,81,33,18,15
15,19,82,18,6,12
15,19,83,15,20,-5
15,19,84,18,22,-4
15,19,85,15,19,-4
15,19,86,18,24,-6
15,19,87,6,13,-7
15,19,88,15,3,12
15,19,89,9,9,0
15,19,90,16,17,-1
15,19,91,15,15,0
15,19,92,10,21,-11
15,19,93,26,9,17
15,19,94,13,16,-3
15,19,95,11,16,-5
15,19,96,16,13,3
15,19,97,16,11,5
15,19,98,19,14,5
15,19,99,15,12,3
15,19,100,15,20,-5
15,19,101,11,14,-3
15,19,102,20,7,13
15,19,103,13,13,0
15,19,104,14,16,-2
15,19,105,15,19,-4
15,19,106,37,10,27
15,19,107,13,15,-2
15,19,108,14,15,-1
15,19,109,21,7,14
15,19,110,20,25,-5
15,19,111,23,5,18
15,19,112,18,18,0
15,19,113,17,20,-3
15,19,114,21,9,12
15,19,115,13,11,2
15,19,116,17,17,0
15,19,117,24,10,14
15,19,118,24,12,12
15,19,119,7,23,-16
15,19,120,12,21,-9
15,19,121,15,25,-10
15,19,122,10,10,0
15,19,123,21,9,12
15,19,124,27,32,-5
15,19,125,11,8,3
15,19,126,9,14,-5
15,19,127,11,2,9
15,19,128,22,10,12
15,19,129,14,17,-3
15,19,130,21,18,3
15,19,131,21,24,-3
15,19,132,9,10,-1
15,19,133,17,22,-5
15,19,134,9,13,-4
15,19,135,7,8,-1
15,19,136,24,13,11
15,19,137,41,17,24
15,19,138,12,12,0
15,19,139,18,14,4
15,19,140,16,17,-1
15,19,141,11,16,-5
15,19,142,27,10,17
15,19,143,11,11,0
15,19,144,11,13,-2
15,19,145,8,13,-5
15,19,146,21,12,9
15,19,147,8,10,-2
15,19,148,20,34,-14
15,19,149,10,17,-7
15,19,150,9,11,-2
15,19,151,13,17,-4
15,19,152,10,14,-4
15,19,153,10,8,2
15,19,154,21,21,0
15,19,155,21,14,7
15,19,156,15,19,-4
15,19,157,7,17,-10
15,19,158,18,16,2
15,19,159,24,23,1
15,19,160,13,17,-4
15,19,161,10,9,1
15,19,162,15,15,0
15,19,163,9,8,1
15,19,164,6,9,-3
15,19,165,9,7,2
15,19,166,16,11,5
15,19,167,5,11,-6
15,19,168,13,20,-7
15,19,169,20,16,4
15,19,170,18,19,-1
15,19,171,12,17,-5
15,19,172,15,10,5
15,19,173,11,30,-19
15,19,174,13,24,-11
15,19,175,24,17,7
15,19,176,12,9,3
15,19,177,16,14,2
15,19,178,19,22,-3
15,19,179,11,11,0
15,19,180,19,18,1
15,19,181,14,17,-3
15,19,182,17,11,6
15,19,183,13,17,-4
15,19,184,16,17,-1
15,19,185,13,14,-1
15,19,186,20,21,-1
15,19,187,18,5,13
15,19,188,10,11,-1
15,19,189,16,13,3
15,19,190,8,15,-7
15,19,191,15,11,4
15,19,192,26,22,4
15,19,193,14,20,-6
15,19,194,2,8,-6
15,19,195,9,14,-5
15,19,196,16,18,-2
15,19,197,11,14,-3
15,19,198,19,21,-2
15,19,199,20,28,-8
15,19,200,34,13,21
15,19,201,18,23,-5
15,19,202,10,28,-18
15,19,203,21,4,17
15,19,204,20,14,6
15,19,205,7,11,-4
15,19,206,14,18,-4
15,19,207,14,20,-6
15,19,208,18,20,-2
15,19,209,9,21,-12
15,19,210,20,20,0
15,19,211,23,29,-6
15,19,212,11,4,7
15,19,213,16,12,4
15,19,214,20,9,11
15,19,215,23,23,0
15,19,216,20,23,-3
15,19,217,12,11,1
15,19,218,39,18,21
15,19,219,23,16,7
15,19,220,17,13,4
15,19,221,13,13,0
15,19,222,8,5,3
15,19,223,11,8,3
15,19,224,20,11,9
15,19,225,11,8,3
15,19,226,10,17,-7
15,19,227,11,9,2
15,19,228,17,28,-11
15,19,229,37,16,21
15,19,230,15,4,11
15,19,231,18,15,3
15,19,232,20,12,8
15,19,233,22,20,2
15,19,234,30,23,7
15,19,235,21,20,1
15,19,236,18,11,7
15,19,237,14,16,-2
15,19,238,26,19,7
15,19,239,13,12,1
15,19,240,9,5,4
15,19,241,20,14,6
15,19,242,17,18,-1
15,19,243,19,11,8
15,19,244,8,15,-7
15,19,245,14,25,-11
15,19,246,18,19,-1
15,19,247,16,16,0
15,19,248,21,19,2
15,19,249,7,17,-10
15,19,250,10,17,-7
15,19,251,12,8,4
15,19,252,28,14,14
15,19,253,16,19,-3
15,19,254,19,18,1
15,19,255,19,8,11
15,19,256,5,14,-9
15,19,257,20,14,6
15,19,258,9,21,-12
15,19,259,21,9,12
15,19,260,18,12,6
15,19,261,25,23,2
15,19,262,22,20,2
15,19,263,20,19,1
15,19,264,6,18,-12
15,19,265,13,14,-1
15,19,266,20,18,2
15,19,267,20,23,-3
15,19,268,11,11,0
15,19,269,9,6,3
15,19,270,13,18,-5
15,19,271,7,15,-8
15,19,272,17,23,-6
15,19,273,20,14,6
15,19,274,24,11,13
15,19,275,17,18,-1
15,19,276,16,8,8
15,19,277,20,8,12
15,19,278,15,12,3
15,19,279,14,17,-3
15,19,280,25,16,9
15,19,281,9,9,0
15,19,282,17,10,7
15,19,283,20,19,1
15,19,284,20,16,4
15,19,285,14,8,6
15,19,286,26,21,5
15,19,287,12,14,-2
15,19,288,8,9,-1
15,19,289,18,13,5
15,19,290,9,9,0
15,19,291,16,19,-3
15,19,292,15,13,2
15,19,293,8,11,-3
15,19,294,21,12,9
15,19,295,21,28,-7
15,19,296,20,10,10
15,19,297,17,24,-7
15,19,298,9,8,1
15,19,299,21,16,5
15,20,0,18,3,15
15,20,1,12,3,9
15,20,2,23,20,3
15,20,3,18,19,-1
15,20,4,18,22,-4
15,20,5,17,17,0
15,20,6,11,10,1
15,20,7,24,16,8
15,20,8,26,9,17
15,20,9,4,11,-7
15,20,10,16,7,9
15,20,11,9,17,-8
15,20,12,15,15,0
15,20,13,9,6,3
15,20,14,11,5,6
15,20,15,8,25,-17
15,20,16,17,14,3
15,20,17,9,9,0
15,20,18,20,19,1
15,20,19,20,10,10
15,20,20,16,10,6
15,20,21,24,15,9
15,20,22,14,24,-10
15,20,23,14,12,2
15,20,24,23,23,0
15,20,25,8,21,-13
15,20,26,9,22,-13
15,20,27,18,13,5
15,20,28,12,11,1
15,20,29,20,11,9
15,20,30,19,12,7
15,20,31,21,18,3
15,20,32,26,15,11
15,20,33,18,19,-1
15,20,34,26,25,1
15,20,35,20,22,-2
15,20,36,12,19,-7
15,20,37,12,11,1
15,20,38,11,9,2
15,20,39,8,26,-18
15,20,40,9,15,-6
15,20,41,15,15,0
15,20,42,11,15,-4
15,20,43,21,30,-9
15,20,44,10,13,-3
15,20,45,7,17,-10
15,20,46,17,10,7
15,20,47,17,12,5
15,20,48,9,9,0
15,20,49,23,14,9
15,20,50,10,14,-4
15,20,51,23,12,11
15,20,52,12,30,-18
15,20,53,14,11,3
15,20,54,7,6,1
15,20,55,25,19,6
15,20,56,13,9,4
15,20,57,16,21,-5
15,20,58,8,11,-3
15,20,59,23,17,6
15,20,60,21,22,-1
15,20,61,6,16,-10
15,20,62,17,22,-5
15,20,63,34,23,11
15,20,64,13,23,-10
15,20,65,11,8,3
15,20,66,21,17,4
15,20,67,29,18,11
15,20,68,26,19,7
15,20,69,17,18,-1
15,20,70,23,19,4
15,20,71,26,18,8
15,20,72,20,15,5
15,20,73,17,3,14
15,20,74,15,23,-8
15,20,75,5,9,-4
15,20,76,14,21,-7
15,20,77,16,3,13
15,20,78,14,16,-2
15,20,79,4,13,-9
15,20,80,11,8,3
15,20,81,10,13,-3
15,20,82,21,17,4
15,20,83,16,14,2
15,20,84,10,12,-2
15,20,85,24,15,9
15,20,86,7,19,-12
15,20,87,25,14,11
15,20,88,6,13,-7
15,20,89,10,18,-8
15,20,90,5,11,-6
15,20,91,14,29,-15
15,20,92,13,6,7
15,20,93,9,12,-3
15,20,94,20,17,3
15,20,95,21,12,9
15,20,96,18,14,4
15,20,97,12,25,-13
15,20,98,5,12,-7
15,20,99,11,11,0
15,20,100,15,25,-10
15,20,101,5,13,-8
15,20,102,9,18,-9
15,20,103,16,23,-7
15,20,104,10,15,-5
15,20,105,22,24,-2
15,20,106,15,12,3
15,20,107,21,12,9
15,20,108,15,22,-7
15,20,109,15,22,-7
15,20,110,10,10,0
15,20,111,17,11,6
15,20,112,3,11,-8
15,20,113,10,14,-4
15,20,114,12,12,0
15,20,115,5,20,-15
15,20,116,8,14,-6
15,20,117,13,18,-5
15,20,118,9,14,-5
15,20,119,24,16,8
15,20,120,33,15,18
15,20,121,14,10,4
15,20,122,28,8,20
15,20,123,8,18,-10
15,20,124,17,13,4
15,20,125,10,18,-8
15,20,126,13,13,0
15,20,127,11,8,3
15,20,128,8,13,-5
15,20,129,21,29,-8
15,20,130,12,15,-3
15,20,131,3,21,-18
15,20,132,8,2,6
15,20,133,18,13,5
15,20,134,10,11,-1
15,20,135,13,22,-9
15,20,136,22,13,9
15,20,137,21,11,10
15,20,138,21,24,-3
15,20,139,17,29,-12
15,20,140,21,9,12
15,20,141,11,12,-1
15,20,142,19,10,9
15,20,143,24,11,13
15,20,144,10,9,1
15,20,145,30,22,8
15,20,146,20,13,7
15,20,147,23,25,-2
15,20,148,13,12,1
15,20,149,10,8,2
15,20,150,9,12,-3
15,20,151,22,20,2
15,20,152,13,10,3
15,20,153,18,11,7
15,20,154,14,7,7
15,20,155,25,28,-3
15,20,156,15,17,-2
15,20,157,28,23,5
15,20,158,12,16,-4
15,20,159,7,9,-2
15,20,160,20,10,10
15,20,161,22,27,-5
15,20,162,21,11,10
15,20,163,10,17,-7
15,20,164,10,9,1
15,20,165,14,19,-5
15,20,166,22,18,4
15,20,167,22,14,8
15,20,168,19,13,6
15,20,169,16,24,-8
15,20,170,4,11,-7
15,20,171,18,12,6
15,20,172,16,16,0
15,20,173,22,19,3
15,20,174,15,5,10
15,20,175,12,9,3
15,20,176,22,19,3
15,20,177,5,4,1
15,20,178,9,14,-5
15,20,179,11,16,-5
15,20,180,16,28,-12
15,20,181,22,19,3
15,20,182,20,10,10
15,20,183,18,15,3
15,20,184,19,8,11
15,20,185,13,9,4
15,20,186,16,22,-6
15,20,187,27,15,12
15,20,188,17,12,5
15,20,189,15,13,2
15,20,190,14,3,11
15,20,191,6,13,-7
15,20,192,29,16,13
15,20,193,23,16,7
15,20,194,12,9,3
15,20,195,8,19,-11
15,20,196,22,21,1
15,20,197,16,12,4
15,20,198,7,8,-1
15,20,199,6,16,-10
15,20,200,16,11,5
15,20,201,13,15,-2
15,20,202,18,11,7
15,20,203,17,31,-14
15,20,204,20,12,8
15,20,205,7,19,-12
15,20,206,11,10,1
15,20,207,9,9,0
15,20,208,21,17,4
15,20,209,12,25,-13
15,20,210,14,14,0
15,20,211,21,12,9
15,20,212,20,15,5
15,20,213,10,13,-3
15,20,214,13,9,4
15,20,215,13,17,-4
15,20,216,7,17,-10
15,20,217,10,13,-3
15,20,218,10,14,-4
15,20,219,10,14,-4
15,20,220,20,11,9
15,20,221,11,8,3
15,20,222,9,8,1
15,20,223,24,15,9
15,20,224,5,5,0
15,20,225,10,9,1
15,20,226,17,13,4
15,20,227,20,14,6
15,20,228,18,9,9
15,20,229,10,11,-1
15,20,230,22,16,6
15,20,231,21,18,3
15,20,232,12,22,-10
15,20,233,19,14,5
15,20,234,18,14,4
15,20,235,6,6,0
15,20,236,13,14,-1
15,20,237,19,7,12
15,20,238,6,13,-7
15,20,239,6,2,4
15,20,240,19,12,7
15,20,241,18,13,5
15,20,242,14,11,3
15,20,243,12,30,-18
15,20,244,13,14,-1
15,20,245,19,16,3
15,20,246,26,17,9
15,20,247,10,11,-1
15,20,248,15,13,2
15,20,249,19,6,13
15,20,250,27,15,12
15,20,251,25,26,-1
15,20,252,17,20,-3
15,20,253,13,9,4
15,20,254,17,13,4
15,20,255,16,23,-7
15,20,256,13,12,1
15,20,257,7,6,1
15,20,258,10,6,4
15,20,259,15,19,-4
15,20,260,15,29,-14
15,20,261,6,10,-4
15,20,262,10,8,2
15,20,263,22,18,4
15,20,264,18,20,-2
15,20,265,19,5,14
15,20,266,16,9,7
15,20,267,16,13,3
15,20,268,28,24,4
15,20,269,22,21,1
15,20,270,12,9,3
15,20,271,23,11,12
15,20,272,19,27,-8
15,20,273,22,15,7
15,20,274,28,22,6
15,20,275,24,11,13
15,20,276,6,16,-10
15,20,277,9,3,6
15,20,278,19,21,-2
15,20,279,14,10,4
15,20,280,21,15,6
15,20,281,16,7,9
15,20,282,16,2,14
15,20,283,17,10,7
15,20,284,19,21,-2
15,20,285,13,13,0
15,20,286,10,6,4
15,20,287,13,14,-1
15,20,288,20,29,-9
15,20,289,21,14,7
15,20,290,11,8,3
15,20,291,6,16,-10
15,20,292,13,15,-2
15,20,293,21,27,-6
15,20,294,29,21,8
15,20,295,24,23,1
15,20,296,11,16,-5
15,20,297,20,11,9
15,20,298,25,23,2
15,20,299,14,18,-4
15,21,0,6,18,-12
15,21,1,29,17,12
15,21,2,17,19,-2
15,21,3,5,7,-2
15,21,4,18,24,-6
15,21,5,11,18,-7
15,21,6,23,10,13
15,21,7,9,14,-5
15,21,8,20,16,4
15,21,9,17,14,3
15,21,10,21,15,6
15,21,11,32,19,13
15,21,12,13,15,-2
15,21,13,17,24,-7
15,21,14,16,5,11
15,21,15,17,8,9
15,21,16,40,19,21
15,21,17,8,5,3
15,21,18,14,14,0
15,21,19,15,16,-1
15,21,20,11,5,6
15,21,21,34,25,9
15,21,22,16,10,6
15,21,23,11,23,-12
15,21,24,18,11,7
15,21,25,17,24,-7
15,21,26,22,19,3
15,21,27,8,14,-6
15,21,28,12,11,1
15,21,29,20,16,4
15,21,30,24,17,7
15,21,31,14,6,8
15,21,32,12,10,2
15,21,33,18,13,5
15,21,34,7,20,-13
15,21,35,21,13,8
15,21,36,21,11,10
15,21,37,9,10,-1
15,21,38,30,8,22
15,21,39,14,20,-6
15,21,40,25,14,11
15,21,41,11,12,-1
15,21,42,19,9,10
15,21,43,27,6,21
15,21,44,25,13,12
15,21,45,9,8,1
15,21,46,14,17,-3
15,21,47,14,13,1
15,21,48,11,12,-1
15,21,49,12,11,1
15,21,50,15,18,-3
15,21,51,16,20,-4
15,21,52,26,16,10
15,21,53,24,11,13
15,21,54,16,12,4
15,21,55,9,10,-1
15,21,56,13,26,-13
15,21,57,18,22,-4
15,21,58,9,7,2
15,21,59,11,11,0
15,21,60,22,19,3
15,21,61,10,11,-1
15,21,62,10,13,-3
15,21,63,15,13,2
15,21,64,9,10,-1
15,21,65,20,13,7
15,21,66,22,16,6
15,21,67,18,16,2
15,21,68,25,37,-12
15,21,69,13,17,-4
15,21,70,21,22,-1
15,21,71,12,15,-3
15,21,72,17,11,6
15,21,73,14,16,-2
15,21,74,10,4,6
15,21,75,15,22,-7
15,21,76,15,14,1
15,21,77,3,28,-25
15,21,78,26,11,15
15,21,79,18,15,3
15,21,80,8,10,-2
15,21,81,17,13,4
15,21,82,10,9,1
15,21,83,10,9,1
15,21,84,27,16,11
15,21,85,19,11,8
15,21,86,20,14,6
15,21,87,14,13,1
15,21,88,24,18,6
15,21,89,14,9,5
15,21,90,9,7,2
15,21,91,8,19,-11
15,21,92,10,6,4
15,21,93,16,31,-15
15,21,94,19,18,1
15,21,95,16,27,-11
15,21,96,8,9,-1
15,21,97,17,9,8
15,21,98,2,13,-11
15,21,99,19,18,1
15,21,100,14,20,-6
15,21,101,7,8,-1
15,21,102,16,22,-6
15,21,103,8,19,-11
15,21,104,14,15,-1
15,21,105,22,13,9
15,21,106,19,17,2
15,21,107,12,14,-2
15,21,108,17,10,7
15,21,109,16,15,1
15,21,110,8,17,-9
15,21,111,19,28,-9
15,21,112,13,19,-6
15,21,113,14,9,5
15,21,114,14,21,-7
15,21,115,9,20,-11
15,21,116,27,20,7
15,21,117,7,3,4
15,21,118,10,18,-8
15,21,119,8,7,1
15,21,120,16,12,4
15,21,121,24,21,3
15,21,122,17,9,8
15,21,123,11,19,-8
15,21,124,15,12,3
15,21,125,21,19,2
15,21,126,12,6,6
15,21,127,24,19,5
15,21,128,16,16,0
15,21,129,19,17,2
15,21,130,22,16,6
15,21,131,5,11,-6
15,21,132,21,9,12
15,21,133,11,18,-7
15,21,134,19,24,-5
15,21,135,16,23,-7
15,21,136,23,21,2
15,21,137,23,22,1
15,21,138,7,7,0
15,21,139,20,11,9
15,21,140,18,15,3
15,21,141,13,8,5
15,21,142,10,10,0
15,21,143,16,14,2
15,21,144,21,34,-13
15,21,145,24,13,11
15,21,146,19,15,4
15,21,147,17,11,6
15,21,148,13,9,4
15,21,149,8,11,-3
15,21,150,13,16,-3
15,21,151,13,20,-7
15,21,152,17,14,3
15,21,153,19,11,8
15,21,154,14,27,-13
15,21,155,16,18,-2
15,21,156,19,10,9
15,21,157,28,27,1
15,21,158,13,18,-5
15,21,159,25,23,2
15,21,160,11,8,3
15,21,161,19,18,1
15,21,162,15,10,5
15,21,163,7,1,6
15,21,164,21,10,11
15,21,165,18,7,11
15,21,166,13,13,0
15,21,167,14,9,5
15,21,168,18,11,7
15,21,169,18,17,1
15,21,170,10,17,-7
15,21,171,13,17,-4
15,21,172,6,9,-3
15,21,173,22,20,2
15,21,174,21,15,6
15,21,175,5,24,-19
15,21,176,15,10,5
15,21,177,23,17,6
15,21,178,23,16,7
15,21,179,23,4,19
15,21,180,16,6,10
15,21,181,17,13,4
15,21,182,19,15,4
15,21,183,7,5,2
15,21,184,21,19,2
15,21,185,11,12,-1
15,21,186,17,9,8
15,21,187,15,21,-6
15,21,188,20,8,12
15,21,189,4,12,-8
15,21,190,16,11,5
15,21,191,29,33,-4
15,21,192,18,6,12
15,21,193,14,14,0
15,21,194,10,15,-5
15,21,195,27,24,3
15,21,196,20,7,13
15,21,197,17,17,0
15,21,198,18,3,15
15,21,199,25,23,2
15,21,200,5,20,-15
15,21,201,23,11,12
15,21,202,18,15,3
15,21,203,25,14,11
15,21,204,20,22,-2
15,21,205,15,12,3
15,21,206,6,7,-1
15,21,207,28,27,1
15,21,208,7,5,2
15,21,209,11,23,-12
15,21,210,11,21,-10
15,21,211,11,14,-3
15,21,212,16,15,1
15,21,213,17,8,9
15,21,214,12,15,-3
15,21,215,14,11,3
15,21,216,9,8,1
15,21,217,6,13,-7
15,21,218,22,14,8
15,21,219,10,13,-3
15,21,220,16,16,0
15,21,221,13,16,-3
15,21,222,11,14,-3
15,21,223,15,19,-4
15,21,224,25,14,11
15,21,225,6,9,-3
15,21,226,11,7,4
15,21,227,12,4,8
15,21,228,12,15,-3
15,21,229,4,17,-13
15,21,230,11,6,5
15,21,231,20,9,11
15,21,232,16,5,11
15,21,233,16,21,-5
15,21,234,24,14,10
15,21,235,13,11,2
15,21,236,19,9,10
15,21,237,10,21,-11
15,21,238,23,22,1
15,21,239,24,14,10
15,21,240,21,16,5
15,21,241,20,22,-2
15,21,242,14,9,5
15,21,243,6,9,-3
15,21,244,10,18,-8
15,21,245,15,19,-4
15,21,246,13,18,-5
15,21,247,23,10,13
15,21,248,11,8,3
15,21,249,16,20,-4
15,21,250,10,16,-6
15,21,251,19,14,5
15,21,252,3,12,-9
15,21,253,29,10,19
15,21,254,12,18,-6
15,21,255,9,22,-13
15,21,256,6,9,-3
15,21,257,26,12,14
15,21,258,13,13,0
15,21,259,12,10,2
15,21,260,13,25,-12
15,21,261,19,18,1
15,21,262,23,15,8
15,21,263,16,21,-5
15,21,264,17,7,10
15,21,265,9,16,-7
15,21,266,6,8,-2
15,21,267,15,9,6
15,21,268,15,23,-8
15,21,269,18,18,0
15,21,270,10,10,0
15,21,271,16,12,4
15,21,272,14,18,-4
15,21,273,23,18,5
15,21,274,11,8,3
15,21,275,17,9,8
15,21,276,17,16,1
15,21,277,23,19,4
15,21,278,10,11,-1
15,21,279,19,11,8
15,21,280,16,13,3
15,21,281,16,14,2
15,21,282,18,24,-6
15,21,283,11,7,4
15,21,284,8,8,0
15,21,285,12,19,-7
15,21,286,15,10,5
15,21,287,10,5,5
15,21,288,18,18,0
15,21,289,19,21,-2
15,21,290,9,8,1
15,21,291,23,10,13
15,21,292,14,17,-3
15,21,293,13,13,0
15,21,294,16,13,3
15,21,295,14,17,-3
15,21,296,14,8,6
15,21,297,14,19,-5
15,21,298,10,12,-2
15,21,299,12,8,4
15,22,0,11,8,3
15,22,1,16,8,8
15,22,2,10,20,-10
15,22,3,9,9,0
15,22,4,10,8,2
15,22,5,16,16,0
15,22,6,25,14,11
15,22,7,11,16,-5
15,22,8,19,10,9
15,22,9,14,13,1
15,22,10,16,16,0
15,22,11,17,8,9
15,22,12,23,20,3
15,22,13,10,22,-12
15,22,14,17,17,0
15,22,15,14,16,-2
15,22,16,13,14,-1
15,22,17,17,22,-5
15,22,18,17,22,-5
15,22,19,28,12,16
15,22,20,8,11,-3
15,22,21,9,20,-11
15,22,22,11,8,3
15,22,23,16,10,6
15,22,24,11,8,3
15,22,25,26,15,11
15,22,26,11,8,3
15,22,27,17,8,9
15,22,28,14,17,-3
15,22,29,19,9,10
15,22,30,20,19,1
15,22,31,21,18,3
15,22,32,16,13,3
15,22,33,11,17,-6
15,22,34,21,15,6
15,22,35,15,10,5
15,22,36,15,6,9
15,22,37,12,4,8
15,22,38,7,4,3
15,22,39,16,11,5
15,22,40,23,22,1
15,22,41,14,21,-7
15,22,42,18,21,-3
15,22,43,21,25,-4
15,22,44,16,7,9
15,22,45,12,11,1
15,22,46,3,14,-11
15,22,47,12,16,-4
15,22,48,13,20,-7
15,22,49,18,14,4
15,22,50,23,13,10
15,22,51,8,2,6
15,22,52,23,15,8
15,22,53,28,10,18
15,22,54,17,8,9
15,22,55,24,15,9
15,22,56,15,7,8
15,22,57,22,6,16
15,22,58,27,18,9
15,22,59,14,8,6
15,22,60,18,8,10
15,22,61,13,14,-1
15,22,62,10,6,4
15,22,63,20,12,8
15,22,64,8,12,-4
15,22,65,13,25,-12
15,22,66,18,22,-4
15,22,67,7,5,2
15,22,68,24,19,5
15,22,69,14,26,-12
15,22,70,11,15,-4
15,22,71,14,11,3
15,22,72,16,12,4
15,22,73,5,8,-3
15,22,74,28,8,20
15,22,75,25,17,8
15,22,76,17,14,3
15,22,77,7,5,2
15,22,78,8,15,-7
15,22,79,11,15,-4
15,22,80,11,15,-4
15,22,81,19,8,11
15,22,82,13,21,-8
15,22,83,21,21,0
15,22,84,15,14,1
15,22,85,9,21,-12
15,22,86,8,18,-10
15,22,87,25,5,20
15,22,88,9,20,-11
15,22,89,12,16,-4
15,22,90,25,21,4
15,22,91,24,20,4
15,22,92,15,14,1
15,22,93,10,6,4
15,22,94,13,6,7
15,22,95,24,19,5
15,22,96,26,22,4
15,22,97,25,23,2
15,22,98,11,11,0
15,22,99,9,12,-3
15,22,100,12,12,0
15,22,101,13,14,-1
15,22,102,23,12,11
15,22,103,8,17,-9
15,22,104,10,19,-9
15,22,105,13,15,-2
15,22,106,8,10,-2
15,22,107,16,17,-1
15,22,108,25,11,14
15,22,109,17,18,-1
15,22,110,13,11,2
15,22,111,12,13,-1
15,22,112,22,22,0
15,22,113,8,14,-6
15,22,114,16,15,1
15,22,115,11,12,-1
15,22,116,20,18,2
15,22,117,9,8,1
15,22,118,12,19,-7
15,22,119,20,12,8
15,22,120,14,15,-1
15,22,121,12,17,-5
15,22,122,17,13,4
15,22,123,19,14,5
15,22,124,22,23,-1
15,22,125,25,17,8
15,22,126,9,9,0
15,22,127,23,16,7
15,22,128,12,7,5
15,22,129,17,11,6
15,22,130,11,16,-5
15,22,131,15,9,6
15,22,132,26,7,19
15,22,133,20,9,11
15,22,134,21,13,8
15,22,135,13,9,4
15,22,136,18,22,-4
15,22,137,22,8,14
15,22,138,6,6,0
15,22,139,31,17,14
15,22,140,20,26,-6
15,22,141,14,16,-2
15,22,142,18,16,2
15,22,143,12,17,-5
15,22,144,11,12,-1
15,22,145,14,15,-1
15,22,146,27,16,11
15,22,147,24,11,13
15,22,148,12,12,0
15,22,149,31,18,13
15,22,150,8,6,2
15,22,151,10,21,-11
15,22,152,22,14,8
15,22,153,17,13,4
15,22,154,13,16,-3
15,22,155,16,15,1
15,22,156,20,19,1
15,22,157,22,25,-3
15,22,158,23,20,3
15,22,159,15,10,5
15,22,160,10,10,0
15,22,161,17,14,3
15,22,162,18,27,-9
15,22,163,16,15,1
15,22,164,14,9,5
15,22,165,13,25,-12
15,22,166,23,18,5
15,22,167,12,12,0
15,22,168,9,6,3
15,22,169,9,5,4
15,22,170,14,21,-7
15,22,171,14,16,-2
15,22,172,21,6,15
15,22,173,24,13,11
15,22,174,11,15,-4
15,22,175,16,16,0
15,22,176,26,21,5
15,22,177,13,12,1
15,22,178,6,19,-13
15,22,179,16,11,5
15,22,180,21,13,8
15,22,181,26,22,4
15,22,182,15,7,8
15,22,183,12,18,-6
15,22,184,8,7,1
15,22,185,19,29,-10
15,22,186,10,30,-20
15,22,187,13,10,3
15,22,188,11,10,1
15,22,189,10,24,-14
15,22,190,2,5,-3
15,22,191,12,11,1
15,22,192,8,10,-2
15,22,193,10,18,-8
15,22,194,20,12,8
15,22,195,25,17,8
15,22,196,16,6,10
15,22,197,21,16,5
15,22,198,20,19,1
15,22,199,11,14,-3
15,22,200,6,9,-3
15,22,201,25,34,-9
15,22,202,19,14,5
15,22,203,9,22,-13
15,22,204,12,3,9
15,22,205,10,13,-3
15,22,206,16,12,4
15,22,207,9,6,3
15,22,208,20,13,7
15,22,209,18,20,-2
15,22,210,21,10,11
15,22,211,20,15,5
15,22,212,16,11,5
15,22,213,9,19,-10
15,22,214,14,13,1
15,22,215,32,18,14
15,22,216,24,14,10
15,22,217,13,11,2
15,22,218,30,16,14
15,22,219,19,14,5
15,22,220,15,12,3
15,22,221,13,15,-2
15,22,222,8,15,-7
15,22,223,29,16,13
15,22,224,21,22,-1
15,22,225,12,14,-2
15,22,226,16,19,-3
15,22,227,14,9,5
15,22,228,11,16,-5
15,22,229,14,9,5
15,22,230,11,10,1
15,22,231,25,29,-4
15,22,232,15,15,0
15,22,233,8,24,-16
15,22,234,27,24,3
15,22,235,23,10,13
15,22,236,27,28,-1
15,22,237,2,9,-7
15,22,238,14,13,1
15,22,239,9,6,3
15,22,240,15,11,4
15,22,241,11,12,-1
15,22,242,24,17,7
15,22,243,15,20,-5
15,22,244,11,13,-2
15,22,245,17,24,-7
15,22,246,6,4,2
15,22,247,12,0,12
15,22,248,10,5,5
15,22,249,9,5,4
15,22,250,8,10,-2
15,22,251,17,11,6
15,22,252,30,15,15
15,22,253,18,9,9
15,22,254,12,6,6
15,22,255,23,19,4
15,22,256,20,14,6
15,22,257,15,6,9
15,22,258,12,14,-2
15,22,259,24,22,2
15,22,260,12,13,-1
15,22,261,7,13,-6
15,22,262,25,27,-2
15,22,263,20,22,-2
15,22,264,16,15,1
15,22,265,16,16,0
15,22,266,26,24,2
15,22,267,18,19,-1
15,22,268,16,10,6
15,22,269,10,4,6
15,22,270,26,14,12
15,22,271,17,17,0
15,22,272,35,21,14
15,22,273,7,16,-9
15,22,274,6,7,-1
15,22,275,8,23,-15
15,22,276,18,8,10
15,22,277,25,9,16
15,22,278,11,12,-1
15,22,279,21,10,11
15,22,280,23,10,13
15,22,281,30,19,11
15,22,282,11,7,4
15,22,283,17,10,7
15,22,284,15,24,-9
15,22,285,24,27,-3
15,22,286,18,12,6
15,22,287,5,10,-5
15,22,288,14,14,0
15,22,289,23,18,5
15,22,290,19,6,13
15,22,291,21,21,0
15,22,292,26,30,-4
15,22,293,25,15,10
15,22,294,10,10,0
15,22,295,22,13,9
15,22,296,16,19,-3
15,22,297,20,17,3
15,22,298,8,10,-2
15,22,299,13,5,8
15,23,0,13,11,2
15,23,1,14,15,-1
15,23,2,14,12,2
15,23,3,17,25,-8
15,23,4,9,20,-11
15,23,5,14,15,-1
15,23,6,21,21,0
15,23,7,17,14,3
15,23,8,18,20,-2
15,23,9,16,12,4
15,23,10,8,8,0
15,23,11,20,21,-1
15,23,12,19,9,10
15,23,13,16,14,2
15,23,14,23,7,16
15,23,15,14,13,1
15,23,16,13,17,-4
15,23,17,17,11,6
15,23,18,29,27,2
15,23,19,26,9,17
15,23,20,11,15,-4
15,23,21,15,16,-1
15,23,22,23,10,13
15,23,23,12,8,4
15,23,24,13,9,4
15,23,25,26,21,5
15,23,26,10,8,2
15,23,27,23,22,1
15,23,28,16,18,-2
15,23,29,12,18,-6
15,23,30,12,7,5
15,23,31,9,12,-3
15,23,32,11,10,1
15,23,33,18,18,0
15,23,34,8,16,-8
15,23,35,13,11,2
15,23,36,13,9,4
15,23,37,15,18,-3
15,23,38,17,14,3
15,23,39,15,18,-3
15,23,40,9,17,-8
15,23,41,23,15,8
15,23,42,25,9,16
15,23,43,11,11,0
15,23,44,21,22,-1
15,23,45,15,16,-1
15,23,46,17,13,4
15,23,47,15,16,-1
15,23,48,15,12,3
15,23,49,14,15,-1
15,23,50,20,13,7
15,23,51,21,8,13
15,23,52,13,18,-5
15,23,53,14,13,1
15,23,54,11,19,-8
15,23,55,16,17,-1
15,23,56,19,18,1
15,23,57,12,26,-14
15,23,58,9,6,3
15,23,59,21,8,13
15,23,60,19,12,7
15,23,61,10,12,-2
15,23,62,20,10,10
15,23,63,15,10,5
15,23,64,15,7,8
15,23,65,18,28,-10
15,23,66,18,21,-3
15,23,67,22,11,11
15,23,68,29,16,13
15,23,69,20,17,3
15,23,70,8,13,-5
15,23,71,16,10,6
15,23,72,14,19,-5
15,23,73,12,12,0
15,23,74,9,15,-6
15,23,75,14,15,-1
15,23,76,10,14,-4
15,23,77,9,10,-1
15,23,78,12,11,1
15,23,79,14,14,0
15,23,80,8,5,3
15,23,81,8,8,0
15,23,82,13,12,1
15,23,83,12,15,-3
15,23,84,14,8,6
15,23,85,14,12,2
15,23,86,10,10,0
15,23,87,9,8,1
15,23,88,13,20,-7
15,23,89,14,14,0
15,23,90,11,18,-7
15,23,91,18,8,10
15,23,92,9,16,-7
15,23,93,12,18,-6
15,23,94,12,13,-1
15,23,95,17,16,1
15,23,96,17,15,2
15,23,97,16,17,-1
15,23,98,16,11,5
15,23,99,19,12,7
15,23,100,13,10,3
15,23,101,23,16,7
15,23,102,6,14,-8
15,23,103,10,12,-2
15,23,104,18,12,6
15,23,105,25,12,13
15,23,106,16,10,6
15,23,107,21,23,-2
15,23,108,24,25,-1
15,23,109,16,14,2
15,23,110,5,6,-1
15,23,111,24,13,11
15,23,112,25,12,13
15,23,113,23,16,7
15,23,114,31,21,10
15,23,115,13,20,-7
15,23,116,18,8,10
15,23,117,19,11,8
15,23,118,17,15,2
15,23,119,12,9,3
15,23,120,9,11,-2
15,23,121,22,15,7
15,23,122,8,11,-3
15,23,123,19,8,11
15,23,124,8,5,3
15,23,125,14,16,-2
15,23,126,23,13,10
15,23,127,9,9,0
15,23,128,16,13,3
15,23,129,11,15,-4
15,23,130,15,10,5
15,23,131,14,21,-7
15,23,132,13,13,0
15,23,133,18,15,3
15,23,134,14,6,8
15,23,135,12,6,6
15,23,136,7,12,-5
15,23,137,23,20,3
15,23,138,12,7,5
15,23,139,20,14,6
15,23,140,21,18,3
15,23,141,14,17,-3
15,23,142,20,7,13
15,23,143,7,9,-2
15,23,144,23,14,9
15,23,145,10,7,3
15,23,146,4,9,-5
15,23,147,11,9,2
15,23,148,17,7,10
15,23,149,16,15,1
15,23,150,18,14,4
15,23,151,13,10,3
15,23,152,16,24,-8
15,23,153,20,20,0
15,23,154,12,29,-17
15,23,155,27,10,17
15,23,156,22,14,8
15,23,157,15,12,3
15,23,158,28,21,7
15,23,159,14,7,7
15,23,160,13,12,1
15,23,161,9,17,-8
15,23,162,13,17,-4
15,23,163,16,13,3
15,23,164,7,11,-4
15,23,165,8,10,-2
15,23,166,14,15,-1
15,23,167,19,9,10
15,23,168,18,16,2
15,23,169,25,8,17
15,23,170,12,17,-5
15,23,171,23,17,6
15,23,172,15,23,-8
15,23,173,13,11,2
15,23,174,24,12,12
15,23,175,14,13,1
15,23,176,14,22,-8
15,23,177,25,23,2
15,23,178,17,13,4
15,23,179,27,9,18
15,23,180,17,14,3
15,23,181,16,6,10
15,23,182,13,5,8
15,23,183,18,18,0
15,23,184,17,18,-1
15,23,185,6,2,4
15,23,186,11,15,-4
15,23,187,10,13,-3
15,23,188,9,8,1
15,23,189,11,14,-3
15,23,190,23,16,7
15,23,191,11,9,2
15,23,192,20,17,3
15,23,193,4,3,1
15,23,194,17,17,0
15,23,195,12,18,-6
15,23,196,23,11,12
15,23,197,10,13,-3
15,23,198,14,17,-3
15,23,199,30,9,21
15,23,200,23,8,15
15,23,201,14,13,1
15,23,202,9,12,-3
15,23,203,17,14,3
15,23,204,21,13,8
15,23,205,21,3,18
15,23,206,32,12,20
15,23,207,12,13,-1
15,23,208,18,11,7
15,23,209,23,20,3
15,23,210,21,29,-8
15,23,211,20,8,12
15,23,212,10,12,-2
15,23,213,16,13,3
15,23,214,24,8,16
15,23,215,28,14,14
15,23,216,19,11,8
15,23,217,12,13,-1
15,23,218,17,7,10
15,23,219,10,11,-1
15,23,220,22,25,-3
15,23,221,13,15,-2
15,23,222,13,11,2
15,23,223,18,17,1
15,23,224,16,24,-8
15,23,225,19,11,8
15,23,226,20,10,10
15,23,227,12,23,-11
15,23,228,5,10,-5
15,23,229,28,28,0
15,23,230,9,16,-7
15,23,231,19,26,-7
15,23,232,15,12,3
15,23,233,16,3,13
15,23,234,27,20,7
15,23,235,22,14,8
15,23,236,13,10,3
15,23,237,21,12,9
15,23,238,14,14,0
15,23,239,22,14,8
15,23,240,22,15,7
15,23,241,15,18,-3
15,23,242,7,20,-13
15,23,243,11,15,-4
15,23,244,17,18,-1
15,23,245,17,7,10
15,23,246,15,10,5
15,23,247,12,14,-2
15,23,248,23,21,2
15,23,249,35,23,12
15,23,250,27,6,21
15,23,251,22,16,6
15,23,252,21,20,1
15,23,253,26,34,-8
15,23,254,3,11,-8
15,23,255,9,18,-9
15,23,256,13,11,2
15,23,257,24,25,-1
15,23,258,19,18,1
15,23,259,24,18,6
15,23,260,18,14,4
15,23,261,2,5,-3
15,23,262,7,12,-5
15,23,263,11,12,-1
15,23,264,30,9,21
15,23,265,16,10,6
15,23,266,12,25,-13
15,23,267,20,10,10
15,23,268,14,5,9
15,23,269,21,20,1
15,23,270,19,16,3
15,23,271,15,10,5
15,23,272,15,16,-1
15,23,273,7,19,-12
15,23,274,7,6,1
15,23,275,15,6,9
15,23,276,21,21,0
15,23,277,20,8,12
15,23,278,13,19,-6
15,23,279,15,15,0
15,23,280,17,6,11
15,23,281,26,13,13
15,23,282,15,13,2
15,23,283,13,18,-5
15,23,284,24,10,14
15,23,285,13,14,-1
15,23,286,20,9,11
15,23,287,21,30,-9
15,23,288,20,12,8
15,23,289,16,17,-1
15,23,290,12,14,-2
15,23,291,27,16,11
15,23,292,20,13,7
15,23,293,8,6,2
15,23,294,14,8,6
15,23,295,17,32,-15
15,23,296,12,29,-17
15,23,297,7,10,-3
15,23,298,15,11,4
15,23,299,24,14,10
15,24,0,26,12,14
15,24,1,21,17,4
15,24,2,15,7,8
15,24,3,20,10,10
15,24,4,10,18,-8
15,24,5,18,22,-4
15,24,6,19,13,6
15,24,7,15,19,-4
15,24,8,16,8,8
15,24,9,14,7,7
15,24,10,15,12,3
15,24,11,24,12,12
15,24,12,23,14,9
15,24,13,18,16,2
15,24,14,11,13,-2
15,24,15,15,11,4
15,24,16,8,14,-6
15,24,17,9,15,-6
15,24,18,11,8,3
15,24,19,17,15,2
15,24,20,7,1,6
15,24,21,25,12,13
15,24,22,18,10,8
15,24,23,20,15,5
15,24,24,21,15,6
15,24,25,16,14,2
15,24,26,17,13,4
15,24,27,17,10,7
15,24,28,15,12,3
15,24,29,11,7,4
15,24,30,16,16,0
15,24,31,12,19,-7
15,24,32,10,23,-13
15,24,33,17,7,10
15,24,34,13,4,9
15,24,35,18,14,4
15,24,36,10,10,0
15,24,37,18,15,3
15,24,38,11,12,-1
15,24,39,20,10,10
15,24,40,26,21,5
15,24,41,16,10,6
15,24,42,13,29,-16
15,24,43,20,14,6
15,24,44,12,11,1
15,24,45,33,20,13
15,24,46,28,12,16
15,24,47,11,5,6
15,24,48,9,17,-8
15,24,49,20,19,1
15,24,50,21,14,7
15,24,51,13,5,8
15,24,52,25,8,17
15,24,53,15,16,-1
15,24,54,19,21,-2
15,24,55,5,13,-8
15,24,56,9,14,-5
15,24,57,11,10,1
15,24,58,13,14,-1
15,24,59,15,5,10
15,24,60,19,11,8
15,24,61,15,18,-3
15,24,62,19,17,2
15,24,63,18,8,10
15,24,64,27,18,9
15,24,65,19,12,7
15,24,66,19,17,2
15,24,67,15,10,5
15,24,68,18,15,3
15,24,69,19,10,9
15,24,70,16,5,11
15,24,71,19,15,4
15,24,72,11,14,-3
15,24,73,15,12,3
15,24,74,13,13,0
15,24,75,22,7,15
15,24,76,10,4,6
15,24,77,14,17,-3
15,24,78,14,12,2
15,24,79,24,19,5
15,24,80,12,13,-1
15,24,81,20,5,15
15,24,82,24,21,3
15,24,83,9,20,-11
15,24,84,18,8,10
15,24,85,21,25,-4
15,24,86,13,17,-4
15,24,87,23,11,12
15,24,88,10,19,-9
15,24,89,19,7,12
15,24,90,28,27,1
15,24,91,22,20,2
15,24,92,20,8,12
15,24,93,17,20,-3
15,24,94,16,11,5
15,24,95,15,7,8
15,24,96,7,14,-7
15,24,97,26,12,14
15,24,98,11,11,0
15,24,99,12,14,-2
15,24,100,18,27,-9
15,24,101,5,20,-15
15,24,102,29,12,17
15,24,103,11,13,-2
15,24,104,30,9,21
15,24,105,11,23,-12
15,24,106,7,8,-1
15,24,107,9,11,-2
15,24,108,22,10,12
15,24,109,22,16,6
15,24,110,12,11,1
15,24,111,17,16,1
15,24,112,14,6,8
15,24,113,25,14,11
15,24,114,10,16,-6
15,24,115,26,14,12
15,24,116,17,13,4
15,24,117,17,18,-1
15,24,118,15,23,-8
15,24,119,7,15,-8
15,24,120,14,18,-4
15,24,121,13,10,3
15,24,122,30,14,16
15,24,123,11,8,3
15,24,124,22,16,6
15,24,125,21,19,2
15,24,126,26,24,2
15,24,127,10,16,-6
15,24,128,17,5,12
15,24,129,22,9,13
15,24,130,12,7,5
15,24,131,22,11,11
15,24,132,11,6,5
15,24,133,21,13,8
15,24,134,16,12,4
15,24,135,16,23,-7
15,24,136,20,14,6
15,24,137,16,9,7
15,24,138,11,11,0
15,24,139,26,20,6
15,24,140,20,11,9
15,24,141,23,9,14
15,24,142,23,7,16
15,24,143,16,9,7
15,24,144,21,18,3
15,24,145,15,17,-2
15,24,146,16,15,1
15,24,147,4,9,-5
15,24,148,17,13,4
15,24,149,16,12,4
15,24,150,23,11,12
15,24,151,12,14,-2
15,24,152,24,14,10
15,24,153,14,3,11
15,24,154,11,9,2
15,24,155,10,18,-8
15,24,156,28,22,6
15,24,157,27,30,-3
15,24,158,28,8,20
15,24,159,18,11,7
15,24,160,13,13,0
15,24,161,25,13,12
15,24,162,15,9,6
15,24,163,9,13,-4
15,24,164,26,28,-2
15,24,165,14,12,2
15,24,166,17,4,13
15,24,167,12,9,3
15,24,168,16,12,4
15,24,169,16,15,1
15,24,170,21,20,1
15,24,171,13,9,4
15,24,172,13,7,6
15,24,173,8,8,0
15,24,174,16,13,3
15,24,175,15,15,0
15,24,176,21,17,4
15,24,177,11,14,-3
15,24,178,17,12,5
15,24,179,11,11,0
15,24,180,21,19,2
15,24,181,16,12,4
15,24,182,5,10,-5
15,24,183,17,13,4
15,24,184,10,21,-11
15,24,185,22,12,10
15,24,186,21,19,2
15,24,187,19,8,11
15,24,188,15,9,6
15,24,189,7,9,-2
15,24,190,20,14,6
15,24,191,18,24,-6
15,24,192,17,12,5
15,24,193,28,20,8
15,24,194,6,16,-10
15,24,195,16,21,-5
15,24,196,21,24,-3
15,24,197,6,12,-6
15,24,198,28,9,19
15,24,199,19,10,9
15,24,200,19,23,-4
15,24,201,11,18,-7
15,24,202,24,27,-3
15,24,203,19,14,5
15,24,204,9,14,-5
15,24,205,27,12,15
15,24,206,14,24,-10
15,24,207,13,15,-2
15,24,208,17,11,6
15,24,209,18,26,-8
15,24,210,20,11,9
15,24,211,12,15,-3
15,24,212,13,15,-2
15,24,213,10,25,-15
15,24,214,27,15,12
15,24,215,20,12,8
15,24,216,26,22,4
15,24,217,19,20,-1
15,24,218,25,19,6
15,24,219,21,16,5
15,24,220,14,15,-1
15,24,221,14,12,2
15,24,222,19,15,4
15,24,223,13,10,3
15,24,224,26,12,14
15,24,225,9,19,-10
15,24,226,19,14,5
15,24,227,20,10,10
15,24,228,17,18,-1
15,24,229,19,22,-3
15,24,230,29,17,12
15,24,231,27,17,10
15,24,232,27,12,15
15,24,233,28,8,20
15,24,234,17,10,7
15,24,235,16,10,6
15,24,236,15,14,1
15,24,237,13,8,5
15,24,238,15,9,6
15,24,239,22,10,12
15,24,240,15,22,-7
15,24,241,16,14,2
15,24,242,11,9,2
15,24,243,16,23,-7
15,24,244,11,15,-4
15,24,245,33,16,17
15,24,246,27,12,15
15,24,247,15,22,-7
15,24,248,14,23,-9
15,24,249,26,10,16
15,24,250,30,11,19
15,24,251,16,10,6
15,24,252,18,17,1
15,24,253,17,19,-2
15,24,254,8,14,-6
15,24,255,18,7,11
15,24,256,14,13,1
15,24,257,8,4,4
15,24,258,18,15,3
15,24,259,15,17,-2
15,24,260,7,14,-7
15,24,261,21,16,5
15,24,262,11,16,-5
15,24,263,25,19,6
15,24,264,14,6,8
15,24,265,17,12,5
15,24,266,7,15,-8
15,24,267,10,17,-7
15,24,268,18,12,6
15,24,269,19,6,13
15,24,270,17,19,-2
15,24,271,9,10,-1
15,24,272,18,10,8
15,24,273,17,15,2
15,24,274,17,8,9
15,24,275,15,12,3
15,24,276,11,14,-3
15,24,277,15,11,4
15,24,278,34,11,23
15,24,279,21,13,8
15,24,280,15,23,-8
15,24,281,20,22,-2
15,24,282,5,11,-6
15,24,283,30,14,16
15,24,284,17,26,-9
15,24,285,12,14,-2
15,24,286,12,6,6
15,24,287,16,24,-8
15,24,288,22,11,11
15,24,289,29,21,8
15,24,290,6,10,-4
15,24,291,20,9,11
15,24,292,8,12,-4
15,24,293,20,21,-1
15,24,294,8,12,-4
15,24,295,19,18,1
15,24,296,14,11,3
15,24,297,24,6,18
15,24,298,27,12,15
15,24,299,17,14,3
15,25,0,21,10,11
15,25,1,18,1,17
15,25,2,4,13,-9
15,25,3,13,17,-4
15,25,4,16,10,6
15,25,5,7,13,-6
15,25,6,26,25,1
15,25,7,22,20,2
15,25,8,18,22,-4
15,25,9,23,13,10
15,25,10,11,6,5
15,25,11,9,13,-4
15,25,12,21,13,8
15,25,13,20,19,1
15,25,14,10,10,0
15,25,15,28,6,22
15,25,16,23,24,-1
15,25,17,17,20,-3
15,25,18,8,8,0
15,25,19,17,7,10
15,25,20,12,12,0
15,25,21,16,9,7
15,25,22,21,11,10
15,25,23,15,21,-6
15,25,24,17,12,5
15,25,25,18,22,-4
15,25,26,15,10,5
15,25,27,18,10,8
15,25,28,28,12,16
15,25,29,20,16,4
15,25,30,15,22,-7
15,25,31,13,11,2
15,25,32,16,16,0
15,25,33,12,6,6
15,25,34,16,12,4
15,25,35,3,4,-1
15,25,36,14,16,-2
15,25,37,32,26,6
15,25,38,14,19,-5
15,25,39,25,22,3
15,25,40,8,5,3
15,25,41,20,12,8
15,25,42,26,18,8
15,25,43,8,9,-1
15,25,44,19,10,9
15,25,45,13,14,-1
15,25,46,17,12,5
15,25,47,22,17,5
15,25,48,17,7,10
15,25,49,9,0,9
15,25,50,26,14,12
15,25,51,7,14,-7
15,25,52,17,15,2
15,25,53,13,14,-1
15,25,54,23,16,7
15,25,55,22,16,6
15,25,56,7,7,0
15,25,57,16,10,6
15,25,58,18,10,8
15,25,59,14,15,-1
15,25,60,14,13,1
15,25,61,8,14,-6
15,25,62,13,13,0
15,25,63,12,14,-2
15,25,64,20,8,12
15,25,65,33,16,17
15,25,66,21,11,10
15,25,67,9,10,-1
15,25,68,22,23,-1
15,25,69,15,24,-9
15,25,70,25,15,10
15,25,71,24,15,9
15,25,72,14,11,3
15,25,73,16,10,6
15,25,74,18,8,10
15,25,75,11,8,3
15,25,76,6,12,-6
15,25,77,13,17,-4
15,25,78,7,14,-7
15,25,79,19,18,1
15,25,80,19,14,5
15,25,81,11,14,-3
15,25,82,11,12,-1
15,25,83,26,18,8
15,25,84,20,10,10
15,25,85,17,14,3
15,25,86,13,8,5
15,25,87,25,25,0
15,25,88,10,3,7
15,25,89,22,11,11
15,25,90,21,13,8
15,25,91,18,10,8
15,25,92,12,18,-6
15,25,93,13,8,5
15,25,94,27,17,10
15,25,95,16,15,1
15,25,96,8,10,-2
15,25,97,24,12,12
15,25,98,15,17,-2
15,25,99,8,14,-6
15,25,100,15,20,-5
15,25,101,15,9,6
15,25,102,13,7,6
15,25,103,17,18,-1
15,25,104,16,16,0
15,25,105,12,14,-2
15,25,106,14,15,-1
15,25,107,5,7,-2
15,25,108,17,20,-3
15,25,109,27,9,18
15,25,110,24,12,12
15,25,111,26,17,9
15,25,112,15,12,3
15,25,113,16,17,-1
15,25,114,14,13,1
15,25,115,15,16,-1
15,25,116,16,17,-1
15,25,117,25,9,16
15,25,118,19,15,4
15,25,119,11,9,2
15,25,120,6,12,-6
15,25,121,26,11,15
15,25,122,11,10,1
15,25,123,26,5,21
15,25,124,26,24,2
15,25,125,9,18,-9
15,25,126,14,17,-3
15,25,127,22,16,6
15,25,128,13,22,-9
15,25,129,9,19,-10
15,25,130,18,8,10
15,25,131,8,12,-4
15,25,132,16,11,5
15,25,133,21,11,10
15,25,134,18,13,5
15,25,135,20,13,7
15,25,136,14,14,0
15,25,137,22,14,8
15,25,138,12,14,-2
15,25,139,7,11,-4
15,25,140,9,10,-1
15,25,141,17,24,-7
15,25,142,8,17,-9
15,25,143,12,10,2
15,25,144,13,11,2
15,25,145,22,9,13
15,25,146,22,9,13
15,25,147,3,10,-7
15,25,148,9,19,-10
15,25,149,35,7,28
15,25,150,15,8,7
15,25,151,22,8,14
15,25,152,22,14,8
15,25,153,17,12,5
15,25,154,19,11,8
15,25,155,18,9,9
15,25,156,17,21,-4
15,25,157,27,10,17
15,25,158,12,6,6
15,25,159,13,19,-6
15,25,160,15,14,1
15,25,161,22,12,10
15,25,162,11,8,3
15,25,163,15,16,-1
15,25,164,13,14,-1
15,25,165,22,11,11
15,25,166,21,17,4
15,25,167,7,12,-5
15,25,168,15,16,-1
15,25,169,17,7,10
15,25,170,7,11,-4
15,25,171,15,18,-3
15,25,172,18,10,8
15,25,173,12,20,-8
15,25,174,22,15,7
15,25,175,27,8,19
15,25,176,14,11,3
15,25,177,10,8,2
15,25,178,17,6,11
15,25,179,9,13,-4
15,25,180,21,23,-2
15,25,181,10,33,-23
15,25,182,26,10,16
15,25,183,9,5,4
15,25,184,19,24,-5
15,25,185,22,16,6
15,25,186,22,14,8
15,25,187,20,14,6
15,25,188,17,13,4
15,25,189,25,26,-1
15,25,190,15,19,-4
15,25,191,12,5,7
15,25,192,14,13,1
15,25,193,20,10,10
15,25,194,6,15,-9
15,25,195,7,12,-5
15,25,196,25,20,5
15,25,197,12,18,-6
15,25,198,4,9,-5
15,25,199,18,9,9
15,25,200,19,12,7
15,25,201,13,11,2
15,25,202,23,14,9
15,25,203,12,10,2
15,25,204,13,11,2
15,25,205,14,21,-7
15,25,206,14,8,6
15,25,207,10,12,-2
15,25,208,28,9,19
15,25,209,17,14,3
15,25,210,17,26,-9
15,25,211,21,8,13
15,25,212,15,10,5
15,25,213,21,16,5
15,25,214,14,5,9
15,25,215,16,13,3
15,25,216,20,14,6
15,25,217,15,8,7
15,25,218,13,1,12
15,25,219,7,14,-7
15,25,220,22,19,3
15,25,221,16,17,-1
15,25,222,19,19,0
15,25,223,13,12,1
15,25,224,9,6,3
15,25,225,8,6,2
15,25,226,16,16,0
15,25,227,18,10,8
15,25,228,11,28,-17
15,25,229,15,10,5
15,25,230,18,13,5
15,25,231,15,10,5
15,25,232,14,16,-2
15,25,233,7,14,-7
15,25,234,12,9,3
15,25,235,22,12,10
15,25,236,27,12,15
15,25,237,13,19,-6
15,25,238,9,5,4
15,25,239,18,14,4
15,25,240,19,15,4
15,25,241,16,10,6
15,25,242,16,10,6
15,25,243,12,15,-3
15,25,244,19,19,0
15,25,245,17,14,3
15,25,246,21,21,0
15,25,247,14,11,3
15,25,248,13,11,2
15,25,249,16,11,5
15,25,250,24,6,18
15,25,251,12,8,4
15,25,252,15,12,3
15,25,253,18,9,9
15,25,254,12,15,-3
15,25,255,9,8,1
15,25,256,15,6,9
15,25,257,21,15,6
15,25,258,22,19,3
15,25,259,13,9,4
15,25,260,14,15,-1
15,25,261,19,15,4
15,25,262,4,16,-12
15,25,263,18,16,2
15,25,264,18,11,7
15,25,265,17,8,9
15,25,266,13,14,-1
15,25,267,12,6,6
15,25,268,20,16,4
15,25,269,6,17,-11
15,25,270,17,3,14
15,25,271,22,18,4
15,25,272,5,5,0
15,25,273,25,14,11
15,25,274,12,8,4
15,25,275,19,26,-7
15,25,276,24,5,19
15,25,277,15,13,2
15,25,278,15,11,4
15,25,279,19,9,10
15,25,280,5,9,-4
15,25,281,15,15,0
15,25,282,16,23,-7
15,25,283,21,16,5
15,25,284,28,17,11
15,25,285,25,17,8
15,25,286,27,17,10
15,25,287,25,5,20
15,25,288,15,14,1
15,25,289,27,7,20
15,25,290,26,16,10
15,25,291,20,21,-1
15,25,292,13,16,-3
15,25,293,13,8,5
15,25,294,11,4,7
15,25,295,7,14,-7
15,25,296,15,5,10
15,25,297,4,4,0
15,25,298,24,16,8
15,25,299,20,11,9
15,26,0,20,18,2
15,26,1,8,14,-6
15,26,2,18,16,2
15,26,3,12,7,5
15,26,4,28,23,5
15,26,5,12,13,-1
15,26,6,24,8,16
15,26,7,28,26,2
15,26,8,29,10,19
15,26,9,10,10,0
15,26,10,27,14,13
15,26,11,31,6,25
15,26,12,14,12,2
15,26,13,7,11,-4
15,26,14,12,10,2
15,26,15,16,15,1
15,26,16,15,4,11
15,26,17,14,11,3
15,26,18,18,10,8
15,26,19,15,18,-3
15,26,20,16,14,2
15,26,21,5,9,-4
15,26,22,23,11,12
15,26,23,9,4,5
15,26,24,12,19,-7
15,26,25,15,14,1
15,26,26,18,18,0
15,26,27,27,17,10
15,26,28,23,13,10
15,26,29,18,11,7
15,26,30,9,4,5
15,26,31,6,17,-11
15,26,32,23,20,3
15,26,33,19,9,10
15,26,34,16,13,3
15,26,35,16,15,1
15,26,36,9,16,-7
15,26,37,6,10,-4
15,26,38,16,19,-3
15,26,39,17,4,13
15,26,40,24,16,8
15,26,41,11,8,3
15,26,42,37,17,20
15,26,43,13,13,0
15,26,44,12,8,4
15,26,45,5,10,-5
15,26,46,11,9,2
15,26,47,24,13,11
15,26,48,17,8,9
15,26,49,23,6,17
15,26,50,13,18,-5
15,26,51,16,19,-3
15,26,52,12,11,1
15,26,53,16,7,9
15,26,54,22,15,7
15,26,55,12,5,7
15,26,56,13,18,-5
15,26,57,10,7,3
15,26,58,15,11,4
15,26,59,17,10,7
15,26,60,17,12,5
15,26,61,17,18,-1
15,26,62,16,18,-2
15,26,63,16,13,3
15,26,64,10,2,8
15,26,65,6,13,-7
15,26,66,23,13,10
15,26,67,5,10,-5
15,26,68,21,15,6
15,26,69,19,19,0
15,26,70,14,9,5
15,26,71,13,9,4
15,26,72,12,6,6
15,26,73,21,17,4
15,26,74,7,17,-10
15,26,75,10,13,-3
15,26,76,9,7,2
15,26,77,20,22,-2
15,26,78,14,11,3
15,26,79,17,14,3
15,26,80,22,18,4
15,26,81,10,21,-11
15,26,82,23,18,5
15,26,83,11,7,4
15,26,84,13,2,11
15,26,85,14,13,1
15,26,86,11,4,7
15,26,87,14,9,5
15,26,88,10,8,2
15,26,89,18,25,-7
15,26,90,18,17,1
15,26,91,9,15,-6
15,26,92,28,14,14
15,26,93,35,29,6
15,26,94,34,13,21
15,26,95,25,15,10
15,26,96,16,7,9
15,26,97,22,14,8
15,26,98,19,14,5
15,26,99,25,11,14
15,26,100,27,12,15
15,26,101,9,13,-4
15,26,102,14,13,1
15,26,103,12,10,2
15,26,104,16,10,6
15,26,105,20,21,-1
15,26,106,9,13,-4
15,26,107,10,12,-2
15,26,108,23,10,13
15,26,109,12,18,-6
15,26,110,6,10,-4
15,26,111,13,10,3
15,26,112,13,16,-3
15,26,113,19,16,3
15,26,114,20,9,11
15,26,115,17,10,7
15,26,116,15,21,-6
15,26,117,17,15,2
15,26,118,23,16,7
15,26,119,10,10,0
15,26,120,14,3,11
15,26,121,18,6,12
15,26,122,21,15,6
15,26,123,13,12,1
15,26,124,17,17,0
15,26,125,14,12,2
15,26,126,10,9,1
15,26,127,9,23,-14
15,26,128,11,10,1
15,26,129,32,19,13
15,26,130,10,10,0
15,26,131,10,8,2
15,26,132,17,16,1
15,26,133,22,24,-2
15,26,134,22,17,5
15,26,135,13,9,4
15,26,136,14,16,-2
15,26,137,17,10,7
15,26,138,5,11,-6
15,26,139,10,12,-2
15,26,140,14,5,9
15,26,141,13,8,5
15,26,142,17,12,5
15,26,143,8,13,-5
15,26,144,9,16,-7
15,26,145,13,11,2
15,26,146,17,10,7
15,26,147,12,11,1
15,26,148,25,14,11
15,26,149,3,2,1
15,26,150,12,23,-11
15,26,151,31,16,15
15,26,152,18,9,9
15,26,153,16,14,2
15,26,154,28,10,18
15,26,155,18,9,9
15,26,156,17,9,8
15,26,157,25,9,16
15,26,158,27,19,8
15,26,159,21,15,6
15,26,160,32,12,20
15,26,161,17,17,0
15,26,162,16,10,6
15,26,163,22,19,3
15,26,164,18,11,7
15,26,165,26,14,12
15,26,166,20,14,6
15,26,167,14,18,-4
15,26,168,12,12,0
15,26,169,12,15,-3
15,26,170,15,14,1
15,26,171,10,17,-7
15,26,172,23,5,18
15,26,173,20,11,9
15,26,174,32,23,9
15,26,175,5,18,-13
15,26,176,19,14,5
15,26,177,14,6,8
15,26,178,23,11,12
15,26,179,10,4,6
15,26,180,20,10,10
15,26,181,18,10,8
15,26,182,14,16,-2
15,26,183,11,14,-3
15,26,184,14,4,10
15,26,185,26,20,6
15,26,186,10,26,-16
15,26,187,10,18,-8
15,26,188,13,26,-13
15,26,189,24,17,7
15,26,190,10,19,-9
15,26,191,13,10,3
15,26,192,12,4,8
15,26,193,11,20,-9
15,26,194,28,15,13
15,26,195,10,6,4
15,26,196,11,20,-9
15,26,197,11,10,1
15,26,198,23,15,8
15,26,199,9,16,-7
15,26,200,21,11,10
15,26,201,14,20,-6
15,26,202,17,9,8
15,26,203,15,13,2
15,26,204,25,13,12
15,26,205,14,13,1
15,26,206,9,8,1
15,26,207,20,10,10
15,26,208,11,14,-3
15,26,209,21,11,10
15,26,210,17,17,0
15,26,211,11,14,-3
15,26,212,28,16,12
15,26,213,25,10,15
15,26,214,15,15,0
15,26,215,20,6,14
15,26,216,19,14,5
15,26,217,15,11,4
15,26,218,22,8,14
15,26,219,27,12,15
15,26,220,13,13,0
15,26,221,26,15,11
15,26,222,36,27,9
15,26,223,7,9,-2
15,26,224,18,19,-1
15,26,225,28,23,5
15,26,226,17,9,8
15,26,227,20,19,1
15,26,228,8,13,-5
15,26,229,16,7,9
15,26,230,17,9,8
15,26,231,10,7,3
15,26,232,19,19,0
15,26,233,16,8,8
15,26,234,15,20,-5
15,26,235,8,14,-6
15,26,236,19,10,9
15,26,237,15,14,1
15,26,238,18,10,8
15,26,239,22,13,9
15,26,240,15,16,-1
15,26,241,12,19,-7
15,26,242,25,23,2
15,26,243,24,14,10
15,26,244,6,10,-4
15,26,245,16,19,-3
15,26,246,15,8,7
15,26,247,23,16,7
15,26,248,16,8,8
15,26,249,24,9,15
15,26,250,28,23,5
15,26,251,8,8,0
15,26,252,21,16,5
15,26,253,12,6,6
15,26,254,22,24,-2
15,26,255,26,14,12
15,26,256,17,20,-3
15,26,257,16,12,4
15,26,258,10,10,0
15,26,259,13,13,0
15,26,260,18,15,3
15,26,261,18,12,6
15,26,262,23,20,3
15,26,263,24,19,5
15,26,264,14,15,-1
15,26,265,18,15,3
15,26,266,25,11,14
15,26,267,15,15,0
15,26,268,27,20,7
15,26,269,16,6,10
15,26,270,15,13,2
15,26,271,17,5,12
15,26,272,11,3,8
15,26,273,13,10,3
15,26,274,20,1,19
15,26,275,14,12,2
15,26,276,12,14,-2
15,26,277,6,16,-10
15,26,278,19,15,4
15,26,279,12,15,-3
15,26,280,16,8,8
15,26,281,24,26,-2
15,26,282,23,21,2
15,26,283,28,17,11
15,26,284,10,8,2
15,26,285,20,12,8
15,26,286,11,7,4
15,26,287,15,15,0
15,26,288,32,25,7
15,26,289,18,13,5
15,26,290,19,17,2
15,26,291,16,15,1
15,26,292,13,5,8
15,26,293,15,4,11
15,26,294,14,6,8
15,26,295,22,24,-2
15,26,296,13,12,1
15,26,297,14,23,-9
15,26,298,12,20,-8
15,26,299,12,6,6
15,27,0,22,14,8
15,27,1,15,10,5
15,27,2,14,16,-2
15,27,3,22,13,9
15,27,4,10,18,-8
15,27,5,17,15,2
15,27,6,15,12,3
15,27,7,14,13,1
15,27,8,14,11,3
15,27,9,13,15,-2
15,27,10,8,5,3
15,27,11,18,12,6
15,27,12,11,7,4
15,27,13,24,11,13
15,27,14,15,8,7
15,27,15,22,8,14
15,27,16,26,25,1
15,27,17,20,15,5
15,27,18,19,13,6
15,27,19,28,14,14
15,27,20,15,21,-6
15,27,21,10,4,6
15,27,22,23,26,-3
15,27,23,11,23,-12
15,27,24,17,18,-1
15,27,25,13,9,4
15,27,26,19,13,6
15,27,27,12,12,0
15,27,28,16,2,14
15,27,29,12,4,8
15,27,30,28,18,10
15,27,31,22,12,10
15,27,32,16,14,2
15,27,33,19,19,0
15,27,34,9,2,7
15,27,35,25,9,16
15,27,36,9,15,-6
15,27,37,20,9,11
15,27,38,22,13,9
15,27,39,11,3,8
15,27,40,27,20,7
15,27,41,14,10,4
15,27,42,9,13,-4
15,27,43,13,10,3
15,27,44,21,12,9
15,27,45,17,7,10
15,27,46,19,14,5
15,27,47,17,6,11
15,27,48,14,16,-2
15,27,49,16,15,1
15,27,50,12,10,2
15,27,51,12,3,9
15,27,52,9,7,2
15,27,53,15,13,2
15,27,54,18,18,0
15,27,55,34,14,20
15,27,56,13,13,0
15,27,57,14,11,3
15,27,58,13,12,1
15,27,59,8,19,-11
15,27,60,5,13,-8
15,27,61,16,8,8
15,27,62,11,9,2
15,27,63,15,18,-3
15,27,64,15,12,3
15,27,65,13,12,1
15,27,66,12,20,-8
15,27,67,12,10,2
15,27,68,8,7,1
15,27,69,11,12,-1
15,27,70,14,7,7
15,27,71,24,14,10
15,27,72,7,9,-2
15,27,73,14,12,2
15,27,74,14,12,2
15,27,75,4,11,-7
15,27,76,13,11,2
15,27,77,21,21,0
15,27,78,23,13,10
15,27,79,15,11,4
15,27,80,19,11,8
15,27,81,9,14,-5
15,27,82,17,15,2
15,27,83,20,21,-1
15,27,84,17,12,5
15,27,85,24,12,12
15,27,86,16,11,5
15,27,87,18,13,5
15,27,88,10,15,-5
15,27,89,11,20,-9
15,27,90,15,9,6
15,27,91,17,13,4
15,27,92,20,11,9
15,27,93,13,7,6
15,27,94,15,13,2
15,27,95,6,13,-7
15,27,96,17,14,3
15,27,97,16,13,3
15,27,98,14,8,6
15,27,99,26,12,14
15,27,100,25,8,17
15,27,101,15,14,1
15,27,102,11,10,1
15,27,103,27,8,19
15,27,104,12,6,6
15,27,105,26,14,12
15,27,106,25,4,21
15,27,107,23,12,11
15,27,108,13,12,1
15,27,109,23,15,8
15,27,110,24,23,1
15,27,111,22,13,9
15,27,112,22,5,17
15,27,113,25,28,-3
15,27,114,13,17,-4
15,27,115,25,13,12
15,27,116,7,9,-2
15,27,117,7,8,-1
15,27,118,22,9,13
15,27,119,15,12,3
15,27,120,14,7,7
15,27,121,12,2,10
15,27,122,14,3,11
15,27,123,11,14,-3
15,27,124,32,7,25
15,27,125,22,9,13
15,27,126,21,5,16
15,27,127,22,9,13
15,27,128,9,10,-1
15,27,129,24,25,-1
15,27,130,15,7,8
15,27,131,14,17,-3
15,27,132,29,20,9
15,27,133,15,17,-2
15,27,134,15,6,9
15,27,135,11,7,4
15,27,136,18,24,-6
15,27,137,20,13,7
15,27,138,14,17,-3
15,27,139,12,4,8
15,27,140,14,12,2
15,27,141,14,8,6
15,27,142,16,20,-4
15,27,143,16,8,8
15,27,144,24,17,7
15,27,145,13,7,6
15,27,146,21,8,13
15,27,147,19,14,5
15,27,148,21,6,15
15,27,149,26,26,0
15,27,150,12,6,6
15,27,151,15,7,8
15,27,152,9,19,-10
15,27,153,12,13,-1
15,27,154,19,10,9
15,27,155,11,13,-2
15,27,156,25,17,8
15,27,157,29,24,5
15,27,158,12,5,7
15,27,159,23,13,10
15,27,160,15,18,-3
15,27,161,15,16,-1
15,27,162,21,8,13
15,27,163,5,22,-17
15,27,164,20,19,1
15,27,165,10,15,-5
15,27,166,24,13,11
15,27,167,16,14,2
15,27,168,28,28,0
15,27,169,8,6,2
15,27,170,11,13,-2
15,27,171,21,21,0
15,27,172,12,13,-1
15,27,173,26,19,7
15,27,174,9,15,-6
15,27,175,20,13,7
15,27,176,14,13,1
15,27,177,12,14,-2
15,27,178,24,13,11
15,27,179,31,15,16
15,27,180,26,14,12
15,27,181,13,12,1
15,27,182,14,16,-2
15,27,183,8,13,-5
15,27,184,18,7,11
15,27,185,17,10,7
15,27,186,19,12,7
15,27,187,17,10,7
15,27,188,20,12,8
15,27,189,18,16,2
15,27,190,32,13,19
15,27,191,24,20,4
15,27,192,13,14,-1
15,27,193,13,12,1
15,27,194,17,12,5
15,27,195,18,17,1
15,27,196,17,13,4
15,27,197,17,7,10
15,27,198,22,7,15
15,27,199,13,15,-2
15,27,200,16,11,5
15,27,201,26,19,7
15,27,202,16,6,10
15,27,203,16,15,1
15,27,204,18,9,9
15,27,205,18,14,4
15,27,206,15,2,13
15,27,207,4,11,-7
15,27,208,13,7,6
15,27,209,17,13,4
15,27,210,9,13,-4
15,27,211,15,14,1
15,27,212,13,4,9
15,27,213,17,15,2
15,27,214,11,11,0
15,27,215,10,13,-3
15,27,216,15,16,-1
15,27,217,20,12,8
15,27,218,18,13,5
15,27,219,18,11,7
15,27,220,9,7,2
15,27,221,23,13,10
15,27,222,14,22,-8
15,27,223,11,7,4
15,27,224,20,11,9
15,27,225,21,16,5
15,27,226,6,13,-7
15,27,227,14,7,7
15,27,228,17,14,3
15,27,229,20,12,8
15,27,230,17,8,9
15,27,231,8,11,-3
15,27,232,14,17,-3
15,27,233,14,22,-8
15,27,234,23,9,14
15,27,235,20,19,1
15,27,236,9,11,-2
15,27,237,17,12,5
15,27,238,8,18,-10
15,27,239,14,24,-10
15,27,240,8,12,-4
15,27,241,13,14,-1
15,27,242,17,7,10
15,27,243,9,10,-1
15,27,244,14,10,4
15,27,245,26,14,12
15,27,246,14,14,0
15,27,247,18,18,0
15,27,248,17,16,1
15,27,249,29,9,20
15,27,250,14,10,4
15,27,251,7,2,5
15,27,252,20,16,4
15,27,253,27,16,11
15,27,254,27,13,14
15,27,255,17,9,8
15,27,256,16,14,2
15,27,257,18,13,5
15,27,258,14,14,0
15,27,259,16,9,7
15,27,260,16,9,7
15,27,261,11,10,1
15,27,262,22,19,3
15,27,263,21,15,6
15,27,264,18,14,4
15,27,265,15,12,3
15,27,266,13,20,-7
15,27,267,18,11,7
15,27,268,13,18,-5
15,27,269,5,8,-3
15,27,270,19,3,16
15,27,271,12,13,-1
15,27,272,19,18,1
15,27,273,21,17,4
15,27,274,21,18,3
15,27,275,8,9,-1
15,27,276,16,20,-4
15,27,277,26,27,-1
15,27,278,16,8,8
15,27,279,23,18,5
15,27,280,14,20,-6
15,27,281,26,7,19
15,27,282,8,7,1
15,27,283,12,6,6
15,27,284,16,6,10
15,27,285,17,7,10
15,27,286,9,12,-3
15,27,287,11,16,-5
15,27,288,21,13,8
15,27,289,23,18,5
15,27,290,22,22,0
15,27,291,7,11,-4
15,27,292,16,9,7
15,27,293,21,18,3
15,27,294,13,9,4
15,27,295,19,10,9
15,27,296,12,6,6
15,27,297,27,8,19
15,27,298,22,25,-3
15,27,299,19,19,0
15,28,0,16,16,0
15,28,1,16,15,1
15,28,2,19,8,11
15,28,3,20,11,9
15,28,4,17,13,4
15,28,5,13,5,8
15,28,6,3,7,-4
15,28,7,27,18,9
15,28,8,37,9,28
15,28,9,22,14,8
15,28,10,16,14,2
15,28,11,6,11,-5
15,28,12,22,11,11
15,28,13,11,19,-8
15,28,14,9,4,5
15,28,15,17,5,12
15,28,16,25,8,17
15,28,17,17,16,1
15,28,18,12,4,8
15,28,19,10,14,-4
15,28,20,11,10,1
15,28,21,27,22,5
15,28,22,18,15,3
15,28,23,25,4,21
15,28,24,16,6,10
15,28,25,17,19,-2
15,28,26,30,6,24
15,28,27,22,21,1
15,28,28,10,22,-12
15,28,29,1,19,-18
15,28,30,18,9,9
15,28,31,16,11,5
15,28,32,7,14,-7
15,28,33,10,3,7
15,28,34,21,16,5
15,28,35,23,13,10
15,28,36,19,13,6
15,28,37,16,14,2
15,28,38,10,9,1
15,28,39,14,20,-6
15,28,40,16,21,-5
15,28,41,13,15,-2
15,28,42,20,14,6
15,28,43,9,8,1
15,28,44,22,10,12
15,28,45,13,6,7
15,28,46,17,10,7
15,28,47,13,9,4
15,28,48,16,8,8
15,28,49,22,9,13
15,28,50,9,8,1
15,28,51,29,10,19
15,28,52,14,8,6
15,28,53,13,9,4
15,28,54,28,15,13
15,28,55,19,8,11
15,28,56,23,14,9
15,28,57,16,13,3
15,28,58,24,13,11
15,28,59,15,5,10
15,28,60,10,13,-3
15,28,61,19,15,4
15,28,62,20,9,11
15,28,63,6,11,-5
15,28,64,10,8,2
15,28,65,20,7,13
15,28,66,13,15,-2
15,28,67,8,19,-11
15,28,68,24,15,9
15,28,69,10,4,6
15,28,70,10,10,0
15,28,71,16,21,-5
15,28,72,8,14,-6
15,28,73,9,9,0
15,28,74,15,10,5
15,28,75,18,9,9
15,28,76,23,14,9
15,28,77,15,7,8
15,28,78,16,9,7
15,28,79,21,14,7
15,28,80,23,22,1
15,28,81,15,11,4
15,28,82,14,12,2
15,28,83,9,3,6
15,28,84,18,20,-2
15,28,85,19,10,9
15,28,86,9,14,-5
15,28,87,14,15,-1
15,28,88,14,9,5
15,28,89,19,11,8
15,28,90,10,15,-5
15,28,91,13,16,-3
15,28,92,22,9,13
15,28,93,20,10,10
15,28,94,19,8,11
15,28,95,9,9,0
15,28,96,16,16,0
15,28,97,14,11,3
15,28,98,13,7,6
15,28,99,19,17,2
15,28,100,28,21,7
15,28,101,16,4,12
15,28,102,21,11,10
15,28,103,19,15,4
15,28,104,12,12,0
15,28,105,13,11,2
15,28,106,34,16,18
15,28,107,15,11,4
15,28,108,6,15,-9
15,28,109,14,19,-5
15,28,110,20,12,8
15,28,111,25,13,12
15,28,112,5,11,-6
15,28,113,10,7,3
15,28,114,22,17,5
15,28,115,10,12,-2
15,28,116,9,12,-3
15,28,117,19,30,-11
15,28,118,12,10,2
15,28,119,21,11,10
15,28,120,24,13,11
15,28,121,15,15,0
15,28,122,18,20,-2
15,28,123,11,6,5
15,28,124,14,8,6
15,28,125,15,14,1
15,28,126,13,10,3
15,28,127,10,6,4
15,28,128,9,7,2
15,28,129,10,5,5
15,28,130,21,12,9
15,28,131,8,8,0
15,28,132,11,11,0
15,28,133,12,18,-6
15,28,134,13,9,4
15,28,135,19,19,0
15,28,136,28,16,12
15,28,137,15,16,-1
15,28,138,24,15,9
15,28,139,12,7,5
15,28,140,21,12,9
15,28,141,12,9,3
15,28,142,8,10,-2
15,28,143,15,14,1
15,28,144,24,16,8
15,28,145,18,12,6
15,28,146,13,21,-8
15,28,147,5,4,1
15,28,148,1,7,-6
15,28,149,20,7,13
15,28,150,19,11,8
15,28,151,18,7,11
15,28,152,15,7,8
15,28,153,19,8,11
15,28,154,5,14,-9
15,28,155,18,20,-2
15,28,156,17,5,12
15,28,157,18,11,7
15,28,158,22,13,9
15,28,159,8,3,5
15,28,160,20,14,6
15,28,161,12,8,4
15,28,162,24,9,15
15,28,163,22,10,12
15,28,164,15,11,4
15,28,165,25,21,4
15,28,166,16,18,-2
15,28,167,20,15,5
15,28,168,6,4,2
15,28,169,20,12,8
15,28,170,30,12,18
15,28,171,24,18,6
15,28,172,16,12,4
15,28,173,11,9,2
15,28,174,13,10,3
15,28,175,10,14,-4
15,28,176,20,11,9
15,28,177,13,14,-1
15,28,178,13,20,-7
15,28,179,18,15,3
15,28,180,25,16,9
15,28,181,35,15,20
15,28,182,17,11,6
15,28,183,12,10,2
15,28,184,13,10,3
15,28,185,19,20,-1
15,28,186,23,19,4
15,28,187,19,6,13
15,28,188,17,11,6
15,28,189,5,14,-9
15,28,190,18,13,5
15,28,191,24,20,4
15,28,192,17,11,6
15,28,193,14,18,-4
15,28,194,16,19,-3
15,28,195,20,14,6
15,28,196,13,12,1
15,28,197,25,23,2
15,28,198,8,15,-7
15,28,199,12,19,-7
15,28,200,14,11,3
15,28,201,28,5,23
15,28,202,15,18,-3
15,28,203,15,8,7
15,28,204,5,10,-5
15,28,205,6,14,-8
15,28,206,18,11,7
15,28,207,14,8,6
15,28,208,12,3,9
15,28,209,8,8,0
15,28,210,7,9,-2
15,28,211,23,4,19
15,28,212,14,11,3
15,28,213,12,8,4
15,28,214,14,5,9
15,28,215,16,14,2
15,28,216,20,11,9
15,28,217,10,3,7
15,28,218,12,23,-11
15,28,219,11,14,-3
15,28,220,14,5,9
15,28,221,14,6,8
15,28,222,26,20,6
15,28,223,23,11,12
15,28,224,10,5,5
15,28,225,18,15,3
15,28,226,15,7,8
15,28,227,25,9,16
15,28,228,20,11,9
15,28,229,11,3,8
15,28,230,21,14,7
15,28,231,9,7,2
15,28,232,29,12,17
15,28,233,8,7,1
15,28,234,9,13,-4
15,28,235,18,20,-2
15,28,236,15,15,0
15,28,237,25,8,17
15,28,238,16,7,9
15,28,239,31,6,25
15,28,240,20,5,15
15,28,241,27,12,15
15,28,242,19,20,-1
15,28,243,14,12,2
15,28,244,20,15,5
15,28,245,23,12,11
15,28,246,18,7,11
15,28,247,14,13,1
15,28,248,17,9,8
15,28,249,9,15,-6
15,28,250,22,20,2
15,28,251,27,19,8
15,28,252,21,5,16
15,28,253,31,20,11
15,28,254,23,11,12
15,28,255,20,13,7
15,28,256,21,9,12
15,28,257,7,14,-7
15,28,258,18,9,9
15,28,259,13,4,9
15,28,260,15,19,-4
15,28,261,20,22,-2
15,28,262,19,17,2
15,28,263,8,19,-11
15,28,264,6,12,-6
15,28,265,20,5,15
15,28,266,22,12,10
15,28,267,17,13,4
15,28,268,16,11,5
15,28,269,18,7,11
15,28,270,13,15,-2
15,28,271,11,11,0
15,28,272,14,13,1
15,28,273,27,17,10
15,28,274,14,10,4
15,28,275,21,12,9
15,28,276,15,17,-2
15,28,277,6,5,1
15,28,278,19,11,8
15,28,279,24,14,10
15,28,280,32,16,16
15,28,281,22,14,8
15,28,282,8,3,5
15,28,283,15,16,-1
15,28,284,17,18,-1
15,28,285,25,12,13
15,28,286,33,24,9
15,28,287,19,9,10
15,28,288,13,18,-5
15,28,289,16,10,6
15,28,290,15,7,8
15,28,291,20,9,11
15,28,292,16,24,-8
15,28,293,16,13,3
15,28,294,13,11,2
15,28,295,15,16,-1
15,28,296,18,9,9
15,28,297,28,10,18
15,28,298,15,12,3
15,28,299,19,3,16
15,29,0,14,13,1
15,29,1,29,21,8
15,29,2,15,13,2
15,29,3,20,18,2
15,29,4,9,14,-5
15,29,5,13,12,1
15,29,6,11,9,2
15,29,7,22,12,10
15,29,8,22,17,5
15,29,9,27,15,12
15,29,10,16,10,6
15,29,11,25,9,16
15,29,12,18,8,10
15,29,13,14,10,4
15,29,14,37,16,21
15,29,15,13,13,0
15,29,16,14,8,6
15,29,17,6,8,-2
15,29,18,10,11,-1
15,29,19,16,20,-4
15,29,20,8,12,-4
15,29,21,8,4,4
15,29,22,25,13,12
15,29,23,15,16,-1
15,29,24,31,22,9
15,29,25,13,10,3
15,29,26,17,10,7
15,29,27,5,8,-3
15,29,28,10,11,-1
15,29,29,17,6,11
15,29,30,17,18,-1
15,29,31,19,18,1
15,29,32,6,20,-14
15,29,33,8,8,0
15,29,34,17,9,8
15,29,35,14,14,0
15,29,36,22,23,-1
15,29,37,25,20,5
15,29,38,14,2,12
15,29,39,17,10,7
15,29,40,23,12,11
15,29,41,19,13,6
15,29,42,15,7,8
15,29,43,20,11,9
15,29,44,14,7,7
15,29,45,23,16,7
15,29,46,10,18,-8
15,29,47,25,19,6
15,29,48,17,15,2
15,29,49,15,16,-1
15,29,50,14,5,9
15,29,51,15,9,6
15,29,52,10,6,4
15,29,53,16,5,11
15,29,54,20,15,5
15,29,55,23,11,12
15,29,56,4,9,-5
15,29,57,12,10,2
15,29,58,31,8,23
15,29,59,18,8,10
15,29,60,17,9,8
15,29,61,16,3,13
15,29,62,9,14,-5
15,29,63,12,20,-8
15,29,64,17,6,11
15,29,65,32,14,18
15,29,66,22,9,13
15,29,67,17,11,6
15,29,68,24,15,9
15,29,69,17,7,10
15,29,70,15,16,-1
15,29,71,14,11,3
15,29,72,23,6,17
15,29,73,19,8,11
15,29,74,20,14,6
15,29,75,19,18,1
15,29,76,9,6,3
15,29,77,15,6,9
15,29,78,5,8,-3
15,29,79,8,14,-6
15,29,80,5,13,-8
15,29,81,24,9,15
15,29,82,15,13,2
15,29,83,13,12,1
15,29,84,25,12,13
15,29,85,23,22,1
15,29,86,27,9,18
15,29,87,9,8,1
15,29,88,20,8,12
15,29,89,11,14,-3
15,29,90,15,5,10
15,29,91,15,17,-2
15,29,92,20,14,6
15,29,93,19,5,14
15,29,94,23,10,13
15,29,95,29,13,16
15,29,96,13,5,8
15,29,97,20,13,7
15,29,98,14,11,3
15,29,99,10,12,-2
15,29,100,8,12,-4
15,29,101,9,9,0
15,29,102,12,10,2
15,29,103,15,6,9
15,29,104,29,5,24
15,29,105,14,11,3
15,29,106,17,31,-14
15,29,107,2,7,-5
15,29,108,16,13,3
15,29,109,26,9,17
15,29,110,21,15,6
15,29,111,12,18,-6
15,29,112,10,2,8
15,29,113,17,14,3
15,29,114,20,19,1
15,29,115,11,13,-2
15,29,116,23,11,12
15,29,117,14,9,5
15,29,118,28,14,14
15,29,119,24,17,7
15,29,120,13,8,5
15,29,121,16,13,3
15,29,122,20,24,-4
15,29,123,23,8,15
15,29,124,16,16,0
15,29,125,4,10,-6
15,29,126,13,13,0
15,29,127,7,0,7
15,29,128,21,13,8
15,29,129,33,21,12
15,29,130,15,10,5
15,29,131,13,5,8
15,29,132,15,14,1
15,29,133,25,12,13
15,29,134,18,11,7
15,29,135,13,3,10
15,29,136,8,13,-5
15,29,137,19,16,3
15,29,138,4,8,-4
15,29,139,20,11,9
15,29,140,17,10,7
15,29,141,13,10,3
15,29,142,25,10,15
15,29,143,22,13,9
15,29,144,24,25,-1
15,29,145,19,3,16
15,29,146,14,14,0
15,29,147,11,8,3
15,29,148,15,14,1
15,29,149,22,7,15
15,29,150,25,18,7
15,29,151,18,15,3
15,29,152,14,12,2
15,29,153,14,6,8
15,29,154,7,6,1
15,29,155,8,9,-1
15,29,156,27,14,13
15,29,157,18,7,11
15,29,158,18,11,7
15,29,159,11,9,2
15,29,160,26,14,12
15,29,161,16,7,9
15,29,162,12,6,6
15,29,163,7,9,-2
15,29,164,17,10,7
15,29,165,21,12,9
15,29,166,22,12,10
15,29,167,14,15,-1
15,29,168,20,12,8
15,29,169,19,7,12
15,29,170,26,11,15
15,29,171,13,6,7
15,29,172,18,11,7
15,29,173,31,20,11
15,29,174,14,6,8
15,29,175,21,13,8
15,29,176,7,3,4
15,29,177,14,10,4
15,29,178,14,8,6
15,29,179,18,21,-3
15,29,180,15,24,-9
15,29,181,26,6,20
15,29,182,9,9,0
15,29,183,10,3,7
15,29,184,13,14,-1
15,29,185,14,14,0
15,29,186,10,25,-15
15,29,187,28,17,11
15,29,188,12,12,0
15,29,189,21,24,-3
15,29,190,8,17,-9
15,29,191,18,8,10
15,29,192,7,8,-1
15,29,193,16,10,6
15,29,194,22,12,10
15,29,195,17,14,3
15,29,196,21,8,13
15,29,197,8,7,1
15,29,198,10,7,3
15,29,199,7,10,-3
15,29,200,8,5,3
15,29,201,16,9,7
15,29,202,31,23,8
15,29,203,14,12,2
15,29,204,11,4,7
15,29,205,16,13,3
15,29,206,15,10,5
15,29,207,21,12,9
15,29,208,10,2,8
15,29,209,13,13,0
15,29,210,29,11,18
15,29,211,13,23,-10
15,29,212,14,11,3
15,29,213,15,19,-4
15,29,214,9,6,3
15,29,215,10,7,3
15,29,216,13,12,1
15,29,217,23,12,11
15,29,218,18,15,3
15,29,219,20,9,11
15,29,220,23,11,12
15,29,221,19,11,8
15,29,222,17,16,1
15,29,223,18,8,10
15,29,224,14,7,7
15,29,225,13,11,2
15,29,226,25,14,11
15,29,227,3,14,-11
15,29,228,14,12,2
15,29,229,16,13,3
15,29,230,23,21,2
15,29,231,15,11,4
15,29,232,5,9,-4
15,29,233,13,3,10
15,29,234,29,16,13
15,29,235,14,14,0
15,29,236,13,14,-1
15,29,237,14,22,-8
15,29,238,26,15,11
15,29,239,21,18,3
15,29,240,28,16,12
15,29,241,18,7,11
15,29,242,16,6,10
15,29,243,29,15,14
15,29,244,11,13,-2
15,29,245,25,13,12
15,29,246,14,10,4
15,29,247,25,8,17
15,29,248,16,22,-6
15,29,249,15,22,-7
15,29,250,21,10,11
15,29,251,21,11,10
15,29,252,29,20,9
15,29,253,15,12,3
15,29,254,22,19,3
15,29,255,17,9,8
15,29,256,8,6,2
15,29,257,19,4,15
15,29,258,9,6,3
15,29,259,31,13,18
15,29,260,23,11,12
15,29,261,17,22,-5
15,29,262,21,16,5
15,29,263,16,6,10
15,29,264,22,14,8
15,29,265,15,14,1
15,29,266,18,19,-1
15,29,267,14,10,4
15,29,268,7,13,-6
15,29,269,17,16,1
15,29,270,4,13,-9
15,29,271,27,11,16
15,29,272,22,14,8
15,29,273,20,9,11
15,29,274,13,4,9
15,29,275,5,2,3
15,29,276,18,20,-2
15,29,277,10,9,1
15,29,278,12,10,2
15,29,279,12,9,3
15,29,280,31,14,17
15,29,281,22,14,8
15,29,282,25,13,12
15,29,283,20,21,-1
15,29,284,18,24,-6
15,29,285,12,6,6
15,29,286,27,12,15
15,29,287,9,13,-4
15,29,288,8,14,-6
15,29,289,13,8,5
15,29,290,27,10,17
15,29,291,16,12,4
15,29,292,20,9,11
15,29,293,13,4,9
15,29,294,20,8,12
15,29,295,31,18,13
15,29,296,20,28,-8
15,29,297,4,14,-10
15,29,298,17,11,6
15,29,299,7,8,-1
15,30,0,15,13,2
15,30,1,11,18,-7
15,30,2,18,17,1
15,30,3,15,18,-3
15,30,4,27,17,10
15,30,5,14,7,7
15,30,6,14,14,0
15,30,7,23,12,11
15,30,8,12,8,4
15,30,9,9,8,1
15,30,10,17,9,8
15,30,11,22,22,0
15,30,12,15,15,0
15,30,13,21,6,15
15,30,14,18,13,5
15,30,15,15,7,8
15,30,16,23,19,4
15,30,17,15,13,2
15,30,18,17,20,-3
15,30,19,9,12,-3
15,30,20,15,15,0
15,30,21,26,17,9
15,30,22,17,15,2
15,30,23,24,12,12
15,30,24,21,12,9
15,30,25,17,15,2
15,30,26,33,7,26
15,30,27,5,6,-1
15,30,28,22,7,15
15,30,29,14,6,8
15,30,30,15,8,7
15,30,31,13,7,6
15,30,32,16,15,1
15,30,33,11,9,2
15,30,34,19,8,11
15,30,35,19,13,6
15,30,36,18,17,1
15,30,37,13,6,7
15,30,38,11,7,4
15,30,39,8,5,3
15,30,40,9,11,-2
15,30,41,27,14,13
15,30,42,37,12,25
15,30,43,15,12,3
15,30,44,15,15,0
15,30,45,21,17,4
15,30,46,20,5,15
15,30,47,13,10,3
15,30,48,13,3,10
15,30,49,13,11,2
15,30,50,8,15,-7
15,30,51,26,14,12
15,30,52,12,4,8
15,30,53,9,11,-2
15,30,54,23,9,14
15,30,55,25,14,11
15,30,56,32,18,14
15,30,57,10,9,1
15,30,58,8,17,-9
15,30,59,12,17,-5
15,30,60,11,9,2
15,30,61,23,16,7
15,30,62,21,12,9
15,30,63,16,12,4
15,30,64,10,9,1
15,30,65,18,7,11
15,30,66,5,32,-27
15,30,67,12,9,3
15,30,68,17,11,6
15,30,69,18,12,6
15,30,70,9,9,0
15,30,71,14,7,7
15,30,72,30,19,11
15,30,73,12,7,5
15,30,74,27,10,17
15,30,75,28,12,16
15,30,76,21,8,13
15,30,77,14,9,5
15,30,78,15,7,8
15,30,79,25,19,6
15,30,80,15,12,3
15,30,81,15,5,10
15,30,82,21,9,12
15,30,83,7,7,0
15,30,84,12,14,-2
15,30,85,13,7,6
15,30,86,17,8,9
15,30,87,19,6,13
15,30,88,20,3,17
15,30,89,13,15,-2
15,30,90,31,20,11
15,30,91,13,14,-1
15,30,92,3,9,-6
15,30,93,19,20,-1
15,30,94,24,18,6
15,30,95,17,15,2
15,30,96,12,12,0
15,30,97,14,3,11
15,30,98,6,0,6
15,30,99,10,8,2
15,30,100,31,13,18
15,30,101,14,15,-1
15,30,102,19,7,12
15,30,103,11,14,-3
15,30,104,18,10,8
15,30,105,15,16,-1
15,30,106,17,15,2
15,30,107,18,21,-3
15,30,108,12,10,2
15,30,109,21,9,12
15,30,110,10,19,-9
15,30,111,10,6,4
15,30,112,12,18,-6
15,30,113,18,8,10
15,30,114,13,13,0
15,30,115,26,18,8
15,30,116,15,2,13
15,30,117,43,19,24
15,30,118,20,12,8
15,30,119,27,17,10
15,30,120,25,15,10
15,30,121,36,19,17
15,30,122,9,9,0
15,30,123,20,19,1
15,30,124,12,6,6
15,30,125,18,9,9
15,30,126,27,17,10
15,30,127,29,18,11
15,30,128,11,13,-2
15,30,129,15,7,8
15,30,130,10,13,-3
15,30,131,20,8,12
15,30,132,29,17,12
15,30,133,17,10,7
15,30,134,17,12,5
15,30,135,28,10,18
15,30,136,7,3,4
15,30,137,10,10,0
15,30,138,17,13,4
15,30,139,7,12,-5
15,30,140,10,13,-3
15,30,141,19,12,7
15,30,142,19,12,7
15,30,143,16,16,0
15,30,144,17,11,6
15,30,145,12,4,8
15,30,146,10,6,4
15,30,147,13,19,-6
15,30,148,14,14,0
15,30,149,13,6,7
15,30,150,19,10,9
15,30,151,4,3,1
15,30,152,13,9,4
15,30,153,16,9,7
15,30,154,25,14,11
15,30,155,17,12,5
15,30,156,11,7,4
15,30,157,17,12,5
15,30,158,9,17,-8
15,30,159,26,12,14
15,30,160,18,16,2
15,30,161,10,8,2
15,30,162,14,6,8
15,30,163,15,8,7
15,30,164,11,4,7
15,30,165,13,16,-3
15,30,166,11,10,1
15,30,167,23,8,15
15,30,168,26,19,7
15,30,169,24,2,22
15,30,170,20,5,15
15,30,171,24,14,10
15,30,172,15,7,8
15,30,173,11,11,0
15,30,174,16,10,6
15,30,175,9,11,-2
15,30,176,22,9,13
15,30,177,22,11,11
15,30,178,25,22,3
15,30,179,3,10,-7
15,30,180,25,22,3
15,30,181,8,18,-10
15,30,182,18,7,11
15,30,183,25,8,17
15,30,184,11,10,1
15,30,185,18,13,5
15,30,186,29,15,14
15,30,187,12,7,5
15,30,188,19,7,12
15,30,189,15,10,5
15,30,190,20,8,12
15,30,191,16,8,8
15,30,192,30,17,13
15,30,193,10,12,-2
15,30,194,23,16,7
15,30,195,23,20,3
15,30,196,12,12,0
15,30,197,18,11,7
15,30,198,11,18,-7
15,30,199,22,12,10
15,30,200,15,24,-9
15,30,201,27,22,5
15,30,202,6,16,-10
15,30,203,20,12,8
15,30,204,13,6,7
15,30,205,15,18,-3
15,30,206,22,9,13
15,30,207,12,9,3
15,30,208,10,12,-2
15,30,209,10,4,6
15,30,210,29,22,7
15,30,211,9,7,2
15,30,212,18,8,10
15,30,213,13,12,1
15,30,214,31,8,23
15,30,215,21,8,13
15,30,216,14,5,9
15,30,217,20,7,13
15,30,218,13,15,-2
15,30,219,22,15,7
15,30,220,22,24,-2
15,30,221,17,9,8
15,30,222,28,20,8
15,30,223,23,15,8
15,30,224,11,8,3
15,30,225,11,9,2
15,30,226,28,8,20
15,30,227,10,13,-3
15,30,228,10,9,1
15,30,229,24,22,2
15,30,230,26,9,17
15,30,231,22,8,14
15,30,232,31,12,19
15,30,233,5,12,-7
15,30,234,28,3,25
15,30,235,16,7,9
15,30,236,20,16,4
15,30,237,19,6,13
15,30,238,23,8,15
15,30,239,22,10,12
15,30,240,6,12,-6
15,30,241,24,19,5
15,30,242,7,16,-9
15,30,243,17,6,11
15,30,244,15,17,-2
15,30,245,11,3,8
15,30,246,9,6,3
15,30,247,7,10,-3
15,30,248,16,15,1
15,30,249,12,14,-2
15,30,250,16,6,10
15,30,251,10,13,-3
15,30,252,11,8,3
15,30,253,15,11,4
15,30,254,16,7,9
15,30,255,14,18,-4
15,30,256,21,13,8
15,30,257,24,19,5
15,30,258,14,10,4
15,30,259,15,11,4
15,30,260,13,8,5
15,30,261,7,9,-2
15,30,262,14,16,-2
15,30,263,23,6,17
15,30,264,17,13,4
15,30,265,7,9,-2
15,30,266,10,12,-2
15,30,267,17,21,-4
15,30,268,16,8,8
15,30,269,6,7,-1
15,30,270,10,3,7
15,30,271,12,15,-3
15,30,272,18,19,-1
15,30,273,24,21,3
15,30,274,14,14,0
15,30,275,13,15,-2
15,30,276,7,11,-4
15,30,277,28,19,9
15,30,278,8,8,0
15,30,279,19,18,1
15,30,280,22,14,8
15,30,281,12,10,2
15,30,282,19,13,6
15,30,283,13,8,5
15,30,284,15,15,0
15,30,285,17,13,4
15,30,286,24,14,10
15,30,287,19,11,8
15,30,288,9,10,-1
15,30,289,21,13,8
15,30,290,21,9,12
15,30,291,14,5,9
15,30,292,15,9,6
15,30,293,18,4,14
15,30,294,30,11,19
15,30,295,29,7,22
15,30,296,6,5,1
15,30,297,14,9,5
15,30,298,12,7,5
15,30,299,16,7,9
