# frame_skip_agent_A, frame_skip_agent_B, episode, score_A, score_B, reward
2,1,0,6,11,-5
2,1,1,9,30,-21
2,1,2,3,7,-4
2,1,3,13,12,1
2,1,4,3,5,-2
2,1,5,1,4,-3
2,1,6,9,4,5
2,1,7,6,10,-4
2,1,8,3,7,-4
2,1,9,13,19,-6
2,1,10,4,6,-2
2,1,11,6,12,-6
2,1,12,6,4,2
2,1,13,6,8,-2
2,1,14,6,11,-5
2,1,15,15,17,-2
2,1,16,12,9,3
2,1,17,11,9,2
2,1,18,5,15,-10
2,1,19,0,3,-3
2,1,20,3,7,-4
2,1,21,5,3,2
2,1,22,6,6,0
2,1,23,4,2,2
2,1,24,5,4,1
2,1,25,3,3,0
2,1,26,12,7,5
