# frame_skip_agent_A, frame_skip_agent_B, episode, score_A, score_B, reward
21,1,0,10,8,2
21,1,1,19,20,-1
21,1,2,14,42,-28
21,1,3,7,12,-5
21,1,4,5,7,-2
21,1,5,10,10,0
21,1,6,3,9,-6
21,1,7,14,37,-23
21,1,8,12,34,-22
21,1,9,10,27,-17
21,1,10,7,18,-11
21,1,11,8,21,-13
21,1,12,9,9,0
21,1,13,1,14,-13
21,1,14,19,13,6
21,1,15,10,15,-5
21,1,16,10,24,-14
21,1,17,15,22,-7
21,1,18,4,9,-5
21,1,19,7,16,-9
21,1,20,4,10,-6
21,1,21,11,17,-6
21,1,22,8,6,2
21,1,23,4,17,-13
21,1,24,2,17,-15
21,1,25,9,46,-37
21,1,26,5,4,1
21,1,27,6,14,-8
21,1,28,5,11,-6
21,1,29,2,9,-7
21,1,30,8,16,-8
21,1,31,12,31,-19
21,1,32,13,25,-12
21,1,33,0,8,-8
21,1,34,12,14,-2
21,1,35,13,24,-11
21,1,36,15,16,-1
21,1,37,8,24,-16
21,1,38,4,4,0
21,1,39,12,16,-4
21,1,40,7,11,-4
21,1,41,3,16,-13
21,1,42,11,22,-11
21,1,43,4,8,-4
21,1,44,10,18,-8
21,1,45,7,9,-2
21,1,46,2,8,-6
21,1,47,9,12,-3
21,1,48,4,10,-6
21,1,49,13,15,-2
21,1,50,12,9,3
21,1,51,10,10,0
21,1,52,8,19,-11
21,1,53,9,12,-3
21,1,54,10,17,-7
21,1,55,9,15,-6
21,1,56,7,14,-7
21,1,57,8,10,-2
21,1,58,8,16,-8
21,1,59,13,16,-3
21,1,60,4,16,-12
21,1,61,3,8,-5
21,1,62,3,9,-6
21,1,63,4,8,-4
21,1,64,7,11,-4
21,1,65,9,15,-6
21,1,66,4,26,-22
21,1,67,7,9,-2
21,1,68,2,11,-9
21,1,69,9,25,-16
21,1,70,8,12,-4
21,1,71,4,19,-15
21,1,72,13,16,-3
21,1,73,4,22,-18
21,1,74,5,9,-4
21,1,75,5,16,-11
21,1,76,6,7,-1
21,1,77,9,8,1
21,1,78,3,11,-8
21,1,79,11,11,0
21,1,80,9,15,-6
21,1,81,8,23,-15
21,1,82,4,13,-9
21,1,83,8,7,1
21,1,84,2,4,-2
21,1,85,3,13,-10
21,1,86,3,9,-6
21,1,87,8,15,-7
21,1,88,6,14,-8
21,1,89,14,22,-8
21,1,90,12,17,-5
21,1,91,9,13,-4
21,1,92,11,16,-5
21,1,93,4,17,-13
21,1,94,5,17,-12
21,1,95,12,24,-12
21,1,96,4,17,-13
21,1,97,10,18,-8
21,1,98,8,15,-7
21,1,99,16,26,-10
21,1,100,14,9,5
21,1,101,14,16,-2
21,1,102,13,20,-7
21,1,103,3,22,-19
21,1,104,4,17,-13
21,1,105,14,10,4
21,1,106,11,21,-10
21,1,107,4,28,-24
21,1,108,9,9,0
21,1,109,22,23,-1
21,1,110,10,13,-3
21,1,111,23,29,-6
21,1,112,4,8,-4
21,1,113,10,15,-5
21,1,114,9,37,-28
21,1,115,17,22,-5
21,1,116,11,19,-8
21,1,117,8,13,-5
21,1,118,7,9,-2
21,1,119,9,9,0
21,1,120,13,22,-9
21,1,121,7,16,-9
21,1,122,9,31,-22
21,1,123,10,9,1
21,1,124,12,21,-9
21,1,125,16,16,0
21,1,126,6,6,0
21,1,127,10,16,-6
21,1,128,14,22,-8
21,1,129,13,22,-9
21,1,130,9,17,-8
21,1,131,11,19,-8
21,1,132,7,10,-3
21,1,133,7,28,-21
21,1,134,9,9,0
21,1,135,5,8,-3
21,1,136,8,13,-5
21,1,137,13,15,-2
21,1,138,9,9,0
21,1,139,4,19,-15
21,1,140,6,13,-7
21,1,141,8,18,-10
21,1,142,9,20,-11
21,1,143,15,15,0
21,1,144,2,21,-19
21,1,145,6,25,-19
21,1,146,6,11,-5
21,1,147,10,17,-7
21,1,148,7,18,-11
21,1,149,12,16,-4
21,1,150,11,11,0
21,1,151,13,13,0
21,1,152,4,12,-8
21,1,153,18,15,3
21,1,154,9,5,4
21,1,155,6,13,-7
21,1,156,7,6,1
21,1,157,1,8,-7
21,1,158,14,26,-12
21,1,159,4,11,-7
21,1,160,5,14,-9
21,1,161,10,11,-1
21,1,162,12,15,-3
21,1,163,13,19,-6
21,1,164,3,11,-8
21,1,165,15,17,-2
21,1,166,9,24,-15
21,1,167,9,10,-1
21,1,168,15,19,-4
21,1,169,17,13,4
21,1,170,8,14,-6
21,1,171,12,13,-1
21,1,172,7,17,-10
21,1,173,8,9,-1
21,1,174,8,23,-15
21,1,175,11,15,-4
21,1,176,10,15,-5
21,1,177,5,9,-4
21,1,178,10,15,-5
21,1,179,8,18,-10
21,1,180,4,11,-7
21,1,181,1,20,-19
21,1,182,2,9,-7
21,1,183,12,17,-5
21,1,184,9,8,1
21,1,185,4,18,-14
21,1,186,9,25,-16
21,1,187,6,8,-2
21,1,188,8,21,-13
21,1,189,13,15,-2
21,1,190,5,21,-16
21,1,191,3,18,-15
21,1,192,7,8,-1
21,1,193,9,13,-4
21,1,194,9,15,-6
21,1,195,12,14,-2
21,1,196,5,11,-6
21,1,197,4,18,-14
21,1,198,13,15,-2
21,1,199,8,19,-11
21,1,200,4,17,-13
21,1,201,8,13,-5
21,1,202,1,4,-3
21,1,203,3,14,-11
21,1,204,11,12,-1
21,1,205,16,16,0
21,1,206,19,22,-3
21,1,207,8,14,-6
21,1,208,5,10,-5
21,1,209,13,21,-8
21,1,210,7,24,-17
21,1,211,9,25,-16
21,1,212,10,11,-1
21,1,213,9,17,-8
21,1,214,3,11,-8
21,1,215,7,13,-6
21,1,216,11,22,-11
21,1,217,11,19,-8
21,1,218,9,20,-11
21,1,219,9,16,-7
21,1,220,13,20,-7
21,1,221,2,11,-9
21,1,222,7,10,-3
21,1,223,4,15,-11
21,1,224,6,14,-8
21,1,225,9,11,-2
21,1,226,9,22,-13
21,1,227,11,10,1
21,1,228,7,13,-6
21,1,229,17,18,-1
21,1,230,2,8,-6
21,1,231,9,12,-3
21,1,232,5,15,-10
21,1,233,9,22,-13
21,1,234,9,15,-6
21,1,235,9,9,0
21,1,236,7,16,-9
21,1,237,9,25,-16
21,1,238,13,17,-4
21,1,239,4,13,-9
21,1,240,7,7,0
21,1,241,11,20,-9
21,1,242,7,12,-5
21,1,243,15,19,-4
21,1,244,11,16,-5
21,1,245,5,17,-12
21,1,246,6,16,-10
21,1,247,8,21,-13
21,1,248,6,22,-16
21,1,249,24,16,8
21,1,250,7,18,-11
21,1,251,3,19,-16
21,1,252,11,15,-4
21,1,253,3,14,-11
21,1,254,8,18,-10
21,1,255,12,18,-6
21,1,256,4,17,-13
21,1,257,11,31,-20
21,1,258,14,15,-1
21,1,259,8,7,1
21,1,260,3,10,-7
21,1,261,11,24,-13
21,1,262,11,15,-4
21,1,263,9,22,-13
21,1,264,9,17,-8
21,1,265,7,11,-4
21,1,266,20,18,2
21,1,267,9,23,-14
21,1,268,4,12,-8
21,1,269,6,8,-2
21,1,270,9,19,-10
21,1,271,2,8,-6
21,1,272,8,17,-9
21,1,273,5,6,-1
21,1,274,6,25,-19
21,1,275,6,23,-17
21,1,276,10,18,-8
21,1,277,5,7,-2
21,1,278,7,13,-6
21,1,279,11,16,-5
21,1,280,12,17,-5
21,1,281,6,20,-14
21,1,282,7,12,-5
21,1,283,6,13,-7
21,1,284,5,28,-23
21,1,285,8,11,-3
21,1,286,10,23,-13
21,1,287,8,24,-16
21,1,288,19,27,-8
21,1,289,10,13,-3
21,1,290,5,11,-6
21,1,291,6,12,-6
21,1,292,8,20,-12
21,1,293,11,22,-11
21,1,294,1,9,-8
21,1,295,2,7,-5
21,1,296,7,16,-9
21,1,297,4,19,-15
21,1,298,8,4,4
21,1,299,1,15,-14
21,2,0,7,22,-15
21,2,1,10,9,1
21,2,2,10,27,-17
21,2,3,11,21,-10
21,2,4,8,19,-11
21,2,5,4,19,-15
21,2,6,10,20,-10
21,2,7,11,27,-16
21,2,8,16,16,0
21,2,9,16,31,-15
21,2,10,6,20,-14
21,2,11,18,29,-11
21,2,12,17,18,-1
21,2,13,3,28,-25
21,2,14,10,9,1
21,2,15,15,16,-1
21,2,16,5,19,-14
21,2,17,14,24,-10
21,2,18,3,24,-21
21,2,19,5,18,-13
21,2,20,0,12,-12
21,2,21,8,13,-5
21,2,22,8,15,-7
21,2,23,16,20,-4
21,2,24,10,21,-11
21,2,25,6,12,-6
21,2,26,11,23,-12
21,2,27,10,20,-10
21,2,28,4,16,-12
21,2,29,11,18,-7
21,2,30,1,13,-12
21,2,31,6,12,-6
21,2,32,2,14,-12
21,2,33,8,17,-9
21,2,34,12,27,-15
21,2,35,1,13,-12
21,2,36,19,24,-5
21,2,37,5,11,-6
21,2,38,9,12,-3
21,2,39,9,24,-15
21,2,40,5,13,-8
21,2,41,9,12,-3
21,2,42,9,25,-16
21,2,43,6,20,-14
21,2,44,9,17,-8
21,2,45,13,11,2
21,2,46,9,7,2
21,2,47,9,11,-2
21,2,48,5,12,-7
21,2,49,16,18,-2
21,2,50,3,18,-15
21,2,51,4,19,-15
21,2,52,8,22,-14
21,2,53,5,13,-8
21,2,54,6,22,-16
21,2,55,20,31,-11
21,2,56,5,12,-7
21,2,57,8,15,-7
21,2,58,8,26,-18
21,2,59,8,5,3
21,2,60,11,29,-18
21,2,61,3,8,-5
21,2,62,7,21,-14
21,2,63,12,17,-5
21,2,64,7,14,-7
21,2,65,10,32,-22
21,2,66,7,33,-26
21,2,67,5,19,-14
21,2,68,16,14,2
21,2,69,11,28,-17
21,2,70,7,10,-3
21,2,71,3,8,-5
21,2,72,9,17,-8
21,2,73,13,7,6
21,2,74,9,11,-2
21,2,75,19,18,1
21,2,76,25,13,12
21,2,77,4,5,-1
21,2,78,3,11,-8
21,2,79,6,18,-12
21,2,80,12,8,4
21,2,81,12,16,-4
21,2,82,13,20,-7
21,2,83,13,6,7
21,2,84,10,14,-4
21,2,85,11,15,-4
21,2,86,10,12,-2
21,2,87,11,16,-5
21,2,88,11,4,7
21,2,89,13,23,-10
21,2,90,17,14,3
21,2,91,5,23,-18
21,2,92,9,10,-1
21,2,93,12,20,-8
21,2,94,11,15,-4
21,2,95,4,13,-9
21,2,96,5,18,-13
21,2,97,8,15,-7
21,2,98,10,13,-3
21,2,99,5,5,0
21,2,100,8,14,-6
21,2,101,4,23,-19
21,2,102,8,26,-18
21,2,103,9,20,-11
21,2,104,7,16,-9
21,2,105,5,20,-15
21,2,106,14,26,-12
21,2,107,10,12,-2
21,2,108,11,12,-1
21,2,109,12,38,-26
21,2,110,5,8,-3
21,2,111,10,26,-16
21,2,112,12,34,-22
21,2,113,2,20,-18
21,2,114,9,13,-4
21,2,115,7,17,-10
21,2,116,5,9,-4
21,2,117,5,7,-2
21,2,118,8,15,-7
21,2,119,5,19,-14
21,2,120,9,17,-8
21,2,121,8,1,7
21,2,122,9,10,-1
21,2,123,15,20,-5
21,2,124,8,12,-4
21,2,125,21,30,-9
21,2,126,9,19,-10
21,2,127,14,13,1
21,2,128,14,29,-15
21,2,129,11,20,-9
21,2,130,12,22,-10
21,2,131,7,11,-4
21,2,132,6,26,-20
21,2,133,7,38,-31
21,2,134,6,9,-3
21,2,135,6,28,-22
21,2,136,16,32,-16
21,2,137,9,26,-17
21,2,138,10,14,-4
21,2,139,17,28,-11
21,2,140,12,25,-13
21,2,141,12,14,-2
21,2,142,11,27,-16
21,2,143,3,24,-21
21,2,144,4,18,-14
21,2,145,0,17,-17
21,2,146,5,23,-18
21,2,147,7,6,1
21,2,148,6,13,-7
21,2,149,7,16,-9
21,2,150,13,19,-6
21,2,151,12,16,-4
21,2,152,9,31,-22
21,2,153,7,10,-3
21,2,154,15,37,-22
21,2,155,4,11,-7
21,2,156,2,16,-14
21,2,157,6,22,-16
21,2,158,7,26,-19
21,2,159,3,5,-2
21,2,160,5,15,-10
21,2,161,2,18,-16
21,2,162,7,9,-2
21,2,163,8,19,-11
21,2,164,1,12,-11
21,2,165,11,11,0
21,2,166,13,16,-3
21,2,167,3,14,-11
21,2,168,16,19,-3
21,2,169,4,20,-16
21,2,170,5,10,-5
21,2,171,8,23,-15
21,2,172,9,10,-1
21,2,173,12,10,2
21,2,174,10,36,-26
21,2,175,9,28,-19
21,2,176,10,20,-10
21,2,177,10,15,-5
21,2,178,12,16,-4
21,2,179,6,18,-12
21,2,180,9,33,-24
21,2,181,10,20,-10
21,2,182,10,20,-10
21,2,183,9,17,-8
21,2,184,12,24,-12
21,2,185,4,15,-11
21,2,186,13,16,-3
21,2,187,8,10,-2
21,2,188,2,7,-5
21,2,189,15,38,-23
21,2,190,13,22,-9
21,2,191,5,5,0
21,2,192,10,19,-9
21,2,193,7,17,-10
21,2,194,15,26,-11
21,2,195,8,10,-2
21,2,196,7,29,-22
21,2,197,1,9,-8
21,2,198,13,12,1
21,2,199,2,8,-6
21,2,200,11,18,-7
21,2,201,9,21,-12
21,2,202,4,8,-4
21,2,203,6,13,-7
21,2,204,3,10,-7
21,2,205,13,26,-13
21,2,206,8,11,-3
21,2,207,4,15,-11
21,2,208,9,10,-1
21,2,209,3,19,-16
21,2,210,11,40,-29
21,2,211,9,9,0
21,2,212,13,28,-15
21,2,213,16,33,-17
21,2,214,18,21,-3
21,2,215,6,23,-17
21,2,216,15,11,4
21,2,217,7,10,-3
21,2,218,18,30,-12
21,2,219,5,11,-6
21,2,220,12,21,-9
21,2,221,14,18,-4
21,2,222,10,22,-12
21,2,223,5,8,-3
21,2,224,2,27,-25
21,2,225,21,23,-2
21,2,226,4,9,-5
21,2,227,3,23,-20
21,2,228,8,11,-3
21,2,229,13,24,-11
21,2,230,10,11,-1
21,2,231,9,22,-13
21,2,232,5,14,-9
21,2,233,21,17,4
21,2,234,11,21,-10
21,2,235,13,20,-7
21,2,236,9,13,-4
21,2,237,2,16,-14
21,2,238,5,18,-13
21,2,239,17,31,-14
21,2,240,8,18,-10
21,2,241,19,19,0
21,2,242,9,13,-4
21,2,243,12,16,-4
21,2,244,5,13,-8
21,2,245,11,14,-3
21,2,246,5,17,-12
21,2,247,9,24,-15
21,2,248,4,12,-8
21,2,249,5,24,-19
21,2,250,4,13,-9
21,2,251,17,19,-2
21,2,252,13,28,-15
21,2,253,8,18,-10
21,2,254,10,29,-19
21,2,255,11,16,-5
21,2,256,4,9,-5
21,2,257,14,27,-13
21,2,258,6,25,-19
21,2,259,7,27,-20
21,2,260,10,26,-16
21,2,261,16,21,-5
21,2,262,13,27,-14
21,2,263,8,13,-5
21,2,264,6,22,-16
21,2,265,8,24,-16
21,2,266,4,11,-7
21,2,267,10,17,-7
21,2,268,10,5,5
21,2,269,11,29,-18
21,2,270,6,3,3
21,2,271,6,19,-13
21,2,272,8,13,-5
21,2,273,12,25,-13
21,2,274,13,13,0
21,2,275,9,17,-8
21,2,276,10,23,-13
21,2,277,6,15,-9
21,2,278,22,37,-15
21,2,279,2,22,-20
21,2,280,7,15,-8
21,2,281,14,7,7
21,2,282,16,28,-12
21,2,283,9,19,-10
21,2,284,12,33,-21
21,2,285,2,4,-2
21,2,286,10,13,-3
21,2,287,10,13,-3
21,2,288,10,23,-13
21,2,289,15,15,0
21,2,290,19,26,-7
21,2,291,8,20,-12
21,2,292,11,22,-11
21,2,293,8,18,-10
21,2,294,1,10,-9
21,2,295,8,21,-13
21,2,296,7,12,-5
21,2,297,11,26,-15
21,2,298,5,16,-11
21,2,299,8,14,-6
21,3,0,13,20,-7
21,3,1,7,9,-2
21,3,2,16,18,-2
21,3,3,17,24,-7
21,3,4,12,17,-5
21,3,5,14,31,-17
21,3,6,5,11,-6
21,3,7,13,29,-16
21,3,8,12,21,-9
21,3,9,9,14,-5
21,3,10,14,9,5
21,3,11,12,18,-6
21,3,12,13,19,-6
21,3,13,7,20,-13
21,3,14,11,21,-10
21,3,15,6,8,-2
21,3,16,8,12,-4
21,3,17,10,14,-4
21,3,18,10,17,-7
21,3,19,8,23,-15
21,3,20,13,29,-16
21,3,21,8,19,-11
21,3,22,12,14,-2
21,3,23,6,22,-16
21,3,24,7,25,-18
21,3,25,7,21,-14
21,3,26,16,15,1
21,3,27,11,20,-9
21,3,28,6,20,-14
21,3,29,14,16,-2
21,3,30,5,25,-20
21,3,31,16,11,5
21,3,32,8,12,-4
21,3,33,14,23,-9
21,3,34,6,11,-5
21,3,35,6,25,-19
21,3,36,6,13,-7
21,3,37,10,19,-9
21,3,38,12,34,-22
21,3,39,20,22,-2
21,3,40,10,21,-11
21,3,41,10,26,-16
21,3,42,4,13,-9
21,3,43,7,28,-21
21,3,44,5,17,-12
21,3,45,8,16,-8
21,3,46,3,27,-24
21,3,47,8,19,-11
21,3,48,3,19,-16
21,3,49,7,18,-11
21,3,50,16,20,-4
21,3,51,11,14,-3
21,3,52,13,19,-6
21,3,53,15,17,-2
21,3,54,13,31,-18
21,3,55,11,13,-2
21,3,56,10,31,-21
21,3,57,5,10,-5
21,3,58,3,11,-8
21,3,59,5,16,-11
21,3,60,5,11,-6
21,3,61,14,24,-10
21,3,62,5,16,-11
21,3,63,11,23,-12
21,3,64,12,26,-14
21,3,65,5,49,-44
21,3,66,14,9,5
21,3,67,8,26,-18
21,3,68,11,27,-16
21,3,69,8,27,-19
21,3,70,10,27,-17
21,3,71,11,15,-4
21,3,72,10,16,-6
21,3,73,7,22,-15
21,3,74,7,13,-6
21,3,75,5,12,-7
21,3,76,10,12,-2
21,3,77,12,30,-18
21,3,78,5,18,-13
21,3,79,7,35,-28
21,3,80,1,17,-16
21,3,81,14,13,1
21,3,82,6,7,-1
21,3,83,13,18,-5
21,3,84,10,24,-14
21,3,85,5,11,-6
21,3,86,5,16,-11
21,3,87,17,29,-12
21,3,88,6,17,-11
21,3,89,12,25,-13
21,3,90,6,19,-13
21,3,91,11,20,-9
21,3,92,9,30,-21
21,3,93,5,17,-12
21,3,94,6,30,-24
21,3,95,17,12,5
21,3,96,13,18,-5
21,3,97,5,32,-27
21,3,98,7,15,-8
21,3,99,6,26,-20
21,3,100,11,27,-16
21,3,101,2,7,-5
21,3,102,9,29,-20
21,3,103,11,30,-19
21,3,104,22,20,2
21,3,105,11,42,-31
21,3,106,12,14,-2
21,3,107,9,9,0
21,3,108,7,15,-8
21,3,109,13,20,-7
21,3,110,14,11,3
21,3,111,7,32,-25
21,3,112,8,13,-5
21,3,113,6,24,-18
21,3,114,1,21,-20
21,3,115,7,24,-17
21,3,116,9,12,-3
21,3,117,1,20,-19
21,3,118,11,22,-11
21,3,119,8,24,-16
21,3,120,3,18,-15
21,3,121,10,32,-22
21,3,122,12,26,-14
21,3,123,12,12,0
21,3,124,4,24,-20
21,3,125,18,24,-6
21,3,126,8,12,-4
21,3,127,6,13,-7
21,3,128,11,17,-6
21,3,129,3,21,-18
21,3,130,6,24,-18
21,3,131,5,13,-8
21,3,132,10,7,3
21,3,133,3,14,-11
21,3,134,7,9,-2
21,3,135,7,14,-7
21,3,136,14,12,2
21,3,137,13,11,2
21,3,138,4,16,-12
21,3,139,4,25,-21
21,3,140,15,16,-1
21,3,141,17,19,-2
21,3,142,5,28,-23
21,3,143,21,23,-2
21,3,144,14,20,-6
21,3,145,20,22,-2
21,3,146,10,11,-1
21,3,147,7,19,-12
21,3,148,5,11,-6
21,3,149,7,11,-4
21,3,150,10,23,-13
21,3,151,13,12,1
21,3,152,15,23,-8
21,3,153,13,14,-1
21,3,154,3,4,-1
21,3,155,11,14,-3
21,3,156,6,26,-20
21,3,157,15,15,0
21,3,158,3,19,-16
21,3,159,8,17,-9
21,3,160,8,13,-5
21,3,161,3,21,-18
21,3,162,4,18,-14
21,3,163,7,11,-4
21,3,164,13,20,-7
21,3,165,16,24,-8
21,3,166,14,19,-5
21,3,167,1,14,-13
21,3,168,7,19,-12
21,3,169,16,16,0
21,3,170,7,15,-8
21,3,171,5,25,-20
21,3,172,9,4,5
21,3,173,16,20,-4
21,3,174,9,12,-3
21,3,175,20,23,-3
21,3,176,4,16,-12
21,3,177,6,30,-24
21,3,178,23,19,4
21,3,179,8,16,-8
21,3,180,9,22,-13
21,3,181,21,14,7
21,3,182,4,19,-15
21,3,183,14,26,-12
21,3,184,6,17,-11
21,3,185,13,20,-7
21,3,186,7,20,-13
21,3,187,13,34,-21
21,3,188,9,24,-15
21,3,189,7,18,-11
21,3,190,16,44,-28
21,3,191,6,11,-5
21,3,192,8,9,-1
21,3,193,2,15,-13
21,3,194,7,21,-14
21,3,195,10,12,-2
21,3,196,10,12,-2
21,3,197,6,25,-19
21,3,198,4,15,-11
21,3,199,5,9,-4
21,3,200,9,11,-2
21,3,201,16,14,2
21,3,202,8,10,-2
21,3,203,6,25,-19
21,3,204,6,23,-17
21,3,205,3,24,-21
21,3,206,3,10,-7
21,3,207,9,20,-11
21,3,208,10,13,-3
21,3,209,14,17,-3
21,3,210,10,24,-14
21,3,211,4,13,-9
21,3,212,17,18,-1
21,3,213,7,16,-9
21,3,214,11,27,-16
21,3,215,15,29,-14
21,3,216,7,21,-14
21,3,217,10,26,-16
21,3,218,12,30,-18
21,3,219,7,22,-15
21,3,220,8,8,0
21,3,221,5,8,-3
21,3,222,5,22,-17
21,3,223,3,25,-22
21,3,224,8,18,-10
21,3,225,6,7,-1
21,3,226,5,18,-13
21,3,227,2,16,-14
21,3,228,6,22,-16
21,3,229,8,20,-12
21,3,230,4,5,-1
21,3,231,7,17,-10
21,3,232,8,17,-9
21,3,233,13,17,-4
21,3,234,5,10,-5
21,3,235,16,29,-13
21,3,236,5,19,-14
21,3,237,7,9,-2
21,3,238,7,21,-14
21,3,239,5,22,-17
21,3,240,10,22,-12
21,3,241,6,13,-7
21,3,242,18,22,-4
21,3,243,19,11,8
21,3,244,7,18,-11
21,3,245,8,23,-15
21,3,246,2,12,-10
21,3,247,4,32,-28
21,3,248,10,13,-3
21,3,249,10,16,-6
21,3,250,3,16,-13
21,3,251,15,24,-9
21,3,252,16,21,-5
21,3,253,14,17,-3
21,3,254,13,22,-9
21,3,255,6,13,-7
21,3,256,12,18,-6
21,3,257,15,20,-5
21,3,258,6,18,-12
21,3,259,8,26,-18
21,3,260,3,22,-19
21,3,261,10,12,-2
21,3,262,9,26,-17
21,3,263,7,28,-21
21,3,264,6,8,-2
21,3,265,4,11,-7
21,3,266,7,17,-10
21,3,267,10,6,4
21,3,268,18,31,-13
21,3,269,0,2,-2
21,3,270,16,12,4
21,3,271,8,16,-8
21,3,272,10,14,-4
21,3,273,8,35,-27
21,3,274,10,20,-10
21,3,275,19,21,-2
21,3,276,7,13,-6
21,3,277,5,14,-9
21,3,278,14,15,-1
21,3,279,22,22,0
21,3,280,21,31,-10
21,3,281,12,18,-6
21,3,282,7,18,-11
21,3,283,4,27,-23
21,3,284,21,19,2
21,3,285,8,15,-7
21,3,286,16,17,-1
21,3,287,3,25,-22
21,3,288,10,16,-6
21,3,289,6,20,-14
21,3,290,14,21,-7
21,3,291,11,19,-8
21,3,292,13,12,1
21,3,293,5,17,-12
21,3,294,6,21,-15
21,3,295,2,14,-12
21,3,296,13,17,-4
21,3,297,4,6,-2
21,3,298,10,37,-27
21,3,299,5,21,-16
21,4,0,2,17,-15
21,4,1,10,15,-5
21,4,2,2,9,-7
21,4,3,15,20,-5
21,4,4,20,34,-14
21,4,5,7,22,-15
21,4,6,13,18,-5
21,4,7,7,19,-12
21,4,8,13,20,-7
21,4,9,13,22,-9
21,4,10,9,19,-10
21,4,11,12,15,-3
21,4,12,6,17,-11
21,4,13,10,15,-5
21,4,14,16,16,0
21,4,15,12,12,0
21,4,16,17,18,-1
21,4,17,11,15,-4
21,4,18,11,25,-14
21,4,19,2,5,-3
21,4,20,13,32,-19
21,4,21,22,41,-19
21,4,22,6,19,-13
21,4,23,11,15,-4
21,4,24,9,15,-6
21,4,25,7,13,-6
21,4,26,8,25,-17
21,4,27,3,20,-17
21,4,28,4,11,-7
21,4,29,5,17,-12
21,4,30,8,34,-26
21,4,31,8,29,-21
21,4,32,7,7,0
21,4,33,6,29,-23
21,4,34,5,9,-4
21,4,35,10,10,0
21,4,36,2,13,-11
21,4,37,10,20,-10
21,4,38,11,18,-7
21,4,39,9,33,-24
21,4,40,9,22,-13
21,4,41,9,25,-16
21,4,42,11,12,-1
21,4,43,14,24,-10
21,4,44,5,11,-6
21,4,45,18,14,4
21,4,46,5,14,-9
21,4,47,10,19,-9
21,4,48,8,23,-15
21,4,49,7,12,-5
21,4,50,11,29,-18
21,4,51,8,18,-10
21,4,52,10,30,-20
21,4,53,14,21,-7
21,4,54,10,20,-10
21,4,55,12,34,-22
21,4,56,7,21,-14
21,4,57,11,15,-4
21,4,58,3,19,-16
21,4,59,7,19,-12
21,4,60,5,13,-8
21,4,61,7,17,-10
21,4,62,10,7,3
21,4,63,9,11,-2
21,4,64,12,19,-7
21,4,65,6,12,-6
21,4,66,13,29,-16
21,4,67,12,22,-10
21,4,68,15,21,-6
21,4,69,12,25,-13
21,4,70,10,16,-6
21,4,71,8,17,-9
21,4,72,11,21,-10
21,4,73,15,11,4
21,4,74,6,22,-16
21,4,75,11,18,-7
21,4,76,6,16,-10
21,4,77,8,23,-15
21,4,78,10,6,4
21,4,79,15,17,-2
21,4,80,15,33,-18
21,4,81,5,14,-9
21,4,82,4,14,-10
21,4,83,7,21,-14
21,4,84,11,14,-3
21,4,85,7,23,-16
21,4,86,13,28,-15
21,4,87,6,9,-3
21,4,88,16,9,7
21,4,89,9,15,-6
21,4,90,4,7,-3
21,4,91,3,9,-6
21,4,92,7,5,2
21,4,93,16,30,-14
21,4,94,12,11,1
21,4,95,14,15,-1
21,4,96,12,17,-5
21,4,97,5,16,-11
21,4,98,9,17,-8
21,4,99,8,16,-8
21,4,100,7,16,-9
21,4,101,14,25,-11
21,4,102,7,8,-1
21,4,103,10,28,-18
21,4,104,7,22,-15
21,4,105,13,7,6
21,4,106,6,4,2
21,4,107,9,18,-9
21,4,108,15,34,-19
21,4,109,4,6,-2
21,4,110,5,13,-8
21,4,111,11,19,-8
21,4,112,12,34,-22
21,4,113,19,25,-6
21,4,114,8,22,-14
21,4,115,15,31,-16
21,4,116,10,16,-6
21,4,117,5,20,-15
21,4,118,9,11,-2
21,4,119,11,19,-8
21,4,120,12,27,-15
21,4,121,1,5,-4
21,4,122,14,18,-4
21,4,123,14,11,3
21,4,124,17,18,-1
21,4,125,7,23,-16
21,4,126,13,24,-11
21,4,127,4,23,-19
21,4,128,12,20,-8
21,4,129,22,33,-11
21,4,130,8,27,-19
21,4,131,10,15,-5
21,4,132,19,19,0
21,4,133,32,34,-2
21,4,134,1,15,-14
21,4,135,14,23,-9
21,4,136,14,14,0
21,4,137,13,19,-6
21,4,138,21,33,-12
21,4,139,7,21,-14
21,4,140,11,13,-2
21,4,141,7,13,-6
21,4,142,14,27,-13
21,4,143,7,20,-13
21,4,144,11,22,-11
21,4,145,15,10,5
21,4,146,9,13,-4
21,4,147,15,12,3
21,4,148,6,11,-5
21,4,149,6,12,-6
21,4,150,8,21,-13
21,4,151,12,24,-12
21,4,152,18,26,-8
21,4,153,5,21,-16
21,4,154,9,31,-22
21,4,155,11,26,-15
21,4,156,9,19,-10
21,4,157,17,21,-4
21,4,158,15,29,-14
21,4,159,29,32,-3
21,4,160,9,20,-11
21,4,161,17,21,-4
21,4,162,9,26,-17
21,4,163,9,13,-4
21,4,164,9,13,-4
21,4,165,8,19,-11
21,4,166,11,19,-8
21,4,167,9,29,-20
21,4,168,9,23,-14
21,4,169,7,23,-16
21,4,170,15,27,-12
21,4,171,16,19,-3
21,4,172,11,16,-5
21,4,173,12,27,-15
21,4,174,18,33,-15
21,4,175,8,6,2
21,4,176,11,4,7
21,4,177,12,26,-14
21,4,178,14,20,-6
21,4,179,5,8,-3
21,4,180,18,28,-10
21,4,181,12,14,-2
21,4,182,6,21,-15
21,4,183,3,5,-2
21,4,184,4,22,-18
21,4,185,13,18,-5
21,4,186,16,13,3
21,4,187,8,38,-30
21,4,188,17,29,-12
21,4,189,14,15,-1
21,4,190,6,12,-6
21,4,191,9,17,-8
21,4,192,18,12,6
21,4,193,9,19,-10
21,4,194,9,15,-6
21,4,195,6,15,-9
21,4,196,10,25,-15
21,4,197,19,22,-3
21,4,198,12,18,-6
21,4,199,6,17,-11
21,4,200,8,16,-8
21,4,201,6,24,-18
21,4,202,11,23,-12
21,4,203,15,16,-1
21,4,204,3,23,-20
21,4,205,12,36,-24
21,4,206,13,36,-23
21,4,207,13,17,-4
21,4,208,14,12,2
21,4,209,15,31,-16
21,4,210,9,14,-5
21,4,211,10,13,-3
21,4,212,15,19,-4
21,4,213,11,13,-2
21,4,214,10,18,-8
21,4,215,10,13,-3
21,4,216,1,7,-6
21,4,217,11,18,-7
21,4,218,13,28,-15
21,4,219,8,15,-7
21,4,220,9,16,-7
21,4,221,6,12,-6
21,4,222,9,18,-9
21,4,223,9,18,-9
21,4,224,11,29,-18
21,4,225,10,7,3
21,4,226,8,28,-20
21,4,227,8,23,-15
21,4,228,19,26,-7
21,4,229,6,21,-15
21,4,230,13,22,-9
21,4,231,4,19,-15
21,4,232,9,9,0
21,4,233,13,18,-5
21,4,234,8,14,-6
21,4,235,18,16,2
21,4,236,5,22,-17
21,4,237,12,17,-5
21,4,238,6,21,-15
21,4,239,9,24,-15
21,4,240,12,19,-7
21,4,241,18,26,-8
21,4,242,15,30,-15
21,4,243,9,18,-9
21,4,244,11,8,3
21,4,245,1,27,-26
21,4,246,8,7,1
21,4,247,15,20,-5
21,4,248,18,31,-13
21,4,249,13,19,-6
21,4,250,18,32,-14
21,4,251,14,16,-2
21,4,252,10,16,-6
21,4,253,9,17,-8
21,4,254,5,9,-4
21,4,255,5,11,-6
21,4,256,12,24,-12
21,4,257,5,15,-10
21,4,258,13,30,-17
21,4,259,11,22,-11
21,4,260,9,16,-7
21,4,261,6,11,-5
21,4,262,11,12,-1
21,4,263,11,16,-5
21,4,264,3,14,-11
21,4,265,9,16,-7
21,4,266,16,15,1
21,4,267,10,18,-8
21,4,268,13,18,-5
21,4,269,5,19,-14
21,4,270,18,21,-3
21,4,271,6,8,-2
21,4,272,13,17,-4
21,4,273,17,33,-16
21,4,274,11,16,-5
21,4,275,12,30,-18
21,4,276,6,9,-3
21,4,277,7,20,-13
21,4,278,10,13,-3
21,4,279,6,29,-23
21,4,280,17,17,0
21,4,281,10,21,-11
21,4,282,14,20,-6
21,4,283,7,13,-6
21,4,284,9,14,-5
21,4,285,13,17,-4
21,4,286,5,14,-9
21,4,287,8,31,-23
21,4,288,18,8,10
21,4,289,11,21,-10
21,4,290,5,11,-6
21,4,291,18,18,0
21,4,292,13,18,-5
21,4,293,10,19,-9
21,4,294,9,16,-7
21,4,295,11,17,-6
21,4,296,9,15,-6
21,4,297,11,22,-11
21,4,298,9,22,-13
21,4,299,7,20,-13
21,5,0,10,20,-10
21,5,1,11,20,-9
21,5,2,14,33,-19
21,5,3,10,31,-21
21,5,4,12,30,-18
21,5,5,17,19,-2
21,5,6,6,9,-3
21,5,7,9,7,2
21,5,8,7,12,-5
21,5,9,10,18,-8
21,5,10,11,20,-9
21,5,11,11,19,-8
21,5,12,14,29,-15
21,5,13,7,19,-12
21,5,14,1,13,-12
21,5,15,18,10,8
21,5,16,12,13,-1
21,5,17,5,10,-5
21,5,18,11,13,-2
21,5,19,9,20,-11
21,5,20,11,23,-12
21,5,21,5,10,-5
21,5,22,19,17,2
21,5,23,14,25,-11
21,5,24,6,35,-29
21,5,25,7,17,-10
21,5,26,10,23,-13
21,5,27,9,17,-8
21,5,28,7,21,-14
21,5,29,8,24,-16
21,5,30,6,12,-6
21,5,31,6,14,-8
21,5,32,18,21,-3
21,5,33,20,23,-3
21,5,34,10,29,-19
21,5,35,14,24,-10
21,5,36,20,17,3
21,5,37,20,28,-8
21,5,38,7,19,-12
21,5,39,13,10,3
21,5,40,4,16,-12
21,5,41,8,38,-30
21,5,42,7,19,-12
21,5,43,5,18,-13
21,5,44,5,21,-16
21,5,45,15,25,-10
21,5,46,5,13,-8
21,5,47,16,24,-8
21,5,48,3,21,-18
21,5,49,6,22,-16
21,5,50,3,20,-17
21,5,51,14,18,-4
21,5,52,10,14,-4
21,5,53,9,21,-12
21,5,54,3,21,-18
21,5,55,10,30,-20
21,5,56,24,28,-4
21,5,57,6,25,-19
21,5,58,19,26,-7
21,5,59,12,29,-17
21,5,60,9,20,-11
21,5,61,15,31,-16
21,5,62,17,13,4
21,5,63,5,12,-7
21,5,64,9,16,-7
21,5,65,11,21,-10
21,5,66,4,18,-14
21,5,67,2,10,-8
21,5,68,6,7,-1
21,5,69,8,24,-16
21,5,70,10,26,-16
21,5,71,16,26,-10
21,5,72,7,14,-7
21,5,73,13,26,-13
21,5,74,25,33,-8
21,5,75,8,15,-7
21,5,76,5,14,-9
21,5,77,10,18,-8
21,5,78,8,20,-12
21,5,79,11,24,-13
21,5,80,8,19,-11
21,5,81,17,15,2
21,5,82,12,31,-19
21,5,83,9,26,-17
21,5,84,8,16,-8
21,5,85,7,25,-18
21,5,86,9,26,-17
21,5,87,19,14,5
21,5,88,12,25,-13
21,5,89,9,23,-14
21,5,90,2,17,-15
21,5,91,14,15,-1
21,5,92,6,27,-21
21,5,93,8,16,-8
21,5,94,20,25,-5
21,5,95,16,34,-18
21,5,96,8,8,0
21,5,97,10,29,-19
21,5,98,7,16,-9
21,5,99,3,14,-11
21,5,100,20,24,-4
21,5,101,16,40,-24
21,5,102,15,14,1
21,5,103,6,29,-23
21,5,104,10,18,-8
21,5,105,3,12,-9
21,5,106,20,33,-13
21,5,107,6,17,-11
21,5,108,25,13,12
21,5,109,14,16,-2
21,5,110,6,29,-23
21,5,111,8,7,1
21,5,112,15,14,1
21,5,113,10,8,2
21,5,114,8,18,-10
21,5,115,8,11,-3
21,5,116,12,26,-14
21,5,117,5,16,-11
21,5,118,16,14,2
21,5,119,10,28,-18
21,5,120,10,14,-4
21,5,121,3,12,-9
21,5,122,5,9,-4
21,5,123,10,23,-13
21,5,124,15,27,-12
21,5,125,11,23,-12
21,5,126,2,11,-9
21,5,127,11,17,-6
21,5,128,5,21,-16
21,5,129,3,13,-10
21,5,130,3,16,-13
21,5,131,10,20,-10
21,5,132,2,11,-9
21,5,133,13,24,-11
21,5,134,7,21,-14
21,5,135,6,24,-18
21,5,136,11,26,-15
21,5,137,15,27,-12
21,5,138,8,12,-4
21,5,139,4,16,-12
21,5,140,19,29,-10
21,5,141,11,34,-23
21,5,142,12,21,-9
21,5,143,11,6,5
21,5,144,8,27,-19
21,5,145,19,29,-10
21,5,146,13,38,-25
21,5,147,6,26,-20
21,5,148,8,18,-10
21,5,149,8,25,-17
21,5,150,11,13,-2
21,5,151,5,4,1
21,5,152,19,27,-8
21,5,153,14,29,-15
21,5,154,12,19,-7
21,5,155,11,25,-14
21,5,156,5,17,-12
21,5,157,14,15,-1
21,5,158,8,11,-3
21,5,159,9,22,-13
21,5,160,12,18,-6
21,5,161,7,16,-9
21,5,162,1,33,-32
21,5,163,3,18,-15
21,5,164,8,46,-38
21,5,165,3,13,-10
21,5,166,13,15,-2
21,5,167,10,38,-28
21,5,168,3,19,-16
21,5,169,13,20,-7
21,5,170,12,20,-8
21,5,171,12,29,-17
21,5,172,5,11,-6
21,5,173,15,23,-8
21,5,174,7,13,-6
21,5,175,11,46,-35
21,5,176,11,14,-3
21,5,177,13,31,-18
21,5,178,16,20,-4
21,5,179,11,38,-27
21,5,180,15,29,-14
21,5,181,10,13,-3
21,5,182,9,20,-11
21,5,183,15,29,-14
21,5,184,10,26,-16
21,5,185,14,24,-10
21,5,186,13,16,-3
21,5,187,14,29,-15
21,5,188,15,25,-10
21,5,189,2,21,-19
21,5,190,11,17,-6
21,5,191,8,13,-5
21,5,192,16,9,7
21,5,193,5,27,-22
21,5,194,6,11,-5
21,5,195,9,25,-16
21,5,196,8,6,2
21,5,197,12,16,-4
21,5,198,5,19,-14
21,5,199,10,15,-5
21,5,200,15,38,-23
21,5,201,7,14,-7
21,5,202,4,16,-12
21,5,203,15,22,-7
21,5,204,8,30,-22
21,5,205,7,15,-8
21,5,206,8,11,-3
21,5,207,9,22,-13
21,5,208,5,16,-11
21,5,209,9,24,-15
21,5,210,19,12,7
21,5,211,13,23,-10
21,5,212,6,21,-15
21,5,213,8,45,-37
21,5,214,11,9,2
21,5,215,11,20,-9
21,5,216,10,22,-12
21,5,217,1,17,-16
21,5,218,10,8,2
21,5,219,11,31,-20
21,5,220,10,21,-11
21,5,221,16,14,2
21,5,222,16,40,-24
21,5,223,9,23,-14
21,5,224,5,11,-6
21,5,225,10,9,1
21,5,226,12,14,-2
21,5,227,8,26,-18
21,5,228,11,27,-16
21,5,229,6,24,-18
21,5,230,6,12,-6
21,5,231,0,12,-12
21,5,232,11,20,-9
21,5,233,8,41,-33
21,5,234,21,13,8
21,5,235,12,12,0
21,5,236,21,23,-2
21,5,237,11,18,-7
21,5,238,11,18,-7
21,5,239,9,30,-21
21,5,240,14,18,-4
21,5,241,4,12,-8
21,5,242,18,14,4
21,5,243,12,19,-7
21,5,244,8,23,-15
21,5,245,24,11,13
21,5,246,6,17,-11
21,5,247,14,22,-8
21,5,248,8,14,-6
21,5,249,13,14,-1
21,5,250,3,23,-20
21,5,251,6,13,-7
21,5,252,9,11,-2
21,5,253,17,40,-23
21,5,254,11,17,-6
21,5,255,20,20,0
21,5,256,10,19,-9
21,5,257,6,26,-20
21,5,258,11,24,-13
21,5,259,17,15,2
21,5,260,8,15,-7
21,5,261,11,20,-9
21,5,262,10,26,-16
21,5,263,12,22,-10
21,5,264,17,25,-8
21,5,265,10,30,-20
21,5,266,15,11,4
21,5,267,11,15,-4
21,5,268,11,25,-14
21,5,269,10,19,-9
21,5,270,9,20,-11
21,5,271,12,15,-3
21,5,272,9,14,-5
21,5,273,12,16,-4
21,5,274,10,21,-11
21,5,275,8,12,-4
21,5,276,19,22,-3
21,5,277,9,36,-27
21,5,278,6,20,-14
21,5,279,7,18,-11
21,5,280,9,17,-8
21,5,281,6,22,-16
21,5,282,12,32,-20
21,5,283,13,20,-7
21,5,284,8,25,-17
21,5,285,13,34,-21
21,5,286,5,12,-7
21,5,287,8,22,-14
21,5,288,15,27,-12
21,5,289,15,33,-18
21,5,290,3,6,-3
21,5,291,7,22,-15
21,5,292,14,17,-3
21,5,293,4,26,-22
21,5,294,7,17,-10
21,5,295,11,16,-5
21,5,296,13,15,-2
21,5,297,7,19,-12
21,5,298,10,18,-8
21,5,299,10,16,-6
21,6,0,14,29,-15
21,6,1,8,23,-15
21,6,2,5,11,-6
21,6,3,30,24,6
21,6,4,10,17,-7
21,6,5,12,34,-22
21,6,6,15,25,-10
21,6,7,9,25,-16
21,6,8,7,24,-17
21,6,9,12,21,-9
21,6,10,3,7,-4
21,6,11,8,20,-12
21,6,12,5,5,0
21,6,13,10,5,5
21,6,14,8,23,-15
21,6,15,14,16,-2
21,6,16,12,15,-3
21,6,17,16,23,-7
21,6,18,6,14,-8
21,6,19,16,12,4
21,6,20,12,36,-24
21,6,21,8,17,-9
21,6,22,20,23,-3
21,6,23,17,14,3
21,6,24,16,18,-2
21,6,25,9,19,-10
21,6,26,14,16,-2
21,6,27,12,22,-10
21,6,28,13,19,-6
21,6,29,12,21,-9
21,6,30,7,29,-22
21,6,31,8,21,-13
21,6,32,12,21,-9
21,6,33,8,12,-4
21,6,34,10,23,-13
21,6,35,8,26,-18
21,6,36,7,19,-12
21,6,37,13,27,-14
21,6,38,10,17,-7
21,6,39,14,28,-14
21,6,40,11,12,-1
21,6,41,3,32,-29
21,6,42,4,18,-14
21,6,43,14,26,-12
21,6,44,8,22,-14
21,6,45,9,10,-1
21,6,46,9,13,-4
21,6,47,8,11,-3
21,6,48,6,31,-25
21,6,49,17,9,8
21,6,50,6,23,-17
21,6,51,6,18,-12
21,6,52,6,31,-25
21,6,53,6,28,-22
21,6,54,9,5,4
21,6,55,3,13,-10
21,6,56,10,22,-12
21,6,57,12,9,3
21,6,58,2,23,-21
21,6,59,13,14,-1
21,6,60,16,17,-1
21,6,61,10,19,-9
21,6,62,11,15,-4
21,6,63,9,24,-15
21,6,64,29,25,4
21,6,65,12,21,-9
21,6,66,7,29,-22
21,6,67,6,9,-3
21,6,68,14,23,-9
21,6,69,17,12,5
21,6,70,11,18,-7
21,6,71,9,9,0
21,6,72,15,11,4
21,6,73,7,19,-12
21,6,74,13,19,-6
21,6,75,2,17,-15
21,6,76,23,20,3
21,6,77,14,19,-5
21,6,78,11,11,0
21,6,79,10,29,-19
21,6,80,13,18,-5
21,6,81,22,33,-11
21,6,82,9,22,-13
21,6,83,6,17,-11
21,6,84,12,27,-15
21,6,85,13,19,-6
21,6,86,7,13,-6
21,6,87,8,26,-18
21,6,88,3,12,-9
21,6,89,1,27,-26
21,6,90,31,19,12
21,6,91,13,18,-5
21,6,92,12,18,-6
21,6,93,8,29,-21
21,6,94,15,23,-8
21,6,95,26,31,-5
21,6,96,16,20,-4
21,6,97,4,15,-11
21,6,98,6,14,-8
21,6,99,21,19,2
21,6,100,14,25,-11
21,6,101,14,31,-17
21,6,102,17,36,-19
21,6,103,14,18,-4
21,6,104,14,29,-15
21,6,105,8,12,-4
21,6,106,17,13,4
21,6,107,8,7,1
21,6,108,11,22,-11
21,6,109,13,17,-4
21,6,110,7,31,-24
21,6,111,12,9,3
21,6,112,14,37,-23
21,6,113,6,18,-12
21,6,114,18,12,6
21,6,115,9,12,-3
21,6,116,15,34,-19
21,6,117,11,13,-2
21,6,118,9,21,-12
21,6,119,14,26,-12
21,6,120,12,21,-9
21,6,121,13,27,-14
21,6,122,8,20,-12
21,6,123,7,8,-1
21,6,124,19,21,-2
21,6,125,12,13,-1
21,6,126,9,11,-2
21,6,127,5,18,-13
21,6,128,9,16,-7
21,6,129,6,19,-13
21,6,130,8,26,-18
21,6,131,13,25,-12
21,6,132,11,9,2
21,6,133,12,7,5
21,6,134,18,19,-1
21,6,135,14,21,-7
21,6,136,14,12,2
21,6,137,13,23,-10
21,6,138,7,20,-13
21,6,139,14,8,6
21,6,140,15,27,-12
21,6,141,7,23,-16
21,6,142,10,24,-14
21,6,143,18,28,-10
21,6,144,6,26,-20
21,6,145,15,14,1
21,6,146,16,18,-2
21,6,147,7,12,-5
21,6,148,4,12,-8
21,6,149,19,39,-20
21,6,150,14,23,-9
21,6,151,12,23,-11
21,6,152,9,11,-2
21,6,153,17,30,-13
21,6,154,3,20,-17
21,6,155,13,15,-2
21,6,156,14,13,1
21,6,157,11,31,-20
21,6,158,10,18,-8
21,6,159,7,32,-25
21,6,160,15,28,-13
21,6,161,14,33,-19
21,6,162,13,18,-5
21,6,163,19,34,-15
21,6,164,14,9,5
21,6,165,19,20,-1
21,6,166,7,10,-3
21,6,167,14,15,-1
21,6,168,10,19,-9
21,6,169,15,26,-11
21,6,170,11,4,7
21,6,171,18,25,-7
21,6,172,15,35,-20
21,6,173,17,22,-5
21,6,174,10,22,-12
21,6,175,7,17,-10
21,6,176,7,22,-15
21,6,177,5,23,-18
21,6,178,10,37,-27
21,6,179,9,13,-4
21,6,180,10,18,-8
21,6,181,13,20,-7
21,6,182,13,13,0
21,6,183,4,18,-14
21,6,184,6,28,-22
21,6,185,12,18,-6
21,6,186,8,13,-5
21,6,187,13,14,-1
21,6,188,10,23,-13
21,6,189,22,14,8
21,6,190,10,16,-6
21,6,191,5,20,-15
21,6,192,8,8,0
21,6,193,11,12,-1
21,6,194,0,10,-10
21,6,195,8,19,-11
21,6,196,3,21,-18
21,6,197,21,35,-14
21,6,198,4,16,-12
21,6,199,13,28,-15
21,6,200,13,36,-23
21,6,201,14,20,-6
21,6,202,11,19,-8
21,6,203,11,18,-7
21,6,204,6,13,-7
21,6,205,10,16,-6
21,6,206,16,17,-1
21,6,207,18,22,-4
21,6,208,9,16,-7
21,6,209,4,12,-8
21,6,210,15,23,-8
21,6,211,16,21,-5
21,6,212,10,20,-10
21,6,213,16,21,-5
21,6,214,18,27,-9
21,6,215,6,25,-19
21,6,216,9,10,-1
21,6,217,19,18,1
21,6,218,5,10,-5
21,6,219,16,27,-11
21,6,220,8,7,1
21,6,221,15,27,-12
21,6,222,11,26,-15
21,6,223,13,19,-6
21,6,224,12,15,-3
21,6,225,18,25,-7
21,6,226,7,11,-4
21,6,227,9,24,-15
21,6,228,8,20,-12
21,6,229,3,25,-22
21,6,230,9,23,-14
21,6,231,5,18,-13
21,6,232,16,11,5
21,6,233,10,19,-9
21,6,234,15,31,-16
21,6,235,15,24,-9
21,6,236,11,30,-19
21,6,237,19,33,-14
21,6,238,10,27,-17
21,6,239,23,21,2
21,6,240,5,20,-15
21,6,241,8,22,-14
21,6,242,19,13,6
21,6,243,5,13,-8
21,6,244,13,22,-9
21,6,245,14,11,3
21,6,246,5,28,-23
21,6,247,6,16,-10
21,6,248,9,22,-13
21,6,249,15,32,-17
21,6,250,14,31,-17
21,6,251,15,30,-15
21,6,252,20,24,-4
21,6,253,11,38,-27
21,6,254,14,45,-31
21,6,255,14,16,-2
21,6,256,14,14,0
21,6,257,11,14,-3
21,6,258,11,14,-3
21,6,259,5,18,-13
21,6,260,15,11,4
21,6,261,13,11,2
21,6,262,10,9,1
21,6,263,12,18,-6
21,6,264,5,13,-8
21,6,265,20,25,-5
21,6,266,15,18,-3
21,6,267,5,18,-13
21,6,268,16,22,-6
21,6,269,11,9,2
21,6,270,10,19,-9
21,6,271,13,17,-4
21,6,272,11,36,-25
21,6,273,12,22,-10
21,6,274,12,15,-3
21,6,275,13,19,-6
21,6,276,18,18,0
21,6,277,17,23,-6
21,6,278,13,19,-6
21,6,279,12,20,-8
21,6,280,12,17,-5
21,6,281,21,13,8
21,6,282,19,19,0
21,6,283,6,15,-9
21,6,284,13,18,-5
21,6,285,13,15,-2
21,6,286,8,20,-12
21,6,287,12,17,-5
21,6,288,4,11,-7
21,6,289,5,23,-18
21,6,290,5,8,-3
21,6,291,6,27,-21
21,6,292,5,28,-23
21,6,293,18,31,-13
21,6,294,11,16,-5
21,6,295,8,20,-12
21,6,296,13,13,0
21,6,297,8,22,-14
21,6,298,6,11,-5
21,6,299,11,12,-1
21,7,0,13,20,-7
21,7,1,16,25,-9
21,7,2,9,15,-6
21,7,3,10,29,-19
21,7,4,17,29,-12
21,7,5,21,4,17
21,7,6,14,21,-7
21,7,7,14,30,-16
21,7,8,10,23,-13
21,7,9,11,26,-15
21,7,10,8,12,-4
21,7,11,13,26,-13
21,7,12,11,16,-5
21,7,13,13,19,-6
21,7,14,14,19,-5
21,7,15,16,22,-6
21,7,16,2,9,-7
21,7,17,18,22,-4
21,7,18,11,20,-9
21,7,19,15,16,-1
21,7,20,9,15,-6
21,7,21,11,9,2
21,7,22,10,14,-4
21,7,23,11,19,-8
21,7,24,22,27,-5
21,7,25,11,12,-1
21,7,26,17,26,-9
21,7,27,28,17,11
21,7,28,8,18,-10
21,7,29,1,21,-20
21,7,30,10,28,-18
21,7,31,19,15,4
21,7,32,18,20,-2
21,7,33,14,21,-7
21,7,34,12,18,-6
21,7,35,10,27,-17
21,7,36,11,14,-3
21,7,37,8,17,-9
21,7,38,18,32,-14
21,7,39,14,17,-3
21,7,40,7,25,-18
21,7,41,6,24,-18
21,7,42,16,37,-21
21,7,43,11,24,-13
21,7,44,12,19,-7
21,7,45,16,30,-14
21,7,46,12,22,-10
21,7,47,12,19,-7
21,7,48,10,26,-16
21,7,49,20,20,0
21,7,50,13,19,-6
21,7,51,15,25,-10
21,7,52,8,26,-18
21,7,53,6,13,-7
21,7,54,21,26,-5
21,7,55,10,17,-7
21,7,56,7,17,-10
21,7,57,13,25,-12
21,7,58,6,9,-3
21,7,59,16,11,5
21,7,60,11,19,-8
21,7,61,9,22,-13
21,7,62,9,24,-15
21,7,63,4,8,-4
21,7,64,7,19,-12
21,7,65,12,28,-16
21,7,66,16,15,1
21,7,67,8,23,-15
21,7,68,9,12,-3
21,7,69,11,16,-5
21,7,70,17,19,-2
21,7,71,7,19,-12
21,7,72,9,19,-10
21,7,73,23,29,-6
21,7,74,13,19,-6
21,7,75,13,27,-14
21,7,76,24,16,8
21,7,77,26,19,7
21,7,78,11,5,6
21,7,79,9,27,-18
21,7,80,13,15,-2
21,7,81,15,33,-18
21,7,82,15,25,-10
21,7,83,3,11,-8
21,7,84,8,19,-11
21,7,85,21,22,-1
21,7,86,8,33,-25
21,7,87,17,30,-13
21,7,88,11,8,3
21,7,89,18,36,-18
21,7,90,11,10,1
21,7,91,22,20,2
21,7,92,13,33,-20
21,7,93,9,21,-12
21,7,94,9,14,-5
21,7,95,11,20,-9
21,7,96,19,20,-1
21,7,97,13,13,0
21,7,98,12,10,2
21,7,99,14,18,-4
21,7,100,9,15,-6
21,7,101,22,26,-4
21,7,102,16,19,-3
21,7,103,16,18,-2
21,7,104,13,32,-19
21,7,105,18,27,-9
21,7,106,8,21,-13
21,7,107,18,24,-6
21,7,108,10,15,-5
21,7,109,5,27,-22
21,7,110,17,31,-14
21,7,111,12,26,-14
21,7,112,4,20,-16
21,7,113,15,12,3
21,7,114,4,15,-11
21,7,115,10,20,-10
21,7,116,14,28,-14
21,7,117,13,17,-4
21,7,118,9,17,-8
21,7,119,10,9,1
21,7,120,10,17,-7
21,7,121,20,32,-12
21,7,122,10,13,-3
21,7,123,6,15,-9
21,7,124,10,5,5
21,7,125,12,11,1
21,7,126,7,19,-12
21,7,127,15,16,-1
21,7,128,13,18,-5
21,7,129,20,26,-6
21,7,130,10,18,-8
21,7,131,13,32,-19
21,7,132,9,7,2
21,7,133,8,10,-2
21,7,134,18,27,-9
21,7,135,10,22,-12
21,7,136,21,29,-8
21,7,137,17,18,-1
21,7,138,5,18,-13
21,7,139,17,14,3
21,7,140,12,15,-3
21,7,141,16,38,-22
21,7,142,12,25,-13
21,7,143,17,28,-11
21,7,144,4,26,-22
21,7,145,11,27,-16
21,7,146,7,15,-8
21,7,147,7,9,-2
21,7,148,9,17,-8
21,7,149,9,27,-18
21,7,150,8,14,-6
21,7,151,8,26,-18
21,7,152,16,25,-9
21,7,153,16,11,5
21,7,154,19,24,-5
21,7,155,14,6,8
21,7,156,8,27,-19
21,7,157,9,10,-1
21,7,158,8,14,-6
21,7,159,15,25,-10
21,7,160,10,25,-15
21,7,161,14,30,-16
21,7,162,9,16,-7
21,7,163,7,22,-15
21,7,164,11,17,-6
21,7,165,18,21,-3
21,7,166,15,24,-9
21,7,167,13,23,-10
21,7,168,18,14,4
21,7,169,8,6,2
21,7,170,6,9,-3
21,7,171,9,15,-6
21,7,172,9,20,-11
21,7,173,20,22,-2
21,7,174,9,11,-2
21,7,175,9,17,-8
21,7,176,20,26,-6
21,7,177,7,21,-14
21,7,178,8,18,-10
21,7,179,17,27,-10
21,7,180,17,11,6
21,7,181,19,33,-14
21,7,182,17,34,-17
21,7,183,10,29,-19
21,7,184,9,35,-26
21,7,185,17,17,0
21,7,186,8,36,-28
21,7,187,5,21,-16
21,7,188,12,21,-9
21,7,189,11,18,-7
21,7,190,6,17,-11
21,7,191,10,29,-19
21,7,192,13,27,-14
21,7,193,8,12,-4
21,7,194,10,19,-9
21,7,195,17,26,-9
21,7,196,9,22,-13
21,7,197,11,14,-3
21,7,198,11,18,-7
21,7,199,14,17,-3
21,7,200,14,16,-2
21,7,201,6,27,-21
21,7,202,4,12,-8
21,7,203,4,11,-7
21,7,204,7,11,-4
21,7,205,10,14,-4
21,7,206,11,25,-14
21,7,207,13,21,-8
21,7,208,9,33,-24
21,7,209,13,21,-8
21,7,210,1,17,-16
21,7,211,5,15,-10
21,7,212,9,20,-11
21,7,213,14,17,-3
21,7,214,10,13,-3
21,7,215,8,21,-13
21,7,216,18,19,-1
21,7,217,14,20,-6
21,7,218,7,29,-22
21,7,219,21,22,-1
21,7,220,11,11,0
21,7,221,5,17,-12
21,7,222,6,15,-9
21,7,223,17,19,-2
21,7,224,16,31,-15
21,7,225,9,35,-26
21,7,226,14,21,-7
21,7,227,11,22,-11
21,7,228,10,17,-7
21,7,229,8,16,-8
21,7,230,11,14,-3
21,7,231,16,12,4
21,7,232,6,10,-4
21,7,233,10,13,-3
21,7,234,14,26,-12
21,7,235,16,17,-1
21,7,236,22,27,-5
21,7,237,15,31,-16
21,7,238,13,31,-18
21,7,239,9,25,-16
21,7,240,12,24,-12
21,7,241,14,9,5
21,7,242,6,13,-7
21,7,243,13,13,0
21,7,244,5,10,-5
21,7,245,21,20,1
21,7,246,17,7,10
21,7,247,9,17,-8
21,7,248,10,22,-12
21,7,249,10,16,-6
21,7,250,10,20,-10
21,7,251,11,16,-5
21,7,252,4,9,-5
21,7,253,6,17,-11
21,7,254,12,17,-5
21,7,255,19,31,-12
21,7,256,8,34,-26
21,7,257,8,22,-14
21,7,258,14,14,0
21,7,259,9,25,-16
21,7,260,11,29,-18
21,7,261,17,24,-7
21,7,262,9,21,-12
21,7,263,11,14,-3
21,7,264,10,23,-13
21,7,265,16,21,-5
21,7,266,8,20,-12
21,7,267,7,25,-18
21,7,268,12,29,-17
21,7,269,5,18,-13
21,7,270,11,29,-18
21,7,271,19,25,-6
21,7,272,14,27,-13
21,7,273,10,31,-21
21,7,274,10,17,-7
21,7,275,12,15,-3
21,7,276,14,22,-8
21,7,277,25,14,11
21,7,278,17,26,-9
21,7,279,16,28,-12
21,7,280,16,20,-4
21,7,281,2,16,-14
21,7,282,7,18,-11
21,7,283,3,13,-10
21,7,284,14,30,-16
21,7,285,5,14,-9
21,7,286,11,10,1
21,7,287,25,24,1
21,7,288,13,27,-14
21,7,289,16,26,-10
21,7,290,4,10,-6
21,7,291,17,32,-15
21,7,292,14,15,-1
21,7,293,6,4,2
21,7,294,11,18,-7
21,7,295,27,23,4
21,7,296,9,16,-7
21,7,297,2,19,-17
21,7,298,13,13,0
21,7,299,7,24,-17
21,8,0,6,6,0
21,8,1,9,26,-17
21,8,2,8,14,-6
21,8,3,20,27,-7
21,8,4,11,14,-3
21,8,5,7,19,-12
21,8,6,16,19,-3
21,8,7,10,23,-13
21,8,8,7,23,-16
21,8,9,15,20,-5
21,8,10,5,12,-7
21,8,11,9,22,-13
21,8,12,19,21,-2
21,8,13,8,29,-21
21,8,14,7,20,-13
21,8,15,18,17,1
21,8,16,22,22,0
21,8,17,26,19,7
21,8,18,6,18,-12
21,8,19,12,15,-3
21,8,20,9,2,7
21,8,21,11,23,-12
21,8,22,19,35,-16
21,8,23,11,26,-15
21,8,24,11,27,-16
21,8,25,12,20,-8
21,8,26,20,25,-5
21,8,27,6,10,-4
21,8,28,11,21,-10
21,8,29,13,20,-7
21,8,30,9,28,-19
21,8,31,11,19,-8
21,8,32,11,20,-9
21,8,33,14,16,-2
21,8,34,13,20,-7
21,8,35,7,27,-20
21,8,36,15,26,-11
21,8,37,14,19,-5
21,8,38,10,10,0
21,8,39,10,19,-9
21,8,40,14,10,4
21,8,41,7,15,-8
21,8,42,16,27,-11
21,8,43,23,21,2
21,8,44,10,13,-3
21,8,45,29,28,1
21,8,46,8,19,-11
21,8,47,15,20,-5
21,8,48,9,20,-11
21,8,49,16,18,-2
21,8,50,15,15,0
21,8,51,18,28,-10
21,8,52,13,14,-1
21,8,53,24,28,-4
21,8,54,13,21,-8
21,8,55,10,25,-15
21,8,56,14,32,-18
21,8,57,10,7,3
21,8,58,6,8,-2
21,8,59,19,21,-2
21,8,60,10,36,-26
21,8,61,15,40,-25
21,8,62,12,9,3
21,8,63,12,27,-15
21,8,64,10,15,-5
21,8,65,15,15,0
21,8,66,13,23,-10
21,8,67,18,14,4
21,8,68,13,13,0
21,8,69,6,23,-17
21,8,70,8,30,-22
21,8,71,19,19,0
21,8,72,13,18,-5
21,8,73,19,18,1
21,8,74,5,14,-9
21,8,75,4,16,-12
21,8,76,12,13,-1
21,8,77,14,7,7
21,8,78,10,15,-5
21,8,79,20,13,7
21,8,80,8,8,0
21,8,81,17,24,-7
21,8,82,13,25,-12
21,8,83,13,24,-11
21,8,84,4,23,-19
21,8,85,5,18,-13
21,8,86,14,14,0
21,8,87,7,35,-28
21,8,88,7,8,-1
21,8,89,3,31,-28
21,8,90,9,14,-5
21,8,91,15,19,-4
21,8,92,19,33,-14
21,8,93,13,20,-7
21,8,94,7,25,-18
21,8,95,6,9,-3
21,8,96,7,18,-11
21,8,97,4,3,1
21,8,98,13,13,0
21,8,99,9,27,-18
21,8,100,4,15,-11
21,8,101,6,14,-8
21,8,102,7,26,-19
21,8,103,15,23,-8
21,8,104,4,21,-17
21,8,105,9,20,-11
21,8,106,12,21,-9
21,8,107,15,18,-3
21,8,108,10,17,-7
21,8,109,13,21,-8
21,8,110,10,19,-9
21,8,111,11,10,1
21,8,112,25,18,7
21,8,113,21,14,7
21,8,114,9,15,-6
21,8,115,18,45,-27
21,8,116,17,27,-10
21,8,117,6,8,-2
21,8,118,12,26,-14
21,8,119,16,25,-9
21,8,120,10,21,-11
21,8,121,11,15,-4
21,8,122,13,13,0
21,8,123,5,7,-2
21,8,124,23,17,6
21,8,125,6,24,-18
21,8,126,6,22,-16
21,8,127,16,17,-1
21,8,128,6,18,-12
21,8,129,10,10,0
21,8,130,8,16,-8
21,8,131,13,26,-13
21,8,132,10,30,-20
21,8,133,4,11,-7
21,8,134,10,12,-2
21,8,135,18,20,-2
21,8,136,14,19,-5
21,8,137,5,7,-2
21,8,138,5,18,-13
21,8,139,10,28,-18
21,8,140,17,28,-11
21,8,141,14,25,-11
21,8,142,8,29,-21
21,8,143,29,23,6
21,8,144,15,11,4
21,8,145,5,25,-20
21,8,146,10,20,-10
21,8,147,19,20,-1
21,8,148,12,25,-13
21,8,149,10,23,-13
21,8,150,16,32,-16
21,8,151,17,23,-6
21,8,152,8,25,-17
21,8,153,10,26,-16
21,8,154,15,11,4
21,8,155,10,25,-15
21,8,156,20,20,0
21,8,157,3,17,-14
21,8,158,31,23,8
21,8,159,9,15,-6
21,8,160,11,15,-4
21,8,161,9,24,-15
21,8,162,14,24,-10
21,8,163,13,23,-10
21,8,164,15,21,-6
21,8,165,24,29,-5
21,8,166,18,13,5
21,8,167,14,13,1
21,8,168,13,29,-16
21,8,169,13,14,-1
21,8,170,21,29,-8
21,8,171,24,28,-4
21,8,172,12,25,-13
21,8,173,4,25,-21
21,8,174,5,22,-17
21,8,175,18,19,-1
21,8,176,9,24,-15
21,8,177,8,18,-10
21,8,178,18,34,-16
21,8,179,10,23,-13
21,8,180,14,27,-13
21,8,181,12,17,-5
21,8,182,12,32,-20
21,8,183,3,17,-14
21,8,184,11,19,-8
21,8,185,16,23,-7
21,8,186,8,30,-22
21,8,187,9,15,-6
21,8,188,8,25,-17
21,8,189,9,14,-5
21,8,190,11,12,-1
21,8,191,11,21,-10
21,8,192,8,7,1
21,8,193,11,18,-7
21,8,194,12,13,-1
21,8,195,19,34,-15
21,8,196,19,25,-6
21,8,197,12,20,-8
21,8,198,8,16,-8
21,8,199,17,24,-7
21,8,200,15,38,-23
21,8,201,13,27,-14
21,8,202,9,20,-11
21,8,203,8,23,-15
21,8,204,19,30,-11
21,8,205,20,31,-11
21,8,206,14,26,-12
21,8,207,6,35,-29
21,8,208,13,18,-5
21,8,209,7,13,-6
21,8,210,11,4,7
21,8,211,8,11,-3
21,8,212,11,21,-10
21,8,213,12,18,-6
21,8,214,2,5,-3
21,8,215,20,16,4
21,8,216,9,9,0
21,8,217,5,24,-19
21,8,218,11,20,-9
21,8,219,11,19,-8
21,8,220,6,28,-22
21,8,221,13,23,-10
21,8,222,13,11,2
21,8,223,7,3,4
21,8,224,12,21,-9
21,8,225,15,15,0
21,8,226,6,15,-9
21,8,227,8,9,-1
21,8,228,12,24,-12
21,8,229,6,12,-6
21,8,230,9,13,-4
21,8,231,13,25,-12
21,8,232,10,20,-10
21,8,233,5,31,-26
21,8,234,11,16,-5
21,8,235,19,19,0
21,8,236,13,11,2
21,8,237,8,18,-10
21,8,238,16,15,1
21,8,239,12,9,3
21,8,240,5,22,-17
21,8,241,14,23,-9
21,8,242,17,22,-5
21,8,243,14,10,4
21,8,244,13,21,-8
21,8,245,11,5,6
21,8,246,11,13,-2
21,8,247,13,24,-11
21,8,248,7,16,-9
21,8,249,23,35,-12
21,8,250,14,22,-8
21,8,251,16,12,4
21,8,252,17,27,-10
21,8,253,16,22,-6
21,8,254,7,36,-29
21,8,255,4,18,-14
21,8,256,4,11,-7
21,8,257,18,29,-11
21,8,258,7,17,-10
21,8,259,29,16,13
21,8,260,8,6,2
21,8,261,24,19,5
21,8,262,7,45,-38
21,8,263,17,22,-5
21,8,264,6,18,-12
21,8,265,10,22,-12
21,8,266,6,12,-6
21,8,267,14,22,-8
21,8,268,10,23,-13
21,8,269,14,21,-7
21,8,270,14,15,-1
21,8,271,17,15,2
21,8,272,7,14,-7
21,8,273,7,16,-9
21,8,274,10,23,-13
21,8,275,16,12,4
21,8,276,6,18,-12
21,8,277,4,16,-12
21,8,278,20,18,2
21,8,279,11,8,3
21,8,280,22,30,-8
21,8,281,8,21,-13
21,8,282,12,8,4
21,8,283,13,20,-7
21,8,284,13,33,-20
21,8,285,20,21,-1
21,8,286,21,23,-2
21,8,287,10,10,0
21,8,288,11,37,-26
21,8,289,17,25,-8
21,8,290,6,14,-8
21,8,291,13,15,-2
21,8,292,15,17,-2
21,8,293,7,16,-9
21,8,294,8,11,-3
21,8,295,6,17,-11
21,8,296,6,21,-15
21,8,297,15,26,-11
21,8,298,10,26,-16
21,8,299,5,10,-5
21,9,0,13,27,-14
21,9,1,6,14,-8
21,9,2,10,14,-4
21,9,3,18,9,9
21,9,4,13,32,-19
21,9,5,8,33,-25
21,9,6,7,16,-9
21,9,7,12,18,-6
21,9,8,10,15,-5
21,9,9,0,12,-12
21,9,10,8,27,-19
21,9,11,18,13,5
21,9,12,16,28,-12
21,9,13,3,13,-10
21,9,14,20,23,-3
21,9,15,3,11,-8
21,9,16,10,13,-3
21,9,17,9,25,-16
21,9,18,19,16,3
21,9,19,19,24,-5
21,9,20,8,11,-3
21,9,21,20,21,-1
21,9,22,16,17,-1
21,9,23,9,26,-17
21,9,24,23,23,0
21,9,25,13,26,-13
21,9,26,23,16,7
21,9,27,21,26,-5
21,9,28,6,25,-19
21,9,29,5,18,-13
21,9,30,13,20,-7
21,9,31,11,9,2
21,9,32,8,22,-14
21,9,33,18,28,-10
21,9,34,20,17,3
21,9,35,15,28,-13
21,9,36,4,13,-9
21,9,37,14,29,-15
21,9,38,13,25,-12
21,9,39,4,20,-16
21,9,40,9,11,-2
21,9,41,15,18,-3
21,9,42,9,24,-15
21,9,43,7,9,-2
21,9,44,14,12,2
21,9,45,14,27,-13
21,9,46,15,14,1
21,9,47,16,32,-16
21,9,48,6,15,-9
21,9,49,12,28,-16
21,9,50,8,11,-3
21,9,51,9,14,-5
21,9,52,17,19,-2
21,9,53,16,22,-6
21,9,54,9,12,-3
21,9,55,23,29,-6
21,9,56,6,14,-8
21,9,57,10,27,-17
21,9,58,13,23,-10
21,9,59,20,14,6
21,9,60,7,16,-9
21,9,61,14,21,-7
21,9,62,10,21,-11
21,9,63,18,27,-9
21,9,64,19,19,0
21,9,65,17,21,-4
21,9,66,18,23,-5
21,9,67,5,14,-9
21,9,68,11,13,-2
21,9,69,20,25,-5
21,9,70,6,15,-9
21,9,71,9,32,-23
21,9,72,14,20,-6
21,9,73,8,15,-7
21,9,74,7,11,-4
21,9,75,8,20,-12
21,9,76,6,20,-14
21,9,77,12,16,-4
21,9,78,21,18,3
21,9,79,8,14,-6
21,9,80,11,24,-13
21,9,81,12,20,-8
21,9,82,9,16,-7
21,9,83,5,9,-4
21,9,84,20,13,7
21,9,85,18,24,-6
21,9,86,5,17,-12
21,9,87,7,21,-14
21,9,88,13,11,2
21,9,89,10,28,-18
21,9,90,21,19,2
21,9,91,19,18,1
21,9,92,10,18,-8
21,9,93,13,21,-8
21,9,94,8,23,-15
21,9,95,14,20,-6
21,9,96,7,10,-3
21,9,97,11,17,-6
21,9,98,8,10,-2
21,9,99,15,18,-3
21,9,100,7,14,-7
21,9,101,8,13,-5
21,9,102,13,9,4
21,9,103,18,26,-8
21,9,104,16,26,-10
21,9,105,12,41,-29
21,9,106,17,19,-2
21,9,107,13,14,-1
21,9,108,5,7,-2
21,9,109,11,21,-10
21,9,110,16,14,2
21,9,111,11,12,-1
21,9,112,11,27,-16
21,9,113,14,16,-2
21,9,114,18,23,-5
21,9,115,13,11,2
21,9,116,9,15,-6
21,9,117,9,19,-10
21,9,118,11,12,-1
21,9,119,13,33,-20
21,9,120,11,15,-4
21,9,121,14,25,-11
21,9,122,15,17,-2
21,9,123,13,24,-11
21,9,124,15,25,-10
21,9,125,15,18,-3
21,9,126,11,15,-4
21,9,127,10,24,-14
21,9,128,22,17,5
21,9,129,16,16,0
21,9,130,10,20,-10
21,9,131,11,10,1
21,9,132,3,16,-13
21,9,133,14,6,8
21,9,134,11,27,-16
21,9,135,7,15,-8
21,9,136,7,11,-4
21,9,137,14,17,-3
21,9,138,21,20,1
21,9,139,10,14,-4
21,9,140,1,17,-16
21,9,141,11,19,-8
21,9,142,16,29,-13
21,9,143,7,16,-9
21,9,144,6,21,-15
21,9,145,5,8,-3
21,9,146,3,19,-16
21,9,147,3,9,-6
21,9,148,17,17,0
21,9,149,8,25,-17
21,9,150,13,28,-15
21,9,151,7,22,-15
21,9,152,13,25,-12
21,9,153,14,32,-18
21,9,154,10,24,-14
21,9,155,16,17,-1
21,9,156,8,13,-5
21,9,157,6,15,-9
21,9,158,20,35,-15
21,9,159,7,14,-7
21,9,160,12,11,1
21,9,161,16,23,-7
21,9,162,13,11,2
21,9,163,4,11,-7
21,9,164,9,24,-15
21,9,165,13,31,-18
21,9,166,8,16,-8
21,9,167,12,20,-8
21,9,168,12,13,-1
21,9,169,19,25,-6
21,9,170,15,17,-2
21,9,171,9,26,-17
21,9,172,13,23,-10
21,9,173,19,25,-6
21,9,174,14,34,-20
21,9,175,11,13,-2
21,9,176,10,19,-9
21,9,177,7,18,-11
21,9,178,14,34,-20
21,9,179,21,27,-6
21,9,180,11,22,-11
21,9,181,6,26,-20
21,9,182,11,22,-11
21,9,183,10,19,-9
21,9,184,11,20,-9
21,9,185,14,27,-13
21,9,186,11,24,-13
21,9,187,10,23,-13
21,9,188,13,19,-6
21,9,189,14,34,-20
21,9,190,3,13,-10
21,9,191,9,25,-16
21,9,192,12,27,-15
21,9,193,4,11,-7
21,9,194,11,9,2
21,9,195,12,9,3
21,9,196,22,29,-7
21,9,197,16,21,-5
21,9,198,21,19,2
21,9,199,12,36,-24
21,9,200,10,16,-6
21,9,201,6,15,-9
21,9,202,16,24,-8
21,9,203,16,36,-20
21,9,204,12,20,-8
21,9,205,2,16,-14
21,9,206,6,21,-15
21,9,207,10,20,-10
21,9,208,11,10,1
21,9,209,9,6,3
21,9,210,18,15,3
21,9,211,18,28,-10
21,9,212,5,18,-13
21,9,213,20,18,2
21,9,214,20,25,-5
21,9,215,13,21,-8
21,9,216,9,15,-6
21,9,217,9,12,-3
21,9,218,15,26,-11
21,9,219,29,32,-3
21,9,220,11,21,-10
21,9,221,15,21,-6
21,9,222,11,23,-12
21,9,223,7,19,-12
21,9,224,13,9,4
21,9,225,11,31,-20
21,9,226,14,15,-1
21,9,227,9,22,-13
21,9,228,9,16,-7
21,9,229,17,25,-8
21,9,230,16,24,-8
21,9,231,12,24,-12
21,9,232,5,11,-6
21,9,233,8,19,-11
21,9,234,11,29,-18
21,9,235,9,16,-7
21,9,236,16,13,3
21,9,237,20,29,-9
21,9,238,13,15,-2
21,9,239,11,21,-10
21,9,240,16,30,-14
21,9,241,8,25,-17
21,9,242,4,5,-1
21,9,243,9,8,1
21,9,244,14,32,-18
21,9,245,15,17,-2
21,9,246,7,10,-3
21,9,247,6,15,-9
21,9,248,11,21,-10
21,9,249,7,19,-12
21,9,250,4,29,-25
21,9,251,15,19,-4
21,9,252,16,13,3
21,9,253,13,13,0
21,9,254,14,21,-7
21,9,255,19,21,-2
21,9,256,20,33,-13
21,9,257,14,26,-12
21,9,258,8,16,-8
21,9,259,13,22,-9
21,9,260,20,28,-8
21,9,261,17,34,-17
21,9,262,2,13,-11
21,9,263,7,33,-26
21,9,264,8,13,-5
21,9,265,13,14,-1
21,9,266,6,12,-6
21,9,267,11,17,-6
21,9,268,12,14,-2
21,9,269,8,17,-9
21,9,270,17,19,-2
21,9,271,5,16,-11
21,9,272,7,8,-1
21,9,273,9,9,0
21,9,274,9,21,-12
21,9,275,24,19,5
21,9,276,22,20,2
21,9,277,11,21,-10
21,9,278,3,15,-12
21,9,279,13,15,-2
21,9,280,9,19,-10
21,9,281,0,17,-17
21,9,282,9,30,-21
21,9,283,9,14,-5
21,9,284,14,12,2
21,9,285,12,21,-9
21,9,286,22,37,-15
21,9,287,7,11,-4
21,9,288,4,23,-19
21,9,289,13,21,-8
21,9,290,17,22,-5
21,9,291,8,20,-12
21,9,292,21,21,0
21,9,293,8,10,-2
21,9,294,10,43,-33
21,9,295,17,25,-8
21,9,296,22,35,-13
21,9,297,21,18,3
21,9,298,17,22,-5
21,9,299,16,22,-6
21,10,0,17,29,-12
21,10,1,7,18,-11
21,10,2,16,5,11
21,10,3,2,19,-17
21,10,4,12,17,-5
21,10,5,12,30,-18
21,10,6,13,13,0
21,10,7,9,15,-6
21,10,8,9,19,-10
21,10,9,15,27,-12
21,10,10,12,10,2
21,10,11,9,16,-7
21,10,12,8,27,-19
21,10,13,7,18,-11
21,10,14,16,21,-5
21,10,15,11,12,-1
21,10,16,8,24,-16
21,10,17,2,16,-14
21,10,18,7,16,-9
21,10,19,20,22,-2
21,10,20,14,12,2
21,10,21,10,27,-17
21,10,22,18,25,-7
21,10,23,11,16,-5
21,10,24,12,17,-5
21,10,25,12,20,-8
21,10,26,5,17,-12
21,10,27,19,11,8
21,10,28,12,18,-6
21,10,29,20,17,3
21,10,30,10,16,-6
21,10,31,5,17,-12
21,10,32,15,23,-8
21,10,33,10,10,0
21,10,34,16,4,12
21,10,35,20,23,-3
21,10,36,13,13,0
21,10,37,6,19,-13
21,10,38,9,14,-5
21,10,39,6,21,-15
21,10,40,19,12,7
21,10,41,17,17,0
21,10,42,17,12,5
21,10,43,10,27,-17
21,10,44,23,11,12
21,10,45,14,24,-10
21,10,46,32,13,19
21,10,47,15,33,-18
21,10,48,6,15,-9
21,10,49,24,29,-5
21,10,50,24,33,-9
21,10,51,6,7,-1
21,10,52,13,24,-11
21,10,53,17,12,5
21,10,54,16,24,-8
21,10,55,10,19,-9
21,10,56,12,16,-4
21,10,57,7,24,-17
21,10,58,4,23,-19
21,10,59,9,17,-8
21,10,60,19,31,-12
21,10,61,6,27,-21
21,10,62,17,12,5
21,10,63,9,22,-13
21,10,64,11,13,-2
21,10,65,18,26,-8
21,10,66,12,10,2
21,10,67,13,18,-5
21,10,68,8,20,-12
21,10,69,12,13,-1
21,10,70,11,18,-7
21,10,71,25,26,-1
21,10,72,4,20,-16
21,10,73,11,13,-2
21,10,74,12,17,-5
21,10,75,18,17,1
21,10,76,12,25,-13
21,10,77,12,17,-5
21,10,78,14,8,6
21,10,79,4,8,-4
21,10,80,17,16,1
21,10,81,8,11,-3
21,10,82,10,8,2
21,10,83,13,22,-9
21,10,84,15,25,-10
21,10,85,11,22,-11
21,10,86,10,19,-9
21,10,87,14,12,2
21,10,88,12,26,-14
21,10,89,13,12,1
21,10,90,9,16,-7
21,10,91,15,20,-5
21,10,92,19,33,-14
21,10,93,9,21,-12
21,10,94,13,13,0
21,10,95,22,15,7
21,10,96,7,33,-26
21,10,97,15,15,0
21,10,98,5,17,-12
21,10,99,9,12,-3
21,10,100,14,40,-26
21,10,101,12,18,-6
21,10,102,18,34,-16
21,10,103,11,20,-9
21,10,104,16,20,-4
21,10,105,9,33,-24
21,10,106,15,22,-7
21,10,107,7,17,-10
21,10,108,15,24,-9
21,10,109,11,12,-1
21,10,110,6,25,-19
21,10,111,20,27,-7
21,10,112,22,18,4
21,10,113,19,19,0
21,10,114,8,18,-10
21,10,115,9,19,-10
21,10,116,15,25,-10
21,10,117,7,7,0
21,10,118,2,7,-5
21,10,119,14,24,-10
21,10,120,15,30,-15
21,10,121,4,14,-10
21,10,122,16,14,2
21,10,123,15,26,-11
21,10,124,18,21,-3
21,10,125,8,11,-3
21,10,126,13,31,-18
21,10,127,19,22,-3
21,10,128,24,19,5
21,10,129,20,14,6
21,10,130,21,23,-2
21,10,131,18,27,-9
21,10,132,15,28,-13
21,10,133,26,33,-7
21,10,134,8,22,-14
21,10,135,25,15,10
21,10,136,13,20,-7
21,10,137,15,23,-8
21,10,138,7,16,-9
21,10,139,4,7,-3
21,10,140,5,22,-17
21,10,141,17,22,-5
21,10,142,10,19,-9
21,10,143,5,11,-6
21,10,144,18,22,-4
21,10,145,10,24,-14
21,10,146,11,11,0
21,10,147,14,30,-16
21,10,148,11,21,-10
21,10,149,3,19,-16
21,10,150,15,17,-2
21,10,151,16,15,1
21,10,152,20,15,5
21,10,153,8,25,-17
21,10,154,14,34,-20
21,10,155,8,22,-14
21,10,156,16,14,2
21,10,157,9,18,-9
21,10,158,15,28,-13
21,10,159,19,22,-3
21,10,160,9,26,-17
21,10,161,6,6,0
21,10,162,10,25,-15
21,10,163,12,21,-9
21,10,164,9,24,-15
21,10,165,13,21,-8
21,10,166,6,10,-4
21,10,167,14,32,-18
21,10,168,8,8,0
21,10,169,16,18,-2
21,10,170,12,9,3
21,10,171,4,11,-7
21,10,172,11,15,-4
21,10,173,14,23,-9
21,10,174,14,12,2
21,10,175,8,13,-5
21,10,176,23,21,2
21,10,177,6,15,-9
21,10,178,11,4,7
21,10,179,17,39,-22
21,10,180,8,19,-11
21,10,181,14,18,-4
21,10,182,5,18,-13
21,10,183,12,20,-8
21,10,184,7,26,-19
21,10,185,12,22,-10
21,10,186,7,9,-2
21,10,187,18,14,4
21,10,188,6,15,-9
21,10,189,5,5,0
21,10,190,16,17,-1
21,10,191,14,21,-7
21,10,192,10,22,-12
21,10,193,15,20,-5
21,10,194,10,16,-6
21,10,195,12,18,-6
21,10,196,6,13,-7
21,10,197,5,16,-11
21,10,198,18,13,5
21,10,199,10,17,-7
21,10,200,8,15,-7
21,10,201,13,22,-9
21,10,202,16,32,-16
21,10,203,8,17,-9
21,10,204,8,7,1
21,10,205,11,25,-14
21,10,206,8,19,-11
21,10,207,12,12,0
21,10,208,5,9,-4
21,10,209,10,18,-8
21,10,210,15,11,4
21,10,211,11,20,-9
21,10,212,12,17,-5
21,10,213,11,15,-4
21,10,214,23,20,3
21,10,215,9,17,-8
21,10,216,16,23,-7
21,10,217,15,18,-3
21,10,218,8,15,-7
21,10,219,7,20,-13
21,10,220,6,10,-4
21,10,221,12,36,-24
21,10,222,13,9,4
21,10,223,17,19,-2
21,10,224,6,15,-9
21,10,225,17,28,-11
21,10,226,19,16,3
21,10,227,15,20,-5
21,10,228,9,11,-2
21,10,229,14,23,-9
21,10,230,12,17,-5
21,10,231,4,9,-5
21,10,232,5,14,-9
21,10,233,5,12,-7
21,10,234,10,14,-4
21,10,235,7,22,-15
21,10,236,14,22,-8
21,10,237,2,8,-6
21,10,238,17,19,-2
21,10,239,18,23,-5
21,10,240,14,25,-11
21,10,241,6,13,-7
21,10,242,16,28,-12
21,10,243,16,17,-1
21,10,244,12,10,2
21,10,245,12,15,-3
21,10,246,16,15,1
21,10,247,10,15,-5
21,10,248,9,20,-11
21,10,249,21,33,-12
21,10,250,13,14,-1
21,10,251,15,22,-7
21,10,252,10,19,-9
21,10,253,19,13,6
21,10,254,18,19,-1
21,10,255,10,10,0
21,10,256,16,24,-8
21,10,257,18,17,1
21,10,258,16,27,-11
21,10,259,17,22,-5
21,10,260,16,19,-3
21,10,261,14,22,-8
21,10,262,8,17,-9
21,10,263,10,21,-11
21,10,264,15,17,-2
21,10,265,12,19,-7
21,10,266,23,23,0
21,10,267,12,20,-8
21,10,268,16,23,-7
21,10,269,7,13,-6
21,10,270,11,27,-16
21,10,271,7,14,-7
21,10,272,7,33,-26
21,10,273,21,36,-15
21,10,274,13,23,-10
21,10,275,17,24,-7
21,10,276,12,12,0
21,10,277,12,29,-17
21,10,278,19,14,5
21,10,279,20,23,-3
21,10,280,16,33,-17
21,10,281,12,15,-3
21,10,282,10,20,-10
21,10,283,20,25,-5
21,10,284,18,13,5
21,10,285,5,15,-10
21,10,286,20,17,3
21,10,287,13,20,-7
21,10,288,11,20,-9
21,10,289,20,20,0
21,10,290,10,9,1
21,10,291,10,19,-9
21,10,292,20,18,2
21,10,293,25,23,2
21,10,294,16,15,1
21,10,295,10,11,-1
21,10,296,8,11,-3
21,10,297,10,29,-19
21,10,298,11,20,-9
21,10,299,8,25,-17
21,11,0,6,10,-4
21,11,1,20,29,-9
21,11,2,15,34,-19
21,11,3,8,19,-11
21,11,4,10,24,-14
21,11,5,3,7,-4
21,11,6,11,12,-1
21,11,7,15,27,-12
21,11,8,7,3,4
21,11,9,16,7,9
21,11,10,13,26,-13
21,11,11,11,14,-3
21,11,12,22,31,-9
21,11,13,17,26,-9
21,11,14,13,17,-4
21,11,15,12,14,-2
21,11,16,28,15,13
21,11,17,22,23,-1
21,11,18,7,19,-12
21,11,19,13,25,-12
21,11,20,13,23,-10
21,11,21,10,15,-5
21,11,22,11,19,-8
21,11,23,19,21,-2
21,11,24,8,27,-19
21,11,25,13,11,2
21,11,26,10,26,-16
21,11,27,8,12,-4
21,11,28,8,13,-5
21,11,29,13,9,4
21,11,30,19,34,-15
21,11,31,4,22,-18
21,11,32,8,20,-12
21,11,33,4,16,-12
21,11,34,18,25,-7
21,11,35,12,12,0
21,11,36,11,9,2
21,11,37,16,8,8
21,11,38,21,36,-15
21,11,39,7,16,-9
21,11,40,20,20,0
21,11,41,10,11,-1
21,11,42,15,25,-10
21,11,43,24,26,-2
21,11,44,12,24,-12
21,11,45,11,14,-3
21,11,46,10,14,-4
21,11,47,9,18,-9
21,11,48,4,20,-16
21,11,49,14,21,-7
21,11,50,7,8,-1
21,11,51,17,17,0
21,11,52,12,7,5
21,11,53,11,21,-10
21,11,54,8,19,-11
21,11,55,14,17,-3
21,11,56,14,20,-6
21,11,57,13,5,8
21,11,58,9,9,0
21,11,59,14,9,5
21,11,60,15,18,-3
21,11,61,12,7,5
21,11,62,11,14,-3
21,11,63,9,12,-3
21,11,64,6,20,-14
21,11,65,17,16,1
21,11,66,13,26,-13
21,11,67,15,19,-4
21,11,68,10,18,-8
21,11,69,13,19,-6
21,11,70,8,7,1
21,11,71,12,13,-1
21,11,72,12,12,0
21,11,73,6,10,-4
21,11,74,10,15,-5
21,11,75,10,26,-16
21,11,76,13,17,-4
21,11,77,29,22,7
21,11,78,18,12,6
21,11,79,20,14,6
21,11,80,9,15,-6
21,11,81,10,30,-20
21,11,82,21,28,-7
21,11,83,22,29,-7
21,11,84,17,25,-8
21,11,85,18,23,-5
21,11,86,12,22,-10
21,11,87,8,15,-7
21,11,88,17,15,2
21,11,89,10,22,-12
21,11,90,19,21,-2
21,11,91,18,20,-2
21,11,92,15,12,3
21,11,93,10,16,-6
21,11,94,10,14,-4
21,11,95,2,17,-15
21,11,96,14,15,-1
21,11,97,11,25,-14
21,11,98,9,5,4
21,11,99,22,21,1
21,11,100,10,26,-16
21,11,101,14,18,-4
21,11,102,18,19,-1
21,11,103,9,30,-21
21,11,104,17,21,-4
21,11,105,16,31,-15
21,11,106,20,18,2
21,11,107,12,9,3
21,11,108,7,18,-11
21,11,109,15,10,5
21,11,110,9,8,1
21,11,111,8,14,-6
21,11,112,21,33,-12
21,11,113,26,26,0
21,11,114,9,13,-4
21,11,115,8,9,-1
21,11,116,7,3,4
21,11,117,11,29,-18
21,11,118,13,21,-8
21,11,119,4,14,-10
21,11,120,17,21,-4
21,11,121,10,10,0
21,11,122,17,15,2
21,11,123,13,11,2
21,11,124,26,32,-6
21,11,125,3,27,-24
21,11,126,17,10,7
21,11,127,19,29,-10
21,11,128,15,21,-6
21,11,129,11,17,-6
21,11,130,16,25,-9
21,11,131,6,13,-7
21,11,132,4,6,-2
21,11,133,18,33,-15
21,11,134,21,16,5
21,11,135,8,17,-9
21,11,136,11,17,-6
21,11,137,11,17,-6
21,11,138,12,17,-5
21,11,139,17,17,0
21,11,140,10,7,3
21,11,141,15,33,-18
21,11,142,1,10,-9
21,11,143,9,17,-8
21,11,144,12,22,-10
21,11,145,11,13,-2
21,11,146,17,16,1
21,11,147,20,15,5
21,11,148,14,15,-1
21,11,149,12,17,-5
21,11,150,8,17,-9
21,11,151,7,34,-27
21,11,152,6,32,-26
21,11,153,8,16,-8
21,11,154,13,25,-12
21,11,155,22,14,8
21,11,156,10,18,-8
21,11,157,21,29,-8
21,11,158,6,11,-5
21,11,159,7,27,-20
21,11,160,16,28,-12
21,11,161,20,19,1
21,11,162,11,16,-5
21,11,163,7,7,0
21,11,164,7,11,-4
21,11,165,9,21,-12
21,11,166,18,24,-6
21,11,167,10,16,-6
21,11,168,9,9,0
21,11,169,17,24,-7
21,11,170,11,18,-7
21,11,171,6,11,-5
21,11,172,11,26,-15
21,11,173,11,7,4
21,11,174,21,39,-18
21,11,175,12,10,2
21,11,176,16,16,0
21,11,177,7,26,-19
21,11,178,14,13,1
21,11,179,17,14,3
21,11,180,3,12,-9
21,11,181,17,21,-4
21,11,182,15,11,4
21,11,183,10,21,-11
21,11,184,12,23,-11
21,11,185,10,11,-1
21,11,186,17,15,2
21,11,187,11,15,-4
21,11,188,13,22,-9
21,11,189,10,29,-19
21,11,190,12,26,-14
21,11,191,17,21,-4
21,11,192,5,21,-16
21,11,193,13,16,-3
21,11,194,14,18,-4
21,11,195,11,16,-5
21,11,196,17,16,1
21,11,197,12,19,-7
21,11,198,13,20,-7
21,11,199,19,19,0
21,11,200,7,11,-4
21,11,201,13,31,-18
21,11,202,12,14,-2
21,11,203,9,12,-3
21,11,204,10,11,-1
21,11,205,15,16,-1
21,11,206,13,18,-5
21,11,207,9,26,-17
21,11,208,17,30,-13
21,11,209,25,20,5
21,11,210,11,18,-7
21,11,211,14,16,-2
21,11,212,21,25,-4
21,11,213,4,22,-18
21,11,214,25,27,-2
21,11,215,10,24,-14
21,11,216,26,25,1
21,11,217,23,20,3
21,11,218,13,17,-4
21,11,219,24,19,5
21,11,220,22,18,4
21,11,221,8,12,-4
21,11,222,19,5,14
21,11,223,30,22,8
21,11,224,5,14,-9
21,11,225,13,19,-6
21,11,226,19,23,-4
21,11,227,8,20,-12
21,11,228,10,9,1
21,11,229,6,18,-12
21,11,230,19,28,-9
21,11,231,11,13,-2
21,11,232,5,11,-6
21,11,233,11,16,-5
21,11,234,16,19,-3
21,11,235,17,20,-3
21,11,236,14,34,-20
21,11,237,10,18,-8
21,11,238,24,19,5
21,11,239,11,16,-5
21,11,240,19,20,-1
21,11,241,10,11,-1
21,11,242,15,19,-4
21,11,243,13,16,-3
21,11,244,11,18,-7
21,11,245,9,35,-26
21,11,246,10,17,-7
21,11,247,7,17,-10
21,11,248,10,20,-10
21,11,249,8,17,-9
21,11,250,11,16,-5
21,11,251,16,18,-2
21,11,252,13,13,0
21,11,253,15,20,-5
21,11,254,21,17,4
21,11,255,12,17,-5
21,11,256,15,29,-14
21,11,257,11,22,-11
21,11,258,13,16,-3
21,11,259,9,22,-13
21,11,260,18,5,13
21,11,261,13,21,-8
21,11,262,5,12,-7
21,11,263,12,14,-2
21,11,264,11,10,1
21,11,265,14,15,-1
21,11,266,14,4,10
21,11,267,10,20,-10
21,11,268,15,22,-7
21,11,269,5,13,-8
21,11,270,7,10,-3
21,11,271,21,21,0
21,11,272,9,23,-14
21,11,273,10,17,-7
21,11,274,13,13,0
21,11,275,16,25,-9
21,11,276,7,16,-9
21,11,277,10,26,-16
21,11,278,12,20,-8
21,11,279,8,8,0
21,11,280,12,16,-4
21,11,281,9,17,-8
21,11,282,10,18,-8
21,11,283,20,18,2
21,11,284,14,12,2
21,11,285,14,35,-21
21,11,286,11,15,-4
21,11,287,10,20,-10
21,11,288,19,23,-4
21,11,289,8,3,5
21,11,290,18,26,-8
21,11,291,19,15,4
21,11,292,14,16,-2
21,11,293,6,17,-11
21,11,294,7,12,-5
21,11,295,15,23,-8
21,11,296,13,23,-10
21,11,297,10,31,-21
21,11,298,19,19,0
21,11,299,17,23,-6
21,12,0,17,12,5
21,12,1,20,20,0
21,12,2,18,15,3
21,12,3,21,25,-4
21,12,4,9,5,4
21,12,5,9,17,-8
21,12,6,4,9,-5
21,12,7,19,20,-1
21,12,8,6,22,-16
21,12,9,12,12,0
21,12,10,7,20,-13
21,12,11,9,22,-13
21,12,12,17,30,-13
21,12,13,18,13,5
21,12,14,8,13,-5
21,12,15,8,19,-11
21,12,16,24,18,6
21,12,17,10,14,-4
21,12,18,11,17,-6
21,12,19,23,18,5
21,12,20,7,16,-9
21,12,21,5,10,-5
21,12,22,23,28,-5
21,12,23,7,19,-12
21,12,24,3,22,-19
21,12,25,14,15,-1
21,12,26,13,13,0
21,12,27,12,5,7
21,12,28,9,9,0
21,12,29,7,18,-11
21,12,30,17,15,2
21,12,31,16,26,-10
21,12,32,14,21,-7
21,12,33,13,20,-7
21,12,34,7,36,-29
21,12,35,21,31,-10
21,12,36,17,20,-3
21,12,37,13,17,-4
21,12,38,21,11,10
21,12,39,13,14,-1
21,12,40,1,15,-14
21,12,41,16,22,-6
21,12,42,19,23,-4
21,12,43,20,14,6
21,12,44,13,15,-2
21,12,45,8,24,-16
21,12,46,9,13,-4
21,12,47,9,14,-5
21,12,48,11,12,-1
21,12,49,13,17,-4
21,12,50,6,22,-16
21,12,51,6,24,-18
21,12,52,4,11,-7
21,12,53,8,11,-3
21,12,54,13,23,-10
21,12,55,6,15,-9
21,12,56,14,15,-1
21,12,57,21,27,-6
21,12,58,8,14,-6
21,12,59,12,7,5
21,12,60,18,25,-7
21,12,61,15,7,8
21,12,62,9,23,-14
21,12,63,7,15,-8
21,12,64,11,7,4
21,12,65,6,8,-2
21,12,66,18,33,-15
21,12,67,13,8,5
21,12,68,22,15,7
21,12,69,13,14,-1
21,12,70,3,8,-5
21,12,71,20,15,5
21,12,72,20,15,5
21,12,73,12,12,0
21,12,74,12,28,-16
21,12,75,16,27,-11
21,12,76,19,21,-2
21,12,77,14,15,-1
21,12,78,15,21,-6
21,12,79,14,8,6
21,12,80,12,11,1
21,12,81,10,12,-2
21,12,82,19,22,-3
21,12,83,14,14,0
21,12,84,10,15,-5
21,12,85,17,15,2
21,12,86,21,15,6
21,12,87,15,23,-8
21,12,88,6,9,-3
21,12,89,12,13,-1
21,12,90,15,8,7
21,12,91,9,14,-5
21,12,92,6,18,-12
21,12,93,9,9,0
21,12,94,15,14,1
21,12,95,11,28,-17
21,12,96,12,15,-3
21,12,97,13,8,5
21,12,98,8,14,-6
21,12,99,7,33,-26
21,12,100,20,18,2
21,12,101,17,27,-10
21,12,102,19,27,-8
21,12,103,14,19,-5
21,12,104,19,22,-3
21,12,105,12,22,-10
21,12,106,21,17,4
21,12,107,21,16,5
21,12,108,7,17,-10
21,12,109,14,24,-10
21,12,110,7,16,-9
21,12,111,11,17,-6
21,12,112,11,12,-1
21,12,113,16,18,-2
21,12,114,20,34,-14
21,12,115,8,19,-11
21,12,116,14,15,-1
21,12,117,9,15,-6
21,12,118,19,21,-2
21,12,119,19,32,-13
21,12,120,14,23,-9
21,12,121,21,17,4
21,12,122,15,18,-3
21,12,123,13,14,-1
21,12,124,21,20,1
21,12,125,7,19,-12
21,12,126,9,21,-12
21,12,127,17,13,4
21,12,128,6,8,-2
21,12,129,7,19,-12
21,12,130,7,19,-12
21,12,131,13,15,-2
21,12,132,12,9,3
21,12,133,13,24,-11
21,12,134,6,12,-6
21,12,135,15,20,-5
21,12,136,18,27,-9
21,12,137,8,21,-13
21,12,138,3,18,-15
21,12,139,13,19,-6
21,12,140,16,8,8
21,12,141,20,22,-2
21,12,142,9,20,-11
21,12,143,13,17,-4
21,12,144,5,10,-5
21,12,145,7,16,-9
21,12,146,9,15,-6
21,12,147,17,16,1
21,12,148,13,10,3
21,12,149,3,7,-4
21,12,150,17,19,-2
21,12,151,4,7,-3
21,12,152,18,19,-1
21,12,153,20,21,-1
21,12,154,4,16,-12
21,12,155,22,38,-16
21,12,156,8,25,-17
21,12,157,23,17,6
21,12,158,6,15,-9
21,12,159,20,34,-14
21,12,160,26,24,2
21,12,161,14,8,6
21,12,162,21,22,-1
21,12,163,17,23,-6
21,12,164,21,17,4
21,12,165,12,19,-7
21,12,166,12,26,-14
21,12,167,6,11,-5
21,12,168,11,24,-13
21,12,169,6,19,-13
21,12,170,10,31,-21
21,12,171,18,21,-3
21,12,172,12,29,-17
21,12,173,11,14,-3
21,12,174,21,23,-2
21,12,175,17,17,0
21,12,176,6,11,-5
21,12,177,15,14,1
21,12,178,19,12,7
21,12,179,19,24,-5
21,12,180,13,18,-5
21,12,181,14,19,-5
21,12,182,11,17,-6
21,12,183,7,26,-19
21,12,184,12,18,-6
21,12,185,12,23,-11
21,12,186,8,11,-3
21,12,187,16,41,-25
21,12,188,6,20,-14
21,12,189,11,29,-18
21,12,190,13,26,-13
21,12,191,24,32,-8
21,12,192,9,27,-18
21,12,193,8,8,0
21,12,194,9,14,-5
21,12,195,16,15,1
21,12,196,19,15,4
21,12,197,11,25,-14
21,12,198,13,10,3
21,12,199,8,6,2
21,12,200,15,17,-2
21,12,201,11,21,-10
21,12,202,16,13,3
21,12,203,28,16,12
21,12,204,4,15,-11
21,12,205,22,32,-10
21,12,206,22,22,0
21,12,207,14,26,-12
21,12,208,13,34,-21
21,12,209,3,12,-9
21,12,210,15,17,-2
21,12,211,8,20,-12
21,12,212,13,18,-5
21,12,213,6,5,1
21,12,214,26,17,9
21,12,215,10,29,-19
21,12,216,13,31,-18
21,12,217,24,18,6
21,12,218,29,38,-9
21,12,219,15,21,-6
21,12,220,10,17,-7
21,12,221,10,18,-8
21,12,222,3,20,-17
21,12,223,15,24,-9
21,12,224,10,3,7
21,12,225,23,22,1
21,12,226,10,10,0
21,12,227,15,17,-2
21,12,228,16,17,-1
21,12,229,7,17,-10
21,12,230,5,14,-9
21,12,231,7,21,-14
21,12,232,6,14,-8
21,12,233,7,16,-9
21,12,234,7,22,-15
21,12,235,9,11,-2
21,12,236,21,21,0
21,12,237,23,22,1
21,12,238,16,14,2
21,12,239,16,16,0
21,12,240,11,22,-11
21,12,241,18,26,-8
21,12,242,16,9,7
21,12,243,13,13,0
21,12,244,9,9,0
21,12,245,13,21,-8
21,12,246,12,23,-11
21,12,247,15,16,-1
21,12,248,10,12,-2
21,12,249,9,24,-15
21,12,250,12,21,-9
21,12,251,8,19,-11
21,12,252,6,10,-4
21,12,253,23,18,5
21,12,254,21,18,3
21,12,255,6,22,-16
21,12,256,13,19,-6
21,12,257,9,17,-8
21,12,258,6,9,-3
21,12,259,9,20,-11
21,12,260,13,25,-12
21,12,261,14,20,-6
21,12,262,20,21,-1
21,12,263,11,30,-19
21,12,264,7,15,-8
21,12,265,10,13,-3
21,12,266,5,24,-19
21,12,267,13,25,-12
21,12,268,20,34,-14
21,12,269,10,21,-11
21,12,270,5,10,-5
21,12,271,18,16,2
21,12,272,6,15,-9
21,12,273,11,20,-9
21,12,274,7,9,-2
21,12,275,4,10,-6
21,12,276,9,16,-7
21,12,277,13,14,-1
21,12,278,6,18,-12
21,12,279,7,10,-3
21,12,280,13,5,8
21,12,281,12,14,-2
21,12,282,12,1,11
21,12,283,13,20,-7
21,12,284,19,14,5
21,12,285,14,23,-9
21,12,286,9,18,-9
21,12,287,14,16,-2
21,12,288,19,26,-7
21,12,289,13,19,-6
21,12,290,20,15,5
21,12,291,7,16,-9
21,12,292,13,18,-5
21,12,293,16,30,-14
21,12,294,6,12,-6
21,12,295,19,9,10
21,12,296,26,29,-3
21,12,297,8,15,-7
21,12,298,13,13,0
21,12,299,19,16,3
21,13,0,13,21,-8
21,13,1,12,9,3
21,13,2,8,9,-1
21,13,3,14,18,-4
21,13,4,12,29,-17
21,13,5,8,22,-14
21,13,6,21,19,2
21,13,7,20,13,7
21,13,8,12,20,-8
21,13,9,12,18,-6
21,13,10,13,23,-10
21,13,11,9,30,-21
21,13,12,8,17,-9
21,13,13,9,16,-7
21,13,14,24,35,-11
21,13,15,23,27,-4
21,13,16,11,9,2
21,13,17,12,17,-5
21,13,18,5,16,-11
21,13,19,5,10,-5
21,13,20,14,33,-19
21,13,21,7,25,-18
21,13,22,29,13,16
21,13,23,15,13,2
21,13,24,15,17,-2
21,13,25,14,23,-9
21,13,26,8,21,-13
21,13,27,20,17,3
21,13,28,16,30,-14
21,13,29,12,5,7
21,13,30,15,14,1
21,13,31,5,11,-6
21,13,32,15,19,-4
21,13,33,10,19,-9
21,13,34,18,16,2
21,13,35,16,20,-4
21,13,36,9,25,-16
21,13,37,13,14,-1
21,13,38,17,31,-14
21,13,39,7,9,-2
21,13,40,14,13,1
21,13,41,19,24,-5
21,13,42,10,20,-10
21,13,43,12,16,-4
21,13,44,12,15,-3
21,13,45,18,30,-12
21,13,46,19,22,-3
21,13,47,13,29,-16
21,13,48,10,39,-29
21,13,49,4,10,-6
21,13,50,8,10,-2
21,13,51,20,23,-3
21,13,52,14,22,-8
21,13,53,15,31,-16
21,13,54,8,12,-4
21,13,55,9,14,-5
21,13,56,12,13,-1
21,13,57,7,18,-11
21,13,58,11,11,0
21,13,59,6,16,-10
21,13,60,16,13,3
21,13,61,15,16,-1
21,13,62,17,11,6
21,13,63,16,13,3
21,13,64,11,20,-9
21,13,65,18,18,0
21,13,66,18,18,0
21,13,67,5,17,-12
21,13,68,7,8,-1
21,13,69,11,14,-3
21,13,70,11,12,-1
21,13,71,13,13,0
21,13,72,12,14,-2
21,13,73,6,13,-7
21,13,74,14,15,-1
21,13,75,11,14,-3
21,13,76,11,14,-3
21,13,77,9,12,-3
21,13,78,6,19,-13
21,13,79,31,27,4
21,13,80,10,18,-8
21,13,81,11,31,-20
21,13,82,13,22,-9
21,13,83,9,14,-5
21,13,84,11,24,-13
21,13,85,17,17,0
21,13,86,12,19,-7
21,13,87,9,14,-5
21,13,88,16,13,3
21,13,89,23,28,-5
21,13,90,9,26,-17
21,13,91,18,28,-10
21,13,92,7,21,-14
21,13,93,12,24,-12
21,13,94,16,10,6
21,13,95,19,16,3
21,13,96,10,13,-3
21,13,97,16,28,-12
21,13,98,10,25,-15
21,13,99,13,15,-2
21,13,100,18,27,-9
21,13,101,9,14,-5
21,13,102,23,11,12
21,13,103,9,13,-4
21,13,104,10,9,1
21,13,105,22,27,-5
21,13,106,11,28,-17
21,13,107,13,14,-1
21,13,108,17,29,-12
21,13,109,16,20,-4
21,13,110,18,34,-16
21,13,111,17,9,8
21,13,112,10,21,-11
21,13,113,19,23,-4
21,13,114,10,13,-3
21,13,115,16,13,3
21,13,116,17,34,-17
21,13,117,21,27,-6
21,13,118,9,6,3
21,13,119,14,14,0
21,13,120,13,24,-11
21,13,121,13,15,-2
21,13,122,17,29,-12
21,13,123,16,24,-8
21,13,124,5,24,-19
21,13,125,19,15,4
21,13,126,11,11,0
21,13,127,16,14,2
21,13,128,10,14,-4
21,13,129,12,6,6
21,13,130,20,39,-19
21,13,131,11,14,-3
21,13,132,4,11,-7
21,13,133,5,13,-8
21,13,134,18,17,1
21,13,135,11,21,-10
21,13,136,5,14,-9
21,13,137,9,29,-20
21,13,138,14,11,3
21,13,139,11,15,-4
21,13,140,4,16,-12
21,13,141,12,10,2
21,13,142,10,19,-9
21,13,143,9,23,-14
21,13,144,30,22,8
21,13,145,11,15,-4
21,13,146,18,32,-14
21,13,147,10,13,-3
21,13,148,2,14,-12
21,13,149,17,30,-13
21,13,150,8,11,-3
21,13,151,16,14,2
21,13,152,11,13,-2
21,13,153,25,22,3
21,13,154,14,24,-10
21,13,155,14,18,-4
21,13,156,16,25,-9
21,13,157,8,9,-1
21,13,158,15,17,-2
21,13,159,6,10,-4
21,13,160,11,8,3
21,13,161,19,22,-3
21,13,162,17,20,-3
21,13,163,13,19,-6
21,13,164,13,17,-4
21,13,165,10,19,-9
21,13,166,10,22,-12
21,13,167,8,22,-14
21,13,168,11,11,0
21,13,169,6,13,-7
21,13,170,13,13,0
21,13,171,11,12,-1
21,13,172,18,29,-11
21,13,173,10,8,2
21,13,174,7,6,1
21,13,175,21,6,15
21,13,176,13,28,-15
21,13,177,13,10,3
21,13,178,23,29,-6
21,13,179,8,18,-10
21,13,180,5,13,-8
21,13,181,13,36,-23
21,13,182,3,20,-17
21,13,183,11,13,-2
21,13,184,6,18,-12
21,13,185,21,18,3
21,13,186,7,20,-13
21,13,187,7,25,-18
21,13,188,14,14,0
21,13,189,21,16,5
21,13,190,10,22,-12
21,13,191,7,16,-9
21,13,192,8,18,-10
21,13,193,10,11,-1
21,13,194,4,17,-13
21,13,195,6,16,-10
21,13,196,16,18,-2
21,13,197,19,31,-12
21,13,198,7,7,0
21,13,199,7,27,-20
21,13,200,9,10,-1
21,13,201,6,25,-19
21,13,202,24,26,-2
21,13,203,20,27,-7
21,13,204,20,17,3
21,13,205,8,17,-9
21,13,206,5,7,-2
21,13,207,8,14,-6
21,13,208,12,15,-3
21,13,209,13,33,-20
21,13,210,19,33,-14
21,13,211,12,16,-4
21,13,212,11,10,1
21,13,213,13,26,-13
21,13,214,7,9,-2
21,13,215,12,13,-1
21,13,216,9,26,-17
21,13,217,8,34,-26
21,13,218,24,20,4
21,13,219,17,20,-3
21,13,220,13,14,-1
21,13,221,9,18,-9
21,13,222,12,9,3
21,13,223,5,17,-12
21,13,224,8,21,-13
21,13,225,26,22,4
21,13,226,12,20,-8
21,13,227,6,16,-10
21,13,228,17,11,6
21,13,229,9,18,-9
21,13,230,8,26,-18
21,13,231,13,10,3
21,13,232,8,18,-10
21,13,233,7,13,-6
21,13,234,10,16,-6
21,13,235,19,19,0
21,13,236,8,11,-3
21,13,237,15,19,-4
21,13,238,8,15,-7
21,13,239,16,21,-5
21,13,240,15,24,-9
21,13,241,5,21,-16
21,13,242,14,20,-6
21,13,243,3,21,-18
21,13,244,6,19,-13
21,13,245,10,10,0
21,13,246,5,27,-22
21,13,247,12,17,-5
21,13,248,23,15,8
21,13,249,7,20,-13
21,13,250,11,25,-14
21,13,251,11,13,-2
21,13,252,21,19,2
21,13,253,25,21,4
21,13,254,11,18,-7
21,13,255,14,21,-7
21,13,256,30,31,-1
21,13,257,8,9,-1
21,13,258,14,24,-10
21,13,259,8,25,-17
21,13,260,11,15,-4
21,13,261,14,8,6
21,13,262,7,10,-3
21,13,263,11,13,-2
21,13,264,21,20,1
21,13,265,5,19,-14
21,13,266,9,13,-4
21,13,267,14,18,-4
21,13,268,9,17,-8
21,13,269,16,28,-12
21,13,270,16,19,-3
21,13,271,24,22,2
21,13,272,13,25,-12
21,13,273,6,12,-6
21,13,274,7,11,-4
21,13,275,16,17,-1
21,13,276,11,5,6
21,13,277,14,16,-2
21,13,278,12,20,-8
21,13,279,8,23,-15
21,13,280,14,18,-4
21,13,281,18,14,4
21,13,282,11,25,-14
21,13,283,9,22,-13
21,13,284,19,10,9
21,13,285,12,20,-8
21,13,286,17,12,5
21,13,287,13,12,1
21,13,288,15,28,-13
21,13,289,19,28,-9
21,13,290,6,13,-7
21,13,291,19,35,-16
21,13,292,13,25,-12
21,13,293,3,12,-9
21,13,294,5,14,-9
21,13,295,17,20,-3
21,13,296,17,16,1
21,13,297,9,31,-22
21,13,298,20,24,-4
21,13,299,8,7,1
21,14,0,8,24,-16
21,14,1,13,15,-2
21,14,2,13,9,4
21,14,3,8,17,-9
21,14,4,21,26,-5
21,14,5,15,10,5
21,14,6,14,18,-4
21,14,7,13,21,-8
21,14,8,9,16,-7
21,14,9,11,24,-13
21,14,10,17,25,-8
21,14,11,7,14,-7
21,14,12,11,13,-2
21,14,13,8,14,-6
21,14,14,11,13,-2
21,14,15,15,27,-12
21,14,16,8,22,-14
21,14,17,18,23,-5
21,14,18,11,23,-12
21,14,19,11,16,-5
21,14,20,15,21,-6
21,14,21,8,13,-5
21,14,22,17,36,-19
21,14,23,17,20,-3
21,14,24,13,19,-6
21,14,25,15,18,-3
21,14,26,16,13,3
21,14,27,5,17,-12
21,14,28,18,28,-10
21,14,29,10,21,-11
21,14,30,11,15,-4
21,14,31,17,14,3
21,14,32,7,24,-17
21,14,33,12,24,-12
21,14,34,9,15,-6
21,14,35,9,27,-18
21,14,36,20,16,4
21,14,37,4,10,-6
21,14,38,15,23,-8
21,14,39,11,10,1
21,14,40,27,25,2
21,14,41,12,15,-3
21,14,42,12,12,0
21,14,43,8,23,-15
21,14,44,9,14,-5
21,14,45,15,25,-10
21,14,46,24,14,10
21,14,47,25,11,14
21,14,48,16,22,-6
21,14,49,13,17,-4
21,14,50,15,16,-1
21,14,51,19,41,-22
21,14,52,11,8,3
21,14,53,12,12,0
21,14,54,11,12,-1
21,14,55,25,10,15
21,14,56,7,20,-13
21,14,57,8,18,-10
21,14,58,8,10,-2
21,14,59,14,27,-13
21,14,60,14,18,-4
21,14,61,23,34,-11
21,14,62,11,12,-1
21,14,63,16,22,-6
21,14,64,15,20,-5
21,14,65,14,19,-5
21,14,66,14,12,2
21,14,67,15,23,-8
21,14,68,21,19,2
21,14,69,7,17,-10
21,14,70,16,22,-6
21,14,71,8,14,-6
21,14,72,10,10,0
21,14,73,15,13,2
21,14,74,20,14,6
21,14,75,14,19,-5
21,14,76,13,26,-13
21,14,77,13,26,-13
21,14,78,12,17,-5
21,14,79,10,16,-6
21,14,80,9,18,-9
21,14,81,18,30,-12
21,14,82,7,13,-6
21,14,83,9,17,-8
21,14,84,10,17,-7
21,14,85,11,11,0
21,14,86,11,15,-4
21,14,87,11,19,-8
21,14,88,20,16,4
21,14,89,11,4,7
21,14,90,8,21,-13
21,14,91,14,17,-3
21,14,92,15,27,-12
21,14,93,16,17,-1
21,14,94,8,25,-17
21,14,95,11,14,-3
21,14,96,11,19,-8
21,14,97,5,21,-16
21,14,98,16,21,-5
21,14,99,12,16,-4
21,14,100,6,15,-9
21,14,101,12,16,-4
21,14,102,7,11,-4
21,14,103,17,19,-2
21,14,104,9,18,-9
21,14,105,8,31,-23
21,14,106,17,18,-1
21,14,107,13,13,0
21,14,108,22,24,-2
21,14,109,23,16,7
21,14,110,19,24,-5
21,14,111,14,21,-7
21,14,112,23,11,12
21,14,113,5,12,-7
21,14,114,4,15,-11
21,14,115,19,11,8
21,14,116,18,13,5
21,14,117,12,18,-6
21,14,118,18,40,-22
21,14,119,18,21,-3
21,14,120,8,11,-3
21,14,121,13,8,5
21,14,122,6,25,-19
21,14,123,14,17,-3
21,14,124,15,24,-9
21,14,125,8,17,-9
21,14,126,15,18,-3
21,14,127,25,13,12
21,14,128,11,12,-1
21,14,129,6,6,0
21,14,130,8,22,-14
21,14,131,21,27,-6
21,14,132,14,13,1
21,14,133,9,15,-6
21,14,134,8,15,-7
21,14,135,12,21,-9
21,14,136,16,16,0
21,14,137,20,12,8
21,14,138,13,14,-1
21,14,139,2,12,-10
21,14,140,14,18,-4
21,14,141,9,3,6
21,14,142,18,24,-6
21,14,143,24,9,15
21,14,144,22,29,-7
21,14,145,24,26,-2
21,14,146,17,16,1
21,14,147,22,21,1
21,14,148,14,17,-3
21,14,149,3,28,-25
21,14,150,15,20,-5
21,14,151,9,18,-9
21,14,152,9,17,-8
21,14,153,11,13,-2
21,14,154,18,12,6
21,14,155,14,23,-9
21,14,156,7,20,-13
21,14,157,7,14,-7
21,14,158,14,15,-1
21,14,159,8,12,-4
21,14,160,24,21,3
21,14,161,24,16,8
21,14,162,13,32,-19
21,14,163,8,12,-4
21,14,164,12,13,-1
21,14,165,16,15,1
21,14,166,8,4,4
21,14,167,9,13,-4
21,14,168,18,18,0
21,14,169,14,13,1
21,14,170,6,10,-4
21,14,171,10,10,0
21,14,172,8,25,-17
21,14,173,15,23,-8
21,14,174,15,7,8
21,14,175,12,10,2
21,14,176,10,18,-8
21,14,177,16,16,0
21,14,178,30,20,10
21,14,179,7,23,-16
21,14,180,9,20,-11
21,14,181,11,21,-10
21,14,182,21,23,-2
21,14,183,14,18,-4
21,14,184,12,7,5
21,14,185,15,11,4
21,14,186,11,6,5
21,14,187,14,40,-26
21,14,188,19,31,-12
21,14,189,5,20,-15
21,14,190,9,5,4
21,14,191,14,18,-4
21,14,192,5,4,1
21,14,193,14,17,-3
21,14,194,7,21,-14
21,14,195,24,13,11
21,14,196,12,14,-2
21,14,197,9,14,-5
21,14,198,13,30,-17
21,14,199,14,19,-5
21,14,200,12,17,-5
21,14,201,14,11,3
21,14,202,12,4,8
21,14,203,5,10,-5
21,14,204,9,10,-1
21,14,205,17,21,-4
21,14,206,15,24,-9
21,14,207,7,20,-13
21,14,208,20,19,1
21,14,209,15,12,3
21,14,210,12,13,-1
21,14,211,7,9,-2
21,14,212,16,17,-1
21,14,213,7,18,-11
21,14,214,12,23,-11
21,14,215,20,17,3
21,14,216,12,27,-15
21,14,217,14,24,-10
21,14,218,5,7,-2
21,14,219,6,16,-10
21,14,220,20,12,8
21,14,221,10,21,-11
21,14,222,11,22,-11
21,14,223,25,20,5
21,14,224,16,24,-8
21,14,225,8,11,-3
21,14,226,14,22,-8
21,14,227,15,19,-4
21,14,228,12,19,-7
21,14,229,17,12,5
21,14,230,20,18,2
21,14,231,20,24,-4
21,14,232,13,25,-12
21,14,233,9,11,-2
21,14,234,6,19,-13
21,14,235,9,10,-1
21,14,236,11,18,-7
21,14,237,16,24,-8
21,14,238,11,25,-14
21,14,239,8,17,-9
21,14,240,17,20,-3
21,14,241,18,16,2
21,14,242,10,15,-5
21,14,243,9,29,-20
21,14,244,14,14,0
21,14,245,6,18,-12
21,14,246,17,13,4
21,14,247,10,15,-5
21,14,248,8,20,-12
21,14,249,1,6,-5
21,14,250,13,26,-13
21,14,251,13,19,-6
21,14,252,16,24,-8
21,14,253,19,22,-3
21,14,254,19,9,10
21,14,255,15,9,6
21,14,256,11,14,-3
21,14,257,8,12,-4
21,14,258,10,31,-21
21,14,259,16,25,-9
21,14,260,21,31,-10
21,14,261,17,30,-13
21,14,262,17,17,0
21,14,263,9,21,-12
21,14,264,2,13,-11
21,14,265,15,16,-1
21,14,266,9,29,-20
21,14,267,15,22,-7
21,14,268,19,28,-9
21,14,269,10,22,-12
21,14,270,8,20,-12
21,14,271,9,12,-3
21,14,272,17,27,-10
21,14,273,9,7,2
21,14,274,4,10,-6
21,14,275,18,29,-11
21,14,276,14,22,-8
21,14,277,16,45,-29
21,14,278,18,21,-3
21,14,279,11,15,-4
21,14,280,13,40,-27
21,14,281,11,15,-4
21,14,282,7,14,-7
21,14,283,16,20,-4
21,14,284,11,11,0
21,14,285,14,16,-2
21,14,286,17,12,5
21,14,287,22,14,8
21,14,288,11,19,-8
21,14,289,15,20,-5
21,14,290,18,28,-10
21,14,291,13,16,-3
21,14,292,13,19,-6
21,14,293,10,23,-13
21,14,294,15,14,1
21,14,295,4,12,-8
21,14,296,17,15,2
21,14,297,13,11,2
21,14,298,18,22,-4
21,14,299,12,14,-2
21,15,0,19,6,13
21,15,1,13,19,-6
21,15,2,15,21,-6
21,15,3,9,15,-6
21,15,4,18,19,-1
21,15,5,17,20,-3
21,15,6,8,20,-12
21,15,7,5,18,-13
21,15,8,31,12,19
21,15,9,13,24,-11
21,15,10,10,8,2
21,15,11,11,10,1
21,15,12,19,23,-4
21,15,13,11,26,-15
21,15,14,16,26,-10
21,15,15,15,21,-6
21,15,16,22,16,6
21,15,17,6,8,-2
21,15,18,21,12,9
21,15,19,15,24,-9
21,15,20,19,30,-11
21,15,21,9,5,4
21,15,22,17,16,1
21,15,23,20,20,0
21,15,24,14,22,-8
21,15,25,10,17,-7
21,15,26,15,17,-2
21,15,27,13,16,-3
21,15,28,8,27,-19
21,15,29,7,26,-19
21,15,30,6,18,-12
21,15,31,10,20,-10
21,15,32,9,15,-6
21,15,33,12,23,-11
21,15,34,26,30,-4
21,15,35,9,19,-10
21,15,36,17,16,1
21,15,37,9,17,-8
21,15,38,11,16,-5
21,15,39,23,27,-4
21,15,40,15,23,-8
21,15,41,5,23,-18
21,15,42,18,9,9
21,15,43,16,11,5
21,15,44,12,20,-8
21,15,45,12,11,1
21,15,46,8,20,-12
21,15,47,11,29,-18
21,15,48,12,19,-7
21,15,49,10,18,-8
21,15,50,6,24,-18
21,15,51,16,26,-10
21,15,52,6,16,-10
21,15,53,14,22,-8
21,15,54,21,24,-3
21,15,55,17,18,-1
21,15,56,16,16,0
21,15,57,20,21,-1
21,15,58,19,15,4
21,15,59,23,22,1
21,15,60,19,25,-6
21,15,61,20,11,9
21,15,62,12,16,-4
21,15,63,14,15,-1
21,15,64,26,26,0
21,15,65,14,14,0
21,15,66,11,25,-14
21,15,67,12,20,-8
21,15,68,6,21,-15
21,15,69,8,9,-1
21,15,70,9,8,1
21,15,71,8,8,0
21,15,72,19,15,4
21,15,73,28,26,2
21,15,74,13,12,1
21,15,75,17,17,0
21,15,76,13,15,-2
21,15,77,19,25,-6
21,15,78,10,14,-4
21,15,79,9,16,-7
21,15,80,13,32,-19
21,15,81,12,19,-7
21,15,82,12,22,-10
21,15,83,10,18,-8
21,15,84,22,16,6
21,15,85,15,19,-4
21,15,86,25,36,-11
21,15,87,10,10,0
21,15,88,17,15,2
21,15,89,3,11,-8
21,15,90,7,13,-6
21,15,91,24,14,10
21,15,92,23,19,4
21,15,93,4,15,-11
21,15,94,7,13,-6
21,15,95,13,16,-3
21,15,96,9,14,-5
21,15,97,4,20,-16
21,15,98,6,21,-15
21,15,99,17,18,-1
21,15,100,15,16,-1
21,15,101,9,31,-22
21,15,102,19,24,-5
21,15,103,11,19,-8
21,15,104,12,14,-2
21,15,105,11,24,-13
21,15,106,20,36,-16
21,15,107,9,10,-1
21,15,108,17,32,-15
21,15,109,9,24,-15
21,15,110,10,17,-7
21,15,111,11,15,-4
21,15,112,21,11,10
21,15,113,21,22,-1
21,15,114,18,18,0
21,15,115,19,14,5
21,15,116,12,12,0
21,15,117,16,8,8
21,15,118,26,17,9
21,15,119,5,22,-17
21,15,120,17,7,10
21,15,121,11,11,0
21,15,122,21,24,-3
21,15,123,18,13,5
21,15,124,14,20,-6
21,15,125,19,16,3
21,15,126,22,24,-2
21,15,127,22,30,-8
21,15,128,25,22,3
21,15,129,14,11,3
21,15,130,16,21,-5
21,15,131,9,14,-5
21,15,132,10,29,-19
21,15,133,6,17,-11
21,15,134,15,16,-1
21,15,135,12,2,10
21,15,136,8,16,-8
21,15,137,6,16,-10
21,15,138,14,9,5
21,15,139,15,5,10
21,15,140,20,28,-8
21,15,141,13,10,3
21,15,142,10,10,0
21,15,143,15,16,-1
21,15,144,13,15,-2
21,15,145,14,8,6
21,15,146,12,15,-3
21,15,147,19,26,-7
21,15,148,19,21,-2
21,15,149,14,25,-11
21,15,150,8,12,-4
21,15,151,12,9,3
21,15,152,9,10,-1
21,15,153,10,11,-1
21,15,154,22,30,-8
21,15,155,17,10,7
21,15,156,16,22,-6
21,15,157,20,13,7
21,15,158,12,14,-2
21,15,159,19,12,7
21,15,160,18,11,7
21,15,161,11,17,-6
21,15,162,15,18,-3
21,15,163,6,18,-12
21,15,164,8,15,-7
21,15,165,11,17,-6
21,15,166,13,10,3
21,15,167,10,29,-19
21,15,168,9,9,0
21,15,169,7,14,-7
21,15,170,11,14,-3
21,15,171,15,10,5
21,15,172,15,23,-8
21,15,173,23,22,1
21,15,174,10,9,1
21,15,175,13,19,-6
21,15,176,13,8,5
21,15,177,11,13,-2
21,15,178,13,20,-7
21,15,179,15,21,-6
21,15,180,16,16,0
21,15,181,16,14,2
21,15,182,13,27,-14
21,15,183,16,25,-9
21,15,184,15,20,-5
21,15,185,12,15,-3
21,15,186,5,19,-14
21,15,187,17,24,-7
21,15,188,11,16,-5
21,15,189,17,17,0
21,15,190,19,16,3
21,15,191,13,19,-6
21,15,192,18,18,0
21,15,193,8,20,-12
21,15,194,18,16,2
21,15,195,17,15,2
21,15,196,21,13,8
21,15,197,10,6,4
21,15,198,27,20,7
21,15,199,14,31,-17
21,15,200,18,18,0
21,15,201,15,20,-5
21,15,202,16,25,-9
21,15,203,13,12,1
21,15,204,20,24,-4
21,15,205,14,18,-4
21,15,206,15,21,-6
21,15,207,8,8,0
21,15,208,10,19,-9
21,15,209,12,14,-2
21,15,210,28,29,-1
21,15,211,15,20,-5
21,15,212,17,24,-7
21,15,213,21,16,5
21,15,214,17,15,2
21,15,215,13,14,-1
21,15,216,14,6,8
21,15,217,18,12,6
21,15,218,5,13,-8
21,15,219,20,17,3
21,15,220,18,30,-12
21,15,221,7,16,-9
21,15,222,10,10,0
21,15,223,24,34,-10
21,15,224,9,14,-5
21,15,225,9,31,-22
21,15,226,14,20,-6
21,15,227,11,15,-4
21,15,228,8,33,-25
21,15,229,14,8,6
21,15,230,12,9,3
21,15,231,9,14,-5
21,15,232,5,15,-10
21,15,233,10,10,0
21,15,234,8,17,-9
21,15,235,9,16,-7
21,15,236,16,16,0
21,15,237,5,10,-5
21,15,238,19,27,-8
21,15,239,13,8,5
21,15,240,16,31,-15
21,15,241,12,15,-3
21,15,242,14,13,1
21,15,243,10,33,-23
21,15,244,17,11,6
21,15,245,13,13,0
21,15,246,12,9,3
21,15,247,17,16,1
21,15,248,10,22,-12
21,15,249,8,12,-4
21,15,250,12,23,-11
21,15,251,11,15,-4
21,15,252,12,14,-2
21,15,253,9,15,-6
21,15,254,9,22,-13
21,15,255,24,19,5
21,15,256,11,10,1
21,15,257,9,12,-3
21,15,258,16,31,-15
21,15,259,13,13,0
21,15,260,15,25,-10
21,15,261,6,22,-16
21,15,262,12,9,3
21,15,263,6,19,-13
21,15,264,9,14,-5
21,15,265,8,9,-1
21,15,266,13,19,-6
21,15,267,13,14,-1
21,15,268,9,14,-5
21,15,269,16,9,7
21,15,270,10,20,-10
21,15,271,16,22,-6
21,15,272,17,12,5
21,15,273,12,22,-10
21,15,274,12,19,-7
21,15,275,11,16,-5
21,15,276,5,6,-1
21,15,277,4,17,-13
21,15,278,14,21,-7
21,15,279,8,17,-9
21,15,280,5,19,-14
21,15,281,19,20,-1
21,15,282,8,19,-11
21,15,283,16,16,0
21,15,284,14,22,-8
21,15,285,11,11,0
21,15,286,6,8,-2
21,15,287,14,19,-5
21,15,288,11,16,-5
21,15,289,12,13,-1
21,15,290,7,25,-18
21,15,291,16,24,-8
21,15,292,9,13,-4
21,15,293,9,32,-23
21,15,294,13,17,-4
21,15,295,18,18,0
21,15,296,9,19,-10
21,15,297,17,18,-1
21,15,298,12,15,-3
21,15,299,13,29,-16
21,16,0,5,8,-3
21,16,1,9,12,-3
21,16,2,17,25,-8
21,16,3,7,5,2
21,16,4,8,14,-6
21,16,5,3,11,-8
21,16,6,10,13,-3
21,16,7,20,23,-3
21,16,8,4,18,-14
21,16,9,15,16,-1
21,16,10,9,15,-6
21,16,11,9,19,-10
21,16,12,14,8,6
21,16,13,13,3,10
21,16,14,11,14,-3
21,16,15,5,29,-24
21,16,16,14,14,0
21,16,17,12,18,-6
21,16,18,7,13,-6
21,16,19,13,21,-8
21,16,20,12,21,-9
21,16,21,10,20,-10
21,16,22,27,23,4
21,16,23,17,28,-11
21,16,24,10,17,-7
21,16,25,13,13,0
21,16,26,36,21,15
21,16,27,17,16,1
21,16,28,23,23,0
21,16,29,6,14,-8
21,16,30,4,6,-2
21,16,31,16,9,7
21,16,32,23,14,9
21,16,33,22,20,2
21,16,34,11,18,-7
21,16,35,15,26,-11
21,16,36,16,16,0
21,16,37,7,18,-11
21,16,38,17,14,3
21,16,39,14,19,-5
21,16,40,15,19,-4
21,16,41,9,23,-14
21,16,42,6,10,-4
21,16,43,14,16,-2
21,16,44,8,17,-9
21,16,45,24,27,-3
21,16,46,15,11,4
21,16,47,18,25,-7
21,16,48,9,13,-4
21,16,49,15,13,2
21,16,50,11,8,3
21,16,51,17,11,6
21,16,52,16,19,-3
21,16,53,10,7,3
21,16,54,16,15,1
21,16,55,17,12,5
21,16,56,5,13,-8
21,16,57,16,30,-14
21,16,58,14,17,-3
21,16,59,19,17,2
21,16,60,22,22,0
21,16,61,12,7,5
21,16,62,14,10,4
21,16,63,8,14,-6
21,16,64,4,34,-30
21,16,65,8,21,-13
21,16,66,8,11,-3
21,16,67,6,24,-18
21,16,68,14,25,-11
21,16,69,11,19,-8
21,16,70,10,20,-10
21,16,71,9,23,-14
21,16,72,21,11,10
21,16,73,18,9,9
21,16,74,8,14,-6
21,16,75,8,23,-15
21,16,76,17,30,-13
21,16,77,3,4,-1
21,16,78,11,18,-7
21,16,79,9,18,-9
21,16,80,17,15,2
21,16,81,8,13,-5
21,16,82,13,13,0
21,16,83,20,9,11
21,16,84,12,23,-11
21,16,85,10,11,-1
21,16,86,15,13,2
21,16,87,8,17,-9
21,16,88,10,16,-6
21,16,89,10,15,-5
21,16,90,28,18,10
21,16,91,17,18,-1
21,16,92,16,37,-21
21,16,93,20,20,0
21,16,94,15,14,1
21,16,95,17,12,5
21,16,96,13,14,-1
21,16,97,10,27,-17
21,16,98,20,30,-10
21,16,99,12,17,-5
21,16,100,10,20,-10
21,16,101,8,15,-7
21,16,102,13,14,-1
21,16,103,21,16,5
21,16,104,9,7,2
21,16,105,6,1,5
21,16,106,18,13,5
21,16,107,12,13,-1
21,16,108,17,12,5
21,16,109,29,16,13
21,16,110,13,21,-8
21,16,111,22,26,-4
21,16,112,19,28,-9
21,16,113,14,19,-5
21,16,114,14,17,-3
21,16,115,11,6,5
21,16,116,7,21,-14
21,16,117,11,16,-5
21,16,118,7,19,-12
21,16,119,12,16,-4
21,16,120,13,9,4
21,16,121,10,10,0
21,16,122,12,26,-14
21,16,123,9,16,-7
21,16,124,12,21,-9
21,16,125,21,28,-7
21,16,126,7,9,-2
21,16,127,7,14,-7
21,16,128,11,17,-6
21,16,129,25,14,11
21,16,130,11,14,-3
21,16,131,8,22,-14
21,16,132,10,9,1
21,16,133,8,25,-17
21,16,134,14,17,-3
21,16,135,9,25,-16
21,16,136,12,21,-9
21,16,137,15,22,-7
21,16,138,16,10,6
21,16,139,15,22,-7
21,16,140,12,27,-15
21,16,141,16,14,2
21,16,142,22,19,3
21,16,143,21,16,5
21,16,144,7,14,-7
21,16,145,14,13,1
21,16,146,7,7,0
21,16,147,21,9,12
21,16,148,22,33,-11
21,16,149,13,20,-7
21,16,150,24,9,15
21,16,151,17,13,4
21,16,152,6,7,-1
21,16,153,8,11,-3
21,16,154,12,23,-11
21,16,155,11,19,-8
21,16,156,16,10,6
21,16,157,19,18,1
21,16,158,14,20,-6
21,16,159,12,14,-2
21,16,160,6,23,-17
21,16,161,10,15,-5
21,16,162,20,20,0
21,16,163,10,23,-13
21,16,164,11,17,-6
21,16,165,14,14,0
21,16,166,9,24,-15
21,16,167,20,13,7
21,16,168,19,25,-6
21,16,169,13,26,-13
21,16,170,12,24,-12
21,16,171,15,9,6
21,16,172,4,7,-3
21,16,173,9,11,-2
21,16,174,11,15,-4
21,16,175,14,10,4
21,16,176,15,20,-5
21,16,177,12,11,1
21,16,178,9,15,-6
21,16,179,13,19,-6
21,16,180,22,16,6
21,16,181,9,7,2
21,16,182,1,21,-20
21,16,183,20,24,-4
21,16,184,21,30,-9
21,16,185,11,18,-7
21,16,186,28,20,8
21,16,187,20,23,-3
21,16,188,9,21,-12
21,16,189,12,20,-8
21,16,190,22,12,10
21,16,191,16,21,-5
21,16,192,13,20,-7
21,16,193,12,21,-9
21,16,194,12,17,-5
21,16,195,5,17,-12
21,16,196,14,10,4
21,16,197,18,21,-3
21,16,198,5,17,-12
21,16,199,8,14,-6
21,16,200,10,12,-2
21,16,201,12,31,-19
21,16,202,4,11,-7
21,16,203,15,16,-1
21,16,204,16,13,3
21,16,205,13,16,-3
21,16,206,8,20,-12
21,16,207,19,16,3
21,16,208,10,20,-10
21,16,209,4,9,-5
21,16,210,14,5,9
21,16,211,8,6,2
21,16,212,16,15,1
21,16,213,8,21,-13
21,16,214,4,12,-8
21,16,215,7,29,-22
21,16,216,20,16,4
21,16,217,17,9,8
21,16,218,1,2,-1
21,16,219,19,19,0
21,16,220,10,18,-8
21,16,221,13,17,-4
21,16,222,5,14,-9
21,16,223,15,19,-4
21,16,224,11,13,-2
21,16,225,16,26,-10
21,16,226,6,18,-12
21,16,227,13,21,-8
21,16,228,7,25,-18
21,16,229,14,24,-10
21,16,230,14,17,-3
21,16,231,7,8,-1
21,16,232,20,6,14
21,16,233,13,19,-6
21,16,234,25,23,2
21,16,235,17,16,1
21,16,236,11,23,-12
21,16,237,15,13,2
21,16,238,8,20,-12
21,16,239,17,6,11
21,16,240,10,17,-7
21,16,241,14,18,-4
21,16,242,10,30,-20
21,16,243,9,11,-2
21,16,244,28,13,15
21,16,245,5,19,-14
21,16,246,10,9,1
21,16,247,10,15,-5
21,16,248,14,19,-5
21,16,249,12,12,0
21,16,250,8,14,-6
21,16,251,17,11,6
21,16,252,17,14,3
21,16,253,12,44,-32
21,16,254,16,16,0
21,16,255,8,7,1
21,16,256,9,4,5
21,16,257,24,20,4
21,16,258,6,3,3
21,16,259,24,19,5
21,16,260,29,29,0
21,16,261,12,13,-1
21,16,262,3,3,0
21,16,263,10,26,-16
21,16,264,22,11,11
21,16,265,12,13,-1
21,16,266,20,14,6
21,16,267,22,24,-2
21,16,268,10,12,-2
21,16,269,19,17,2
21,16,270,18,21,-3
21,16,271,7,7,0
21,16,272,18,17,1
21,16,273,11,26,-15
21,16,274,7,9,-2
21,16,275,12,20,-8
21,16,276,12,16,-4
21,16,277,11,12,-1
21,16,278,13,22,-9
21,16,279,17,16,1
21,16,280,11,31,-20
21,16,281,14,17,-3
21,16,282,13,20,-7
21,16,283,17,19,-2
21,16,284,7,19,-12
21,16,285,7,13,-6
21,16,286,12,17,-5
21,16,287,14,20,-6
21,16,288,3,17,-14
21,16,289,3,11,-8
21,16,290,18,17,1
21,16,291,16,10,6
21,16,292,5,9,-4
21,16,293,15,25,-10
21,16,294,16,16,0
21,16,295,11,21,-10
21,16,296,18,20,-2
21,16,297,9,28,-19
21,16,298,12,26,-14
21,16,299,7,10,-3
21,17,0,10,22,-12
21,17,1,20,20,0
21,17,2,13,11,2
21,17,3,17,16,1
21,17,4,14,19,-5
21,17,5,18,26,-8
21,17,6,8,10,-2
21,17,7,9,19,-10
21,17,8,14,25,-11
21,17,9,9,23,-14
21,17,10,18,9,9
21,17,11,17,18,-1
21,17,12,15,12,3
21,17,13,19,27,-8
21,17,14,6,6,0
21,17,15,12,6,6
21,17,16,15,16,-1
21,17,17,11,12,-1
21,17,18,13,17,-4
21,17,19,19,10,9
21,17,20,12,7,5
21,17,21,13,22,-9
21,17,22,13,13,0
21,17,23,17,10,7
21,17,24,11,16,-5
21,17,25,14,9,5
21,17,26,19,14,5
21,17,27,15,23,-8
21,17,28,13,25,-12
21,17,29,19,21,-2
21,17,30,5,10,-5
21,17,31,10,10,0
21,17,32,14,9,5
21,17,33,16,16,0
21,17,34,19,13,6
21,17,35,9,7,2
21,17,36,10,11,-1
21,17,37,18,9,9
21,17,38,25,21,4
21,17,39,24,13,11
21,17,40,16,13,3
21,17,41,16,16,0
21,17,42,7,18,-11
21,17,43,16,17,-1
21,17,44,15,7,8
21,17,45,18,27,-9
21,17,46,13,23,-10
21,17,47,25,12,13
21,17,48,13,12,1
21,17,49,17,13,4
21,17,50,13,20,-7
21,17,51,15,28,-13
21,17,52,20,27,-7
21,17,53,11,16,-5
21,17,54,20,20,0
21,17,55,17,41,-24
21,17,56,15,11,4
21,17,57,12,10,2
21,17,58,20,14,6
21,17,59,11,33,-22
21,17,60,14,11,3
21,17,61,9,13,-4
21,17,62,9,10,-1
21,17,63,12,19,-7
21,17,64,7,20,-13
21,17,65,20,24,-4
21,17,66,12,16,-4
21,17,67,14,23,-9
21,17,68,11,16,-5
21,17,69,11,14,-3
21,17,70,4,6,-2
21,17,71,10,23,-13
21,17,72,17,12,5
21,17,73,7,16,-9
21,17,74,15,17,-2
21,17,75,8,10,-2
21,17,76,7,13,-6
21,17,77,9,13,-4
21,17,78,13,15,-2
21,17,79,17,17,0
21,17,80,16,14,2
21,17,81,5,8,-3
21,17,82,12,30,-18
21,17,83,10,20,-10
21,17,84,14,12,2
21,17,85,10,11,-1
21,17,86,18,9,9
21,17,87,10,5,5
21,17,88,10,15,-5
21,17,89,17,12,5
21,17,90,26,9,17
21,17,91,3,13,-10
21,17,92,24,20,4
21,17,93,6,11,-5
21,17,94,4,12,-8
21,17,95,21,22,-1
21,17,96,15,15,0
21,17,97,30,23,7
21,17,98,16,14,2
21,17,99,17,9,8
21,17,100,28,31,-3
21,17,101,18,17,1
21,17,102,22,18,4
21,17,103,10,13,-3
21,17,104,9,9,0
21,17,105,10,12,-2
21,17,106,26,21,5
21,17,107,18,23,-5
21,17,108,8,11,-3
21,17,109,19,10,9
21,17,110,11,24,-13
21,17,111,10,8,2
21,17,112,12,22,-10
21,17,113,13,10,3
21,17,114,16,16,0
21,17,115,7,18,-11
21,17,116,9,9,0
21,17,117,14,19,-5
21,17,118,10,24,-14
21,17,119,22,15,7
21,17,120,7,23,-16
21,17,121,7,27,-20
21,17,122,16,12,4
21,17,123,12,18,-6
21,17,124,3,5,-2
21,17,125,9,12,-3
21,17,126,4,13,-9
21,17,127,5,11,-6
21,17,128,13,26,-13
21,17,129,22,12,10
21,17,130,21,14,7
21,17,131,10,19,-9
21,17,132,6,18,-12
21,17,133,12,18,-6
21,17,134,19,13,6
21,17,135,8,16,-8
21,17,136,9,6,3
21,17,137,5,24,-19
21,17,138,15,15,0
21,17,139,9,22,-13
21,17,140,16,18,-2
21,17,141,16,12,4
21,17,142,11,33,-22
21,17,143,9,8,1
21,17,144,7,24,-17
21,17,145,18,24,-6
21,17,146,7,17,-10
21,17,147,10,10,0
21,17,148,6,10,-4
21,17,149,11,10,1
21,17,150,7,19,-12
21,17,151,12,8,4
21,17,152,14,5,9
21,17,153,7,16,-9
21,17,154,13,17,-4
21,17,155,12,10,2
21,17,156,9,20,-11
21,17,157,9,22,-13
21,17,158,15,25,-10
21,17,159,12,12,0
21,17,160,10,7,3
21,17,161,21,19,2
21,17,162,8,22,-14
21,17,163,10,24,-14
21,17,164,9,17,-8
21,17,165,6,21,-15
21,17,166,16,28,-12
21,17,167,13,15,-2
21,17,168,13,13,0
21,17,169,14,16,-2
21,17,170,19,28,-9
21,17,171,4,12,-8
21,17,172,13,24,-11
21,17,173,6,11,-5
21,17,174,19,27,-8
21,17,175,8,6,2
21,17,176,9,19,-10
21,17,177,12,14,-2
21,17,178,6,22,-16
21,17,179,8,22,-14
21,17,180,16,21,-5
21,17,181,20,14,6
21,17,182,9,12,-3
21,17,183,16,9,7
21,17,184,14,16,-2
21,17,185,17,21,-4
21,17,186,20,13,7
21,17,187,10,24,-14
21,17,188,15,19,-4
21,17,189,8,21,-13
21,17,190,9,14,-5
21,17,191,11,8,3
21,17,192,14,7,7
21,17,193,17,4,13
21,17,194,13,9,4
21,17,195,18,20,-2
21,17,196,10,21,-11
21,17,197,14,21,-7
21,17,198,10,20,-10
21,17,199,19,27,-8
21,17,200,16,18,-2
21,17,201,12,16,-4
21,17,202,10,13,-3
21,17,203,13,21,-8
21,17,204,21,19,2
21,17,205,25,35,-10
21,17,206,12,11,1
21,17,207,13,18,-5
21,17,208,10,19,-9
21,17,209,24,14,10
21,17,210,22,16,6
21,17,211,27,14,13
21,17,212,11,9,2
21,17,213,7,16,-9
21,17,214,19,14,5
21,17,215,19,15,4
21,17,216,4,16,-12
21,17,217,8,17,-9
21,17,218,9,7,2
21,17,219,17,14,3
21,17,220,20,19,1
21,17,221,17,14,3
21,17,222,15,11,4
21,17,223,15,15,0
21,17,224,11,12,-1
21,17,225,19,22,-3
21,17,226,15,12,3
21,17,227,21,20,1
21,17,228,6,14,-8
21,17,229,19,22,-3
21,17,230,17,14,3
21,17,231,12,15,-3
21,17,232,18,11,7
21,17,233,17,24,-7
21,17,234,17,10,7
21,17,235,17,19,-2
21,17,236,7,10,-3
21,17,237,11,16,-5
21,17,238,11,13,-2
21,17,239,19,13,6
21,17,240,10,8,2
21,17,241,17,25,-8
21,17,242,2,9,-7
21,17,243,12,25,-13
21,17,244,14,17,-3
21,17,245,11,26,-15
21,17,246,14,15,-1
21,17,247,8,14,-6
21,17,248,15,18,-3
21,17,249,20,13,7
21,17,250,7,9,-2
21,17,251,11,16,-5
21,17,252,19,20,-1
21,17,253,19,9,10
21,17,254,9,5,4
21,17,255,12,16,-4
21,17,256,13,19,-6
21,17,257,6,20,-14
21,17,258,11,8,3
21,17,259,14,20,-6
21,17,260,16,21,-5
21,17,261,21,17,4
21,17,262,8,20,-12
21,17,263,16,12,4
21,17,264,14,20,-6
21,17,265,11,14,-3
21,17,266,15,16,-1
21,17,267,10,23,-13
21,17,268,17,14,3
21,17,269,10,14,-4
21,17,270,21,23,-2
21,17,271,15,23,-8
21,17,272,13,20,-7
21,17,273,18,18,0
21,17,274,22,16,6
21,17,275,14,15,-1
21,17,276,16,11,5
21,17,277,11,9,2
21,17,278,12,17,-5
21,17,279,6,17,-11
21,17,280,21,19,2
21,17,281,21,24,-3
21,17,282,15,25,-10
21,17,283,13,13,0
21,17,284,3,6,-3
21,17,285,16,11,5
21,17,286,17,21,-4
21,17,287,12,13,-1
21,17,288,21,13,8
21,17,289,7,11,-4
21,17,290,13,35,-22
21,17,291,11,12,-1
21,17,292,8,19,-11
21,17,293,20,17,3
21,17,294,19,13,6
21,17,295,24,10,14
21,17,296,7,25,-18
21,17,297,14,15,-1
21,17,298,21,16,5
21,17,299,7,13,-6
21,18,0,28,13,15
21,18,1,28,14,14
21,18,2,13,25,-12
21,18,3,13,16,-3
21,18,4,16,19,-3
21,18,5,14,13,1
21,18,6,17,20,-3
21,18,7,14,19,-5
21,18,8,11,10,1
21,18,9,17,25,-8
21,18,10,19,10,9
21,18,11,13,12,1
21,18,12,13,16,-3
21,18,13,12,20,-8
21,18,14,14,17,-3
21,18,15,17,12,5
21,18,16,22,8,14
21,18,17,9,16,-7
21,18,18,18,18,0
21,18,19,9,10,-1
21,18,20,10,7,3
21,18,21,12,13,-1
21,18,22,13,11,2
21,18,23,12,11,1
21,18,24,22,22,0
21,18,25,12,24,-12
21,18,26,8,16,-8
21,18,27,10,9,1
21,18,28,22,27,-5
21,18,29,12,26,-14
21,18,30,21,19,2
21,18,31,13,22,-9
21,18,32,8,34,-26
21,18,33,14,25,-11
21,18,34,8,9,-1
21,18,35,16,22,-6
21,18,36,8,11,-3
21,18,37,6,21,-15
21,18,38,11,5,6
21,18,39,10,14,-4
21,18,40,9,14,-5
21,18,41,10,23,-13
21,18,42,28,6,22
21,18,43,9,7,2
21,18,44,10,16,-6
21,18,45,17,17,0
21,18,46,13,14,-1
21,18,47,15,35,-20
21,18,48,17,19,-2
21,18,49,21,16,5
21,18,50,6,8,-2
21,18,51,24,32,-8
21,18,52,23,30,-7
21,18,53,14,14,0
21,18,54,16,18,-2
21,18,55,9,25,-16
21,18,56,13,6,7
21,18,57,18,4,14
21,18,58,9,8,1
21,18,59,16,12,4
21,18,60,8,19,-11
21,18,61,12,17,-5
21,18,62,14,13,1
21,18,63,23,19,4
21,18,64,10,15,-5
21,18,65,15,21,-6
21,18,66,12,5,7
21,18,67,19,25,-6
21,18,68,16,17,-1
21,18,69,12,17,-5
21,18,70,21,16,5
21,18,71,19,23,-4
21,18,72,13,17,-4
21,18,73,18,26,-8
21,18,74,21,17,4
21,18,75,15,25,-10
21,18,76,18,26,-8
21,18,77,7,22,-15
21,18,78,10,6,4
21,18,79,16,16,0
21,18,80,10,14,-4
21,18,81,6,14,-8
21,18,82,19,20,-1
21,18,83,23,28,-5
21,18,84,3,10,-7
21,18,85,15,11,4
21,18,86,11,15,-4
21,18,87,13,17,-4
21,18,88,7,16,-9
21,18,89,19,22,-3
21,18,90,10,12,-2
21,18,91,18,17,1
21,18,92,10,11,-1
21,18,93,13,17,-4
21,18,94,17,20,-3
21,18,95,19,20,-1
21,18,96,8,9,-1
21,18,97,19,23,-4
21,18,98,11,10,1
21,18,99,20,19,1
21,18,100,9,6,3
21,18,101,12,19,-7
21,18,102,6,19,-13
21,18,103,18,15,3
21,18,104,22,13,9
21,18,105,6,22,-16
21,18,106,6,12,-6
21,18,107,11,13,-2
21,18,108,29,31,-2
21,18,109,10,11,-1
21,18,110,11,11,0
21,18,111,16,17,-1
21,18,112,20,20,0
21,18,113,8,20,-12
21,18,114,17,5,12
21,18,115,17,10,7
21,18,116,24,11,13
21,18,117,10,13,-3
21,18,118,19,22,-3
21,18,119,10,9,1
21,18,120,16,17,-1
21,18,121,21,16,5
21,18,122,31,14,17
21,18,123,6,15,-9
21,18,124,5,11,-6
21,18,125,9,19,-10
21,18,126,11,14,-3
21,18,127,8,22,-14
21,18,128,7,7,0
21,18,129,4,6,-2
21,18,130,13,22,-9
21,18,131,7,16,-9
21,18,132,11,24,-13
21,18,133,15,27,-12
21,18,134,16,9,7
21,18,135,12,14,-2
21,18,136,14,8,6
21,18,137,15,22,-7
21,18,138,21,14,7
21,18,139,16,13,3
21,18,140,11,15,-4
21,18,141,16,9,7
21,18,142,9,15,-6
21,18,143,8,4,4
21,18,144,4,11,-7
21,18,145,22,14,8
21,18,146,8,11,-3
21,18,147,8,10,-2
21,18,148,25,13,12
21,18,149,15,16,-1
21,18,150,28,19,9
21,18,151,5,14,-9
21,18,152,14,23,-9
21,18,153,11,9,2
21,18,154,11,16,-5
21,18,155,17,12,5
21,18,156,40,20,20
21,18,157,18,11,7
21,18,158,14,15,-1
21,18,159,13,23,-10
21,18,160,9,10,-1
21,18,161,7,13,-6
21,18,162,3,8,-5
21,18,163,22,15,7
21,18,164,18,13,5
21,18,165,21,19,2
21,18,166,6,15,-9
21,18,167,20,12,8
21,18,168,17,20,-3
21,18,169,17,14,3
21,18,170,16,24,-8
21,18,171,0,11,-11
21,18,172,10,15,-5
21,18,173,9,13,-4
21,18,174,15,21,-6
21,18,175,17,15,2
21,18,176,7,12,-5
21,18,177,13,13,0
21,18,178,13,26,-13
21,18,179,11,16,-5
21,18,180,19,28,-9
21,18,181,10,17,-7
21,18,182,9,30,-21
21,18,183,12,11,1
21,18,184,20,25,-5
21,18,185,11,15,-4
21,18,186,4,10,-6
21,18,187,13,23,-10
21,18,188,12,7,5
21,18,189,17,15,2
21,18,190,11,18,-7
21,18,191,10,15,-5
21,18,192,11,5,6
21,18,193,15,15,0
21,18,194,11,10,1
21,18,195,9,16,-7
21,18,196,17,15,2
21,18,197,9,11,-2
21,18,198,8,13,-5
21,18,199,8,15,-7
21,18,200,18,17,1
21,18,201,11,13,-2
21,18,202,15,15,0
21,18,203,6,25,-19
21,18,204,10,18,-8
21,18,205,29,16,13
21,18,206,18,22,-4
21,18,207,14,13,1
21,18,208,8,17,-9
21,18,209,15,23,-8
21,18,210,10,15,-5
21,18,211,14,16,-2
21,18,212,12,24,-12
21,18,213,14,10,4
21,18,214,11,3,8
21,18,215,11,6,5
21,18,216,17,23,-6
21,18,217,7,19,-12
21,18,218,8,14,-6
21,18,219,20,27,-7
21,18,220,21,18,3
21,18,221,4,10,-6
21,18,222,22,15,7
21,18,223,17,17,0
21,18,224,19,19,0
21,18,225,4,12,-8
21,18,226,23,33,-10
21,18,227,15,23,-8
21,18,228,9,13,-4
21,18,229,20,9,11
21,18,230,3,6,-3
21,18,231,4,15,-11
21,18,232,23,28,-5
21,18,233,9,13,-4
21,18,234,9,17,-8
21,18,235,12,14,-2
21,18,236,13,15,-2
21,18,237,8,5,3
21,18,238,16,14,2
21,18,239,11,15,-4
21,18,240,22,22,0
21,18,241,7,22,-15
21,18,242,28,19,9
21,18,243,18,18,0
21,18,244,13,13,0
21,18,245,17,12,5
21,18,246,13,15,-2
21,18,247,11,24,-13
21,18,248,8,13,-5
21,18,249,7,12,-5
21,18,250,8,22,-14
21,18,251,15,17,-2
21,18,252,4,12,-8
21,18,253,20,17,3
21,18,254,14,18,-4
21,18,255,5,13,-8
21,18,256,10,11,-1
21,18,257,13,22,-9
21,18,258,16,17,-1
21,18,259,23,13,10
21,18,260,13,13,0
21,18,261,25,12,13
21,18,262,9,11,-2
21,18,263,9,7,2
21,18,264,13,12,1
21,18,265,20,20,0
21,18,266,12,13,-1
21,18,267,21,13,8
21,18,268,9,13,-4
21,18,269,12,12,0
21,18,270,21,22,-1
21,18,271,19,27,-8
21,18,272,16,21,-5
21,18,273,20,16,4
21,18,274,12,17,-5
21,18,275,14,29,-15
21,18,276,2,5,-3
21,18,277,14,34,-20
21,18,278,10,4,6
21,18,279,10,10,0
21,18,280,15,12,3
21,18,281,15,13,2
21,18,282,20,17,3
21,18,283,6,5,1
21,18,284,21,20,1
21,18,285,13,11,2
21,18,286,19,29,-10
21,18,287,21,23,-2
21,18,288,20,6,14
21,18,289,10,6,4
21,18,290,20,18,2
21,18,291,14,16,-2
21,18,292,9,9,0
21,18,293,10,24,-14
21,18,294,18,19,-1
21,18,295,11,17,-6
21,18,296,17,16,1
21,18,297,8,18,-10
21,18,298,19,22,-3
21,18,299,5,10,-5
21,19,0,9,11,-2
21,19,1,17,13,4
21,19,2,6,10,-4
21,19,3,13,13,0
21,19,4,11,17,-6
21,19,5,11,9,2
21,19,6,26,26,0
21,19,7,9,13,-4
21,19,8,7,8,-1
21,19,9,22,11,11
21,19,10,18,10,8
21,19,11,8,14,-6
21,19,12,14,26,-12
21,19,13,14,14,0
21,19,14,5,9,-4
21,19,15,11,23,-12
21,19,16,17,17,0
21,19,17,21,29,-8
21,19,18,18,26,-8
21,19,19,18,16,2
21,19,20,9,20,-11
21,19,21,8,14,-6
21,19,22,14,10,4
21,19,23,18,16,2
21,19,24,10,12,-2
21,19,25,10,11,-1
21,19,26,14,13,1
21,19,27,13,12,1
21,19,28,8,15,-7
21,19,29,21,24,-3
21,19,30,16,21,-5
21,19,31,5,16,-11
21,19,32,13,11,2
21,19,33,13,21,-8
21,19,34,19,16,3
21,19,35,20,24,-4
21,19,36,12,14,-2
21,19,37,11,18,-7
21,19,38,17,21,-4
21,19,39,11,11,0
21,19,40,11,12,-1
21,19,41,12,10,2
21,19,42,13,6,7
21,19,43,6,27,-21
21,19,44,9,14,-5
21,19,45,19,12,7
21,19,46,21,17,4
21,19,47,15,17,-2
21,19,48,16,9,7
21,19,49,14,10,4
21,19,50,21,19,2
21,19,51,15,20,-5
21,19,52,4,25,-21
21,19,53,12,25,-13
21,19,54,13,10,3
21,19,55,13,19,-6
21,19,56,16,25,-9
21,19,57,21,13,8
21,19,58,14,6,8
21,19,59,11,20,-9
21,19,60,19,14,5
21,19,61,18,18,0
21,19,62,13,22,-9
21,19,63,16,14,2
21,19,64,14,18,-4
21,19,65,12,9,3
21,19,66,9,20,-11
21,19,67,17,17,0
21,19,68,21,22,-1
21,19,69,19,24,-5
21,19,70,21,13,8
21,19,71,15,20,-5
21,19,72,16,11,5
21,19,73,6,8,-2
21,19,74,21,12,9
21,19,75,9,17,-8
21,19,76,11,16,-5
21,19,77,14,21,-7
21,19,78,23,15,8
21,19,79,12,13,-1
21,19,80,12,20,-8
21,19,81,14,18,-4
21,19,82,25,17,8
21,19,83,21,22,-1
21,19,84,29,32,-3
21,19,85,10,18,-8
21,19,86,20,12,8
21,19,87,14,7,7
21,19,88,17,22,-5
21,19,89,19,15,4
21,19,90,13,22,-9
21,19,91,6,12,-6
21,19,92,12,14,-2
21,19,93,11,12,-1
21,19,94,16,22,-6
21,19,95,11,10,1
21,19,96,12,10,2
21,19,97,16,15,1
21,19,98,14,9,5
21,19,99,13,24,-11
21,19,100,9,8,1
21,19,101,6,8,-2
21,19,102,11,14,-3
21,19,103,13,21,-8
21,19,104,17,7,10
21,19,105,8,13,-5
21,19,106,15,21,-6
21,19,107,20,17,3
21,19,108,26,24,2
21,19,109,13,21,-8
21,19,110,16,11,5
21,19,111,25,19,6
21,19,112,19,8,11
21,19,113,10,13,-3
21,19,114,28,23,5
21,19,115,14,16,-2
21,19,116,22,26,-4
21,19,117,22,32,-10
21,19,118,5,13,-8
21,19,119,20,12,8
21,19,120,16,17,-1
21,19,121,10,12,-2
21,19,122,11,10,1
21,19,123,21,22,-1
21,19,124,10,18,-8
21,19,125,11,26,-15
21,19,126,15,14,1
21,19,127,14,19,-5
21,19,128,6,5,1
21,19,129,10,17,-7
21,19,130,13,30,-17
21,19,131,25,18,7
21,19,132,12,9,3
21,19,133,13,14,-1
21,19,134,3,17,-14
21,19,135,16,14,2
21,19,136,14,16,-2
21,19,137,12,19,-7
21,19,138,10,23,-13
21,19,139,17,21,-4
21,19,140,18,21,-3
21,19,141,14,18,-4
21,19,142,13,21,-8
21,19,143,12,23,-11
21,19,144,8,15,-7
21,19,145,10,7,3
21,19,146,22,22,0
21,19,147,18,11,7
21,19,148,9,8,1
21,19,149,21,9,12
21,19,150,19,10,9
21,19,151,11,13,-2
21,19,152,10,9,1
21,19,153,17,20,-3
21,19,154,21,16,5
21,19,155,7,10,-3
21,19,156,18,22,-4
21,19,157,15,26,-11
21,19,158,10,22,-12
21,19,159,16,12,4
21,19,160,17,23,-6
21,19,161,25,17,8
21,19,162,17,17,0
21,19,163,15,16,-1
21,19,164,21,15,6
21,19,165,9,7,2
21,19,166,14,25,-11
21,19,167,14,9,5
21,19,168,15,15,0
21,19,169,9,19,-10
21,19,170,19,28,-9
21,19,171,6,20,-14
21,19,172,11,20,-9
21,19,173,11,7,4
21,19,174,11,10,1
21,19,175,24,15,9
21,19,176,7,1,6
21,19,177,19,10,9
21,19,178,5,9,-4
21,19,179,10,8,2
21,19,180,14,19,-5
21,19,181,4,11,-7
21,19,182,23,11,12
21,19,183,6,16,-10
21,19,184,22,22,0
21,19,185,13,10,3
21,19,186,14,18,-4
21,19,187,14,22,-8
21,19,188,16,31,-15
21,19,189,25,30,-5
21,19,190,8,13,-5
21,19,191,10,12,-2
21,19,192,4,14,-10
21,19,193,16,21,-5
21,19,194,16,20,-4
21,19,195,14,10,4
21,19,196,8,12,-4
21,19,197,9,22,-13
21,19,198,11,25,-14
21,19,199,15,19,-4
21,19,200,18,25,-7
21,19,201,18,19,-1
21,19,202,19,18,1
21,19,203,5,12,-7
21,19,204,12,13,-1
21,19,205,22,18,4
21,19,206,7,28,-21
21,19,207,22,16,6
21,19,208,18,10,8
21,19,209,14,14,0
21,19,210,11,11,0
21,19,211,7,9,-2
21,19,212,21,23,-2
21,19,213,22,13,9
21,19,214,11,7,4
21,19,215,9,13,-4
21,19,216,5,19,-14
21,19,217,14,17,-3
21,19,218,11,6,5
21,19,219,22,17,5
21,19,220,6,6,0
21,19,221,16,15,1
21,19,222,19,11,8
21,19,223,22,14,8
21,19,224,15,28,-13
21,19,225,23,17,6
21,19,226,6,12,-6
21,19,227,13,12,1
21,19,228,19,15,4
21,19,229,8,7,1
21,19,230,13,17,-4
21,19,231,8,23,-15
21,19,232,15,20,-5
21,19,233,13,10,3
21,19,234,18,6,12
21,19,235,7,19,-12
21,19,236,5,11,-6
21,19,237,23,19,4
21,19,238,4,9,-5
21,19,239,10,16,-6
21,19,240,13,22,-9
21,19,241,11,14,-3
21,19,242,23,28,-5
21,19,243,11,18,-7
21,19,244,13,19,-6
21,19,245,17,13,4
21,19,246,18,18,0
21,19,247,15,25,-10
21,19,248,10,14,-4
21,19,249,14,14,0
21,19,250,11,19,-8
21,19,251,24,20,4
21,19,252,26,13,13
21,19,253,17,31,-14
21,19,254,7,11,-4
21,19,255,3,7,-4
21,19,256,6,10,-4
21,19,257,18,11,7
21,19,258,14,23,-9
21,19,259,13,14,-1
21,19,260,7,8,-1
21,19,261,18,14,4
21,19,262,14,17,-3
21,19,263,7,8,-1
21,19,264,8,9,-1
21,19,265,8,23,-15
21,19,266,7,6,1
21,19,267,12,14,-2
21,19,268,12,21,-9
21,19,269,15,10,5
21,19,270,11,15,-4
21,19,271,23,20,3
21,19,272,12,8,4
21,19,273,9,4,5
21,19,274,16,22,-6
21,19,275,8,6,2
21,19,276,14,16,-2
21,19,277,18,24,-6
21,19,278,6,10,-4
21,19,279,9,13,-4
21,19,280,12,25,-13
21,19,281,10,5,5
21,19,282,8,17,-9
21,19,283,16,22,-6
21,19,284,21,18,3
21,19,285,9,7,2
21,19,286,25,21,4
21,19,287,14,17,-3
21,19,288,17,9,8
21,19,289,14,12,2
21,19,290,7,25,-18
21,19,291,14,22,-8
21,19,292,14,19,-5
21,19,293,20,20,0
21,19,294,5,19,-14
21,19,295,11,8,3
21,19,296,16,22,-6
21,19,297,8,22,-14
21,19,298,14,13,1
21,19,299,12,21,-9
21,20,0,7,11,-4
21,20,1,19,22,-3
21,20,2,19,23,-4
21,20,3,12,8,4
21,20,4,18,23,-5
21,20,5,11,19,-8
21,20,6,14,24,-10
21,20,7,20,14,6
21,20,8,17,22,-5
21,20,9,12,15,-3
21,20,10,3,13,-10
21,20,11,20,18,2
21,20,12,12,23,-11
21,20,13,11,7,4
21,20,14,9,16,-7
21,20,15,8,23,-15
21,20,16,5,22,-17
21,20,17,24,22,2
21,20,18,12,28,-16
21,20,19,7,5,2
21,20,20,10,11,-1
21,20,21,31,25,6
21,20,22,19,11,8
21,20,23,15,13,2
21,20,24,16,22,-6
21,20,25,12,6,6
21,20,26,11,20,-9
21,20,27,21,16,5
21,20,28,10,20,-10
21,20,29,15,15,0
21,20,30,7,10,-3
21,20,31,9,15,-6
21,20,32,21,18,3
21,20,33,16,16,0
21,20,34,10,10,0
21,20,35,24,9,15
21,20,36,11,29,-18
21,20,37,11,5,6
21,20,38,17,10,7
21,20,39,6,17,-11
21,20,40,17,18,-1
21,20,41,11,24,-13
21,20,42,16,11,5
21,20,43,25,27,-2
21,20,44,5,12,-7
21,20,45,10,12,-2
21,20,46,10,14,-4
21,20,47,16,11,5
21,20,48,13,10,3
21,20,49,23,23,0
21,20,50,11,9,2
21,20,51,6,4,2
21,20,52,21,28,-7
21,20,53,15,20,-5
21,20,54,16,8,8
21,20,55,6,7,-1
21,20,56,17,21,-4
21,20,57,6,8,-2
21,20,58,12,7,5
21,20,59,15,2,13
21,20,60,14,11,3
21,20,61,14,23,-9
21,20,62,9,13,-4
21,20,63,12,33,-21
21,20,64,9,17,-8
21,20,65,18,17,1
21,20,66,12,24,-12
21,20,67,6,17,-11
21,20,68,16,22,-6
21,20,69,21,28,-7
21,20,70,24,18,6
21,20,71,20,31,-11
21,20,72,13,16,-3
21,20,73,9,12,-3
21,20,74,2,11,-9
21,20,75,28,15,13
21,20,76,9,15,-6
21,20,77,8,14,-6
21,20,78,14,19,-5
21,20,79,10,20,-10
21,20,80,5,29,-24
21,20,81,18,20,-2
21,20,82,17,18,-1
21,20,83,16,22,-6
21,20,84,17,24,-7
21,20,85,18,16,2
21,20,86,21,10,11
21,20,87,12,25,-13
21,20,88,9,12,-3
21,20,89,7,18,-11
21,20,90,25,9,16
21,20,91,11,13,-2
21,20,92,15,15,0
21,20,93,12,12,0
21,20,94,13,4,9
21,20,95,13,25,-12
21,20,96,18,26,-8
21,20,97,9,20,-11
21,20,98,27,20,7
21,20,99,17,11,6
21,20,100,11,11,0
21,20,101,17,9,8
21,20,102,10,10,0
21,20,103,24,17,7
21,20,104,11,29,-18
21,20,105,15,18,-3
21,20,106,24,25,-1
21,20,107,9,14,-5
21,20,108,4,11,-7
21,20,109,9,15,-6
21,20,110,6,11,-5
21,20,111,30,14,16
21,20,112,12,15,-3
21,20,113,6,3,3
21,20,114,8,10,-2
21,20,115,12,7,5
21,20,116,10,16,-6
21,20,117,24,24,0
21,20,118,9,24,-15
21,20,119,17,2,15
21,20,120,22,12,10
21,20,121,11,9,2
21,20,122,5,11,-6
21,20,123,7,16,-9
21,20,124,13,9,4
21,20,125,15,6,9
21,20,126,14,23,-9
21,20,127,19,14,5
21,20,128,7,8,-1
21,20,129,20,30,-10
21,20,130,5,11,-6
21,20,131,17,18,-1
21,20,132,27,9,18
21,20,133,11,8,3
21,20,134,6,19,-13
21,20,135,10,18,-8
21,20,136,16,14,2
21,20,137,18,12,6
21,20,138,26,25,1
21,20,139,22,20,2
21,20,140,13,14,-1
21,20,141,8,13,-5
21,20,142,9,6,3
21,20,143,13,20,-7
21,20,144,12,15,-3
21,20,145,14,15,-1
21,20,146,19,23,-4
21,20,147,13,8,5
21,20,148,19,17,2
21,20,149,17,21,-4
21,20,150,14,14,0
21,20,151,13,20,-7
21,20,152,11,20,-9
21,20,153,14,19,-5
21,20,154,9,9,0
21,20,155,21,13,8
21,20,156,20,18,2
21,20,157,16,20,-4
21,20,158,11,22,-11
21,20,159,20,17,3
21,20,160,16,18,-2
21,20,161,13,23,-10
21,20,162,20,20,0
21,20,163,16,15,1
21,20,164,18,19,-1
21,20,165,14,11,3
21,20,166,9,4,5
21,20,167,17,17,0
21,20,168,12,13,-1
21,20,169,13,13,0
21,20,170,13,8,5
21,20,171,16,19,-3
21,20,172,14,9,5
21,20,173,24,11,13
21,20,174,9,10,-1
21,20,175,8,19,-11
21,20,176,11,9,2
21,20,177,13,20,-7
21,20,178,6,16,-10
21,20,179,14,12,2
21,20,180,8,21,-13
21,20,181,15,22,-7
21,20,182,9,16,-7
21,20,183,15,22,-7
21,20,184,2,10,-8
21,20,185,16,25,-9
21,20,186,14,11,3
21,20,187,17,13,4
21,20,188,14,23,-9
21,20,189,27,15,12
21,20,190,17,18,-1
21,20,191,7,13,-6
21,20,192,14,18,-4
21,20,193,8,13,-5
21,20,194,9,10,-1
21,20,195,7,16,-9
21,20,196,16,11,5
21,20,197,18,10,8
21,20,198,12,14,-2
21,20,199,10,10,0
21,20,200,12,4,8
21,20,201,11,12,-1
21,20,202,13,28,-15
21,20,203,28,11,17
21,20,204,7,30,-23
21,20,205,17,14,3
21,20,206,6,20,-14
21,20,207,15,26,-11
21,20,208,13,19,-6
21,20,209,22,26,-4
21,20,210,17,9,8
21,20,211,3,8,-5
21,20,212,12,14,-2
21,20,213,15,6,9
21,20,214,12,28,-16
21,20,215,10,4,6
21,20,216,20,14,6
21,20,217,13,19,-6
21,20,218,20,18,2
21,20,219,15,23,-8
21,20,220,16,24,-8
21,20,221,10,15,-5
21,20,222,11,8,3
21,20,223,14,13,1
21,20,224,13,20,-7
21,20,225,7,9,-2
21,20,226,12,13,-1
21,20,227,9,3,6
21,20,228,20,33,-13
21,20,229,6,24,-18
21,20,230,12,23,-11
21,20,231,15,12,3
21,20,232,11,10,1
21,20,233,17,22,-5
21,20,234,15,9,6
21,20,235,20,16,4
21,20,236,16,19,-3
21,20,237,15,28,-13
21,20,238,24,9,15
21,20,239,14,15,-1
21,20,240,19,18,1
21,20,241,16,22,-6
21,20,242,10,16,-6
21,20,243,11,19,-8
21,20,244,21,7,14
21,20,245,6,8,-2
21,20,246,12,26,-14
21,20,247,20,21,-1
21,20,248,11,11,0
21,20,249,19,34,-15
21,20,250,19,14,5
21,20,251,13,15,-2
21,20,252,12,14,-2
21,20,253,5,7,-2
21,20,254,26,21,5
21,20,255,20,14,6
21,20,256,17,8,9
21,20,257,8,20,-12
21,20,258,20,11,9
21,20,259,7,12,-5
21,20,260,4,16,-12
21,20,261,13,16,-3
21,20,262,12,13,-1
21,20,263,15,10,5
21,20,264,19,20,-1
21,20,265,7,17,-10
21,20,266,27,38,-11
21,20,267,20,18,2
21,20,268,11,12,-1
21,20,269,14,17,-3
21,20,270,14,9,5
21,20,271,10,10,0
21,20,272,9,11,-2
21,20,273,18,25,-7
21,20,274,14,20,-6
21,20,275,10,4,6
21,20,276,14,33,-19
21,20,277,20,21,-1
21,20,278,14,27,-13
21,20,279,19,5,14
21,20,280,13,25,-12
21,20,281,13,12,1
21,20,282,11,19,-8
21,20,283,16,18,-2
21,20,284,15,25,-10
21,20,285,17,20,-3
21,20,286,10,12,-2
21,20,287,15,23,-8
21,20,288,14,12,2
21,20,289,10,6,4
21,20,290,20,9,11
21,20,291,25,23,2
21,20,292,29,12,17
21,20,293,5,20,-15
21,20,294,19,21,-2
21,20,295,30,8,22
21,20,296,11,21,-10
21,20,297,23,25,-2
21,20,298,11,12,-1
21,20,299,10,15,-5
21,21,0,17,22,-5
21,21,1,17,22,-5
21,21,2,8,23,-15
21,21,3,15,12,3
21,21,4,12,15,-3
21,21,5,8,14,-6
21,21,6,19,18,1
21,21,7,16,19,-3
21,21,8,20,23,-3
21,21,9,6,8,-2
21,21,10,11,10,1
21,21,11,22,26,-4
21,21,12,6,18,-12
21,21,13,16,15,1
21,21,14,18,14,4
21,21,15,9,11,-2
21,21,16,13,9,4
21,21,17,13,11,2
21,21,18,20,17,3
21,21,19,6,11,-5
21,21,20,16,26,-10
21,21,21,14,30,-16
21,21,22,34,23,11
21,21,23,14,19,-5
21,21,24,19,9,10
21,21,25,18,21,-3
21,21,26,22,8,14
21,21,27,10,5,5
21,21,28,19,31,-12
21,21,29,10,4,6
21,21,30,14,9,5
21,21,31,20,15,5
21,21,32,13,20,-7
21,21,33,6,8,-2
21,21,34,5,17,-12
21,21,35,12,5,7
21,21,36,12,7,5
21,21,37,8,6,2
21,21,38,10,3,7
21,21,39,14,17,-3
21,21,40,10,19,-9
21,21,41,11,20,-9
21,21,42,19,15,4
21,21,43,14,10,4
21,21,44,10,15,-5
21,21,45,12,13,-1
21,21,46,18,29,-11
21,21,47,13,13,0
21,21,48,14,29,-15
21,21,49,16,14,2
21,21,50,12,24,-12
21,21,51,10,6,4
21,21,52,13,11,2
21,21,53,14,29,-15
21,21,54,18,20,-2
21,21,55,10,18,-8
21,21,56,21,16,5
21,21,57,12,7,5
21,21,58,11,24,-13
21,21,59,21,31,-10
21,21,60,19,16,3
21,21,61,25,12,13
21,21,62,6,10,-4
21,21,63,13,6,7
21,21,64,3,10,-7
21,21,65,15,12,3
21,21,66,10,18,-8
21,21,67,12,14,-2
21,21,68,6,18,-12
21,21,69,6,22,-16
21,21,70,14,7,7
21,21,71,9,19,-10
21,21,72,18,19,-1
21,21,73,15,30,-15
21,21,74,14,14,0
21,21,75,8,8,0
21,21,76,3,7,-4
21,21,77,17,22,-5
21,21,78,27,18,9
21,21,79,8,32,-24
21,21,80,7,11,-4
21,21,81,16,21,-5
21,21,82,21,14,7
21,21,83,25,19,6
21,21,84,12,15,-3
21,21,85,11,21,-10
21,21,86,20,10,10
21,21,87,24,7,17
21,21,88,15,8,7
21,21,89,8,9,-1
21,21,90,15,11,4
21,21,91,18,27,-9
21,21,92,10,14,-4
21,21,93,6,9,-3
21,21,94,6,14,-8
21,21,95,10,17,-7
21,21,96,18,13,5
21,21,97,14,21,-7
21,21,98,15,14,1
21,21,99,16,24,-8
21,21,100,13,29,-16
21,21,101,14,15,-1
21,21,102,15,14,1
21,21,103,9,10,-1
21,21,104,12,4,8
21,21,105,17,16,1
21,21,106,9,14,-5
21,21,107,6,15,-9
21,21,108,10,16,-6
21,21,109,18,16,2
21,21,110,9,10,-1
21,21,111,24,28,-4
21,21,112,14,12,2
21,21,113,35,17,18
21,21,114,7,10,-3
21,21,115,21,15,6
21,21,116,16,14,2
21,21,117,9,10,-1
21,21,118,10,7,3
21,21,119,9,13,-4
21,21,120,10,9,1
21,21,121,5,4,1
21,21,122,22,23,-1
21,21,123,16,19,-3
21,21,124,15,17,-2
21,21,125,5,14,-9
21,21,126,14,19,-5
21,21,127,8,23,-15
21,21,128,9,16,-7
21,21,129,19,15,4
21,21,130,7,8,-1
21,21,131,9,10,-1
21,21,132,14,19,-5
21,21,133,10,16,-6
21,21,134,13,12,1
21,21,135,6,23,-17
21,21,136,9,17,-8
21,21,137,10,11,-1
21,21,138,13,13,0
21,21,139,18,18,0
21,21,140,7,23,-16
21,21,141,14,10,4
21,21,142,13,19,-6
21,21,143,12,8,4
21,21,144,16,15,1
21,21,145,12,6,6
21,21,146,24,16,8
21,21,147,7,10,-3
21,21,148,12,31,-19
21,21,149,5,10,-5
21,21,150,18,16,2
21,21,151,23,22,1
21,21,152,5,15,-10
21,21,153,10,12,-2
21,21,154,13,11,2
21,21,155,11,19,-8
21,21,156,11,11,0
21,21,157,12,23,-11
21,21,158,10,18,-8
21,21,159,25,32,-7
21,21,160,9,15,-6
21,21,161,7,8,-1
21,21,162,13,17,-4
21,21,163,5,19,-14
21,21,164,7,4,3
21,21,165,12,19,-7
21,21,166,9,12,-3
21,21,167,13,15,-2
21,21,168,18,11,7
21,21,169,17,12,5
21,21,170,18,15,3
21,21,171,7,19,-12
21,21,172,9,14,-5
21,21,173,16,16,0
21,21,174,20,15,5
21,21,175,11,28,-17
21,21,176,27,24,3
21,21,177,18,17,1
21,21,178,7,18,-11
21,21,179,21,19,2
21,21,180,16,24,-8
21,21,181,12,6,6
21,21,182,15,8,7
21,21,183,23,13,10
21,21,184,10,11,-1
21,21,185,17,26,-9
21,21,186,8,16,-8
21,21,187,14,18,-4
21,21,188,15,20,-5
21,21,189,13,7,6
21,21,190,8,13,-5
21,21,191,17,16,1
21,21,192,10,20,-10
21,21,193,20,24,-4
21,21,194,12,14,-2
21,21,195,17,18,-1
21,21,196,12,13,-1
21,21,197,10,18,-8
21,21,198,24,22,2
21,21,199,18,2,16
21,21,200,9,12,-3
21,21,201,12,14,-2
21,21,202,13,24,-11
21,21,203,6,10,-4
21,21,204,9,12,-3
21,21,205,27,14,13
21,21,206,24,5,19
21,21,207,7,9,-2
21,21,208,16,9,7
21,21,209,19,25,-6
21,21,210,13,19,-6
21,21,211,6,10,-4
21,21,212,10,10,0
21,21,213,18,25,-7
21,21,214,19,9,10
21,21,215,2,4,-2
21,21,216,15,28,-13
21,21,217,19,18,1
21,21,218,2,10,-8
21,21,219,10,16,-6
21,21,220,19,28,-9
21,21,221,17,23,-6
21,21,222,13,10,3
21,21,223,15,9,6
21,21,224,9,13,-4
21,21,225,21,18,3
21,21,226,23,17,6
21,21,227,17,23,-6
21,21,228,7,13,-6
21,21,229,17,9,8
21,21,230,20,19,1
21,21,231,20,17,3
21,21,232,19,10,9
21,21,233,5,11,-6
21,21,234,14,19,-5
21,21,235,12,4,8
21,21,236,18,11,7
21,21,237,11,14,-3
21,21,238,17,13,4
21,21,239,11,13,-2
21,21,240,10,25,-15
21,21,241,18,13,5
21,21,242,14,19,-5
21,21,243,13,7,6
21,21,244,9,7,2
21,21,245,11,12,-1
21,21,246,12,13,-1
21,21,247,11,10,1
21,21,248,7,15,-8
21,21,249,15,27,-12
21,21,250,11,12,-1
21,21,251,14,12,2
21,21,252,15,8,7
21,21,253,19,10,9
21,21,254,8,20,-12
21,21,255,8,21,-13
21,21,256,12,13,-1
21,21,257,6,11,-5
21,21,258,16,31,-15
21,21,259,2,3,-1
21,21,260,20,17,3
21,21,261,12,15,-3
21,21,262,13,12,1
21,21,263,14,21,-7
21,21,264,28,31,-3
21,21,265,15,15,0
21,21,266,8,2,6
21,21,267,8,21,-13
21,21,268,11,15,-4
21,21,269,16,10,6
21,21,270,14,27,-13
21,21,271,23,17,6
21,21,272,25,28,-3
21,21,273,12,11,1
21,21,274,8,9,-1
21,21,275,11,10,1
21,21,276,5,15,-10
21,21,277,25,11,14
21,21,278,10,9,1
21,21,279,20,13,7
21,21,280,8,12,-4
21,21,281,11,24,-13
21,21,282,14,20,-6
21,21,283,15,27,-12
21,21,284,13,12,1
21,21,285,8,7,1
21,21,286,15,10,5
21,21,287,21,18,3
21,21,288,5,9,-4
21,21,289,6,3,3
21,21,290,10,14,-4
21,21,291,23,31,-8
21,21,292,15,15,0
21,21,293,2,23,-21
21,21,294,17,28,-11
21,21,295,5,7,-2
21,21,296,16,33,-17
21,21,297,21,20,1
21,21,298,9,10,-1
21,21,299,8,25,-17
21,22,0,21,16,5
21,22,1,17,27,-10
21,22,2,6,16,-10
21,22,3,15,8,7
21,22,4,15,10,5
21,22,5,9,7,2
21,22,6,21,18,3
21,22,7,13,12,1
21,22,8,13,15,-2
21,22,9,11,13,-2
21,22,10,20,14,6
21,22,11,11,10,1
21,22,12,12,16,-4
21,22,13,15,22,-7
21,22,14,13,4,9
21,22,15,18,17,1
21,22,16,11,12,-1
21,22,17,10,7,3
21,22,18,13,19,-6
21,22,19,17,29,-12
21,22,20,5,14,-9
21,22,21,13,8,5
21,22,22,23,14,9
21,22,23,18,8,10
21,22,24,15,15,0
21,22,25,16,13,3
21,22,26,21,8,13
21,22,27,16,20,-4
21,22,28,17,20,-3
21,22,29,11,6,5
21,22,30,11,17,-6
21,22,31,10,10,0
21,22,32,16,27,-11
21,22,33,13,15,-2
21,22,34,20,20,0
21,22,35,11,7,4
21,22,36,6,24,-18
21,22,37,11,14,-3
21,22,38,15,18,-3
21,22,39,11,12,-1
21,22,40,13,12,1
21,22,41,13,10,3
21,22,42,15,22,-7
21,22,43,6,15,-9
21,22,44,8,15,-7
21,22,45,6,15,-9
21,22,46,14,16,-2
21,22,47,15,19,-4
21,22,48,12,7,5
21,22,49,30,9,21
21,22,50,16,14,2
21,22,51,9,11,-2
21,22,52,10,16,-6
21,22,53,12,8,4
21,22,54,18,9,9
21,22,55,22,12,10
21,22,56,14,9,5
21,22,57,18,6,12
21,22,58,15,23,-8
21,22,59,13,24,-11
21,22,60,10,20,-10
21,22,61,12,24,-12
21,22,62,15,18,-3
21,22,63,25,10,15
21,22,64,8,12,-4
21,22,65,17,14,3
21,22,66,14,10,4
21,22,67,18,5,13
21,22,68,11,15,-4
21,22,69,13,21,-8
21,22,70,17,16,1
21,22,71,16,9,7
21,22,72,17,22,-5
21,22,73,14,17,-3
21,22,74,16,21,-5
21,22,75,23,20,3
21,22,76,9,24,-15
21,22,77,16,16,0
21,22,78,15,14,1
21,22,79,13,18,-5
21,22,80,11,10,1
21,22,81,15,23,-8
21,22,82,10,6,4
21,22,83,14,22,-8
21,22,84,8,18,-10
21,22,85,16,12,4
21,22,86,21,17,4
21,22,87,16,22,-6
21,22,88,14,16,-2
21,22,89,11,12,-1
21,22,90,16,16,0
21,22,91,22,9,13
21,22,92,24,15,9
21,22,93,16,21,-5
21,22,94,24,14,10
21,22,95,9,12,-3
21,22,96,25,16,9
21,22,97,19,10,9
21,22,98,11,20,-9
21,22,99,20,18,2
21,22,100,8,9,-1
21,22,101,19,26,-7
21,22,102,14,9,5
21,22,103,18,23,-5
21,22,104,13,12,1
21,22,105,19,21,-2
21,22,106,5,5,0
21,22,107,17,10,7
21,22,108,22,27,-5
21,22,109,11,19,-8
21,22,110,22,17,5
21,22,111,16,7,9
21,22,112,5,16,-11
21,22,113,10,12,-2
21,22,114,23,7,16
21,22,115,10,9,1
21,22,116,18,17,1
21,22,117,6,16,-10
21,22,118,14,7,7
21,22,119,19,18,1
21,22,120,11,21,-10
21,22,121,22,22,0
21,22,122,13,8,5
21,22,123,14,7,7
21,22,124,10,17,-7
21,22,125,10,18,-8
21,22,126,13,12,1
21,22,127,36,24,12
21,22,128,10,20,-10
21,22,129,18,18,0
21,22,130,20,15,5
21,22,131,8,14,-6
21,22,132,12,15,-3
21,22,133,9,19,-10
21,22,134,17,22,-5
21,22,135,18,10,8
21,22,136,17,16,1
21,22,137,16,28,-12
21,22,138,6,15,-9
21,22,139,22,29,-7
21,22,140,13,18,-5
21,22,141,20,10,10
21,22,142,3,6,-3
21,22,143,21,13,8
21,22,144,7,17,-10
21,22,145,28,15,13
21,22,146,17,11,6
21,22,147,19,14,5
21,22,148,15,15,0
21,22,149,18,15,3
21,22,150,16,13,3
21,22,151,13,10,3
21,22,152,12,8,4
21,22,153,14,10,4
21,22,154,6,13,-7
21,22,155,19,14,5
21,22,156,23,8,15
21,22,157,14,14,0
21,22,158,13,18,-5
21,22,159,12,8,4
21,22,160,9,28,-19
21,22,161,14,11,3
21,22,162,18,16,2
21,22,163,20,16,4
21,22,164,19,17,2
21,22,165,10,11,-1
21,22,166,13,22,-9
21,22,167,12,21,-9
21,22,168,7,21,-14
21,22,169,7,12,-5
21,22,170,16,12,4
21,22,171,12,13,-1
21,22,172,17,17,0
21,22,173,8,7,1
21,22,174,9,9,0
21,22,175,17,18,-1
21,22,176,13,26,-13
21,22,177,25,22,3
21,22,178,6,10,-4
21,22,179,14,13,1
21,22,180,8,14,-6
21,22,181,19,10,9
21,22,182,16,25,-9
21,22,183,6,11,-5
21,22,184,7,13,-6
21,22,185,6,10,-4
21,22,186,14,19,-5
21,22,187,17,13,4
21,22,188,8,14,-6
21,22,189,22,13,9
21,22,190,7,7,0
21,22,191,16,24,-8
21,22,192,14,19,-5
21,22,193,17,11,6
21,22,194,17,8,9
21,22,195,14,27,-13
21,22,196,17,22,-5
21,22,197,12,13,-1
21,22,198,16,16,0
21,22,199,7,11,-4
21,22,200,10,12,-2
21,22,201,11,4,7
21,22,202,15,20,-5
21,22,203,10,9,1
21,22,204,17,12,5
21,22,205,12,16,-4
21,22,206,8,4,4
21,22,207,20,16,4
21,22,208,17,20,-3
21,22,209,15,12,3
21,22,210,13,13,0
21,22,211,10,12,-2
21,22,212,18,9,9
21,22,213,13,11,2
21,22,214,23,15,8
21,22,215,24,20,4
21,22,216,18,21,-3
21,22,217,34,24,10
21,22,218,12,12,0
21,22,219,17,14,3
21,22,220,19,15,4
21,22,221,15,11,4
21,22,222,11,13,-2
21,22,223,15,14,1
21,22,224,17,15,2
21,22,225,14,12,2
21,22,226,13,5,8
21,22,227,19,13,6
21,22,228,11,12,-1
21,22,229,17,16,1
21,22,230,20,14,6
21,22,231,9,18,-9
21,22,232,19,10,9
21,22,233,7,16,-9
21,22,234,13,21,-8
21,22,235,4,11,-7
21,22,236,5,24,-19
21,22,237,20,21,-1
21,22,238,5,11,-6
21,22,239,4,15,-11
21,22,240,20,13,7
21,22,241,7,7,0
21,22,242,12,11,1
21,22,243,17,11,6
21,22,244,10,8,2
21,22,245,12,23,-11
21,22,246,15,33,-18
21,22,247,7,15,-8
21,22,248,24,15,9
21,22,249,13,11,2
21,22,250,8,10,-2
21,22,251,10,12,-2
21,22,252,5,5,0
21,22,253,20,18,2
21,22,254,6,20,-14
21,22,255,5,11,-6
21,22,256,8,19,-11
21,22,257,12,14,-2
21,22,258,23,11,12
21,22,259,6,25,-19
21,22,260,8,13,-5
21,22,261,9,29,-20
21,22,262,15,12,3
21,22,263,23,13,10
21,22,264,11,11,0
21,22,265,16,14,2
21,22,266,17,20,-3
21,22,267,25,23,2
21,22,268,12,23,-11
21,22,269,12,5,7
21,22,270,14,9,5
21,22,271,9,18,-9
21,22,272,9,12,-3
21,22,273,8,7,1
21,22,274,20,11,9
21,22,275,18,12,6
21,22,276,8,15,-7
21,22,277,18,12,6
21,22,278,31,18,13
21,22,279,20,9,11
21,22,280,9,22,-13
21,22,281,19,10,9
21,22,282,15,16,-1
21,22,283,17,16,1
21,22,284,22,9,13
21,22,285,12,14,-2
21,22,286,19,17,2
21,22,287,4,11,-7
21,22,288,6,18,-12
21,22,289,18,13,5
21,22,290,9,7,2
21,22,291,16,14,2
21,22,292,14,13,1
21,22,293,16,19,-3
21,22,294,20,18,2
21,22,295,10,11,-1
21,22,296,9,10,-1
21,22,297,13,12,1
21,22,298,19,16,3
21,22,299,11,13,-2
21,23,0,4,5,-1
21,23,1,22,36,-14
21,23,2,17,13,4
21,23,3,6,11,-5
21,23,4,23,18,5
21,23,5,21,12,9
21,23,6,29,28,1
21,23,7,14,12,2
21,23,8,22,18,4
21,23,9,25,29,-4
21,23,10,11,18,-7
21,23,11,7,9,-2
21,23,12,13,18,-5
21,23,13,6,8,-2
21,23,14,15,10,5
21,23,15,13,15,-2
21,23,16,8,20,-12
21,23,17,17,14,3
21,23,18,9,10,-1
21,23,19,13,17,-4
21,23,20,21,16,5
21,23,21,8,15,-7
21,23,22,16,13,3
21,23,23,13,10,3
21,23,24,19,21,-2
21,23,25,14,12,2
21,23,26,11,25,-14
21,23,27,9,13,-4
21,23,28,11,5,6
21,23,29,5,15,-10
21,23,30,12,13,-1
21,23,31,19,12,7
21,23,32,15,10,5
21,23,33,9,10,-1
21,23,34,14,11,3
21,23,35,21,12,9
21,23,36,26,25,1
21,23,37,24,8,16
21,23,38,15,8,7
21,23,39,17,16,1
21,23,40,8,7,1
21,23,41,15,9,6
21,23,42,22,9,13
21,23,43,18,13,5
21,23,44,23,15,8
21,23,45,3,14,-11
21,23,46,5,25,-20
21,23,47,11,12,-1
21,23,48,6,18,-12
21,23,49,15,19,-4
21,23,50,19,6,13
21,23,51,15,19,-4
21,23,52,13,19,-6
21,23,53,18,17,1
21,23,54,21,19,2
21,23,55,18,13,5
21,23,56,15,12,3
21,23,57,8,14,-6
21,23,58,13,14,-1
21,23,59,8,11,-3
21,23,60,6,11,-5
21,23,61,14,14,0
21,23,62,22,22,0
21,23,63,29,13,16
21,23,64,10,11,-1
21,23,65,21,13,8
21,23,66,10,18,-8
21,23,67,12,7,5
21,23,68,13,15,-2
21,23,69,13,10,3
21,23,70,23,21,2
21,23,71,21,21,0
21,23,72,18,22,-4
21,23,73,25,32,-7
21,23,74,2,14,-12
21,23,75,13,25,-12
21,23,76,12,10,2
21,23,77,20,16,4
21,23,78,10,22,-12
21,23,79,22,17,5
21,23,80,8,11,-3
21,23,81,12,12,0
21,23,82,16,21,-5
21,23,83,14,14,0
21,23,84,18,20,-2
21,23,85,26,17,9
21,23,86,11,14,-3
21,23,87,11,7,4
21,23,88,9,17,-8
21,23,89,9,6,3
21,23,90,7,26,-19
21,23,91,12,4,8
21,23,92,9,8,1
21,23,93,20,23,-3
21,23,94,14,13,1
21,23,95,12,7,5
21,23,96,18,20,-2
21,23,97,9,2,7
21,23,98,7,9,-2
21,23,99,30,18,12
21,23,100,19,11,8
21,23,101,17,24,-7
21,23,102,13,20,-7
21,23,103,7,14,-7
21,23,104,4,8,-4
21,23,105,20,17,3
21,23,106,17,10,7
21,23,107,18,19,-1
21,23,108,7,18,-11
21,23,109,21,12,9
21,23,110,16,23,-7
21,23,111,16,15,1
21,23,112,6,12,-6
21,23,113,12,16,-4
21,23,114,11,5,6
21,23,115,7,19,-12
21,23,116,19,26,-7
21,23,117,12,9,3
21,23,118,4,14,-10
21,23,119,13,16,-3
21,23,120,23,16,7
21,23,121,11,8,3
21,23,122,14,12,2
21,23,123,21,23,-2
21,23,124,14,17,-3
21,23,125,9,16,-7
21,23,126,18,22,-4
21,23,127,9,8,1
21,23,128,19,9,10
21,23,129,8,10,-2
21,23,130,9,11,-2
21,23,131,15,25,-10
21,23,132,15,23,-8
21,23,133,16,19,-3
21,23,134,11,10,1
21,23,135,17,17,0
21,23,136,11,8,3
21,23,137,18,24,-6
21,23,138,16,25,-9
21,23,139,26,13,13
21,23,140,22,10,12
21,23,141,9,17,-8
21,23,142,25,18,7
21,23,143,24,11,13
21,23,144,8,17,-9
21,23,145,10,10,0
21,23,146,20,21,-1
21,23,147,20,11,9
21,23,148,19,7,12
21,23,149,25,11,14
21,23,150,23,25,-2
21,23,151,17,15,2
21,23,152,17,18,-1
21,23,153,10,10,0
21,23,154,11,13,-2
21,23,155,18,12,6
21,23,156,6,7,-1
21,23,157,16,10,6
21,23,158,12,17,-5
21,23,159,10,10,0
21,23,160,13,8,5
21,23,161,18,26,-8
21,23,162,5,6,-1
21,23,163,16,15,1
21,23,164,14,12,2
21,23,165,18,13,5
21,23,166,20,13,7
21,23,167,13,20,-7
21,23,168,11,19,-8
21,23,169,8,7,1
21,23,170,11,9,2
21,23,171,26,13,13
21,23,172,9,14,-5
21,23,173,24,20,4
21,23,174,17,13,4
21,23,175,10,14,-4
21,23,176,17,12,5
21,23,177,6,10,-4
21,23,178,6,4,2
21,23,179,14,14,0
21,23,180,22,16,6
21,23,181,19,10,9
21,23,182,20,17,3
21,23,183,15,10,5
21,23,184,13,14,-1
21,23,185,18,11,7
21,23,186,25,24,1
21,23,187,26,33,-7
21,23,188,12,10,2
21,23,189,25,23,2
21,23,190,20,21,-1
21,23,191,24,27,-3
21,23,192,20,13,7
21,23,193,12,13,-1
21,23,194,14,22,-8
21,23,195,6,12,-6
21,23,196,13,11,2
21,23,197,11,11,0
21,23,198,19,9,10
21,23,199,16,18,-2
21,23,200,14,9,5
21,23,201,17,20,-3
21,23,202,14,12,2
21,23,203,12,15,-3
21,23,204,19,18,1
21,23,205,14,22,-8
21,23,206,7,11,-4
21,23,207,9,16,-7
21,23,208,30,29,1
21,23,209,19,8,11
21,23,210,9,14,-5
21,23,211,18,14,4
21,23,212,23,14,9
21,23,213,19,24,-5
21,23,214,12,11,1
21,23,215,2,16,-14
21,23,216,7,5,2
21,23,217,16,15,1
21,23,218,8,15,-7
21,23,219,21,16,5
21,23,220,30,20,10
21,23,221,15,10,5
21,23,222,15,19,-4
21,23,223,17,13,4
21,23,224,29,20,9
21,23,225,12,11,1
21,23,226,20,28,-8
21,23,227,7,10,-3
21,23,228,19,22,-3
21,23,229,5,6,-1
21,23,230,14,19,-5
21,23,231,20,14,6
21,23,232,11,9,2
21,23,233,12,17,-5
21,23,234,6,16,-10
21,23,235,10,14,-4
21,23,236,3,6,-3
21,23,237,12,14,-2
21,23,238,18,7,11
21,23,239,19,16,3
21,23,240,8,18,-10
21,23,241,15,4,11
21,23,242,17,7,10
21,23,243,16,11,5
21,23,244,24,23,1
21,23,245,27,19,8
21,23,246,13,18,-5
21,23,247,15,11,4
21,23,248,14,8,6
21,23,249,12,12,0
21,23,250,15,11,4
21,23,251,6,18,-12
21,23,252,12,16,-4
21,23,253,11,10,1
21,23,254,14,12,2
21,23,255,11,14,-3
21,23,256,12,7,5
21,23,257,21,17,4
21,23,258,8,19,-11
21,23,259,19,12,7
21,23,260,16,14,2
21,23,261,17,20,-3
21,23,262,16,12,4
21,23,263,19,17,2
21,23,264,21,10,11
21,23,265,23,13,10
21,23,266,19,25,-6
21,23,267,10,7,3
21,23,268,16,28,-12
21,23,269,9,12,-3
21,23,270,9,17,-8
21,23,271,16,16,0
21,23,272,13,8,5
21,23,273,14,13,1
21,23,274,17,6,11
21,23,275,16,16,0
21,23,276,16,17,-1
21,23,277,12,11,1
21,23,278,20,16,4
21,23,279,20,15,5
21,23,280,15,20,-5
21,23,281,23,25,-2
21,23,282,14,3,11
21,23,283,12,12,0
21,23,284,24,26,-2
21,23,285,14,11,3
21,23,286,15,11,4
21,23,287,10,9,1
21,23,288,10,10,0
21,23,289,11,21,-10
21,23,290,19,19,0
21,23,291,10,6,4
21,23,292,10,11,-1
21,23,293,11,20,-9
21,23,294,8,5,3
21,23,295,6,3,3
21,23,296,9,5,4
21,23,297,15,14,1
21,23,298,14,8,6
21,23,299,9,11,-2
21,24,0,5,17,-12
21,24,1,11,18,-7
21,24,2,11,13,-2
21,24,3,8,16,-8
21,24,4,8,7,1
21,24,5,15,26,-11
21,24,6,6,6,0
21,24,7,20,17,3
21,24,8,12,10,2
21,24,9,9,12,-3
21,24,10,7,3,4
21,24,11,14,17,-3
21,24,12,9,4,5
21,24,13,10,6,4
21,24,14,10,16,-6
21,24,15,26,15,11
21,24,16,14,19,-5
21,24,17,12,13,-1
21,24,18,6,7,-1
21,24,19,8,19,-11
21,24,20,8,16,-8
21,24,21,10,13,-3
21,24,22,24,10,14
21,24,23,11,12,-1
21,24,24,13,20,-7
21,24,25,8,15,-7
21,24,26,19,12,7
21,24,27,14,8,6
21,24,28,11,14,-3
21,24,29,17,13,4
21,24,30,15,12,3
21,24,31,9,7,2
21,24,32,12,19,-7
21,24,33,11,8,3
21,24,34,10,10,0
21,24,35,22,16,6
21,24,36,9,13,-4
21,24,37,13,11,2
21,24,38,9,14,-5
21,24,39,3,19,-16
21,24,40,15,16,-1
21,24,41,21,19,2
21,24,42,22,22,0
21,24,43,10,6,4
21,24,44,11,12,-1
21,24,45,9,12,-3
21,24,46,13,5,8
21,24,47,21,18,3
21,24,48,6,15,-9
21,24,49,13,17,-4
21,24,50,19,18,1
21,24,51,24,22,2
21,24,52,7,13,-6
21,24,53,28,15,13
21,24,54,11,11,0
21,24,55,14,7,7
21,24,56,16,25,-9
21,24,57,16,9,7
21,24,58,6,7,-1
21,24,59,9,8,1
21,24,60,15,28,-13
21,24,61,16,15,1
21,24,62,19,10,9
21,24,63,9,8,1
21,24,64,21,23,-2
21,24,65,20,17,3
21,24,66,7,8,-1
21,24,67,5,6,-1
21,24,68,20,20,0
21,24,69,16,8,8
21,24,70,10,9,1
21,24,71,16,16,0
21,24,72,12,20,-8
21,24,73,14,18,-4
21,24,74,16,24,-8
21,24,75,23,20,3
21,24,76,9,18,-9
21,24,77,22,12,10
21,24,78,11,15,-4
21,24,79,22,10,12
21,24,80,12,13,-1
21,24,81,15,18,-3
21,24,82,14,16,-2
21,24,83,15,27,-12
21,24,84,14,16,-2
21,24,85,12,17,-5
21,24,86,11,14,-3
21,24,87,7,13,-6
21,24,88,21,21,0
21,24,89,21,23,-2
21,24,90,11,5,6
21,24,91,21,12,9
21,24,92,18,10,8
21,24,93,23,20,3
21,24,94,15,6,9
21,24,95,12,14,-2
21,24,96,24,28,-4
21,24,97,20,13,7
21,24,98,7,13,-6
21,24,99,17,28,-11
21,24,100,13,15,-2
21,24,101,13,19,-6
21,24,102,14,2,12
21,24,103,19,10,9
21,24,104,13,20,-7
21,24,105,9,10,-1
21,24,106,21,20,1
21,24,107,17,13,4
21,24,108,22,15,7
21,24,109,12,14,-2
21,24,110,7,23,-16
21,24,111,18,25,-7
21,24,112,14,18,-4
21,24,113,22,18,4
21,24,114,10,12,-2
21,24,115,11,10,1
21,24,116,12,15,-3
21,24,117,10,11,-1
21,24,118,13,16,-3
21,24,119,9,21,-12
21,24,120,20,20,0
21,24,121,13,15,-2
21,24,122,2,5,-3
21,24,123,15,7,8
21,24,124,22,15,7
21,24,125,22,14,8
21,24,126,6,7,-1
21,24,127,14,18,-4
21,24,128,23,11,12
21,24,129,21,13,8
21,24,130,12,14,-2
21,24,131,17,15,2
21,24,132,8,14,-6
21,24,133,13,11,2
21,24,134,18,22,-4
21,24,135,21,7,14
21,24,136,19,30,-11
21,24,137,10,10,0
21,24,138,19,30,-11
21,24,139,9,23,-14
21,24,140,9,13,-4
21,24,141,19,24,-5
21,24,142,12,25,-13
21,24,143,8,12,-4
21,24,144,15,6,9
21,24,145,11,27,-16
21,24,146,16,13,3
21,24,147,11,9,2
21,24,148,14,20,-6
21,24,149,18,12,6
21,24,150,11,17,-6
21,24,151,14,9,5
21,24,152,19,12,7
21,24,153,14,7,7
21,24,154,22,16,6
21,24,155,11,24,-13
21,24,156,21,16,5
21,24,157,17,10,7
21,24,158,11,18,-7
21,24,159,10,18,-8
21,24,160,5,10,-5
21,24,161,13,25,-12
21,24,162,16,18,-2
21,24,163,11,17,-6
21,24,164,12,15,-3
21,24,165,14,15,-1
21,24,166,23,20,3
21,24,167,7,14,-7
21,24,168,29,16,13
21,24,169,2,10,-8
21,24,170,8,4,4
21,24,171,16,23,-7
21,24,172,8,4,4
21,24,173,12,16,-4
21,24,174,12,4,8
21,24,175,17,11,6
21,24,176,16,26,-10
21,24,177,22,21,1
21,24,178,4,5,-1
21,24,179,22,11,11
21,24,180,11,15,-4
21,24,181,15,19,-4
21,24,182,15,11,4
21,24,183,20,14,6
21,24,184,19,19,0
21,24,185,23,19,4
21,24,186,7,5,2
21,24,187,25,8,17
21,24,188,32,20,12
21,24,189,24,13,11
21,24,190,8,21,-13
21,24,191,17,14,3
21,24,192,19,12,7
21,24,193,10,11,-1
21,24,194,8,17,-9
21,24,195,18,20,-2
21,24,196,26,19,7
21,24,197,11,14,-3
21,24,198,15,17,-2
21,24,199,14,21,-7
21,24,200,20,9,11
21,24,201,12,11,1
21,24,202,14,4,10
21,24,203,16,13,3
21,24,204,11,13,-2
21,24,205,8,11,-3
21,24,206,6,5,1
21,24,207,21,19,2
21,24,208,22,15,7
21,24,209,14,18,-4
21,24,210,5,10,-5
21,24,211,16,10,6
21,24,212,18,23,-5
21,24,213,5,5,0
21,24,214,18,11,7
21,24,215,20,9,11
21,24,216,14,21,-7
21,24,217,15,7,8
21,24,218,15,7,8
21,24,219,11,12,-1
21,24,220,13,17,-4
21,24,221,7,6,1
21,24,222,20,23,-3
21,24,223,24,10,14
21,24,224,16,8,8
21,24,225,19,15,4
21,24,226,17,12,5
21,24,227,7,4,3
21,24,228,12,14,-2
21,24,229,17,29,-12
21,24,230,20,15,5
21,24,231,16,20,-4
21,24,232,18,10,8
21,24,233,15,15,0
21,24,234,14,16,-2
21,24,235,16,10,6
21,24,236,11,13,-2
21,24,237,14,14,0
21,24,238,9,8,1
21,24,239,3,2,1
21,24,240,18,11,7
21,24,241,13,21,-8
21,24,242,17,21,-4
21,24,243,6,9,-3
21,24,244,15,10,5
21,24,245,18,16,2
21,24,246,12,18,-6
21,24,247,13,15,-2
21,24,248,17,21,-4
21,24,249,13,16,-3
21,24,250,9,18,-9
21,24,251,16,12,4
21,24,252,9,11,-2
21,24,253,9,16,-7
21,24,254,19,7,12
21,24,255,18,17,1
21,24,256,15,17,-2
21,24,257,11,13,-2
21,24,258,18,18,0
21,24,259,20,21,-1
21,24,260,13,10,3
21,24,261,12,15,-3
21,24,262,12,22,-10
21,24,263,14,12,2
21,24,264,20,27,-7
21,24,265,14,22,-8
21,24,266,15,14,1
21,24,267,19,23,-4
21,24,268,13,10,3
21,24,269,13,19,-6
21,24,270,8,15,-7
21,24,271,12,9,3
21,24,272,21,11,10
21,24,273,15,14,1
21,24,274,9,12,-3
21,24,275,12,16,-4
21,24,276,24,16,8
21,24,277,10,11,-1
21,24,278,8,20,-12
21,24,279,12,19,-7
21,24,280,6,9,-3
21,24,281,14,17,-3
21,24,282,14,19,-5
21,24,283,25,27,-2
21,24,284,19,14,5
21,24,285,14,8,6
21,24,286,16,22,-6
21,24,287,14,26,-12
21,24,288,10,14,-4
21,24,289,16,5,11
21,24,290,6,13,-7
21,24,291,18,9,9
21,24,292,14,19,-5
21,24,293,15,15,0
21,24,294,16,13,3
21,24,295,10,4,6
21,24,296,22,11,11
21,24,297,20,14,6
21,24,298,3,20,-17
21,24,299,15,10,5
21,25,0,9,12,-3
21,25,1,29,19,10
21,25,2,10,21,-11
21,25,3,29,13,16
21,25,4,10,11,-1
21,25,5,14,21,-7
21,25,6,23,15,8
21,25,7,3,14,-11
21,25,8,15,19,-4
21,25,9,13,17,-4
21,25,10,19,20,-1
21,25,11,10,8,2
21,25,12,9,16,-7
21,25,13,16,17,-1
21,25,14,13,9,4
21,25,15,7,7,0
21,25,16,12,13,-1
21,25,17,8,15,-7
21,25,18,9,19,-10
21,25,19,13,28,-15
21,25,20,4,9,-5
21,25,21,10,9,1
21,25,22,17,19,-2
21,25,23,13,12,1
21,25,24,5,12,-7
21,25,25,8,11,-3
21,25,26,9,10,-1
21,25,27,16,22,-6
21,25,28,9,18,-9
21,25,29,14,14,0
21,25,30,10,10,0
21,25,31,17,13,4
21,25,32,25,26,-1
21,25,33,15,5,10
21,25,34,8,15,-7
21,25,35,13,25,-12
21,25,36,13,14,-1
21,25,37,21,12,9
21,25,38,17,22,-5
21,25,39,8,3,5
21,25,40,13,9,4
21,25,41,13,13,0
21,25,42,23,31,-8
21,25,43,6,10,-4
21,25,44,27,12,15
21,25,45,15,7,8
21,25,46,8,8,0
21,25,47,27,17,10
21,25,48,18,15,3
21,25,49,17,23,-6
21,25,50,13,13,0
21,25,51,12,12,0
21,25,52,14,4,10
21,25,53,11,7,4
21,25,54,11,19,-8
21,25,55,11,7,4
21,25,56,20,16,4
21,25,57,13,7,6
21,25,58,17,12,5
21,25,59,16,16,0
21,25,60,16,16,0
21,25,61,21,13,8
21,25,62,8,13,-5
21,25,63,14,10,4
21,25,64,8,10,-2
21,25,65,15,19,-4
21,25,66,15,9,6
21,25,67,16,22,-6
21,25,68,15,23,-8
21,25,69,19,9,10
21,25,70,19,16,3
21,25,71,12,17,-5
21,25,72,14,21,-7
21,25,73,12,18,-6
21,25,74,16,19,-3
21,25,75,12,15,-3
21,25,76,24,21,3
21,25,77,19,14,5
21,25,78,14,18,-4
21,25,79,21,12,9
21,25,80,5,7,-2
21,25,81,18,17,1
21,25,82,9,27,-18
21,25,83,13,16,-3
21,25,84,15,8,7
21,25,85,15,8,7
21,25,86,13,12,1
21,25,87,9,14,-5
21,25,88,9,9,0
21,25,89,18,12,6
21,25,90,9,8,1
21,25,91,24,17,7
21,25,92,24,16,8
21,25,93,21,6,15
21,25,94,13,17,-4
21,25,95,10,4,6
21,25,96,15,24,-9
21,25,97,20,10,10
21,25,98,11,11,0
21,25,99,24,22,2
21,25,100,17,14,3
21,25,101,19,8,11
21,25,102,12,11,1
21,25,103,21,19,2
21,25,104,12,13,-1
21,25,105,17,10,7
21,25,106,13,14,-1
21,25,107,23,13,10
21,25,108,16,14,2
21,25,109,26,14,12
21,25,110,9,20,-11
21,25,111,12,16,-4
21,25,112,18,9,9
21,25,113,20,17,3
21,25,114,19,11,8
21,25,115,6,8,-2
21,25,116,26,10,16
21,25,117,20,24,-4
21,25,118,14,19,-5
21,25,119,4,13,-9
21,25,120,9,10,-1
21,25,121,18,9,9
21,25,122,5,10,-5
21,25,123,12,8,4
21,25,124,14,15,-1
21,25,125,19,7,12
21,25,126,16,14,2
21,25,127,17,15,2
21,25,128,16,5,11
21,25,129,20,16,4
21,25,130,15,12,3
21,25,131,17,17,0
21,25,132,11,11,0
21,25,133,7,19,-12
21,25,134,21,17,4
21,25,135,20,12,8
21,25,136,19,19,0
21,25,137,11,2,9
21,25,138,17,18,-1
21,25,139,6,12,-6
21,25,140,11,18,-7
21,25,141,14,11,3
21,25,142,19,13,6
21,25,143,24,20,4
21,25,144,14,30,-16
21,25,145,23,14,9
21,25,146,20,13,7
21,25,147,16,12,4
21,25,148,15,5,10
21,25,149,5,14,-9
21,25,150,9,10,-1
21,25,151,19,5,14
21,25,152,15,29,-14
21,25,153,25,18,7
21,25,154,8,20,-12
21,25,155,5,6,-1
21,25,156,21,15,6
21,25,157,9,8,1
21,25,158,12,7,5
21,25,159,14,19,-5
21,25,160,22,17,5
21,25,161,19,15,4
21,25,162,4,14,-10
21,25,163,13,12,1
21,25,164,21,21,0
21,25,165,26,7,19
21,25,166,5,7,-2
21,25,167,11,7,4
21,25,168,11,6,5
21,25,169,12,13,-1
21,25,170,14,22,-8
21,25,171,14,11,3
21,25,172,10,11,-1
21,25,173,29,28,1
21,25,174,20,10,10
21,25,175,4,7,-3
21,25,176,8,8,0
21,25,177,18,19,-1
21,25,178,14,19,-5
21,25,179,7,4,3
21,25,180,18,20,-2
21,25,181,14,28,-14
21,25,182,15,15,0
21,25,183,20,13,7
21,25,184,21,16,5
21,25,185,12,19,-7
21,25,186,11,23,-12
21,25,187,10,7,3
21,25,188,19,12,7
21,25,189,13,8,5
21,25,190,11,14,-3
21,25,191,8,5,3
21,25,192,6,7,-1
21,25,193,25,15,10
21,25,194,30,34,-4
21,25,195,24,22,2
21,25,196,22,15,7
21,25,197,27,12,15
21,25,198,17,13,4
21,25,199,32,14,18
21,25,200,8,7,1
21,25,201,24,20,4
21,25,202,12,8,4
21,25,203,9,14,-5
21,25,204,15,22,-7
21,25,205,16,21,-5
21,25,206,22,17,5
21,25,207,18,8,10
21,25,208,21,17,4
21,25,209,5,15,-10
21,25,210,7,5,2
21,25,211,8,12,-4
21,25,212,13,15,-2
21,25,213,15,17,-2
21,25,214,14,12,2
21,25,215,11,23,-12
21,25,216,12,14,-2
21,25,217,17,17,0
21,25,218,14,16,-2
21,25,219,16,14,2
21,25,220,18,14,4
21,25,221,8,8,0
21,25,222,9,7,2
21,25,223,17,16,1
21,25,224,19,11,8
21,25,225,15,13,2
21,25,226,10,11,-1
21,25,227,29,21,8
21,25,228,8,9,-1
21,25,229,15,9,6
21,25,230,23,13,10
21,25,231,11,18,-7
21,25,232,18,5,13
21,25,233,21,5,16
21,25,234,10,7,3
21,25,235,7,18,-11
21,25,236,13,20,-7
21,25,237,15,13,2
21,25,238,12,17,-5
21,25,239,16,10,6
21,25,240,18,9,9
21,25,241,21,14,7
21,25,242,4,21,-17
21,25,243,18,16,2
21,25,244,24,15,9
21,25,245,27,21,6
21,25,246,18,11,7
21,25,247,12,15,-3
21,25,248,15,7,8
21,25,249,14,14,0
21,25,250,4,13,-9
21,25,251,8,9,-1
21,25,252,24,16,8
21,25,253,17,16,1
21,25,254,15,9,6
21,25,255,9,10,-1
21,25,256,11,13,-2
21,25,257,11,10,1
21,25,258,25,16,9
21,25,259,24,13,11
21,25,260,7,5,2
21,25,261,10,13,-3
21,25,262,11,12,-1
21,25,263,15,12,3
21,25,264,17,30,-13
21,25,265,8,10,-2
21,25,266,7,4,3
21,25,267,12,9,3
21,25,268,15,18,-3
21,25,269,9,14,-5
21,25,270,17,12,5
21,25,271,16,17,-1
21,25,272,16,11,5
21,25,273,11,15,-4
21,25,274,8,6,2
21,25,275,11,13,-2
21,25,276,16,11,5
21,25,277,18,8,10
21,25,278,7,8,-1
21,25,279,28,18,10
21,25,280,21,14,7
21,25,281,15,15,0
21,25,282,12,11,1
21,25,283,20,13,7
21,25,284,23,19,4
21,25,285,11,18,-7
21,25,286,12,10,2
21,25,287,14,12,2
21,25,288,17,16,1
21,25,289,16,17,-1
21,25,290,21,27,-6
21,25,291,8,11,-3
21,25,292,5,11,-6
21,25,293,12,15,-3
21,25,294,19,11,8
21,25,295,17,10,7
21,25,296,13,5,8
21,25,297,10,15,-5
21,25,298,7,13,-6
21,25,299,3,14,-11
21,26,0,13,10,3
21,26,1,14,10,4
21,26,2,14,15,-1
21,26,3,5,12,-7
21,26,4,13,16,-3
21,26,5,15,11,4
21,26,6,23,28,-5
21,26,7,20,10,10
21,26,8,12,6,6
21,26,9,13,7,6
21,26,10,19,12,7
21,26,11,15,6,9
21,26,12,10,0,10
21,26,13,4,14,-10
21,26,14,16,7,9
21,26,15,19,11,8
21,26,16,20,9,11
21,26,17,17,14,3
21,26,18,19,11,8
21,26,19,11,10,1
21,26,20,25,12,13
21,26,21,24,27,-3
21,26,22,19,23,-4
21,26,23,6,11,-5
21,26,24,16,23,-7
21,26,25,14,9,5
21,26,26,9,10,-1
21,26,27,30,16,14
21,26,28,10,17,-7
21,26,29,28,27,1
21,26,30,16,5,11
21,26,31,7,10,-3
21,26,32,21,32,-11
21,26,33,24,13,11
21,26,34,10,10,0
21,26,35,18,8,10
21,26,36,16,8,8
21,26,37,16,16,0
21,26,38,13,12,1
21,26,39,30,20,10
21,26,40,6,3,3
21,26,41,11,15,-4
21,26,42,21,18,3
21,26,43,23,15,8
21,26,44,12,16,-4
21,26,45,14,4,10
21,26,46,11,8,3
21,26,47,20,9,11
21,26,48,10,13,-3
21,26,49,11,7,4
21,26,50,19,7,12
21,26,51,14,24,-10
21,26,52,3,5,-2
21,26,53,25,17,8
21,26,54,11,20,-9
21,26,55,25,5,20
21,26,56,11,19,-8
21,26,57,17,11,6
21,26,58,17,18,-1
21,26,59,9,11,-2
21,26,60,21,19,2
21,26,61,10,2,8
21,26,62,28,20,8
21,26,63,19,16,3
21,26,64,4,13,-9
21,26,65,13,17,-4
21,26,66,8,13,-5
21,26,67,17,9,8
21,26,68,18,21,-3
21,26,69,16,18,-2
21,26,70,9,12,-3
21,26,71,12,14,-2
21,26,72,14,7,7
21,26,73,8,10,-2
21,26,74,4,6,-2
21,26,75,9,14,-5
21,26,76,8,6,2
21,26,77,7,5,2
21,26,78,11,15,-4
21,26,79,18,16,2
21,26,80,14,10,4
21,26,81,18,21,-3
21,26,82,10,18,-8
21,26,83,9,10,-1
21,26,84,25,18,7
21,26,85,18,10,8
21,26,86,18,10,8
21,26,87,8,17,-9
21,26,88,8,9,-1
21,26,89,22,10,12
21,26,90,21,23,-2
21,26,91,20,18,2
21,26,92,17,13,4
21,26,93,5,18,-13
21,26,94,14,11,3
21,26,95,12,8,4
21,26,96,19,17,2
21,26,97,14,14,0
21,26,98,5,7,-2
21,26,99,9,24,-15
21,26,100,25,18,7
21,26,101,16,15,1
21,26,102,9,2,7
21,26,103,23,17,6
21,26,104,15,19,-4
21,26,105,20,4,16
21,26,106,6,10,-4
21,26,107,14,17,-3
21,26,108,25,18,7
21,26,109,14,10,4
21,26,110,13,14,-1
21,26,111,17,13,4
21,26,112,2,1,1
21,26,113,10,24,-14
21,26,114,6,8,-2
21,26,115,12,7,5
21,26,116,9,15,-6
21,26,117,5,2,3
21,26,118,5,4,1
21,26,119,10,16,-6
21,26,120,23,1,22
21,26,121,17,14,3
21,26,122,17,9,8
21,26,123,17,14,3
21,26,124,9,22,-13
21,26,125,16,17,-1
21,26,126,8,12,-4
21,26,127,14,14,0
21,26,128,4,12,-8
21,26,129,11,26,-15
21,26,130,11,9,2
21,26,131,16,10,6
21,26,132,14,19,-5
21,26,133,15,8,7
21,26,134,9,18,-9
21,26,135,21,16,5
21,26,136,25,12,13
21,26,137,19,10,9
21,26,138,22,14,8
21,26,139,12,25,-13
21,26,140,11,10,1
21,26,141,18,10,8
21,26,142,13,11,2
21,26,143,18,16,2
21,26,144,16,11,5
21,26,145,16,17,-1
21,26,146,21,16,5
21,26,147,17,6,11
21,26,148,10,13,-3
21,26,149,24,14,10
21,26,150,15,12,3
21,26,151,21,15,6
21,26,152,20,3,17
21,26,153,12,10,2
21,26,154,12,8,4
21,26,155,20,18,2
21,26,156,12,15,-3
21,26,157,7,14,-7
21,26,158,11,13,-2
21,26,159,13,15,-2
21,26,160,8,9,-1
21,26,161,21,24,-3
21,26,162,21,16,5
21,26,163,6,11,-5
21,26,164,10,7,3
21,26,165,14,8,6
21,26,166,12,12,0
21,26,167,9,18,-9
21,26,168,15,5,10
21,26,169,20,15,5
21,26,170,14,11,3
21,26,171,13,13,0
21,26,172,19,17,2
21,26,173,17,22,-5
21,26,174,12,15,-3
21,26,175,14,26,-12
21,26,176,14,13,1
21,26,177,15,26,-11
21,26,178,9,19,-10
21,26,179,12,13,-1
21,26,180,8,12,-4
21,26,181,15,20,-5
21,26,182,10,21,-11
21,26,183,14,9,5
21,26,184,21,5,16
21,26,185,24,13,11
21,26,186,12,6,6
21,26,187,16,12,4
21,26,188,13,8,5
21,26,189,12,26,-14
21,26,190,17,23,-6
21,26,191,10,7,3
21,26,192,7,20,-13
21,26,193,22,14,8
21,26,194,22,14,8
21,26,195,16,9,7
21,26,196,18,6,12
21,26,197,12,14,-2
21,26,198,12,9,3
21,26,199,15,4,11
21,26,200,13,16,-3
21,26,201,11,9,2
21,26,202,24,21,3
21,26,203,12,20,-8
21,26,204,15,15,0
21,26,205,8,10,-2
21,26,206,13,11,2
21,26,207,8,11,-3
21,26,208,13,16,-3
21,26,209,21,19,2
21,26,210,21,12,9
21,26,211,16,18,-2
21,26,212,19,15,4
21,26,213,13,7,6
21,26,214,16,5,11
21,26,215,5,8,-3
21,26,216,28,17,11
21,26,217,14,15,-1
21,26,218,15,14,1
21,26,219,26,21,5
21,26,220,13,15,-2
21,26,221,17,13,4
21,26,222,14,14,0
21,26,223,16,11,5
21,26,224,9,8,1
21,26,225,19,8,11
21,26,226,17,14,3
21,26,227,14,15,-1
21,26,228,13,17,-4
21,26,229,18,13,5
21,26,230,12,15,-3
21,26,231,9,5,4
21,26,232,21,12,9
21,26,233,22,9,13
21,26,234,29,21,8
21,26,235,17,4,13
21,26,236,11,19,-8
21,26,237,7,13,-6
21,26,238,11,12,-1
21,26,239,6,13,-7
21,26,240,16,15,1
21,26,241,23,18,5
21,26,242,28,21,7
21,26,243,8,3,5
21,26,244,16,19,-3
21,26,245,10,14,-4
21,26,246,16,17,-1
21,26,247,19,12,7
21,26,248,9,11,-2
21,26,249,18,18,0
21,26,250,8,6,2
21,26,251,12,8,4
21,26,252,13,7,6
21,26,253,14,12,2
21,26,254,15,13,2
21,26,255,17,15,2
21,26,256,17,14,3
21,26,257,6,11,-5
21,26,258,11,6,5
21,26,259,20,11,9
21,26,260,13,24,-11
21,26,261,17,19,-2
21,26,262,19,15,4
21,26,263,10,15,-5
21,26,264,30,16,14
21,26,265,17,8,9
21,26,266,11,13,-2
21,26,267,22,17,5
21,26,268,14,8,6
21,26,269,7,7,0
21,26,270,20,22,-2
21,26,271,17,17,0
21,26,272,15,16,-1
21,26,273,15,19,-4
21,26,274,21,14,7
21,26,275,8,14,-6
21,26,276,11,8,3
21,26,277,16,16,0
21,26,278,18,13,5
21,26,279,11,11,0
21,26,280,17,6,11
21,26,281,15,16,-1
21,26,282,9,12,-3
21,26,283,14,9,5
21,26,284,14,18,-4
21,26,285,10,13,-3
21,26,286,3,10,-7
21,26,287,11,15,-4
21,26,288,22,22,0
21,26,289,7,10,-3
21,26,290,10,24,-14
21,26,291,29,15,14
21,26,292,15,11,4
21,26,293,20,20,0
21,26,294,15,6,9
21,26,295,22,11,11
21,26,296,10,4,6
21,26,297,11,9,2
21,26,298,10,9,1
21,26,299,22,7,15
21,27,0,15,17,-2
21,27,1,27,27,0
21,27,2,12,11,1
21,27,3,9,18,-9
21,27,4,20,8,12
21,27,5,12,12,0
21,27,6,12,17,-5
21,27,7,11,14,-3
21,27,8,20,3,17
21,27,9,14,13,1
21,27,10,12,17,-5
21,27,11,16,13,3
21,27,12,18,12,6
21,27,13,13,13,0
21,27,14,23,17,6
21,27,15,22,9,13
21,27,16,19,18,1
21,27,17,24,12,12
21,27,18,11,12,-1
21,27,19,13,5,8
21,27,20,6,6,0
21,27,21,14,12,2
21,27,22,18,22,-4
21,27,23,16,8,8
21,27,24,20,22,-2
21,27,25,21,19,2
21,27,26,16,12,4
21,27,27,24,16,8
21,27,28,15,19,-4
21,27,29,17,10,7
21,27,30,13,13,0
21,27,31,8,12,-4
21,27,32,18,20,-2
21,27,33,12,17,-5
21,27,34,16,19,-3
21,27,35,12,14,-2
21,27,36,18,13,5
21,27,37,8,12,-4
21,27,38,8,5,3
21,27,39,16,15,1
21,27,40,8,12,-4
21,27,41,23,22,1
21,27,42,10,6,4
21,27,43,23,15,8
21,27,44,21,13,8
21,27,45,19,5,14
21,27,46,6,5,1
21,27,47,15,15,0
21,27,48,9,9,0
21,27,49,18,14,4
21,27,50,17,23,-6
21,27,51,10,9,1
21,27,52,16,9,7
21,27,53,16,11,5
21,27,54,22,3,19
21,27,55,20,20,0
21,27,56,10,0,10
21,27,57,17,6,11
21,27,58,14,10,4
21,27,59,13,8,5
21,27,60,7,13,-6
21,27,61,11,10,1
21,27,62,15,13,2
21,27,63,13,10,3
21,27,64,21,14,7
21,27,65,11,14,-3
21,27,66,15,11,4
21,27,67,14,12,2
21,27,68,27,13,14
21,27,69,15,12,3
21,27,70,17,27,-10
21,27,71,10,9,1
21,27,72,18,20,-2
21,27,73,9,2,7
21,27,74,11,17,-6
21,27,75,21,10,11
21,27,76,7,15,-8
21,27,77,30,18,12
21,27,78,14,14,0
21,27,79,16,5,11
21,27,80,12,30,-18
21,27,81,11,9,2
21,27,82,19,13,6
21,27,83,25,14,11
21,27,84,18,8,10
21,27,85,12,24,-12
21,27,86,17,15,2
21,27,87,21,13,8
21,27,88,5,9,-4
21,27,89,14,13,1
21,27,90,22,22,0
21,27,91,22,6,16
21,27,92,14,11,3
21,27,93,21,12,9
21,27,94,9,14,-5
21,27,95,10,10,0
21,27,96,11,11,0
21,27,97,12,12,0
21,27,98,16,6,10
21,27,99,9,6,3
21,27,100,24,10,14
21,27,101,14,10,4
21,27,102,22,16,6
21,27,103,19,12,7
21,27,104,18,13,5
21,27,105,16,19,-3
21,27,106,19,15,4
21,27,107,19,11,8
21,27,108,16,28,-12
21,27,109,8,17,-9
21,27,110,15,14,1
21,27,111,16,12,4
21,27,112,11,14,-3
21,27,113,5,12,-7
21,27,114,19,20,-1
21,27,115,11,22,-11
21,27,116,13,9,4
21,27,117,22,22,0
21,27,118,13,15,-2
21,27,119,17,22,-5
21,27,120,16,12,4
21,27,121,11,17,-6
21,27,122,14,20,-6
21,27,123,12,12,0
21,27,124,18,15,3
21,27,125,19,8,11
21,27,126,12,7,5
21,27,127,23,10,13
21,27,128,24,21,3
21,27,129,8,9,-1
21,27,130,8,18,-10
21,27,131,15,12,3
21,27,132,19,12,7
21,27,133,9,6,3
21,27,134,12,10,2
21,27,135,14,12,2
21,27,136,14,14,0
21,27,137,19,19,0
21,27,138,18,17,1
21,27,139,13,11,2
21,27,140,22,27,-5
21,27,141,9,11,-2
21,27,142,19,21,-2
21,27,143,23,25,-2
21,27,144,6,7,-1
21,27,145,7,10,-3
21,27,146,17,18,-1
21,27,147,10,4,6
21,27,148,14,15,-1
21,27,149,22,10,12
21,27,150,20,11,9
21,27,151,15,20,-5
21,27,152,9,4,5
21,27,153,20,15,5
21,27,154,6,7,-1
21,27,155,19,25,-6
21,27,156,27,8,19
21,27,157,8,15,-7
21,27,158,3,13,-10
21,27,159,16,10,6
21,27,160,20,7,13
21,27,161,23,20,3
21,27,162,18,14,4
21,27,163,9,13,-4
21,27,164,15,17,-2
21,27,165,5,6,-1
21,27,166,15,11,4
21,27,167,12,12,0
21,27,168,19,7,12
21,27,169,20,19,1
21,27,170,14,6,8
21,27,171,4,0,4
21,27,172,9,11,-2
21,27,173,12,14,-2
21,27,174,16,21,-5
21,27,175,15,13,2
21,27,176,17,12,5
21,27,177,18,13,5
21,27,178,18,13,5
21,27,179,18,13,5
21,27,180,25,9,16
21,27,181,14,19,-5
21,27,182,13,7,6
21,27,183,24,13,11
21,27,184,19,9,10
21,27,185,18,12,6
21,27,186,19,14,5
21,27,187,8,17,-9
21,27,188,16,11,5
21,27,189,14,9,5
21,27,190,17,12,5
21,27,191,8,4,4
21,27,192,17,11,6
21,27,193,11,5,6
21,27,194,16,13,3
21,27,195,19,11,8
21,27,196,19,9,10
21,27,197,2,15,-13
21,27,198,6,11,-5
21,27,199,26,9,17
21,27,200,10,14,-4
21,27,201,14,7,7
21,27,202,12,16,-4
21,27,203,6,4,2
21,27,204,12,17,-5
21,27,205,9,5,4
21,27,206,9,7,2
21,27,207,16,12,4
21,27,208,19,15,4
21,27,209,15,13,2
21,27,210,21,10,11
21,27,211,18,16,2
21,27,212,12,22,-10
21,27,213,13,18,-5
21,27,214,26,20,6
21,27,215,9,3,6
21,27,216,7,12,-5
21,27,217,11,15,-4
21,27,218,12,18,-6
21,27,219,20,24,-4
21,27,220,14,13,1
21,27,221,11,8,3
21,27,222,9,4,5
21,27,223,6,18,-12
21,27,224,18,17,1
21,27,225,14,7,7
21,27,226,19,12,7
21,27,227,20,13,7
21,27,228,12,23,-11
21,27,229,11,13,-2
21,27,230,15,9,6
21,27,231,15,21,-6
21,27,232,20,9,11
21,27,233,7,7,0
21,27,234,30,13,17
21,27,235,13,11,2
21,27,236,16,2,14
21,27,237,18,18,0
21,27,238,18,14,4
21,27,239,13,9,4
21,27,240,12,21,-9
21,27,241,26,18,8
21,27,242,11,15,-4
21,27,243,14,9,5
21,27,244,8,9,-1
21,27,245,11,7,4
21,27,246,19,10,9
21,27,247,17,12,5
21,27,248,8,18,-10
21,27,249,13,18,-5
21,27,250,22,13,9
21,27,251,19,13,6
21,27,252,16,9,7
21,27,253,27,10,17
21,27,254,7,10,-3
21,27,255,31,14,17
21,27,256,12,18,-6
21,27,257,16,14,2
21,27,258,19,13,6
21,27,259,14,13,1
21,27,260,20,26,-6
21,27,261,6,11,-5
21,27,262,10,7,3
21,27,263,7,12,-5
21,27,264,23,16,7
21,27,265,14,12,2
21,27,266,13,8,5
21,27,267,18,21,-3
21,27,268,17,15,2
21,27,269,11,7,4
21,27,270,8,8,0
21,27,271,11,13,-2
21,27,272,25,16,9
21,27,273,18,19,-1
21,27,274,15,19,-4
21,27,275,14,18,-4
21,27,276,18,11,7
21,27,277,20,14,6
21,27,278,23,19,4
21,27,279,21,6,15
21,27,280,11,9,2
21,27,281,22,18,4
21,27,282,18,11,7
21,27,283,9,21,-12
21,27,284,16,21,-5
21,27,285,13,5,8
21,27,286,20,14,6
21,27,287,14,15,-1
21,27,288,15,22,-7
21,27,289,13,12,1
21,27,290,11,6,5
21,27,291,23,8,15
21,27,292,18,18,0
21,27,293,16,7,9
21,27,294,15,9,6
21,27,295,12,23,-11
21,27,296,23,10,13
21,27,297,15,19,-4
21,27,298,14,18,-4
21,27,299,18,15,3
21,28,0,15,9,6
21,28,1,22,8,14
21,28,2,6,9,-3
21,28,3,5,9,-4
21,28,4,11,8,3
21,28,5,17,2,15
21,28,6,18,14,4
21,28,7,14,11,3
21,28,8,31,10,21
21,28,9,18,11,7
21,28,10,12,23,-11
21,28,11,17,19,-2
21,28,12,15,13,2
21,28,13,26,18,8
21,28,14,18,11,7
21,28,15,25,16,9
21,28,16,19,20,-1
21,28,17,8,7,1
21,28,18,20,6,14
21,28,19,21,14,7
21,28,20,16,15,1
21,28,21,4,3,1
21,28,22,25,20,5
21,28,23,17,9,8
21,28,24,16,15,1
21,28,25,10,11,-1
21,28,26,13,11,2
21,28,27,24,9,15
21,28,28,9,5,4
21,28,29,17,17,0
21,28,30,15,19,-4
21,28,31,15,11,4
21,28,32,12,12,0
21,28,33,20,11,9
21,28,34,19,6,13
21,28,35,17,9,8
21,28,36,9,6,3
21,28,37,10,8,2
21,28,38,24,26,-2
21,28,39,12,6,6
21,28,40,20,11,9
21,28,41,19,12,7
21,28,42,11,12,-1
21,28,43,12,14,-2
21,28,44,15,11,4
21,28,45,25,3,22
21,28,46,13,7,6
21,28,47,22,12,10
21,28,48,11,17,-6
21,28,49,26,23,3
21,28,50,12,17,-5
21,28,51,15,15,0
21,28,52,18,25,-7
21,28,53,17,5,12
21,28,54,22,17,5
21,28,55,27,12,15
21,28,56,17,13,4
21,28,57,10,14,-4
21,28,58,14,13,1
21,28,59,26,18,8
21,28,60,20,18,2
21,28,61,7,11,-4
21,28,62,10,8,2
21,28,63,19,17,2
21,28,64,16,11,5
21,28,65,19,20,-1
21,28,66,10,25,-15
21,28,67,18,13,5
21,28,68,21,7,14
21,28,69,22,22,0
21,28,70,14,8,6
21,28,71,14,8,6
21,28,72,16,8,8
21,28,73,4,5,-1
21,28,74,12,12,0
21,28,75,14,19,-5
21,28,76,14,4,10
21,28,77,20,11,9
21,28,78,11,22,-11
21,28,79,12,7,5
21,28,80,18,9,9
21,28,81,5,10,-5
21,28,82,16,17,-1
21,28,83,9,10,-1
21,28,84,2,8,-6
21,28,85,4,15,-11
21,28,86,12,18,-6
21,28,87,17,15,2
21,28,88,12,2,10
21,28,89,11,10,1
21,28,90,14,17,-3
21,28,91,4,5,-1
21,28,92,8,15,-7
21,28,93,14,12,2
21,28,94,13,16,-3
21,28,95,7,11,-4
21,28,96,23,12,11
21,28,97,31,35,-4
21,28,98,23,14,9
21,28,99,13,9,4
21,28,100,14,9,5
21,28,101,15,24,-9
21,28,102,12,16,-4
21,28,103,11,2,9
21,28,104,6,3,3
21,28,105,27,15,12
21,28,106,13,8,5
21,28,107,14,12,2
21,28,108,21,6,15
21,28,109,12,12,0
21,28,110,19,14,5
21,28,111,24,14,10
21,28,112,11,6,5
21,28,113,16,18,-2
21,28,114,22,12,10
21,28,115,21,10,11
21,28,116,20,15,5
21,28,117,10,12,-2
21,28,118,19,9,10
21,28,119,16,8,8
21,28,120,10,16,-6
21,28,121,10,15,-5
21,28,122,17,10,7
21,28,123,21,18,3
21,28,124,19,13,6
21,28,125,15,20,-5
21,28,126,12,7,5
21,28,127,9,9,0
21,28,128,25,15,10
21,28,129,12,16,-4
21,28,130,28,22,6
21,28,131,13,10,3
21,28,132,10,6,4
21,28,133,17,19,-2
21,28,134,12,10,2
21,28,135,7,3,4
21,28,136,16,11,5
21,28,137,31,25,6
21,28,138,11,19,-8
21,28,139,5,13,-8
21,28,140,14,5,9
21,28,141,16,8,8
21,28,142,3,18,-15
21,28,143,17,10,7
21,28,144,22,18,4
21,28,145,9,13,-4
21,28,146,9,16,-7
21,28,147,21,28,-7
21,28,148,12,8,4
21,28,149,14,12,2
21,28,150,15,13,2
21,28,151,8,14,-6
21,28,152,11,5,6
21,28,153,18,11,7
21,28,154,12,11,1
21,28,155,14,19,-5
21,28,156,7,7,0
21,28,157,24,18,6
21,28,158,19,7,12
21,28,159,6,21,-15
21,28,160,18,17,1
21,28,161,12,11,1
21,28,162,4,9,-5
21,28,163,19,24,-5
21,28,164,20,13,7
21,28,165,7,13,-6
21,28,166,16,7,9
21,28,167,20,10,10
21,28,168,24,5,19
21,28,169,6,16,-10
21,28,170,22,8,14
21,28,171,10,6,4
21,28,172,16,5,11
21,28,173,19,24,-5
21,28,174,10,12,-2
21,28,175,9,10,-1
21,28,176,14,11,3
21,28,177,23,32,-9
21,28,178,12,13,-1
21,28,179,15,8,7
21,28,180,21,9,12
21,28,181,13,5,8
21,28,182,17,11,6
21,28,183,15,6,9
21,28,184,11,9,2
21,28,185,7,4,3
21,28,186,11,12,-1
21,28,187,15,21,-6
21,28,188,11,13,-2
21,28,189,14,15,-1
21,28,190,17,9,8
21,28,191,18,13,5
21,28,192,11,7,4
21,28,193,27,22,5
21,28,194,25,16,9
21,28,195,13,23,-10
21,28,196,17,10,7
21,28,197,16,16,0
21,28,198,9,13,-4
21,28,199,13,24,-11
21,28,200,14,6,8
21,28,201,17,22,-5
21,28,202,12,15,-3
21,28,203,27,21,6
21,28,204,23,17,6
21,28,205,23,10,13
21,28,206,14,7,7
21,28,207,21,25,-4
21,28,208,18,14,4
21,28,209,7,6,1
21,28,210,12,9,3
21,28,211,11,6,5
21,28,212,20,11,9
21,28,213,20,11,9
21,28,214,7,15,-8
21,28,215,18,7,11
21,28,216,15,15,0
21,28,217,13,26,-13
21,28,218,19,18,1
21,28,219,17,18,-1
21,28,220,16,16,0
21,28,221,18,9,9
21,28,222,15,13,2
21,28,223,19,13,6
21,28,224,18,14,4
21,28,225,11,9,2
21,28,226,12,16,-4
21,28,227,16,11,5
21,28,228,10,9,1
21,28,229,19,14,5
21,28,230,16,19,-3
21,28,231,17,13,4
21,28,232,15,15,0
21,28,233,15,18,-3
21,28,234,13,9,4
21,28,235,14,10,4
21,28,236,10,9,1
21,28,237,16,21,-5
21,28,238,11,14,-3
21,28,239,13,22,-9
21,28,240,10,13,-3
21,28,241,20,22,-2
21,28,242,4,17,-13
21,28,243,9,11,-2
21,28,244,9,8,1
21,28,245,13,11,2
21,28,246,8,3,5
21,28,247,14,12,2
21,28,248,10,12,-2
21,28,249,28,12,16
21,28,250,10,6,4
21,28,251,12,17,-5
21,28,252,10,13,-3
21,28,253,11,11,0
21,28,254,11,21,-10
21,28,255,9,23,-14
21,28,256,19,21,-2
21,28,257,12,20,-8
21,28,258,3,9,-6
21,28,259,26,13,13
21,28,260,16,6,10
21,28,261,15,18,-3
21,28,262,11,8,3
21,28,263,17,12,5
21,28,264,7,10,-3
21,28,265,27,8,19
21,28,266,18,8,10
21,28,267,15,18,-3
21,28,268,7,10,-3
21,28,269,18,10,8
21,28,270,10,9,1
21,28,271,16,16,0
21,28,272,7,4,3
21,28,273,7,6,1
21,28,274,15,17,-2
21,28,275,16,20,-4
21,28,276,21,20,1
21,28,277,16,25,-9
21,28,278,25,2,23
21,28,279,21,10,11
21,28,280,7,14,-7
21,28,281,13,8,5
21,28,282,30,10,20
21,28,283,14,15,-1
21,28,284,17,10,7
21,28,285,24,12,12
21,28,286,10,29,-19
21,28,287,5,6,-1
21,28,288,14,8,6
21,28,289,9,9,0
21,28,290,14,12,2
21,28,291,14,13,1
21,28,292,15,25,-10
21,28,293,14,5,9
21,28,294,11,14,-3
21,28,295,15,10,5
21,28,296,15,14,1
21,28,297,18,11,7
21,28,298,12,12,0
21,28,299,13,20,-7
21,29,0,33,10,23
21,29,1,22,9,13
21,29,2,16,14,2
21,29,3,5,5,0
21,29,4,12,10,2
21,29,5,18,10,8
21,29,6,8,11,-3
21,29,7,7,4,3
21,29,8,16,15,1
21,29,9,11,13,-2
21,29,10,19,12,7
21,29,11,18,20,-2
21,29,12,18,13,5
21,29,13,15,7,8
21,29,14,4,11,-7
21,29,15,18,5,13
21,29,16,21,10,11
21,29,17,20,9,11
21,29,18,21,15,6
21,29,19,15,4,11
21,29,20,20,17,3
21,29,21,17,27,-10
21,29,22,9,8,1
21,29,23,14,19,-5
21,29,24,14,11,3
21,29,25,16,15,1
21,29,26,29,18,11
21,29,27,18,6,12
21,29,28,18,13,5
21,29,29,11,3,8
21,29,30,13,15,-2
21,29,31,18,27,-9
21,29,32,7,2,5
21,29,33,17,15,2
21,29,34,16,18,-2
21,29,35,7,6,1
21,29,36,9,10,-1
21,29,37,12,6,6
21,29,38,14,10,4
21,29,39,20,22,-2
21,29,40,21,13,8
21,29,41,15,6,9
21,29,42,18,18,0
21,29,43,29,29,0
21,29,44,14,16,-2
21,29,45,21,14,7
21,29,46,24,9,15
21,29,47,15,12,3
21,29,48,16,11,5
21,29,49,12,6,6
21,29,50,6,11,-5
21,29,51,9,9,0
21,29,52,6,11,-5
21,29,53,9,8,1
21,29,54,4,7,-3
21,29,55,14,24,-10
21,29,56,27,19,8
21,29,57,8,13,-5
21,29,58,17,11,6
21,29,59,16,16,0
21,29,60,3,10,-7
21,29,61,21,12,9
21,29,62,17,18,-1
21,29,63,15,5,10
21,29,64,13,13,0
21,29,65,14,14,0
21,29,66,9,7,2
21,29,67,18,15,3
21,29,68,30,19,11
21,29,69,7,13,-6
21,29,70,21,21,0
21,29,71,22,21,1
21,29,72,17,21,-4
21,29,73,25,15,10
21,29,74,7,11,-4
21,29,75,8,15,-7
21,29,76,5,12,-7
21,29,77,23,16,7
21,29,78,16,15,1
21,29,79,16,10,6
21,29,80,17,15,2
21,29,81,23,15,8
21,29,82,15,9,6
21,29,83,26,18,8
21,29,84,8,5,3
21,29,85,9,14,-5
21,29,86,6,14,-8
21,29,87,23,17,6
21,29,88,22,7,15
21,29,89,22,13,9
21,29,90,7,3,4
21,29,91,17,11,6
21,29,92,15,13,2
21,29,93,7,2,5
21,29,94,28,13,15
21,29,95,3,15,-12
21,29,96,15,7,8
21,29,97,11,6,5
21,29,98,12,25,-13
21,29,99,15,8,7
21,29,100,21,10,11
21,29,101,9,11,-2
21,29,102,14,17,-3
21,29,103,20,14,6
21,29,104,11,10,1
21,29,105,10,8,2
21,29,106,21,11,10
21,29,107,11,6,5
21,29,108,24,27,-3
21,29,109,16,8,8
21,29,110,18,25,-7
21,29,111,14,20,-6
21,29,112,11,9,2
21,29,113,8,12,-4
21,29,114,21,9,12
21,29,115,12,10,2
21,29,116,16,8,8
21,29,117,12,18,-6
21,29,118,17,10,7
21,29,119,14,21,-7
21,29,120,15,15,0
21,29,121,18,17,1
21,29,122,13,5,8
21,29,123,6,15,-9
21,29,124,9,19,-10
21,29,125,18,11,7
21,29,126,22,8,14
21,29,127,12,10,2
21,29,128,26,5,21
21,29,129,16,2,14
21,29,130,9,13,-4
21,29,131,17,5,12
21,29,132,19,7,12
21,29,133,10,6,4
21,29,134,23,10,13
21,29,135,14,12,2
21,29,136,13,4,9
21,29,137,17,8,9
21,29,138,23,22,1
21,29,139,13,15,-2
21,29,140,13,18,-5
21,29,141,19,13,6
21,29,142,12,20,-8
21,29,143,13,11,2
21,29,144,29,16,13
21,29,145,15,11,4
21,29,146,9,14,-5
21,29,147,9,5,4
21,29,148,19,8,11
21,29,149,18,18,0
21,29,150,20,13,7
21,29,151,10,3,7
21,29,152,12,14,-2
21,29,153,13,15,-2
21,29,154,18,17,1
21,29,155,8,9,-1
21,29,156,20,10,10
21,29,157,8,14,-6
21,29,158,12,10,2
21,29,159,5,13,-8
21,29,160,13,9,4
21,29,161,13,8,5
21,29,162,25,11,14
21,29,163,6,10,-4
21,29,164,12,15,-3
21,29,165,9,5,4
21,29,166,24,11,13
21,29,167,14,10,4
21,29,168,10,4,6
21,29,169,11,8,3
21,29,170,22,17,5
21,29,171,8,9,-1
21,29,172,11,17,-6
21,29,173,20,9,11
21,29,174,10,12,-2
21,29,175,27,9,18
21,29,176,26,10,16
21,29,177,16,14,2
21,29,178,21,13,8
21,29,179,16,15,1
21,29,180,10,15,-5
21,29,181,16,15,1
21,29,182,22,21,1
21,29,183,17,14,3
21,29,184,18,8,10
21,29,185,11,9,2
21,29,186,11,9,2
21,29,187,11,8,3
21,29,188,13,13,0
21,29,189,24,8,16
21,29,190,10,5,5
21,29,191,8,10,-2
21,29,192,6,18,-12
21,29,193,8,16,-8
21,29,194,16,16,0
21,29,195,17,18,-1
21,29,196,23,19,4
21,29,197,23,18,5
21,29,198,12,11,1
21,29,199,8,18,-10
21,29,200,10,9,1
21,29,201,12,15,-3
21,29,202,24,6,18
21,29,203,16,9,7
21,29,204,20,22,-2
21,29,205,18,15,3
21,29,206,21,5,16
21,29,207,13,19,-6
21,29,208,11,8,3
21,29,209,8,10,-2
21,29,210,5,14,-9
21,29,211,6,12,-6
21,29,212,13,11,2
21,29,213,10,16,-6
21,29,214,15,23,-8
21,29,215,9,7,2
21,29,216,4,8,-4
21,29,217,16,7,9
21,29,218,18,6,12
21,29,219,13,17,-4
21,29,220,5,9,-4
21,29,221,15,11,4
21,29,222,18,13,5
21,29,223,16,8,8
21,29,224,10,4,6
21,29,225,12,12,0
21,29,226,40,22,18
21,29,227,2,7,-5
21,29,228,24,18,6
21,29,229,17,4,13
21,29,230,17,5,12
21,29,231,14,5,9
21,29,232,17,23,-6
21,29,233,7,8,-1
21,29,234,18,21,-3
21,29,235,25,8,17
21,29,236,14,17,-3
21,29,237,28,13,15
21,29,238,8,6,2
21,29,239,18,15,3
21,29,240,9,4,5
21,29,241,21,4,17
21,29,242,12,8,4
21,29,243,17,11,6
21,29,244,6,5,1
21,29,245,9,7,2
21,29,246,11,21,-10
21,29,247,16,11,5
21,29,248,11,20,-9
21,29,249,18,13,5
21,29,250,26,13,13
21,29,251,23,14,9
21,29,252,9,14,-5
21,29,253,10,20,-10
21,29,254,11,11,0
21,29,255,13,15,-2
21,29,256,38,15,23
21,29,257,14,11,3
21,29,258,18,15,3
21,29,259,17,21,-4
21,29,260,16,9,7
21,29,261,16,9,7
21,29,262,21,12,9
21,29,263,17,16,1
21,29,264,28,10,18
21,29,265,9,4,5
21,29,266,17,8,9
21,29,267,20,21,-1
21,29,268,15,12,3
21,29,269,4,21,-17
21,29,270,20,17,3
21,29,271,21,9,12
21,29,272,23,11,12
21,29,273,10,20,-10
21,29,274,10,5,5
21,29,275,14,6,8
21,29,276,23,10,13
21,29,277,11,12,-1
21,29,278,21,23,-2
21,29,279,20,17,3
21,29,280,16,7,9
21,29,281,13,6,7
21,29,282,25,12,13
21,29,283,12,9,3
21,29,284,10,6,4
21,29,285,15,11,4
21,29,286,12,13,-1
21,29,287,10,14,-4
21,29,288,9,11,-2
21,29,289,20,11,9
21,29,290,17,23,-6
21,29,291,18,13,5
21,29,292,19,7,12
21,29,293,16,18,-2
21,29,294,31,20,11
21,29,295,13,6,7
21,29,296,2,9,-7
21,29,297,12,4,8
21,29,298,20,10,10
21,29,299,20,16,4
21,30,0,6,16,-10
21,30,1,12,15,-3
21,30,2,4,4,0
21,30,3,8,15,-7
21,30,4,10,16,-6
21,30,5,13,13,0
21,30,6,9,7,2
21,30,7,14,7,7
21,30,8,15,9,6
21,30,9,6,5,1
21,30,10,14,9,5
21,30,11,8,13,-5
21,30,12,21,11,10
21,30,13,22,16,6
21,30,14,12,8,4
21,30,15,13,9,4
21,30,16,7,5,2
21,30,17,26,21,5
21,30,18,8,19,-11
21,30,19,17,11,6
21,30,20,17,13,4
21,30,21,16,7,9
21,30,22,9,1,8
21,30,23,12,6,6
21,30,24,12,19,-7
21,30,25,15,8,7
21,30,26,21,16,5
21,30,27,6,17,-11
21,30,28,9,11,-2
21,30,29,25,19,6
21,30,30,12,21,-9
21,30,31,18,17,1
21,30,32,7,9,-2
21,30,33,12,19,-7
21,30,34,13,9,4
21,30,35,21,15,6
21,30,36,21,18,3
21,30,37,9,11,-2
21,30,38,12,8,4
21,30,39,10,15,-5
21,30,40,3,9,-6
21,30,41,8,18,-10
21,30,42,5,15,-10
21,30,43,14,10,4
21,30,44,6,4,2
21,30,45,6,8,-2
21,30,46,20,12,8
21,30,47,8,11,-3
21,30,48,24,14,10
21,30,49,28,15,13
21,30,50,15,9,6
21,30,51,24,19,5
21,30,52,15,17,-2
21,30,53,8,6,2
21,30,54,15,8,7
21,30,55,9,12,-3
21,30,56,6,11,-5
21,30,57,15,4,11
21,30,58,14,15,-1
21,30,59,16,17,-1
21,30,60,10,6,4
21,30,61,2,4,-2
21,30,62,16,7,9
21,30,63,17,11,6
21,30,64,16,10,6
21,30,65,7,6,1
21,30,66,10,12,-2
21,30,67,11,7,4
21,30,68,19,11,8
21,30,69,21,8,13
21,30,70,15,17,-2
21,30,71,20,9,11
21,30,72,19,23,-4
21,30,73,28,14,14
21,30,74,15,7,8
21,30,75,10,19,-9
21,30,76,19,23,-4
21,30,77,16,8,8
21,30,78,23,15,8
21,30,79,7,14,-7
21,30,80,7,4,3
21,30,81,19,7,12
21,30,82,10,24,-14
21,30,83,13,17,-4
21,30,84,21,14,7
21,30,85,10,4,6
21,30,86,13,3,10
21,30,87,16,13,3
21,30,88,12,9,3
21,30,89,6,12,-6
21,30,90,9,7,2
21,30,91,14,14,0
21,30,92,15,16,-1
21,30,93,8,10,-2
21,30,94,33,20,13
21,30,95,23,11,12
21,30,96,17,23,-6
21,30,97,9,6,3
21,30,98,10,9,1
21,30,99,25,15,10
21,30,100,4,6,-2
21,30,101,17,9,8
21,30,102,8,18,-10
21,30,103,6,7,-1
21,30,104,10,9,1
21,30,105,18,7,11
21,30,106,7,1,6
21,30,107,18,15,3
21,30,108,16,21,-5
21,30,109,18,12,6
21,30,110,16,14,2
21,30,111,27,11,16
21,30,112,19,19,0
21,30,113,8,10,-2
21,30,114,20,5,15
21,30,115,7,20,-13
21,30,116,13,10,3
21,30,117,6,8,-2
21,30,118,22,4,18
21,30,119,19,10,9
21,30,120,14,10,4
21,30,121,17,15,2
21,30,122,12,10,2
21,30,123,10,17,-7
21,30,124,14,4,10
21,30,125,9,8,1
21,30,126,5,14,-9
21,30,127,11,6,5
21,30,128,5,4,1
21,30,129,16,13,3
21,30,130,14,9,5
21,30,131,13,14,-1
21,30,132,19,9,10
21,30,133,10,8,2
21,30,134,18,14,4
21,30,135,12,13,-1
21,30,136,6,20,-14
21,30,137,16,7,9
21,30,138,6,8,-2
21,30,139,13,7,6
21,30,140,11,10,1
21,30,141,14,24,-10
21,30,142,23,3,20
21,30,143,11,8,3
21,30,144,19,17,2
21,30,145,7,7,0
21,30,146,14,10,4
21,30,147,20,11,9
21,30,148,16,8,8
21,30,149,19,10,9
21,30,150,23,11,12
21,30,151,17,21,-4
21,30,152,20,8,12
21,30,153,17,27,-10
21,30,154,8,6,2
21,30,155,32,10,22
21,30,156,15,4,11
21,30,157,14,9,5
21,30,158,7,18,-11
21,30,159,22,4,18
21,30,160,6,13,-7
21,30,161,17,13,4
21,30,162,13,14,-1
21,30,163,15,9,6
21,30,164,12,9,3
21,30,165,14,3,11
21,30,166,9,5,4
21,30,167,24,14,10
21,30,168,19,12,7
21,30,169,6,7,-1
21,30,170,14,11,3
21,30,171,7,7,0
21,30,172,16,14,2
21,30,173,12,15,-3
21,30,174,8,20,-12
21,30,175,8,11,-3
21,30,176,7,9,-2
21,30,177,11,15,-4
21,30,178,19,4,15
21,30,179,22,15,7
21,30,180,10,12,-2
21,30,181,25,20,5
21,30,182,13,5,8
21,30,183,20,9,11
21,30,184,16,12,4
21,30,185,15,16,-1
21,30,186,18,10,8
21,30,187,14,22,-8
21,30,188,10,11,-1
21,30,189,18,10,8
21,30,190,19,11,8
21,30,191,10,10,0
21,30,192,13,23,-10
21,30,193,14,6,8
21,30,194,15,6,9
21,30,195,20,11,9
21,30,196,16,9,7
21,30,197,15,23,-8
21,30,198,8,13,-5
21,30,199,15,16,-1
21,30,200,9,9,0
21,30,201,6,7,-1
21,30,202,15,10,5
21,30,203,16,18,-2
21,30,204,13,7,6
21,30,205,20,14,6
21,30,206,14,10,4
21,30,207,19,14,5
21,30,208,16,17,-1
21,30,209,20,10,10
21,30,210,23,11,12
21,30,211,12,14,-2
21,30,212,20,12,8
21,30,213,15,15,0
21,30,214,14,8,6
21,30,215,9,2,7
21,30,216,15,26,-11
21,30,217,25,30,-5
21,30,218,19,16,3
21,30,219,19,21,-2
21,30,220,11,7,4
21,30,221,16,16,0
21,30,222,21,11,10
21,30,223,14,10,4
21,30,224,22,18,4
21,30,225,6,6,0
21,30,226,14,11,3
21,30,227,21,16,5
21,30,228,13,6,7
21,30,229,8,8,0
21,30,230,22,15,7
21,30,231,18,15,3
21,30,232,29,8,21
21,30,233,10,13,-3
21,30,234,14,17,-3
21,30,235,12,18,-6
21,30,236,32,14,18
21,30,237,25,24,1
21,30,238,6,5,1
21,30,239,14,17,-3
21,30,240,17,16,1
21,30,241,14,14,0
21,30,242,12,8,4
21,30,243,6,10,-4
21,30,244,7,12,-5
21,30,245,11,4,7
21,30,246,13,9,4
21,30,247,20,19,1
21,30,248,21,13,8
21,30,249,12,7,5
21,30,250,15,11,4
21,30,251,8,19,-11
21,30,252,24,9,15
21,30,253,11,12,-1
21,30,254,5,10,-5
21,30,255,31,15,16
21,30,256,23,10,13
21,30,257,13,9,4
21,30,258,10,5,5
21,30,259,15,9,6
21,30,260,16,6,10
21,30,261,19,6,13
21,30,262,22,20,2
21,30,263,13,11,2
21,30,264,16,5,11
21,30,265,15,18,-3
21,30,266,12,10,2
21,30,267,12,8,4
21,30,268,13,13,0
21,30,269,25,10,15
21,30,270,5,12,-7
21,30,271,23,11,12
21,30,272,9,9,0
21,30,273,17,8,9
21,30,274,10,6,4
21,30,275,18,14,4
21,30,276,22,15,7
21,30,277,17,12,5
21,30,278,30,13,17
21,30,279,17,7,10
21,30,280,11,9,2
21,30,281,5,8,-3
21,30,282,12,10,2
21,30,283,9,9,0
21,30,284,12,6,6
21,30,285,2,15,-13
21,30,286,20,14,6
21,30,287,11,9,2
21,30,288,14,9,5
21,30,289,12,14,-2
21,30,290,20,20,0
21,30,291,17,15,2
21,30,292,15,9,6
21,30,293,7,15,-8
21,30,294,15,16,-1
21,30,295,22,14,8
21,30,296,8,17,-9
21,30,297,10,15,-5
21,30,298,26,4,22
21,30,299,14,9,5
22,1,0,13,13,0
22,1,1,15,31,-16
22,1,2,7,16,-9
22,1,3,3,9,-6
22,1,4,4,22,-18
22,1,5,3,19,-16
22,1,6,25,29,-4
22,1,7,6,18,-12
22,1,8,7,12,-5
22,1,9,11,20,-9
22,1,10,5,13,-8
22,1,11,7,12,-5
22,1,12,1,5,-4
22,1,13,8,20,-12
22,1,14,3,9,-6
22,1,15,14,22,-8
22,1,16,11,10,1
22,1,17,8,9,-1
22,1,18,10,5,5
22,1,19,8,13,-5
22,1,20,8,14,-6
22,1,21,6,9,-3
22,1,22,8,16,-8
22,1,23,13,34,-21
22,1,24,19,21,-2
22,1,25,8,15,-7
22,1,26,7,15,-8
22,1,27,8,24,-16
22,1,28,9,10,-1
22,1,29,12,16,-4
22,1,30,11,29,-18
22,1,31,11,15,-4
22,1,32,11,28,-17
22,1,33,1,4,-3
22,1,34,10,28,-18
22,1,35,1,7,-6
22,1,36,5,10,-5
22,1,37,4,15,-11
22,1,38,11,20,-9
22,1,39,9,14,-5
22,1,40,13,10,3
22,1,41,2,12,-10
22,1,42,8,16,-8
22,1,43,12,20,-8
22,1,44,3,13,-10
22,1,45,14,22,-8
22,1,46,3,17,-14
22,1,47,7,8,-1
22,1,48,12,11,1
22,1,49,8,31,-23
22,1,50,1,6,-5
22,1,51,8,13,-5
22,1,52,10,20,-10
22,1,53,12,12,0
22,1,54,8,19,-11
22,1,55,8,17,-9
22,1,56,10,11,-1
22,1,57,0,20,-20
22,1,58,7,23,-16
22,1,59,4,28,-24
22,1,60,12,19,-7
22,1,61,11,25,-14
22,1,62,12,16,-4
22,1,63,4,17,-13
22,1,64,5,23,-18
22,1,65,9,20,-11
22,1,66,9,22,-13
22,1,67,6,5,1
22,1,68,12,21,-9
22,1,69,7,18,-11
22,1,70,11,13,-2
22,1,71,6,10,-4
22,1,72,5,22,-17
22,1,73,6,17,-11
22,1,74,12,11,1
22,1,75,4,18,-14
22,1,76,7,10,-3
22,1,77,11,20,-9
22,1,78,7,19,-12
22,1,79,7,14,-7
22,1,80,6,12,-6
22,1,81,2,4,-2
22,1,82,8,24,-16
22,1,83,4,16,-12
22,1,84,11,28,-17
22,1,85,18,18,0
22,1,86,8,9,-1
22,1,87,0,16,-16
22,1,88,5,11,-6
22,1,89,2,10,-8
22,1,90,4,29,-25
22,1,91,17,26,-9
22,1,92,11,18,-7
22,1,93,4,14,-10
22,1,94,4,9,-5
22,1,95,10,9,1
22,1,96,10,30,-20
22,1,97,8,13,-5
22,1,98,2,8,-6
22,1,99,6,16,-10
22,1,100,18,15,3
22,1,101,9,13,-4
22,1,102,4,21,-17
22,1,103,4,18,-14
22,1,104,5,12,-7
22,1,105,4,14,-10
22,1,106,0,4,-4
22,1,107,4,17,-13
22,1,108,10,15,-5
22,1,109,5,13,-8
22,1,110,5,13,-8
22,1,111,7,9,-2
22,1,112,8,18,-10
22,1,113,4,21,-17
22,1,114,6,23,-17
22,1,115,5,8,-3
22,1,116,9,22,-13
22,1,117,9,7,2
22,1,118,8,4,4
22,1,119,1,21,-20
22,1,120,11,20,-9
22,1,121,27,34,-7
22,1,122,7,11,-4
22,1,123,0,23,-23
22,1,124,9,23,-14
22,1,125,6,11,-5
22,1,126,25,18,7
22,1,127,12,37,-25
22,1,128,16,23,-7
22,1,129,12,16,-4
22,1,130,4,15,-11
22,1,131,2,16,-14
22,1,132,13,23,-10
22,1,133,15,25,-10
22,1,134,8,8,0
22,1,135,14,25,-11
22,1,136,7,21,-14
22,1,137,10,6,4
22,1,138,14,17,-3
22,1,139,10,14,-4
22,1,140,12,22,-10
22,1,141,6,19,-13
22,1,142,1,9,-8
22,1,143,13,16,-3
22,1,144,4,16,-12
22,1,145,4,18,-14
22,1,146,12,16,-4
22,1,147,15,29,-14
22,1,148,7,11,-4
22,1,149,13,22,-9
22,1,150,5,14,-9
22,1,151,7,7,0
22,1,152,9,15,-6
22,1,153,7,8,-1
22,1,154,2,15,-13
22,1,155,8,16,-8
22,1,156,13,18,-5
22,1,157,4,16,-12
22,1,158,4,24,-20
22,1,159,8,28,-20
22,1,160,4,18,-14
22,1,161,13,12,1
22,1,162,8,22,-14
22,1,163,13,20,-7
22,1,164,7,7,0
22,1,165,10,24,-14
22,1,166,5,15,-10
22,1,167,4,16,-12
22,1,168,10,14,-4
22,1,169,9,19,-10
22,1,170,16,15,1
22,1,171,5,6,-1
22,1,172,4,8,-4
22,1,173,10,14,-4
22,1,174,11,17,-6
22,1,175,18,26,-8
22,1,176,7,13,-6
22,1,177,9,8,1
22,1,178,12,12,0
22,1,179,2,20,-18
22,1,180,12,9,3
22,1,181,5,12,-7
22,1,182,7,16,-9
22,1,183,8,4,4
22,1,184,10,15,-5
22,1,185,15,36,-21
22,1,186,4,16,-12
22,1,187,11,18,-7
22,1,188,3,2,1
22,1,189,9,17,-8
22,1,190,2,12,-10
22,1,191,3,17,-14
22,1,192,18,15,3
22,1,193,7,21,-14
22,1,194,9,15,-6
22,1,195,8,29,-21
22,1,196,3,10,-7
22,1,197,4,26,-22
22,1,198,3,9,-6
22,1,199,7,25,-18
22,1,200,9,19,-10
22,1,201,6,4,2
22,1,202,4,17,-13
22,1,203,5,8,-3
22,1,204,9,11,-2
22,1,205,17,18,-1
22,1,206,4,17,-13
22,1,207,3,10,-7
22,1,208,12,17,-5
22,1,209,4,11,-7
22,1,210,6,6,0
22,1,211,7,16,-9
22,1,212,12,33,-21
22,1,213,3,14,-11
22,1,214,15,22,-7
22,1,215,6,23,-17
22,1,216,12,13,-1
22,1,217,5,14,-9
22,1,218,9,16,-7
22,1,219,3,12,-9
22,1,220,16,18,-2
22,1,221,9,35,-26
22,1,222,10,23,-13
22,1,223,7,9,-2
22,1,224,13,23,-10
22,1,225,13,22,-9
22,1,226,5,20,-15
22,1,227,11,23,-12
22,1,228,11,6,5
22,1,229,7,19,-12
22,1,230,15,16,-1
22,1,231,11,16,-5
22,1,232,5,16,-11
22,1,233,10,8,2
22,1,234,8,6,2
22,1,235,4,13,-9
22,1,236,11,14,-3
22,1,237,7,17,-10
22,1,238,5,24,-19
22,1,239,22,16,6
22,1,240,6,11,-5
22,1,241,12,19,-7
22,1,242,10,26,-16
22,1,243,13,15,-2
22,1,244,18,23,-5
22,1,245,15,13,2
22,1,246,9,17,-8
22,1,247,4,24,-20
22,1,248,7,24,-17
22,1,249,9,25,-16
22,1,250,11,20,-9
22,1,251,5,14,-9
22,1,252,6,16,-10
22,1,253,8,26,-18
22,1,254,13,20,-7
22,1,255,10,8,2
22,1,256,10,17,-7
22,1,257,5,16,-11
22,1,258,10,28,-18
22,1,259,6,15,-9
22,1,260,11,11,0
22,1,261,19,21,-2
22,1,262,10,23,-13
22,1,263,3,7,-4
22,1,264,11,14,-3
22,1,265,9,7,2
22,1,266,12,15,-3
22,1,267,7,10,-3
22,1,268,2,8,-6
22,1,269,18,36,-18
22,1,270,3,5,-2
22,1,271,11,27,-16
22,1,272,9,23,-14
22,1,273,9,15,-6
22,1,274,6,8,-2
22,1,275,8,15,-7
22,1,276,14,14,0
22,1,277,10,9,1
22,1,278,6,12,-6
22,1,279,5,23,-18
22,1,280,3,15,-12
22,1,281,10,18,-8
22,1,282,6,13,-7
22,1,283,5,19,-14
22,1,284,13,10,3
22,1,285,3,15,-12
22,1,286,8,31,-23
22,1,287,8,21,-13
22,1,288,7,7,0
22,1,289,3,1,2
22,1,290,2,4,-2
22,1,291,10,16,-6
22,1,292,8,21,-13
22,1,293,7,8,-1
22,1,294,10,10,0
22,1,295,9,12,-3
22,1,296,12,10,2
22,1,297,13,12,1
22,1,298,13,11,2
22,1,299,7,13,-6
22,2,0,12,18,-6
22,2,1,4,8,-4
22,2,2,8,24,-16
22,2,3,19,9,10
22,2,4,5,19,-14
22,2,5,7,19,-12
22,2,6,3,13,-10
22,2,7,11,16,-5
22,2,8,12,28,-16
22,2,9,12,8,4
22,2,10,21,30,-9
22,2,11,12,26,-14
22,2,12,10,30,-20
22,2,13,10,13,-3
22,2,14,13,40,-27
22,2,15,11,35,-24
22,2,16,12,27,-15
22,2,17,11,13,-2
22,2,18,9,5,4
22,2,19,9,29,-20
22,2,20,8,26,-18
22,2,21,11,19,-8
22,2,22,8,18,-10
22,2,23,3,13,-10
22,2,24,7,26,-19
22,2,25,11,18,-7
22,2,26,22,16,6
22,2,27,4,25,-21
22,2,28,12,29,-17
22,2,29,7,17,-10
22,2,30,9,18,-9
22,2,31,7,16,-9
22,2,32,4,9,-5
22,2,33,10,18,-8
22,2,34,9,21,-12
22,2,35,14,18,-4
22,2,36,2,23,-21
22,2,37,4,15,-11
22,2,38,6,14,-8
22,2,39,10,19,-9
22,2,40,9,24,-15
22,2,41,13,21,-8
22,2,42,14,17,-3
22,2,43,7,9,-2
22,2,44,6,16,-10
22,2,45,15,18,-3
22,2,46,1,12,-11
22,2,47,13,18,-5
22,2,48,5,18,-13
22,2,49,2,25,-23
22,2,50,4,12,-8
22,2,51,9,14,-5
22,2,52,15,28,-13
22,2,53,12,22,-10
22,2,54,5,16,-11
22,2,55,10,23,-13
22,2,56,11,33,-22
22,2,57,18,25,-7
22,2,58,14,17,-3
22,2,59,5,19,-14
22,2,60,15,15,0
22,2,61,9,17,-8
22,2,62,10,22,-12
22,2,63,7,12,-5
22,2,64,4,17,-13
22,2,65,18,30,-12
22,2,66,5,10,-5
22,2,67,4,9,-5
22,2,68,6,19,-13
22,2,69,14,22,-8
22,2,70,18,19,-1
22,2,71,9,11,-2
22,2,72,12,18,-6
22,2,73,20,26,-6
22,2,74,20,23,-3
22,2,75,4,10,-6
22,2,76,7,15,-8
22,2,77,11,29,-18
22,2,78,3,13,-10
22,2,79,8,20,-12
22,2,80,10,14,-4
22,2,81,11,22,-11
22,2,82,12,4,8
22,2,83,5,29,-24
22,2,84,3,7,-4
22,2,85,6,21,-15
22,2,86,3,25,-22
22,2,87,9,18,-9
22,2,88,10,11,-1
22,2,89,2,8,-6
22,2,90,11,5,6
22,2,91,1,14,-13
22,2,92,10,18,-8
22,2,93,6,14,-8
22,2,94,5,21,-16
22,2,95,6,17,-11
22,2,96,14,31,-17
22,2,97,2,21,-19
22,2,98,6,11,-5
22,2,99,8,14,-6
22,2,100,9,21,-12
22,2,101,13,14,-1
22,2,102,9,9,0
22,2,103,13,22,-9
22,2,104,5,26,-21
22,2,105,8,9,-1
22,2,106,12,14,-2
22,2,107,5,10,-5
22,2,108,6,8,-2
22,2,109,19,30,-11
22,2,110,0,21,-21
22,2,111,15,24,-9
22,2,112,7,16,-9
22,2,113,8,12,-4
22,2,114,7,11,-4
22,2,115,8,21,-13
22,2,116,10,20,-10
22,2,117,0,15,-15
22,2,118,10,28,-18
22,2,119,3,17,-14
22,2,120,10,11,-1
22,2,121,12,17,-5
22,2,122,3,9,-6
22,2,123,8,11,-3
22,2,124,4,16,-12
22,2,125,13,20,-7
22,2,126,13,26,-13
22,2,127,4,5,-1
22,2,128,5,27,-22
22,2,129,8,23,-15
22,2,130,2,9,-7
22,2,131,3,16,-13
22,2,132,8,33,-25
22,2,133,12,17,-5
22,2,134,4,24,-20
22,2,135,12,29,-17
22,2,136,6,18,-12
22,2,137,6,21,-15
22,2,138,2,6,-4
22,2,139,11,16,-5
22,2,140,2,28,-26
22,2,141,15,26,-11
22,2,142,7,7,0
22,2,143,13,18,-5
22,2,144,13,14,-1
22,2,145,5,10,-5
22,2,146,3,4,-1
22,2,147,13,19,-6
22,2,148,16,29,-13
22,2,149,4,13,-9
22,2,150,2,24,-22
22,2,151,7,24,-17
22,2,152,7,23,-16
22,2,153,12,19,-7
22,2,154,9,31,-22
22,2,155,10,23,-13
22,2,156,11,31,-20
22,2,157,4,21,-17
22,2,158,8,25,-17
22,2,159,5,19,-14
22,2,160,12,16,-4
22,2,161,5,12,-7
22,2,162,14,23,-9
22,2,163,8,10,-2
22,2,164,10,15,-5
22,2,165,4,7,-3
22,2,166,9,21,-12
22,2,167,11,21,-10
22,2,168,1,1,0
22,2,169,4,10,-6
22,2,170,11,18,-7
22,2,171,12,19,-7
22,2,172,6,12,-6
22,2,173,12,17,-5
22,2,174,5,8,-3
22,2,175,3,9,-6
22,2,176,13,23,-10
22,2,177,8,20,-12
22,2,178,10,28,-18
22,2,179,5,15,-10
22,2,180,12,21,-9
22,2,181,9,11,-2
22,2,182,3,15,-12
22,2,183,10,15,-5
22,2,184,15,13,2
22,2,185,1,7,-6
22,2,186,8,13,-5
22,2,187,9,15,-6
22,2,188,7,18,-11
22,2,189,11,13,-2
22,2,190,11,19,-8
22,2,191,6,31,-25
22,2,192,9,8,1
22,2,193,9,17,-8
22,2,194,4,31,-27
22,2,195,8,38,-30
22,2,196,10,17,-7
22,2,197,9,2,7
22,2,198,4,15,-11
22,2,199,5,23,-18
22,2,200,8,23,-15
22,2,201,10,21,-11
22,2,202,12,28,-16
22,2,203,9,19,-10
22,2,204,2,17,-15
22,2,205,8,9,-1
22,2,206,10,27,-17
22,2,207,9,21,-12
22,2,208,7,22,-15
22,2,209,8,18,-10
22,2,210,12,13,-1
22,2,211,6,7,-1
22,2,212,10,27,-17
22,2,213,9,16,-7
22,2,214,17,25,-8
22,2,215,6,10,-4
22,2,216,5,12,-7
22,2,217,6,13,-7
22,2,218,12,22,-10
22,2,219,10,21,-11
22,2,220,10,22,-12
22,2,221,10,14,-4
22,2,222,4,11,-7
22,2,223,10,24,-14
22,2,224,2,11,-9
22,2,225,6,9,-3
22,2,226,11,17,-6
22,2,227,9,8,1
22,2,228,10,19,-9
22,2,229,15,14,1
22,2,230,10,32,-22
22,2,231,12,18,-6
22,2,232,12,32,-20
22,2,233,10,12,-2
22,2,234,11,14,-3
22,2,235,8,11,-3
22,2,236,3,6,-3
22,2,237,6,29,-23
22,2,238,4,5,-1
22,2,239,8,16,-8
22,2,240,15,19,-4
22,2,241,4,12,-8
22,2,242,15,35,-20
22,2,243,10,27,-17
22,2,244,6,11,-5
22,2,245,6,23,-17
22,2,246,7,23,-16
22,2,247,2,19,-17
22,2,248,8,14,-6
22,2,249,6,26,-20
22,2,250,7,8,-1
22,2,251,7,8,-1
22,2,252,9,42,-33
22,2,253,16,23,-7
22,2,254,12,33,-21
22,2,255,11,9,2
22,2,256,6,28,-22
22,2,257,5,12,-7
22,2,258,17,17,0
22,2,259,13,38,-25
22,2,260,6,25,-19
22,2,261,11,15,-4
22,2,262,10,15,-5
22,2,263,9,11,-2
22,2,264,4,8,-4
22,2,265,2,24,-22
22,2,266,8,8,0
22,2,267,14,29,-15
22,2,268,9,7,2
22,2,269,8,12,-4
22,2,270,9,28,-19
22,2,271,9,13,-4
22,2,272,9,20,-11
22,2,273,8,18,-10
22,2,274,10,19,-9
22,2,275,9,19,-10
22,2,276,12,17,-5
22,2,277,6,14,-8
22,2,278,7,9,-2
22,2,279,3,20,-17
22,2,280,6,19,-13
22,2,281,7,16,-9
22,2,282,6,27,-21
22,2,283,17,7,10
22,2,284,9,21,-12
22,2,285,6,22,-16
22,2,286,14,23,-9
22,2,287,15,19,-4
22,2,288,13,14,-1
22,2,289,11,20,-9
22,2,290,7,14,-7
22,2,291,14,16,-2
22,2,292,15,17,-2
22,2,293,6,13,-7
22,2,294,9,15,-6
22,2,295,18,16,2
22,2,296,5,17,-12
22,2,297,3,31,-28
22,2,298,8,28,-20
22,2,299,11,15,-4
22,3,0,7,22,-15
22,3,1,5,10,-5
22,3,2,14,15,-1
22,3,3,12,13,-1
22,3,4,9,24,-15
22,3,5,9,9,0
22,3,6,15,10,5
22,3,7,9,23,-14
22,3,8,8,18,-10
22,3,9,7,32,-25
22,3,10,5,16,-11
22,3,11,6,14,-8
22,3,12,17,37,-20
22,3,13,5,19,-14
22,3,14,5,5,0
22,3,15,14,34,-20
22,3,16,3,3,0
22,3,17,16,29,-13
22,3,18,10,38,-28
22,3,19,9,36,-27
22,3,20,7,10,-3
22,3,21,3,5,-2
22,3,22,9,25,-16
22,3,23,6,17,-11
22,3,24,7,17,-10
22,3,25,10,28,-18
22,3,26,5,17,-12
22,3,27,4,26,-22
22,3,28,14,13,1
22,3,29,17,26,-9
22,3,30,4,15,-11
22,3,31,13,20,-7
22,3,32,12,25,-13
22,3,33,5,12,-7
22,3,34,10,17,-7
22,3,35,17,20,-3
22,3,36,9,19,-10
22,3,37,5,7,-2
22,3,38,12,15,-3
22,3,39,13,15,-2
22,3,40,6,14,-8
22,3,41,6,13,-7
22,3,42,6,16,-10
22,3,43,12,21,-9
22,3,44,11,16,-5
22,3,45,3,15,-12
22,3,46,5,9,-4
22,3,47,2,16,-14
22,3,48,11,26,-15
22,3,49,16,18,-2
22,3,50,7,12,-5
22,3,51,9,19,-10
22,3,52,9,12,-3
22,3,53,9,31,-22
22,3,54,10,23,-13
22,3,55,11,22,-11
22,3,56,8,12,-4
22,3,57,18,18,0
22,3,58,7,17,-10
22,3,59,13,18,-5
22,3,60,5,32,-27
22,3,61,9,23,-14
22,3,62,10,12,-2
22,3,63,7,21,-14
22,3,64,4,24,-20
22,3,65,7,15,-8
22,3,66,5,18,-13
22,3,67,15,31,-16
22,3,68,9,16,-7
22,3,69,8,20,-12
22,3,70,3,13,-10
22,3,71,7,21,-14
22,3,72,8,13,-5
22,3,73,3,23,-20
22,3,74,4,13,-9
22,3,75,1,8,-7
22,3,76,15,23,-8
22,3,77,17,21,-4
22,3,78,4,19,-15
22,3,79,11,17,-6
22,3,80,7,4,3
22,3,81,12,10,2
22,3,82,4,10,-6
22,3,83,10,10,0
22,3,84,10,13,-3
22,3,85,11,16,-5
22,3,86,9,31,-22
22,3,87,10,26,-16
22,3,88,10,21,-11
22,3,89,17,20,-3
22,3,90,6,14,-8
22,3,91,5,7,-2
22,3,92,7,18,-11
22,3,93,7,12,-5
22,3,94,8,18,-10
22,3,95,12,21,-9
22,3,96,11,19,-8
22,3,97,12,15,-3
22,3,98,5,15,-10
22,3,99,23,21,2
22,3,100,7,31,-24
22,3,101,5,5,0
22,3,102,10,20,-10
22,3,103,9,29,-20
22,3,104,2,18,-16
22,3,105,23,13,10
22,3,106,14,16,-2
22,3,107,15,18,-3
22,3,108,7,10,-3
22,3,109,12,28,-16
22,3,110,9,25,-16
22,3,111,5,28,-23
22,3,112,23,26,-3
22,3,113,9,22,-13
22,3,114,10,9,1
22,3,115,15,18,-3
22,3,116,11,28,-17
22,3,117,11,23,-12
22,3,118,11,29,-18
22,3,119,6,14,-8
22,3,120,7,20,-13
22,3,121,14,16,-2
22,3,122,10,18,-8
22,3,123,10,17,-7
22,3,124,8,18,-10
22,3,125,9,15,-6
22,3,126,6,19,-13
22,3,127,6,28,-22
22,3,128,13,22,-9
22,3,129,17,8,9
22,3,130,5,11,-6
22,3,131,11,30,-19
22,3,132,4,15,-11
22,3,133,7,12,-5
22,3,134,5,17,-12
22,3,135,17,11,6
22,3,136,5,22,-17
22,3,137,16,18,-2
22,3,138,12,22,-10
22,3,139,11,25,-14
22,3,140,10,23,-13
22,3,141,7,20,-13
22,3,142,7,14,-7
22,3,143,11,28,-17
22,3,144,3,24,-21
22,3,145,7,21,-14
22,3,146,2,8,-6
22,3,147,8,20,-12
22,3,148,12,21,-9
22,3,149,11,26,-15
22,3,150,16,28,-12
22,3,151,7,21,-14
22,3,152,7,19,-12
22,3,153,7,12,-5
22,3,154,10,28,-18
22,3,155,15,17,-2
22,3,156,5,23,-18
22,3,157,12,14,-2
22,3,158,4,25,-21
22,3,159,15,31,-16
22,3,160,8,20,-12
22,3,161,10,24,-14
22,3,162,4,28,-24
22,3,163,18,18,0
22,3,164,9,13,-4
22,3,165,7,12,-5
22,3,166,18,24,-6
22,3,167,6,24,-18
22,3,168,11,13,-2
22,3,169,12,38,-26
22,3,170,7,9,-2
22,3,171,6,9,-3
22,3,172,8,16,-8
22,3,173,9,14,-5
22,3,174,20,18,2
22,3,175,7,13,-6
22,3,176,23,13,10
22,3,177,4,23,-19
22,3,178,7,21,-14
22,3,179,19,30,-11
22,3,180,7,11,-4
22,3,181,17,15,2
22,3,182,4,11,-7
22,3,183,6,10,-4
22,3,184,4,18,-14
22,3,185,14,18,-4
22,3,186,15,15,0
22,3,187,18,22,-4
22,3,188,19,24,-5
22,3,189,12,15,-3
22,3,190,15,29,-14
22,3,191,19,15,4
22,3,192,13,15,-2
22,3,193,10,22,-12
22,3,194,16,17,-1
22,3,195,12,11,1
22,3,196,8,22,-14
22,3,197,8,30,-22
22,3,198,2,12,-10
22,3,199,7,20,-13
22,3,200,6,17,-11
22,3,201,8,37,-29
22,3,202,10,23,-13
22,3,203,13,31,-18
22,3,204,9,14,-5
22,3,205,12,16,-4
22,3,206,8,18,-10
22,3,207,4,23,-19
22,3,208,7,10,-3
22,3,209,11,24,-13
22,3,210,5,23,-18
22,3,211,5,13,-8
22,3,212,9,12,-3
22,3,213,7,22,-15
22,3,214,5,8,-3
22,3,215,9,13,-4
22,3,216,8,18,-10
22,3,217,9,19,-10
22,3,218,9,18,-9
22,3,219,7,23,-16
22,3,220,15,26,-11
22,3,221,11,9,2
22,3,222,8,21,-13
22,3,223,8,37,-29
22,3,224,5,20,-15
22,3,225,6,14,-8
22,3,226,6,18,-12
22,3,227,9,19,-10
22,3,228,1,20,-19
22,3,229,6,19,-13
22,3,230,17,26,-9
22,3,231,12,18,-6
22,3,232,17,17,0
22,3,233,13,18,-5
22,3,234,5,13,-8
22,3,235,2,9,-7
22,3,236,7,30,-23
22,3,237,12,16,-4
22,3,238,9,16,-7
22,3,239,5,22,-17
22,3,240,7,5,2
22,3,241,19,18,1
22,3,242,5,15,-10
22,3,243,15,20,-5
22,3,244,12,20,-8
22,3,245,7,24,-17
22,3,246,15,18,-3
22,3,247,4,16,-12
22,3,248,7,8,-1
22,3,249,14,36,-22
22,3,250,10,17,-7
22,3,251,16,33,-17
22,3,252,5,17,-12
22,3,253,5,22,-17
22,3,254,14,21,-7
22,3,255,6,15,-9
22,3,256,8,23,-15
22,3,257,7,16,-9
22,3,258,6,16,-10
22,3,259,14,10,4
22,3,260,16,21,-5
22,3,261,13,12,1
22,3,262,9,23,-14
22,3,263,11,33,-22
22,3,264,10,17,-7
22,3,265,7,31,-24
22,3,266,13,27,-14
22,3,267,7,6,1
22,3,268,12,28,-16
22,3,269,2,11,-9
22,3,270,6,21,-15
22,3,271,11,20,-9
22,3,272,9,19,-10
22,3,273,12,11,1
22,3,274,7,21,-14
22,3,275,12,20,-8
22,3,276,4,6,-2
22,3,277,7,9,-2
22,3,278,6,21,-15
22,3,279,2,16,-14
22,3,280,12,16,-4
22,3,281,8,17,-9
22,3,282,9,14,-5
22,3,283,8,6,2
22,3,284,5,20,-15
22,3,285,6,24,-18
22,3,286,8,22,-14
22,3,287,12,23,-11
22,3,288,11,17,-6
22,3,289,5,7,-2
22,3,290,5,17,-12
22,3,291,13,31,-18
22,3,292,9,27,-18
22,3,293,11,18,-7
22,3,294,9,11,-2
22,3,295,17,26,-9
22,3,296,10,22,-12
22,3,297,12,19,-7
22,3,298,5,19,-14
22,3,299,15,22,-7
22,4,0,8,32,-24
22,4,1,5,22,-17
22,4,2,8,15,-7
22,4,3,15,22,-7
22,4,4,11,33,-22
22,4,5,12,23,-11
22,4,6,6,21,-15
22,4,7,12,15,-3
22,4,8,12,11,1
22,4,9,6,8,-2
22,4,10,19,33,-14
22,4,11,14,17,-3
22,4,12,3,15,-12
22,4,13,5,40,-35
22,4,14,4,16,-12
22,4,15,7,14,-7
22,4,16,6,27,-21
22,4,17,14,28,-14
22,4,18,12,33,-21
22,4,19,8,16,-8
22,4,20,8,7,1
22,4,21,14,23,-9
22,4,22,13,17,-4
22,4,23,5,9,-4
22,4,24,4,14,-10
22,4,25,6,7,-1
22,4,26,6,16,-10
22,4,27,6,21,-15
22,4,28,21,14,7
22,4,29,11,6,5
22,4,30,13,27,-14
22,4,31,11,27,-16
22,4,32,15,17,-2
22,4,33,4,17,-13
22,4,34,14,13,1
22,4,35,12,9,3
22,4,36,16,26,-10
22,4,37,9,17,-8
22,4,38,17,20,-3
22,4,39,7,21,-14
22,4,40,10,21,-11
22,4,41,14,24,-10
22,4,42,16,18,-2
22,4,43,11,14,-3
22,4,44,10,10,0
22,4,45,10,12,-2
22,4,46,6,14,-8
22,4,47,8,23,-15
22,4,48,9,19,-10
22,4,49,16,21,-5
22,4,50,8,28,-20
22,4,51,5,6,-1
22,4,52,5,18,-13
22,4,53,7,29,-22
22,4,54,10,13,-3
22,4,55,16,9,7
22,4,56,13,21,-8
22,4,57,20,18,2
22,4,58,8,21,-13
22,4,59,6,22,-16
22,4,60,5,13,-8
22,4,61,13,16,-3
22,4,62,4,26,-22
22,4,63,8,24,-16
22,4,64,8,10,-2
22,4,65,15,14,1
22,4,66,8,19,-11
22,4,67,11,11,0
22,4,68,12,22,-10
22,4,69,7,11,-4
22,4,70,19,21,-2
22,4,71,9,16,-7
22,4,72,9,9,0
22,4,73,6,20,-14
22,4,74,5,9,-4
22,4,75,8,23,-15
22,4,76,13,24,-11
22,4,77,17,30,-13
22,4,78,21,14,7
22,4,79,7,27,-20
22,4,80,3,22,-19
22,4,81,19,21,-2
22,4,82,15,17,-2
22,4,83,12,11,1
22,4,84,17,15,2
22,4,85,6,11,-5
22,4,86,10,15,-5
22,4,87,12,18,-6
22,4,88,7,16,-9
22,4,89,9,16,-7
22,4,90,10,17,-7
22,4,91,8,25,-17
22,4,92,5,28,-23
22,4,93,13,17,-4
22,4,94,13,25,-12
22,4,95,12,29,-17
22,4,96,12,22,-10
22,4,97,6,19,-13
22,4,98,4,4,0
22,4,99,14,23,-9
22,4,100,11,22,-11
22,4,101,10,32,-22
22,4,102,7,23,-16
22,4,103,5,8,-3
22,4,104,8,13,-5
22,4,105,6,16,-10
22,4,106,7,8,-1
22,4,107,15,34,-19
22,4,108,11,26,-15
22,4,109,6,11,-5
22,4,110,17,17,0
22,4,111,15,43,-28
22,4,112,14,27,-13
22,4,113,12,11,1
22,4,114,11,18,-7
22,4,115,9,27,-18
22,4,116,6,11,-5
22,4,117,13,24,-11
22,4,118,16,17,-1
22,4,119,20,22,-2
22,4,120,7,19,-12
22,4,121,16,34,-18
22,4,122,8,18,-10
22,4,123,12,25,-13
22,4,124,12,34,-22
22,4,125,10,18,-8
22,4,126,14,29,-15
22,4,127,2,21,-19
22,4,128,10,22,-12
22,4,129,3,24,-21
22,4,130,8,21,-13
22,4,131,6,22,-16
22,4,132,7,17,-10
22,4,133,16,20,-4
22,4,134,3,18,-15
22,4,135,12,16,-4
22,4,136,11,25,-14
22,4,137,9,11,-2
22,4,138,10,25,-15
22,4,139,17,29,-12
22,4,140,7,21,-14
22,4,141,11,16,-5
22,4,142,2,19,-17
22,4,143,8,15,-7
22,4,144,5,20,-15
22,4,145,0,11,-11
22,4,146,10,17,-7
22,4,147,5,11,-6
22,4,148,2,19,-17
22,4,149,9,15,-6
22,4,150,9,23,-14
22,4,151,12,11,1
22,4,152,10,25,-15
22,4,153,11,15,-4
22,4,154,17,16,1
22,4,155,5,21,-16
22,4,156,10,23,-13
22,4,157,8,13,-5
22,4,158,10,19,-9
22,4,159,8,24,-16
22,4,160,9,15,-6
22,4,161,9,22,-13
22,4,162,13,19,-6
22,4,163,12,15,-3
22,4,164,5,16,-11
22,4,165,8,16,-8
22,4,166,8,20,-12
22,4,167,7,17,-10
22,4,168,10,34,-24
22,4,169,22,28,-6
22,4,170,9,20,-11
22,4,171,8,13,-5
22,4,172,15,14,1
22,4,173,10,18,-8
22,4,174,10,30,-20
22,4,175,7,16,-9
22,4,176,13,24,-11
22,4,177,4,22,-18
22,4,178,6,19,-13
22,4,179,9,15,-6
22,4,180,6,19,-13
22,4,181,8,20,-12
22,4,182,17,25,-8
22,4,183,15,22,-7
22,4,184,6,18,-12
22,4,185,14,21,-7
22,4,186,14,20,-6
22,4,187,9,12,-3
22,4,188,15,22,-7
22,4,189,10,30,-20
22,4,190,12,18,-6
22,4,191,15,30,-15
22,4,192,8,26,-18
22,4,193,13,14,-1
22,4,194,5,15,-10
22,4,195,11,16,-5
22,4,196,5,10,-5
22,4,197,11,21,-10
22,4,198,13,12,1
22,4,199,9,24,-15
22,4,200,10,16,-6
22,4,201,7,19,-12
22,4,202,6,21,-15
22,4,203,6,26,-20
22,4,204,7,25,-18
22,4,205,4,29,-25
22,4,206,5,18,-13
22,4,207,1,4,-3
22,4,208,5,20,-15
22,4,209,11,22,-11
22,4,210,4,26,-22
22,4,211,4,13,-9
22,4,212,5,14,-9
22,4,213,6,11,-5
22,4,214,7,26,-19
22,4,215,11,20,-9
22,4,216,25,30,-5
22,4,217,6,19,-13
22,4,218,3,15,-12
22,4,219,11,26,-15
22,4,220,6,21,-15
22,4,221,13,32,-19
22,4,222,7,19,-12
22,4,223,7,26,-19
22,4,224,7,13,-6
22,4,225,9,15,-6
22,4,226,8,10,-2
22,4,227,13,14,-1
22,4,228,10,14,-4
22,4,229,8,20,-12
22,4,230,9,14,-5
22,4,231,9,14,-5
22,4,232,1,9,-8
22,4,233,13,31,-18
22,4,234,5,22,-17
22,4,235,8,14,-6
22,4,236,7,11,-4
22,4,237,12,12,0
22,4,238,11,33,-22
22,4,239,5,16,-11
22,4,240,9,14,-5
22,4,241,17,23,-6
22,4,242,14,25,-11
22,4,243,8,30,-22
22,4,244,15,12,3
22,4,245,8,33,-25
22,4,246,11,22,-11
22,4,247,12,8,4
22,4,248,1,15,-14
22,4,249,15,24,-9
22,4,250,12,27,-15
22,4,251,11,13,-2
22,4,252,10,17,-7
22,4,253,11,24,-13
22,4,254,6,12,-6
22,4,255,8,27,-19
22,4,256,12,21,-9
22,4,257,22,18,4
22,4,258,7,21,-14
22,4,259,11,26,-15
22,4,260,10,21,-11
22,4,261,8,21,-13
22,4,262,10,15,-5
22,4,263,12,18,-6
22,4,264,12,27,-15
22,4,265,6,12,-6
22,4,266,13,19,-6
22,4,267,9,6,3
22,4,268,11,18,-7
22,4,269,19,15,4
22,4,270,10,31,-21
22,4,271,10,9,1
22,4,272,13,21,-8
22,4,273,17,17,0
22,4,274,7,5,2
22,4,275,5,16,-11
22,4,276,10,28,-18
22,4,277,12,28,-16
22,4,278,8,22,-14
22,4,279,3,12,-9
22,4,280,11,42,-31
22,4,281,15,9,6
22,4,282,9,16,-7
22,4,283,8,19,-11
22,4,284,15,17,-2
22,4,285,2,22,-20
22,4,286,12,22,-10
22,4,287,9,22,-13
22,4,288,7,21,-14
22,4,289,16,8,8
22,4,290,20,32,-12
22,4,291,5,16,-11
22,4,292,4,19,-15
22,4,293,24,32,-8
22,4,294,5,13,-8
22,4,295,14,18,-4
22,4,296,12,22,-10
22,4,297,14,23,-9
22,4,298,5,19,-14
22,4,299,7,30,-23
22,5,0,12,22,-10
22,5,1,10,18,-8
22,5,2,10,22,-12
22,5,3,10,10,0
22,5,4,4,24,-20
22,5,5,11,26,-15
22,5,6,15,27,-12
22,5,7,11,16,-5
22,5,8,17,19,-2
22,5,9,11,36,-25
22,5,10,10,24,-14
22,5,11,10,16,-6
22,5,12,20,29,-9
22,5,13,7,14,-7
22,5,14,7,22,-15
22,5,15,7,15,-8
22,5,16,12,16,-4
22,5,17,10,19,-9
22,5,18,7,7,0
22,5,19,6,15,-9
22,5,20,10,13,-3
22,5,21,12,8,4
22,5,22,7,10,-3
22,5,23,7,11,-4
22,5,24,8,13,-5
22,5,25,7,15,-8
22,5,26,17,17,0
22,5,27,11,14,-3
22,5,28,2,6,-4
22,5,29,18,25,-7
22,5,30,4,22,-18
22,5,31,14,32,-18
22,5,32,18,37,-19
22,5,33,11,21,-10
22,5,34,6,27,-21
22,5,35,14,24,-10
22,5,36,14,25,-11
22,5,37,10,19,-9
22,5,38,11,19,-8
22,5,39,12,35,-23
22,5,40,19,18,1
22,5,41,12,27,-15
22,5,42,10,26,-16
22,5,43,5,13,-8
22,5,44,12,29,-17
22,5,45,6,8,-2
22,5,46,7,10,-3
22,5,47,6,16,-10
22,5,48,12,15,-3
22,5,49,10,19,-9
22,5,50,8,15,-7
22,5,51,9,21,-12
22,5,52,5,33,-28
22,5,53,9,17,-8
22,5,54,10,13,-3
22,5,55,9,16,-7
22,5,56,13,21,-8
22,5,57,8,26,-18
22,5,58,13,16,-3
22,5,59,3,13,-10
22,5,60,5,6,-1
22,5,61,6,23,-17
22,5,62,18,17,1
22,5,63,6,16,-10
22,5,64,8,19,-11
22,5,65,6,12,-6
22,5,66,10,25,-15
22,5,67,13,31,-18
22,5,68,19,29,-10
22,5,69,7,10,-3
22,5,70,13,38,-25
22,5,71,18,13,5
22,5,72,9,24,-15
22,5,73,9,20,-11
22,5,74,7,11,-4
22,5,75,7,5,2
22,5,76,11,21,-10
22,5,77,16,21,-5
22,5,78,13,24,-11
22,5,79,10,13,-3
22,5,80,20,19,1
22,5,81,10,24,-14
22,5,82,14,11,3
22,5,83,8,19,-11
22,5,84,10,20,-10
22,5,85,6,18,-12
22,5,86,9,29,-20
22,5,87,23,19,4
22,5,88,6,21,-15
22,5,89,11,23,-12
22,5,90,8,18,-10
22,5,91,12,19,-7
22,5,92,6,26,-20
22,5,93,15,24,-9
22,5,94,8,11,-3
22,5,95,5,19,-14
22,5,96,14,17,-3
22,5,97,9,24,-15
22,5,98,19,26,-7
22,5,99,15,9,6
22,5,100,16,21,-5
22,5,101,7,21,-14
22,5,102,9,31,-22
22,5,103,9,29,-20
22,5,104,13,13,0
22,5,105,8,17,-9
22,5,106,17,23,-6
22,5,107,5,9,-4
22,5,108,10,26,-16
22,5,109,14,15,-1
22,5,110,8,21,-13
22,5,111,12,28,-16
22,5,112,12,23,-11
22,5,113,10,8,2
22,5,114,13,25,-12
22,5,115,6,11,-5
22,5,116,9,18,-9
22,5,117,10,18,-8
22,5,118,18,12,6
22,5,119,14,13,1
22,5,120,14,16,-2
22,5,121,10,31,-21
22,5,122,15,26,-11
22,5,123,7,15,-8
22,5,124,13,23,-10
22,5,125,11,21,-10
22,5,126,8,15,-7
22,5,127,11,16,-5
22,5,128,9,32,-23
22,5,129,5,11,-6
22,5,130,6,30,-24
22,5,131,12,25,-13
22,5,132,18,37,-19
22,5,133,9,24,-15
22,5,134,5,20,-15
22,5,135,15,21,-6
22,5,136,11,31,-20
22,5,137,21,16,5
22,5,138,9,10,-1
22,5,139,21,28,-7
22,5,140,11,13,-2
22,5,141,15,35,-20
22,5,142,6,17,-11
22,5,143,15,14,1
22,5,144,10,24,-14
22,5,145,9,16,-7
22,5,146,9,25,-16
22,5,147,4,10,-6
22,5,148,7,14,-7
22,5,149,10,24,-14
22,5,150,6,15,-9
22,5,151,8,22,-14
22,5,152,3,9,-6
22,5,153,6,24,-18
22,5,154,11,13,-2
22,5,155,5,34,-29
22,5,156,13,11,2
22,5,157,13,24,-11
22,5,158,5,11,-6
22,5,159,9,9,0
22,5,160,9,16,-7
22,5,161,9,14,-5
22,5,162,4,18,-14
22,5,163,11,4,7
22,5,164,16,14,2
22,5,165,14,15,-1
22,5,166,10,25,-15
22,5,167,6,17,-11
22,5,168,6,13,-7
22,5,169,19,31,-12
22,5,170,13,13,0
22,5,171,6,20,-14
22,5,172,12,12,0
22,5,173,13,22,-9
22,5,174,12,22,-10
22,5,175,14,13,1
22,5,176,19,11,8
22,5,177,16,26,-10
22,5,178,15,17,-2
22,5,179,8,23,-15
22,5,180,1,15,-14
22,5,181,8,36,-28
22,5,182,7,11,-4
22,5,183,12,25,-13
22,5,184,12,14,-2
22,5,185,8,23,-15
22,5,186,4,11,-7
22,5,187,10,31,-21
22,5,188,12,15,-3
22,5,189,8,19,-11
22,5,190,9,22,-13
22,5,191,18,23,-5
22,5,192,9,24,-15
22,5,193,4,16,-12
22,5,194,14,25,-11
22,5,195,10,22,-12
22,5,196,8,48,-40
22,5,197,2,13,-11
22,5,198,12,30,-18
22,5,199,11,11,0
22,5,200,5,16,-11
22,5,201,2,19,-17
22,5,202,12,21,-9
22,5,203,18,22,-4
22,5,204,8,21,-13
22,5,205,14,15,-1
22,5,206,10,12,-2
22,5,207,17,15,2
22,5,208,14,33,-19
22,5,209,15,10,5
22,5,210,2,13,-11
22,5,211,13,37,-24
22,5,212,13,16,-3
22,5,213,6,6,0
22,5,214,7,36,-29
22,5,215,23,43,-20
22,5,216,12,31,-19
22,5,217,8,13,-5
22,5,218,26,23,3
22,5,219,11,11,0
22,5,220,16,12,4
22,5,221,7,35,-28
22,5,222,12,21,-9
22,5,223,10,16,-6
22,5,224,7,23,-16
22,5,225,15,19,-4
22,5,226,15,19,-4
22,5,227,19,17,2
22,5,228,13,12,1
22,5,229,3,13,-10
22,5,230,6,21,-15
22,5,231,16,18,-2
22,5,232,14,12,2
22,5,233,11,19,-8
22,5,234,9,14,-5
22,5,235,23,33,-10
22,5,236,12,18,-6
22,5,237,14,20,-6
22,5,238,10,11,-1
22,5,239,7,16,-9
22,5,240,13,33,-20
22,5,241,2,20,-18
22,5,242,12,25,-13
22,5,243,10,25,-15
22,5,244,13,40,-27
22,5,245,16,24,-8
22,5,246,8,26,-18
22,5,247,10,25,-15
22,5,248,8,12,-4
22,5,249,11,13,-2
22,5,250,8,24,-16
22,5,251,10,22,-12
22,5,252,8,18,-10
22,5,253,15,28,-13
22,5,254,9,21,-12
22,5,255,12,10,2
22,5,256,8,18,-10
22,5,257,5,25,-20
22,5,258,7,12,-5
22,5,259,3,11,-8
22,5,260,4,18,-14
22,5,261,11,25,-14
22,5,262,19,19,0
22,5,263,5,9,-4
22,5,264,7,22,-15
22,5,265,9,31,-22
22,5,266,11,22,-11
22,5,267,7,23,-16
22,5,268,15,28,-13
22,5,269,21,20,1
22,5,270,12,23,-11
22,5,271,7,12,-5
22,5,272,4,11,-7
22,5,273,11,27,-16
22,5,274,8,27,-19
22,5,275,6,14,-8
22,5,276,8,17,-9
22,5,277,6,13,-7
22,5,278,4,14,-10
22,5,279,9,14,-5
22,5,280,10,19,-9
22,5,281,13,20,-7
22,5,282,10,25,-15
22,5,283,14,22,-8
22,5,284,17,24,-7
22,5,285,9,18,-9
22,5,286,5,26,-21
22,5,287,7,9,-2
22,5,288,14,16,-2
22,5,289,3,7,-4
22,5,290,15,23,-8
22,5,291,16,20,-4
22,5,292,8,15,-7
22,5,293,7,10,-3
22,5,294,12,22,-10
22,5,295,2,9,-7
22,5,296,14,29,-15
22,5,297,15,32,-17
22,5,298,9,24,-15
22,5,299,8,22,-14
22,6,0,9,20,-11
22,6,1,14,29,-15
22,6,2,13,20,-7
22,6,3,16,20,-4
22,6,4,8,15,-7
22,6,5,6,25,-19
22,6,6,11,12,-1
22,6,7,7,23,-16
22,6,8,8,25,-17
22,6,9,2,5,-3
22,6,10,7,17,-10
22,6,11,6,21,-15
22,6,12,17,19,-2
22,6,13,14,21,-7
22,6,14,7,26,-19
22,6,15,11,21,-10
22,6,16,15,14,1
22,6,17,19,17,2
22,6,18,10,20,-10
22,6,19,15,22,-7
22,6,20,7,15,-8
22,6,21,10,39,-29
22,6,22,10,27,-17
22,6,23,4,11,-7
22,6,24,8,10,-2
22,6,25,8,16,-8
22,6,26,12,21,-9
22,6,27,7,11,-4
22,6,28,3,23,-20
22,6,29,20,35,-15
22,6,30,14,21,-7
22,6,31,9,34,-25
22,6,32,12,32,-20
22,6,33,5,19,-14
22,6,34,13,18,-5
22,6,35,21,19,2
22,6,36,9,21,-12
22,6,37,7,10,-3
22,6,38,7,27,-20
22,6,39,10,11,-1
22,6,40,17,20,-3
22,6,41,16,39,-23
22,6,42,14,25,-11
22,6,43,10,29,-19
22,6,44,12,18,-6
22,6,45,11,20,-9
22,6,46,16,35,-19
22,6,47,15,29,-14
22,6,48,8,11,-3
22,6,49,15,18,-3
22,6,50,7,20,-13
22,6,51,18,22,-4
22,6,52,17,11,6
22,6,53,7,16,-9
22,6,54,2,24,-22
22,6,55,6,16,-10
22,6,56,6,24,-18
22,6,57,7,21,-14
22,6,58,4,11,-7
22,6,59,9,21,-12
22,6,60,13,25,-12
22,6,61,11,26,-15
22,6,62,14,33,-19
22,6,63,8,21,-13
22,6,64,8,27,-19
22,6,65,15,20,-5
22,6,66,15,16,-1
22,6,67,3,15,-12
22,6,68,4,9,-5
22,6,69,5,34,-29
22,6,70,11,14,-3
22,6,71,16,19,-3
22,6,72,16,19,-3
22,6,73,4,12,-8
22,6,74,7,12,-5
22,6,75,7,9,-2
22,6,76,17,23,-6
22,6,77,8,17,-9
22,6,78,10,29,-19
22,6,79,13,15,-2
22,6,80,19,21,-2
22,6,81,4,16,-12
22,6,82,7,21,-14
22,6,83,12,30,-18
22,6,84,21,12,9
22,6,85,16,18,-2
22,6,86,18,18,0
22,6,87,15,23,-8
22,6,88,10,10,0
22,6,89,4,9,-5
22,6,90,10,21,-11
22,6,91,17,22,-5
22,6,92,30,31,-1
22,6,93,9,19,-10
22,6,94,10,14,-4
22,6,95,17,25,-8
22,6,96,5,18,-13
22,6,97,8,20,-12
22,6,98,6,25,-19
22,6,99,6,20,-14
22,6,100,8,13,-5
22,6,101,8,14,-6
22,6,102,2,15,-13
22,6,103,8,36,-28
22,6,104,12,22,-10
22,6,105,6,19,-13
22,6,106,6,35,-29
22,6,107,15,26,-11
22,6,108,5,14,-9
22,6,109,14,24,-10
22,6,110,2,18,-16
22,6,111,11,18,-7
22,6,112,14,28,-14
22,6,113,3,19,-16
22,6,114,6,16,-10
22,6,115,16,19,-3
22,6,116,9,17,-8
22,6,117,6,15,-9
22,6,118,10,9,1
22,6,119,4,9,-5
22,6,120,17,21,-4
22,6,121,11,13,-2
22,6,122,17,20,-3
22,6,123,18,24,-6
22,6,124,6,8,-2
22,6,125,11,14,-3
22,6,126,16,32,-16
22,6,127,21,26,-5
22,6,128,8,24,-16
22,6,129,4,21,-17
22,6,130,15,23,-8
22,6,131,9,11,-2
22,6,132,17,20,-3
22,6,133,6,25,-19
22,6,134,4,13,-9
22,6,135,20,25,-5
22,6,136,3,16,-13
22,6,137,6,15,-9
22,6,138,16,24,-8
22,6,139,7,12,-5
22,6,140,12,18,-6
22,6,141,6,21,-15
22,6,142,7,6,1
22,6,143,10,22,-12
22,6,144,14,24,-10
22,6,145,12,19,-7
22,6,146,11,20,-9
22,6,147,8,9,-1
22,6,148,10,14,-4
22,6,149,10,16,-6
22,6,150,8,25,-17
22,6,151,12,34,-22
22,6,152,9,8,1
22,6,153,3,27,-24
22,6,154,13,4,9
22,6,155,18,26,-8
22,6,156,15,10,5
22,6,157,3,7,-4
22,6,158,11,8,3
22,6,159,11,16,-5
22,6,160,11,14,-3
22,6,161,8,11,-3
22,6,162,11,43,-32
22,6,163,10,13,-3
22,6,164,5,16,-11
22,6,165,9,24,-15
22,6,166,6,14,-8
22,6,167,7,28,-21
22,6,168,13,7,6
22,6,169,9,21,-12
22,6,170,7,26,-19
22,6,171,5,7,-2
22,6,172,9,22,-13
22,6,173,14,15,-1
22,6,174,16,14,2
22,6,175,15,19,-4
22,6,176,8,20,-12
22,6,177,16,19,-3
22,6,178,11,14,-3
22,6,179,10,21,-11
22,6,180,18,18,0
22,6,181,9,17,-8
22,6,182,5,19,-14
22,6,183,16,39,-23
22,6,184,14,27,-13
22,6,185,9,32,-23
22,6,186,18,26,-8
22,6,187,9,16,-7
22,6,188,14,26,-12
22,6,189,6,15,-9
22,6,190,7,19,-12
22,6,191,6,13,-7
22,6,192,6,22,-16
22,6,193,11,10,1
22,6,194,12,18,-6
22,6,195,12,25,-13
22,6,196,11,22,-11
22,6,197,11,38,-27
22,6,198,10,17,-7
22,6,199,14,5,9
22,6,200,6,32,-26
22,6,201,5,10,-5
22,6,202,6,29,-23
22,6,203,8,21,-13
22,6,204,7,7,0
22,6,205,8,31,-23
22,6,206,9,24,-15
22,6,207,16,26,-10
22,6,208,7,13,-6
22,6,209,11,10,1
22,6,210,13,24,-11
22,6,211,5,19,-14
22,6,212,9,30,-21
22,6,213,7,13,-6
22,6,214,5,16,-11
22,6,215,13,17,-4
22,6,216,10,30,-20
22,6,217,11,10,1
22,6,218,7,21,-14
22,6,219,7,32,-25
22,6,220,10,22,-12
22,6,221,15,24,-9
22,6,222,15,20,-5
22,6,223,5,25,-20
22,6,224,12,13,-1
22,6,225,11,25,-14
22,6,226,24,20,4
22,6,227,16,26,-10
22,6,228,5,24,-19
22,6,229,4,20,-16
22,6,230,19,26,-7
22,6,231,25,24,1
22,6,232,16,35,-19
22,6,233,16,21,-5
22,6,234,13,14,-1
22,6,235,6,10,-4
22,6,236,6,20,-14
22,6,237,15,18,-3
22,6,238,17,25,-8
22,6,239,7,27,-20
22,6,240,13,49,-36
22,6,241,8,22,-14
22,6,242,16,14,2
22,6,243,15,20,-5
22,6,244,13,25,-12
22,6,245,13,26,-13
22,6,246,12,31,-19
22,6,247,17,7,10
22,6,248,13,8,5
22,6,249,4,28,-24
22,6,250,7,14,-7
22,6,251,4,8,-4
22,6,252,15,25,-10
22,6,253,15,22,-7
22,6,254,8,15,-7
22,6,255,13,5,8
22,6,256,11,20,-9
22,6,257,9,20,-11
22,6,258,16,18,-2
22,6,259,21,19,2
22,6,260,12,11,1
22,6,261,10,14,-4
22,6,262,16,11,5
22,6,263,14,39,-25
22,6,264,17,21,-4
22,6,265,9,13,-4
22,6,266,4,16,-12
22,6,267,10,19,-9
22,6,268,11,11,0
22,6,269,18,15,3
22,6,270,7,10,-3
22,6,271,12,11,1
22,6,272,9,25,-16
22,6,273,10,26,-16
22,6,274,16,29,-13
22,6,275,8,17,-9
22,6,276,8,28,-20
22,6,277,5,27,-22
22,6,278,10,12,-2
22,6,279,10,21,-11
22,6,280,10,23,-13
22,6,281,4,21,-17
22,6,282,12,18,-6
22,6,283,12,22,-10
22,6,284,8,29,-21
22,6,285,13,16,-3
22,6,286,10,18,-8
22,6,287,5,25,-20
22,6,288,14,33,-19
22,6,289,9,24,-15
22,6,290,15,9,6
22,6,291,12,25,-13
22,6,292,15,12,3
22,6,293,4,30,-26
22,6,294,9,23,-14
22,6,295,9,24,-15
22,6,296,12,23,-11
22,6,297,5,25,-20
22,6,298,5,10,-5
22,6,299,10,25,-15
22,7,0,20,21,-1
22,7,1,6,19,-13
22,7,2,19,19,0
22,7,3,12,16,-4
22,7,4,9,17,-8
22,7,5,2,17,-15
22,7,6,10,17,-7
22,7,7,11,16,-5
22,7,8,11,27,-16
22,7,9,7,11,-4
22,7,10,20,18,2
22,7,11,10,27,-17
22,7,12,12,25,-13
22,7,13,11,18,-7
22,7,14,9,30,-21
22,7,15,17,17,0
22,7,16,22,36,-14
22,7,17,12,14,-2
22,7,18,10,24,-14
22,7,19,21,23,-2
22,7,20,8,15,-7
22,7,21,14,38,-24
22,7,22,19,27,-8
22,7,23,27,23,4
22,7,24,11,24,-13
22,7,25,12,15,-3
22,7,26,12,24,-12
22,7,27,6,12,-6
22,7,28,15,16,-1
22,7,29,12,20,-8
22,7,30,8,16,-8
22,7,31,4,27,-23
22,7,32,10,16,-6
22,7,33,13,17,-4
22,7,34,15,14,1
22,7,35,7,19,-12
22,7,36,16,23,-7
22,7,37,18,21,-3
22,7,38,14,30,-16
22,7,39,7,12,-5
22,7,40,3,11,-8
22,7,41,9,20,-11
22,7,42,13,36,-23
22,7,43,12,23,-11
22,7,44,21,32,-11
22,7,45,16,23,-7
22,7,46,6,7,-1
22,7,47,13,24,-11
22,7,48,7,20,-13
22,7,49,16,34,-18
22,7,50,16,19,-3
22,7,51,10,6,4
22,7,52,19,10,9
22,7,53,6,25,-19
22,7,54,7,22,-15
22,7,55,14,25,-11
22,7,56,8,25,-17
22,7,57,17,21,-4
22,7,58,16,19,-3
22,7,59,19,30,-11
22,7,60,10,10,0
22,7,61,11,20,-9
22,7,62,20,12,8
22,7,63,5,14,-9
22,7,64,8,19,-11
22,7,65,8,28,-20
22,7,66,12,15,-3
22,7,67,5,8,-3
22,7,68,20,12,8
22,7,69,20,23,-3
22,7,70,10,22,-12
22,7,71,3,16,-13
22,7,72,11,24,-13
22,7,73,18,21,-3
22,7,74,9,21,-12
22,7,75,10,23,-13
22,7,76,5,11,-6
22,7,77,10,11,-1
22,7,78,10,32,-22
22,7,79,8,18,-10
22,7,80,9,26,-17
22,7,81,18,19,-1
22,7,82,8,18,-10
22,7,83,6,15,-9
22,7,84,16,25,-9
22,7,85,19,26,-7
22,7,86,6,15,-9
22,7,87,9,16,-7
22,7,88,9,19,-10
22,7,89,15,20,-5
22,7,90,13,25,-12
22,7,91,17,25,-8
22,7,92,11,11,0
22,7,93,16,29,-13
22,7,94,9,6,3
22,7,95,2,7,-5
22,7,96,5,24,-19
22,7,97,5,17,-12
22,7,98,10,24,-14
22,7,99,10,27,-17
22,7,100,6,15,-9
22,7,101,4,25,-21
22,7,102,9,11,-2
22,7,103,14,15,-1
22,7,104,19,25,-6
22,7,105,12,14,-2
22,7,106,15,20,-5
22,7,107,8,26,-18
22,7,108,10,14,-4
22,7,109,16,13,3
22,7,110,7,27,-20
22,7,111,12,17,-5
22,7,112,16,26,-10
22,7,113,11,12,-1
22,7,114,11,15,-4
22,7,115,14,12,2
22,7,116,14,21,-7
22,7,117,24,20,4
22,7,118,3,23,-20
22,7,119,17,21,-4
22,7,120,7,19,-12
22,7,121,11,16,-5
22,7,122,12,17,-5
22,7,123,12,20,-8
22,7,124,10,16,-6
22,7,125,3,10,-7
22,7,126,12,24,-12
22,7,127,13,23,-10
22,7,128,14,35,-21
22,7,129,15,16,-1
22,7,130,8,24,-16
22,7,131,12,8,4
22,7,132,7,15,-8
22,7,133,10,11,-1
22,7,134,6,24,-18
22,7,135,7,24,-17
22,7,136,4,15,-11
22,7,137,9,33,-24
22,7,138,15,30,-15
22,7,139,12,13,-1
22,7,140,13,29,-16
22,7,141,11,23,-12
22,7,142,17,30,-13
22,7,143,7,22,-15
22,7,144,9,19,-10
22,7,145,12,28,-16
22,7,146,20,25,-5
22,7,147,11,17,-6
22,7,148,18,21,-3
22,7,149,14,25,-11
22,7,150,12,35,-23
22,7,151,22,19,3
22,7,152,12,25,-13
22,7,153,20,20,0
22,7,154,16,18,-2
22,7,155,11,20,-9
22,7,156,8,15,-7
22,7,157,9,18,-9
22,7,158,8,31,-23
22,7,159,16,18,-2
22,7,160,7,14,-7
22,7,161,10,16,-6
22,7,162,6,31,-25
22,7,163,15,14,1
22,7,164,4,10,-6
22,7,165,4,19,-15
22,7,166,16,25,-9
22,7,167,10,26,-16
22,7,168,8,12,-4
22,7,169,14,28,-14
22,7,170,21,4,17
22,7,171,7,19,-12
22,7,172,12,16,-4
22,7,173,8,13,-5
22,7,174,14,24,-10
22,7,175,8,17,-9
22,7,176,18,22,-4
22,7,177,13,19,-6
22,7,178,7,9,-2
22,7,179,10,42,-32
22,7,180,10,24,-14
22,7,181,15,16,-1
22,7,182,3,8,-5
22,7,183,20,27,-7
22,7,184,10,18,-8
22,7,185,12,16,-4
22,7,186,17,33,-16
22,7,187,6,19,-13
22,7,188,10,11,-1
22,7,189,12,21,-9
22,7,190,14,24,-10
22,7,191,17,17,0
22,7,192,9,23,-14
22,7,193,11,24,-13
22,7,194,18,17,1
22,7,195,18,14,4
22,7,196,14,18,-4
22,7,197,3,19,-16
22,7,198,12,21,-9
22,7,199,10,19,-9
22,7,200,8,13,-5
22,7,201,8,19,-11
22,7,202,11,9,2
22,7,203,6,17,-11
22,7,204,19,15,4
22,7,205,12,13,-1
22,7,206,12,32,-20
22,7,207,15,22,-7
22,7,208,12,20,-8
22,7,209,25,28,-3
22,7,210,19,34,-15
22,7,211,10,18,-8
22,7,212,22,23,-1
22,7,213,18,18,0
22,7,214,11,22,-11
22,7,215,17,17,0
22,7,216,7,19,-12
22,7,217,16,13,3
22,7,218,15,18,-3
22,7,219,8,14,-6
22,7,220,1,14,-13
22,7,221,9,9,0
22,7,222,9,9,0
22,7,223,16,16,0
22,7,224,7,25,-18
22,7,225,12,23,-11
22,7,226,11,32,-21
22,7,227,13,24,-11
22,7,228,20,31,-11
22,7,229,11,33,-22
22,7,230,5,10,-5
22,7,231,7,7,0
22,7,232,4,19,-15
22,7,233,5,13,-8
22,7,234,10,13,-3
22,7,235,10,21,-11
22,7,236,17,26,-9
22,7,237,13,15,-2
22,7,238,9,17,-8
22,7,239,13,17,-4
22,7,240,9,12,-3
22,7,241,13,11,2
22,7,242,11,18,-7
22,7,243,7,9,-2
22,7,244,5,18,-13
22,7,245,11,8,3
22,7,246,9,21,-12
22,7,247,9,24,-15
22,7,248,7,18,-11
22,7,249,9,18,-9
22,7,250,17,33,-16
22,7,251,9,23,-14
22,7,252,12,11,1
22,7,253,19,20,-1
22,7,254,17,12,5
22,7,255,7,16,-9
22,7,256,19,27,-8
22,7,257,3,11,-8
22,7,258,7,21,-14
22,7,259,13,34,-21
22,7,260,13,20,-7
22,7,261,8,14,-6
22,7,262,12,11,1
22,7,263,13,21,-8
22,7,264,14,23,-9
22,7,265,11,22,-11
22,7,266,19,16,3
22,7,267,15,21,-6
22,7,268,10,14,-4
22,7,269,11,16,-5
22,7,270,15,13,2
22,7,271,5,9,-4
22,7,272,7,20,-13
22,7,273,20,30,-10
22,7,274,16,21,-5
22,7,275,9,14,-5
22,7,276,10,24,-14
22,7,277,3,25,-22
22,7,278,5,18,-13
22,7,279,11,19,-8
22,7,280,20,23,-3
22,7,281,12,26,-14
22,7,282,14,29,-15
22,7,283,14,10,4
22,7,284,14,20,-6
22,7,285,10,30,-20
22,7,286,12,20,-8
22,7,287,8,15,-7
22,7,288,13,27,-14
22,7,289,13,28,-15
22,7,290,16,40,-24
22,7,291,19,25,-6
22,7,292,14,28,-14
22,7,293,9,19,-10
22,7,294,11,26,-15
22,7,295,14,23,-9
22,7,296,10,24,-14
22,7,297,8,14,-6
22,7,298,9,16,-7
22,7,299,8,8,0
22,8,0,12,13,-1
22,8,1,20,28,-8
22,8,2,22,30,-8
22,8,3,10,15,-5
22,8,4,16,31,-15
22,8,5,10,21,-11
22,8,6,8,22,-14
22,8,7,10,19,-9
22,8,8,20,18,2
22,8,9,17,23,-6
22,8,10,6,12,-6
22,8,11,11,18,-7
22,8,12,3,18,-15
22,8,13,8,23,-15
22,8,14,8,13,-5
22,8,15,16,25,-9
22,8,16,4,18,-14
22,8,17,17,14,3
22,8,18,11,14,-3
22,8,19,12,16,-4
22,8,20,10,24,-14
22,8,21,10,21,-11
22,8,22,5,6,-1
22,8,23,9,14,-5
22,8,24,18,18,0
22,8,25,9,20,-11
22,8,26,12,21,-9
22,8,27,14,19,-5
22,8,28,10,34,-24
22,8,29,16,18,-2
22,8,30,8,15,-7
22,8,31,10,22,-12
22,8,32,9,13,-4
22,8,33,13,16,-3
22,8,34,7,17,-10
22,8,35,13,26,-13
22,8,36,22,23,-1
22,8,37,13,16,-3
22,8,38,16,25,-9
22,8,39,18,11,7
22,8,40,11,17,-6
22,8,41,9,16,-7
22,8,42,12,17,-5
22,8,43,7,11,-4
22,8,44,5,14,-9
22,8,45,10,13,-3
22,8,46,11,13,-2
22,8,47,13,31,-18
22,8,48,5,7,-2
22,8,49,23,32,-9
22,8,50,10,23,-13
22,8,51,12,19,-7
22,8,52,14,16,-2
22,8,53,8,27,-19
22,8,54,8,11,-3
22,8,55,19,17,2
22,8,56,0,13,-13
22,8,57,10,15,-5
22,8,58,29,28,1
22,8,59,18,26,-8
22,8,60,14,23,-9
22,8,61,12,8,4
22,8,62,8,22,-14
22,8,63,10,23,-13
22,8,64,6,16,-10
22,8,65,10,19,-9
22,8,66,14,25,-11
22,8,67,13,15,-2
22,8,68,9,24,-15
22,8,69,6,16,-10
22,8,70,4,10,-6
22,8,71,8,14,-6
22,8,72,11,16,-5
22,8,73,21,32,-11
22,8,74,13,16,-3
22,8,75,13,22,-9
22,8,76,16,12,4
22,8,77,7,17,-10
22,8,78,17,21,-4
22,8,79,14,31,-17
22,8,80,16,41,-25
22,8,81,12,11,1
22,8,82,8,14,-6
22,8,83,19,16,3
22,8,84,10,16,-6
22,8,85,20,16,4
22,8,86,3,6,-3
22,8,87,6,24,-18
22,8,88,7,18,-11
22,8,89,8,17,-9
22,8,90,10,20,-10
22,8,91,19,20,-1
22,8,92,16,12,4
22,8,93,11,27,-16
22,8,94,8,26,-18
22,8,95,10,22,-12
22,8,96,17,25,-8
22,8,97,10,27,-17
22,8,98,10,21,-11
22,8,99,10,11,-1
22,8,100,12,20,-8
22,8,101,16,24,-8
22,8,102,8,25,-17
22,8,103,8,19,-11
22,8,104,8,21,-13
22,8,105,3,18,-15
22,8,106,8,9,-1
22,8,107,5,18,-13
22,8,108,12,8,4
22,8,109,14,19,-5
22,8,110,10,14,-4
22,8,111,5,14,-9
22,8,112,14,8,6
22,8,113,16,30,-14
22,8,114,14,20,-6
22,8,115,13,27,-14
22,8,116,5,44,-39
22,8,117,12,20,-8
22,8,118,16,26,-10
22,8,119,12,14,-2
22,8,120,6,11,-5
22,8,121,8,14,-6
22,8,122,16,16,0
22,8,123,7,23,-16
22,8,124,13,29,-16
22,8,125,19,16,3
22,8,126,6,10,-4
22,8,127,17,20,-3
22,8,128,7,22,-15
22,8,129,7,20,-13
22,8,130,10,28,-18
22,8,131,12,31,-19
22,8,132,19,32,-13
22,8,133,6,14,-8
22,8,134,12,29,-17
22,8,135,13,18,-5
22,8,136,14,12,2
22,8,137,16,34,-18
22,8,138,9,14,-5
22,8,139,10,21,-11
22,8,140,15,24,-9
22,8,141,13,11,2
22,8,142,16,36,-20
22,8,143,24,26,-2
22,8,144,10,28,-18
22,8,145,7,3,4
22,8,146,16,20,-4
22,8,147,12,19,-7
22,8,148,8,12,-4
22,8,149,10,22,-12
22,8,150,4,11,-7
22,8,151,10,12,-2
22,8,152,5,13,-8
22,8,153,10,19,-9
22,8,154,7,23,-16
22,8,155,11,14,-3
22,8,156,9,11,-2
22,8,157,4,24,-20
22,8,158,12,21,-9
22,8,159,9,28,-19
22,8,160,10,15,-5
22,8,161,11,21,-10
22,8,162,17,19,-2
22,8,163,4,11,-7
22,8,164,6,18,-12
22,8,165,11,23,-12
22,8,166,12,36,-24
22,8,167,17,10,7
22,8,168,7,18,-11
22,8,169,5,15,-10
22,8,170,19,24,-5
22,8,171,15,21,-6
22,8,172,4,20,-16
22,8,173,19,18,1
22,8,174,9,19,-10
22,8,175,5,14,-9
22,8,176,16,30,-14
22,8,177,16,26,-10
22,8,178,12,23,-11
22,8,179,19,20,-1
22,8,180,7,11,-4
22,8,181,8,12,-4
22,8,182,13,35,-22
22,8,183,15,18,-3
22,8,184,7,11,-4
22,8,185,12,20,-8
22,8,186,15,28,-13
22,8,187,18,15,3
22,8,188,8,12,-4
22,8,189,16,18,-2
22,8,190,5,6,-1
22,8,191,7,4,3
22,8,192,7,23,-16
22,8,193,11,23,-12
22,8,194,17,24,-7
22,8,195,20,18,2
22,8,196,9,35,-26
22,8,197,12,22,-10
22,8,198,24,30,-6
22,8,199,16,17,-1
22,8,200,9,20,-11
22,8,201,15,15,0
22,8,202,15,15,0
22,8,203,18,9,9
22,8,204,12,11,1
22,8,205,8,14,-6
22,8,206,14,40,-26
22,8,207,7,9,-2
22,8,208,8,17,-9
22,8,209,29,38,-9
22,8,210,16,13,3
22,8,211,21,21,0
22,8,212,14,8,6
22,8,213,4,18,-14
22,8,214,15,20,-5
22,8,215,6,19,-13
22,8,216,11,16,-5
22,8,217,9,22,-13
22,8,218,6,17,-11
22,8,219,12,18,-6
22,8,220,12,21,-9
22,8,221,8,15,-7
22,8,222,29,22,7
22,8,223,5,22,-17
22,8,224,22,23,-1
22,8,225,4,28,-24
22,8,226,13,29,-16
22,8,227,11,32,-21
22,8,228,8,21,-13
22,8,229,8,7,1
22,8,230,15,16,-1
22,8,231,7,17,-10
22,8,232,6,21,-15
22,8,233,3,21,-18
22,8,234,6,30,-24
22,8,235,16,26,-10
22,8,236,17,29,-12
22,8,237,13,13,0
22,8,238,9,45,-36
22,8,239,6,28,-22
22,8,240,7,14,-7
22,8,241,7,8,-1
22,8,242,10,10,0
22,8,243,12,21,-9
22,8,244,19,18,1
22,8,245,2,19,-17
22,8,246,7,30,-23
22,8,247,9,18,-9
22,8,248,28,29,-1
22,8,249,2,11,-9
22,8,250,10,23,-13
22,8,251,7,30,-23
22,8,252,10,34,-24
22,8,253,10,13,-3
22,8,254,17,16,1
22,8,255,14,11,3
22,8,256,8,48,-40
22,8,257,6,25,-19
22,8,258,21,24,-3
22,8,259,14,29,-15
22,8,260,11,21,-10
22,8,261,10,19,-9
22,8,262,11,24,-13
22,8,263,19,17,2
22,8,264,19,20,-1
22,8,265,14,21,-7
22,8,266,11,10,1
22,8,267,16,21,-5
22,8,268,7,12,-5
22,8,269,6,26,-20
22,8,270,9,23,-14
22,8,271,12,18,-6
22,8,272,10,16,-6
22,8,273,12,31,-19
22,8,274,17,27,-10
22,8,275,13,20,-7
22,8,276,14,22,-8
22,8,277,26,19,7
22,8,278,17,23,-6
22,8,279,12,27,-15
22,8,280,6,10,-4
22,8,281,14,10,4
22,8,282,16,21,-5
22,8,283,5,18,-13
22,8,284,7,8,-1
22,8,285,19,22,-3
22,8,286,10,28,-18
22,8,287,9,12,-3
22,8,288,10,22,-12
22,8,289,6,21,-15
22,8,290,3,13,-10
22,8,291,27,14,13
22,8,292,18,23,-5
22,8,293,8,14,-6
22,8,294,7,18,-11
22,8,295,13,31,-18
22,8,296,10,12,-2
22,8,297,11,21,-10
22,8,298,10,23,-13
22,8,299,10,23,-13
22,9,0,19,22,-3
22,9,1,9,30,-21
22,9,2,8,13,-5
22,9,3,6,21,-15
22,9,4,16,12,4
22,9,5,15,11,4
22,9,6,28,31,-3
22,9,7,7,12,-5
22,9,8,7,11,-4
22,9,9,18,20,-2
22,9,10,18,15,3
22,9,11,5,23,-18
22,9,12,12,17,-5
22,9,13,7,7,0
22,9,14,14,31,-17
22,9,15,12,18,-6
22,9,16,12,16,-4
22,9,17,20,20,0
22,9,18,14,16,-2
22,9,19,14,32,-18
22,9,20,15,32,-17
22,9,21,6,19,-13
22,9,22,11,28,-17
22,9,23,10,19,-9
22,9,24,10,21,-11
22,9,25,11,35,-24
22,9,26,16,17,-1
22,9,27,12,20,-8
22,9,28,14,26,-12
22,9,29,6,19,-13
22,9,30,11,22,-11
22,9,31,16,11,5
22,9,32,8,9,-1
22,9,33,14,11,3
22,9,34,9,24,-15
22,9,35,6,21,-15
22,9,36,7,20,-13
22,9,37,10,8,2
22,9,38,20,20,0
22,9,39,12,33,-21
22,9,40,10,12,-2
22,9,41,2,9,-7
22,9,42,15,30,-15
22,9,43,8,17,-9
22,9,44,11,16,-5
22,9,45,14,27,-13
22,9,46,18,28,-10
22,9,47,12,22,-10
22,9,48,10,8,2
22,9,49,7,16,-9
22,9,50,14,26,-12
22,9,51,9,15,-6
22,9,52,16,34,-18
22,9,53,11,12,-1
22,9,54,15,26,-11
22,9,55,13,21,-8
22,9,56,14,25,-11
22,9,57,18,20,-2
22,9,58,11,30,-19
22,9,59,15,14,1
22,9,60,3,11,-8
22,9,61,19,21,-2
22,9,62,8,30,-22
22,9,63,21,33,-12
22,9,64,8,30,-22
22,9,65,5,6,-1
22,9,66,10,19,-9
22,9,67,11,21,-10
22,9,68,13,22,-9
22,9,69,11,15,-4
22,9,70,3,25,-22
22,9,71,9,5,4
22,9,72,12,20,-8
22,9,73,12,18,-6
22,9,74,19,21,-2
22,9,75,17,41,-24
22,9,76,8,21,-13
22,9,77,10,17,-7
22,9,78,11,17,-6
22,9,79,9,30,-21
22,9,80,14,24,-10
22,9,81,17,29,-12
22,9,82,12,27,-15
22,9,83,3,31,-28
22,9,84,8,27,-19
22,9,85,6,13,-7
22,9,86,16,17,-1
22,9,87,8,18,-10
22,9,88,11,22,-11
22,9,89,12,22,-10
22,9,90,4,30,-26
22,9,91,9,20,-11
22,9,92,11,12,-1
22,9,93,7,9,-2
22,9,94,8,16,-8
22,9,95,10,18,-8
22,9,96,16,30,-14
22,9,97,12,22,-10
22,9,98,10,42,-32
22,9,99,14,19,-5
22,9,100,11,24,-13
22,9,101,8,24,-16
22,9,102,11,6,5
22,9,103,4,14,-10
22,9,104,15,14,1
22,9,105,16,28,-12
22,9,106,12,19,-7
22,9,107,15,12,3
22,9,108,16,36,-20
22,9,109,17,25,-8
22,9,110,7,20,-13
22,9,111,24,18,6
22,9,112,14,20,-6
22,9,113,18,32,-14
22,9,114,14,16,-2
22,9,115,5,11,-6
22,9,116,7,24,-17
22,9,117,19,21,-2
22,9,118,17,28,-11
22,9,119,8,25,-17
22,9,120,9,21,-12
22,9,121,8,26,-18
22,9,122,9,29,-20
22,9,123,7,19,-12
22,9,124,10,9,1
22,9,125,5,23,-18
22,9,126,9,17,-8
22,9,127,18,12,6
22,9,128,9,18,-9
22,9,129,7,21,-14
22,9,130,8,9,-1
22,9,131,11,16,-5
22,9,132,15,17,-2
22,9,133,6,21,-15
22,9,134,9,16,-7
22,9,135,16,38,-22
22,9,136,19,19,0
22,9,137,14,24,-10
22,9,138,2,17,-15
22,9,139,3,22,-19
22,9,140,20,28,-8
22,9,141,10,18,-8
22,9,142,10,17,-7
22,9,143,2,16,-14
22,9,144,4,20,-16
22,9,145,10,15,-5
22,9,146,3,13,-10
22,9,147,21,13,8
22,9,148,8,31,-23
22,9,149,7,31,-24
22,9,150,18,31,-13
22,9,151,6,17,-11
22,9,152,8,15,-7
22,9,153,12,16,-4
22,9,154,3,20,-17
22,9,155,19,21,-2
22,9,156,4,14,-10
22,9,157,19,31,-12
22,9,158,13,16,-3
22,9,159,10,14,-4
22,9,160,12,29,-17
22,9,161,7,21,-14
22,9,162,4,23,-19
22,9,163,12,17,-5
22,9,164,13,10,3
22,9,165,11,22,-11
22,9,166,11,7,4
22,9,167,19,19,0
22,9,168,11,20,-9
22,9,169,10,12,-2
22,9,170,12,24,-12
22,9,171,12,22,-10
22,9,172,19,16,3
22,9,173,10,17,-7
22,9,174,17,18,-1
22,9,175,12,6,6
22,9,176,14,15,-1
22,9,177,9,19,-10
22,9,178,10,5,5
22,9,179,11,22,-11
22,9,180,9,15,-6
22,9,181,13,14,-1
22,9,182,13,12,1
22,9,183,10,11,-1
22,9,184,7,22,-15
22,9,185,12,28,-16
22,9,186,15,23,-8
22,9,187,4,10,-6
22,9,188,14,19,-5
22,9,189,17,22,-5
22,9,190,7,7,0
22,9,191,10,26,-16
22,9,192,14,13,1
22,9,193,7,13,-6
22,9,194,10,10,0
22,9,195,13,23,-10
22,9,196,12,17,-5
22,9,197,15,34,-19
22,9,198,13,22,-9
22,9,199,8,13,-5
22,9,200,10,17,-7
22,9,201,14,14,0
22,9,202,9,31,-22
22,9,203,13,7,6
22,9,204,8,23,-15
22,9,205,13,16,-3
22,9,206,10,11,-1
22,9,207,13,5,8
22,9,208,11,7,4
22,9,209,11,21,-10
22,9,210,3,18,-15
22,9,211,15,19,-4
22,9,212,2,16,-14
22,9,213,10,19,-9
22,9,214,10,21,-11
22,9,215,5,15,-10
22,9,216,21,23,-2
22,9,217,8,19,-11
22,9,218,13,24,-11
22,9,219,13,17,-4
22,9,220,3,24,-21
22,9,221,6,8,-2
22,9,222,12,13,-1
22,9,223,12,34,-22
22,9,224,17,25,-8
22,9,225,12,20,-8
22,9,226,13,28,-15
22,9,227,8,43,-35
22,9,228,15,19,-4
22,9,229,11,29,-18
22,9,230,10,21,-11
22,9,231,10,37,-27
22,9,232,10,29,-19
22,9,233,9,22,-13
22,9,234,25,34,-9
22,9,235,10,20,-10
22,9,236,12,26,-14
22,9,237,6,23,-17
22,9,238,7,26,-19
22,9,239,9,22,-13
22,9,240,10,16,-6
22,9,241,12,28,-16
22,9,242,14,25,-11
22,9,243,13,28,-15
22,9,244,15,25,-10
22,9,245,18,32,-14
22,9,246,11,12,-1
22,9,247,18,44,-26
22,9,248,4,8,-4
22,9,249,13,38,-25
22,9,250,20,22,-2
22,9,251,10,13,-3
22,9,252,10,21,-11
22,9,253,12,17,-5
22,9,254,8,20,-12
22,9,255,13,36,-23
22,9,256,16,17,-1
22,9,257,8,12,-4
22,9,258,7,20,-13
22,9,259,12,12,0
22,9,260,15,29,-14
22,9,261,10,27,-17
22,9,262,4,25,-21
22,9,263,15,20,-5
22,9,264,10,18,-8
22,9,265,16,21,-5
22,9,266,16,17,-1
22,9,267,12,16,-4
22,9,268,8,14,-6
22,9,269,9,12,-3
22,9,270,5,6,-1
22,9,271,23,25,-2
22,9,272,12,15,-3
22,9,273,8,31,-23
22,9,274,14,13,1
22,9,275,3,9,-6
22,9,276,11,6,5
22,9,277,8,24,-16
22,9,278,16,25,-9
22,9,279,18,26,-8
22,9,280,13,24,-11
22,9,281,8,23,-15
22,9,282,5,23,-18
22,9,283,19,10,9
22,9,284,7,12,-5
22,9,285,7,16,-9
22,9,286,16,23,-7
22,9,287,5,10,-5
22,9,288,7,17,-10
22,9,289,10,17,-7
22,9,290,13,15,-2
22,9,291,5,11,-6
22,9,292,15,22,-7
22,9,293,15,19,-4
22,9,294,13,26,-13
22,9,295,5,20,-15
22,9,296,9,17,-8
22,9,297,12,32,-20
22,9,298,13,17,-4
22,9,299,3,13,-10
22,10,0,11,32,-21
22,10,1,13,24,-11
22,10,2,13,20,-7
22,10,3,4,17,-13
22,10,4,4,33,-29
22,10,5,10,25,-15
22,10,6,13,9,4
22,10,7,10,15,-5
22,10,8,8,4,4
22,10,9,8,19,-11
22,10,10,11,22,-11
22,10,11,21,21,0
22,10,12,10,21,-11
22,10,13,11,8,3
22,10,14,18,22,-4
22,10,15,6,8,-2
22,10,16,4,17,-13
22,10,17,9,17,-8
22,10,18,15,17,-2
22,10,19,13,12,1
22,10,20,14,25,-11
22,10,21,9,22,-13
22,10,22,13,26,-13
22,10,23,4,22,-18
22,10,24,12,29,-17
22,10,25,7,7,0
22,10,26,8,25,-17
22,10,27,10,30,-20
22,10,28,10,19,-9
22,10,29,11,15,-4
22,10,30,7,12,-5
22,10,31,12,22,-10
22,10,32,6,13,-7
22,10,33,10,8,2
22,10,34,5,25,-20
22,10,35,20,24,-4
22,10,36,17,22,-5
22,10,37,6,5,1
22,10,38,12,35,-23
22,10,39,17,16,1
22,10,40,17,13,4
22,10,41,10,11,-1
22,10,42,8,27,-19
22,10,43,8,12,-4
22,10,44,5,23,-18
22,10,45,12,15,-3
22,10,46,6,26,-20
22,10,47,12,8,4
22,10,48,18,28,-10
22,10,49,16,31,-15
22,10,50,18,21,-3
22,10,51,20,34,-14
22,10,52,10,12,-2
22,10,53,14,37,-23
22,10,54,18,17,1
22,10,55,15,19,-4
22,10,56,19,25,-6
22,10,57,15,23,-8
22,10,58,21,33,-12
22,10,59,12,22,-10
22,10,60,25,26,-1
22,10,61,13,16,-3
22,10,62,11,34,-23
22,10,63,9,24,-15
22,10,64,11,18,-7
22,10,65,16,11,5
22,10,66,13,19,-6
22,10,67,12,13,-1
22,10,68,17,12,5
22,10,69,16,24,-8
22,10,70,10,29,-19
22,10,71,19,12,7
22,10,72,13,20,-7
22,10,73,6,4,2
22,10,74,11,15,-4
22,10,75,11,17,-6
22,10,76,9,20,-11
22,10,77,11,18,-7
22,10,78,6,9,-3
22,10,79,18,25,-7
22,10,80,9,22,-13
22,10,81,14,8,6
22,10,82,2,10,-8
22,10,83,15,31,-16
22,10,84,16,28,-12
22,10,85,9,19,-10
22,10,86,7,19,-12
22,10,87,7,32,-25
22,10,88,7,18,-11
22,10,89,7,10,-3
22,10,90,13,22,-9
22,10,91,9,13,-4
22,10,92,17,26,-9
22,10,93,9,22,-13
22,10,94,13,30,-17
22,10,95,16,29,-13
22,10,96,20,48,-28
22,10,97,18,20,-2
22,10,98,14,18,-4
22,10,99,18,28,-10
22,10,100,8,14,-6
22,10,101,17,29,-12
22,10,102,9,19,-10
22,10,103,7,19,-12
22,10,104,15,14,1
22,10,105,14,12,2
22,10,106,10,17,-7
22,10,107,21,31,-10
22,10,108,17,38,-21
22,10,109,16,26,-10
22,10,110,7,10,-3
22,10,111,9,12,-3
22,10,112,11,22,-11
22,10,113,8,12,-4
22,10,114,20,15,5
22,10,115,16,26,-10
22,10,116,3,18,-15
22,10,117,11,21,-10
22,10,118,4,10,-6
22,10,119,17,23,-6
22,10,120,10,7,3
22,10,121,10,22,-12
22,10,122,4,17,-13
22,10,123,10,15,-5
22,10,124,17,26,-9
22,10,125,7,15,-8
22,10,126,4,24,-20
22,10,127,10,30,-20
22,10,128,9,19,-10
22,10,129,14,24,-10
22,10,130,12,17,-5
22,10,131,19,26,-7
22,10,132,6,31,-25
22,10,133,15,16,-1
22,10,134,6,21,-15
22,10,135,14,23,-9
22,10,136,15,9,6
22,10,137,18,16,2
22,10,138,16,13,3
22,10,139,12,25,-13
22,10,140,15,20,-5
22,10,141,24,37,-13
22,10,142,11,18,-7
22,10,143,11,21,-10
22,10,144,15,24,-9
22,10,145,16,18,-2
22,10,146,28,23,5
22,10,147,8,11,-3
22,10,148,6,10,-4
22,10,149,13,24,-11
22,10,150,8,14,-6
22,10,151,8,14,-6
22,10,152,9,22,-13
22,10,153,15,18,-3
22,10,154,20,38,-18
22,10,155,25,20,5
22,10,156,6,7,-1
22,10,157,15,15,0
22,10,158,17,22,-5
22,10,159,24,24,0
22,10,160,10,25,-15
22,10,161,3,10,-7
22,10,162,12,11,1
22,10,163,5,8,-3
22,10,164,17,4,13
22,10,165,21,29,-8
22,10,166,11,24,-13
22,10,167,20,20,0
22,10,168,12,15,-3
22,10,169,17,19,-2
22,10,170,5,15,-10
22,10,171,19,36,-17
22,10,172,6,14,-8
22,10,173,9,27,-18
22,10,174,14,27,-13
22,10,175,9,14,-5
22,10,176,15,15,0
22,10,177,9,18,-9
22,10,178,23,20,3
22,10,179,8,28,-20
22,10,180,18,26,-8
22,10,181,23,29,-6
22,10,182,11,28,-17
22,10,183,5,16,-11
22,10,184,13,20,-7
22,10,185,14,13,1
22,10,186,11,9,2
22,10,187,8,9,-1
22,10,188,8,19,-11
22,10,189,19,24,-5
22,10,190,4,10,-6
22,10,191,19,14,5
22,10,192,13,31,-18
22,10,193,17,20,-3
22,10,194,11,15,-4
22,10,195,11,6,5
22,10,196,10,25,-15
22,10,197,12,17,-5
22,10,198,6,13,-7
22,10,199,13,19,-6
22,10,200,4,23,-19
22,10,201,17,33,-16
22,10,202,23,35,-12
22,10,203,15,23,-8
22,10,204,9,12,-3
22,10,205,7,9,-2
22,10,206,12,15,-3
22,10,207,11,15,-4
22,10,208,15,19,-4
22,10,209,11,11,0
22,10,210,19,31,-12
22,10,211,11,13,-2
22,10,212,9,26,-17
22,10,213,4,20,-16
22,10,214,15,15,0
22,10,215,17,15,2
22,10,216,12,14,-2
22,10,217,18,15,3
22,10,218,6,15,-9
22,10,219,9,27,-18
22,10,220,11,15,-4
22,10,221,10,16,-6
22,10,222,15,23,-8
22,10,223,22,25,-3
22,10,224,11,17,-6
22,10,225,7,21,-14
22,10,226,17,33,-16
22,10,227,5,14,-9
22,10,228,16,17,-1
22,10,229,17,25,-8
22,10,230,5,9,-4
22,10,231,4,24,-20
22,10,232,7,25,-18
22,10,233,6,24,-18
22,10,234,12,21,-9
22,10,235,18,26,-8
22,10,236,13,19,-6
22,10,237,9,20,-11
22,10,238,14,18,-4
22,10,239,17,19,-2
22,10,240,8,40,-32
22,10,241,13,18,-5
22,10,242,16,19,-3
22,10,243,5,18,-13
22,10,244,8,17,-9
22,10,245,13,16,-3
22,10,246,12,18,-6
22,10,247,11,13,-2
22,10,248,12,26,-14
22,10,249,20,18,2
22,10,250,19,21,-2
22,10,251,18,11,7
22,10,252,6,10,-4
22,10,253,18,23,-5
22,10,254,14,20,-6
22,10,255,17,26,-9
22,10,256,19,7,12
22,10,257,8,4,4
22,10,258,16,25,-9
22,10,259,15,16,-1
22,10,260,15,23,-8
22,10,261,8,12,-4
22,10,262,9,10,-1
22,10,263,22,11,11
22,10,264,11,34,-23
22,10,265,16,16,0
22,10,266,19,20,-1
22,10,267,6,18,-12
22,10,268,15,27,-12
22,10,269,13,25,-12
22,10,270,9,25,-16
22,10,271,13,16,-3
22,10,272,15,20,-5
22,10,273,7,16,-9
22,10,274,10,25,-15
22,10,275,9,24,-15
22,10,276,4,19,-15
22,10,277,14,15,-1
22,10,278,8,7,1
22,10,279,13,22,-9
22,10,280,16,33,-17
22,10,281,10,24,-14
22,10,282,4,10,-6
22,10,283,20,17,3
22,10,284,3,10,-7
22,10,285,7,16,-9
22,10,286,12,16,-4
22,10,287,12,19,-7
22,10,288,4,7,-3
22,10,289,15,24,-9
22,10,290,14,18,-4
22,10,291,3,10,-7
22,10,292,16,25,-9
22,10,293,9,7,2
22,10,294,15,18,-3
22,10,295,8,14,-6
22,10,296,5,19,-14
22,10,297,14,17,-3
22,10,298,20,26,-6
22,10,299,8,14,-6
22,11,0,22,21,1
22,11,1,7,14,-7
22,11,2,8,24,-16
22,11,3,16,35,-19
22,11,4,8,17,-9
22,11,5,12,13,-1
22,11,6,16,18,-2
22,11,7,23,13,10
22,11,8,5,14,-9
22,11,9,4,13,-9
22,11,10,17,12,5
22,11,11,7,12,-5
22,11,12,17,20,-3
22,11,13,10,12,-2
22,11,14,15,14,1
22,11,15,19,28,-9
22,11,16,14,19,-5
22,11,17,8,4,4
22,11,18,6,18,-12
22,11,19,17,19,-2
22,11,20,7,19,-12
22,11,21,10,11,-1
22,11,22,6,13,-7
22,11,23,11,17,-6
22,11,24,10,18,-8
22,11,25,16,24,-8
22,11,26,17,8,9
22,11,27,9,36,-27
22,11,28,12,19,-7
22,11,29,13,15,-2
22,11,30,8,14,-6
22,11,31,7,29,-22
22,11,32,5,14,-9
22,11,33,13,23,-10
22,11,34,7,22,-15
22,11,35,8,8,0
22,11,36,4,24,-20
22,11,37,11,13,-2
22,11,38,11,23,-12
22,11,39,27,7,20
22,11,40,12,28,-16
22,11,41,10,18,-8
22,11,42,5,13,-8
22,11,43,12,18,-6
22,11,44,12,10,2
22,11,45,13,17,-4
22,11,46,10,23,-13
22,11,47,16,19,-3
22,11,48,5,20,-15
22,11,49,17,10,7
22,11,50,18,14,4
22,11,51,13,15,-2
22,11,52,8,25,-17
22,11,53,14,23,-9
22,11,54,15,17,-2
22,11,55,8,8,0
22,11,56,8,25,-17
22,11,57,10,21,-11
22,11,58,10,26,-16
22,11,59,13,19,-6
22,11,60,22,19,3
22,11,61,13,14,-1
22,11,62,5,12,-7
22,11,63,13,40,-27
22,11,64,10,21,-11
22,11,65,13,12,1
22,11,66,20,20,0
22,11,67,8,8,0
22,11,68,8,12,-4
22,11,69,13,18,-5
22,11,70,15,23,-8
22,11,71,24,19,5
22,11,72,16,18,-2
22,11,73,8,11,-3
22,11,74,8,22,-14
22,11,75,14,27,-13
22,11,76,12,18,-6
22,11,77,19,31,-12
22,11,78,5,23,-18
22,11,79,7,27,-20
22,11,80,10,18,-8
22,11,81,9,32,-23
22,11,82,15,33,-18
22,11,83,8,17,-9
22,11,84,18,19,-1
22,11,85,14,24,-10
22,11,86,5,6,-1
22,11,87,5,16,-11
22,11,88,13,14,-1
22,11,89,10,7,3
22,11,90,14,9,5
22,11,91,14,13,1
22,11,92,9,14,-5
22,11,93,16,29,-13
22,11,94,12,11,1
22,11,95,7,33,-26
22,11,96,12,10,2
22,11,97,8,22,-14
22,11,98,11,29,-18
22,11,99,8,14,-6
22,11,100,13,17,-4
22,11,101,15,17,-2
22,11,102,21,31,-10
22,11,103,2,8,-6
22,11,104,12,23,-11
22,11,105,18,27,-9
22,11,106,14,21,-7
22,11,107,4,14,-10
22,11,108,14,14,0
22,11,109,11,9,2
22,11,110,15,15,0
22,11,111,13,12,1
22,11,112,14,21,-7
22,11,113,5,32,-27
22,11,114,18,11,7
22,11,115,8,10,-2
22,11,116,11,19,-8
22,11,117,6,19,-13
22,11,118,8,25,-17
22,11,119,11,12,-1
22,11,120,8,14,-6
22,11,121,8,29,-21
22,11,122,7,8,-1
22,11,123,15,21,-6
22,11,124,11,18,-7
22,11,125,11,12,-1
22,11,126,10,15,-5
22,11,127,12,20,-8
22,11,128,14,26,-12
22,11,129,13,24,-11
22,11,130,16,18,-2
22,11,131,11,20,-9
22,11,132,12,30,-18
22,11,133,6,7,-1
22,11,134,5,14,-9
22,11,135,14,19,-5
22,11,136,9,21,-12
22,11,137,10,25,-15
22,11,138,17,26,-9
22,11,139,9,11,-2
22,11,140,14,13,1
22,11,141,15,16,-1
22,11,142,11,12,-1
22,11,143,12,18,-6
22,11,144,9,28,-19
22,11,145,6,20,-14
22,11,146,7,12,-5
22,11,147,14,27,-13
22,11,148,11,8,3
22,11,149,12,12,0
22,11,150,7,19,-12
22,11,151,3,11,-8
22,11,152,7,20,-13
22,11,153,8,37,-29
22,11,154,14,21,-7
22,11,155,15,18,-3
22,11,156,9,12,-3
22,11,157,18,22,-4
22,11,158,13,12,1
22,11,159,11,9,2
22,11,160,6,7,-1
22,11,161,6,17,-11
22,11,162,14,21,-7
22,11,163,11,14,-3
22,11,164,5,17,-12
22,11,165,6,15,-9
22,11,166,8,18,-10
22,11,167,7,14,-7
22,11,168,15,32,-17
22,11,169,15,10,5
22,11,170,18,7,11
22,11,171,15,9,6
22,11,172,14,18,-4
22,11,173,10,10,0
22,11,174,9,21,-12
22,11,175,9,19,-10
22,11,176,12,14,-2
22,11,177,11,20,-9
22,11,178,13,18,-5
22,11,179,6,32,-26
22,11,180,17,27,-10
22,11,181,13,21,-8
22,11,182,16,23,-7
22,11,183,11,18,-7
22,11,184,24,23,1
22,11,185,6,25,-19
22,11,186,1,19,-18
22,11,187,12,29,-17
22,11,188,25,21,4
22,11,189,18,23,-5
22,11,190,10,19,-9
22,11,191,21,23,-2
22,11,192,9,28,-19
22,11,193,8,11,-3
22,11,194,15,13,2
22,11,195,6,21,-15
22,11,196,10,16,-6
22,11,197,10,15,-5
22,11,198,15,26,-11
22,11,199,15,30,-15
22,11,200,19,25,-6
22,11,201,18,20,-2
22,11,202,12,17,-5
22,11,203,17,15,2
22,11,204,12,22,-10
22,11,205,5,40,-35
22,11,206,16,20,-4
22,11,207,12,15,-3
22,11,208,13,21,-8
22,11,209,7,8,-1
22,11,210,15,21,-6
22,11,211,11,11,0
22,11,212,5,14,-9
22,11,213,15,18,-3
22,11,214,6,12,-6
22,11,215,14,28,-14
22,11,216,2,12,-10
22,11,217,11,27,-16
22,11,218,14,22,-8
22,11,219,15,27,-12
22,11,220,16,12,4
22,11,221,15,32,-17
22,11,222,9,25,-16
22,11,223,5,18,-13
22,11,224,15,19,-4
22,11,225,17,13,4
22,11,226,9,13,-4
22,11,227,10,36,-26
22,11,228,9,20,-11
22,11,229,6,12,-6
22,11,230,23,34,-11
22,11,231,2,14,-12
22,11,232,12,15,-3
22,11,233,12,19,-7
22,11,234,14,41,-27
22,11,235,11,11,0
22,11,236,10,16,-6
22,11,237,11,27,-16
22,11,238,8,30,-22
22,11,239,9,20,-11
22,11,240,13,12,1
22,11,241,17,12,5
22,11,242,13,18,-5
22,11,243,11,27,-16
22,11,244,3,13,-10
22,11,245,22,26,-4
22,11,246,16,13,3
22,11,247,15,11,4
22,11,248,16,19,-3
22,11,249,16,20,-4
22,11,250,9,9,0
22,11,251,18,27,-9
22,11,252,5,6,-1
22,11,253,11,16,-5
22,11,254,10,10,0
22,11,255,7,29,-22
22,11,256,12,24,-12
22,11,257,10,26,-16
22,11,258,10,22,-12
22,11,259,13,33,-20
22,11,260,12,26,-14
22,11,261,5,13,-8
22,11,262,21,26,-5
22,11,263,9,17,-8
22,11,264,9,12,-3
22,11,265,18,8,10
22,11,266,19,23,-4
22,11,267,10,15,-5
22,11,268,21,27,-6
22,11,269,4,12,-8
22,11,270,6,12,-6
22,11,271,4,22,-18
22,11,272,7,15,-8
22,11,273,4,10,-6
22,11,274,16,29,-13
22,11,275,12,21,-9
22,11,276,14,2,12
22,11,277,16,33,-17
22,11,278,11,34,-23
22,11,279,12,14,-2
22,11,280,15,12,3
22,11,281,16,10,6
22,11,282,9,15,-6
22,11,283,13,14,-1
22,11,284,25,20,5
22,11,285,3,11,-8
22,11,286,4,5,-1
22,11,287,18,18,0
22,11,288,13,14,-1
22,11,289,8,19,-11
22,11,290,10,15,-5
22,11,291,20,10,10
22,11,292,18,17,1
22,11,293,6,9,-3
22,11,294,18,41,-23
22,11,295,11,19,-8
22,11,296,17,24,-7
22,11,297,20,31,-11
22,11,298,9,10,-1
22,11,299,21,24,-3
22,12,0,14,19,-5
22,12,1,11,13,-2
22,12,2,14,21,-7
22,12,3,12,19,-7
22,12,4,13,30,-17
22,12,5,10,6,4
22,12,6,21,15,6
22,12,7,10,26,-16
22,12,8,13,11,2
22,12,9,10,13,-3
22,12,10,2,15,-13
22,12,11,7,7,0
22,12,12,14,13,1
22,12,13,8,5,3
22,12,14,13,22,-9
22,12,15,12,11,1
22,12,16,11,22,-11
22,12,17,12,23,-11
22,12,18,10,10,0
22,12,19,12,28,-16
22,12,20,7,19,-12
22,12,21,19,26,-7
22,12,22,15,22,-7
22,12,23,22,29,-7
22,12,24,11,12,-1
22,12,25,7,16,-9
22,12,26,8,18,-10
22,12,27,14,13,1
22,12,28,13,32,-19
22,12,29,13,29,-16
22,12,30,17,19,-2
22,12,31,8,43,-35
22,12,32,20,20,0
22,12,33,6,9,-3
22,12,34,8,14,-6
22,12,35,0,10,-10
22,12,36,10,4,6
22,12,37,7,16,-9
22,12,38,9,12,-3
22,12,39,10,28,-18
22,12,40,20,30,-10
22,12,41,14,20,-6
22,12,42,9,24,-15
22,12,43,20,21,-1
22,12,44,12,15,-3
22,12,45,24,23,1
22,12,46,12,23,-11
22,12,47,13,24,-11
22,12,48,6,12,-6
22,12,49,11,23,-12
22,12,50,13,7,6
22,12,51,14,16,-2
22,12,52,15,17,-2
22,12,53,23,19,4
22,12,54,10,18,-8
22,12,55,10,19,-9
22,12,56,16,25,-9
22,12,57,4,20,-16
22,12,58,6,13,-7
22,12,59,14,18,-4
22,12,60,10,33,-23
22,12,61,9,8,1
22,12,62,8,21,-13
22,12,63,15,24,-9
22,12,64,16,8,8
22,12,65,16,23,-7
22,12,66,20,24,-4
22,12,67,24,16,8
22,12,68,16,23,-7
22,12,69,13,18,-5
22,12,70,14,6,8
22,12,71,1,16,-15
22,12,72,7,11,-4
22,12,73,7,15,-8
22,12,74,12,13,-1
22,12,75,8,32,-24
22,12,76,12,23,-11
22,12,77,10,6,4
22,12,78,19,20,-1
22,12,79,14,20,-6
22,12,80,14,30,-16
22,12,81,20,17,3
22,12,82,8,5,3
22,12,83,7,30,-23
22,12,84,15,34,-19
22,12,85,9,12,-3
22,12,86,4,15,-11
22,12,87,8,10,-2
22,12,88,8,24,-16
22,12,89,18,17,1
22,12,90,20,27,-7
22,12,91,10,26,-16
22,12,92,13,31,-18
22,12,93,11,21,-10
22,12,94,19,16,3
22,12,95,15,31,-16
22,12,96,17,21,-4
22,12,97,16,26,-10
22,12,98,9,24,-15
22,12,99,15,28,-13
22,12,100,12,19,-7
22,12,101,25,15,10
22,12,102,12,10,2
22,12,103,14,25,-11
22,12,104,12,22,-10
22,12,105,10,16,-6
22,12,106,12,26,-14
22,12,107,7,21,-14
22,12,108,14,15,-1
22,12,109,16,8,8
22,12,110,16,14,2
22,12,111,33,21,12
22,12,112,12,14,-2
22,12,113,16,27,-11
22,12,114,11,19,-8
22,12,115,11,23,-12
22,12,116,12,17,-5
22,12,117,15,27,-12
22,12,118,22,28,-6
22,12,119,25,23,2
22,12,120,6,6,0
22,12,121,22,12,10
22,12,122,19,25,-6
22,12,123,8,9,-1
22,12,124,19,43,-24
22,12,125,14,8,6
22,12,126,14,17,-3
22,12,127,13,28,-15
22,12,128,14,13,1
22,12,129,12,13,-1
22,12,130,14,12,2
22,12,131,8,16,-8
22,12,132,11,1,10
22,12,133,10,32,-22
22,12,134,9,11,-2
22,12,135,10,15,-5
22,12,136,10,14,-4
22,12,137,10,38,-28
22,12,138,9,18,-9
22,12,139,25,25,0
22,12,140,10,16,-6
22,12,141,20,24,-4
22,12,142,19,31,-12
22,12,143,16,20,-4
22,12,144,13,14,-1
22,12,145,8,9,-1
22,12,146,8,7,1
22,12,147,10,10,0
22,12,148,13,8,5
22,12,149,16,25,-9
22,12,150,13,26,-13
22,12,151,8,16,-8
22,12,152,10,18,-8
22,12,153,10,23,-13
22,12,154,6,22,-16
22,12,155,35,12,23
22,12,156,9,17,-8
22,12,157,4,17,-13
22,12,158,9,6,3
22,12,159,11,23,-12
22,12,160,7,14,-7
22,12,161,13,2,11
22,12,162,13,13,0
22,12,163,13,16,-3
22,12,164,9,9,0
22,12,165,7,24,-17
22,12,166,18,19,-1
22,12,167,15,13,2
22,12,168,8,20,-12
22,12,169,7,22,-15
22,12,170,17,18,-1
22,12,171,8,2,6
22,12,172,13,16,-3
22,12,173,15,11,4
22,12,174,8,24,-16
22,12,175,18,18,0
22,12,176,7,22,-15
22,12,177,21,25,-4
22,12,178,13,20,-7
22,12,179,7,10,-3
22,12,180,10,14,-4
22,12,181,10,14,-4
22,12,182,5,13,-8
22,12,183,13,20,-7
22,12,184,8,17,-9
22,12,185,17,13,4
22,12,186,19,21,-2
22,12,187,14,18,-4
22,12,188,6,15,-9
22,12,189,21,18,3
22,12,190,12,10,2
22,12,191,9,24,-15
22,12,192,14,25,-11
22,12,193,10,16,-6
22,12,194,21,15,6
22,12,195,10,22,-12
22,12,196,6,23,-17
22,12,197,15,21,-6
22,12,198,13,15,-2
22,12,199,6,5,1
22,12,200,29,33,-4
22,12,201,21,20,1
22,12,202,11,10,1
22,12,203,15,26,-11
22,12,204,9,19,-10
22,12,205,13,19,-6
22,12,206,24,15,9
22,12,207,8,22,-14
22,12,208,11,12,-1
22,12,209,7,18,-11
22,12,210,8,31,-23
22,12,211,9,15,-6
22,12,212,20,24,-4
22,12,213,17,16,1
22,12,214,25,13,12
22,12,215,11,15,-4
22,12,216,16,29,-13
22,12,217,6,15,-9
22,12,218,15,36,-21
22,12,219,7,15,-8
22,12,220,13,15,-2
22,12,221,16,17,-1
22,12,222,13,10,3
22,12,223,12,15,-3
22,12,224,10,17,-7
22,12,225,10,16,-6
22,12,226,7,9,-2
22,12,227,14,10,4
22,12,228,4,16,-12
22,12,229,10,22,-12
22,12,230,7,23,-16
22,12,231,7,10,-3
22,12,232,16,20,-4
22,12,233,8,20,-12
22,12,234,5,8,-3
22,12,235,19,20,-1
22,12,236,20,30,-10
22,12,237,11,23,-12
22,12,238,13,15,-2
22,12,239,16,19,-3
22,12,240,14,19,-5
22,12,241,10,11,-1
22,12,242,18,15,3
22,12,243,16,21,-5
22,12,244,13,24,-11
22,12,245,14,26,-12
22,12,246,18,19,-1
22,12,247,13,30,-17
22,12,248,24,31,-7
22,12,249,15,30,-15
22,12,250,16,21,-5
22,12,251,6,13,-7
22,12,252,9,34,-25
22,12,253,10,18,-8
22,12,254,14,19,-5
22,12,255,13,20,-7
22,12,256,20,12,8
22,12,257,15,9,6
22,12,258,10,16,-6
22,12,259,15,18,-3
22,12,260,9,14,-5
22,12,261,12,17,-5
22,12,262,19,13,6
22,12,263,5,19,-14
22,12,264,16,16,0
22,12,265,3,20,-17
22,12,266,27,25,2
22,12,267,13,27,-14
22,12,268,7,16,-9
22,12,269,10,19,-9
22,12,270,11,15,-4
22,12,271,13,22,-9
22,12,272,13,12,1
22,12,273,8,9,-1
22,12,274,17,8,9
22,12,275,12,14,-2
22,12,276,9,30,-21
22,12,277,20,25,-5
22,12,278,15,28,-13
22,12,279,9,12,-3
22,12,280,12,20,-8
22,12,281,6,23,-17
22,12,282,20,12,8
22,12,283,19,23,-4
22,12,284,14,16,-2
22,12,285,8,8,0
22,12,286,17,16,1
22,12,287,11,21,-10
22,12,288,17,28,-11
22,12,289,25,31,-6
22,12,290,13,13,0
22,12,291,8,19,-11
22,12,292,17,23,-6
22,12,293,15,8,7
22,12,294,7,13,-6
22,12,295,10,15,-5
22,12,296,7,17,-10
22,12,297,15,31,-16
22,12,298,14,15,-1
22,12,299,11,12,-1
22,13,0,11,3,8
22,13,1,6,18,-12
22,13,2,11,16,-5
22,13,3,16,31,-15
22,13,4,13,26,-13
22,13,5,10,15,-5
22,13,6,5,15,-10
22,13,7,4,8,-4
22,13,8,6,19,-13
22,13,9,12,15,-3
22,13,10,7,30,-23
22,13,11,8,17,-9
22,13,12,13,13,0
22,13,13,16,24,-8
22,13,14,21,31,-10
22,13,15,12,16,-4
22,13,16,11,17,-6
22,13,17,10,19,-9
22,13,18,17,20,-3
22,13,19,15,29,-14
22,13,20,11,31,-20
22,13,21,12,14,-2
22,13,22,18,17,1
22,13,23,20,20,0
22,13,24,10,17,-7
22,13,25,13,17,-4
22,13,26,16,30,-14
22,13,27,8,19,-11
22,13,28,13,24,-11
22,13,29,9,16,-7
22,13,30,8,24,-16
22,13,31,16,21,-5
22,13,32,15,13,2
22,13,33,12,19,-7
22,13,34,14,18,-4
22,13,35,12,40,-28
22,13,36,15,29,-14
22,13,37,12,15,-3
22,13,38,16,3,13
22,13,39,4,11,-7
22,13,40,12,18,-6
22,13,41,14,31,-17
22,13,42,11,24,-13
22,13,43,11,15,-4
22,13,44,7,20,-13
22,13,45,10,18,-8
22,13,46,16,19,-3
22,13,47,6,13,-7
22,13,48,10,18,-8
22,13,49,16,17,-1
22,13,50,19,13,6
22,13,51,15,24,-9
22,13,52,7,15,-8
22,13,53,14,25,-11
22,13,54,8,17,-9
22,13,55,6,7,-1
22,13,56,15,31,-16
22,13,57,14,15,-1
22,13,58,9,15,-6
22,13,59,17,11,6
22,13,60,10,18,-8
22,13,61,11,5,6
22,13,62,10,16,-6
22,13,63,7,26,-19
22,13,64,17,23,-6
22,13,65,16,8,8
22,13,66,4,10,-6
22,13,67,14,8,6
22,13,68,7,18,-11
22,13,69,12,17,-5
22,13,70,5,12,-7
22,13,71,10,8,2
22,13,72,18,23,-5
22,13,73,10,31,-21
22,13,74,21,22,-1
22,13,75,8,15,-7
22,13,76,16,13,3
22,13,77,33,25,8
22,13,78,11,21,-10
22,13,79,18,16,2
22,13,80,14,26,-12
22,13,81,9,13,-4
22,13,82,16,24,-8
22,13,83,11,24,-13
22,13,84,9,11,-2
22,13,85,14,28,-14
22,13,86,21,28,-7
22,13,87,10,15,-5
22,13,88,16,13,3
22,13,89,19,11,8
22,13,90,17,30,-13
22,13,91,15,20,-5
22,13,92,21,22,-1
22,13,93,11,18,-7
22,13,94,10,22,-12
22,13,95,9,19,-10
22,13,96,19,8,11
22,13,97,5,12,-7
22,13,98,17,24,-7
22,13,99,11,24,-13
22,13,100,16,13,3
22,13,101,13,18,-5
22,13,102,20,31,-11
22,13,103,17,22,-5
22,13,104,2,14,-12
22,13,105,12,11,1
22,13,106,29,38,-9
22,13,107,10,29,-19
22,13,108,12,15,-3
22,13,109,11,31,-20
22,13,110,11,12,-1
22,13,111,15,9,6
22,13,112,21,24,-3
22,13,113,16,15,1
22,13,114,12,14,-2
22,13,115,9,22,-13
22,13,116,15,20,-5
22,13,117,14,18,-4
22,13,118,12,19,-7
22,13,119,12,13,-1
22,13,120,27,28,-1
22,13,121,18,13,5
22,13,122,14,16,-2
22,13,123,9,26,-17
22,13,124,17,33,-16
22,13,125,10,22,-12
22,13,126,9,22,-13
22,13,127,12,28,-16
22,13,128,12,25,-13
22,13,129,18,17,1
22,13,130,10,25,-15
22,13,131,11,10,1
22,13,132,12,19,-7
22,13,133,9,11,-2
22,13,134,11,21,-10
22,13,135,17,15,2
22,13,136,6,23,-17
22,13,137,12,14,-2
22,13,138,9,17,-8
22,13,139,24,29,-5
22,13,140,18,11,7
22,13,141,8,20,-12
22,13,142,17,15,2
22,13,143,14,26,-12
22,13,144,14,20,-6
22,13,145,13,8,5
22,13,146,6,19,-13
22,13,147,17,23,-6
22,13,148,6,25,-19
22,13,149,6,21,-15
22,13,150,14,16,-2
22,13,151,4,7,-3
22,13,152,23,16,7
22,13,153,19,30,-11
22,13,154,10,9,1
22,13,155,5,7,-2
22,13,156,7,13,-6
22,13,157,9,25,-16
22,13,158,22,11,11
22,13,159,14,24,-10
22,13,160,10,20,-10
22,13,161,13,27,-14
22,13,162,12,31,-19
22,13,163,15,11,4
22,13,164,15,29,-14
22,13,165,4,19,-15
22,13,166,11,13,-2
22,13,167,8,33,-25
22,13,168,5,15,-10
22,13,169,12,26,-14
22,13,170,11,14,-3
22,13,171,9,12,-3
22,13,172,9,14,-5
22,13,173,10,16,-6
22,13,174,16,31,-15
22,13,175,14,19,-5
22,13,176,16,32,-16
22,13,177,1,22,-21
22,13,178,12,24,-12
22,13,179,10,13,-3
22,13,180,18,19,-1
22,13,181,17,22,-5
22,13,182,21,22,-1
22,13,183,7,14,-7
22,13,184,7,5,2
22,13,185,15,13,2
22,13,186,7,25,-18
22,13,187,8,14,-6
22,13,188,15,12,3
22,13,189,12,16,-4
22,13,190,16,10,6
22,13,191,5,13,-8
22,13,192,14,26,-12
22,13,193,17,20,-3
22,13,194,9,14,-5
22,13,195,15,21,-6
22,13,196,16,11,5
22,13,197,13,15,-2
22,13,198,15,25,-10
22,13,199,13,18,-5
22,13,200,1,18,-17
22,13,201,18,18,0
22,13,202,9,20,-11
22,13,203,8,27,-19
22,13,204,6,26,-20
22,13,205,10,5,5
22,13,206,8,10,-2
22,13,207,6,29,-23
22,13,208,14,25,-11
22,13,209,13,25,-12
22,13,210,16,19,-3
22,13,211,7,24,-17
22,13,212,12,32,-20
22,13,213,14,20,-6
22,13,214,20,19,1
22,13,215,11,27,-16
22,13,216,13,21,-8
22,13,217,13,18,-5
22,13,218,5,13,-8
22,13,219,19,22,-3
22,13,220,11,11,0
22,13,221,6,21,-15
22,13,222,13,23,-10
22,13,223,19,30,-11
22,13,224,13,13,0
22,13,225,14,17,-3
22,13,226,17,19,-2
22,13,227,12,8,4
22,13,228,15,28,-13
22,13,229,8,12,-4
22,13,230,6,11,-5
22,13,231,12,16,-4
22,13,232,19,18,1
22,13,233,9,26,-17
22,13,234,14,20,-6
22,13,235,9,11,-2
22,13,236,7,5,2
22,13,237,21,20,1
22,13,238,12,13,-1
22,13,239,21,14,7
22,13,240,7,9,-2
22,13,241,18,17,1
22,13,242,9,10,-1
22,13,243,8,16,-8
22,13,244,15,31,-16
22,13,245,15,19,-4
22,13,246,9,9,0
22,13,247,8,18,-10
22,13,248,7,23,-16
22,13,249,7,16,-9
22,13,250,15,17,-2
22,13,251,13,13,0
22,13,252,14,9,5
22,13,253,12,9,3
22,13,254,6,16,-10
22,13,255,6,30,-24
22,13,256,12,21,-9
22,13,257,13,11,2
22,13,258,2,22,-20
22,13,259,7,12,-5
22,13,260,5,22,-17
22,13,261,10,21,-11
22,13,262,18,15,3
22,13,263,8,23,-15
22,13,264,14,9,5
22,13,265,19,36,-17
22,13,266,11,19,-8
22,13,267,4,5,-1
22,13,268,14,11,3
22,13,269,23,21,2
22,13,270,9,20,-11
22,13,271,12,24,-12
22,13,272,12,28,-16
22,13,273,18,11,7
22,13,274,24,23,1
22,13,275,8,13,-5
22,13,276,15,18,-3
22,13,277,3,9,-6
22,13,278,20,26,-6
22,13,279,1,15,-14
22,13,280,7,12,-5
22,13,281,11,18,-7
22,13,282,13,26,-13
22,13,283,7,13,-6
22,13,284,17,26,-9
22,13,285,16,9,7
22,13,286,12,24,-12
22,13,287,15,24,-9
22,13,288,12,24,-12
22,13,289,19,13,6
22,13,290,10,18,-8
22,13,291,23,29,-6
22,13,292,22,24,-2
22,13,293,20,25,-5
22,13,294,11,8,3
22,13,295,8,15,-7
22,13,296,10,14,-4
22,13,297,10,17,-7
22,13,298,14,30,-16
22,13,299,16,14,2
22,14,0,12,13,-1
22,14,1,22,15,7
22,14,2,15,22,-7
22,14,3,14,12,2
22,14,4,14,4,10
22,14,5,7,19,-12
22,14,6,27,26,1
22,14,7,16,17,-1
22,14,8,8,15,-7
22,14,9,12,27,-15
22,14,10,16,34,-18
22,14,11,10,7,3
22,14,12,8,14,-6
22,14,13,22,28,-6
22,14,14,5,18,-13
22,14,15,9,11,-2
22,14,16,13,29,-16
22,14,17,5,17,-12
22,14,18,14,15,-1
22,14,19,8,25,-17
22,14,20,13,14,-1
22,14,21,9,22,-13
22,14,22,10,19,-9
22,14,23,3,13,-10
22,14,24,19,25,-6
22,14,25,14,17,-3
22,14,26,12,9,3
22,14,27,13,14,-1
22,14,28,5,9,-4
22,14,29,24,19,5
22,14,30,22,27,-5
22,14,31,21,25,-4
22,14,32,17,25,-8
22,14,33,18,25,-7
22,14,34,6,11,-5
22,14,35,8,16,-8
22,14,36,19,32,-13
22,14,37,11,6,5
22,14,38,12,23,-11
22,14,39,10,21,-11
22,14,40,9,8,1
22,14,41,15,16,-1
22,14,42,12,4,8
22,14,43,9,22,-13
22,14,44,13,25,-12
22,14,45,5,14,-9
22,14,46,17,13,4
22,14,47,19,17,2
22,14,48,8,24,-16
22,14,49,13,9,4
22,14,50,8,11,-3
22,14,51,19,19,0
22,14,52,8,15,-7
22,14,53,9,18,-9
22,14,54,7,19,-12
22,14,55,6,15,-9
22,14,56,17,19,-2
22,14,57,19,29,-10
22,14,58,13,13,0
22,14,59,19,25,-6
22,14,60,13,15,-2
22,14,61,4,29,-25
22,14,62,14,30,-16
22,14,63,21,15,6
22,14,64,9,4,5
22,14,65,21,20,1
22,14,66,16,19,-3
22,14,67,8,17,-9
22,14,68,11,12,-1
22,14,69,12,10,2
22,14,70,13,4,9
22,14,71,6,9,-3
22,14,72,13,11,2
22,14,73,4,13,-9
22,14,74,9,14,-5
22,14,75,9,14,-5
22,14,76,6,10,-4
22,14,77,16,12,4
22,14,78,15,17,-2
22,14,79,7,11,-4
22,14,80,23,24,-1
22,14,81,7,29,-22
22,14,82,14,19,-5
22,14,83,13,20,-7
22,14,84,20,17,3
22,14,85,17,11,6
22,14,86,18,23,-5
22,14,87,16,13,3
22,14,88,8,19,-11
22,14,89,1,10,-9
22,14,90,17,23,-6
22,14,91,12,21,-9
22,14,92,6,8,-2
22,14,93,10,15,-5
22,14,94,10,10,0
22,14,95,12,20,-8
22,14,96,13,20,-7
22,14,97,15,30,-15
22,14,98,10,23,-13
22,14,99,9,23,-14
22,14,100,16,13,3
22,14,101,25,19,6
22,14,102,23,29,-6
22,14,103,16,25,-9
22,14,104,3,19,-16
22,14,105,12,27,-15
22,14,106,20,16,4
22,14,107,6,19,-13
22,14,108,12,16,-4
22,14,109,16,15,1
22,14,110,9,9,0
22,14,111,14,17,-3
22,14,112,13,12,1
22,14,113,24,32,-8
22,14,114,13,18,-5
22,14,115,26,19,7
22,14,116,19,22,-3
22,14,117,4,17,-13
22,14,118,10,7,3
22,14,119,6,28,-22
22,14,120,12,12,0
22,14,121,18,5,13
22,14,122,22,15,7
22,14,123,13,20,-7
22,14,124,4,11,-7
22,14,125,15,14,1
22,14,126,19,19,0
22,14,127,17,16,1
22,14,128,9,15,-6
22,14,129,3,14,-11
22,14,130,19,13,6
22,14,131,8,14,-6
22,14,132,18,20,-2
22,14,133,19,11,8
22,14,134,8,21,-13
22,14,135,15,14,1
22,14,136,11,24,-13
22,14,137,10,14,-4
22,14,138,5,10,-5
22,14,139,13,14,-1
22,14,140,16,10,6
22,14,141,13,19,-6
22,14,142,19,10,9
22,14,143,16,22,-6
22,14,144,7,26,-19
22,14,145,9,23,-14
22,14,146,10,11,-1
22,14,147,15,11,4
22,14,148,9,12,-3
22,14,149,9,24,-15
22,14,150,10,8,2
22,14,151,22,15,7
22,14,152,11,15,-4
22,14,153,8,23,-15
22,14,154,20,22,-2
22,14,155,15,16,-1
22,14,156,19,15,4
22,14,157,26,18,8
22,14,158,9,14,-5
22,14,159,8,9,-1
22,14,160,17,8,9
22,14,161,17,34,-17
22,14,162,5,12,-7
22,14,163,7,14,-7
22,14,164,11,17,-6
22,14,165,14,18,-4
22,14,166,18,30,-12
22,14,167,8,8,0
22,14,168,16,22,-6
22,14,169,8,8,0
22,14,170,14,17,-3
22,14,171,19,15,4
22,14,172,11,16,-5
22,14,173,5,8,-3
22,14,174,21,20,1
22,14,175,14,19,-5
22,14,176,14,33,-19
22,14,177,15,22,-7
22,14,178,7,22,-15
22,14,179,13,10,3
22,14,180,16,23,-7
22,14,181,18,24,-6
22,14,182,12,18,-6
22,14,183,8,13,-5
22,14,184,17,23,-6
22,14,185,10,10,0
22,14,186,10,16,-6
22,14,187,15,19,-4
22,14,188,8,13,-5
22,14,189,7,19,-12
22,14,190,7,25,-18
22,14,191,17,16,1
22,14,192,14,16,-2
22,14,193,14,16,-2
22,14,194,24,22,2
22,14,195,11,16,-5
22,14,196,21,22,-1
22,14,197,14,8,6
22,14,198,29,17,12
22,14,199,13,12,1
22,14,200,13,15,-2
22,14,201,17,23,-6
22,14,202,14,21,-7
22,14,203,12,14,-2
22,14,204,23,18,5
22,14,205,7,23,-16
22,14,206,9,8,1
22,14,207,13,28,-15
22,14,208,12,22,-10
22,14,209,24,16,8
22,14,210,14,16,-2
22,14,211,7,18,-11
22,14,212,19,19,0
22,14,213,5,14,-9
22,14,214,9,31,-22
22,14,215,12,10,2
22,14,216,22,31,-9
22,14,217,23,16,7
22,14,218,8,19,-11
22,14,219,9,14,-5
22,14,220,18,17,1
22,14,221,9,19,-10
22,14,222,7,12,-5
22,14,223,3,19,-16
22,14,224,13,25,-12
22,14,225,8,20,-12
22,14,226,11,21,-10
22,14,227,10,26,-16
22,14,228,9,20,-11
22,14,229,6,13,-7
22,14,230,17,30,-13
22,14,231,10,12,-2
22,14,232,17,3,14
22,14,233,16,16,0
22,14,234,7,11,-4
22,14,235,14,16,-2
22,14,236,14,15,-1
22,14,237,26,28,-2
22,14,238,3,16,-13
22,14,239,14,21,-7
22,14,240,10,18,-8
22,14,241,7,25,-18
22,14,242,18,25,-7
22,14,243,18,18,0
22,14,244,6,17,-11
22,14,245,13,12,1
22,14,246,9,30,-21
22,14,247,8,18,-10
22,14,248,18,15,3
22,14,249,15,7,8
22,14,250,7,9,-2
22,14,251,10,14,-4
22,14,252,5,14,-9
22,14,253,21,31,-10
22,14,254,23,19,4
22,14,255,19,23,-4
22,14,256,21,17,4
22,14,257,6,19,-13
22,14,258,7,13,-6
22,14,259,12,23,-11
22,14,260,7,10,-3
22,14,261,9,7,2
22,14,262,11,16,-5
22,14,263,4,29,-25
22,14,264,12,22,-10
22,14,265,5,13,-8
22,14,266,7,17,-10
22,14,267,6,14,-8
22,14,268,18,16,2
22,14,269,9,31,-22
22,14,270,12,19,-7
22,14,271,15,22,-7
22,14,272,11,16,-5
22,14,273,12,20,-8
22,14,274,11,7,4
22,14,275,23,30,-7
22,14,276,8,21,-13
22,14,277,4,17,-13
22,14,278,4,15,-11
22,14,279,10,11,-1
22,14,280,10,13,-3
22,14,281,17,24,-7
22,14,282,11,12,-1
22,14,283,9,9,0
22,14,284,16,20,-4
22,14,285,19,13,6
22,14,286,12,28,-16
22,14,287,8,22,-14
22,14,288,14,25,-11
22,14,289,11,25,-14
22,14,290,12,28,-16
22,14,291,10,33,-23
22,14,292,16,19,-3
22,14,293,17,15,2
22,14,294,2,27,-25
22,14,295,13,23,-10
22,14,296,18,9,9
22,14,297,14,18,-4
22,14,298,11,21,-10
22,14,299,20,29,-9
22,15,0,8,19,-11
22,15,1,18,12,6
22,15,2,26,13,13
22,15,3,6,16,-10
22,15,4,13,6,7
22,15,5,12,23,-11
22,15,6,8,12,-4
22,15,7,25,23,2
22,15,8,11,3,8
22,15,9,9,14,-5
22,15,10,11,16,-5
22,15,11,23,26,-3
22,15,12,6,10,-4
22,15,13,12,17,-5
22,15,14,18,19,-1
22,15,15,6,8,-2
22,15,16,14,22,-8
22,15,17,11,25,-14
22,15,18,12,21,-9
22,15,19,7,15,-8
22,15,20,21,22,-1
22,15,21,19,11,8
22,15,22,18,21,-3
22,15,23,5,1,4
22,15,24,12,9,3
22,15,25,8,22,-14
22,15,26,6,12,-6
22,15,27,21,25,-4
22,15,28,13,13,0
22,15,29,14,16,-2
22,15,30,12,13,-1
22,15,31,14,31,-17
22,15,32,16,13,3
22,15,33,16,19,-3
22,15,34,14,18,-4
22,15,35,13,25,-12
22,15,36,15,12,3
22,15,37,7,23,-16
22,15,38,23,21,2
22,15,39,22,28,-6
22,15,40,11,19,-8
22,15,41,13,16,-3
22,15,42,8,7,1
22,15,43,9,17,-8
22,15,44,23,22,1
22,15,45,20,13,7
22,15,46,4,12,-8
22,15,47,8,28,-20
22,15,48,14,20,-6
22,15,49,16,9,7
22,15,50,18,12,6
22,15,51,16,16,0
22,15,52,24,20,4
22,15,53,14,18,-4
22,15,54,16,34,-18
22,15,55,14,30,-16
22,15,56,21,21,0
22,15,57,9,12,-3
22,15,58,9,9,0
22,15,59,18,27,-9
22,15,60,13,22,-9
22,15,61,11,26,-15
22,15,62,4,11,-7
22,15,63,13,10,3
22,15,64,4,7,-3
22,15,65,15,25,-10
22,15,66,14,21,-7
22,15,67,7,22,-15
22,15,68,12,14,-2
22,15,69,13,23,-10
22,15,70,17,38,-21
22,15,71,32,20,12
22,15,72,1,13,-12
22,15,73,8,8,0
22,15,74,22,26,-4
22,15,75,16,16,0
22,15,76,14,28,-14
22,15,77,10,22,-12
22,15,78,6,5,1
22,15,79,13,24,-11
22,15,80,15,18,-3
22,15,81,19,19,0
22,15,82,17,12,5
22,15,83,7,8,-1
22,15,84,12,13,-1
22,15,85,14,23,-9
22,15,86,19,12,7
22,15,87,18,23,-5
22,15,88,12,22,-10
22,15,89,8,18,-10
22,15,90,19,18,1
22,15,91,14,17,-3
22,15,92,14,21,-7
22,15,93,12,20,-8
22,15,94,11,21,-10
22,15,95,6,6,0
22,15,96,19,17,2
22,15,97,17,17,0
22,15,98,7,25,-18
22,15,99,15,14,1
22,15,100,10,15,-5
22,15,101,8,12,-4
22,15,102,22,19,3
22,15,103,4,5,-1
22,15,104,30,20,10
22,15,105,10,14,-4
22,15,106,17,7,10
22,15,107,23,10,13
22,15,108,16,15,1
22,15,109,11,15,-4
22,15,110,8,18,-10
22,15,111,9,18,-9
22,15,112,16,27,-11
22,15,113,6,8,-2
22,15,114,18,19,-1
22,15,115,17,9,8
22,15,116,9,10,-1
22,15,117,10,13,-3
22,15,118,9,12,-3
22,15,119,14,16,-2
22,15,120,13,19,-6
22,15,121,17,19,-2
22,15,122,22,15,7
22,15,123,27,29,-2
22,15,124,7,20,-13
22,15,125,18,22,-4
22,15,126,11,12,-1
22,15,127,8,13,-5
22,15,128,7,22,-15
22,15,129,19,24,-5
22,15,130,9,21,-12
22,15,131,19,17,2
22,15,132,30,20,10
22,15,133,3,15,-12
22,15,134,19,18,1
22,15,135,3,20,-17
22,15,136,7,21,-14
22,15,137,18,30,-12
22,15,138,10,16,-6
22,15,139,15,19,-4
22,15,140,12,10,2
22,15,141,12,12,0
22,15,142,10,12,-2
22,15,143,6,13,-7
22,15,144,8,22,-14
22,15,145,18,13,5
22,15,146,23,24,-1
22,15,147,10,9,1
22,15,148,30,18,12
22,15,149,14,18,-4
22,15,150,8,27,-19
22,15,151,5,21,-16
22,15,152,10,9,1
22,15,153,16,17,-1
22,15,154,16,19,-3
22,15,155,16,22,-6
22,15,156,16,15,1
22,15,157,11,12,-1
22,15,158,13,34,-21
22,15,159,9,22,-13
22,15,160,2,9,-7
22,15,161,12,6,6
22,15,162,9,21,-12
22,15,163,12,31,-19
22,15,164,10,25,-15
22,15,165,12,11,1
22,15,166,20,18,2
22,15,167,23,23,0
22,15,168,17,13,4
22,15,169,7,17,-10
22,15,170,14,11,3
22,15,171,7,11,-4
22,15,172,8,21,-13
22,15,173,16,13,3
22,15,174,13,19,-6
22,15,175,4,6,-2
22,15,176,12,10,2
22,15,177,21,14,7
22,15,178,15,19,-4
22,15,179,17,24,-7
22,15,180,15,15,0
22,15,181,8,19,-11
22,15,182,12,10,2
22,15,183,5,10,-5
22,15,184,22,24,-2
22,15,185,19,19,0
22,15,186,23,14,9
22,15,187,9,21,-12
22,15,188,13,20,-7
22,15,189,12,26,-14
22,15,190,19,40,-21
22,15,191,12,30,-18
22,15,192,20,19,1
22,15,193,12,19,-7
22,15,194,12,12,0
22,15,195,6,16,-10
22,15,196,14,22,-8
22,15,197,14,19,-5
22,15,198,10,11,-1
22,15,199,7,24,-17
22,15,200,13,23,-10
22,15,201,6,18,-12
22,15,202,7,30,-23
22,15,203,15,20,-5
22,15,204,26,10,16
22,15,205,10,17,-7
22,15,206,19,21,-2
22,15,207,12,10,2
22,15,208,10,11,-1
22,15,209,12,12,0
22,15,210,18,15,3
22,15,211,12,19,-7
22,15,212,21,42,-21
22,15,213,7,21,-14
22,15,214,9,7,2
22,15,215,10,23,-13
22,15,216,17,17,0
22,15,217,17,17,0
22,15,218,19,25,-6
22,15,219,7,22,-15
22,15,220,12,16,-4
22,15,221,16,14,2
22,15,222,18,17,1
22,15,223,19,29,-10
22,15,224,9,15,-6
22,15,225,14,16,-2
22,15,226,11,20,-9
22,15,227,36,35,1
22,15,228,14,18,-4
22,15,229,17,16,1
22,15,230,21,31,-10
22,15,231,16,15,1
22,15,232,8,21,-13
22,15,233,10,16,-6
22,15,234,12,19,-7
22,15,235,11,22,-11
22,15,236,17,27,-10
22,15,237,8,16,-8
22,15,238,6,20,-14
22,15,239,12,10,2
22,15,240,13,22,-9
22,15,241,15,20,-5
22,15,242,9,22,-13
22,15,243,20,16,4
22,15,244,9,26,-17
22,15,245,12,7,5
22,15,246,17,22,-5
22,15,247,29,13,16
22,15,248,16,25,-9
22,15,249,10,15,-5
22,15,250,10,11,-1
22,15,251,4,15,-11
22,15,252,17,16,1
22,15,253,18,17,1
22,15,254,7,12,-5
22,15,255,14,11,3
22,15,256,13,17,-4
22,15,257,28,16,12
22,15,258,11,22,-11
22,15,259,11,24,-13
22,15,260,7,11,-4
22,15,261,10,20,-10
22,15,262,19,18,1
22,15,263,21,25,-4
22,15,264,14,24,-10
22,15,265,7,13,-6
22,15,266,13,28,-15
22,15,267,4,25,-21
22,15,268,24,22,2
22,15,269,11,13,-2
22,15,270,7,18,-11
22,15,271,12,18,-6
22,15,272,20,15,5
22,15,273,10,10,0
22,15,274,11,17,-6
22,15,275,15,18,-3
22,15,276,15,18,-3
22,15,277,7,13,-6
22,15,278,15,16,-1
22,15,279,12,22,-10
22,15,280,4,19,-15
22,15,281,8,14,-6
22,15,282,11,18,-7
22,15,283,7,26,-19
22,15,284,11,20,-9
22,15,285,14,12,2
22,15,286,21,17,4
22,15,287,8,19,-11
22,15,288,11,7,4
22,15,289,23,14,9
22,15,290,8,21,-13
22,15,291,15,28,-13
22,15,292,32,18,14
22,15,293,24,15,9
22,15,294,11,16,-5
22,15,295,15,20,-5
22,15,296,11,5,6
22,15,297,17,14,3
22,15,298,7,16,-9
22,15,299,18,29,-11
22,16,0,7,15,-8
22,16,1,16,25,-9
22,16,2,8,20,-12
22,16,3,22,21,1
22,16,4,18,12,6
22,16,5,15,15,0
22,16,6,17,21,-4
22,16,7,8,19,-11
22,16,8,22,28,-6
22,16,9,11,9,2
22,16,10,11,23,-12
22,16,11,7,13,-6
22,16,12,11,19,-8
22,16,13,15,10,5
22,16,14,11,16,-5
22,16,15,16,21,-5
22,16,16,10,11,-1
22,16,17,21,27,-6
22,16,18,15,19,-4
22,16,19,9,8,1
22,16,20,17,29,-12
22,16,21,17,7,10
22,16,22,23,16,7
22,16,23,24,31,-7
22,16,24,15,16,-1
22,16,25,10,6,4
22,16,26,7,14,-7
22,16,27,13,23,-10
22,16,28,12,22,-10
22,16,29,6,13,-7
22,16,30,9,19,-10
22,16,31,11,10,1
22,16,32,4,5,-1
22,16,33,6,16,-10
22,16,34,5,14,-9
22,16,35,24,21,3
22,16,36,11,8,3
22,16,37,18,21,-3
22,16,38,17,30,-13
22,16,39,12,18,-6
22,16,40,8,16,-8
22,16,41,16,20,-4
22,16,42,15,18,-3
22,16,43,17,14,3
22,16,44,13,13,0
22,16,45,9,42,-33
22,16,46,16,14,2
22,16,47,19,24,-5
22,16,48,9,7,2
22,16,49,2,17,-15
22,16,50,11,13,-2
22,16,51,8,15,-7
22,16,52,19,11,8
22,16,53,11,7,4
22,16,54,10,13,-3
22,16,55,11,23,-12
22,16,56,15,12,3
22,16,57,19,21,-2
22,16,58,17,23,-6
22,16,59,13,24,-11
22,16,60,21,19,2
22,16,61,17,26,-9
22,16,62,12,14,-2
22,16,63,9,30,-21
22,16,64,24,21,3
22,16,65,4,4,0
22,16,66,21,21,0
22,16,67,14,22,-8
22,16,68,16,22,-6
22,16,69,11,6,5
22,16,70,9,17,-8
22,16,71,9,6,3
22,16,72,23,29,-6
22,16,73,9,21,-12
22,16,74,9,12,-3
22,16,75,4,7,-3
22,16,76,7,11,-4
22,16,77,13,37,-24
22,16,78,15,17,-2
22,16,79,10,15,-5
22,16,80,11,16,-5
22,16,81,6,17,-11
22,16,82,14,21,-7
22,16,83,20,13,7
22,16,84,17,18,-1
22,16,85,14,18,-4
22,16,86,18,13,5
22,16,87,15,24,-9
22,16,88,12,13,-1
22,16,89,19,24,-5
22,16,90,20,21,-1
22,16,91,10,11,-1
22,16,92,10,6,4
22,16,93,10,15,-5
22,16,94,6,17,-11
22,16,95,3,5,-2
22,16,96,6,13,-7
22,16,97,8,15,-7
22,16,98,8,22,-14
22,16,99,4,19,-15
22,16,100,17,14,3
22,16,101,16,31,-15
22,16,102,18,23,-5
22,16,103,29,14,15
22,16,104,22,22,0
22,16,105,19,19,0
22,16,106,9,16,-7
22,16,107,4,21,-17
22,16,108,17,22,-5
22,16,109,9,35,-26
22,16,110,20,23,-3
22,16,111,16,11,5
22,16,112,7,9,-2
22,16,113,11,22,-11
22,16,114,7,22,-15
22,16,115,17,17,0
22,16,116,10,16,-6
22,16,117,22,34,-12
22,16,118,14,14,0
22,16,119,9,14,-5
22,16,120,5,24,-19
22,16,121,18,9,9
22,16,122,15,21,-6
22,16,123,9,21,-12
22,16,124,4,31,-27
22,16,125,16,13,3
22,16,126,15,17,-2
22,16,127,10,22,-12
22,16,128,7,12,-5
22,16,129,4,13,-9
22,16,130,14,13,1
22,16,131,2,15,-13
22,16,132,6,9,-3
22,16,133,12,27,-15
22,16,134,14,29,-15
22,16,135,12,14,-2
22,16,136,13,30,-17
22,16,137,8,9,-1
22,16,138,11,16,-5
22,16,139,17,27,-10
22,16,140,12,21,-9
22,16,141,18,15,3
22,16,142,12,11,1
22,16,143,17,14,3
22,16,144,11,17,-6
22,16,145,19,17,2
22,16,146,13,17,-4
22,16,147,19,17,2
22,16,148,9,12,-3
22,16,149,10,17,-7
22,16,150,21,26,-5
22,16,151,17,33,-16
22,16,152,21,22,-1
22,16,153,15,21,-6
22,16,154,13,11,2
22,16,155,13,16,-3
22,16,156,5,8,-3
22,16,157,17,21,-4
22,16,158,16,21,-5
22,16,159,9,21,-12
22,16,160,31,26,5
22,16,161,21,21,0
22,16,162,12,18,-6
22,16,163,16,20,-4
22,16,164,12,27,-15
22,16,165,10,22,-12
22,16,166,14,16,-2
22,16,167,29,12,17
22,16,168,8,10,-2
22,16,169,9,10,-1
22,16,170,7,16,-9
22,16,171,14,12,2
22,16,172,14,12,2
22,16,173,5,16,-11
22,16,174,11,21,-10
22,16,175,15,19,-4
22,16,176,19,23,-4
22,16,177,10,20,-10
22,16,178,16,11,5
22,16,179,8,6,2
22,16,180,7,21,-14
22,16,181,9,18,-9
22,16,182,20,15,5
22,16,183,17,10,7
22,16,184,20,20,0
22,16,185,4,6,-2
22,16,186,15,17,-2
22,16,187,20,13,7
22,16,188,11,6,5
22,16,189,12,14,-2
22,16,190,4,17,-13
22,16,191,16,19,-3
22,16,192,4,8,-4
22,16,193,11,21,-10
22,16,194,18,21,-3
22,16,195,21,17,4
22,16,196,14,10,4
22,16,197,18,16,2
22,16,198,21,22,-1
22,16,199,6,14,-8
22,16,200,16,12,4
22,16,201,14,18,-4
22,16,202,10,12,-2
22,16,203,12,14,-2
22,16,204,2,15,-13
22,16,205,5,17,-12
22,16,206,16,26,-10
22,16,207,13,21,-8
22,16,208,15,23,-8
22,16,209,19,13,6
22,16,210,11,15,-4
22,16,211,10,12,-2
22,16,212,13,9,4
22,16,213,9,16,-7
22,16,214,16,8,8
22,16,215,3,7,-4
22,16,216,21,9,12
22,16,217,6,15,-9
22,16,218,17,26,-9
22,16,219,13,14,-1
22,16,220,12,23,-11
22,16,221,20,29,-9
22,16,222,2,13,-11
22,16,223,12,24,-12
22,16,224,17,26,-9
22,16,225,12,21,-9
22,16,226,13,13,0
22,16,227,11,16,-5
22,16,228,14,12,2
22,16,229,13,14,-1
22,16,230,5,5,0
22,16,231,7,20,-13
22,16,232,9,19,-10
22,16,233,8,12,-4
22,16,234,15,7,8
22,16,235,16,25,-9
22,16,236,19,17,2
22,16,237,9,15,-6
22,16,238,9,18,-9
22,16,239,13,11,2
22,16,240,24,21,3
22,16,241,8,11,-3
22,16,242,21,17,4
22,16,243,27,13,14
22,16,244,21,19,2
22,16,245,17,9,8
22,16,246,16,18,-2
22,16,247,10,8,2
22,16,248,13,22,-9
22,16,249,19,12,7
22,16,250,16,18,-2
22,16,251,7,15,-8
22,16,252,15,19,-4
22,16,253,9,21,-12
22,16,254,10,17,-7
22,16,255,11,14,-3
22,16,256,13,19,-6
22,16,257,15,19,-4
22,16,258,15,20,-5
22,16,259,21,20,1
22,16,260,12,18,-6
22,16,261,7,14,-7
22,16,262,11,4,7
22,16,263,16,23,-7
22,16,264,7,15,-8
22,16,265,10,9,1
22,16,266,14,29,-15
22,16,267,19,21,-2
22,16,268,28,22,6
22,16,269,6,10,-4
22,16,270,15,22,-7
22,16,271,20,16,4
22,16,272,8,11,-3
22,16,273,16,16,0
22,16,274,14,9,5
22,16,275,11,20,-9
22,16,276,11,16,-5
22,16,277,28,27,1
22,16,278,21,16,5
22,16,279,11,7,4
22,16,280,8,15,-7
22,16,281,10,10,0
22,16,282,11,19,-8
22,16,283,7,15,-8
22,16,284,4,9,-5
22,16,285,14,14,0
22,16,286,15,10,5
22,16,287,11,30,-19
22,16,288,5,7,-2
22,16,289,18,10,8
22,16,290,16,15,1
22,16,291,8,14,-6
22,16,292,11,25,-14
22,16,293,11,24,-13
22,16,294,21,28,-7
22,16,295,10,15,-5
22,16,296,16,15,1
22,16,297,16,24,-8
22,16,298,10,16,-6
22,16,299,10,8,2
22,17,0,11,8,3
22,17,1,16,19,-3
22,17,2,17,9,8
22,17,3,12,23,-11
22,17,4,13,36,-23
22,17,5,7,29,-22
22,17,6,10,16,-6
22,17,7,11,10,1
22,17,8,18,12,6
22,17,9,12,3,9
22,17,10,7,12,-5
22,17,11,7,14,-7
22,17,12,18,16,2
22,17,13,18,23,-5
22,17,14,11,11,0
22,17,15,24,12,12
22,17,16,18,22,-4
22,17,17,11,11,0
22,17,18,14,9,5
22,17,19,8,10,-2
22,17,20,9,19,-10
22,17,21,7,12,-5
22,17,22,10,15,-5
22,17,23,18,23,-5
22,17,24,9,13,-4
22,17,25,13,11,2
22,17,26,12,16,-4
22,17,27,6,10,-4
22,17,28,10,14,-4
22,17,29,6,14,-8
22,17,30,11,20,-9
22,17,31,24,34,-10
22,17,32,17,5,12
22,17,33,13,14,-1
22,17,34,6,11,-5
22,17,35,7,17,-10
22,17,36,8,6,2
22,17,37,19,11,8
22,17,38,24,25,-1
22,17,39,15,19,-4
22,17,40,14,10,4
22,17,41,8,17,-9
22,17,42,14,17,-3
22,17,43,7,20,-13
22,17,44,18,15,3
22,17,45,9,11,-2
22,17,46,14,17,-3
22,17,47,16,14,2
22,17,48,21,17,4
22,17,49,8,4,4
22,17,50,7,21,-14
22,17,51,9,18,-9
22,17,52,17,23,-6
22,17,53,15,5,10
22,17,54,8,15,-7
22,17,55,16,21,-5
22,17,56,18,9,9
22,17,57,11,17,-6
22,17,58,9,13,-4
22,17,59,12,17,-5
22,17,60,17,35,-18
22,17,61,18,10,8
22,17,62,15,20,-5
22,17,63,8,12,-4
22,17,64,8,14,-6
22,17,65,15,24,-9
22,17,66,18,16,2
22,17,67,12,19,-7
22,17,68,9,16,-7
22,17,69,9,16,-7
22,17,70,8,15,-7
22,17,71,11,19,-8
22,17,72,14,13,1
22,17,73,14,19,-5
22,17,74,16,11,5
22,17,75,16,13,3
22,17,76,10,22,-12
22,17,77,16,15,1
22,17,78,14,11,3
22,17,79,21,17,4
22,17,80,12,13,-1
22,17,81,6,16,-10
22,17,82,5,18,-13
22,17,83,11,25,-14
22,17,84,23,37,-14
22,17,85,10,14,-4
22,17,86,14,9,5
22,17,87,5,21,-16
22,17,88,10,15,-5
22,17,89,10,17,-7
22,17,90,27,14,13
22,17,91,20,28,-8
22,17,92,8,11,-3
22,17,93,10,7,3
22,17,94,18,18,0
22,17,95,25,18,7
22,17,96,12,22,-10
22,17,97,14,8,6
22,17,98,13,24,-11
22,17,99,4,2,2
22,17,100,12,18,-6
22,17,101,12,15,-3
22,17,102,9,31,-22
22,17,103,11,14,-3
22,17,104,10,5,5
22,17,105,15,16,-1
22,17,106,16,18,-2
22,17,107,13,13,0
22,17,108,15,19,-4
22,17,109,14,14,0
22,17,110,29,19,10
22,17,111,14,12,2
22,17,112,23,22,1
22,17,113,4,15,-11
22,17,114,12,11,1
22,17,115,22,8,14
22,17,116,12,20,-8
22,17,117,7,13,-6
22,17,118,8,15,-7
22,17,119,25,17,8
22,17,120,8,21,-13
22,17,121,14,15,-1
22,17,122,13,22,-9
22,17,123,17,24,-7
22,17,124,15,6,9
22,17,125,16,11,5
22,17,126,12,9,3
22,17,127,21,34,-13
22,17,128,14,10,4
22,17,129,9,17,-8
22,17,130,7,14,-7
22,17,131,7,26,-19
22,17,132,15,15,0
22,17,133,25,10,15
22,17,134,19,18,1
22,17,135,11,8,3
22,17,136,17,24,-7
22,17,137,17,22,-5
22,17,138,10,8,2
22,17,139,12,14,-2
22,17,140,9,10,-1
22,17,141,11,21,-10
22,17,142,13,30,-17
22,17,143,7,11,-4
22,17,144,19,15,4
22,17,145,12,25,-13
22,17,146,16,23,-7
22,17,147,11,13,-2
22,17,148,18,27,-9
22,17,149,14,19,-5
22,17,150,9,21,-12
22,17,151,9,22,-13
22,17,152,6,18,-12
22,17,153,16,23,-7
22,17,154,14,14,0
22,17,155,8,13,-5
22,17,156,9,16,-7
22,17,157,26,16,10
22,17,158,14,19,-5
22,17,159,6,11,-5
22,17,160,8,7,1
22,17,161,14,9,5
22,17,162,16,31,-15
22,17,163,10,6,4
22,17,164,14,16,-2
22,17,165,9,13,-4
22,17,166,16,22,-6
22,17,167,7,14,-7
22,17,168,4,7,-3
22,17,169,21,6,15
22,17,170,13,25,-12
22,17,171,11,14,-3
22,17,172,9,21,-12
22,17,173,15,14,1
22,17,174,22,30,-8
22,17,175,8,11,-3
22,17,176,20,11,9
22,17,177,10,13,-3
22,17,178,22,14,8
22,17,179,14,17,-3
22,17,180,7,20,-13
22,17,181,16,22,-6
22,17,182,22,20,2
22,17,183,14,17,-3
22,17,184,22,23,-1
22,17,185,13,6,7
22,17,186,12,14,-2
22,17,187,17,10,7
22,17,188,23,13,10
22,17,189,10,16,-6
22,17,190,8,24,-16
22,17,191,16,17,-1
22,17,192,12,11,1
22,17,193,3,13,-10
22,17,194,23,24,-1
22,17,195,10,9,1
22,17,196,13,10,3
22,17,197,15,17,-2
22,17,198,17,10,7
22,17,199,20,21,-1
22,17,200,12,13,-1
22,17,201,8,16,-8
22,17,202,8,21,-13
22,17,203,12,18,-6
22,17,204,14,11,3
22,17,205,15,14,1
22,17,206,19,22,-3
22,17,207,8,12,-4
22,17,208,7,15,-8
22,17,209,9,17,-8
22,17,210,13,15,-2
22,17,211,17,15,2
22,17,212,6,10,-4
22,17,213,13,12,1
22,17,214,12,26,-14
22,17,215,8,20,-12
22,17,216,8,22,-14
22,17,217,10,6,4
22,17,218,3,5,-2
22,17,219,16,11,5
22,17,220,13,12,1
22,17,221,9,16,-7
22,17,222,21,18,3
22,17,223,10,19,-9
22,17,224,11,16,-5
22,17,225,15,16,-1
22,17,226,10,16,-6
22,17,227,12,17,-5
22,17,228,24,13,11
22,17,229,18,18,0
22,17,230,13,11,2
22,17,231,18,21,-3
22,17,232,14,12,2
22,17,233,10,17,-7
22,17,234,9,8,1
22,17,235,17,17,0
22,17,236,19,14,5
22,17,237,11,11,0
22,17,238,15,10,5
22,17,239,12,22,-10
22,17,240,12,17,-5
22,17,241,9,14,-5
22,17,242,9,22,-13
22,17,243,5,17,-12
22,17,244,7,12,-5
22,17,245,12,18,-6
22,17,246,4,8,-4
22,17,247,10,18,-8
22,17,248,7,15,-8
22,17,249,10,17,-7
22,17,250,9,9,0
22,17,251,3,6,-3
22,17,252,20,11,9
22,17,253,5,19,-14
22,17,254,6,20,-14
22,17,255,16,22,-6
22,17,256,10,13,-3
22,17,257,29,15,14
22,17,258,12,8,4
22,17,259,12,15,-3
22,17,260,22,16,6
22,17,261,19,13,6
22,17,262,12,9,3
22,17,263,25,37,-12
22,17,264,9,9,0
22,17,265,13,21,-8
22,17,266,14,14,0
22,17,267,19,14,5
22,17,268,14,11,3
22,17,269,17,16,1
22,17,270,8,11,-3
22,17,271,14,17,-3
22,17,272,6,21,-15
22,17,273,23,19,4
22,17,274,11,18,-7
22,17,275,16,19,-3
22,17,276,12,10,2
22,17,277,15,20,-5
22,17,278,16,13,3
22,17,279,15,29,-14
22,17,280,18,22,-4
22,17,281,18,16,2
22,17,282,10,13,-3
22,17,283,13,15,-2
22,17,284,7,13,-6
22,17,285,16,15,1
22,17,286,13,12,1
22,17,287,10,16,-6
22,17,288,7,23,-16
22,17,289,19,16,3
22,17,290,18,28,-10
22,17,291,15,14,1
22,17,292,2,26,-24
22,17,293,11,12,-1
22,17,294,19,21,-2
22,17,295,12,12,0
22,17,296,3,22,-19
22,17,297,13,22,-9
22,17,298,13,16,-3
22,17,299,20,20,0
22,18,0,5,16,-11
22,18,1,8,15,-7
22,18,2,20,20,0
22,18,3,19,9,10
22,18,4,14,15,-1
22,18,5,23,16,7
22,18,6,8,19,-11
22,18,7,12,16,-4
22,18,8,19,17,2
22,18,9,21,10,11
22,18,10,13,9,4
22,18,11,6,11,-5
22,18,12,27,17,10
22,18,13,21,27,-6
22,18,14,18,28,-10
22,18,15,21,7,14
22,18,16,7,21,-14
22,18,17,6,14,-8
22,18,18,11,25,-14
22,18,19,19,33,-14
22,18,20,22,18,4
22,18,21,12,20,-8
22,18,22,8,5,3
22,18,23,21,10,11
22,18,24,8,21,-13
22,18,25,8,9,-1
22,18,26,13,20,-7
22,18,27,21,34,-13
22,18,28,13,23,-10
22,18,29,11,19,-8
22,18,30,13,18,-5
22,18,31,15,11,4
22,18,32,8,6,2
22,18,33,16,15,1
22,18,34,8,8,0
22,18,35,25,21,4
22,18,36,11,13,-2
22,18,37,14,11,3
22,18,38,14,18,-4
22,18,39,18,8,10
22,18,40,11,13,-2
22,18,41,13,12,1
22,18,42,16,9,7
22,18,43,16,16,0
22,18,44,9,17,-8
22,18,45,14,14,0
22,18,46,6,4,2
22,18,47,13,17,-4
22,18,48,13,12,1
22,18,49,17,20,-3
22,18,50,12,18,-6
22,18,51,18,13,5
22,18,52,28,23,5
22,18,53,27,10,17
22,18,54,9,10,-1
22,18,55,7,22,-15
22,18,56,8,11,-3
22,18,57,3,25,-22
22,18,58,12,22,-10
22,18,59,10,13,-3
22,18,60,19,26,-7
22,18,61,9,6,3
22,18,62,7,14,-7
22,18,63,16,12,4
22,18,64,8,21,-13
22,18,65,17,20,-3
22,18,66,19,18,1
22,18,67,13,19,-6
22,18,68,12,15,-3
22,18,69,22,23,-1
22,18,70,17,14,3
22,18,71,5,7,-2
22,18,72,22,13,9
22,18,73,9,15,-6
22,18,74,13,20,-7
22,18,75,10,8,2
22,18,76,7,9,-2
22,18,77,12,15,-3
22,18,78,18,21,-3
22,18,79,17,11,6
22,18,80,5,10,-5
22,18,81,12,20,-8
22,18,82,2,15,-13
22,18,83,14,17,-3
22,18,84,11,16,-5
22,18,85,13,28,-15
22,18,86,13,8,5
22,18,87,5,25,-20
22,18,88,8,11,-3
22,18,89,6,15,-9
22,18,90,8,8,0
22,18,91,22,7,15
22,18,92,15,22,-7
22,18,93,10,15,-5
22,18,94,8,12,-4
22,18,95,11,16,-5
22,18,96,12,15,-3
22,18,97,22,16,6
22,18,98,8,15,-7
22,18,99,7,17,-10
22,18,100,22,18,4
22,18,101,17,16,1
22,18,102,21,19,2
22,18,103,21,26,-5
22,18,104,0,16,-16
22,18,105,21,19,2
22,18,106,25,19,6
22,18,107,10,24,-14
22,18,108,5,13,-8
22,18,109,19,13,6
22,18,110,11,8,3
22,18,111,14,10,4
22,18,112,12,14,-2
22,18,113,15,9,6
22,18,114,8,9,-1
22,18,115,3,11,-8
22,18,116,7,13,-6
22,18,117,10,17,-7
22,18,118,12,16,-4
22,18,119,13,17,-4
22,18,120,9,23,-14
22,18,121,13,24,-11
22,18,122,13,17,-4
22,18,123,8,13,-5
22,18,124,18,19,-1
22,18,125,8,21,-13
22,18,126,14,14,0
22,18,127,13,20,-7
22,18,128,4,14,-10
22,18,129,5,21,-16
22,18,130,20,7,13
22,18,131,11,19,-8
22,18,132,26,16,10
22,18,133,8,11,-3
22,18,134,5,15,-10
22,18,135,5,5,0
22,18,136,13,12,1
22,18,137,20,15,5
22,18,138,24,19,5
22,18,139,11,15,-4
22,18,140,19,22,-3
22,18,141,6,16,-10
22,18,142,12,11,1
22,18,143,13,7,6
22,18,144,14,12,2
22,18,145,11,8,3
22,18,146,18,20,-2
22,18,147,21,29,-8
22,18,148,6,9,-3
22,18,149,5,16,-11
22,18,150,14,16,-2
22,18,151,4,16,-12
22,18,152,16,14,2
22,18,153,23,15,8
22,18,154,13,14,-1
22,18,155,16,22,-6
22,18,156,18,13,5
22,18,157,9,10,-1
22,18,158,15,24,-9
22,18,159,27,16,11
22,18,160,13,10,3
22,18,161,14,15,-1
22,18,162,12,4,8
22,18,163,8,17,-9
22,18,164,12,9,3
22,18,165,7,10,-3
22,18,166,15,6,9
22,18,167,24,21,3
22,18,168,21,12,9
22,18,169,17,28,-11
22,18,170,10,13,-3
22,18,171,13,12,1
22,18,172,24,15,9
22,18,173,12,7,5
22,18,174,8,12,-4
22,18,175,13,17,-4
22,18,176,19,22,-3
22,18,177,9,10,-1
22,18,178,17,13,4
22,18,179,11,28,-17
22,18,180,2,14,-12
22,18,181,13,7,6
22,18,182,10,14,-4
22,18,183,7,8,-1
22,18,184,19,9,10
22,18,185,11,12,-1
22,18,186,10,22,-12
22,18,187,8,12,-4
22,18,188,12,22,-10
22,18,189,2,3,-1
22,18,190,12,14,-2
22,18,191,14,18,-4
22,18,192,16,9,7
22,18,193,16,25,-9
22,18,194,8,22,-14
22,18,195,7,13,-6
22,18,196,14,19,-5
22,18,197,6,11,-5
22,18,198,10,15,-5
22,18,199,11,24,-13
22,18,200,15,8,7
22,18,201,21,13,8
22,18,202,10,14,-4
22,18,203,9,12,-3
22,18,204,11,11,0
22,18,205,17,18,-1
22,18,206,10,13,-3
22,18,207,8,13,-5
22,18,208,16,22,-6
22,18,209,21,20,1
22,18,210,17,16,1
22,18,211,11,13,-2
22,18,212,19,17,2
22,18,213,6,6,0
22,18,214,8,13,-5
22,18,215,16,10,6
22,18,216,20,31,-11
22,18,217,8,14,-6
22,18,218,10,11,-1
22,18,219,17,22,-5
22,18,220,11,23,-12
22,18,221,14,14,0
22,18,222,9,6,3
22,18,223,13,18,-5
22,18,224,10,11,-1
22,18,225,7,21,-14
22,18,226,11,11,0
22,18,227,27,9,18
22,18,228,14,10,4
22,18,229,20,15,5
22,18,230,10,15,-5
22,18,231,15,13,2
22,18,232,5,5,0
22,18,233,11,13,-2
22,18,234,12,11,1
22,18,235,3,21,-18
22,18,236,17,15,2
22,18,237,22,14,8
22,18,238,20,24,-4
22,18,239,23,17,6
22,18,240,15,19,-4
22,18,241,19,24,-5
22,18,242,15,19,-4
22,18,243,7,12,-5
22,18,244,14,17,-3
22,18,245,10,12,-2
22,18,246,0,8,-8
22,18,247,3,7,-4
22,18,248,14,21,-7
22,18,249,15,24,-9
22,18,250,6,13,-7
22,18,251,12,14,-2
22,18,252,11,21,-10
22,18,253,19,14,5
22,18,254,26,15,11
22,18,255,10,7,3
22,18,256,5,8,-3
22,18,257,15,10,5
22,18,258,19,16,3
22,18,259,10,13,-3
22,18,260,7,9,-2
22,18,261,22,7,15
22,18,262,12,21,-9
22,18,263,23,16,7
22,18,264,18,18,0
22,18,265,8,16,-8
22,18,266,12,24,-12
22,18,267,10,10,0
22,18,268,16,20,-4
22,18,269,13,23,-10
22,18,270,9,11,-2
22,18,271,12,5,7
22,18,272,10,13,-3
22,18,273,14,23,-9
22,18,274,23,23,0
22,18,275,17,15,2
22,18,276,7,15,-8
22,18,277,26,23,3
22,18,278,13,12,1
22,18,279,17,9,8
22,18,280,20,14,6
22,18,281,11,34,-23
22,18,282,18,28,-10
22,18,283,9,19,-10
22,18,284,17,14,3
22,18,285,14,29,-15
22,18,286,16,23,-7
22,18,287,24,15,9
22,18,288,9,7,2
22,18,289,17,11,6
22,18,290,10,8,2
22,18,291,6,14,-8
22,18,292,7,12,-5
22,18,293,12,26,-14
22,18,294,7,10,-3
22,18,295,12,18,-6
22,18,296,20,27,-7
22,18,297,5,12,-7
22,18,298,12,16,-4
22,18,299,14,13,1
22,19,0,14,13,1
22,19,1,14,10,4
22,19,2,17,7,10
22,19,3,20,30,-10
22,19,4,9,23,-14
22,19,5,9,14,-5
22,19,6,6,14,-8
22,19,7,12,5,7
22,19,8,18,19,-1
22,19,9,9,25,-16
22,19,10,11,15,-4
22,19,11,11,11,0
22,19,12,28,27,1
22,19,13,9,7,2
22,19,14,13,9,4
22,19,15,36,16,20
22,19,16,13,25,-12
22,19,17,13,18,-5
22,19,18,12,26,-14
22,19,19,9,12,-3
22,19,20,14,19,-5
22,19,21,8,12,-4
22,19,22,11,11,0
22,19,23,17,18,-1
22,19,24,12,11,1
22,19,25,14,20,-6
22,19,26,17,19,-2
22,19,27,9,14,-5
22,19,28,4,12,-8
22,19,29,15,16,-1
22,19,30,20,13,7
22,19,31,12,17,-5
22,19,32,16,17,-1
22,19,33,17,16,1
22,19,34,6,10,-4
22,19,35,12,16,-4
22,19,36,14,13,1
22,19,37,13,9,4
22,19,38,6,22,-16
22,19,39,16,24,-8
22,19,40,17,20,-3
22,19,41,20,10,10
22,19,42,11,23,-12
22,19,43,3,13,-10
22,19,44,13,18,-5
22,19,45,15,10,5
22,19,46,13,9,4
22,19,47,17,14,3
22,19,48,11,9,2
22,19,49,12,8,4
22,19,50,13,8,5
22,19,51,20,22,-2
22,19,52,7,12,-5
22,19,53,16,14,2
22,19,54,11,12,-1
22,19,55,0,7,-7
22,19,56,11,12,-1
22,19,57,12,14,-2
22,19,58,17,25,-8
22,19,59,14,15,-1
22,19,60,7,9,-2
22,19,61,4,12,-8
22,19,62,12,10,2
22,19,63,18,20,-2
22,19,64,10,16,-6
22,19,65,14,14,0
22,19,66,20,23,-3
22,19,67,12,11,1
22,19,68,9,18,-9
22,19,69,10,10,0
22,19,70,9,14,-5
22,19,71,8,18,-10
22,19,72,11,14,-3
22,19,73,9,16,-7
22,19,74,7,13,-6
22,19,75,13,15,-2
22,19,76,14,25,-11
22,19,77,13,11,2
22,19,78,5,8,-3
22,19,79,16,13,3
22,19,80,15,12,3
22,19,81,15,12,3
22,19,82,11,24,-13
22,19,83,12,15,-3
22,19,84,19,19,0
22,19,85,19,22,-3
22,19,86,13,17,-4
22,19,87,14,21,-7
22,19,88,8,14,-6
22,19,89,8,6,2
22,19,90,15,18,-3
22,19,91,19,12,7
22,19,92,12,10,2
22,19,93,10,18,-8
22,19,94,15,10,5
22,19,95,21,9,12
22,19,96,14,21,-7
22,19,97,18,17,1
22,19,98,14,19,-5
22,19,99,5,14,-9
22,19,100,21,14,7
22,19,101,18,15,3
22,19,102,8,16,-8
22,19,103,20,31,-11
22,19,104,14,22,-8
22,19,105,32,9,23
22,19,106,9,10,-1
22,19,107,8,11,-3
22,19,108,19,12,7
22,19,109,16,10,6
22,19,110,12,19,-7
22,19,111,25,16,9
22,19,112,24,42,-18
22,19,113,7,17,-10
22,19,114,13,13,0
22,19,115,16,19,-3
22,19,116,19,23,-4
22,19,117,17,29,-12
22,19,118,16,15,1
22,19,119,21,10,11
22,19,120,22,18,4
22,19,121,10,17,-7
22,19,122,14,19,-5
22,19,123,8,19,-11
22,19,124,12,21,-9
22,19,125,14,12,2
22,19,126,8,22,-14
22,19,127,26,22,4
22,19,128,11,17,-6
22,19,129,10,19,-9
22,19,130,11,8,3
22,19,131,13,23,-10
22,19,132,7,29,-22
22,19,133,17,15,2
22,19,134,3,12,-9
22,19,135,5,9,-4
22,19,136,22,29,-7
22,19,137,11,18,-7
22,19,138,8,14,-6
22,19,139,12,16,-4
22,19,140,15,24,-9
22,19,141,26,18,8
22,19,142,8,13,-5
22,19,143,17,21,-4
22,19,144,18,15,3
22,19,145,13,17,-4
22,19,146,11,5,6
22,19,147,6,9,-3
22,19,148,11,11,0
22,19,149,6,22,-16
22,19,150,12,11,1
22,19,151,20,16,4
22,19,152,17,18,-1
22,19,153,12,25,-13
22,19,154,9,13,-4
22,19,155,14,13,1
22,19,156,18,24,-6
22,19,157,13,23,-10
22,19,158,14,27,-13
22,19,159,17,18,-1
22,19,160,6,19,-13
22,19,161,9,18,-9
22,19,162,11,12,-1
22,19,163,17,20,-3
22,19,164,18,15,3
22,19,165,13,27,-14
22,19,166,8,15,-7
22,19,167,9,16,-7
22,19,168,7,12,-5
22,19,169,13,13,0
22,19,170,12,9,3
22,19,171,14,13,1
22,19,172,15,18,-3
22,19,173,9,21,-12
22,19,174,10,7,3
22,19,175,10,22,-12
22,19,176,16,21,-5
22,19,177,14,19,-5
22,19,178,8,16,-8
22,19,179,9,19,-10
22,19,180,18,25,-7
22,19,181,22,17,5
22,19,182,28,16,12
22,19,183,10,12,-2
22,19,184,9,13,-4
22,19,185,16,14,2
22,19,186,17,14,3
22,19,187,13,19,-6
22,19,188,17,14,3
22,19,189,17,23,-6
22,19,190,13,22,-9
22,19,191,13,19,-6
22,19,192,6,17,-11
22,19,193,10,17,-7
22,19,194,31,21,10
22,19,195,9,5,4
22,19,196,26,24,2
22,19,197,15,21,-6
22,19,198,23,16,7
22,19,199,18,16,2
22,19,200,14,19,-5
22,19,201,12,14,-2
22,19,202,23,16,7
22,19,203,18,23,-5
22,19,204,15,13,2
22,19,205,14,9,5
22,19,206,17,11,6
22,19,207,17,15,2
22,19,208,15,14,1
22,19,209,19,26,-7
22,19,210,10,14,-4
22,19,211,8,12,-4
22,19,212,19,16,3
22,19,213,10,12,-2
22,19,214,15,17,-2
22,19,215,22,19,3
22,19,216,19,27,-8
22,19,217,15,17,-2
22,19,218,12,10,2
22,19,219,15,17,-2
22,19,220,15,12,3
22,19,221,24,19,5
22,19,222,12,11,1
22,19,223,1,15,-14
22,19,224,7,12,-5
22,19,225,27,21,6
22,19,226,7,16,-9
22,19,227,18,19,-1
22,19,228,7,16,-9
22,19,229,20,26,-6
22,19,230,3,23,-20
22,19,231,7,12,-5
22,19,232,16,14,2
22,19,233,11,13,-2
22,19,234,12,21,-9
22,19,235,12,23,-11
22,19,236,7,19,-12
22,19,237,14,16,-2
22,19,238,12,5,7
22,19,239,10,20,-10
22,19,240,20,19,1
22,19,241,8,12,-4
22,19,242,21,13,8
22,19,243,15,35,-20
22,19,244,26,21,5
22,19,245,8,16,-8
22,19,246,17,16,1
22,19,247,18,11,7
22,19,248,10,18,-8
22,19,249,10,7,3
22,19,250,11,12,-1
22,19,251,17,20,-3
22,19,252,5,13,-8
22,19,253,10,22,-12
22,19,254,9,14,-5
22,19,255,13,13,0
22,19,256,13,14,-1
22,19,257,6,21,-15
22,19,258,7,5,2
22,19,259,8,9,-1
22,19,260,2,16,-14
22,19,261,3,13,-10
22,19,262,19,15,4
22,19,263,19,13,6
22,19,264,9,9,0
22,19,265,19,16,3
22,19,266,7,13,-6
22,19,267,20,12,8
22,19,268,24,26,-2
22,19,269,18,6,12
22,19,270,18,15,3
22,19,271,12,11,1
22,19,272,9,26,-17
22,19,273,10,9,1
22,19,274,19,31,-12
22,19,275,14,16,-2
22,19,276,15,25,-10
22,19,277,9,14,-5
22,19,278,3,8,-5
22,19,279,14,8,6
22,19,280,8,12,-4
22,19,281,21,17,4
22,19,282,15,15,0
22,19,283,16,8,8
22,19,284,25,14,11
22,19,285,14,17,-3
22,19,286,7,15,-8
22,19,287,16,18,-2
22,19,288,14,13,1
22,19,289,10,22,-12
22,19,290,8,9,-1
22,19,291,12,23,-11
22,19,292,17,13,4
22,19,293,16,25,-9
22,19,294,12,13,-1
22,19,295,21,24,-3
22,19,296,8,20,-12
22,19,297,11,11,0
22,19,298,6,8,-2
22,19,299,17,15,2
22,20,0,5,11,-6
22,20,1,13,21,-8
22,20,2,12,15,-3
22,20,3,10,20,-10
22,20,4,11,22,-11
22,20,5,18,10,8
22,20,6,9,18,-9
22,20,7,9,13,-4
22,20,8,16,12,4
22,20,9,5,5,0
22,20,10,17,26,-9
22,20,11,21,25,-4
22,20,12,11,12,-1
22,20,13,15,10,5
22,20,14,12,16,-4
22,20,15,33,12,21
22,20,16,19,23,-4
22,20,17,9,19,-10
22,20,18,13,14,-1
22,20,19,12,25,-13
22,20,20,17,15,2
22,20,21,10,11,-1
22,20,22,9,15,-6
22,20,23,21,18,3
22,20,24,18,12,6
22,20,25,11,15,-4
22,20,26,14,16,-2
22,20,27,7,9,-2
22,20,28,8,5,3
22,20,29,12,12,0
22,20,30,20,9,11
22,20,31,11,15,-4
22,20,32,2,14,-12
22,20,33,16,12,4
22,20,34,5,14,-9
22,20,35,13,16,-3
22,20,36,11,28,-17
22,20,37,18,18,0
22,20,38,10,8,2
22,20,39,20,22,-2
22,20,40,10,10,0
22,20,41,9,20,-11
22,20,42,9,23,-14
22,20,43,20,11,9
22,20,44,11,18,-7
22,20,45,19,12,7
22,20,46,5,8,-3
22,20,47,16,24,-8
22,20,48,25,29,-4
22,20,49,12,11,1
22,20,50,14,17,-3
22,20,51,18,7,11
22,20,52,26,20,6
22,20,53,19,11,8
22,20,54,11,12,-1
22,20,55,14,14,0
22,20,56,12,20,-8
22,20,57,24,21,3
22,20,58,15,9,6
22,20,59,17,20,-3
22,20,60,9,13,-4
22,20,61,16,9,7
22,20,62,9,25,-16
22,20,63,18,19,-1
22,20,64,1,18,-17
22,20,65,14,14,0
22,20,66,7,12,-5
22,20,67,9,11,-2
22,20,68,14,6,8
22,20,69,10,12,-2
22,20,70,18,19,-1
22,20,71,17,24,-7
22,20,72,12,18,-6
22,20,73,22,21,1
22,20,74,7,13,-6
22,20,75,20,17,3
22,20,76,7,6,1
22,20,77,10,10,0
22,20,78,4,9,-5
22,20,79,12,18,-6
22,20,80,22,30,-8
22,20,81,11,17,-6
22,20,82,12,16,-4
22,20,83,9,14,-5
22,20,84,12,19,-7
22,20,85,16,12,4
22,20,86,22,13,9
22,20,87,12,14,-2
22,20,88,21,16,5
22,20,89,16,17,-1
22,20,90,23,23,0
22,20,91,20,21,-1
22,20,92,13,20,-7
22,20,93,24,12,12
22,20,94,7,11,-4
22,20,95,16,10,6
22,20,96,12,16,-4
22,20,97,12,21,-9
22,20,98,7,12,-5
22,20,99,18,16,2
22,20,100,15,18,-3
22,20,101,14,14,0
22,20,102,13,15,-2
22,20,103,8,18,-10
22,20,104,13,22,-9
22,20,105,21,20,1
22,20,106,13,9,4
22,20,107,10,8,2
22,20,108,20,6,14
22,20,109,19,10,9
22,20,110,21,18,3
22,20,111,12,20,-8
22,20,112,16,6,10
22,20,113,11,16,-5
22,20,114,18,8,10
22,20,115,8,9,-1
22,20,116,9,10,-1
22,20,117,8,19,-11
22,20,118,20,15,5
22,20,119,13,19,-6
22,20,120,22,22,0
22,20,121,14,19,-5
22,20,122,25,8,17
22,20,123,8,17,-9
22,20,124,15,18,-3
22,20,125,8,14,-6
22,20,126,14,18,-4
22,20,127,12,9,3
22,20,128,13,12,1
22,20,129,11,10,1
22,20,130,3,17,-14
22,20,131,22,7,15
22,20,132,14,19,-5
22,20,133,10,11,-1
22,20,134,8,14,-6
22,20,135,17,27,-10
22,20,136,32,16,16
22,20,137,3,11,-8
22,20,138,17,15,2
22,20,139,24,11,13
22,20,140,9,10,-1
22,20,141,5,21,-16
22,20,142,11,14,-3
22,20,143,16,18,-2
22,20,144,12,23,-11
22,20,145,14,7,7
22,20,146,18,17,1
22,20,147,18,21,-3
22,20,148,16,15,1
22,20,149,8,13,-5
22,20,150,19,13,6
22,20,151,15,11,4
22,20,152,7,19,-12
22,20,153,25,15,10
22,20,154,23,24,-1
22,20,155,10,12,-2
22,20,156,7,13,-6
22,20,157,16,22,-6
22,20,158,18,10,8
22,20,159,20,15,5
22,20,160,19,21,-2
22,20,161,6,30,-24
22,20,162,29,20,9
22,20,163,17,15,2
22,20,164,13,13,0
22,20,165,14,18,-4
22,20,166,3,8,-5
22,20,167,14,27,-13
22,20,168,22,22,0
22,20,169,13,17,-4
22,20,170,7,4,3
22,20,171,11,15,-4
22,20,172,14,17,-3
22,20,173,23,19,4
22,20,174,17,14,3
22,20,175,13,13,0
22,20,176,17,19,-2
22,20,177,14,16,-2
22,20,178,12,10,2
22,20,179,11,15,-4
22,20,180,13,18,-5
22,20,181,17,20,-3
22,20,182,19,17,2
22,20,183,13,10,3
22,20,184,29,22,7
22,20,185,20,21,-1
22,20,186,18,28,-10
22,20,187,8,13,-5
22,20,188,13,15,-2
22,20,189,15,19,-4
22,20,190,30,16,14
22,20,191,7,18,-11
22,20,192,18,9,9
22,20,193,5,20,-15
22,20,194,11,16,-5
22,20,195,15,12,3
22,20,196,24,28,-4
22,20,197,19,14,5
22,20,198,8,13,-5
22,20,199,8,22,-14
22,20,200,7,11,-4
22,20,201,15,11,4
22,20,202,15,15,0
22,20,203,2,6,-4
22,20,204,9,16,-7
22,20,205,21,12,9
22,20,206,9,10,-1
22,20,207,7,13,-6
22,20,208,16,14,2
22,20,209,10,10,0
22,20,210,16,19,-3
22,20,211,14,18,-4
22,20,212,17,22,-5
22,20,213,11,14,-3
22,20,214,12,20,-8
22,20,215,19,20,-1
22,20,216,12,11,1
22,20,217,7,10,-3
22,20,218,12,18,-6
22,20,219,13,12,1
22,20,220,8,9,-1
22,20,221,16,14,2
22,20,222,10,11,-1
22,20,223,13,9,4
22,20,224,14,19,-5
22,20,225,8,10,-2
22,20,226,11,5,6
22,20,227,5,21,-16
22,20,228,15,18,-3
22,20,229,10,12,-2
22,20,230,11,9,2
22,20,231,9,19,-10
22,20,232,30,26,4
22,20,233,19,13,6
22,20,234,12,13,-1
22,20,235,7,25,-18
22,20,236,14,15,-1
22,20,237,16,11,5
22,20,238,12,13,-1
22,20,239,26,15,11
22,20,240,10,13,-3
22,20,241,30,18,12
22,20,242,20,15,5
22,20,243,14,10,4
22,20,244,14,24,-10
22,20,245,10,19,-9
22,20,246,10,18,-8
22,20,247,19,30,-11
22,20,248,20,19,1
22,20,249,10,4,6
22,20,250,13,9,4
22,20,251,16,16,0
22,20,252,12,19,-7
22,20,253,24,30,-6
22,20,254,11,16,-5
22,20,255,14,8,6
22,20,256,14,10,4
22,20,257,18,11,7
22,20,258,14,9,5
22,20,259,16,23,-7
22,20,260,25,22,3
22,20,261,9,9,0
22,20,262,15,17,-2
22,20,263,7,12,-5
22,20,264,12,8,4
22,20,265,11,21,-10
22,20,266,13,17,-4
22,20,267,9,8,1
22,20,268,6,9,-3
22,20,269,25,10,15
22,20,270,4,16,-12
22,20,271,15,12,3
22,20,272,18,15,3
22,20,273,10,17,-7
22,20,274,26,17,9
22,20,275,17,27,-10
22,20,276,8,11,-3
22,20,277,17,5,12
22,20,278,6,17,-11
22,20,279,22,19,3
22,20,280,21,17,4
22,20,281,18,22,-4
22,20,282,23,28,-5
22,20,283,18,11,7
22,20,284,7,11,-4
22,20,285,10,0,10
22,20,286,8,13,-5
22,20,287,19,16,3
22,20,288,15,16,-1
22,20,289,32,34,-2
22,20,290,14,21,-7
22,20,291,14,17,-3
22,20,292,15,21,-6
22,20,293,13,10,3
22,20,294,18,22,-4
22,20,295,26,34,-8
22,20,296,6,8,-2
22,20,297,17,13,4
22,20,298,16,10,6
22,20,299,10,22,-12
22,21,0,7,19,-12
22,21,1,6,25,-19
22,21,2,18,11,7
22,21,3,11,11,0
22,21,4,16,15,1
22,21,5,15,9,6
22,21,6,21,16,5
22,21,7,12,7,5
22,21,8,23,16,7
22,21,9,4,9,-5
22,21,10,14,9,5
22,21,11,22,10,12
22,21,12,18,20,-2
22,21,13,20,37,-17
22,21,14,5,9,-4
22,21,15,8,11,-3
22,21,16,1,14,-13
22,21,17,31,12,19
22,21,18,15,21,-6
22,21,19,13,14,-1
22,21,20,21,25,-4
22,21,21,17,18,-1
22,21,22,25,20,5
22,21,23,16,12,4
22,21,24,10,11,-1
22,21,25,17,11,6
22,21,26,10,18,-8
22,21,27,12,14,-2
22,21,28,20,21,-1
22,21,29,28,22,6
22,21,30,8,9,-1
22,21,31,21,13,8
22,21,32,11,28,-17
22,21,33,16,7,9
22,21,34,15,9,6
22,21,35,15,13,2
22,21,36,17,19,-2
22,21,37,13,17,-4
22,21,38,8,26,-18
22,21,39,17,7,10
22,21,40,20,14,6
22,21,41,22,13,9
22,21,42,11,17,-6
22,21,43,18,12,6
22,21,44,12,15,-3
22,21,45,7,17,-10
22,21,46,9,12,-3
22,21,47,17,28,-11
22,21,48,11,4,7
22,21,49,17,25,-8
22,21,50,6,10,-4
22,21,51,18,14,4
22,21,52,6,7,-1
22,21,53,14,15,-1
22,21,54,32,29,3
22,21,55,17,25,-8
22,21,56,14,9,5
22,21,57,8,10,-2
22,21,58,7,18,-11
22,21,59,20,23,-3
22,21,60,14,15,-1
22,21,61,6,18,-12
22,21,62,13,12,1
22,21,63,8,13,-5
22,21,64,23,17,6
22,21,65,29,25,4
22,21,66,18,9,9
22,21,67,10,7,3
22,21,68,19,16,3
22,21,69,17,9,8
22,21,70,16,11,5
22,21,71,21,13,8
22,21,72,7,13,-6
22,21,73,15,17,-2
22,21,74,13,23,-10
22,21,75,12,10,2
22,21,76,20,24,-4
22,21,77,12,12,0
22,21,78,3,5,-2
22,21,79,12,20,-8
22,21,80,16,15,1
22,21,81,15,12,3
22,21,82,11,18,-7
22,21,83,10,12,-2
22,21,84,12,17,-5
22,21,85,7,23,-16
22,21,86,13,13,0
22,21,87,5,15,-10
22,21,88,14,10,4
22,21,89,10,9,1
22,21,90,7,18,-11
22,21,91,11,14,-3
22,21,92,16,29,-13
22,21,93,13,11,2
22,21,94,13,13,0
22,21,95,6,10,-4
22,21,96,12,3,9
22,21,97,19,20,-1
22,21,98,20,16,4
22,21,99,20,16,4
22,21,100,15,8,7
22,21,101,10,22,-12
22,21,102,11,14,-3
22,21,103,14,16,-2
22,21,104,16,14,2
22,21,105,14,12,2
22,21,106,16,4,12
22,21,107,20,16,4
22,21,108,4,4,0
22,21,109,10,9,1
22,21,110,17,28,-11
22,21,111,14,12,2
22,21,112,28,32,-4
22,21,113,19,22,-3
22,21,114,15,5,10
22,21,115,17,35,-18
22,21,116,4,7,-3
22,21,117,18,16,2
22,21,118,14,12,2
22,21,119,20,9,11
22,21,120,10,9,1
22,21,121,16,17,-1
22,21,122,8,13,-5
22,21,123,8,7,1
22,21,124,15,24,-9
22,21,125,21,10,11
22,21,126,8,15,-7
22,21,127,13,22,-9
22,21,128,8,18,-10
22,21,129,13,22,-9
22,21,130,16,25,-9
22,21,131,6,6,0
22,21,132,10,11,-1
22,21,133,9,1,8
22,21,134,7,3,4
22,21,135,18,21,-3
22,21,136,16,13,3
22,21,137,8,10,-2
22,21,138,15,26,-11
22,21,139,13,8,5
22,21,140,10,12,-2
22,21,141,17,21,-4
22,21,142,15,26,-11
22,21,143,1,28,-27
22,21,144,9,13,-4
22,21,145,14,20,-6
22,21,146,14,10,4
22,21,147,31,17,14
22,21,148,22,19,3
22,21,149,26,19,7
22,21,150,14,14,0
22,21,151,12,19,-7
22,21,152,12,13,-1
22,21,153,11,10,1
22,21,154,16,19,-3
22,21,155,10,17,-7
22,21,156,15,20,-5
22,21,157,8,9,-1
22,21,158,11,15,-4
22,21,159,14,8,6
22,21,160,28,17,11
22,21,161,10,20,-10
22,21,162,10,11,-1
22,21,163,23,15,8
22,21,164,10,6,4
22,21,165,7,16,-9
22,21,166,16,15,1
22,21,167,24,21,3
22,21,168,10,11,-1
22,21,169,11,10,1
22,21,170,12,12,0
22,21,171,4,16,-12
22,21,172,10,18,-8
22,21,173,19,33,-14
22,21,174,26,16,10
22,21,175,21,26,-5
22,21,176,2,8,-6
22,21,177,17,12,5
22,21,178,8,21,-13
22,21,179,11,18,-7
22,21,180,9,14,-5
22,21,181,17,21,-4
22,21,182,6,28,-22
22,21,183,10,18,-8
22,21,184,7,13,-6
22,21,185,13,14,-1
22,21,186,14,12,2
22,21,187,21,24,-3
22,21,188,9,20,-11
22,21,189,17,13,4
22,21,190,20,26,-6
22,21,191,17,9,8
22,21,192,10,13,-3
22,21,193,17,15,2
22,21,194,13,19,-6
22,21,195,10,21,-11
22,21,196,13,19,-6
22,21,197,22,22,0
22,21,198,12,23,-11
22,21,199,12,15,-3
22,21,200,13,10,3
22,21,201,10,25,-15
22,21,202,8,12,-4
22,21,203,24,29,-5
22,21,204,16,21,-5
22,21,205,11,16,-5
22,21,206,8,24,-16
22,21,207,13,7,6
22,21,208,4,8,-4
22,21,209,11,12,-1
22,21,210,11,9,2
22,21,211,20,15,5
22,21,212,18,28,-10
22,21,213,20,18,2
22,21,214,15,19,-4
22,21,215,7,15,-8
22,21,216,14,19,-5
22,21,217,19,11,8
22,21,218,8,10,-2
22,21,219,14,18,-4
22,21,220,8,12,-4
22,21,221,10,14,-4
22,21,222,3,5,-2
22,21,223,9,17,-8
22,21,224,23,7,16
22,21,225,17,16,1
22,21,226,19,29,-10
22,21,227,15,13,2
22,21,228,29,26,3
22,21,229,10,12,-2
22,21,230,10,8,2
22,21,231,2,11,-9
22,21,232,16,17,-1
22,21,233,8,12,-4
22,21,234,5,22,-17
22,21,235,14,13,1
22,21,236,12,17,-5
22,21,237,12,9,3
22,21,238,10,7,3
22,21,239,13,14,-1
22,21,240,11,21,-10
22,21,241,8,12,-4
22,21,242,25,22,3
22,21,243,13,16,-3
22,21,244,18,28,-10
22,21,245,11,24,-13
22,21,246,20,18,2
22,21,247,15,25,-10
22,21,248,14,20,-6
22,21,249,29,18,11
22,21,250,15,21,-6
22,21,251,7,15,-8
22,21,252,7,4,3
22,21,253,13,18,-5
22,21,254,6,12,-6
22,21,255,15,9,6
22,21,256,22,26,-4
22,21,257,19,16,3
22,21,258,15,10,5
22,21,259,12,17,-5
22,21,260,13,10,3
22,21,261,18,10,8
22,21,262,9,11,-2
22,21,263,10,25,-15
22,21,264,13,16,-3
22,21,265,15,17,-2
22,21,266,24,21,3
22,21,267,20,19,1
22,21,268,13,17,-4
22,21,269,12,11,1
22,21,270,10,24,-14
22,21,271,24,14,10
22,21,272,16,15,1
22,21,273,25,21,4
22,21,274,11,13,-2
22,21,275,16,11,5
22,21,276,10,6,4
22,21,277,15,30,-15
22,21,278,7,12,-5
22,21,279,22,19,3
22,21,280,7,11,-4
22,21,281,8,5,3
22,21,282,17,19,-2
22,21,283,7,9,-2
22,21,284,11,23,-12
22,21,285,16,7,9
22,21,286,13,13,0
22,21,287,12,11,1
22,21,288,15,11,4
22,21,289,17,18,-1
22,21,290,10,18,-8
22,21,291,8,22,-14
22,21,292,16,3,13
22,21,293,19,14,5
22,21,294,29,24,5
22,21,295,21,22,-1
22,21,296,11,21,-10
22,21,297,9,15,-6
22,21,298,12,11,1
22,21,299,19,23,-4
22,22,0,10,3,7
22,22,1,13,9,4
22,22,2,20,24,-4
22,22,3,7,12,-5
22,22,4,10,15,-5
22,22,5,13,13,0
22,22,6,13,19,-6
22,22,7,13,5,8
22,22,8,12,13,-1
22,22,9,9,13,-4
22,22,10,18,16,2
22,22,11,3,4,-1
22,22,12,12,9,3
22,22,13,23,15,8
22,22,14,12,12,0
22,22,15,8,15,-7
22,22,16,21,20,1
22,22,17,3,6,-3
22,22,18,16,22,-6
22,22,19,21,29,-8
22,22,20,10,10,0
22,22,21,12,11,1
22,22,22,13,12,1
22,22,23,28,23,5
22,22,24,10,14,-4
22,22,25,8,14,-6
22,22,26,15,11,4
22,22,27,17,21,-4
22,22,28,22,14,8
22,22,29,18,16,2
22,22,30,4,4,0
22,22,31,11,12,-1
22,22,32,23,18,5
22,22,33,10,17,-7
22,22,34,30,22,8
22,22,35,14,23,-9
22,22,36,10,10,0
22,22,37,11,11,0
22,22,38,17,17,0
22,22,39,10,14,-4
22,22,40,21,23,-2
22,22,41,19,15,4
22,22,42,12,17,-5
22,22,43,21,32,-11
22,22,44,11,20,-9
22,22,45,14,14,0
22,22,46,12,8,4
22,22,47,8,10,-2
22,22,48,11,17,-6
22,22,49,16,18,-2
22,22,50,7,7,0
22,22,51,10,17,-7
22,22,52,18,15,3
22,22,53,6,14,-8
22,22,54,19,18,1
22,22,55,16,19,-3
22,22,56,7,21,-14
22,22,57,21,13,8
22,22,58,9,10,-1
22,22,59,11,11,0
22,22,60,13,20,-7
22,22,61,12,16,-4
22,22,62,17,19,-2
22,22,63,12,20,-8
22,22,64,12,17,-5
22,22,65,12,11,1
22,22,66,12,18,-6
22,22,67,13,21,-8
22,22,68,17,21,-4
22,22,69,12,9,3
22,22,70,7,13,-6
22,22,71,22,18,4
22,22,72,14,9,5
22,22,73,13,14,-1
22,22,74,15,16,-1
22,22,75,12,13,-1
22,22,76,16,23,-7
22,22,77,15,20,-5
22,22,78,18,27,-9
22,22,79,10,21,-11
22,22,80,15,11,4
22,22,81,14,23,-9
22,22,82,15,18,-3
22,22,83,16,27,-11
22,22,84,14,16,-2
22,22,85,13,15,-2
22,22,86,9,14,-5
22,22,87,10,11,-1
22,22,88,7,16,-9
22,22,89,24,18,6
22,22,90,5,9,-4
22,22,91,6,7,-1
22,22,92,10,25,-15
22,22,93,7,14,-7
22,22,94,18,4,14
22,22,95,8,15,-7
22,22,96,24,19,5
22,22,97,18,16,2
22,22,98,15,20,-5
22,22,99,15,17,-2
22,22,100,12,11,1
22,22,101,9,17,-8
22,22,102,19,27,-8
22,22,103,15,28,-13
22,22,104,12,10,2
22,22,105,12,27,-15
22,22,106,7,13,-6
22,22,107,12,16,-4
22,22,108,8,11,-3
22,22,109,13,15,-2
22,22,110,10,11,-1
22,22,111,14,23,-9
22,22,112,15,13,2
22,22,113,19,12,7
22,22,114,21,9,12
22,22,115,14,8,6
22,22,116,13,17,-4
22,22,117,9,10,-1
22,22,118,5,17,-12
22,22,119,14,11,3
22,22,120,6,8,-2
22,22,121,18,25,-7
22,22,122,2,18,-16
22,22,123,10,19,-9
22,22,124,16,17,-1
22,22,125,15,9,6
22,22,126,9,22,-13
22,22,127,12,11,1
22,22,128,24,8,16
22,22,129,7,13,-6
22,22,130,15,14,1
22,22,131,19,15,4
22,22,132,18,13,5
22,22,133,21,12,9
22,22,134,11,9,2
22,22,135,12,16,-4
22,22,136,19,14,5
22,22,137,20,26,-6
22,22,138,9,7,2
22,22,139,8,22,-14
22,22,140,18,37,-19
22,22,141,16,10,6
22,22,142,24,18,6
22,22,143,17,19,-2
22,22,144,15,19,-4
22,22,145,13,24,-11
22,22,146,23,12,11
22,22,147,11,14,-3
22,22,148,4,17,-13
22,22,149,20,17,3
22,22,150,16,13,3
22,22,151,26,18,8
22,22,152,9,16,-7
22,22,153,11,23,-12
22,22,154,8,12,-4
22,22,155,8,11,-3
22,22,156,11,15,-4
22,22,157,10,12,-2
22,22,158,9,16,-7
22,22,159,11,11,0
22,22,160,8,3,5
22,22,161,9,13,-4
22,22,162,8,18,-10
22,22,163,9,9,0
22,22,164,17,12,5
22,22,165,16,14,2
22,22,166,19,6,13
22,22,167,16,25,-9
22,22,168,27,22,5
22,22,169,23,32,-9
22,22,170,8,15,-7
22,22,171,17,19,-2
22,22,172,7,6,1
22,22,173,2,4,-2
22,22,174,13,16,-3
22,22,175,16,14,2
22,22,176,1,13,-12
22,22,177,15,5,10
22,22,178,7,24,-17
22,22,179,5,13,-8
22,22,180,13,18,-5
22,22,181,13,16,-3
22,22,182,11,16,-5
22,22,183,13,9,4
22,22,184,16,9,7
22,22,185,9,12,-3
22,22,186,15,25,-10
22,22,187,14,11,3
22,22,188,20,16,4
22,22,189,18,19,-1
22,22,190,12,13,-1
22,22,191,25,20,5
22,22,192,6,13,-7
22,22,193,25,17,8
22,22,194,10,15,-5
22,22,195,21,9,12
22,22,196,15,9,6
22,22,197,18,19,-1
22,22,198,3,11,-8
22,22,199,16,26,-10
22,22,200,6,8,-2
22,22,201,7,12,-5
22,22,202,19,10,9
22,22,203,20,9,11
22,22,204,12,15,-3
22,22,205,13,15,-2
22,22,206,31,10,21
22,22,207,12,7,5
22,22,208,10,4,6
22,22,209,12,13,-1
22,22,210,13,4,9
22,22,211,11,18,-7
22,22,212,9,12,-3
22,22,213,1,16,-15
22,22,214,12,23,-11
22,22,215,11,21,-10
22,22,216,27,20,7
22,22,217,10,23,-13
22,22,218,10,9,1
22,22,219,11,14,-3
22,22,220,13,19,-6
22,22,221,17,19,-2
22,22,222,15,18,-3
22,22,223,9,16,-7
22,22,224,14,15,-1
22,22,225,9,18,-9
22,22,226,13,18,-5
22,22,227,18,14,4
22,22,228,6,5,1
22,22,229,18,19,-1
22,22,230,16,13,3
22,22,231,9,10,-1
22,22,232,13,14,-1
22,22,233,7,15,-8
22,22,234,10,20,-10
22,22,235,12,12,0
22,22,236,9,11,-2
22,22,237,10,18,-8
22,22,238,28,13,15
22,22,239,8,22,-14
22,22,240,15,6,9
22,22,241,17,17,0
22,22,242,23,19,4
22,22,243,15,12,3
22,22,244,17,18,-1
22,22,245,15,14,1
22,22,246,6,17,-11
22,22,247,16,14,2
22,22,248,8,24,-16
22,22,249,5,5,0
22,22,250,13,19,-6
22,22,251,12,12,0
22,22,252,9,6,3
22,22,253,15,26,-11
22,22,254,4,14,-10
22,22,255,6,9,-3
22,22,256,22,7,15
22,22,257,12,17,-5
22,22,258,4,8,-4
22,22,259,10,18,-8
22,22,260,14,23,-9
22,22,261,14,11,3
22,22,262,8,16,-8
22,22,263,7,11,-4
22,22,264,11,14,-3
22,22,265,17,16,1
22,22,266,24,25,-1
22,22,267,21,15,6
22,22,268,14,14,0
22,22,269,7,26,-19
22,22,270,13,29,-16
22,22,271,12,25,-13
22,22,272,10,17,-7
22,22,273,16,14,2
22,22,274,18,14,4
22,22,275,14,13,1
22,22,276,21,11,10
22,22,277,7,16,-9
22,22,278,12,15,-3
22,22,279,5,5,0
22,22,280,10,22,-12
22,22,281,10,25,-15
22,22,282,6,10,-4
22,22,283,23,22,1
22,22,284,13,16,-3
22,22,285,17,20,-3
22,22,286,14,10,4
22,22,287,16,20,-4
22,22,288,21,15,6
22,22,289,16,9,7
22,22,290,4,16,-12
22,22,291,12,23,-11
22,22,292,10,17,-7
22,22,293,15,6,9
22,22,294,10,23,-13
22,22,295,17,34,-17
22,22,296,14,12,2
22,22,297,21,17,4
22,22,298,22,12,10
22,22,299,26,14,12
22,23,0,7,11,-4
22,23,1,10,4,6
22,23,2,17,12,5
22,23,3,24,17,7
22,23,4,19,14,5
22,23,5,15,9,6
22,23,6,10,15,-5
22,23,7,21,20,1
22,23,8,16,10,6
22,23,9,12,12,0
22,23,10,11,15,-4
22,23,11,9,25,-16
22,23,12,15,10,5
22,23,13,15,8,7
22,23,14,18,18,0
22,23,15,20,29,-9
22,23,16,10,7,3
22,23,17,13,18,-5
22,23,18,10,18,-8
22,23,19,22,14,8
22,23,20,16,12,4
22,23,21,22,6,16
22,23,22,12,9,3
22,23,23,29,23,6
22,23,24,10,7,3
22,23,25,13,7,6
22,23,26,8,13,-5
22,23,27,15,14,1
22,23,28,17,10,7
22,23,29,14,14,0
22,23,30,17,9,8
22,23,31,21,15,6
22,23,32,12,9,3
22,23,33,13,10,3
22,23,34,7,3,4
22,23,35,9,19,-10
22,23,36,11,18,-7
22,23,37,3,22,-19
22,23,38,6,8,-2
22,23,39,11,15,-4
22,23,40,10,11,-1
22,23,41,6,4,2
22,23,42,5,6,-1
22,23,43,15,7,8
22,23,44,19,9,10
22,23,45,17,18,-1
22,23,46,14,11,3
22,23,47,7,6,1
22,23,48,10,9,1
22,23,49,14,17,-3
22,23,50,15,12,3
22,23,51,10,12,-2
22,23,52,14,15,-1
22,23,53,13,9,4
22,23,54,28,26,2
22,23,55,13,20,-7
22,23,56,23,11,12
22,23,57,8,14,-6
22,23,58,25,16,9
22,23,59,13,20,-7
22,23,60,14,19,-5
22,23,61,19,15,4
22,23,62,12,11,1
22,23,63,15,15,0
22,23,64,11,15,-4
22,23,65,15,16,-1
22,23,66,14,10,4
22,23,67,24,16,8
22,23,68,6,8,-2
22,23,69,18,21,-3
22,23,70,11,15,-4
22,23,71,13,19,-6
22,23,72,15,21,-6
22,23,73,20,15,5
22,23,74,16,14,2
22,23,75,22,15,7
22,23,76,14,5,9
22,23,77,15,15,0
22,23,78,11,11,0
22,23,79,6,11,-5
22,23,80,9,12,-3
22,23,81,12,19,-7
22,23,82,3,16,-13
22,23,83,10,25,-15
22,23,84,12,8,4
22,23,85,12,9,3
22,23,86,13,9,4
22,23,87,18,22,-4
22,23,88,10,10,0
22,23,89,10,8,2
22,23,90,25,20,5
22,23,91,16,13,3
22,23,92,11,8,3
22,23,93,24,15,9
22,23,94,3,7,-4
22,23,95,28,22,6
22,23,96,13,6,7
22,23,97,5,5,0
22,23,98,18,11,7
22,23,99,17,13,4
22,23,100,20,14,6
22,23,101,14,19,-5
22,23,102,26,19,7
22,23,103,18,16,2
22,23,104,16,18,-2
22,23,105,22,12,10
22,23,106,6,14,-8
22,23,107,16,11,5
22,23,108,12,20,-8
22,23,109,17,20,-3
22,23,110,10,25,-15
22,23,111,12,20,-8
22,23,112,7,7,0
22,23,113,8,26,-18
22,23,114,19,16,3
22,23,115,14,17,-3
22,23,116,9,7,2
22,23,117,21,10,11
22,23,118,13,19,-6
22,23,119,21,15,6
22,23,120,9,16,-7
22,23,121,23,9,14
22,23,122,16,15,1
22,23,123,13,7,6
22,23,124,15,16,-1
22,23,125,13,15,-2
22,23,126,7,6,1
22,23,127,15,15,0
22,23,128,16,10,6
22,23,129,12,26,-14
22,23,130,11,12,-1
22,23,131,7,3,4
22,23,132,14,17,-3
22,23,133,10,33,-23
22,23,134,17,26,-9
22,23,135,12,15,-3
22,23,136,14,24,-10
22,23,137,21,20,1
22,23,138,12,10,2
22,23,139,13,9,4
22,23,140,25,18,7
22,23,141,12,29,-17
22,23,142,13,11,2
22,23,143,9,14,-5
22,23,144,17,9,8
22,23,145,17,15,2
22,23,146,9,5,4
22,23,147,13,17,-4
22,23,148,20,24,-4
22,23,149,12,9,3
22,23,150,12,21,-9
22,23,151,25,9,16
22,23,152,18,13,5
22,23,153,17,19,-2
22,23,154,10,17,-7
22,23,155,14,12,2
22,23,156,24,15,9
22,23,157,12,19,-7
22,23,158,10,7,3
22,23,159,13,9,4
22,23,160,13,10,3
22,23,161,13,13,0
22,23,162,12,16,-4
22,23,163,3,22,-19
22,23,164,28,16,12
22,23,165,15,12,3
22,23,166,12,9,3
22,23,167,9,9,0
22,23,168,13,8,5
22,23,169,9,19,-10
22,23,170,12,24,-12
22,23,171,13,20,-7
22,23,172,13,21,-8
22,23,173,18,11,7
22,23,174,11,14,-3
22,23,175,11,18,-7
22,23,176,16,11,5
22,23,177,14,19,-5
22,23,178,9,24,-15
22,23,179,8,5,3
22,23,180,5,13,-8
22,23,181,15,12,3
22,23,182,17,15,2
22,23,183,22,17,5
22,23,184,17,7,10
22,23,185,16,8,8
22,23,186,19,10,9
22,23,187,14,27,-13
22,23,188,19,14,5
22,23,189,17,13,4
22,23,190,12,17,-5
22,23,191,15,20,-5
22,23,192,16,22,-6
22,23,193,14,12,2
22,23,194,16,15,1
22,23,195,7,15,-8
22,23,196,12,20,-8
22,23,197,9,14,-5
22,23,198,14,13,1
22,23,199,17,9,8
22,23,200,7,10,-3
22,23,201,24,9,15
22,23,202,25,9,16
22,23,203,19,7,12
22,23,204,13,14,-1
22,23,205,17,19,-2
22,23,206,12,12,0
22,23,207,17,11,6
22,23,208,18,17,1
22,23,209,13,21,-8
22,23,210,10,13,-3
22,23,211,20,25,-5
22,23,212,12,13,-1
22,23,213,16,15,1
22,23,214,7,10,-3
22,23,215,14,9,5
22,23,216,5,7,-2
22,23,217,6,13,-7
22,23,218,25,19,6
22,23,219,13,20,-7
22,23,220,20,8,12
22,23,221,14,11,3
22,23,222,19,22,-3
22,23,223,13,13,0
22,23,224,21,12,9
22,23,225,20,14,6
22,23,226,12,9,3
22,23,227,10,16,-6
22,23,228,5,15,-10
22,23,229,15,16,-1
22,23,230,16,20,-4
22,23,231,14,16,-2
22,23,232,12,7,5
22,23,233,24,9,15
22,23,234,8,18,-10
22,23,235,12,12,0
22,23,236,16,15,1
22,23,237,10,10,0
22,23,238,20,18,2
22,23,239,15,10,5
22,23,240,11,10,1
22,23,241,20,20,0
22,23,242,9,9,0
22,23,243,16,14,2
22,23,244,26,16,10
22,23,245,17,26,-9
22,23,246,8,21,-13
22,23,247,18,20,-2
22,23,248,31,18,13
22,23,249,21,7,14
22,23,250,19,16,3
22,23,251,17,11,6
22,23,252,28,5,23
22,23,253,21,25,-4
22,23,254,18,16,2
22,23,255,5,3,2
22,23,256,7,14,-7
22,23,257,21,10,11
22,23,258,17,15,2
22,23,259,20,17,3
22,23,260,15,19,-4
22,23,261,18,19,-1
22,23,262,15,12,3
22,23,263,11,22,-11
22,23,264,12,11,1
22,23,265,18,7,11
22,23,266,12,8,4
22,23,267,17,22,-5
22,23,268,17,19,-2
22,23,269,20,14,6
22,23,270,15,18,-3
22,23,271,17,7,10
22,23,272,10,18,-8
22,23,273,23,18,5
22,23,274,20,14,6
22,23,275,6,14,-8
22,23,276,12,13,-1
22,23,277,15,12,3
22,23,278,13,5,8
22,23,279,8,12,-4
22,23,280,15,11,4
22,23,281,17,13,4
22,23,282,16,17,-1
22,23,283,11,14,-3
22,23,284,14,12,2
22,23,285,19,19,0
22,23,286,23,10,13
22,23,287,22,22,0
22,23,288,17,18,-1
22,23,289,15,10,5
22,23,290,12,8,4
22,23,291,13,8,5
22,23,292,14,11,3
22,23,293,8,17,-9
22,23,294,21,20,1
22,23,295,7,14,-7
22,23,296,17,21,-4
22,23,297,5,9,-4
22,23,298,17,15,2
22,23,299,16,12,4
22,24,0,11,21,-10
22,24,1,5,4,1
22,24,2,16,15,1
22,24,3,14,10,4
22,24,4,17,16,1
22,24,5,15,24,-9
22,24,6,20,11,9
22,24,7,9,9,0
22,24,8,6,11,-5
22,24,9,12,17,-5
22,24,10,15,15,0
22,24,11,17,7,10
22,24,12,19,29,-10
22,24,13,16,22,-6
22,24,14,9,3,6
22,24,15,16,20,-4
22,24,16,6,6,0
22,24,17,17,8,9
22,24,18,31,28,3
22,24,19,9,10,-1
22,24,20,3,9,-6
22,24,21,9,17,-8
22,24,22,9,10,-1
22,24,23,8,15,-7
22,24,24,11,6,5
22,24,25,6,2,4
22,24,26,12,13,-1
22,24,27,6,14,-8
22,24,28,17,9,8
22,24,29,7,2,5
22,24,30,12,26,-14
22,24,31,13,23,-10
22,24,32,27,8,19
22,24,33,11,16,-5
22,24,34,24,13,11
22,24,35,13,10,3
22,24,36,12,14,-2
22,24,37,21,19,2
22,24,38,7,7,0
22,24,39,15,12,3
22,24,40,10,14,-4
22,24,41,12,8,4
22,24,42,8,15,-7
22,24,43,19,16,3
22,24,44,19,15,4
22,24,45,10,21,-11
22,24,46,18,12,6
22,24,47,10,17,-7
22,24,48,15,17,-2
22,24,49,12,18,-6
22,24,50,18,12,6
22,24,51,18,11,7
22,24,52,5,17,-12
22,24,53,8,13,-5
22,24,54,20,15,5
22,24,55,16,3,13
22,24,56,17,8,9
22,24,57,25,14,11
22,24,58,20,11,9
22,24,59,17,9,8
22,24,60,5,6,-1
22,24,61,11,21,-10
22,24,62,8,13,-5
22,24,63,7,10,-3
22,24,64,10,14,-4
22,24,65,7,8,-1
22,24,66,17,10,7
22,24,67,8,12,-4
22,24,68,15,26,-11
22,24,69,11,15,-4
22,24,70,13,14,-1
22,24,71,12,15,-3
22,24,72,22,15,7
22,24,73,11,20,-9
22,24,74,15,14,1
22,24,75,13,11,2
22,24,76,13,15,-2
22,24,77,16,15,1
22,24,78,17,14,3
22,24,79,15,10,5
22,24,80,12,9,3
22,24,81,11,16,-5
22,24,82,16,22,-6
22,24,83,11,4,7
22,24,84,25,22,3
22,24,85,15,15,0
22,24,86,9,11,-2
22,24,87,21,8,13
22,24,88,22,17,5
22,24,89,18,13,5
22,24,90,6,10,-4
22,24,91,13,15,-2
22,24,92,23,23,0
22,24,93,9,16,-7
22,24,94,14,23,-9
22,24,95,11,15,-4
22,24,96,15,13,2
22,24,97,24,19,5
22,24,98,17,31,-14
22,24,99,3,6,-3
22,24,100,10,28,-18
22,24,101,15,15,0
22,24,102,17,4,13
22,24,103,23,20,3
22,24,104,15,21,-6
22,24,105,22,16,6
22,24,106,14,18,-4
22,24,107,11,8,3
22,24,108,16,22,-6
22,24,109,9,7,2
22,24,110,23,17,6
22,24,111,7,9,-2
22,24,112,14,6,8
22,24,113,14,8,6
22,24,114,9,12,-3
22,24,115,10,13,-3
22,24,116,9,16,-7
22,24,117,7,0,7
22,24,118,13,19,-6
22,24,119,20,13,7
22,24,120,15,5,10
22,24,121,12,10,2
22,24,122,19,19,0
22,24,123,25,19,6
22,24,124,30,18,12
22,24,125,10,6,4
22,24,126,7,14,-7
22,24,127,14,14,0
22,24,128,4,13,-9
22,24,129,11,13,-2
22,24,130,21,20,1
22,24,131,8,14,-6
22,24,132,26,30,-4
22,24,133,9,3,6
22,24,134,10,13,-3
22,24,135,9,9,0
22,24,136,18,19,-1
22,24,137,15,21,-6
22,24,138,16,16,0
22,24,139,18,19,-1
22,24,140,12,19,-7
22,24,141,9,9,0
22,24,142,12,12,0
22,24,143,23,11,12
22,24,144,18,8,10
22,24,145,13,12,1
22,24,146,23,15,8
22,24,147,5,12,-7
22,24,148,16,16,0
22,24,149,10,11,-1
22,24,150,18,8,10
22,24,151,12,14,-2
22,24,152,12,7,5
22,24,153,11,24,-13
22,24,154,16,18,-2
22,24,155,13,15,-2
22,24,156,17,21,-4
22,24,157,23,14,9
22,24,158,12,10,2
22,24,159,10,17,-7
22,24,160,13,18,-5
22,24,161,8,13,-5
22,24,162,16,17,-1
22,24,163,9,13,-4
22,24,164,20,10,10
22,24,165,8,10,-2
22,24,166,20,14,6
22,24,167,14,17,-3
22,24,168,26,13,13
22,24,169,23,18,5
22,24,170,13,28,-15
22,24,171,10,17,-7
22,24,172,6,9,-3
22,24,173,15,13,2
22,24,174,18,15,3
22,24,175,23,17,6
22,24,176,30,17,13
22,24,177,15,24,-9
22,24,178,17,15,2
22,24,179,8,11,-3
22,24,180,9,11,-2
22,24,181,8,8,0
22,24,182,6,7,-1
22,24,183,18,27,-9
22,24,184,14,17,-3
22,24,185,11,17,-6
22,24,186,8,4,4
22,24,187,19,17,2
22,24,188,11,9,2
22,24,189,12,7,5
22,24,190,17,9,8
22,24,191,19,16,3
22,24,192,12,16,-4
22,24,193,8,9,-1
22,24,194,15,21,-6
22,24,195,18,30,-12
22,24,196,13,10,3
22,24,197,18,9,9
22,24,198,7,22,-15
22,24,199,12,17,-5
22,24,200,21,18,3
22,24,201,16,19,-3
22,24,202,15,8,7
22,24,203,12,14,-2
22,24,204,7,5,2
22,24,205,11,10,1
22,24,206,20,14,6
22,24,207,11,8,3
22,24,208,16,11,5
22,24,209,14,18,-4
22,24,210,3,7,-4
22,24,211,18,9,9
22,24,212,7,9,-2
22,24,213,6,3,3
22,24,214,2,3,-1
22,24,215,24,19,5
22,24,216,20,7,13
22,24,217,13,15,-2
22,24,218,19,13,6
22,24,219,16,15,1
22,24,220,7,10,-3
22,24,221,13,8,5
22,24,222,6,14,-8
22,24,223,17,9,8
22,24,224,10,14,-4
22,24,225,18,18,0
22,24,226,12,27,-15
22,24,227,11,13,-2
22,24,228,19,17,2
22,24,229,11,18,-7
22,24,230,12,21,-9
22,24,231,17,23,-6
22,24,232,7,11,-4
22,24,233,17,8,9
22,24,234,9,5,4
22,24,235,28,10,18
22,24,236,20,12,8
22,24,237,13,6,7
22,24,238,11,15,-4
22,24,239,13,17,-4
22,24,240,12,20,-8
22,24,241,13,9,4
22,24,242,21,18,3
22,24,243,18,19,-1
22,24,244,10,9,1
22,24,245,18,18,0
22,24,246,17,24,-7
22,24,247,15,9,6
22,24,248,25,12,13
22,24,249,8,12,-4
22,24,250,12,6,6
22,24,251,19,13,6
22,24,252,14,13,1
22,24,253,12,26,-14
22,24,254,12,20,-8
22,24,255,18,12,6
22,24,256,28,16,12
22,24,257,13,14,-1
22,24,258,12,12,0
22,24,259,15,14,1
22,24,260,17,7,10
22,24,261,13,8,5
22,24,262,18,19,-1
22,24,263,8,21,-13
22,24,264,7,14,-7
22,24,265,8,14,-6
22,24,266,13,16,-3
22,24,267,16,14,2
22,24,268,21,17,4
22,24,269,11,15,-4
22,24,270,12,15,-3
22,24,271,3,5,-2
22,24,272,25,19,6
22,24,273,11,15,-4
22,24,274,15,14,1
22,24,275,11,9,2
22,24,276,17,16,1
22,24,277,15,23,-8
22,24,278,16,7,9
22,24,279,13,16,-3
22,24,280,13,20,-7
22,24,281,10,6,4
22,24,282,24,35,-11
22,24,283,7,6,1
22,24,284,12,19,-7
22,24,285,13,14,-1
22,24,286,18,16,2
22,24,287,4,25,-21
22,24,288,23,6,17
22,24,289,15,23,-8
22,24,290,17,9,8
22,24,291,22,13,9
22,24,292,16,19,-3
22,24,293,7,11,-4
22,24,294,14,12,2
22,24,295,14,8,6
22,24,296,19,2,17
22,24,297,16,19,-3
22,24,298,3,12,-9
22,24,299,7,15,-8
22,25,0,14,18,-4
22,25,1,22,26,-4
22,25,2,13,20,-7
22,25,3,10,2,8
22,25,4,24,18,6
22,25,5,18,20,-2
22,25,6,11,2,9
22,25,7,11,13,-2
22,25,8,15,10,5
22,25,9,26,26,0
22,25,10,13,11,2
22,25,11,10,9,1
22,25,12,14,9,5
22,25,13,14,12,2
22,25,14,19,12,7
22,25,15,13,9,4
22,25,16,5,14,-9
22,25,17,17,13,4
22,25,18,15,9,6
22,25,19,13,10,3
22,25,20,14,23,-9
22,25,21,23,17,6
22,25,22,2,8,-6
22,25,23,18,8,10
22,25,24,15,9,6
22,25,25,18,9,9
22,25,26,11,17,-6
22,25,27,16,25,-9
22,25,28,11,23,-12
22,25,29,5,17,-12
22,25,30,11,14,-3
22,25,31,18,22,-4
22,25,32,27,13,14
22,25,33,24,12,12
22,25,34,3,9,-6
22,25,35,25,14,11
22,25,36,17,21,-4
22,25,37,8,12,-4
22,25,38,12,18,-6
22,25,39,9,20,-11
22,25,40,16,12,4
22,25,41,17,13,4
22,25,42,4,10,-6
22,25,43,13,10,3
22,25,44,23,21,2
22,25,45,12,5,7
22,25,46,12,7,5
22,25,47,12,27,-15
22,25,48,12,11,1
22,25,49,7,5,2
22,25,50,10,20,-10
22,25,51,7,11,-4
22,25,52,15,8,7
22,25,53,11,7,4
22,25,54,17,10,7
22,25,55,9,19,-10
22,25,56,3,18,-15
22,25,57,15,8,7
22,25,58,14,13,1
22,25,59,5,18,-13
22,25,60,11,8,3
22,25,61,23,20,3
22,25,62,17,9,8
22,25,63,9,13,-4
22,25,64,9,9,0
22,25,65,13,11,2
22,25,66,22,23,-1
22,25,67,8,9,-1
22,25,68,11,15,-4
22,25,69,10,17,-7
22,25,70,22,6,16
22,25,71,15,11,4
22,25,72,23,14,9
22,25,73,20,10,10
22,25,74,16,7,9
22,25,75,18,14,4
22,25,76,15,14,1
22,25,77,16,13,3
22,25,78,10,25,-15
22,25,79,18,7,11
22,25,80,16,12,4
22,25,81,12,24,-12
22,25,82,13,20,-7
22,25,83,17,16,1
22,25,84,15,11,4
22,25,85,13,9,4
22,25,86,11,13,-2
22,25,87,9,16,-7
22,25,88,15,15,0
22,25,89,35,20,15
22,25,90,11,3,8
22,25,91,20,17,3
22,25,92,19,20,-1
22,25,93,19,14,5
22,25,94,3,13,-10
22,25,95,14,7,7
22,25,96,17,13,4
22,25,97,14,21,-7
22,25,98,11,20,-9
22,25,99,19,12,7
22,25,100,9,20,-11
22,25,101,19,35,-16
22,25,102,19,14,5
22,25,103,18,6,12
22,25,104,7,11,-4
22,25,105,13,12,1
22,25,106,12,9,3
22,25,107,18,10,8
22,25,108,12,12,0
22,25,109,10,13,-3
22,25,110,26,20,6
22,25,111,7,19,-12
22,25,112,9,14,-5
22,25,113,15,14,1
22,25,114,15,18,-3
22,25,115,18,17,1
22,25,116,23,10,13
22,25,117,11,10,1
22,25,118,6,10,-4
22,25,119,16,16,0
22,25,120,17,18,-1
22,25,121,27,26,1
22,25,122,10,13,-3
22,25,123,7,11,-4
22,25,124,11,6,5
22,25,125,19,10,9
22,25,126,16,14,2
22,25,127,18,10,8
22,25,128,16,8,8
22,25,129,8,10,-2
22,25,130,9,18,-9
22,25,131,16,10,6
22,25,132,12,16,-4
22,25,133,7,5,2
22,25,134,32,21,11
22,25,135,9,29,-20
22,25,136,25,9,16
22,25,137,15,18,-3
22,25,138,14,10,4
22,25,139,15,13,2
22,25,140,12,19,-7
22,25,141,17,8,9
22,25,142,9,6,3
22,25,143,12,21,-9
22,25,144,17,7,10
22,25,145,25,20,5
22,25,146,19,16,3
22,25,147,14,11,3
22,25,148,12,9,3
22,25,149,15,15,0
22,25,150,2,16,-14
22,25,151,30,10,20
22,25,152,31,22,9
22,25,153,22,10,12
22,25,154,13,9,4
22,25,155,20,13,7
22,25,156,6,6,0
22,25,157,20,9,11
22,25,158,8,15,-7
22,25,159,11,12,-1
22,25,160,13,14,-1
22,25,161,19,18,1
22,25,162,18,5,13
22,25,163,24,13,11
22,25,164,17,18,-1
22,25,165,12,13,-1
22,25,166,9,16,-7
22,25,167,7,10,-3
22,25,168,5,12,-7
22,25,169,11,13,-2
22,25,170,3,16,-13
22,25,171,8,9,-1
22,25,172,7,12,-5
22,25,173,18,12,6
22,25,174,10,8,2
22,25,175,10,20,-10
22,25,176,30,25,5
22,25,177,9,12,-3
22,25,178,9,8,1
22,25,179,4,10,-6
22,25,180,15,28,-13
22,25,181,20,25,-5
22,25,182,10,15,-5
22,25,183,11,3,8
22,25,184,20,17,3
22,25,185,25,9,16
22,25,186,7,18,-11
22,25,187,8,10,-2
22,25,188,8,3,5
22,25,189,20,25,-5
22,25,190,14,12,2
22,25,191,24,26,-2
22,25,192,18,18,0
22,25,193,7,12,-5
22,25,194,12,21,-9
22,25,195,19,18,1
22,25,196,13,16,-3
22,25,197,16,15,1
22,25,198,8,7,1
22,25,199,20,13,7
22,25,200,11,11,0
22,25,201,7,13,-6
22,25,202,14,13,1
22,25,203,11,6,5
22,25,204,10,11,-1
22,25,205,13,18,-5
22,25,206,15,15,0
22,25,207,14,28,-14
22,25,208,17,9,8
22,25,209,8,5,3
22,25,210,3,15,-12
22,25,211,12,13,-1
22,25,212,12,22,-10
22,25,213,19,16,3
22,25,214,17,13,4
22,25,215,14,15,-1
22,25,216,10,16,-6
22,25,217,15,10,5
22,25,218,16,6,10
22,25,219,15,25,-10
22,25,220,11,18,-7
22,25,221,8,17,-9
22,25,222,6,7,-1
22,25,223,11,12,-1
22,25,224,19,7,12
22,25,225,11,12,-1
22,25,226,9,11,-2
22,25,227,14,10,4
22,25,228,8,6,2
22,25,229,21,11,10
22,25,230,5,16,-11
22,25,231,9,9,0
22,25,232,12,16,-4
22,25,233,16,13,3
22,25,234,17,23,-6
22,25,235,17,27,-10
22,25,236,19,17,2
22,25,237,22,17,5
22,25,238,23,14,9
22,25,239,20,17,3
22,25,240,10,20,-10
22,25,241,21,12,9
22,25,242,20,13,7
22,25,243,23,16,7
22,25,244,7,20,-13
22,25,245,19,23,-4
22,25,246,8,13,-5
22,25,247,13,14,-1
22,25,248,5,7,-2
22,25,249,21,7,14
22,25,250,8,9,-1
22,25,251,22,16,6
22,25,252,19,15,4
22,25,253,8,12,-4
22,25,254,16,12,4
22,25,255,12,18,-6
22,25,256,24,10,14
22,25,257,16,13,3
22,25,258,19,15,4
22,25,259,9,10,-1
22,25,260,22,28,-6
22,25,261,20,21,-1
22,25,262,22,8,14
22,25,263,9,22,-13
22,25,264,13,6,7
22,25,265,13,12,1
22,25,266,6,14,-8
22,25,267,12,19,-7
22,25,268,16,18,-2
22,25,269,18,9,9
22,25,270,11,16,-5
22,25,271,7,18,-11
22,25,272,10,8,2
22,25,273,23,21,2
22,25,274,20,16,4
22,25,275,10,16,-6
22,25,276,9,6,3
22,25,277,13,7,6
22,25,278,7,3,4
22,25,279,17,9,8
22,25,280,8,8,0
22,25,281,15,23,-8
22,25,282,17,4,13
22,25,283,9,17,-8
22,25,284,15,9,6
22,25,285,15,25,-10
22,25,286,17,26,-9
22,25,287,13,15,-2
22,25,288,11,6,5
22,25,289,9,9,0
22,25,290,14,10,4
22,25,291,11,8,3
22,25,292,15,15,0
22,25,293,19,22,-3
22,25,294,19,8,11
22,25,295,17,11,6
22,25,296,7,11,-4
22,25,297,11,25,-14
22,25,298,14,16,-2
22,25,299,4,13,-9
22,26,0,15,14,1
22,26,1,29,27,2
22,26,2,11,12,-1
22,26,3,13,14,-1
22,26,4,19,15,4
22,26,5,11,8,3
22,26,6,4,10,-6
22,26,7,16,12,4
22,26,8,11,23,-12
22,26,9,18,13,5
22,26,10,5,2,3
22,26,11,7,12,-5
22,26,12,11,15,-4
22,26,13,15,10,5
22,26,14,15,5,10
22,26,15,6,7,-1
22,26,16,15,11,4
22,26,17,9,16,-7
22,26,18,11,13,-2
22,26,19,13,22,-9
22,26,20,5,4,1
22,26,21,25,15,10
22,26,22,16,9,7
22,26,23,12,17,-5
22,26,24,17,10,7
22,26,25,9,14,-5
22,26,26,17,7,10
22,26,27,4,7,-3
22,26,28,36,18,18
22,26,29,13,20,-7
22,26,30,23,17,6
22,26,31,12,15,-3
22,26,32,3,4,-1
22,26,33,17,14,3
22,26,34,7,9,-2
22,26,35,18,11,7
22,26,36,23,2,21
22,26,37,18,14,4
22,26,38,22,20,2
22,26,39,11,33,-22
22,26,40,6,10,-4
22,26,41,12,13,-1
22,26,42,3,10,-7
22,26,43,13,15,-2
22,26,44,21,9,12
22,26,45,5,14,-9
22,26,46,22,8,14
22,26,47,9,12,-3
22,26,48,7,19,-12
22,26,49,13,14,-1
22,26,50,12,14,-2
22,26,51,7,8,-1
22,26,52,28,25,3
22,26,53,7,9,-2
22,26,54,12,6,6
22,26,55,24,18,6
22,26,56,10,26,-16
22,26,57,27,11,16
22,26,58,14,16,-2
22,26,59,18,14,4
22,26,60,14,25,-11
22,26,61,13,11,2
22,26,62,14,16,-2
22,26,63,12,14,-2
22,26,64,19,11,8
22,26,65,24,13,11
22,26,66,21,6,15
22,26,67,13,15,-2
22,26,68,21,11,10
22,26,69,10,17,-7
22,26,70,17,16,1
22,26,71,15,6,9
22,26,72,13,17,-4
22,26,73,13,13,0
22,26,74,20,21,-1
22,26,75,13,15,-2
22,26,76,12,9,3
22,26,77,18,20,-2
22,26,78,14,19,-5
22,26,79,3,5,-2
22,26,80,5,10,-5
22,26,81,20,15,5
22,26,82,24,27,-3
22,26,83,10,7,3
22,26,84,13,13,0
22,26,85,20,20,0
22,26,86,8,8,0
22,26,87,18,7,11
22,26,88,15,3,12
22,26,89,1,8,-7
22,26,90,12,16,-4
22,26,91,4,14,-10
22,26,92,13,9,4
22,26,93,23,17,6
22,26,94,11,16,-5
22,26,95,9,15,-6
22,26,96,11,6,5
22,26,97,17,11,6
22,26,98,8,4,4
22,26,99,14,10,4
22,26,100,7,15,-8
22,26,101,28,25,3
22,26,102,21,13,8
22,26,103,9,9,0
22,26,104,10,12,-2
22,26,105,15,9,6
22,26,106,13,19,-6
22,26,107,11,16,-5
22,26,108,12,9,3
22,26,109,7,16,-9
22,26,110,19,21,-2
22,26,111,14,18,-4
22,26,112,13,14,-1
22,26,113,9,6,3
22,26,114,14,22,-8
22,26,115,9,10,-1
22,26,116,12,14,-2
22,26,117,20,10,10
22,26,118,20,10,10
22,26,119,2,11,-9
22,26,120,25,12,13
22,26,121,10,19,-9
22,26,122,16,22,-6
22,26,123,16,13,3
22,26,124,10,9,1
22,26,125,10,12,-2
22,26,126,16,11,5
22,26,127,26,31,-5
22,26,128,23,17,6
22,26,129,28,12,16
22,26,130,9,13,-4
22,26,131,19,10,9
22,26,132,13,16,-3
22,26,133,20,23,-3
22,26,134,22,19,3
22,26,135,12,9,3
22,26,136,25,14,11
22,26,137,16,8,8
22,26,138,31,12,19
22,26,139,18,22,-4
22,26,140,12,13,-1
22,26,141,12,6,6
22,26,142,14,5,9
22,26,143,12,13,-1
22,26,144,4,8,-4
22,26,145,16,22,-6
22,26,146,21,20,1
22,26,147,22,5,17
22,26,148,6,22,-16
22,26,149,18,11,7
22,26,150,21,6,15
22,26,151,12,13,-1
22,26,152,20,30,-10
22,26,153,13,9,4
22,26,154,20,28,-8
22,26,155,19,21,-2
22,26,156,7,8,-1
22,26,157,17,9,8
22,26,158,15,9,6
22,26,159,30,19,11
22,26,160,6,13,-7
22,26,161,25,23,2
22,26,162,10,20,-10
22,26,163,8,19,-11
22,26,164,21,13,8
22,26,165,24,9,15
22,26,166,22,15,7
22,26,167,21,10,11
22,26,168,15,18,-3
22,26,169,9,17,-8
22,26,170,15,13,2
22,26,171,10,22,-12
22,26,172,8,14,-6
22,26,173,5,20,-15
22,26,174,8,13,-5
22,26,175,14,18,-4
22,26,176,13,20,-7
22,26,177,17,8,9
22,26,178,9,7,2
22,26,179,11,10,1
22,26,180,16,14,2
22,26,181,11,13,-2
22,26,182,9,6,3
22,26,183,8,8,0
22,26,184,5,11,-6
22,26,185,15,11,4
22,26,186,25,24,1
22,26,187,14,23,-9
22,26,188,24,14,10
22,26,189,21,14,7
22,26,190,15,14,1
22,26,191,8,13,-5
22,26,192,13,14,-1
22,26,193,35,26,9
22,26,194,16,9,7
22,26,195,20,13,7
22,26,196,14,18,-4
22,26,197,21,14,7
22,26,198,6,7,-1
22,26,199,21,12,9
22,26,200,19,14,5
22,26,201,13,12,1
22,26,202,14,5,9
22,26,203,18,18,0
22,26,204,27,23,4
22,26,205,23,17,6
22,26,206,5,10,-5
22,26,207,6,18,-12
22,26,208,13,6,7
22,26,209,15,14,1
22,26,210,12,19,-7
22,26,211,6,15,-9
22,26,212,13,12,1
22,26,213,21,31,-10
22,26,214,14,16,-2
22,26,215,9,14,-5
22,26,216,19,12,7
22,26,217,17,4,13
22,26,218,11,17,-6
22,26,219,14,13,1
22,26,220,10,4,6
22,26,221,4,5,-1
22,26,222,5,9,-4
22,26,223,17,14,3
22,26,224,12,8,4
22,26,225,12,8,4
22,26,226,21,6,15
22,26,227,10,8,2
22,26,228,23,13,10
22,26,229,6,11,-5
22,26,230,15,7,8
22,26,231,5,8,-3
22,26,232,21,17,4
22,26,233,26,19,7
22,26,234,12,10,2
22,26,235,20,12,8
22,26,236,12,10,2
22,26,237,16,16,0
22,26,238,9,18,-9
22,26,239,6,5,1
22,26,240,11,6,5
22,26,241,15,16,-1
22,26,242,7,11,-4
22,26,243,12,8,4
22,26,244,18,13,5
22,26,245,15,13,2
22,26,246,15,8,7
22,26,247,28,10,18
22,26,248,11,9,2
22,26,249,9,4,5
22,26,250,16,6,10
22,26,251,7,7,0
22,26,252,14,18,-4
22,26,253,7,7,0
22,26,254,13,10,3
22,26,255,15,8,7
22,26,256,22,21,1
22,26,257,20,17,3
22,26,258,10,4,6
22,26,259,22,27,-5
22,26,260,3,9,-6
22,26,261,14,30,-16
22,26,262,15,23,-8
22,26,263,15,12,3
22,26,264,10,8,2
22,26,265,11,16,-5
22,26,266,9,14,-5
22,26,267,9,10,-1
22,26,268,12,13,-1
22,26,269,12,14,-2
22,26,270,16,14,2
22,26,271,7,22,-15
22,26,272,28,23,5
22,26,273,17,12,5
22,26,274,15,7,8
22,26,275,20,12,8
22,26,276,9,4,5
22,26,277,10,4,6
22,26,278,19,17,2
22,26,279,17,6,11
22,26,280,14,13,1
22,26,281,9,23,-14
22,26,282,16,5,11
22,26,283,20,10,10
22,26,284,6,6,0
22,26,285,30,23,7
22,26,286,17,9,8
22,26,287,17,10,7
22,26,288,17,9,8
22,26,289,10,21,-11
22,26,290,17,14,3
22,26,291,15,11,4
22,26,292,23,22,1
22,26,293,17,14,3
22,26,294,0,12,-12
22,26,295,23,10,13
22,26,296,15,10,5
22,26,297,6,8,-2
22,26,298,8,10,-2
22,26,299,15,16,-1
22,27,0,10,9,1
22,27,1,11,6,5
22,27,2,7,13,-6
22,27,3,19,15,4
22,27,4,24,16,8
22,27,5,12,8,4
22,27,6,5,17,-12
22,27,7,19,18,1
22,27,8,12,9,3
22,27,9,11,11,0
22,27,10,11,7,4
22,27,11,11,16,-5
22,27,12,10,16,-6
22,27,13,8,14,-6
22,27,14,11,18,-7
22,27,15,15,10,5
22,27,16,15,12,3
22,27,17,12,4,8
22,27,18,8,14,-6
22,27,19,23,8,15
22,27,20,18,16,2
22,27,21,14,18,-4
22,27,22,16,7,9
22,27,23,27,16,11
22,27,24,14,10,4
22,27,25,18,9,9
22,27,26,22,9,13
22,27,27,14,21,-7
22,27,28,18,14,4
22,27,29,10,22,-12
22,27,30,11,24,-13
22,27,31,15,16,-1
22,27,32,28,16,12
22,27,33,13,15,-2
22,27,34,5,8,-3
22,27,35,13,11,2
22,27,36,13,13,0
22,27,37,18,16,2
22,27,38,10,5,5
22,27,39,6,16,-10
22,27,40,20,7,13
22,27,41,20,25,-5
22,27,42,19,17,2
22,27,43,3,12,-9
22,27,44,15,20,-5
22,27,45,12,9,3
22,27,46,13,18,-5
22,27,47,13,7,6
22,27,48,17,21,-4
22,27,49,15,12,3
22,27,50,16,9,7
22,27,51,8,8,0
22,27,52,21,16,5
22,27,53,9,13,-4
22,27,54,15,11,4
22,27,55,10,14,-4
22,27,56,16,14,2
22,27,57,16,11,5
22,27,58,16,12,4
22,27,59,16,12,4
22,27,60,13,13,0
22,27,61,12,17,-5
22,27,62,16,16,0
22,27,63,13,14,-1
22,27,64,7,10,-3
22,27,65,19,8,11
22,27,66,10,11,-1
22,27,67,12,12,0
22,27,68,20,13,7
22,27,69,12,8,4
22,27,70,10,12,-2
22,27,71,13,15,-2
22,27,72,14,5,9
22,27,73,11,6,5
22,27,74,19,15,4
22,27,75,12,13,-1
22,27,76,4,15,-11
22,27,77,4,14,-10
22,27,78,12,15,-3
22,27,79,18,11,7
22,27,80,13,20,-7
22,27,81,8,12,-4
22,27,82,16,5,11
22,27,83,24,19,5
22,27,84,20,20,0
22,27,85,22,7,15
22,27,86,8,10,-2
22,27,87,7,4,3
22,27,88,9,8,1
22,27,89,12,8,4
22,27,90,14,10,4
22,27,91,24,29,-5
22,27,92,27,16,11
22,27,93,24,26,-2
22,27,94,13,6,7
22,27,95,14,5,9
22,27,96,12,15,-3
22,27,97,12,16,-4
22,27,98,20,7,13
22,27,99,20,11,9
22,27,100,14,6,8
22,27,101,10,12,-2
22,27,102,23,18,5
22,27,103,11,11,0
22,27,104,19,19,0
22,27,105,23,9,14
22,27,106,9,1,8
22,27,107,7,13,-6
22,27,108,11,16,-5
22,27,109,12,18,-6
22,27,110,10,10,0
22,27,111,9,14,-5
22,27,112,30,7,23
22,27,113,5,8,-3
22,27,114,22,10,12
22,27,115,24,19,5
22,27,116,32,15,17
22,27,117,18,18,0
22,27,118,12,10,2
22,27,119,6,7,-1
22,27,120,11,9,2
22,27,121,8,12,-4
22,27,122,13,8,5
22,27,123,4,10,-6
22,27,124,16,10,6
22,27,125,17,10,7
22,27,126,7,11,-4
22,27,127,19,10,9
22,27,128,15,5,10
22,27,129,27,14,13
22,27,130,13,16,-3
22,27,131,19,21,-2
22,27,132,14,14,0
22,27,133,16,10,6
22,27,134,20,11,9
22,27,135,11,6,5
22,27,136,8,12,-4
22,27,137,14,10,4
22,27,138,10,15,-5
22,27,139,22,5,17
22,27,140,17,10,7
22,27,141,24,35,-11
22,27,142,10,21,-11
22,27,143,26,18,8
22,27,144,10,8,2
22,27,145,28,21,7
22,27,146,5,17,-12
22,27,147,16,13,3
22,27,148,13,11,2
22,27,149,8,12,-4
22,27,150,13,9,4
22,27,151,11,10,1
22,27,152,9,20,-11
22,27,153,11,9,2
22,27,154,12,13,-1
22,27,155,18,13,5
22,27,156,17,31,-14
22,27,157,25,16,9
22,27,158,3,14,-11
22,27,159,12,7,5
22,27,160,14,19,-5
22,27,161,16,14,2
22,27,162,11,6,5
22,27,163,19,6,13
22,27,164,10,15,-5
22,27,165,7,12,-5
22,27,166,8,9,-1
22,27,167,16,15,1
22,27,168,21,10,11
22,27,169,21,20,1
22,27,170,9,8,1
22,27,171,5,4,1
22,27,172,17,6,11
22,27,173,11,13,-2
22,27,174,9,11,-2
22,27,175,16,16,0
22,27,176,18,22,-4
22,27,177,14,18,-4
22,27,178,15,17,-2
22,27,179,8,8,0
22,27,180,12,14,-2
22,27,181,12,23,-11
22,27,182,12,11,1
22,27,183,14,15,-1
22,27,184,16,8,8
22,27,185,16,11,5
22,27,186,29,17,12
22,27,187,13,9,4
22,27,188,11,8,3
22,27,189,13,15,-2
22,27,190,14,10,4
22,27,191,13,15,-2
22,27,192,17,20,-3
22,27,193,19,18,1
22,27,194,22,16,6
22,27,195,7,10,-3
22,27,196,19,10,9
22,27,197,9,12,-3
22,27,198,18,9,9
22,27,199,29,14,15
22,27,200,16,10,6
22,27,201,13,13,0
22,27,202,15,18,-3
22,27,203,14,20,-6
22,27,204,13,15,-2
22,27,205,5,13,-8
22,27,206,10,5,5
22,27,207,20,12,8
22,27,208,6,9,-3
22,27,209,7,12,-5
22,27,210,21,14,7
22,27,211,18,10,8
22,27,212,14,22,-8
22,27,213,14,19,-5
22,27,214,9,10,-1
22,27,215,12,9,3
22,27,216,18,11,7
22,27,217,6,12,-6
22,27,218,16,9,7
22,27,219,10,26,-16
22,27,220,32,21,11
22,27,221,23,12,11
22,27,222,16,16,0
22,27,223,5,15,-10
22,27,224,25,11,14
22,27,225,5,4,1
22,27,226,17,9,8
22,27,227,9,10,-1
22,27,228,13,8,5
22,27,229,12,13,-1
22,27,230,11,4,7
22,27,231,18,13,5
22,27,232,11,14,-3
22,27,233,6,14,-8
22,27,234,15,10,5
22,27,235,23,14,9
22,27,236,16,21,-5
22,27,237,10,8,2
22,27,238,18,11,7
22,27,239,10,8,2
22,27,240,12,15,-3
22,27,241,13,6,7
22,27,242,15,17,-2
22,27,243,5,17,-12
22,27,244,0,6,-6
22,27,245,10,9,1
22,27,246,20,15,5
22,27,247,15,13,2
22,27,248,19,14,5
22,27,249,12,12,0
22,27,250,9,12,-3
22,27,251,8,18,-10
22,27,252,6,12,-6
22,27,253,9,7,2
22,27,254,19,27,-8
22,27,255,16,23,-7
22,27,256,20,17,3
22,27,257,14,15,-1
22,27,258,15,15,0
22,27,259,7,15,-8
22,27,260,16,15,1
22,27,261,19,17,2
22,27,262,9,4,5
22,27,263,20,19,1
22,27,264,12,19,-7
22,27,265,9,10,-1
22,27,266,12,6,6
22,27,267,15,8,7
22,27,268,11,17,-6
22,27,269,13,10,3
22,27,270,8,12,-4
22,27,271,6,8,-2
22,27,272,1,8,-7
22,27,273,15,11,4
22,27,274,8,13,-5
22,27,275,27,10,17
22,27,276,14,15,-1
22,27,277,8,8,0
22,27,278,21,16,5
22,27,279,16,12,4
22,27,280,17,15,2
22,27,281,12,5,7
22,27,282,10,14,-4
22,27,283,19,10,9
22,27,284,19,9,10
22,27,285,9,9,0
22,27,286,14,18,-4
22,27,287,12,18,-6
22,27,288,23,14,9
22,27,289,11,11,0
22,27,290,26,17,9
22,27,291,9,5,4
22,27,292,23,10,13
22,27,293,15,22,-7
22,27,294,20,14,6
22,27,295,6,17,-11
22,27,296,21,13,8
22,27,297,12,17,-5
22,27,298,20,19,1
22,27,299,14,21,-7
22,28,0,12,13,-1
22,28,1,8,17,-9
22,28,2,12,11,1
22,28,3,19,19,0
22,28,4,24,19,5
22,28,5,12,13,-1
22,28,6,18,13,5
22,28,7,5,15,-10
22,28,8,19,10,9
22,28,9,14,16,-2
22,28,10,24,23,1
22,28,11,12,10,2
22,28,12,19,5,14
22,28,13,3,4,-1
22,28,14,22,13,9
22,28,15,5,9,-4
22,28,16,14,14,0
22,28,17,16,16,0
22,28,18,15,15,0
22,28,19,26,22,4
22,28,20,24,11,13
22,28,21,13,10,3
22,28,22,15,16,-1
22,28,23,7,19,-12
22,28,24,10,5,5
22,28,25,23,33,-10
22,28,26,4,2,2
22,28,27,16,7,9
22,28,28,20,9,11
22,28,29,21,7,14
22,28,30,15,11,4
22,28,31,12,9,3
22,28,32,10,14,-4
22,28,33,12,10,2
22,28,34,18,6,12
22,28,35,20,10,10
22,28,36,7,9,-2
22,28,37,19,18,1
22,28,38,10,9,1
22,28,39,11,6,5
22,28,40,13,9,4
22,28,41,16,20,-4
22,28,42,3,10,-7
22,28,43,12,18,-6
22,28,44,17,18,-1
22,28,45,10,10,0
22,28,46,14,30,-16
22,28,47,6,12,-6
22,28,48,10,7,3
22,28,49,18,13,5
22,28,50,25,15,10
22,28,51,16,16,0
22,28,52,23,14,9
22,28,53,11,19,-8
22,28,54,7,14,-7
22,28,55,15,10,5
22,28,56,19,9,10
22,28,57,20,23,-3
22,28,58,11,4,7
22,28,59,16,11,5
22,28,60,18,9,9
22,28,61,14,12,2
22,28,62,12,8,4
22,28,63,10,4,6
22,28,64,19,8,11
22,28,65,15,23,-8
22,28,66,8,6,2
22,28,67,24,18,6
22,28,68,22,8,14
22,28,69,26,29,-3
22,28,70,34,5,29
22,28,71,15,15,0
22,28,72,24,25,-1
22,28,73,11,11,0
22,28,74,19,11,8
22,28,75,18,18,0
22,28,76,15,16,-1
22,28,77,19,13,6
22,28,78,17,10,7
22,28,79,15,8,7
22,28,80,19,11,8
22,28,81,19,8,11
22,28,82,12,10,2
22,28,83,6,10,-4
22,28,84,16,9,7
22,28,85,20,11,9
22,28,86,14,14,0
22,28,87,16,18,-2
22,28,88,16,15,1
22,28,89,15,17,-2
22,28,90,9,13,-4
22,28,91,17,9,8
22,28,92,13,18,-5
22,28,93,17,14,3
22,28,94,11,10,1
22,28,95,10,7,3
22,28,96,8,11,-3
22,28,97,12,17,-5
22,28,98,18,11,7
22,28,99,23,8,15
22,28,100,16,25,-9
22,28,101,9,12,-3
22,28,102,13,9,4
22,28,103,20,20,0
22,28,104,23,11,12
22,28,105,22,13,9
22,28,106,17,14,3
22,28,107,12,21,-9
22,28,108,20,8,12
22,28,109,12,7,5
22,28,110,21,4,17
22,28,111,15,8,7
22,28,112,23,12,11
22,28,113,10,13,-3
22,28,114,11,15,-4
22,28,115,17,7,10
22,28,116,20,3,17
22,28,117,15,10,5
22,28,118,12,15,-3
22,28,119,12,8,4
22,28,120,24,26,-2
22,28,121,10,8,2
22,28,122,15,15,0
22,28,123,15,10,5
22,28,124,6,21,-15
22,28,125,14,20,-6
22,28,126,12,11,1
22,28,127,20,8,12
22,28,128,16,9,7
22,28,129,10,12,-2
22,28,130,4,12,-8
22,28,131,10,17,-7
22,28,132,20,15,5
22,28,133,7,16,-9
22,28,134,13,15,-2
22,28,135,28,20,8
22,28,136,10,5,5
22,28,137,17,17,0
22,28,138,31,18,13
22,28,139,13,17,-4
22,28,140,27,13,14
22,28,141,13,12,1
22,28,142,8,12,-4
22,28,143,22,16,6
22,28,144,12,7,5
22,28,145,6,5,1
22,28,146,23,20,3
22,28,147,8,9,-1
22,28,148,15,8,7
22,28,149,13,6,7
22,28,150,4,14,-10
22,28,151,12,8,4
22,28,152,20,25,-5
22,28,153,19,13,6
22,28,154,20,17,3
22,28,155,10,5,5
22,28,156,7,11,-4
22,28,157,19,16,3
22,28,158,14,17,-3
22,28,159,7,15,-8
22,28,160,14,13,1
22,28,161,7,4,3
22,28,162,7,1,6
22,28,163,8,9,-1
22,28,164,7,13,-6
22,28,165,13,16,-3
22,28,166,9,6,3
22,28,167,33,11,22
22,28,168,18,18,0
22,28,169,13,1,12
22,28,170,10,14,-4
22,28,171,14,7,7
22,28,172,7,9,-2
22,28,173,17,18,-1
22,28,174,13,15,-2
22,28,175,11,8,3
22,28,176,6,10,-4
22,28,177,14,11,3
22,28,178,11,13,-2
22,28,179,12,10,2
22,28,180,12,10,2
22,28,181,16,9,7
22,28,182,14,9,5
22,28,183,28,16,12
22,28,184,16,18,-2
22,28,185,22,12,10
22,28,186,15,11,4
22,28,187,17,24,-7
22,28,188,23,13,10
22,28,189,13,11,2
22,28,190,15,9,6
22,28,191,12,7,5
22,28,192,16,11,5
22,28,193,21,5,16
22,28,194,4,5,-1
22,28,195,19,17,2
22,28,196,16,12,4
22,28,197,8,6,2
22,28,198,14,13,1
22,28,199,13,12,1
22,28,200,18,12,6
22,28,201,18,16,2
22,28,202,17,16,1
22,28,203,6,1,5
22,28,204,3,13,-10
22,28,205,12,7,5
22,28,206,10,14,-4
22,28,207,25,16,9
22,28,208,10,8,2
22,28,209,11,9,2
22,28,210,13,18,-5
22,28,211,9,22,-13
22,28,212,12,25,-13
22,28,213,19,5,14
22,28,214,20,20,0
22,28,215,14,13,1
22,28,216,19,19,0
22,28,217,19,5,14
22,28,218,8,13,-5
22,28,219,18,13,5
22,28,220,18,18,0
22,28,221,22,14,8
22,28,222,25,15,10
22,28,223,22,24,-2
22,28,224,22,11,11
22,28,225,10,6,4
22,28,226,15,14,1
22,28,227,17,12,5
22,28,228,15,8,7
22,28,229,16,8,8
22,28,230,11,17,-6
22,28,231,31,12,19
22,28,232,19,10,9
22,28,233,23,7,16
22,28,234,23,22,1
22,28,235,20,11,9
22,28,236,15,10,5
22,28,237,8,5,3
22,28,238,7,12,-5
22,28,239,14,17,-3
22,28,240,15,21,-6
22,28,241,4,8,-4
22,28,242,13,21,-8
22,28,243,6,8,-2
22,28,244,18,12,6
22,28,245,8,5,3
22,28,246,13,15,-2
22,28,247,17,13,4
22,28,248,9,5,4
22,28,249,11,9,2
22,28,250,13,8,5
22,28,251,12,18,-6
22,28,252,17,4,13
22,28,253,9,22,-13
22,28,254,22,9,13
22,28,255,13,11,2
22,28,256,20,10,10
22,28,257,10,6,4
22,28,258,10,11,-1
22,28,259,14,13,1
22,28,260,15,5,10
22,28,261,16,13,3
22,28,262,14,15,-1
22,28,263,16,15,1
22,28,264,16,16,0
22,28,265,18,6,12
22,28,266,17,21,-4
22,28,267,15,16,-1
22,28,268,13,15,-2
22,28,269,11,4,7
22,28,270,15,10,5
22,28,271,19,15,4
22,28,272,23,15,8
22,28,273,7,7,0
22,28,274,22,20,2
22,28,275,22,14,8
22,28,276,12,9,3
22,28,277,21,5,16
22,28,278,11,5,6
22,28,279,12,9,3
22,28,280,9,11,-2
22,28,281,18,17,1
22,28,282,20,16,4
22,28,283,10,14,-4
22,28,284,12,7,5
22,28,285,27,23,4
22,28,286,14,17,-3
22,28,287,9,11,-2
22,28,288,16,16,0
22,28,289,15,20,-5
22,28,290,10,15,-5
22,28,291,7,2,5
22,28,292,15,15,0
22,28,293,14,7,7
22,28,294,3,7,-4
22,28,295,12,11,1
22,28,296,24,10,14
22,28,297,12,7,5
22,28,298,22,11,11
22,28,299,10,13,-3
22,29,0,9,9,0
22,29,1,16,6,10
22,29,2,10,10,0
22,29,3,19,10,9
22,29,4,20,20,0
22,29,5,9,23,-14
22,29,6,14,15,-1
22,29,7,21,12,9
22,29,8,10,12,-2
22,29,9,23,11,12
22,29,10,7,10,-3
22,29,11,12,11,1
22,29,12,21,18,3
22,29,13,21,15,6
22,29,14,22,12,10
22,29,15,9,11,-2
22,29,16,14,30,-16
22,29,17,18,11,7
22,29,18,10,12,-2
22,29,19,17,10,7
22,29,20,14,12,2
22,29,21,24,17,7
22,29,22,14,8,6
22,29,23,19,10,9
22,29,24,17,15,2
22,29,25,18,14,4
22,29,26,8,9,-1
22,29,27,13,8,5
22,29,28,10,21,-11
22,29,29,20,18,2
22,29,30,5,7,-2
22,29,31,21,18,3
22,29,32,9,10,-1
22,29,33,14,16,-2
22,29,34,11,13,-2
22,29,35,8,9,-1
22,29,36,9,9,0
22,29,37,18,14,4
22,29,38,17,13,4
22,29,39,27,27,0
22,29,40,10,18,-8
22,29,41,15,19,-4
22,29,42,11,6,5
22,29,43,7,6,1
22,29,44,14,4,10
22,29,45,23,8,15
22,29,46,14,8,6
22,29,47,16,6,10
22,29,48,21,11,10
22,29,49,21,9,12
22,29,50,14,12,2
22,29,51,8,15,-7
22,29,52,16,19,-3
22,29,53,11,9,2
22,29,54,14,10,4
22,29,55,12,12,0
22,29,56,9,15,-6
22,29,57,18,8,10
22,29,58,18,13,5
22,29,59,18,17,1
22,29,60,8,17,-9
22,29,61,3,8,-5
22,29,62,13,8,5
22,29,63,11,6,5
22,29,64,22,11,11
22,29,65,7,11,-4
22,29,66,9,10,-1
22,29,67,12,6,6
22,29,68,18,15,3
22,29,69,15,6,9
22,29,70,8,16,-8
22,29,71,12,10,2
22,29,72,10,18,-8
22,29,73,19,11,8
22,29,74,17,10,7
22,29,75,8,10,-2
22,29,76,11,10,1
22,29,77,6,11,-5
22,29,78,17,23,-6
22,29,79,19,16,3
22,29,80,18,11,7
22,29,81,15,25,-10
22,29,82,20,11,9
22,29,83,18,15,3
22,29,84,15,26,-11
22,29,85,16,20,-4
22,29,86,31,21,10
22,29,87,11,20,-9
22,29,88,5,17,-12
22,29,89,21,20,1
22,29,90,9,21,-12
22,29,91,17,7,10
22,29,92,11,13,-2
22,29,93,17,7,10
22,29,94,18,8,10
22,29,95,18,14,4
22,29,96,7,9,-2
22,29,97,13,23,-10
22,29,98,6,13,-7
22,29,99,11,11,0
22,29,100,22,16,6
22,29,101,9,8,1
22,29,102,4,11,-7
22,29,103,9,17,-8
22,29,104,15,18,-3
22,29,105,14,15,-1
22,29,106,21,17,4
22,29,107,26,16,10
22,29,108,7,7,0
22,29,109,13,14,-1
22,29,110,13,7,6
22,29,111,13,24,-11
22,29,112,18,13,5
22,29,113,10,3,7
22,29,114,10,16,-6
22,29,115,29,12,17
22,29,116,21,28,-7
22,29,117,15,5,10
22,29,118,14,9,5
22,29,119,11,15,-4
22,29,120,11,11,0
22,29,121,5,9,-4
22,29,122,22,13,9
22,29,123,29,14,15
22,29,124,7,6,1
22,29,125,13,8,5
22,29,126,15,19,-4
22,29,127,14,14,0
22,29,128,14,11,3
22,29,129,17,16,1
22,29,130,15,8,7
22,29,131,15,10,5
22,29,132,4,14,-10
22,29,133,19,18,1
22,29,134,21,14,7
22,29,135,19,17,2
22,29,136,16,19,-3
22,29,137,15,11,4
22,29,138,8,17,-9
22,29,139,10,6,4
22,29,140,15,12,3
22,29,141,21,9,12
22,29,142,18,13,5
22,29,143,5,3,2
22,29,144,17,7,10
22,29,145,11,3,8
22,29,146,14,21,-7
22,29,147,19,8,11
22,29,148,14,12,2
22,29,149,23,21,2
22,29,150,10,4,6
22,29,151,10,8,2
22,29,152,17,11,6
22,29,153,8,6,2
22,29,154,16,7,9
22,29,155,34,16,18
22,29,156,32,18,14
22,29,157,6,13,-7
22,29,158,10,13,-3
22,29,159,16,11,5
22,29,160,14,12,2
22,29,161,14,8,6
22,29,162,14,14,0
22,29,163,15,10,5
22,29,164,11,14,-3
22,29,165,9,11,-2
22,29,166,7,10,-3
22,29,167,13,5,8
22,29,168,25,11,14
22,29,169,22,9,13
22,29,170,14,10,4
22,29,171,23,10,13
22,29,172,26,6,20
22,29,173,10,9,1
22,29,174,26,10,16
22,29,175,10,4,6
22,29,176,23,25,-2
22,29,177,20,17,3
22,29,178,9,16,-7
22,29,179,23,20,3
22,29,180,17,16,1
22,29,181,6,16,-10
22,29,182,11,7,4
22,29,183,18,26,-8
22,29,184,11,11,0
22,29,185,7,9,-2
22,29,186,10,20,-10
22,29,187,6,5,1
22,29,188,11,8,3
22,29,189,10,20,-10
22,29,190,16,15,1
22,29,191,14,7,7
22,29,192,10,10,0
22,29,193,19,11,8
22,29,194,2,14,-12
22,29,195,17,15,2
22,29,196,17,22,-5
22,29,197,8,8,0
22,29,198,12,14,-2
22,29,199,8,8,0
22,29,200,12,13,-1
22,29,201,9,23,-14
22,29,202,25,11,14
22,29,203,4,7,-3
22,29,204,19,9,10
22,29,205,14,13,1
22,29,206,13,8,5
22,29,207,10,4,6
22,29,208,15,8,7
22,29,209,13,10,3
22,29,210,15,18,-3
22,29,211,20,6,14
22,29,212,10,14,-4
22,29,213,10,7,3
22,29,214,13,16,-3
22,29,215,9,11,-2
22,29,216,13,12,1
22,29,217,15,8,7
22,29,218,14,11,3
22,29,219,16,9,7
22,29,220,17,12,5
22,29,221,19,13,6
22,29,222,11,12,-1
22,29,223,10,11,-1
22,29,224,22,12,10
22,29,225,6,15,-9
22,29,226,10,9,1
22,29,227,26,14,12
22,29,228,23,17,6
22,29,229,11,15,-4
22,29,230,12,10,2
22,29,231,28,20,8
22,29,232,13,19,-6
22,29,233,21,11,10
22,29,234,10,19,-9
22,29,235,14,13,1
22,29,236,18,13,5
22,29,237,20,14,6
22,29,238,18,5,13
22,29,239,21,19,2
22,29,240,13,18,-5
22,29,241,21,10,11
22,29,242,28,12,16
22,29,243,9,10,-1
22,29,244,13,9,4
22,29,245,10,7,3
22,29,246,13,20,-7
22,29,247,9,8,1
22,29,248,20,19,1
22,29,249,12,4,8
22,29,250,13,6,7
22,29,251,13,23,-10
22,29,252,11,4,7
22,29,253,13,20,-7
22,29,254,20,24,-4
22,29,255,13,15,-2
22,29,256,28,24,4
22,29,257,17,15,2
22,29,258,15,15,0
22,29,259,9,12,-3
22,29,260,20,17,3
22,29,261,9,22,-13
22,29,262,13,22,-9
22,29,263,24,19,5
22,29,264,19,19,0
22,29,265,17,10,7
22,29,266,8,11,-3
22,29,267,20,16,4
22,29,268,20,4,16
22,29,269,25,10,15
22,29,270,23,24,-1
22,29,271,22,19,3
22,29,272,9,11,-2
22,29,273,25,13,12
22,29,274,12,22,-10
22,29,275,12,14,-2
22,29,276,14,10,4
22,29,277,16,21,-5
22,29,278,18,11,7
22,29,279,24,23,1
22,29,280,11,8,3
22,29,281,12,20,-8
22,29,282,12,10,2
22,29,283,9,13,-4
22,29,284,20,17,3
22,29,285,21,4,17
22,29,286,13,10,3
22,29,287,8,9,-1
22,29,288,7,16,-9
22,29,289,21,14,7
22,29,290,32,17,15
22,29,291,15,7,8
22,29,292,11,5,6
22,29,293,23,9,14
22,29,294,6,13,-7
22,29,295,13,7,6
22,29,296,7,16,-9
22,29,297,9,14,-5
22,29,298,10,8,2
22,29,299,12,6,6
22,30,0,17,13,4
22,30,1,13,14,-1
22,30,2,21,6,15
22,30,3,22,13,9
22,30,4,11,17,-6
22,30,5,24,12,12
22,30,6,18,11,7
22,30,7,20,7,13
22,30,8,13,4,9
22,30,9,5,12,-7
22,30,10,19,11,8
22,30,11,16,12,4
22,30,12,4,13,-9
22,30,13,16,16,0
22,30,14,9,20,-11
22,30,15,9,13,-4
22,30,16,14,9,5
22,30,17,13,24,-11
22,30,18,10,14,-4
22,30,19,7,1,6
22,30,20,8,10,-2
22,30,21,18,20,-2
22,30,22,19,10,9
22,30,23,12,13,-1
22,30,24,14,20,-6
22,30,25,12,14,-2
22,30,26,8,12,-4
22,30,27,11,12,-1
22,30,28,17,6,11
22,30,29,9,9,0
22,30,30,11,17,-6
22,30,31,16,11,5
22,30,32,2,7,-5
22,30,33,14,14,0
22,30,34,17,23,-6
22,30,35,10,12,-2
22,30,36,7,14,-7
22,30,37,17,14,3
22,30,38,18,14,4
22,30,39,11,19,-8
22,30,40,10,8,2
22,30,41,13,12,1
22,30,42,14,10,4
22,30,43,26,23,3
22,30,44,9,12,-3
22,30,45,15,18,-3
22,30,46,19,12,7
22,30,47,18,16,2
22,30,48,4,13,-9
22,30,49,8,16,-8
22,30,50,4,8,-4
22,30,51,19,10,9
22,30,52,14,1,13
22,30,53,3,1,2
22,30,54,16,14,2
22,30,55,11,7,4
22,30,56,15,13,2
22,30,57,16,6,10
22,30,58,13,14,-1
22,30,59,8,7,1
22,30,60,10,7,3
22,30,61,1,4,-3
22,30,62,14,17,-3
22,30,63,12,9,3
22,30,64,8,20,-12
22,30,65,7,8,-1
22,30,66,17,7,10
22,30,67,17,11,6
22,30,68,12,9,3
22,30,69,10,10,0
22,30,70,30,14,16
22,30,71,13,7,6
22,30,72,14,6,8
22,30,73,13,6,7
22,30,74,10,6,4
22,30,75,14,10,4
22,30,76,15,8,7
22,30,77,14,14,0
22,30,78,16,7,9
22,30,79,13,8,5
22,30,80,7,17,-10
22,30,81,20,17,3
22,30,82,9,10,-1
22,30,83,16,6,10
22,30,84,19,13,6
22,30,85,19,18,1
22,30,86,21,6,15
22,30,87,13,13,0
22,30,88,12,10,2
22,30,89,12,13,-1
22,30,90,8,12,-4
22,30,91,22,12,10
22,30,92,8,11,-3
22,30,93,13,17,-4
22,30,94,11,11,0
22,30,95,24,11,13
22,30,96,9,7,2
22,30,97,8,10,-2
22,30,98,15,8,7
22,30,99,12,13,-1
22,30,100,12,16,-4
22,30,101,16,16,0
22,30,102,19,3,16
22,30,103,15,7,8
22,30,104,5,4,1
22,30,105,19,12,7
22,30,106,9,9,0
22,30,107,26,12,14
22,30,108,7,3,4
22,30,109,11,17,-6
22,30,110,10,4,6
22,30,111,9,7,2
22,30,112,26,24,2
22,30,113,13,24,-11
22,30,114,19,13,6
22,30,115,11,12,-1
22,30,116,16,12,4
22,30,117,16,8,8
22,30,118,18,9,9
22,30,119,21,10,11
22,30,120,11,9,2
22,30,121,14,7,7
22,30,122,4,10,-6
22,30,123,24,20,4
22,30,124,10,2,8
22,30,125,15,17,-2
22,30,126,6,9,-3
22,30,127,15,8,7
22,30,128,16,4,12
22,30,129,15,4,11
22,30,130,11,10,1
22,30,131,10,19,-9
22,30,132,22,18,4
22,30,133,22,5,17
22,30,134,21,8,13
22,30,135,13,13,0
22,30,136,7,14,-7
22,30,137,14,7,7
22,30,138,14,12,2
22,30,139,13,9,4
22,30,140,14,9,5
22,30,141,11,7,4
22,30,142,13,18,-5
22,30,143,13,17,-4
22,30,144,13,7,6
22,30,145,13,14,-1
22,30,146,20,13,7
22,30,147,15,16,-1
22,30,148,15,6,9
22,30,149,15,12,3
22,30,150,13,7,6
22,30,151,15,22,-7
22,30,152,14,4,10
22,30,153,14,8,6
22,30,154,7,12,-5
22,30,155,18,11,7
22,30,156,3,11,-8
22,30,157,19,11,8
22,30,158,11,10,1
22,30,159,20,18,2
22,30,160,14,14,0
22,30,161,12,13,-1
22,30,162,13,18,-5
22,30,163,16,6,10
22,30,164,4,3,1
22,30,165,26,26,0
22,30,166,6,9,-3
22,30,167,8,11,-3
22,30,168,12,8,4
22,30,169,10,7,3
22,30,170,25,20,5
22,30,171,11,19,-8
22,30,172,11,13,-2
22,30,173,11,11,0
22,30,174,27,32,-5
22,30,175,18,8,10
22,30,176,12,8,4
22,30,177,20,10,10
22,30,178,7,14,-7
22,30,179,15,15,0
22,30,180,7,12,-5
22,30,181,18,17,1
22,30,182,18,11,7
22,30,183,12,9,3
22,30,184,10,27,-17
22,30,185,10,20,-10
22,30,186,19,16,3
22,30,187,9,13,-4
22,30,188,14,12,2
22,30,189,15,19,-4
22,30,190,14,13,1
22,30,191,27,12,15
22,30,192,15,11,4
22,30,193,17,20,-3
22,30,194,10,2,8
22,30,195,11,17,-6
22,30,196,8,8,0
22,30,197,17,13,4
22,30,198,8,17,-9
22,30,199,22,14,8
22,30,200,8,11,-3
22,30,201,21,14,7
22,30,202,12,10,2
22,30,203,14,19,-5
22,30,204,20,16,4
22,30,205,20,17,3
22,30,206,20,20,0
22,30,207,19,2,17
22,30,208,11,6,5
22,30,209,32,7,25
22,30,210,20,8,12
22,30,211,4,13,-9
22,30,212,13,11,2
22,30,213,15,20,-5
22,30,214,14,6,8
22,30,215,12,15,-3
22,30,216,11,10,1
22,30,217,23,11,12
22,30,218,28,13,15
22,30,219,15,13,2
22,30,220,14,19,-5
22,30,221,9,6,3
22,30,222,5,4,1
22,30,223,26,16,10
22,30,224,16,16,0
22,30,225,11,13,-2
22,30,226,14,15,-1
22,30,227,7,16,-9
22,30,228,10,12,-2
22,30,229,36,23,13
22,30,230,17,7,10
22,30,231,2,16,-14
22,30,232,14,6,8
22,30,233,15,7,8
22,30,234,19,17,2
22,30,235,17,17,0
22,30,236,15,6,9
22,30,237,18,11,7
22,30,238,20,15,5
22,30,239,27,16,11
22,30,240,11,7,4
22,30,241,10,9,1
22,30,242,23,7,16
22,30,243,10,7,3
22,30,244,11,12,-1
22,30,245,9,8,1
22,30,246,9,11,-2
22,30,247,18,9,9
22,30,248,3,15,-12
22,30,249,18,8,10
22,30,250,9,7,2
22,30,251,31,17,14
22,30,252,19,13,6
22,30,253,14,8,6
22,30,254,12,12,0
22,30,255,14,23,-9
22,30,256,12,20,-8
22,30,257,15,10,5
22,30,258,5,8,-3
22,30,259,26,9,17
22,30,260,10,19,-9
22,30,261,16,10,6
22,30,262,6,10,-4
22,30,263,10,14,-4
22,30,264,14,9,5
22,30,265,17,13,4
22,30,266,11,19,-8
22,30,267,21,16,5
22,30,268,9,9,0
22,30,269,15,20,-5
22,30,270,14,12,2
22,30,271,21,12,9
22,30,272,15,14,1
22,30,273,8,18,-10
22,30,274,10,24,-14
22,30,275,17,6,11
22,30,276,12,11,1
22,30,277,21,14,7
22,30,278,16,15,1
22,30,279,9,8,1
22,30,280,12,11,1
22,30,281,11,12,-1
22,30,282,17,14,3
22,30,283,19,7,12
22,30,284,14,16,-2
22,30,285,20,15,5
22,30,286,14,20,-6
22,30,287,8,9,-1
22,30,288,17,7,10
22,30,289,14,10,4
22,30,290,13,14,-1
22,30,291,15,10,5
22,30,292,16,15,1
22,30,293,16,14,2
22,30,294,22,17,5
22,30,295,3,14,-11
22,30,296,8,17,-9
22,30,297,15,12,3
22,30,298,10,12,-2
22,30,299,22,16,6
23,1,0,10,22,-12
23,1,1,16,20,-4
23,1,2,15,11,4
23,1,3,9,18,-9
23,1,4,8,16,-8
23,1,5,3,25,-22
23,1,6,4,8,-4
23,1,7,10,13,-3
23,1,8,13,15,-2
23,1,9,8,16,-8
23,1,10,11,8,3
23,1,11,15,18,-3
23,1,12,10,16,-6
23,1,13,7,16,-9
23,1,14,12,25,-13
23,1,15,4,16,-12
23,1,16,3,18,-15
23,1,17,7,16,-9
23,1,18,2,14,-12
23,1,19,5,18,-13
23,1,20,12,14,-2
23,1,21,9,16,-7
23,1,22,2,11,-9
23,1,23,7,15,-8
23,1,24,8,14,-6
23,1,25,11,22,-11
23,1,26,3,5,-2
23,1,27,5,25,-20
23,1,28,13,18,-5
23,1,29,1,8,-7
23,1,30,11,25,-14
23,1,31,12,15,-3
23,1,32,11,16,-5
23,1,33,9,17,-8
23,1,34,14,18,-4
23,1,35,11,13,-2
23,1,36,9,24,-15
23,1,37,8,23,-15
23,1,38,7,15,-8
23,1,39,5,6,-1
23,1,40,12,33,-21
23,1,41,4,17,-13
23,1,42,9,13,-4
23,1,43,13,18,-5
23,1,44,10,14,-4
23,1,45,7,11,-4
23,1,46,9,17,-8
23,1,47,15,18,-3
23,1,48,13,11,2
23,1,49,6,12,-6
23,1,50,8,25,-17
23,1,51,16,15,1
23,1,52,7,14,-7
23,1,53,5,9,-4
23,1,54,8,16,-8
23,1,55,7,20,-13
23,1,56,5,13,-8
23,1,57,15,18,-3
23,1,58,17,20,-3
23,1,59,12,20,-8
23,1,60,7,23,-16
23,1,61,11,18,-7
23,1,62,4,10,-6
23,1,63,7,26,-19
23,1,64,5,9,-4
23,1,65,13,16,-3
23,1,66,6,20,-14
23,1,67,9,18,-9
23,1,68,4,10,-6
23,1,69,7,18,-11
23,1,70,5,22,-17
23,1,71,3,17,-14
23,1,72,5,14,-9
23,1,73,13,16,-3
23,1,74,2,8,-6
23,1,75,3,19,-16
23,1,76,7,14,-7
23,1,77,5,10,-5
23,1,78,11,17,-6
23,1,79,4,20,-16
23,1,80,9,18,-9
23,1,81,5,20,-15
23,1,82,6,11,-5
23,1,83,15,22,-7
23,1,84,7,7,0
23,1,85,11,24,-13
23,1,86,11,17,-6
23,1,87,8,10,-2
23,1,88,10,10,0
23,1,89,4,7,-3
23,1,90,6,25,-19
23,1,91,0,4,-4
23,1,92,14,22,-8
23,1,93,13,16,-3
23,1,94,2,8,-6
23,1,95,3,12,-9
23,1,96,10,26,-16
23,1,97,4,12,-8
23,1,98,4,22,-18
23,1,99,11,15,-4
23,1,100,11,15,-4
23,1,101,4,10,-6
23,1,102,11,26,-15
23,1,103,4,30,-26
23,1,104,7,16,-9
23,1,105,14,13,1
23,1,106,5,13,-8
23,1,107,9,7,2
23,1,108,4,12,-8
23,1,109,10,26,-16
23,1,110,3,14,-11
23,1,111,4,20,-16
23,1,112,5,6,-1
23,1,113,4,13,-9
23,1,114,15,48,-33
23,1,115,5,8,-3
23,1,116,6,9,-3
23,1,117,7,20,-13
23,1,118,11,18,-7
23,1,119,13,15,-2
23,1,120,17,22,-5
23,1,121,5,8,-3
23,1,122,1,11,-10
23,1,123,9,6,3
23,1,124,4,12,-8
23,1,125,3,9,-6
23,1,126,7,19,-12
23,1,127,3,9,-6
23,1,128,9,24,-15
23,1,129,9,21,-12
23,1,130,2,14,-12
23,1,131,7,10,-3
23,1,132,5,13,-8
23,1,133,3,10,-7
23,1,134,15,18,-3
23,1,135,8,15,-7
23,1,136,8,19,-11
23,1,137,10,10,0
23,1,138,5,19,-14
23,1,139,5,11,-6
23,1,140,10,12,-2
23,1,141,7,27,-20
23,1,142,18,23,-5
23,1,143,10,20,-10
23,1,144,6,10,-4
23,1,145,11,20,-9
23,1,146,9,22,-13
23,1,147,9,18,-9
23,1,148,2,5,-3
23,1,149,11,11,0
23,1,150,9,9,0
23,1,151,7,6,1
23,1,152,6,31,-25
23,1,153,6,17,-11
23,1,154,9,10,-1
23,1,155,6,22,-16
23,1,156,5,13,-8
23,1,157,10,11,-1
23,1,158,6,17,-11
23,1,159,5,15,-10
23,1,160,15,14,1
23,1,161,11,21,-10
23,1,162,16,16,0
23,1,163,4,8,-4
23,1,164,9,18,-9
23,1,165,5,16,-11
23,1,166,4,14,-10
23,1,167,5,5,0
23,1,168,9,27,-18
23,1,169,10,26,-16
23,1,170,6,7,-1
23,1,171,7,23,-16
23,1,172,10,15,-5
23,1,173,13,18,-5
23,1,174,16,17,-1
23,1,175,13,21,-8
23,1,176,11,13,-2
23,1,177,19,32,-13
23,1,178,7,6,1
23,1,179,3,11,-8
23,1,180,8,25,-17
23,1,181,1,12,-11
23,1,182,17,19,-2
23,1,183,10,27,-17
23,1,184,10,14,-4
23,1,185,14,18,-4
23,1,186,11,18,-7
23,1,187,8,11,-3
23,1,188,14,35,-21
23,1,189,11,20,-9
23,1,190,9,10,-1
23,1,191,2,10,-8
23,1,192,5,32,-27
23,1,193,11,15,-4
23,1,194,3,20,-17
23,1,195,12,14,-2
23,1,196,8,22,-14
23,1,197,10,21,-11
23,1,198,2,8,-6
23,1,199,9,23,-14
23,1,200,4,18,-14
23,1,201,4,22,-18
23,1,202,6,12,-6
23,1,203,5,17,-12
23,1,204,14,30,-16
23,1,205,5,24,-19
23,1,206,8,7,1
23,1,207,9,18,-9
23,1,208,3,24,-21
23,1,209,6,4,2
23,1,210,2,5,-3
23,1,211,6,17,-11
23,1,212,5,11,-6
23,1,213,20,8,12
23,1,214,10,11,-1
23,1,215,7,3,4
23,1,216,14,21,-7
23,1,217,3,22,-19
23,1,218,2,11,-9
23,1,219,14,20,-6
23,1,220,3,9,-6
23,1,221,9,12,-3
23,1,222,6,11,-5
23,1,223,1,18,-17
23,1,224,3,15,-12
23,1,225,7,19,-12
23,1,226,12,22,-10
23,1,227,11,16,-5
23,1,228,2,14,-12
23,1,229,21,30,-9
23,1,230,13,8,5
23,1,231,6,24,-18
23,1,232,6,9,-3
23,1,233,1,10,-9
23,1,234,10,14,-4
23,1,235,4,26,-22
23,1,236,3,13,-10
23,1,237,8,20,-12
23,1,238,4,4,0
23,1,239,6,15,-9
23,1,240,7,24,-17
23,1,241,6,22,-16
23,1,242,9,11,-2
23,1,243,10,24,-14
23,1,244,8,17,-9
23,1,245,7,18,-11
23,1,246,20,19,1
23,1,247,2,23,-21
23,1,248,12,23,-11
23,1,249,16,14,2
23,1,250,9,13,-4
23,1,251,13,18,-5
23,1,252,4,16,-12
23,1,253,11,9,2
23,1,254,6,14,-8
23,1,255,8,18,-10
23,1,256,0,8,-8
23,1,257,9,23,-14
23,1,258,15,15,0
23,1,259,11,17,-6
23,1,260,9,21,-12
23,1,261,3,11,-8
23,1,262,10,13,-3
23,1,263,9,23,-14
23,1,264,7,6,1
23,1,265,1,12,-11
23,1,266,10,18,-8
23,1,267,8,14,-6
23,1,268,6,17,-11
23,1,269,7,17,-10
23,1,270,10,10,0
23,1,271,4,9,-5
23,1,272,8,11,-3
23,1,273,6,10,-4
23,1,274,6,22,-16
23,1,275,7,23,-16
23,1,276,10,23,-13
23,1,277,15,25,-10
23,1,278,9,26,-17
23,1,279,12,16,-4
23,1,280,8,24,-16
23,1,281,6,14,-8
23,1,282,6,17,-11
23,1,283,16,21,-5
23,1,284,8,18,-10
23,1,285,17,28,-11
23,1,286,8,17,-9
23,1,287,6,17,-11
23,1,288,3,16,-13
23,1,289,18,36,-18
23,1,290,6,22,-16
23,1,291,5,18,-13
23,1,292,4,11,-7
23,1,293,10,13,-3
23,1,294,8,23,-15
23,1,295,7,18,-11
23,1,296,11,16,-5
23,1,297,10,11,-1
23,1,298,7,27,-20
23,1,299,4,1,3
23,2,0,5,16,-11
23,2,1,9,19,-10
23,2,2,6,16,-10
23,2,3,10,25,-15
23,2,4,9,26,-17
23,2,5,10,20,-10
23,2,6,12,9,3
23,2,7,10,18,-8
23,2,8,4,11,-7
23,2,9,6,21,-15
23,2,10,10,11,-1
23,2,11,18,22,-4
23,2,12,6,15,-9
23,2,13,9,19,-10
23,2,14,17,33,-16
23,2,15,21,18,3
23,2,16,8,16,-8
23,2,17,4,16,-12
23,2,18,9,25,-16
23,2,19,14,18,-4
23,2,20,7,19,-12
23,2,21,11,20,-9
23,2,22,10,14,-4
23,2,23,6,34,-28
23,2,24,3,27,-24
23,2,25,5,3,2
23,2,26,11,19,-8
23,2,27,8,24,-16
23,2,28,6,17,-11
23,2,29,7,17,-10
23,2,30,12,16,-4
23,2,31,7,30,-23
23,2,32,9,12,-3
23,2,33,14,21,-7
23,2,34,6,17,-11
23,2,35,6,17,-11
23,2,36,7,11,-4
23,2,37,13,28,-15
23,2,38,13,16,-3
23,2,39,12,21,-9
23,2,40,8,32,-24
23,2,41,9,19,-10
23,2,42,5,19,-14
23,2,43,17,17,0
23,2,44,6,22,-16
23,2,45,11,23,-12
23,2,46,7,28,-21
23,2,47,6,19,-13
23,2,48,4,23,-19
23,2,49,15,24,-9
23,2,50,12,19,-7
23,2,51,5,24,-19
23,2,52,14,23,-9
23,2,53,8,17,-9
23,2,54,3,15,-12
23,2,55,16,20,-4
23,2,56,0,17,-17
23,2,57,19,14,5
23,2,58,7,17,-10
23,2,59,3,12,-9
23,2,60,6,17,-11
23,2,61,8,7,1
23,2,62,4,11,-7
23,2,63,13,15,-2
23,2,64,10,30,-20
23,2,65,8,30,-22
23,2,66,7,15,-8
23,2,67,2,18,-16
23,2,68,7,21,-14
23,2,69,9,19,-10
23,2,70,6,11,-5
23,2,71,12,17,-5
23,2,72,13,26,-13
23,2,73,5,16,-11
23,2,74,14,24,-10
23,2,75,13,21,-8
23,2,76,12,22,-10
23,2,77,2,3,-1
23,2,78,13,20,-7
23,2,79,1,18,-17
23,2,80,5,6,-1
23,2,81,3,10,-7
23,2,82,12,33,-21
23,2,83,7,19,-12
23,2,84,3,10,-7
23,2,85,4,12,-8
23,2,86,8,22,-14
23,2,87,9,19,-10
23,2,88,3,16,-13
23,2,89,7,18,-11
23,2,90,6,22,-16
23,2,91,6,19,-13
23,2,92,4,10,-6
23,2,93,6,16,-10
23,2,94,14,14,0
23,2,95,6,14,-8
23,2,96,8,11,-3
23,2,97,5,20,-15
23,2,98,7,14,-7
23,2,99,5,11,-6
23,2,100,4,7,-3
23,2,101,9,21,-12
23,2,102,11,13,-2
23,2,103,9,5,4
23,2,104,4,18,-14
23,2,105,5,24,-19
23,2,106,6,16,-10
23,2,107,3,5,-2
23,2,108,4,16,-12
23,2,109,7,18,-11
23,2,110,7,22,-15
23,2,111,5,30,-25
23,2,112,4,10,-6
23,2,113,6,11,-5
23,2,114,6,20,-14
23,2,115,14,20,-6
23,2,116,8,10,-2
23,2,117,16,11,5
23,2,118,4,14,-10
23,2,119,17,12,5
23,2,120,9,22,-13
23,2,121,4,13,-9
23,2,122,3,8,-5
23,2,123,5,9,-4
23,2,124,14,38,-24
23,2,125,13,12,1
23,2,126,13,19,-6
23,2,127,7,16,-9
23,2,128,1,9,-8
23,2,129,1,7,-6
23,2,130,7,9,-2
23,2,131,12,10,2
23,2,132,14,27,-13
23,2,133,2,12,-10
23,2,134,6,18,-12
23,2,135,8,21,-13
23,2,136,8,15,-7
23,2,137,10,9,1
23,2,138,14,18,-4
23,2,139,5,17,-12
23,2,140,5,24,-19
23,2,141,8,24,-16
23,2,142,11,18,-7
23,2,143,5,23,-18
23,2,144,2,15,-13
23,2,145,9,16,-7
23,2,146,11,12,-1
23,2,147,8,21,-13
23,2,148,7,23,-16
23,2,149,17,23,-6
23,2,150,8,15,-7
23,2,151,9,23,-14
23,2,152,1,13,-12
23,2,153,0,6,-6
23,2,154,6,24,-18
23,2,155,12,20,-8
23,2,156,5,17,-12
23,2,157,8,16,-8
23,2,158,10,9,1
23,2,159,9,26,-17
23,2,160,9,19,-10
23,2,161,14,24,-10
23,2,162,6,9,-3
23,2,163,12,15,-3
23,2,164,24,27,-3
23,2,165,10,18,-8
23,2,166,11,26,-15
23,2,167,7,3,4
23,2,168,6,16,-10
23,2,169,24,22,2
23,2,170,7,19,-12
23,2,171,12,20,-8
23,2,172,2,10,-8
23,2,173,13,21,-8
23,2,174,11,22,-11
23,2,175,5,12,-7
23,2,176,0,14,-14
23,2,177,2,23,-21
23,2,178,4,21,-17
23,2,179,9,26,-17
23,2,180,5,20,-15
23,2,181,11,22,-11
23,2,182,1,11,-10
23,2,183,3,8,-5
23,2,184,3,9,-6
23,2,185,9,10,-1
23,2,186,9,15,-6
23,2,187,5,19,-14
23,2,188,9,16,-7
23,2,189,5,16,-11
23,2,190,12,18,-6
23,2,191,8,15,-7
23,2,192,9,25,-16
23,2,193,8,25,-17
23,2,194,8,9,-1
23,2,195,4,18,-14
23,2,196,7,12,-5
23,2,197,3,7,-4
23,2,198,8,9,-1
23,2,199,6,26,-20
23,2,200,5,15,-10
23,2,201,9,29,-20
23,2,202,10,36,-26
23,2,203,6,6,0
23,2,204,11,31,-20
23,2,205,6,12,-6
23,2,206,8,29,-21
23,2,207,6,8,-2
23,2,208,5,26,-21
23,2,209,4,6,-2
23,2,210,6,7,-1
23,2,211,9,15,-6
23,2,212,8,13,-5
23,2,213,2,16,-14
23,2,214,13,36,-23
23,2,215,2,7,-5
23,2,216,19,25,-6
23,2,217,10,24,-14
23,2,218,10,18,-8
23,2,219,12,24,-12
23,2,220,13,13,0
23,2,221,14,24,-10
23,2,222,4,16,-12
23,2,223,8,11,-3
23,2,224,7,9,-2
23,2,225,8,18,-10
23,2,226,14,19,-5
23,2,227,4,12,-8
23,2,228,6,13,-7
23,2,229,8,17,-9
23,2,230,8,14,-6
23,2,231,5,8,-3
23,2,232,5,15,-10
23,2,233,11,17,-6
23,2,234,9,27,-18
23,2,235,8,20,-12
23,2,236,9,13,-4
23,2,237,9,14,-5
23,2,238,8,7,1
23,2,239,11,15,-4
23,2,240,12,19,-7
23,2,241,7,25,-18
23,2,242,4,17,-13
23,2,243,15,26,-11
23,2,244,13,21,-8
23,2,245,11,17,-6
23,2,246,10,9,1
23,2,247,3,18,-15
23,2,248,13,14,-1
23,2,249,6,9,-3
23,2,250,11,18,-7
23,2,251,5,12,-7
23,2,252,5,16,-11
23,2,253,5,6,-1
23,2,254,11,19,-8
23,2,255,6,9,-3
23,2,256,8,25,-17
23,2,257,6,28,-22
23,2,258,14,16,-2
23,2,259,8,13,-5
23,2,260,1,17,-16
23,2,261,6,12,-6
23,2,262,6,22,-16
23,2,263,8,16,-8
23,2,264,7,8,-1
23,2,265,16,14,2
23,2,266,12,6,6
23,2,267,13,21,-8
23,2,268,4,10,-6
23,2,269,9,23,-14
23,2,270,6,21,-15
23,2,271,5,17,-12
23,2,272,2,12,-10
23,2,273,7,14,-7
23,2,274,5,16,-11
23,2,275,6,19,-13
23,2,276,4,14,-10
23,2,277,2,15,-13
23,2,278,8,33,-25
23,2,279,7,17,-10
23,2,280,11,18,-7
23,2,281,3,8,-5
23,2,282,7,23,-16
23,2,283,5,8,-3
23,2,284,12,19,-7
23,2,285,9,16,-7
23,2,286,5,8,-3
23,2,287,5,16,-11
23,2,288,6,21,-15
23,2,289,14,29,-15
23,2,290,2,8,-6
23,2,291,2,10,-8
23,2,292,11,16,-5
23,2,293,15,16,-1
23,2,294,14,26,-12
23,2,295,5,21,-16
23,2,296,5,15,-10
23,2,297,3,13,-10
23,2,298,8,17,-9
23,2,299,8,13,-5
23,3,0,9,14,-5
23,3,1,8,18,-10
23,3,2,5,32,-27
23,3,3,4,10,-6
23,3,4,7,16,-9
23,3,5,8,15,-7
23,3,6,13,11,2
23,3,7,3,14,-11
23,3,8,10,21,-11
23,3,9,3,26,-23
23,3,10,10,26,-16
23,3,11,13,29,-16
23,3,12,6,15,-9
23,3,13,6,8,-2
23,3,14,9,11,-2
23,3,15,12,14,-2
23,3,16,4,13,-9
23,3,17,6,11,-5
23,3,18,7,11,-4
23,3,19,9,15,-6
23,3,20,9,13,-4
23,3,21,8,19,-11
23,3,22,9,20,-11
23,3,23,5,14,-9
23,3,24,8,19,-11
23,3,25,16,24,-8
23,3,26,6,17,-11
23,3,27,11,22,-11
23,3,28,6,16,-10
23,3,29,6,23,-17
23,3,30,9,27,-18
23,3,31,12,13,-1
23,3,32,16,37,-21
23,3,33,3,17,-14
23,3,34,8,5,3
23,3,35,15,23,-8
23,3,36,13,18,-5
23,3,37,18,11,7
23,3,38,17,15,2
23,3,39,5,17,-12
23,3,40,9,23,-14
23,3,41,11,9,2
23,3,42,8,14,-6
23,3,43,17,39,-22
23,3,44,5,27,-22
23,3,45,15,17,-2
23,3,46,11,24,-13
23,3,47,5,22,-17
23,3,48,7,11,-4
23,3,49,13,24,-11
23,3,50,4,16,-12
23,3,51,10,20,-10
23,3,52,12,21,-9
23,3,53,8,26,-18
23,3,54,6,14,-8
23,3,55,11,38,-27
23,3,56,8,25,-17
23,3,57,20,21,-1
23,3,58,9,19,-10
23,3,59,5,18,-13
23,3,60,7,25,-18
23,3,61,8,22,-14
23,3,62,7,14,-7
23,3,63,9,27,-18
23,3,64,9,23,-14
23,3,65,7,33,-26
23,3,66,12,11,1
23,3,67,9,17,-8
23,3,68,17,20,-3
23,3,69,5,19,-14
23,3,70,9,27,-18
23,3,71,5,19,-14
23,3,72,5,10,-5
23,3,73,9,19,-10
23,3,74,21,19,2
23,3,75,14,22,-8
23,3,76,13,15,-2
23,3,77,4,12,-8
23,3,78,11,25,-14
23,3,79,13,21,-8
23,3,80,14,21,-7
23,3,81,6,25,-19
23,3,82,10,24,-14
23,3,83,20,36,-16
23,3,84,12,19,-7
23,3,85,5,20,-15
23,3,86,6,12,-6
23,3,87,12,25,-13
23,3,88,9,27,-18
23,3,89,6,21,-15
23,3,90,6,22,-16
23,3,91,12,8,4
23,3,92,8,26,-18
23,3,93,14,14,0
23,3,94,4,25,-21
23,3,95,10,18,-8
23,3,96,10,37,-27
23,3,97,7,20,-13
23,3,98,7,34,-27
23,3,99,6,15,-9
23,3,100,8,9,-1
23,3,101,3,29,-26
23,3,102,6,12,-6
23,3,103,5,15,-10
23,3,104,6,27,-21
23,3,105,20,24,-4
23,3,106,16,22,-6
23,3,107,9,7,2
23,3,108,21,20,1
23,3,109,7,15,-8
23,3,110,3,12,-9
23,3,111,4,16,-12
23,3,112,4,12,-8
23,3,113,4,17,-13
23,3,114,10,12,-2
23,3,115,8,32,-24
23,3,116,8,16,-8
23,3,117,5,20,-15
23,3,118,8,13,-5
23,3,119,7,17,-10
23,3,120,6,4,2
23,3,121,5,12,-7
23,3,122,8,24,-16
23,3,123,5,25,-20
23,3,124,14,16,-2
23,3,125,4,12,-8
23,3,126,6,13,-7
23,3,127,6,12,-6
23,3,128,15,21,-6
23,3,129,4,17,-13
23,3,130,8,15,-7
23,3,131,4,23,-19
23,3,132,10,24,-14
23,3,133,13,24,-11
23,3,134,3,35,-32
23,3,135,3,16,-13
23,3,136,7,12,-5
23,3,137,16,23,-7
23,3,138,15,15,0
23,3,139,12,13,-1
23,3,140,5,14,-9
23,3,141,5,22,-17
23,3,142,27,23,4
23,3,143,13,18,-5
23,3,144,9,12,-3
23,3,145,17,12,5
23,3,146,5,25,-20
23,3,147,10,10,0
23,3,148,14,21,-7
23,3,149,11,17,-6
23,3,150,14,18,-4
23,3,151,15,24,-9
23,3,152,6,8,-2
23,3,153,7,16,-9
23,3,154,17,22,-5
23,3,155,12,26,-14
23,3,156,5,23,-18
23,3,157,12,27,-15
23,3,158,10,26,-16
23,3,159,9,13,-4
23,3,160,9,14,-5
23,3,161,10,15,-5
23,3,162,4,31,-27
23,3,163,6,23,-17
23,3,164,7,10,-3
23,3,165,17,18,-1
23,3,166,5,26,-21
23,3,167,8,14,-6
23,3,168,12,22,-10
23,3,169,16,19,-3
23,3,170,9,16,-7
23,3,171,1,10,-9
23,3,172,14,12,2
23,3,173,12,29,-17
23,3,174,11,19,-8
23,3,175,6,26,-20
23,3,176,22,17,5
23,3,177,11,13,-2
23,3,178,21,26,-5
23,3,179,6,26,-20
23,3,180,8,11,-3
23,3,181,6,20,-14
23,3,182,6,8,-2
23,3,183,9,12,-3
23,3,184,12,15,-3
23,3,185,5,20,-15
23,3,186,9,31,-22
23,3,187,12,21,-9
23,3,188,9,15,-6
23,3,189,7,25,-18
23,3,190,7,22,-15
23,3,191,13,27,-14
23,3,192,8,21,-13
23,3,193,9,6,3
23,3,194,4,12,-8
23,3,195,11,22,-11
23,3,196,12,16,-4
23,3,197,6,25,-19
23,3,198,2,7,-5
23,3,199,4,16,-12
23,3,200,15,18,-3
23,3,201,8,24,-16
23,3,202,11,39,-28
23,3,203,3,8,-5
23,3,204,13,27,-14
23,3,205,16,14,2
23,3,206,15,15,0
23,3,207,10,14,-4
23,3,208,6,18,-12
23,3,209,4,9,-5
23,3,210,12,16,-4
23,3,211,5,22,-17
23,3,212,5,17,-12
23,3,213,9,14,-5
23,3,214,14,27,-13
23,3,215,9,20,-11
23,3,216,10,20,-10
23,3,217,8,25,-17
23,3,218,5,21,-16
23,3,219,19,21,-2
23,3,220,13,26,-13
23,3,221,13,14,-1
23,3,222,6,19,-13
23,3,223,10,11,-1
23,3,224,8,19,-11
23,3,225,7,27,-20
23,3,226,7,27,-20
23,3,227,5,28,-23
23,3,228,11,19,-8
23,3,229,9,4,5
23,3,230,7,13,-6
23,3,231,9,12,-3
23,3,232,3,15,-12
23,3,233,11,14,-3
23,3,234,4,18,-14
23,3,235,2,11,-9
23,3,236,11,9,2
23,3,237,6,32,-26
23,3,238,7,22,-15
23,3,239,14,16,-2
23,3,240,10,16,-6
23,3,241,9,6,3
23,3,242,7,13,-6
23,3,243,7,29,-22
23,3,244,7,13,-6
23,3,245,6,13,-7
23,3,246,11,6,5
23,3,247,6,23,-17
23,3,248,5,6,-1
23,3,249,7,21,-14
23,3,250,7,13,-6
23,3,251,20,20,0
23,3,252,12,16,-4
23,3,253,3,16,-13
23,3,254,15,25,-10
23,3,255,9,19,-10
23,3,256,5,12,-7
23,3,257,8,29,-21
23,3,258,8,16,-8
23,3,259,18,15,3
23,3,260,7,12,-5
23,3,261,3,15,-12
23,3,262,4,13,-9
23,3,263,4,13,-9
23,3,264,14,18,-4
23,3,265,8,17,-9
23,3,266,7,34,-27
23,3,267,14,19,-5
23,3,268,11,20,-9
23,3,269,3,5,-2
23,3,270,14,12,2
23,3,271,13,15,-2
23,3,272,13,26,-13
23,3,273,9,15,-6
23,3,274,12,23,-11
23,3,275,11,24,-13
23,3,276,6,5,1
23,3,277,4,7,-3
23,3,278,14,32,-18
23,3,279,12,17,-5
23,3,280,4,27,-23
23,3,281,8,32,-24
23,3,282,11,16,-5
23,3,283,6,13,-7
23,3,284,10,14,-4
23,3,285,11,38,-27
23,3,286,6,32,-26
23,3,287,4,18,-14
23,3,288,6,8,-2
23,3,289,1,21,-20
23,3,290,4,13,-9
23,3,291,2,9,-7
23,3,292,6,26,-20
23,3,293,14,17,-3
23,3,294,8,26,-18
23,3,295,7,21,-14
23,3,296,4,18,-14
23,3,297,5,13,-8
23,3,298,11,15,-4
23,3,299,2,11,-9
23,4,0,10,14,-4
23,4,1,10,36,-26
23,4,2,4,20,-16
23,4,3,9,19,-10
23,4,4,22,36,-14
23,4,5,15,18,-3
23,4,6,5,6,-1
23,4,7,12,27,-15
23,4,8,7,14,-7
23,4,9,10,20,-10
23,4,10,7,19,-12
23,4,11,12,18,-6
23,4,12,8,17,-9
23,4,13,13,31,-18
23,4,14,5,22,-17
23,4,15,12,24,-12
23,4,16,12,28,-16
23,4,17,7,21,-14
23,4,18,15,15,0
23,4,19,8,20,-12
23,4,20,8,20,-12
23,4,21,10,15,-5
23,4,22,15,19,-4
23,4,23,8,16,-8
23,4,24,9,21,-12
23,4,25,9,12,-3
23,4,26,6,21,-15
23,4,27,11,38,-27
23,4,28,6,12,-6
23,4,29,6,9,-3
23,4,30,10,23,-13
23,4,31,9,16,-7
23,4,32,11,29,-18
23,4,33,15,32,-17
23,4,34,6,11,-5
23,4,35,11,17,-6
23,4,36,18,23,-5
23,4,37,13,20,-7
23,4,38,8,28,-20
23,4,39,3,13,-10
23,4,40,7,11,-4
23,4,41,3,25,-22
23,4,42,5,7,-2
23,4,43,10,14,-4
23,4,44,10,27,-17
23,4,45,6,28,-22
23,4,46,17,12,5
23,4,47,7,18,-11
23,4,48,12,16,-4
23,4,49,13,6,7
23,4,50,9,14,-5
23,4,51,4,16,-12
23,4,52,5,21,-16
23,4,53,11,12,-1
23,4,54,10,16,-6
23,4,55,9,31,-22
23,4,56,6,24,-18
23,4,57,7,18,-11
23,4,58,14,28,-14
23,4,59,5,21,-16
23,4,60,18,19,-1
23,4,61,4,18,-14
23,4,62,8,24,-16
23,4,63,13,19,-6
23,4,64,17,21,-4
23,4,65,9,15,-6
23,4,66,15,8,7
23,4,67,12,24,-12
23,4,68,9,11,-2
23,4,69,5,9,-4
23,4,70,6,15,-9
23,4,71,5,15,-10
23,4,72,14,34,-20
23,4,73,3,28,-25
23,4,74,6,19,-13
23,4,75,12,21,-9
23,4,76,6,15,-9
23,4,77,2,30,-28
23,4,78,11,12,-1
23,4,79,14,29,-15
23,4,80,13,21,-8
23,4,81,6,12,-6
23,4,82,11,31,-20
23,4,83,7,28,-21
23,4,84,16,26,-10
23,4,85,4,18,-14
23,4,86,2,15,-13
23,4,87,6,27,-21
23,4,88,6,32,-26
23,4,89,8,23,-15
23,4,90,13,20,-7
23,4,91,13,27,-14
23,4,92,8,10,-2
23,4,93,5,21,-16
23,4,94,9,23,-14
23,4,95,5,13,-8
23,4,96,8,27,-19
23,4,97,10,29,-19
23,4,98,12,21,-9
23,4,99,8,25,-17
23,4,100,13,27,-14
23,4,101,10,22,-12
23,4,102,18,16,2
23,4,103,16,24,-8
23,4,104,7,39,-32
23,4,105,11,21,-10
23,4,106,8,19,-11
23,4,107,7,36,-29
23,4,108,19,13,6
23,4,109,5,20,-15
23,4,110,4,17,-13
23,4,111,11,28,-17
23,4,112,2,20,-18
23,4,113,7,29,-22
23,4,114,9,18,-9
23,4,115,6,17,-11
23,4,116,12,20,-8
23,4,117,1,19,-18
23,4,118,6,21,-15
23,4,119,6,13,-7
23,4,120,7,13,-6
23,4,121,4,10,-6
23,4,122,14,34,-20
23,4,123,9,29,-20
23,4,124,7,16,-9
23,4,125,9,24,-15
23,4,126,9,21,-12
23,4,127,9,22,-13
23,4,128,10,11,-1
23,4,129,14,22,-8
23,4,130,5,27,-22
23,4,131,10,15,-5
23,4,132,6,19,-13
23,4,133,3,11,-8
23,4,134,12,12,0
23,4,135,7,18,-11
23,4,136,12,15,-3
23,4,137,5,12,-7
23,4,138,8,19,-11
23,4,139,14,20,-6
23,4,140,9,31,-22
23,4,141,8,15,-7
23,4,142,7,16,-9
23,4,143,6,23,-17
23,4,144,8,12,-4
23,4,145,11,9,2
23,4,146,7,14,-7
23,4,147,4,9,-5
23,4,148,5,21,-16
23,4,149,1,11,-10
23,4,150,18,23,-5
23,4,151,9,23,-14
23,4,152,8,19,-11
23,4,153,7,10,-3
23,4,154,17,26,-9
23,4,155,14,30,-16
23,4,156,5,17,-12
23,4,157,11,13,-2
23,4,158,12,28,-16
23,4,159,3,17,-14
23,4,160,14,29,-15
23,4,161,3,30,-27
23,4,162,3,13,-10
23,4,163,13,11,2
23,4,164,3,7,-4
23,4,165,12,15,-3
23,4,166,5,15,-10
23,4,167,3,6,-3
23,4,168,4,7,-3
23,4,169,5,6,-1
23,4,170,13,24,-11
23,4,171,17,15,2
23,4,172,8,27,-19
23,4,173,10,18,-8
23,4,174,24,29,-5
23,4,175,7,17,-10
23,4,176,8,19,-11
23,4,177,17,19,-2
23,4,178,7,20,-13
23,4,179,6,25,-19
23,4,180,4,7,-3
23,4,181,7,25,-18
23,4,182,11,15,-4
23,4,183,10,27,-17
23,4,184,9,19,-10
23,4,185,10,25,-15
23,4,186,5,17,-12
23,4,187,19,39,-20
23,4,188,12,29,-17
23,4,189,17,28,-11
23,4,190,6,24,-18
23,4,191,17,18,-1
23,4,192,7,15,-8
23,4,193,5,21,-16
23,4,194,12,36,-24
23,4,195,11,23,-12
23,4,196,7,15,-8
23,4,197,9,17,-8
23,4,198,7,14,-7
23,4,199,11,33,-22
23,4,200,10,21,-11
23,4,201,8,23,-15
23,4,202,5,20,-15
23,4,203,16,23,-7
23,4,204,12,11,1
23,4,205,5,7,-2
23,4,206,14,19,-5
23,4,207,12,26,-14
23,4,208,10,14,-4
23,4,209,15,30,-15
23,4,210,7,15,-8
23,4,211,2,16,-14
23,4,212,21,29,-8
23,4,213,8,18,-10
23,4,214,5,23,-18
23,4,215,10,22,-12
23,4,216,9,18,-9
23,4,217,10,18,-8
23,4,218,1,9,-8
23,4,219,7,23,-16
23,4,220,10,6,4
23,4,221,9,17,-8
23,4,222,8,5,3
23,4,223,14,17,-3
23,4,224,15,28,-13
23,4,225,15,34,-19
23,4,226,10,13,-3
23,4,227,2,13,-11
23,4,228,10,24,-14
23,4,229,6,14,-8
23,4,230,15,15,0
23,4,231,6,19,-13
23,4,232,6,24,-18
23,4,233,5,26,-21
23,4,234,13,20,-7
23,4,235,9,13,-4
23,4,236,8,24,-16
23,4,237,14,14,0
23,4,238,10,22,-12
23,4,239,13,24,-11
23,4,240,11,16,-5
23,4,241,19,22,-3
23,4,242,14,20,-6
23,4,243,11,17,-6
23,4,244,15,15,0
23,4,245,6,9,-3
23,4,246,5,19,-14
23,4,247,9,12,-3
23,4,248,8,25,-17
23,4,249,17,22,-5
23,4,250,4,23,-19
23,4,251,7,22,-15
23,4,252,8,15,-7
23,4,253,18,21,-3
23,4,254,8,34,-26
23,4,255,9,28,-19
23,4,256,8,15,-7
23,4,257,6,10,-4
23,4,258,13,14,-1
23,4,259,19,37,-18
23,4,260,3,20,-17
23,4,261,8,10,-2
23,4,262,16,13,3
23,4,263,8,30,-22
23,4,264,16,26,-10
23,4,265,6,13,-7
23,4,266,13,14,-1
23,4,267,6,14,-8
23,4,268,6,11,-5
23,4,269,7,20,-13
23,4,270,5,8,-3
23,4,271,8,29,-21
23,4,272,2,12,-10
23,4,273,16,33,-17
23,4,274,0,10,-10
23,4,275,18,26,-8
23,4,276,11,12,-1
23,4,277,4,22,-18
23,4,278,10,8,2
23,4,279,12,22,-10
23,4,280,5,20,-15
23,4,281,17,21,-4
23,4,282,9,18,-9
23,4,283,9,27,-18
23,4,284,3,27,-24
23,4,285,7,11,-4
23,4,286,15,23,-8
23,4,287,19,13,6
23,4,288,4,26,-22
23,4,289,3,25,-22
23,4,290,14,19,-5
23,4,291,4,25,-21
23,4,292,11,15,-4
23,4,293,11,12,-1
23,4,294,15,17,-2
23,4,295,12,30,-18
23,4,296,4,16,-12
23,4,297,5,6,-1
23,4,298,12,19,-7
23,4,299,8,23,-15
23,5,0,7,10,-3
23,5,1,13,25,-12
23,5,2,10,18,-8
23,5,3,10,20,-10
23,5,4,12,25,-13
23,5,5,8,18,-10
23,5,6,11,25,-14
23,5,7,15,27,-12
23,5,8,10,16,-6
23,5,9,9,24,-15
23,5,10,11,28,-17
23,5,11,10,29,-19
23,5,12,10,27,-17
23,5,13,5,9,-4
23,5,14,11,23,-12
23,5,15,11,16,-5
23,5,16,10,10,0
23,5,17,10,16,-6
23,5,18,10,22,-12
23,5,19,13,39,-26
23,5,20,7,32,-25
23,5,21,10,18,-8
23,5,22,16,16,0
23,5,23,9,26,-17
23,5,24,8,18,-10
23,5,25,6,19,-13
23,5,26,8,26,-18
23,5,27,11,11,0
23,5,28,13,19,-6
23,5,29,9,10,-1
23,5,30,14,40,-26
23,5,31,2,8,-6
23,5,32,4,16,-12
23,5,33,22,27,-5
23,5,34,17,23,-6
23,5,35,1,20,-19
23,5,36,11,17,-6
23,5,37,3,5,-2
23,5,38,16,21,-5
23,5,39,18,22,-4
23,5,40,12,12,0
23,5,41,21,22,-1
23,5,42,10,16,-6
23,5,43,17,22,-5
23,5,44,12,29,-17
23,5,45,9,11,-2
23,5,46,9,19,-10
23,5,47,6,12,-6
23,5,48,5,16,-11
23,5,49,11,15,-4
23,5,50,5,15,-10
23,5,51,9,3,6
23,5,52,21,33,-12
23,5,53,16,30,-14
23,5,54,8,33,-25
23,5,55,5,22,-17
23,5,56,9,24,-15
23,5,57,7,35,-28
23,5,58,6,8,-2
23,5,59,7,26,-19
23,5,60,11,23,-12
23,5,61,11,16,-5
23,5,62,16,35,-19
23,5,63,11,27,-16
23,5,64,5,12,-7
23,5,65,11,18,-7
23,5,66,3,19,-16
23,5,67,6,17,-11
23,5,68,7,19,-12
23,5,69,9,22,-13
23,5,70,12,27,-15
23,5,71,13,17,-4
23,5,72,12,18,-6
23,5,73,16,22,-6
23,5,74,8,6,2
23,5,75,15,36,-21
23,5,76,8,16,-8
23,5,77,15,16,-1
23,5,78,12,27,-15
23,5,79,10,15,-5
23,5,80,5,14,-9
23,5,81,8,25,-17
23,5,82,6,16,-10
23,5,83,10,30,-20
23,5,84,12,20,-8
23,5,85,16,30,-14
23,5,86,8,14,-6
23,5,87,15,16,-1
23,5,88,11,15,-4
23,5,89,22,19,3
23,5,90,12,28,-16
23,5,91,11,19,-8
23,5,92,6,16,-10
23,5,93,8,12,-4
23,5,94,17,35,-18
23,5,95,9,41,-32
23,5,96,8,13,-5
23,5,97,3,27,-24
23,5,98,7,12,-5
23,5,99,4,13,-9
23,5,100,11,16,-5
23,5,101,6,14,-8
23,5,102,23,34,-11
23,5,103,18,12,6
23,5,104,14,26,-12
23,5,105,11,20,-9
23,5,106,9,15,-6
23,5,107,14,14,0
23,5,108,10,33,-23
23,5,109,7,15,-8
23,5,110,12,21,-9
23,5,111,10,8,2
23,5,112,17,21,-4
23,5,113,15,14,1
23,5,114,13,7,6
23,5,115,13,18,-5
23,5,116,2,4,-2
23,5,117,5,20,-15
23,5,118,9,17,-8
23,5,119,6,22,-16
23,5,120,10,30,-20
23,5,121,10,14,-4
23,5,122,13,18,-5
23,5,123,8,17,-9
23,5,124,5,6,-1
23,5,125,4,12,-8
23,5,126,14,15,-1
23,5,127,8,22,-14
23,5,128,5,32,-27
23,5,129,13,28,-15
23,5,130,8,26,-18
23,5,131,8,25,-17
23,5,132,13,35,-22
23,5,133,7,13,-6
23,5,134,9,24,-15
23,5,135,7,8,-1
23,5,136,14,30,-16
23,5,137,12,17,-5
23,5,138,8,12,-4
23,5,139,6,15,-9
23,5,140,3,5,-2
23,5,141,22,13,9
23,5,142,5,16,-11
23,5,143,7,18,-11
23,5,144,8,36,-28
23,5,145,21,28,-7
23,5,146,20,32,-12
23,5,147,13,22,-9
23,5,148,10,15,-5
23,5,149,16,21,-5
23,5,150,5,21,-16
23,5,151,20,27,-7
23,5,152,13,35,-22
23,5,153,12,24,-12
23,5,154,10,22,-12
23,5,155,10,21,-11
23,5,156,9,11,-2
23,5,157,7,27,-20
23,5,158,8,12,-4
23,5,159,6,19,-13
23,5,160,3,12,-9
23,5,161,7,16,-9
23,5,162,5,20,-15
23,5,163,7,20,-13
23,5,164,5,16,-11
23,5,165,8,12,-4
23,5,166,10,23,-13
23,5,167,7,14,-7
23,5,168,10,22,-12
23,5,169,7,7,0
23,5,170,8,5,3
23,5,171,4,18,-14
23,5,172,11,19,-8
23,5,173,11,26,-15
23,5,174,13,26,-13
23,5,175,12,15,-3
23,5,176,0,11,-11
23,5,177,15,26,-11
23,5,178,10,33,-23
23,5,179,12,16,-4
23,5,180,16,28,-12
23,5,181,13,21,-8
23,5,182,16,22,-6
23,5,183,9,30,-21
23,5,184,13,27,-14
23,5,185,6,13,-7
23,5,186,13,31,-18
23,5,187,5,16,-11
23,5,188,10,17,-7
23,5,189,8,23,-15
23,5,190,9,19,-10
23,5,191,2,16,-14
23,5,192,8,32,-24
23,5,193,4,21,-17
23,5,194,11,26,-15
23,5,195,7,10,-3
23,5,196,8,22,-14
23,5,197,6,16,-10
23,5,198,12,15,-3
23,5,199,23,23,0
23,5,200,14,28,-14
23,5,201,19,27,-8
23,5,202,3,9,-6
23,5,203,4,16,-12
23,5,204,13,21,-8
23,5,205,5,14,-9
23,5,206,8,10,-2
23,5,207,0,19,-19
23,5,208,8,19,-11
23,5,209,8,12,-4
23,5,210,7,16,-9
23,5,211,14,13,1
23,5,212,14,27,-13
23,5,213,11,19,-8
23,5,214,19,38,-19
23,5,215,13,33,-20
23,5,216,12,19,-7
23,5,217,10,23,-13
23,5,218,9,24,-15
23,5,219,11,31,-20
23,5,220,3,10,-7
23,5,221,16,23,-7
23,5,222,20,26,-6
23,5,223,12,10,2
23,5,224,7,17,-10
23,5,225,8,7,1
23,5,226,4,8,-4
23,5,227,18,28,-10
23,5,228,12,9,3
23,5,229,16,22,-6
23,5,230,11,30,-19
23,5,231,10,14,-4
23,5,232,8,16,-8
23,5,233,7,19,-12
23,5,234,16,32,-16
23,5,235,11,36,-25
23,5,236,6,24,-18
23,5,237,9,18,-9
23,5,238,20,18,2
23,5,239,9,17,-8
23,5,240,12,5,7
23,5,241,7,24,-17
23,5,242,7,21,-14
23,5,243,19,21,-2
23,5,244,14,31,-17
23,5,245,12,26,-14
23,5,246,5,13,-8
23,5,247,9,32,-23
23,5,248,15,26,-11
23,5,249,25,30,-5
23,5,250,9,20,-11
23,5,251,11,16,-5
23,5,252,8,34,-26
23,5,253,7,11,-4
23,5,254,12,21,-9
23,5,255,10,15,-5
23,5,256,2,15,-13
23,5,257,4,25,-21
23,5,258,14,18,-4
23,5,259,14,14,0
23,5,260,8,12,-4
23,5,261,7,23,-16
23,5,262,8,17,-9
23,5,263,6,7,-1
23,5,264,15,34,-19
23,5,265,11,20,-9
23,5,266,8,15,-7
23,5,267,5,24,-19
23,5,268,9,23,-14
23,5,269,14,27,-13
23,5,270,10,13,-3
23,5,271,15,19,-4
23,5,272,10,21,-11
23,5,273,5,24,-19
23,5,274,4,15,-11
23,5,275,6,23,-17
23,5,276,16,16,0
23,5,277,5,13,-8
23,5,278,13,13,0
23,5,279,19,15,4
23,5,280,21,25,-4
23,5,281,11,23,-12
23,5,282,17,20,-3
23,5,283,11,29,-18
23,5,284,12,25,-13
23,5,285,6,35,-29
23,5,286,10,21,-11
23,5,287,9,14,-5
23,5,288,4,18,-14
23,5,289,5,10,-5
23,5,290,8,17,-9
23,5,291,8,15,-7
23,5,292,10,22,-12
23,5,293,10,20,-10
23,5,294,18,25,-7
23,5,295,7,23,-16
23,5,296,4,25,-21
23,5,297,7,10,-3
23,5,298,7,13,-6
23,5,299,1,17,-16
23,6,0,10,22,-12
23,6,1,9,18,-9
23,6,2,4,15,-11
23,6,3,9,19,-10
23,6,4,13,16,-3
23,6,5,10,18,-8
23,6,6,17,18,-1
23,6,7,15,13,2
23,6,8,12,10,2
23,6,9,7,8,-1
23,6,10,14,20,-6
23,6,11,8,12,-4
23,6,12,7,20,-13
23,6,13,8,21,-13
23,6,14,6,23,-17
23,6,15,15,24,-9
23,6,16,6,9,-3
23,6,17,8,42,-34
23,6,18,12,17,-5
23,6,19,15,23,-8
23,6,20,8,25,-17
23,6,21,8,13,-5
23,6,22,13,9,4
23,6,23,14,11,3
23,6,24,13,33,-20
23,6,25,11,13,-2
23,6,26,8,15,-7
23,6,27,12,18,-6
23,6,28,6,11,-5
23,6,29,10,14,-4
23,6,30,10,15,-5
23,6,31,7,12,-5
23,6,32,16,10,6
23,6,33,16,18,-2
23,6,34,7,19,-12
23,6,35,15,9,6
23,6,36,5,15,-10
23,6,37,9,15,-6
23,6,38,13,37,-24
23,6,39,7,33,-26
23,6,40,13,14,-1
23,6,41,10,8,2
23,6,42,8,12,-4
23,6,43,10,16,-6
23,6,44,10,30,-20
23,6,45,8,24,-16
23,6,46,16,19,-3
23,6,47,12,17,-5
23,6,48,15,23,-8
23,6,49,14,19,-5
23,6,50,12,24,-12
23,6,51,9,22,-13
23,6,52,9,27,-18
23,6,53,9,24,-15
23,6,54,14,19,-5
23,6,55,5,16,-11
23,6,56,22,30,-8
23,6,57,9,14,-5
23,6,58,14,16,-2
23,6,59,11,19,-8
23,6,60,5,10,-5
23,6,61,8,13,-5
23,6,62,5,14,-9
23,6,63,13,21,-8
23,6,64,3,14,-11
23,6,65,14,12,2
23,6,66,20,34,-14
23,6,67,5,17,-12
23,6,68,8,14,-6
23,6,69,14,19,-5
23,6,70,15,42,-27
23,6,71,10,20,-10
23,6,72,13,21,-8
23,6,73,21,25,-4
23,6,74,5,13,-8
23,6,75,15,17,-2
23,6,76,3,20,-17
23,6,77,11,26,-15
23,6,78,14,25,-11
23,6,79,8,17,-9
23,6,80,13,29,-16
23,6,81,12,19,-7
23,6,82,14,12,2
23,6,83,3,16,-13
23,6,84,6,21,-15
23,6,85,3,13,-10
23,6,86,16,24,-8
23,6,87,9,22,-13
23,6,88,8,25,-17
23,6,89,5,10,-5
23,6,90,10,23,-13
23,6,91,11,25,-14
23,6,92,15,16,-1
23,6,93,5,11,-6
23,6,94,4,10,-6
23,6,95,7,21,-14
23,6,96,10,13,-3
23,6,97,13,21,-8
23,6,98,5,33,-28
23,6,99,2,21,-19
23,6,100,10,11,-1
23,6,101,11,28,-17
23,6,102,19,13,6
23,6,103,9,17,-8
23,6,104,9,22,-13
23,6,105,3,16,-13
23,6,106,11,25,-14
23,6,107,13,11,2
23,6,108,10,8,2
23,6,109,6,16,-10
23,6,110,9,25,-16
23,6,111,8,25,-17
23,6,112,18,12,6
23,6,113,22,20,2
23,6,114,11,24,-13
23,6,115,11,25,-14
23,6,116,23,15,8
23,6,117,7,37,-30
23,6,118,7,20,-13
23,6,119,4,18,-14
23,6,120,12,27,-15
23,6,121,9,31,-22
23,6,122,2,17,-15
23,6,123,3,7,-4
23,6,124,9,10,-1
23,6,125,12,18,-6
23,6,126,18,15,3
23,6,127,20,21,-1
23,6,128,8,12,-4
23,6,129,13,14,-1
23,6,130,12,12,0
23,6,131,10,12,-2
23,6,132,9,31,-22
23,6,133,15,5,10
23,6,134,17,36,-19
23,6,135,6,20,-14
23,6,136,10,27,-17
23,6,137,12,20,-8
23,6,138,19,32,-13
23,6,139,15,19,-4
23,6,140,7,30,-23
23,6,141,18,34,-16
23,6,142,12,20,-8
23,6,143,15,14,1
23,6,144,11,28,-17
23,6,145,8,15,-7
23,6,146,21,19,2
23,6,147,15,29,-14
23,6,148,14,26,-12
23,6,149,5,33,-28
23,6,150,12,32,-20
23,6,151,5,10,-5
23,6,152,15,27,-12
23,6,153,9,20,-11
23,6,154,15,22,-7
23,6,155,8,22,-14
23,6,156,10,13,-3
23,6,157,13,15,-2
23,6,158,10,12,-2
23,6,159,11,17,-6
23,6,160,7,31,-24
23,6,161,2,14,-12
23,6,162,13,24,-11
23,6,163,8,28,-20
23,6,164,9,31,-22
23,6,165,10,30,-20
23,6,166,15,33,-18
23,6,167,8,24,-16
23,6,168,6,16,-10
23,6,169,13,16,-3
23,6,170,13,13,0
23,6,171,9,32,-23
23,6,172,11,27,-16
23,6,173,4,16,-12
23,6,174,4,18,-14
23,6,175,9,12,-3
23,6,176,12,13,-1
23,6,177,9,9,0
23,6,178,11,16,-5
23,6,179,16,21,-5
23,6,180,17,17,0
23,6,181,11,11,0
23,6,182,6,26,-20
23,6,183,6,19,-13
23,6,184,14,34,-20
23,6,185,12,14,-2
23,6,186,14,24,-10
23,6,187,10,20,-10
23,6,188,22,20,2
23,6,189,7,15,-8
23,6,190,8,13,-5
23,6,191,6,16,-10
23,6,192,15,25,-10
23,6,193,10,22,-12
23,6,194,20,22,-2
23,6,195,16,21,-5
23,6,196,8,29,-21
23,6,197,4,23,-19
23,6,198,7,7,0
23,6,199,14,32,-18
23,6,200,3,9,-6
23,6,201,5,11,-6
23,6,202,22,25,-3
23,6,203,15,23,-8
23,6,204,17,34,-17
23,6,205,17,31,-14
23,6,206,10,16,-6
23,6,207,7,8,-1
23,6,208,9,25,-16
23,6,209,8,22,-14
23,6,210,12,28,-16
23,6,211,17,18,-1
23,6,212,9,24,-15
23,6,213,16,19,-3
23,6,214,12,13,-1
23,6,215,7,23,-16
23,6,216,12,27,-15
23,6,217,6,13,-7
23,6,218,13,21,-8
23,6,219,11,20,-9
23,6,220,11,19,-8
23,6,221,17,23,-6
23,6,222,8,21,-13
23,6,223,10,27,-17
23,6,224,4,17,-13
23,6,225,13,20,-7
23,6,226,5,21,-16
23,6,227,1,19,-18
23,6,228,15,32,-17
23,6,229,12,22,-10
23,6,230,13,27,-14
23,6,231,9,20,-11
23,6,232,13,27,-14
23,6,233,10,18,-8
23,6,234,16,21,-5
23,6,235,4,28,-24
23,6,236,12,30,-18
23,6,237,7,25,-18
23,6,238,19,30,-11
23,6,239,11,13,-2
23,6,240,9,23,-14
23,6,241,13,23,-10
23,6,242,12,27,-15
23,6,243,10,18,-8
23,6,244,7,10,-3
23,6,245,13,40,-27
23,6,246,10,25,-15
23,6,247,10,19,-9
23,6,248,14,24,-10
23,6,249,11,17,-6
23,6,250,11,19,-8
23,6,251,11,18,-7
23,6,252,6,25,-19
23,6,253,8,23,-15
23,6,254,8,27,-19
23,6,255,13,11,2
23,6,256,5,24,-19
23,6,257,8,11,-3
23,6,258,4,10,-6
23,6,259,11,24,-13
23,6,260,6,4,2
23,6,261,8,23,-15
23,6,262,6,9,-3
23,6,263,18,25,-7
23,6,264,10,34,-24
23,6,265,13,30,-17
23,6,266,20,19,1
23,6,267,17,17,0
23,6,268,16,13,3
23,6,269,5,17,-12
23,6,270,15,21,-6
23,6,271,8,19,-11
23,6,272,8,11,-3
23,6,273,11,14,-3
23,6,274,13,16,-3
23,6,275,11,29,-18
23,6,276,6,20,-14
23,6,277,14,19,-5
23,6,278,12,41,-29
23,6,279,18,23,-5
23,6,280,16,15,1
23,6,281,7,10,-3
23,6,282,6,22,-16
23,6,283,6,20,-14
23,6,284,5,10,-5
23,6,285,13,23,-10
23,6,286,9,9,0
23,6,287,11,30,-19
23,6,288,12,17,-5
23,6,289,4,14,-10
23,6,290,17,12,5
23,6,291,8,10,-2
23,6,292,10,14,-4
23,6,293,9,25,-16
23,6,294,5,17,-12
23,6,295,7,19,-12
23,6,296,14,32,-18
23,6,297,10,28,-18
23,6,298,11,16,-5
23,6,299,15,27,-12
23,7,0,24,19,5
23,7,1,13,27,-14
23,7,2,8,16,-8
23,7,3,9,27,-18
23,7,4,9,25,-16
23,7,5,19,12,7
23,7,6,4,44,-40
23,7,7,7,5,2
23,7,8,9,28,-19
23,7,9,5,27,-22
23,7,10,10,18,-8
23,7,11,3,11,-8
23,7,12,10,16,-6
23,7,13,10,25,-15
23,7,14,8,16,-8
23,7,15,10,37,-27
23,7,16,12,13,-1
23,7,17,4,14,-10
23,7,18,7,11,-4
23,7,19,5,9,-4
23,7,20,14,21,-7
23,7,21,15,24,-9
23,7,22,11,18,-7
23,7,23,14,11,3
23,7,24,9,15,-6
23,7,25,10,11,-1
23,7,26,6,13,-7
23,7,27,7,12,-5
23,7,28,12,15,-3
23,7,29,9,16,-7
23,7,30,15,10,5
23,7,31,15,30,-15
23,7,32,3,17,-14
23,7,33,12,22,-10
23,7,34,16,15,1
23,7,35,10,14,-4
23,7,36,4,19,-15
23,7,37,10,12,-2
23,7,38,7,13,-6
23,7,39,17,20,-3
23,7,40,14,21,-7
23,7,41,8,25,-17
23,7,42,10,17,-7
23,7,43,16,17,-1
23,7,44,10,29,-19
23,7,45,8,24,-16
23,7,46,26,11,15
23,7,47,21,16,5
23,7,48,11,20,-9
23,7,49,5,16,-11
23,7,50,10,30,-20
23,7,51,14,25,-11
23,7,52,13,24,-11
23,7,53,18,19,-1
23,7,54,11,7,4
23,7,55,5,15,-10
23,7,56,10,9,1
23,7,57,9,25,-16
23,7,58,13,23,-10
23,7,59,15,20,-5
23,7,60,11,18,-7
23,7,61,9,17,-8
23,7,62,14,21,-7
23,7,63,16,19,-3
23,7,64,10,26,-16
23,7,65,12,13,-1
23,7,66,8,14,-6
23,7,67,12,9,3
23,7,68,14,18,-4
23,7,69,13,20,-7
23,7,70,10,21,-11
23,7,71,14,32,-18
23,7,72,5,22,-17
23,7,73,14,18,-4
23,7,74,11,31,-20
23,7,75,6,7,-1
23,7,76,11,14,-3
23,7,77,7,28,-21
23,7,78,5,16,-11
23,7,79,17,14,3
23,7,80,6,9,-3
23,7,81,10,18,-8
23,7,82,16,23,-7
23,7,83,11,18,-7
23,7,84,19,25,-6
23,7,85,13,18,-5
23,7,86,7,17,-10
23,7,87,16,26,-10
23,7,88,11,22,-11
23,7,89,8,27,-19
23,7,90,9,17,-8
23,7,91,11,12,-1
23,7,92,9,18,-9
23,7,93,10,16,-6
23,7,94,16,17,-1
23,7,95,13,24,-11
23,7,96,5,15,-10
23,7,97,5,12,-7
23,7,98,15,8,7
23,7,99,13,20,-7
23,7,100,15,31,-16
23,7,101,18,6,12
23,7,102,17,24,-7
23,7,103,15,26,-11
23,7,104,10,11,-1
23,7,105,6,15,-9
23,7,106,11,26,-15
23,7,107,5,25,-20
23,7,108,14,24,-10
23,7,109,26,22,4
23,7,110,12,17,-5
23,7,111,9,30,-21
23,7,112,13,26,-13
23,7,113,7,22,-15
23,7,114,8,11,-3
23,7,115,7,18,-11
23,7,116,18,22,-4
23,7,117,13,39,-26
23,7,118,5,23,-18
23,7,119,6,30,-24
23,7,120,5,11,-6
23,7,121,13,18,-5
23,7,122,11,27,-16
23,7,123,13,24,-11
23,7,124,7,37,-30
23,7,125,3,15,-12
23,7,126,5,10,-5
23,7,127,12,15,-3
23,7,128,17,25,-8
23,7,129,10,12,-2
23,7,130,5,18,-13
23,7,131,8,17,-9
23,7,132,7,16,-9
23,7,133,15,11,4
23,7,134,4,12,-8
23,7,135,14,27,-13
23,7,136,6,17,-11
23,7,137,19,33,-14
23,7,138,18,17,1
23,7,139,15,44,-29
23,7,140,7,15,-8
23,7,141,8,35,-27
23,7,142,12,23,-11
23,7,143,16,32,-16
23,7,144,8,17,-9
23,7,145,14,33,-19
23,7,146,14,17,-3
23,7,147,6,22,-16
23,7,148,5,12,-7
23,7,149,10,13,-3
23,7,150,9,17,-8
23,7,151,12,23,-11
23,7,152,9,19,-10
23,7,153,15,13,2
23,7,154,3,21,-18
23,7,155,9,21,-12
23,7,156,10,29,-19
23,7,157,17,21,-4
23,7,158,11,18,-7
23,7,159,13,21,-8
23,7,160,8,12,-4
23,7,161,7,24,-17
23,7,162,6,21,-15
23,7,163,16,14,2
23,7,164,9,15,-6
23,7,165,20,29,-9
23,7,166,17,30,-13
23,7,167,16,26,-10
23,7,168,4,20,-16
23,7,169,14,21,-7
23,7,170,10,21,-11
23,7,171,15,30,-15
23,7,172,26,24,2
23,7,173,21,38,-17
23,7,174,7,17,-10
23,7,175,8,14,-6
23,7,176,14,20,-6
23,7,177,8,14,-6
23,7,178,6,15,-9
23,7,179,11,34,-23
23,7,180,12,27,-15
23,7,181,8,17,-9
23,7,182,7,13,-6
23,7,183,14,28,-14
23,7,184,3,13,-10
23,7,185,8,31,-23
23,7,186,15,31,-16
23,7,187,7,34,-27
23,7,188,5,21,-16
23,7,189,4,13,-9
23,7,190,20,35,-15
23,7,191,17,18,-1
23,7,192,1,14,-13
23,7,193,17,23,-6
23,7,194,14,25,-11
23,7,195,15,17,-2
23,7,196,10,32,-22
23,7,197,13,20,-7
23,7,198,10,14,-4
23,7,199,9,17,-8
23,7,200,11,19,-8
23,7,201,9,13,-4
23,7,202,22,25,-3
23,7,203,16,27,-11
23,7,204,14,28,-14
23,7,205,7,27,-20
23,7,206,0,13,-13
23,7,207,12,22,-10
23,7,208,22,26,-4
23,7,209,6,10,-4
23,7,210,11,26,-15
23,7,211,15,10,5
23,7,212,9,32,-23
23,7,213,23,34,-11
23,7,214,5,32,-27
23,7,215,4,20,-16
23,7,216,12,18,-6
23,7,217,20,19,1
23,7,218,5,11,-6
23,7,219,3,20,-17
23,7,220,5,21,-16
23,7,221,4,30,-26
23,7,222,13,10,3
23,7,223,4,16,-12
23,7,224,7,23,-16
23,7,225,8,12,-4
23,7,226,10,22,-12
23,7,227,15,26,-11
23,7,228,17,23,-6
23,7,229,16,33,-17
23,7,230,14,23,-9
23,7,231,16,35,-19
23,7,232,4,19,-15
23,7,233,8,16,-8
23,7,234,10,11,-1
23,7,235,15,21,-6
23,7,236,9,23,-14
23,7,237,11,13,-2
23,7,238,5,17,-12
23,7,239,10,18,-8
23,7,240,14,24,-10
23,7,241,10,19,-9
23,7,242,14,22,-8
23,7,243,11,22,-11
23,7,244,12,27,-15
23,7,245,12,19,-7
23,7,246,11,24,-13
23,7,247,9,19,-10
23,7,248,8,17,-9
23,7,249,17,25,-8
23,7,250,12,24,-12
23,7,251,4,16,-12
23,7,252,11,11,0
23,7,253,15,27,-12
23,7,254,18,15,3
23,7,255,11,18,-7
23,7,256,27,32,-5
23,7,257,12,27,-15
23,7,258,20,20,0
23,7,259,10,18,-8
23,7,260,4,14,-10
23,7,261,7,10,-3
23,7,262,9,20,-11
23,7,263,13,19,-6
23,7,264,13,16,-3
23,7,265,5,14,-9
23,7,266,9,11,-2
23,7,267,9,17,-8
23,7,268,17,23,-6
23,7,269,13,11,2
23,7,270,14,17,-3
23,7,271,16,6,10
23,7,272,11,17,-6
23,7,273,10,28,-18
23,7,274,8,23,-15
23,7,275,9,23,-14
23,7,276,19,16,3
23,7,277,8,17,-9
23,7,278,10,23,-13
23,7,279,9,8,1
23,7,280,16,26,-10
23,7,281,17,19,-2
23,7,282,17,24,-7
23,7,283,5,15,-10
23,7,284,25,26,-1
23,7,285,9,12,-3
23,7,286,4,13,-9
23,7,287,9,14,-5
23,7,288,8,22,-14
23,7,289,10,19,-9
23,7,290,5,11,-6
23,7,291,10,17,-7
23,7,292,14,14,0
23,7,293,6,8,-2
23,7,294,13,27,-14
23,7,295,10,23,-13
23,7,296,24,22,2
23,7,297,12,19,-7
23,7,298,8,13,-5
23,7,299,3,17,-14
23,8,0,4,19,-15
23,8,1,14,20,-6
23,8,2,14,9,5
23,8,3,16,22,-6
23,8,4,8,10,-2
23,8,5,18,23,-5
23,8,6,5,11,-6
23,8,7,9,16,-7
23,8,8,13,25,-12
23,8,9,5,14,-9
23,8,10,13,19,-6
23,8,11,8,13,-5
23,8,12,4,33,-29
23,8,13,12,26,-14
23,8,14,9,22,-13
23,8,15,13,30,-17
23,8,16,5,24,-19
23,8,17,16,30,-14
23,8,18,12,22,-10
23,8,19,14,17,-3
23,8,20,0,15,-15
23,8,21,11,19,-8
23,8,22,5,20,-15
23,8,23,8,24,-16
23,8,24,5,11,-6
23,8,25,5,21,-16
23,8,26,8,13,-5
23,8,27,11,13,-2
23,8,28,7,27,-20
23,8,29,22,33,-11
23,8,30,3,15,-12
23,8,31,10,16,-6
23,8,32,7,17,-10
23,8,33,9,24,-15
23,8,34,1,21,-20
23,8,35,7,17,-10
23,8,36,23,13,10
23,8,37,3,20,-17
23,8,38,17,24,-7
23,8,39,14,28,-14
23,8,40,13,25,-12
23,8,41,13,15,-2
23,8,42,6,17,-11
23,8,43,7,25,-18
23,8,44,3,11,-8
23,8,45,10,9,1
23,8,46,14,15,-1
23,8,47,24,35,-11
23,8,48,10,19,-9
23,8,49,15,9,6
23,8,50,5,24,-19
23,8,51,15,25,-10
23,8,52,4,8,-4
23,8,53,18,29,-11
23,8,54,15,20,-5
23,8,55,9,20,-11
23,8,56,12,27,-15
23,8,57,6,12,-6
23,8,58,7,5,2
23,8,59,13,34,-21
23,8,60,3,17,-14
23,8,61,9,11,-2
23,8,62,10,25,-15
23,8,63,5,7,-2
23,8,64,17,44,-27
23,8,65,11,15,-4
23,8,66,6,24,-18
23,8,67,9,21,-12
23,8,68,6,10,-4
23,8,69,7,16,-9
23,8,70,13,7,6
23,8,71,10,16,-6
23,8,72,17,24,-7
23,8,73,11,9,2
23,8,74,15,10,5
23,8,75,12,12,0
23,8,76,1,13,-12
23,8,77,10,16,-6
23,8,78,3,29,-26
23,8,79,13,22,-9
23,8,80,8,26,-18
23,8,81,7,36,-29
23,8,82,8,19,-11
23,8,83,15,23,-8
23,8,84,13,39,-26
23,8,85,11,20,-9
23,8,86,6,28,-22
23,8,87,4,13,-9
23,8,88,4,26,-22
23,8,89,11,29,-18
23,8,90,12,12,0
23,8,91,9,21,-12
23,8,92,6,11,-5
23,8,93,12,9,3
23,8,94,6,14,-8
23,8,95,11,22,-11
23,8,96,22,20,2
23,8,97,3,20,-17
23,8,98,12,14,-2
23,8,99,5,11,-6
23,8,100,13,12,1
23,8,101,14,19,-5
23,8,102,8,11,-3
23,8,103,16,22,-6
23,8,104,6,37,-31
23,8,105,17,25,-8
23,8,106,7,14,-7
23,8,107,14,16,-2
23,8,108,10,32,-22
23,8,109,12,14,-2
23,8,110,10,18,-8
23,8,111,8,22,-14
23,8,112,11,15,-4
23,8,113,10,19,-9
23,8,114,11,36,-25
23,8,115,10,19,-9
23,8,116,12,25,-13
23,8,117,16,36,-20
23,8,118,9,19,-10
23,8,119,9,21,-12
23,8,120,8,14,-6
23,8,121,12,16,-4
23,8,122,27,16,11
23,8,123,10,22,-12
23,8,124,8,15,-7
23,8,125,11,18,-7
23,8,126,17,26,-9
23,8,127,25,31,-6
23,8,128,17,26,-9
23,8,129,17,30,-13
23,8,130,18,31,-13
23,8,131,16,27,-11
23,8,132,3,12,-9
23,8,133,9,29,-20
23,8,134,10,22,-12
23,8,135,5,22,-17
23,8,136,12,20,-8
23,8,137,14,12,2
23,8,138,6,18,-12
23,8,139,7,17,-10
23,8,140,17,8,9
23,8,141,14,15,-1
23,8,142,20,16,4
23,8,143,13,31,-18
23,8,144,9,26,-17
23,8,145,12,10,2
23,8,146,9,12,-3
23,8,147,7,19,-12
23,8,148,12,16,-4
23,8,149,10,20,-10
23,8,150,24,16,8
23,8,151,10,18,-8
23,8,152,8,25,-17
23,8,153,5,6,-1
23,8,154,9,16,-7
23,8,155,10,18,-8
23,8,156,8,22,-14
23,8,157,13,14,-1
23,8,158,16,22,-6
23,8,159,9,18,-9
23,8,160,8,32,-24
23,8,161,10,13,-3
23,8,162,17,10,7
23,8,163,9,24,-15
23,8,164,19,33,-14
23,8,165,9,21,-12
23,8,166,15,13,2
23,8,167,14,20,-6
23,8,168,6,16,-10
23,8,169,8,27,-19
23,8,170,14,27,-13
23,8,171,6,22,-16
23,8,172,9,18,-9
23,8,173,11,21,-10
23,8,174,7,17,-10
23,8,175,11,40,-29
23,8,176,7,22,-15
23,8,177,15,25,-10
23,8,178,13,20,-7
23,8,179,11,19,-8
23,8,180,24,32,-8
23,8,181,11,18,-7
23,8,182,12,10,2
23,8,183,7,16,-9
23,8,184,7,17,-10
23,8,185,10,20,-10
23,8,186,14,25,-11
23,8,187,8,23,-15
23,8,188,9,16,-7
23,8,189,16,18,-2
23,8,190,11,18,-7
23,8,191,12,17,-5
23,8,192,8,23,-15
23,8,193,12,9,3
23,8,194,11,17,-6
23,8,195,11,25,-14
23,8,196,12,12,0
23,8,197,5,27,-22
23,8,198,14,19,-5
23,8,199,19,29,-10
23,8,200,6,14,-8
23,8,201,15,31,-16
23,8,202,13,27,-14
23,8,203,12,13,-1
23,8,204,4,6,-2
23,8,205,20,17,3
23,8,206,7,24,-17
23,8,207,3,22,-19
23,8,208,2,13,-11
23,8,209,13,17,-4
23,8,210,10,19,-9
23,8,211,20,18,2
23,8,212,5,22,-17
23,8,213,6,22,-16
23,8,214,7,17,-10
23,8,215,5,23,-18
23,8,216,13,8,5
23,8,217,8,30,-22
23,8,218,1,20,-19
23,8,219,20,16,4
23,8,220,9,11,-2
23,8,221,20,29,-9
23,8,222,17,28,-11
23,8,223,20,20,0
23,8,224,22,30,-8
23,8,225,8,19,-11
23,8,226,21,22,-1
23,8,227,9,17,-8
23,8,228,7,10,-3
23,8,229,6,12,-6
23,8,230,16,17,-1
23,8,231,11,14,-3
23,8,232,12,21,-9
23,8,233,21,23,-2
23,8,234,7,32,-25
23,8,235,30,24,6
23,8,236,10,14,-4
23,8,237,14,14,0
23,8,238,8,18,-10
23,8,239,13,34,-21
23,8,240,10,17,-7
23,8,241,15,27,-12
23,8,242,14,19,-5
23,8,243,10,24,-14
23,8,244,13,37,-24
23,8,245,9,19,-10
23,8,246,3,14,-11
23,8,247,15,23,-8
23,8,248,13,29,-16
23,8,249,5,25,-20
23,8,250,11,30,-19
23,8,251,12,22,-10
23,8,252,10,15,-5
23,8,253,10,36,-26
23,8,254,12,19,-7
23,8,255,2,25,-23
23,8,256,8,8,0
23,8,257,7,18,-11
23,8,258,12,14,-2
23,8,259,20,14,6
23,8,260,10,37,-27
23,8,261,13,35,-22
23,8,262,7,19,-12
23,8,263,22,24,-2
23,8,264,14,13,1
23,8,265,5,17,-12
23,8,266,11,7,4
23,8,267,9,19,-10
23,8,268,16,26,-10
23,8,269,7,39,-32
23,8,270,18,25,-7
23,8,271,10,17,-7
23,8,272,6,14,-8
23,8,273,14,20,-6
23,8,274,13,24,-11
23,8,275,15,13,2
23,8,276,9,21,-12
23,8,277,12,17,-5
23,8,278,8,17,-9
23,8,279,10,15,-5
23,8,280,15,35,-20
23,8,281,7,9,-2
23,8,282,10,23,-13
23,8,283,7,22,-15
23,8,284,4,16,-12
23,8,285,11,24,-13
23,8,286,11,13,-2
23,8,287,8,19,-11
23,8,288,15,13,2
23,8,289,10,23,-13
23,8,290,10,17,-7
23,8,291,13,28,-15
23,8,292,17,17,0
23,8,293,12,25,-13
23,8,294,13,29,-16
23,8,295,18,19,-1
23,8,296,10,7,3
23,8,297,8,26,-18
23,8,298,17,24,-7
23,8,299,8,26,-18
23,9,0,12,24,-12
23,9,1,19,25,-6
23,9,2,7,11,-4
23,9,3,7,12,-5
23,9,4,6,19,-13
23,9,5,11,11,0
23,9,6,13,19,-6
23,9,7,5,21,-16
23,9,8,10,20,-10
23,9,9,19,23,-4
23,9,10,10,29,-19
23,9,11,13,25,-12
23,9,12,18,23,-5
23,9,13,4,10,-6
23,9,14,16,28,-12
23,9,15,3,3,0
23,9,16,11,27,-16
23,9,17,9,22,-13
23,9,18,12,29,-17
23,9,19,15,14,1
23,9,20,10,31,-21
23,9,21,4,19,-15
23,9,22,14,16,-2
23,9,23,11,26,-15
23,9,24,5,13,-8
23,9,25,9,19,-10
23,9,26,16,26,-10
23,9,27,12,29,-17
23,9,28,15,18,-3
23,9,29,14,11,3
23,9,30,13,28,-15
23,9,31,26,39,-13
23,9,32,11,7,4
23,9,33,5,21,-16
23,9,34,23,17,6
23,9,35,13,19,-6
23,9,36,11,21,-10
23,9,37,4,12,-8
23,9,38,8,23,-15
23,9,39,8,11,-3
23,9,40,5,15,-10
23,9,41,8,6,2
23,9,42,6,38,-32
23,9,43,10,14,-4
23,9,44,13,20,-7
23,9,45,12,24,-12
23,9,46,19,36,-17
23,9,47,16,23,-7
23,9,48,15,31,-16
23,9,49,11,21,-10
23,9,50,13,11,2
23,9,51,13,18,-5
23,9,52,16,17,-1
23,9,53,8,25,-17
23,9,54,12,18,-6
23,9,55,8,12,-4
23,9,56,12,17,-5
23,9,57,10,17,-7
23,9,58,4,6,-2
23,9,59,13,35,-22
23,9,60,8,28,-20
23,9,61,19,18,1
23,9,62,17,24,-7
23,9,63,17,21,-4
23,9,64,11,27,-16
23,9,65,10,17,-7
23,9,66,13,18,-5
23,9,67,13,32,-19
23,9,68,10,16,-6
23,9,69,11,37,-26
23,9,70,6,10,-4
23,9,71,8,11,-3
23,9,72,4,17,-13
23,9,73,14,32,-18
23,9,74,13,25,-12
23,9,75,10,21,-11
23,9,76,14,13,1
23,9,77,16,30,-14
23,9,78,18,18,0
23,9,79,25,23,2
23,9,80,10,21,-11
23,9,81,19,21,-2
23,9,82,3,21,-18
23,9,83,13,21,-8
23,9,84,13,17,-4
23,9,85,12,33,-21
23,9,86,15,27,-12
23,9,87,14,17,-3
23,9,88,8,24,-16
23,9,89,20,35,-15
23,9,90,5,7,-2
23,9,91,14,25,-11
23,9,92,10,23,-13
23,9,93,21,9,12
23,9,94,11,23,-12
23,9,95,14,14,0
23,9,96,3,26,-23
23,9,97,8,27,-19
23,9,98,8,21,-13
23,9,99,17,28,-11
23,9,100,13,11,2
23,9,101,11,8,3
23,9,102,11,18,-7
23,9,103,8,20,-12
23,9,104,9,22,-13
23,9,105,10,19,-9
23,9,106,17,31,-14
23,9,107,14,18,-4
23,9,108,13,12,1
23,9,109,5,3,2
23,9,110,10,4,6
23,9,111,17,20,-3
23,9,112,13,8,5
23,9,113,19,15,4
23,9,114,5,16,-11
23,9,115,7,16,-9
23,9,116,15,10,5
23,9,117,11,32,-21
23,9,118,18,14,4
23,9,119,11,12,-1
23,9,120,15,19,-4
23,9,121,4,25,-21
23,9,122,4,10,-6
23,9,123,3,28,-25
23,9,124,2,9,-7
23,9,125,30,41,-11
23,9,126,10,15,-5
23,9,127,7,16,-9
23,9,128,11,23,-12
23,9,129,7,13,-6
23,9,130,19,22,-3
23,9,131,7,17,-10
23,9,132,14,12,2
23,9,133,17,16,1
23,9,134,12,29,-17
23,9,135,12,20,-8
23,9,136,5,21,-16
23,9,137,9,15,-6
23,9,138,7,13,-6
23,9,139,22,26,-4
23,9,140,15,28,-13
23,9,141,10,24,-14
23,9,142,13,20,-7
23,9,143,6,9,-3
23,9,144,13,30,-17
23,9,145,9,11,-2
23,9,146,18,41,-23
23,9,147,15,22,-7
23,9,148,13,24,-11
23,9,149,15,20,-5
23,9,150,19,43,-24
23,9,151,10,26,-16
23,9,152,4,6,-2
23,9,153,19,20,-1
23,9,154,17,32,-15
23,9,155,16,33,-17
23,9,156,9,27,-18
23,9,157,9,19,-10
23,9,158,15,11,4
23,9,159,12,35,-23
23,9,160,3,21,-18
23,9,161,6,23,-17
23,9,162,16,24,-8
23,9,163,8,25,-17
23,9,164,11,21,-10
23,9,165,11,24,-13
23,9,166,7,21,-14
23,9,167,19,19,0
23,9,168,8,18,-10
23,9,169,8,22,-14
23,9,170,21,21,0
23,9,171,12,20,-8
23,9,172,8,20,-12
23,9,173,7,34,-27
23,9,174,4,23,-19
23,9,175,15,20,-5
23,9,176,12,25,-13
23,9,177,13,35,-22
23,9,178,13,14,-1
23,9,179,2,23,-21
23,9,180,14,5,9
23,9,181,7,35,-28
23,9,182,8,10,-2
23,9,183,18,16,2
23,9,184,19,27,-8
23,9,185,7,27,-20
23,9,186,12,22,-10
23,9,187,16,19,-3
23,9,188,18,14,4
23,9,189,3,11,-8
23,9,190,12,15,-3
23,9,191,10,10,0
23,9,192,10,25,-15
23,9,193,21,19,2
23,9,194,12,29,-17
23,9,195,13,13,0
23,9,196,24,21,3
23,9,197,5,9,-4
23,9,198,12,11,1
23,9,199,13,24,-11
23,9,200,16,34,-18
23,9,201,14,19,-5
23,9,202,16,15,1
23,9,203,7,11,-4
23,9,204,17,20,-3
23,9,205,13,28,-15
23,9,206,13,4,9
23,9,207,18,16,2
23,9,208,18,19,-1
23,9,209,7,23,-16
23,9,210,7,15,-8
23,9,211,9,16,-7
23,9,212,23,23,0
23,9,213,9,23,-14
23,9,214,8,29,-21
23,9,215,7,25,-18
23,9,216,13,17,-4
23,9,217,10,13,-3
23,9,218,7,17,-10
23,9,219,4,15,-11
23,9,220,28,25,3
23,9,221,15,24,-9
23,9,222,13,21,-8
23,9,223,12,20,-8
23,9,224,14,21,-7
23,9,225,12,30,-18
23,9,226,5,27,-22
23,9,227,13,19,-6
23,9,228,9,26,-17
23,9,229,4,10,-6
23,9,230,14,22,-8
23,9,231,12,22,-10
23,9,232,14,20,-6
23,9,233,9,15,-6
23,9,234,9,26,-17
23,9,235,12,21,-9
23,9,236,21,24,-3
23,9,237,13,16,-3
23,9,238,9,17,-8
23,9,239,9,11,-2
23,9,240,10,30,-20
23,9,241,5,30,-25
23,9,242,7,23,-16
23,9,243,9,12,-3
23,9,244,8,20,-12
23,9,245,12,10,2
23,9,246,6,28,-22
23,9,247,7,6,1
23,9,248,21,23,-2
23,9,249,9,28,-19
23,9,250,10,26,-16
23,9,251,15,21,-6
23,9,252,13,17,-4
23,9,253,21,39,-18
23,9,254,8,20,-12
23,9,255,7,19,-12
23,9,256,17,20,-3
23,9,257,12,16,-4
23,9,258,17,18,-1
23,9,259,11,22,-11
23,9,260,7,29,-22
23,9,261,9,14,-5
23,9,262,7,21,-14
23,9,263,7,19,-12
23,9,264,12,20,-8
23,9,265,15,36,-21
23,9,266,10,20,-10
23,9,267,8,12,-4
23,9,268,1,3,-2
23,9,269,2,11,-9
23,9,270,20,24,-4
23,9,271,10,14,-4
23,9,272,14,27,-13
23,9,273,10,14,-4
23,9,274,18,21,-3
23,9,275,7,19,-12
23,9,276,9,25,-16
23,9,277,11,14,-3
23,9,278,15,21,-6
23,9,279,2,16,-14
23,9,280,11,12,-1
23,9,281,15,22,-7
23,9,282,15,32,-17
23,9,283,12,25,-13
23,9,284,8,20,-12
23,9,285,12,19,-7
23,9,286,13,30,-17
23,9,287,6,11,-5
23,9,288,15,14,1
23,9,289,13,18,-5
23,9,290,10,17,-7
23,9,291,19,16,3
23,9,292,9,10,-1
23,9,293,11,20,-9
23,9,294,12,24,-12
23,9,295,16,23,-7
23,9,296,25,34,-9
23,9,297,8,14,-6
23,9,298,9,22,-13
23,9,299,4,8,-4
23,10,0,10,16,-6
23,10,1,27,34,-7
23,10,2,6,21,-15
23,10,3,6,12,-6
23,10,4,7,30,-23
23,10,5,10,32,-22
23,10,6,5,23,-18
23,10,7,9,14,-5
23,10,8,13,12,1
23,10,9,12,12,0
23,10,10,10,16,-6
23,10,11,7,20,-13
23,10,12,5,12,-7
23,10,13,12,16,-4
23,10,14,16,28,-12
23,10,15,20,18,2
23,10,16,18,31,-13
23,10,17,7,17,-10
23,10,18,9,37,-28
23,10,19,6,19,-13
23,10,20,28,11,17
23,10,21,3,7,-4
23,10,22,19,18,1
23,10,23,11,38,-27
23,10,24,10,20,-10
23,10,25,10,29,-19
23,10,26,13,25,-12
23,10,27,17,26,-9
23,10,28,13,16,-3
23,10,29,12,22,-10
23,10,30,7,15,-8
23,10,31,16,24,-8
23,10,32,9,24,-15
23,10,33,9,16,-7
23,10,34,3,10,-7
23,10,35,8,21,-13
23,10,36,7,16,-9
23,10,37,20,24,-4
23,10,38,9,28,-19
23,10,39,8,12,-4
23,10,40,17,19,-2
23,10,41,14,17,-3
23,10,42,12,26,-14
23,10,43,16,11,5
23,10,44,4,20,-16
23,10,45,13,25,-12
23,10,46,12,11,1
23,10,47,9,26,-17
23,10,48,5,15,-10
23,10,49,3,13,-10
23,10,50,15,10,5
23,10,51,13,25,-12
23,10,52,20,16,4
23,10,53,7,15,-8
23,10,54,21,28,-7
23,10,55,9,34,-25
23,10,56,9,27,-18
23,10,57,16,10,6
23,10,58,13,16,-3
23,10,59,9,20,-11
23,10,60,9,19,-10
23,10,61,16,31,-15
23,10,62,18,21,-3
23,10,63,21,21,0
23,10,64,16,10,6
23,10,65,11,10,1
23,10,66,9,16,-7
23,10,67,4,16,-12
23,10,68,12,16,-4
23,10,69,22,28,-6
23,10,70,15,17,-2
23,10,71,14,15,-1
23,10,72,23,18,5
23,10,73,9,20,-11
23,10,74,12,15,-3
23,10,75,11,7,4
23,10,76,2,12,-10
23,10,77,11,20,-9
23,10,78,6,20,-14
23,10,79,8,27,-19
23,10,80,12,23,-11
23,10,81,11,9,2
23,10,82,9,11,-2
23,10,83,10,23,-13
23,10,84,11,14,-3
23,10,85,15,22,-7
23,10,86,12,21,-9
23,10,87,10,10,0
23,10,88,18,27,-9
23,10,89,13,29,-16
23,10,90,15,17,-2
23,10,91,13,5,8
23,10,92,10,24,-14
23,10,93,20,25,-5
23,10,94,24,39,-15
23,10,95,20,11,9
23,10,96,17,18,-1
23,10,97,5,22,-17
23,10,98,1,14,-13
23,10,99,8,10,-2
23,10,100,17,18,-1
23,10,101,28,17,11
23,10,102,16,23,-7
23,10,103,12,21,-9
23,10,104,14,23,-9
23,10,105,24,19,5
23,10,106,13,12,1
23,10,107,16,19,-3
23,10,108,11,13,-2
23,10,109,16,22,-6
23,10,110,7,29,-22
23,10,111,8,19,-11
23,10,112,28,34,-6
23,10,113,7,37,-30
23,10,114,9,41,-32
23,10,115,10,35,-25
23,10,116,1,24,-23
23,10,117,10,12,-2
23,10,118,11,19,-8
23,10,119,8,10,-2
23,10,120,20,21,-1
23,10,121,9,24,-15
23,10,122,13,10,3
23,10,123,27,27,0
23,10,124,19,26,-7
23,10,125,14,25,-11
23,10,126,8,24,-16
23,10,127,22,28,-6
23,10,128,9,17,-8
23,10,129,23,32,-9
23,10,130,21,28,-7
23,10,131,10,15,-5
23,10,132,13,23,-10
23,10,133,11,17,-6
23,10,134,9,11,-2
23,10,135,10,19,-9
23,10,136,12,19,-7
23,10,137,3,22,-19
23,10,138,5,20,-15
23,10,139,14,20,-6
23,10,140,12,14,-2
23,10,141,13,17,-4
23,10,142,8,24,-16
23,10,143,9,18,-9
23,10,144,13,19,-6
23,10,145,9,8,1
23,10,146,8,25,-17
23,10,147,4,27,-23
23,10,148,15,21,-6
23,10,149,7,13,-6
23,10,150,8,18,-10
23,10,151,13,23,-10
23,10,152,5,11,-6
23,10,153,13,18,-5
23,10,154,15,23,-8
23,10,155,12,7,5
23,10,156,4,17,-13
23,10,157,10,19,-9
23,10,158,16,15,1
23,10,159,11,18,-7
23,10,160,10,34,-24
23,10,161,22,24,-2
23,10,162,8,28,-20
23,10,163,17,19,-2
23,10,164,5,20,-15
23,10,165,11,37,-26
23,10,166,8,12,-4
23,10,167,2,24,-22
23,10,168,15,13,2
23,10,169,6,32,-26
23,10,170,13,20,-7
23,10,171,13,7,6
23,10,172,5,28,-23
23,10,173,16,20,-4
23,10,174,20,36,-16
23,10,175,15,20,-5
23,10,176,11,26,-15
23,10,177,34,33,1
23,10,178,13,22,-9
23,10,179,16,18,-2
23,10,180,22,44,-22
23,10,181,17,21,-4
23,10,182,7,10,-3
23,10,183,16,11,5
23,10,184,8,19,-11
23,10,185,7,21,-14
23,10,186,15,20,-5
23,10,187,14,13,1
23,10,188,14,35,-21
23,10,189,28,22,6
23,10,190,7,15,-8
23,10,191,12,18,-6
23,10,192,11,24,-13
23,10,193,10,27,-17
23,10,194,1,19,-18
23,10,195,15,17,-2
23,10,196,15,20,-5
23,10,197,9,16,-7
23,10,198,14,31,-17
23,10,199,19,30,-11
23,10,200,9,10,-1
23,10,201,22,24,-2
23,10,202,13,20,-7
23,10,203,13,6,7
23,10,204,16,20,-4
23,10,205,8,13,-5
23,10,206,5,17,-12
23,10,207,18,31,-13
23,10,208,17,37,-20
23,10,209,20,15,5
23,10,210,12,14,-2
23,10,211,5,22,-17
23,10,212,24,9,15
23,10,213,12,21,-9
23,10,214,13,32,-19
23,10,215,6,6,0
23,10,216,9,24,-15
23,10,217,9,9,0
23,10,218,23,19,4
23,10,219,19,29,-10
23,10,220,15,21,-6
23,10,221,5,14,-9
23,10,222,13,16,-3
23,10,223,10,16,-6
23,10,224,11,22,-11
23,10,225,5,21,-16
23,10,226,15,15,0
23,10,227,13,27,-14
23,10,228,16,23,-7
23,10,229,11,9,2
23,10,230,14,25,-11
23,10,231,8,16,-8
23,10,232,21,15,6
23,10,233,21,28,-7
23,10,234,10,16,-6
23,10,235,14,18,-4
23,10,236,13,21,-8
23,10,237,9,15,-6
23,10,238,14,24,-10
23,10,239,6,24,-18
23,10,240,10,19,-9
23,10,241,13,37,-24
23,10,242,19,21,-2
23,10,243,17,21,-4
23,10,244,11,23,-12
23,10,245,7,20,-13
23,10,246,6,13,-7
23,10,247,7,22,-15
23,10,248,17,21,-4
23,10,249,18,25,-7
23,10,250,11,25,-14
23,10,251,11,16,-5
23,10,252,5,19,-14
23,10,253,11,27,-16
23,10,254,5,13,-8
23,10,255,7,21,-14
23,10,256,18,28,-10
23,10,257,2,14,-12
23,10,258,9,25,-16
23,10,259,23,11,12
23,10,260,7,18,-11
23,10,261,10,41,-31
23,10,262,20,36,-16
23,10,263,7,15,-8
23,10,264,18,15,3
23,10,265,12,16,-4
23,10,266,2,9,-7
23,10,267,8,23,-15
23,10,268,12,17,-5
23,10,269,11,21,-10
23,10,270,7,13,-6
23,10,271,15,15,0
23,10,272,4,23,-19
23,10,273,19,24,-5
23,10,274,14,25,-11
23,10,275,6,9,-3
23,10,276,9,23,-14
23,10,277,4,22,-18
23,10,278,8,21,-13
23,10,279,9,25,-16
23,10,280,27,16,11
23,10,281,7,8,-1
23,10,282,3,13,-10
23,10,283,7,15,-8
23,10,284,9,26,-17
23,10,285,7,21,-14
23,10,286,14,19,-5
23,10,287,8,20,-12
23,10,288,7,14,-7
23,10,289,24,17,7
23,10,290,13,22,-9
23,10,291,10,14,-4
23,10,292,9,23,-14
23,10,293,11,15,-4
23,10,294,8,10,-2
23,10,295,14,20,-6
23,10,296,9,10,-1
23,10,297,17,24,-7
23,10,298,26,15,11
23,10,299,9,13,-4
23,11,0,13,17,-4
23,11,1,10,7,3
23,11,2,14,8,6
23,11,3,12,18,-6
23,11,4,8,19,-11
23,11,5,11,21,-10
23,11,6,8,10,-2
23,11,7,16,27,-11
23,11,8,13,21,-8
23,11,9,7,20,-13
23,11,10,17,11,6
23,11,11,10,21,-11
23,11,12,14,22,-8
23,11,13,8,14,-6
23,11,14,20,19,1
23,11,15,12,18,-6
23,11,16,8,26,-18
23,11,17,11,28,-17
23,11,18,8,10,-2
23,11,19,14,23,-9
23,11,20,3,17,-14
23,11,21,10,20,-10
23,11,22,8,22,-14
23,11,23,12,18,-6
23,11,24,14,12,2
23,11,25,13,11,2
23,11,26,8,20,-12
23,11,27,8,26,-18
23,11,28,5,13,-8
23,11,29,3,16,-13
23,11,30,5,22,-17
23,11,31,8,20,-12
23,11,32,10,19,-9
23,11,33,12,12,0
23,11,34,16,18,-2
23,11,35,10,13,-3
23,11,36,19,24,-5
23,11,37,12,16,-4
23,11,38,11,18,-7
23,11,39,15,19,-4
23,11,40,7,20,-13
23,11,41,15,22,-7
23,11,42,13,13,0
23,11,43,9,21,-12
23,11,44,2,12,-10
23,11,45,7,8,-1
23,11,46,15,20,-5
23,11,47,4,9,-5
23,11,48,8,8,0
23,11,49,10,12,-2
23,11,50,5,17,-12
23,11,51,12,16,-4
23,11,52,15,28,-13
23,11,53,17,25,-8
23,11,54,14,11,3
23,11,55,20,15,5
23,11,56,11,31,-20
23,11,57,8,5,3
23,11,58,7,15,-8
23,11,59,12,23,-11
23,11,60,12,18,-6
23,11,61,5,17,-12
23,11,62,15,18,-3
23,11,63,10,23,-13
23,11,64,13,14,-1
23,11,65,25,17,8
23,11,66,10,18,-8
23,11,67,18,24,-6
23,11,68,4,10,-6
23,11,69,16,10,6
23,11,70,19,13,6
23,11,71,6,14,-8
23,11,72,19,22,-3
23,11,73,14,23,-9
23,11,74,10,23,-13
23,11,75,9,33,-24
23,11,76,7,22,-15
23,11,77,12,20,-8
23,11,78,10,28,-18
23,11,79,10,15,-5
23,11,80,9,14,-5
23,11,81,15,24,-9
23,11,82,13,28,-15
23,11,83,9,20,-11
23,11,84,11,12,-1
23,11,85,24,24,0
23,11,86,12,12,0
23,11,87,14,16,-2
23,11,88,10,18,-8
23,11,89,16,16,0
23,11,90,15,40,-25
23,11,91,6,21,-15
23,11,92,11,24,-13
23,11,93,14,25,-11
23,11,94,8,9,-1
23,11,95,19,17,2
23,11,96,15,22,-7
23,11,97,18,19,-1
23,11,98,9,21,-12
23,11,99,15,21,-6
23,11,100,6,13,-7
23,11,101,10,24,-14
23,11,102,12,13,-1
23,11,103,6,5,1
23,11,104,11,5,6
23,11,105,12,15,-3
23,11,106,14,18,-4
23,11,107,8,12,-4
23,11,108,14,27,-13
23,11,109,6,5,1
23,11,110,17,21,-4
23,11,111,19,32,-13
23,11,112,11,21,-10
23,11,113,6,20,-14
23,11,114,17,26,-9
23,11,115,12,13,-1
23,11,116,8,20,-12
23,11,117,21,20,1
23,11,118,15,15,0
23,11,119,13,12,1
23,11,120,18,22,-4
23,11,121,11,22,-11
23,11,122,6,3,3
23,11,123,18,21,-3
23,11,124,5,11,-6
23,11,125,20,28,-8
23,11,126,13,14,-1
23,11,127,15,30,-15
23,11,128,5,16,-11
23,11,129,8,18,-10
23,11,130,8,12,-4
23,11,131,10,21,-11
23,11,132,10,16,-6
23,11,133,6,15,-9
23,11,134,18,24,-6
23,11,135,11,19,-8
23,11,136,7,27,-20
23,11,137,14,18,-4
23,11,138,26,25,1
23,11,139,11,17,-6
23,11,140,18,15,3
23,11,141,11,23,-12
23,11,142,13,34,-21
23,11,143,20,22,-2
23,11,144,7,13,-6
23,11,145,15,9,6
23,11,146,20,21,-1
23,11,147,7,15,-8
23,11,148,15,12,3
23,11,149,14,19,-5
23,11,150,7,10,-3
23,11,151,13,23,-10
23,11,152,8,26,-18
23,11,153,14,28,-14
23,11,154,20,26,-6
23,11,155,14,19,-5
23,11,156,6,18,-12
23,11,157,15,16,-1
23,11,158,6,19,-13
23,11,159,18,23,-5
23,11,160,13,13,0
23,11,161,17,16,1
23,11,162,7,13,-6
23,11,163,6,12,-6
23,11,164,12,20,-8
23,11,165,14,29,-15
23,11,166,12,25,-13
23,11,167,22,41,-19
23,11,168,18,28,-10
23,11,169,15,23,-8
23,11,170,9,13,-4
23,11,171,18,24,-6
23,11,172,15,9,6
23,11,173,11,17,-6
23,11,174,11,12,-1
23,11,175,15,14,1
23,11,176,10,12,-2
23,11,177,8,10,-2
23,11,178,23,16,7
23,11,179,9,9,0
23,11,180,13,29,-16
23,11,181,11,21,-10
23,11,182,11,23,-12
23,11,183,8,16,-8
23,11,184,14,14,0
23,11,185,28,30,-2
23,11,186,11,21,-10
23,11,187,10,16,-6
23,11,188,20,18,2
23,11,189,10,13,-3
23,11,190,15,16,-1
23,11,191,9,8,1
23,11,192,4,17,-13
23,11,193,29,24,5
23,11,194,4,21,-17
23,11,195,2,17,-15
23,11,196,12,14,-2
23,11,197,8,13,-5
23,11,198,13,8,5
23,11,199,17,28,-11
23,11,200,10,11,-1
23,11,201,9,11,-2
23,11,202,20,16,4
23,11,203,14,26,-12
23,11,204,12,14,-2
23,11,205,10,17,-7
23,11,206,26,14,12
23,11,207,17,24,-7
23,11,208,12,23,-11
23,11,209,9,14,-5
23,11,210,11,36,-25
23,11,211,13,28,-15
23,11,212,8,16,-8
23,11,213,15,9,6
23,11,214,9,14,-5
23,11,215,6,13,-7
23,11,216,7,14,-7
23,11,217,17,19,-2
23,11,218,15,19,-4
23,11,219,9,33,-24
23,11,220,13,29,-16
23,11,221,13,20,-7
23,11,222,6,16,-10
23,11,223,10,14,-4
23,11,224,19,18,1
23,11,225,21,15,6
23,11,226,11,16,-5
23,11,227,6,16,-10
23,11,228,14,23,-9
23,11,229,15,8,7
23,11,230,8,15,-7
23,11,231,9,32,-23
23,11,232,10,21,-11
23,11,233,1,11,-10
23,11,234,15,18,-3
23,11,235,10,11,-1
23,11,236,17,14,3
23,11,237,12,22,-10
23,11,238,10,23,-13
23,11,239,13,23,-10
23,11,240,20,21,-1
23,11,241,22,28,-6
23,11,242,24,18,6
23,11,243,12,10,2
23,11,244,7,14,-7
23,11,245,20,15,5
23,11,246,26,22,4
23,11,247,8,33,-25
23,11,248,16,17,-1
23,11,249,13,25,-12
23,11,250,9,11,-2
23,11,251,16,21,-5
23,11,252,14,14,0
23,11,253,18,20,-2
23,11,254,5,9,-4
23,11,255,12,26,-14
23,11,256,8,17,-9
23,11,257,14,29,-15
23,11,258,12,31,-19
23,11,259,6,5,1
23,11,260,5,17,-12
23,11,261,19,31,-12
23,11,262,20,14,6
23,11,263,13,37,-24
23,11,264,13,8,5
23,11,265,11,5,6
23,11,266,9,15,-6
23,11,267,11,19,-8
23,11,268,14,20,-6
23,11,269,22,11,11
23,11,270,12,19,-7
23,11,271,14,26,-12
23,11,272,12,25,-13
23,11,273,24,26,-2
23,11,274,15,21,-6
23,11,275,14,28,-14
23,11,276,16,25,-9
23,11,277,20,18,2
23,11,278,15,17,-2
23,11,279,8,27,-19
23,11,280,17,27,-10
23,11,281,14,32,-18
23,11,282,9,17,-8
23,11,283,16,26,-10
23,11,284,11,15,-4
23,11,285,17,15,2
23,11,286,14,30,-16
23,11,287,17,14,3
23,11,288,10,10,0
23,11,289,7,10,-3
23,11,290,17,14,3
23,11,291,17,16,1
23,11,292,17,21,-4
23,11,293,8,12,-4
23,11,294,18,9,9
23,11,295,12,13,-1
23,11,296,12,21,-9
23,11,297,6,15,-9
23,11,298,13,23,-10
23,11,299,19,32,-13
23,12,0,6,14,-8
23,12,1,12,28,-16
23,12,2,24,26,-2
23,12,3,12,11,1
23,12,4,8,17,-9
23,12,5,15,23,-8
23,12,6,13,13,0
23,12,7,21,11,10
23,12,8,9,11,-2
23,12,9,17,23,-6
23,12,10,16,16,0
23,12,11,3,12,-9
23,12,12,18,23,-5
23,12,13,13,22,-9
23,12,14,12,19,-7
23,12,15,21,11,10
23,12,16,14,28,-14
23,12,17,9,22,-13
23,12,18,6,17,-11
23,12,19,10,17,-7
23,12,20,2,15,-13
23,12,21,14,17,-3
23,12,22,14,10,4
23,12,23,9,15,-6
23,12,24,18,16,2
23,12,25,6,25,-19
23,12,26,14,34,-20
23,12,27,7,9,-2
23,12,28,21,16,5
23,12,29,16,26,-10
23,12,30,8,10,-2
23,12,31,14,10,4
23,12,32,11,22,-11
23,12,33,16,23,-7
23,12,34,15,14,1
23,12,35,12,21,-9
23,12,36,21,15,6
23,12,37,13,14,-1
23,12,38,12,9,3
23,12,39,16,21,-5
23,12,40,10,10,0
23,12,41,7,6,1
23,12,42,10,15,-5
23,12,43,2,6,-4
23,12,44,10,22,-12
23,12,45,10,16,-6
23,12,46,13,15,-2
23,12,47,6,11,-5
23,12,48,23,23,0
23,12,49,9,20,-11
23,12,50,6,21,-15
23,12,51,15,16,-1
23,12,52,10,25,-15
23,12,53,19,11,8
23,12,54,16,17,-1
23,12,55,11,19,-8
23,12,56,9,17,-8
23,12,57,8,19,-11
23,12,58,17,36,-19
23,12,59,15,28,-13
23,12,60,13,17,-4
23,12,61,13,14,-1
23,12,62,6,13,-7
23,12,63,7,12,-5
23,12,64,14,19,-5
23,12,65,10,15,-5
23,12,66,15,20,-5
23,12,67,17,27,-10
23,12,68,19,22,-3
23,12,69,7,13,-6
23,12,70,23,19,4
23,12,71,9,10,-1
23,12,72,11,21,-10
23,12,73,9,20,-11
23,12,74,8,15,-7
23,12,75,22,24,-2
23,12,76,17,35,-18
23,12,77,11,31,-20
23,12,78,8,27,-19
23,12,79,14,34,-20
23,12,80,14,16,-2
23,12,81,9,22,-13
23,12,82,12,25,-13
23,12,83,13,16,-3
23,12,84,9,10,-1
23,12,85,24,22,2
23,12,86,2,12,-10
23,12,87,20,36,-16
23,12,88,24,28,-4
23,12,89,14,14,0
23,12,90,13,21,-8
23,12,91,15,25,-10
23,12,92,17,7,10
23,12,93,13,30,-17
23,12,94,9,26,-17
23,12,95,13,17,-4
23,12,96,7,16,-9
23,12,97,23,26,-3
23,12,98,9,26,-17
23,12,99,9,18,-9
23,12,100,9,16,-7
23,12,101,12,17,-5
23,12,102,14,10,4
23,12,103,16,12,4
23,12,104,21,23,-2
23,12,105,18,22,-4
23,12,106,10,16,-6
23,12,107,13,4,9
23,12,108,21,15,6
23,12,109,13,12,1
23,12,110,19,18,1
23,12,111,10,18,-8
23,12,112,8,12,-4
23,12,113,24,29,-5
23,12,114,7,16,-9
23,12,115,9,7,2
23,12,116,16,25,-9
23,12,117,21,43,-22
23,12,118,11,21,-10
23,12,119,14,20,-6
23,12,120,4,9,-5
23,12,121,7,21,-14
23,12,122,12,19,-7
23,12,123,12,27,-15
23,12,124,16,24,-8
23,12,125,13,18,-5
23,12,126,11,20,-9
23,12,127,16,20,-4
23,12,128,8,18,-10
23,12,129,20,17,3
23,12,130,21,31,-10
23,12,131,7,5,2
23,12,132,16,12,4
23,12,133,8,24,-16
23,12,134,6,5,1
23,12,135,9,14,-5
23,12,136,11,6,5
23,12,137,13,24,-11
23,12,138,17,31,-14
23,12,139,15,29,-14
23,12,140,4,15,-11
23,12,141,15,20,-5
23,12,142,18,18,0
23,12,143,8,28,-20
23,12,144,5,10,-5
23,12,145,19,31,-12
23,12,146,10,18,-8
23,12,147,12,22,-10
23,12,148,6,18,-12
23,12,149,14,22,-8
23,12,150,8,11,-3
23,12,151,16,19,-3
23,12,152,11,14,-3
23,12,153,9,32,-23
23,12,154,11,25,-14
23,12,155,5,20,-15
23,12,156,15,15,0
23,12,157,12,21,-9
23,12,158,5,14,-9
23,12,159,14,17,-3
23,12,160,10,23,-13
23,12,161,16,17,-1
23,12,162,8,17,-9
23,12,163,11,14,-3
23,12,164,13,10,3
23,12,165,14,24,-10
23,12,166,4,26,-22
23,12,167,8,13,-5
23,12,168,12,20,-8
23,12,169,14,24,-10
23,12,170,8,13,-5
23,12,171,9,20,-11
23,12,172,10,19,-9
23,12,173,16,12,4
23,12,174,25,28,-3
23,12,175,8,25,-17
23,12,176,11,16,-5
23,12,177,18,17,1
23,12,178,15,31,-16
23,12,179,19,24,-5
23,12,180,14,24,-10
23,12,181,19,24,-5
23,12,182,10,12,-2
23,12,183,13,27,-14
23,12,184,7,15,-8
23,12,185,13,18,-5
23,12,186,15,29,-14
23,12,187,13,16,-3
23,12,188,7,8,-1
23,12,189,9,15,-6
23,12,190,16,14,2
23,12,191,13,14,-1
23,12,192,9,14,-5
23,12,193,5,9,-4
23,12,194,9,19,-10
23,12,195,5,25,-20
23,12,196,12,16,-4
23,12,197,12,20,-8
23,12,198,13,18,-5
23,12,199,7,11,-4
23,12,200,14,28,-14
23,12,201,14,13,1
23,12,202,17,22,-5
23,12,203,8,27,-19
23,12,204,12,31,-19
23,12,205,2,3,-1
23,12,206,12,17,-5
23,12,207,16,27,-11
23,12,208,10,5,5
23,12,209,8,10,-2
23,12,210,13,20,-7
23,12,211,9,6,3
23,12,212,8,15,-7
23,12,213,12,9,3
23,12,214,26,22,4
23,12,215,11,18,-7
23,12,216,18,16,2
23,12,217,14,23,-9
23,12,218,10,18,-8
23,12,219,5,12,-7
23,12,220,10,17,-7
23,12,221,6,28,-22
23,12,222,21,15,6
23,12,223,13,24,-11
23,12,224,15,19,-4
23,12,225,11,16,-5
23,12,226,13,25,-12
23,12,227,5,8,-3
23,12,228,8,22,-14
23,12,229,4,13,-9
23,12,230,15,24,-9
23,12,231,12,16,-4
23,12,232,8,35,-27
23,12,233,8,22,-14
23,12,234,11,28,-17
23,12,235,7,28,-21
23,12,236,15,16,-1
23,12,237,15,21,-6
23,12,238,8,20,-12
23,12,239,17,27,-10
23,12,240,9,23,-14
23,12,241,15,13,2
23,12,242,6,10,-4
23,12,243,13,21,-8
23,12,244,9,12,-3
23,12,245,21,26,-5
23,12,246,8,21,-13
23,12,247,10,16,-6
23,12,248,9,20,-11
23,12,249,14,14,0
23,12,250,8,23,-15
23,12,251,6,19,-13
23,12,252,20,23,-3
23,12,253,3,7,-4
23,12,254,10,24,-14
23,12,255,16,24,-8
23,12,256,25,21,4
23,12,257,34,22,12
23,12,258,9,18,-9
23,12,259,13,31,-18
23,12,260,10,14,-4
23,12,261,15,14,1
23,12,262,8,16,-8
23,12,263,16,23,-7
23,12,264,11,24,-13
23,12,265,18,19,-1
23,12,266,7,8,-1
23,12,267,11,11,0
23,12,268,16,27,-11
23,12,269,9,13,-4
23,12,270,17,22,-5
23,12,271,19,17,2
23,12,272,5,7,-2
23,12,273,1,7,-6
23,12,274,15,29,-14
23,12,275,13,28,-15
23,12,276,15,20,-5
23,12,277,12,25,-13
23,12,278,6,21,-15
23,12,279,10,11,-1
23,12,280,18,28,-10
23,12,281,9,14,-5
23,12,282,12,19,-7
23,12,283,5,12,-7
23,12,284,9,14,-5
23,12,285,11,22,-11
23,12,286,11,40,-29
23,12,287,17,14,3
23,12,288,19,10,9
23,12,289,6,14,-8
23,12,290,18,20,-2
23,12,291,12,20,-8
23,12,292,5,12,-7
23,12,293,16,24,-8
23,12,294,5,17,-12
23,12,295,10,16,-6
23,12,296,12,31,-19
23,12,297,23,19,4
23,12,298,10,17,-7
23,12,299,15,7,8
23,13,0,8,32,-24
23,13,1,8,19,-11
23,13,2,21,21,0
23,13,3,22,13,9
23,13,4,6,21,-15
23,13,5,25,26,-1
23,13,6,13,13,0
23,13,7,15,25,-10
23,13,8,10,42,-32
23,13,9,10,11,-1
23,13,10,5,17,-12
23,13,11,7,22,-15
23,13,12,13,23,-10
23,13,13,20,20,0
23,13,14,8,12,-4
23,13,15,3,20,-17
23,13,16,7,18,-11
23,13,17,15,25,-10
23,13,18,10,17,-7
23,13,19,12,35,-23
23,13,20,22,23,-1
23,13,21,20,21,-1
23,13,22,18,21,-3
23,13,23,8,20,-12
23,13,24,8,18,-10
23,13,25,26,20,6
23,13,26,10,24,-14
23,13,27,10,18,-8
23,13,28,14,23,-9
23,13,29,18,20,-2
23,13,30,7,14,-7
23,13,31,8,25,-17
23,13,32,11,20,-9
23,13,33,20,22,-2
23,13,34,20,20,0
23,13,35,10,18,-8
23,13,36,25,26,-1
23,13,37,11,13,-2
23,13,38,3,14,-11
23,13,39,9,18,-9
23,13,40,9,16,-7
23,13,41,15,12,3
23,13,42,7,12,-5
23,13,43,5,19,-14
23,13,44,10,18,-8
23,13,45,21,13,8
23,13,46,13,16,-3
23,13,47,23,32,-9
23,13,48,11,8,3
23,13,49,11,28,-17
23,13,50,13,14,-1
23,13,51,16,22,-6
23,13,52,19,26,-7
23,13,53,9,18,-9
23,13,54,12,20,-8
23,13,55,5,20,-15
23,13,56,16,18,-2
23,13,57,13,25,-12
23,13,58,12,19,-7
23,13,59,10,11,-1
23,13,60,19,13,6
23,13,61,9,23,-14
23,13,62,13,19,-6
23,13,63,5,10,-5
23,13,64,15,16,-1
23,13,65,17,20,-3
23,13,66,14,37,-23
23,13,67,11,9,2
23,13,68,9,19,-10
23,13,69,4,15,-11
23,13,70,12,20,-8
23,13,71,9,17,-8
23,13,72,9,9,0
23,13,73,19,22,-3
23,13,74,11,8,3
23,13,75,14,19,-5
23,13,76,16,23,-7
23,13,77,15,13,2
23,13,78,8,20,-12
23,13,79,12,19,-7
23,13,80,8,21,-13
23,13,81,17,18,-1
23,13,82,14,19,-5
23,13,83,8,14,-6
23,13,84,8,5,3
23,13,85,11,14,-3
23,13,86,13,20,-7
23,13,87,8,9,-1
23,13,88,14,24,-10
23,13,89,9,9,0
23,13,90,12,12,0
23,13,91,0,9,-9
23,13,92,6,13,-7
23,13,93,9,14,-5
23,13,94,15,9,6
23,13,95,22,33,-11
23,13,96,10,32,-22
23,13,97,15,13,2
23,13,98,17,37,-20
23,13,99,15,7,8
23,13,100,10,18,-8
23,13,101,8,13,-5
23,13,102,7,14,-7
23,13,103,16,45,-29
23,13,104,6,16,-10
23,13,105,23,39,-16
23,13,106,23,20,3
23,13,107,15,15,0
23,13,108,18,29,-11
23,13,109,13,5,8
23,13,110,8,20,-12
23,13,111,9,12,-3
23,13,112,15,18,-3
23,13,113,13,17,-4
23,13,114,10,12,-2
23,13,115,3,21,-18
23,13,116,11,13,-2
23,13,117,10,21,-11
23,13,118,13,26,-13
23,13,119,26,33,-7
23,13,120,14,20,-6
23,13,121,6,7,-1
23,13,122,7,26,-19
23,13,123,11,21,-10
23,13,124,6,26,-20
23,13,125,15,25,-10
23,13,126,16,20,-4
23,13,127,5,2,3
23,13,128,16,23,-7
23,13,129,15,27,-12
23,13,130,18,26,-8
23,13,131,2,7,-5
23,13,132,3,7,-4
23,13,133,10,20,-10
23,13,134,21,27,-6
23,13,135,20,10,10
23,13,136,10,12,-2
23,13,137,17,19,-2
23,13,138,11,19,-8
23,13,139,20,25,-5
23,13,140,7,10,-3
23,13,141,13,21,-8
23,13,142,24,19,5
23,13,143,13,13,0
23,13,144,7,17,-10
23,13,145,21,26,-5
23,13,146,16,21,-5
23,13,147,13,18,-5
23,13,148,12,17,-5
23,13,149,9,7,2
23,13,150,11,17,-6
23,13,151,9,23,-14
23,13,152,17,27,-10
23,13,153,16,13,3
23,13,154,19,13,6
23,13,155,17,13,4
23,13,156,16,20,-4
23,13,157,11,16,-5
23,13,158,5,15,-10
23,13,159,11,23,-12
23,13,160,17,16,1
23,13,161,6,13,-7
23,13,162,21,26,-5
23,13,163,9,15,-6
23,13,164,7,12,-5
23,13,165,9,6,3
23,13,166,8,29,-21
23,13,167,16,12,4
23,13,168,15,13,2
23,13,169,12,12,0
23,13,170,8,9,-1
23,13,171,16,23,-7
23,13,172,13,19,-6
23,13,173,12,22,-10
23,13,174,4,15,-11
23,13,175,10,21,-11
23,13,176,6,35,-29
23,13,177,10,19,-9
23,13,178,14,20,-6
23,13,179,7,22,-15
23,13,180,9,13,-4
23,13,181,21,9,12
23,13,182,9,25,-16
23,13,183,8,25,-17
23,13,184,27,39,-12
23,13,185,12,19,-7
23,13,186,10,13,-3
23,13,187,15,19,-4
23,13,188,7,21,-14
23,13,189,19,13,6
23,13,190,22,24,-2
23,13,191,17,20,-3
23,13,192,10,22,-12
23,13,193,15,19,-4
23,13,194,21,31,-10
23,13,195,17,22,-5
23,13,196,17,16,1
23,13,197,28,20,8
23,13,198,7,8,-1
23,13,199,10,25,-15
23,13,200,11,17,-6
23,13,201,16,26,-10
23,13,202,26,30,-4
23,13,203,14,24,-10
23,13,204,14,17,-3
23,13,205,14,23,-9
23,13,206,13,29,-16
23,13,207,8,13,-5
23,13,208,11,14,-3
23,13,209,11,12,-1
23,13,210,11,27,-16
23,13,211,26,10,16
23,13,212,16,26,-10
23,13,213,13,28,-15
23,13,214,11,19,-8
23,13,215,10,25,-15
23,13,216,17,27,-10
23,13,217,25,26,-1
23,13,218,9,21,-12
23,13,219,15,14,1
23,13,220,16,25,-9
23,13,221,13,36,-23
23,13,222,5,11,-6
23,13,223,9,24,-15
23,13,224,5,11,-6
23,13,225,10,14,-4
23,13,226,7,14,-7
23,13,227,8,8,0
23,13,228,22,17,5
23,13,229,15,23,-8
23,13,230,9,24,-15
23,13,231,10,19,-9
23,13,232,12,14,-2
23,13,233,11,15,-4
23,13,234,8,10,-2
23,13,235,14,11,3
23,13,236,12,18,-6
23,13,237,10,9,1
23,13,238,8,13,-5
23,13,239,11,18,-7
23,13,240,6,9,-3
23,13,241,11,19,-8
23,13,242,9,26,-17
23,13,243,14,27,-13
23,13,244,18,18,0
23,13,245,15,26,-11
23,13,246,20,13,7
23,13,247,19,33,-14
23,13,248,17,23,-6
23,13,249,13,20,-7
23,13,250,21,21,0
23,13,251,16,6,10
23,13,252,15,24,-9
23,13,253,2,18,-16
23,13,254,14,21,-7
23,13,255,13,24,-11
23,13,256,13,30,-17
23,13,257,16,11,5
23,13,258,6,22,-16
23,13,259,11,16,-5
23,13,260,12,20,-8
23,13,261,27,37,-10
23,13,262,18,35,-17
23,13,263,24,31,-7
23,13,264,12,17,-5
23,13,265,8,25,-17
23,13,266,12,8,4
23,13,267,7,16,-9
23,13,268,17,20,-3
23,13,269,17,18,-1
23,13,270,2,8,-6
23,13,271,23,30,-7
23,13,272,21,37,-16
23,13,273,17,25,-8
23,13,274,5,10,-5
23,13,275,13,41,-28
23,13,276,22,14,8
23,13,277,19,21,-2
23,13,278,5,22,-17
23,13,279,8,20,-12
23,13,280,8,14,-6
23,13,281,11,19,-8
23,13,282,19,24,-5
23,13,283,16,27,-11
23,13,284,16,15,1
23,13,285,18,12,6
23,13,286,19,34,-15
23,13,287,12,19,-7
23,13,288,6,13,-7
23,13,289,10,20,-10
23,13,290,10,14,-4
23,13,291,13,13,0
23,13,292,9,15,-6
23,13,293,16,17,-1
23,13,294,15,17,-2
23,13,295,6,8,-2
23,13,296,7,20,-13
23,13,297,7,22,-15
23,13,298,14,12,2
23,13,299,9,13,-4
23,14,0,14,9,5
23,14,1,14,26,-12
23,14,2,12,13,-1
23,14,3,14,15,-1
23,14,4,6,15,-9
23,14,5,8,15,-7
23,14,6,10,16,-6
23,14,7,16,16,0
23,14,8,10,14,-4
23,14,9,24,25,-1
23,14,10,15,10,5
23,14,11,10,14,-4
23,14,12,12,13,-1
23,14,13,13,11,2
23,14,14,6,11,-5
23,14,15,9,29,-20
23,14,16,13,23,-10
23,14,17,7,23,-16
23,14,18,15,17,-2
23,14,19,14,10,4
23,14,20,9,7,2
23,14,21,14,24,-10
23,14,22,5,19,-14
23,14,23,8,22,-14
23,14,24,12,21,-9
23,14,25,6,16,-10
23,14,26,14,11,3
23,14,27,8,37,-29
23,14,28,21,18,3
23,14,29,7,13,-6
23,14,30,6,19,-13
23,14,31,10,10,0
23,14,32,7,25,-18
23,14,33,15,24,-9
23,14,34,10,12,-2
23,14,35,13,27,-14
23,14,36,2,24,-22
23,14,37,11,24,-13
23,14,38,10,11,-1
23,14,39,10,19,-9
23,14,40,9,21,-12
23,14,41,12,12,0
23,14,42,19,22,-3
23,14,43,21,16,5
23,14,44,11,8,3
23,14,45,14,27,-13
23,14,46,8,23,-15
23,14,47,12,28,-16
23,14,48,28,17,11
23,14,49,14,23,-9
23,14,50,5,8,-3
23,14,51,27,29,-2
23,14,52,18,19,-1
23,14,53,9,14,-5
23,14,54,11,12,-1
23,14,55,7,29,-22
23,14,56,9,17,-8
23,14,57,16,25,-9
23,14,58,11,15,-4
23,14,59,20,18,2
23,14,60,4,10,-6
23,14,61,16,14,2
23,14,62,12,16,-4
23,14,63,4,14,-10
23,14,64,19,16,3
23,14,65,10,30,-20
23,14,66,14,11,3
23,14,67,12,20,-8
23,14,68,7,12,-5
23,14,69,12,18,-6
23,14,70,10,12,-2
23,14,71,7,19,-12
23,14,72,7,18,-11
23,14,73,7,24,-17
23,14,74,15,30,-15
23,14,75,15,21,-6
23,14,76,8,19,-11
23,14,77,6,13,-7
23,14,78,11,13,-2
23,14,79,15,16,-1
23,14,80,20,14,6
23,14,81,16,14,2
23,14,82,16,17,-1
23,14,83,9,7,2
23,14,84,17,25,-8
23,14,85,13,11,2
23,14,86,10,15,-5
23,14,87,12,18,-6
23,14,88,11,10,1
23,14,89,19,16,3
23,14,90,13,16,-3
23,14,91,10,18,-8
23,14,92,10,4,6
23,14,93,10,20,-10
23,14,94,6,20,-14
23,14,95,9,16,-7
23,14,96,10,8,2
23,14,97,8,22,-14
23,14,98,17,11,6
23,14,99,26,30,-4
23,14,100,6,21,-15
23,14,101,17,25,-8
23,14,102,7,14,-7
23,14,103,12,9,3
23,14,104,10,17,-7
23,14,105,9,27,-18
23,14,106,7,11,-4
23,14,107,13,14,-1
23,14,108,17,22,-5
23,14,109,6,19,-13
23,14,110,11,17,-6
23,14,111,5,10,-5
23,14,112,13,23,-10
23,14,113,5,37,-32
23,14,114,8,13,-5
23,14,115,25,29,-4
23,14,116,8,11,-3
23,14,117,5,5,0
23,14,118,7,17,-10
23,14,119,20,12,8
23,14,120,19,20,-1
23,14,121,11,24,-13
23,14,122,10,13,-3
23,14,123,8,14,-6
23,14,124,7,16,-9
23,14,125,11,24,-13
23,14,126,16,23,-7
23,14,127,6,22,-16
23,14,128,12,17,-5
23,14,129,7,18,-11
23,14,130,15,15,0
23,14,131,8,19,-11
23,14,132,19,23,-4
23,14,133,6,16,-10
23,14,134,10,27,-17
23,14,135,19,26,-7
23,14,136,13,11,2
23,14,137,9,7,2
23,14,138,17,23,-6
23,14,139,13,13,0
23,14,140,9,7,2
23,14,141,23,34,-11
23,14,142,14,13,1
23,14,143,4,20,-16
23,14,144,2,12,-10
23,14,145,13,14,-1
23,14,146,11,17,-6
23,14,147,26,24,2
23,14,148,8,17,-9
23,14,149,12,16,-4
23,14,150,16,18,-2
23,14,151,12,16,-4
23,14,152,9,31,-22
23,14,153,10,23,-13
23,14,154,10,7,3
23,14,155,11,16,-5
23,14,156,14,19,-5
23,14,157,9,15,-6
23,14,158,17,19,-2
23,14,159,5,12,-7
23,14,160,10,17,-7
23,14,161,6,18,-12
23,14,162,19,17,2
23,14,163,4,16,-12
23,14,164,3,10,-7
23,14,165,17,23,-6
23,14,166,15,22,-7
23,14,167,8,11,-3
23,14,168,15,17,-2
23,14,169,9,14,-5
23,14,170,13,19,-6
23,14,171,12,25,-13
23,14,172,11,16,-5
23,14,173,11,14,-3
23,14,174,13,14,-1
23,14,175,5,15,-10
23,14,176,13,19,-6
23,14,177,7,11,-4
23,14,178,8,9,-1
23,14,179,24,14,10
23,14,180,12,23,-11
23,14,181,11,23,-12
23,14,182,6,19,-13
23,14,183,17,18,-1
23,14,184,24,18,6
23,14,185,10,16,-6
23,14,186,13,13,0
23,14,187,11,20,-9
23,14,188,13,19,-6
23,14,189,24,30,-6
23,14,190,5,10,-5
23,14,191,9,15,-6
23,14,192,25,24,1
23,14,193,10,26,-16
23,14,194,16,14,2
23,14,195,4,22,-18
23,14,196,15,15,0
23,14,197,14,27,-13
23,14,198,2,17,-15
23,14,199,13,16,-3
23,14,200,9,9,0
23,14,201,10,16,-6
23,14,202,16,26,-10
23,14,203,7,18,-11
23,14,204,5,9,-4
23,14,205,12,28,-16
23,14,206,12,8,4
23,14,207,20,7,13
23,14,208,18,24,-6
23,14,209,10,9,1
23,14,210,5,18,-13
23,14,211,12,20,-8
23,14,212,7,9,-2
23,14,213,4,15,-11
23,14,214,9,13,-4
23,14,215,7,5,2
23,14,216,15,18,-3
23,14,217,13,9,4
23,14,218,17,15,2
23,14,219,6,8,-2
23,14,220,15,9,6
23,14,221,8,11,-3
23,14,222,20,16,4
23,14,223,9,18,-9
23,14,224,5,16,-11
23,14,225,16,22,-6
23,14,226,13,17,-4
23,14,227,14,34,-20
23,14,228,13,18,-5
23,14,229,6,10,-4
23,14,230,5,6,-1
23,14,231,14,22,-8
23,14,232,10,18,-8
23,14,233,16,18,-2
23,14,234,10,31,-21
23,14,235,11,14,-3
23,14,236,10,31,-21
23,14,237,9,28,-19
23,14,238,13,23,-10
23,14,239,15,25,-10
23,14,240,12,21,-9
23,14,241,6,9,-3
23,14,242,9,23,-14
23,14,243,8,18,-10
23,14,244,9,16,-7
23,14,245,19,19,0
23,14,246,18,19,-1
23,14,247,11,13,-2
23,14,248,12,20,-8
23,14,249,3,27,-24
23,14,250,14,21,-7
23,14,251,9,13,-4
23,14,252,15,18,-3
23,14,253,18,36,-18
23,14,254,7,26,-19
23,14,255,17,20,-3
23,14,256,19,18,1
23,14,257,19,17,2
23,14,258,15,17,-2
23,14,259,18,27,-9
23,14,260,14,9,5
23,14,261,22,29,-7
23,14,262,15,23,-8
23,14,263,12,9,3
23,14,264,14,14,0
23,14,265,0,15,-15
23,14,266,24,16,8
23,14,267,14,12,2
23,14,268,11,13,-2
23,14,269,12,15,-3
23,14,270,13,13,0
23,14,271,21,14,7
23,14,272,15,18,-3
23,14,273,15,7,8
23,14,274,10,30,-20
23,14,275,9,30,-21
23,14,276,11,10,1
23,14,277,22,22,0
23,14,278,6,10,-4
23,14,279,18,31,-13
23,14,280,20,18,2
23,14,281,9,24,-15
23,14,282,10,17,-7
23,14,283,13,22,-9
23,14,284,13,18,-5
23,14,285,10,25,-15
23,14,286,5,23,-18
23,14,287,8,7,1
23,14,288,11,18,-7
23,14,289,19,11,8
23,14,290,10,9,1
23,14,291,14,26,-12
23,14,292,12,16,-4
23,14,293,14,17,-3
23,14,294,14,16,-2
23,14,295,14,22,-8
23,14,296,7,17,-10
23,14,297,8,6,2
23,14,298,25,23,2
23,14,299,13,17,-4
23,15,0,9,12,-3
23,15,1,16,17,-1
23,15,2,13,25,-12
23,15,3,11,16,-5
23,15,4,11,22,-11
23,15,5,10,11,-1
23,15,6,13,13,0
23,15,7,16,11,5
23,15,8,14,12,2
23,15,9,23,21,2
23,15,10,17,19,-2
23,15,11,9,18,-9
23,15,12,12,15,-3
23,15,13,23,16,7
23,15,14,11,21,-10
23,15,15,23,30,-7
23,15,16,15,19,-4
23,15,17,11,16,-5
23,15,18,10,11,-1
23,15,19,11,13,-2
23,15,20,7,6,1
23,15,21,13,21,-8
23,15,22,17,24,-7
23,15,23,22,27,-5
23,15,24,17,16,1
23,15,25,14,29,-15
23,15,26,19,21,-2
23,15,27,14,29,-15
23,15,28,10,13,-3
23,15,29,10,12,-2
23,15,30,24,21,3
23,15,31,6,14,-8
23,15,32,9,11,-2
23,15,33,15,11,4
23,15,34,14,25,-11
23,15,35,12,21,-9
23,15,36,17,9,8
23,15,37,19,12,7
23,15,38,21,24,-3
23,15,39,7,13,-6
23,15,40,12,12,0
23,15,41,15,17,-2
23,15,42,12,17,-5
23,15,43,4,21,-17
23,15,44,14,18,-4
23,15,45,12,16,-4
23,15,46,9,16,-7
23,15,47,5,18,-13
23,15,48,10,13,-3
23,15,49,15,19,-4
23,15,50,11,16,-5
23,15,51,8,19,-11
23,15,52,9,17,-8
23,15,53,15,11,4
23,15,54,16,19,-3
23,15,55,10,17,-7
23,15,56,14,24,-10
23,15,57,13,6,7
23,15,58,10,19,-9
23,15,59,10,22,-12
23,15,60,23,16,7
23,15,61,14,17,-3
23,15,62,15,25,-10
23,15,63,15,11,4
23,15,64,8,23,-15
23,15,65,10,14,-4
23,15,66,4,19,-15
23,15,67,20,31,-11
23,15,68,15,32,-17
23,15,69,15,14,1
23,15,70,17,17,0
23,15,71,6,15,-9
23,15,72,13,12,1
23,15,73,10,14,-4
23,15,74,14,16,-2
23,15,75,13,13,0
23,15,76,15,24,-9
23,15,77,18,16,2
23,15,78,8,8,0
23,15,79,28,23,5
23,15,80,9,8,1
23,15,81,12,14,-2
23,15,82,10,22,-12
23,15,83,17,28,-11
23,15,84,8,16,-8
23,15,85,11,18,-7
23,15,86,7,25,-18
23,15,87,23,10,13
23,15,88,14,13,1
23,15,89,13,15,-2
23,15,90,12,2,10
23,15,91,8,13,-5
23,15,92,6,15,-9
23,15,93,11,11,0
23,15,94,23,15,8
23,15,95,21,29,-8
23,15,96,14,9,5
23,15,97,16,15,1
23,15,98,15,12,3
23,15,99,13,21,-8
23,15,100,14,26,-12
23,15,101,6,10,-4
23,15,102,11,24,-13
23,15,103,11,10,1
23,15,104,15,14,1
23,15,105,7,8,-1
23,15,106,16,15,1
23,15,107,13,36,-23
23,15,108,18,26,-8
23,15,109,28,20,8
23,15,110,18,20,-2
23,15,111,12,6,6
23,15,112,9,8,1
23,15,113,17,18,-1
23,15,114,22,14,8
23,15,115,15,9,6
23,15,116,18,3,15
23,15,117,13,17,-4
23,15,118,16,18,-2
23,15,119,12,12,0
23,15,120,10,15,-5
23,15,121,16,19,-3
23,15,122,20,29,-9
23,15,123,16,10,6
23,15,124,14,28,-14
23,15,125,15,22,-7
23,15,126,5,13,-8
23,15,127,8,15,-7
23,15,128,9,16,-7
23,15,129,11,25,-14
23,15,130,5,11,-6
23,15,131,24,30,-6
23,15,132,21,25,-4
23,15,133,17,17,0
23,15,134,12,17,-5
23,15,135,11,15,-4
23,15,136,10,27,-17
23,15,137,16,13,3
23,15,138,11,13,-2
23,15,139,7,5,2
23,15,140,3,6,-3
23,15,141,17,10,7
23,15,142,5,16,-11
23,15,143,22,16,6
23,15,144,16,21,-5
23,15,145,7,11,-4
23,15,146,14,20,-6
23,15,147,16,28,-12
23,15,148,20,16,4
23,15,149,19,20,-1
23,15,150,9,16,-7
23,15,151,14,13,1
23,15,152,8,15,-7
23,15,153,27,22,5
23,15,154,14,26,-12
23,15,155,5,4,1
23,15,156,17,21,-4
23,15,157,10,17,-7
23,15,158,18,13,5
23,15,159,16,28,-12
23,15,160,6,12,-6
23,15,161,10,23,-13
23,15,162,20,24,-4
23,15,163,23,21,2
23,15,164,11,23,-12
23,15,165,20,20,0
23,15,166,9,17,-8
23,15,167,7,14,-7
23,15,168,6,10,-4
23,15,169,11,24,-13
23,15,170,7,18,-11
23,15,171,21,14,7
23,15,172,13,18,-5
23,15,173,15,20,-5
23,15,174,12,14,-2
23,15,175,19,20,-1
23,15,176,8,12,-4
23,15,177,6,11,-5
23,15,178,16,13,3
23,15,179,15,13,2
23,15,180,5,24,-19
23,15,181,8,18,-10
23,15,182,17,31,-14
23,15,183,9,7,2
23,15,184,9,9,0
23,15,185,13,9,4
23,15,186,7,15,-8
23,15,187,16,18,-2
23,15,188,11,22,-11
23,15,189,11,20,-9
23,15,190,5,18,-13
23,15,191,15,23,-8
23,15,192,13,11,2
23,15,193,8,14,-6
23,15,194,6,21,-15
23,15,195,9,7,2
23,15,196,11,28,-17
23,15,197,10,16,-6
23,15,198,7,8,-1
23,15,199,8,17,-9
23,15,200,18,10,8
23,15,201,7,20,-13
23,15,202,7,18,-11
23,15,203,16,16,0
23,15,204,7,12,-5
23,15,205,11,15,-4
23,15,206,7,18,-11
23,15,207,15,16,-1
23,15,208,13,17,-4
23,15,209,8,17,-9
23,15,210,22,20,2
23,15,211,18,21,-3
23,15,212,19,34,-15
23,15,213,16,14,2
23,15,214,11,16,-5
23,15,215,12,24,-12
23,15,216,22,24,-2
23,15,217,16,18,-2
23,15,218,15,21,-6
23,15,219,15,17,-2
23,15,220,24,27,-3
23,15,221,13,13,0
23,15,222,18,12,6
23,15,223,12,18,-6
23,15,224,9,5,4
23,15,225,13,21,-8
23,15,226,15,12,3
23,15,227,14,18,-4
23,15,228,21,22,-1
23,15,229,13,19,-6
23,15,230,22,16,6
23,15,231,10,13,-3
23,15,232,25,15,10
23,15,233,16,22,-6
23,15,234,13,23,-10
23,15,235,18,25,-7
23,15,236,4,13,-9
23,15,237,18,27,-9
23,15,238,24,13,11
23,15,239,14,19,-5
23,15,240,13,15,-2
23,15,241,11,14,-3
23,15,242,11,19,-8
23,15,243,20,21,-1
23,15,244,3,19,-16
23,15,245,16,11,5
23,15,246,5,16,-11
23,15,247,12,11,1
23,15,248,18,16,2
23,15,249,10,21,-11
23,15,250,12,13,-1
23,15,251,16,25,-9
23,15,252,16,25,-9
23,15,253,11,17,-6
23,15,254,22,18,4
23,15,255,6,7,-1
23,15,256,10,20,-10
23,15,257,21,23,-2
23,15,258,7,30,-23
23,15,259,18,16,2
23,15,260,25,17,8
23,15,261,9,17,-8
23,15,262,11,14,-3
23,15,263,16,22,-6
23,15,264,15,21,-6
23,15,265,12,14,-2
23,15,266,13,30,-17
23,15,267,9,12,-3
23,15,268,8,14,-6
23,15,269,11,18,-7
23,15,270,12,17,-5
23,15,271,9,18,-9
23,15,272,6,13,-7
23,15,273,17,25,-8
23,15,274,22,28,-6
23,15,275,15,22,-7
23,15,276,7,21,-14
23,15,277,23,17,6
23,15,278,14,18,-4
23,15,279,8,21,-13
23,15,280,13,12,1
23,15,281,17,13,4
23,15,282,10,18,-8
23,15,283,14,9,5
23,15,284,20,19,1
23,15,285,15,15,0
23,15,286,14,23,-9
23,15,287,24,24,0
23,15,288,6,26,-20
23,15,289,13,11,2
23,15,290,15,27,-12
23,15,291,16,19,-3
23,15,292,0,10,-10
23,15,293,9,13,-4
23,15,294,12,17,-5
23,15,295,11,22,-11
23,15,296,16,15,1
23,15,297,10,10,0
23,15,298,6,24,-18
23,15,299,10,13,-3
23,16,0,12,24,-12
23,16,1,13,29,-16
23,16,2,14,15,-1
23,16,3,11,18,-7
23,16,4,19,26,-7
23,16,5,9,9,0
23,16,6,21,26,-5
23,16,7,16,8,8
23,16,8,11,14,-3
23,16,9,12,11,1
23,16,10,9,6,3
23,16,11,10,22,-12
23,16,12,20,19,1
23,16,13,8,24,-16
23,16,14,13,12,1
23,16,15,7,13,-6
23,16,16,15,20,-5
23,16,17,13,19,-6
23,16,18,4,18,-14
23,16,19,19,19,0
23,16,20,17,12,5
23,16,21,3,9,-6
23,16,22,9,15,-6
23,16,23,15,13,2
23,16,24,10,19,-9
23,16,25,12,17,-5
23,16,26,12,12,0
23,16,27,20,21,-1
23,16,28,14,18,-4
23,16,29,21,21,0
23,16,30,14,10,4
23,16,31,11,18,-7
23,16,32,9,19,-10
23,16,33,21,21,0
23,16,34,11,12,-1
23,16,35,17,25,-8
23,16,36,10,19,-9
23,16,37,9,16,-7
23,16,38,7,17,-10
23,16,39,15,13,2
23,16,40,11,13,-2
23,16,41,13,16,-3
23,16,42,6,14,-8
23,16,43,18,29,-11
23,16,44,16,17,-1
23,16,45,10,22,-12
23,16,46,12,11,1
23,16,47,8,28,-20
23,16,48,9,11,-2
23,16,49,11,18,-7
23,16,50,15,6,9
23,16,51,7,28,-21
23,16,52,6,13,-7
23,16,53,8,20,-12
23,16,54,17,10,7
23,16,55,19,17,2
23,16,56,20,20,0
23,16,57,8,21,-13
23,16,58,12,24,-12
23,16,59,8,20,-12
23,16,60,18,12,6
23,16,61,6,13,-7
23,16,62,12,15,-3
23,16,63,22,12,10
23,16,64,11,10,1
23,16,65,11,15,-4
23,16,66,5,13,-8
23,16,67,10,21,-11
23,16,68,10,36,-26
23,16,69,12,11,1
23,16,70,14,19,-5
23,16,71,18,8,10
23,16,72,5,13,-8
23,16,73,10,26,-16
23,16,74,14,14,0
23,16,75,11,20,-9
23,16,76,4,18,-14
23,16,77,20,21,-1
23,16,78,12,18,-6
23,16,79,17,12,5
23,16,80,9,13,-4
23,16,81,5,13,-8
23,16,82,11,9,2
23,16,83,5,9,-4
23,16,84,8,15,-7
23,16,85,11,6,5
23,16,86,18,24,-6
23,16,87,13,22,-9
23,16,88,20,20,0
23,16,89,13,23,-10
23,16,90,8,11,-3
23,16,91,14,13,1
23,16,92,5,15,-10
23,16,93,19,20,-1
23,16,94,12,16,-4
23,16,95,9,16,-7
23,16,96,13,13,0
23,16,97,15,15,0
23,16,98,11,24,-13
23,16,99,14,14,0
23,16,100,5,10,-5
23,16,101,19,26,-7
23,16,102,14,15,-1
23,16,103,7,9,-2
23,16,104,7,34,-27
23,16,105,10,9,1
23,16,106,9,20,-11
23,16,107,13,19,-6
23,16,108,5,8,-3
23,16,109,9,20,-11
23,16,110,14,13,1
23,16,111,6,11,-5
23,16,112,13,17,-4
23,16,113,16,12,4
23,16,114,14,8,6
23,16,115,20,15,5
23,16,116,12,15,-3
23,16,117,13,8,5
23,16,118,11,8,3
23,16,119,7,23,-16
23,16,120,11,15,-4
23,16,121,7,6,1
23,16,122,13,35,-22
23,16,123,30,26,4
23,16,124,10,14,-4
23,16,125,16,9,7
23,16,126,11,14,-3
23,16,127,8,15,-7
23,16,128,2,8,-6
23,16,129,17,20,-3
23,16,130,10,23,-13
23,16,131,27,25,2
23,16,132,28,20,8
23,16,133,11,9,2
23,16,134,12,20,-8
23,16,135,15,25,-10
23,16,136,13,20,-7
23,16,137,22,26,-4
23,16,138,6,18,-12
23,16,139,10,29,-19
23,16,140,8,12,-4
23,16,141,13,24,-11
23,16,142,23,17,6
23,16,143,10,18,-8
23,16,144,26,37,-11
23,16,145,7,10,-3
23,16,146,13,14,-1
23,16,147,13,21,-8
23,16,148,15,14,1
23,16,149,8,27,-19
23,16,150,21,14,7
23,16,151,23,11,12
23,16,152,12,20,-8
23,16,153,17,15,2
23,16,154,4,14,-10
23,16,155,8,14,-6
23,16,156,10,17,-7
23,16,157,4,10,-6
23,16,158,18,26,-8
23,16,159,6,10,-4
23,16,160,9,15,-6
23,16,161,18,10,8
23,16,162,9,17,-8
23,16,163,6,14,-8
23,16,164,4,9,-5
23,16,165,16,15,1
23,16,166,16,32,-16
23,16,167,11,14,-3
23,16,168,11,24,-13
23,16,169,1,10,-9
23,16,170,19,30,-11
23,16,171,20,19,1
23,16,172,9,20,-11
23,16,173,6,9,-3
23,16,174,12,22,-10
23,16,175,5,5,0
23,16,176,19,19,0
23,16,177,6,14,-8
23,16,178,15,10,5
23,16,179,16,21,-5
23,16,180,15,15,0
23,16,181,7,21,-14
23,16,182,4,13,-9
23,16,183,19,12,7
23,16,184,12,9,3
23,16,185,4,12,-8
23,16,186,11,19,-8
23,16,187,6,10,-4
23,16,188,15,14,1
23,16,189,19,25,-6
23,16,190,12,21,-9
23,16,191,14,23,-9
23,16,192,16,14,2
23,16,193,16,31,-15
23,16,194,15,13,2
23,16,195,12,6,6
23,16,196,8,25,-17
23,16,197,18,22,-4
23,16,198,8,21,-13
23,16,199,11,27,-16
23,16,200,12,11,1
23,16,201,16,19,-3
23,16,202,9,16,-7
23,16,203,11,18,-7
23,16,204,6,9,-3
23,16,205,24,16,8
23,16,206,12,17,-5
23,16,207,18,12,6
23,16,208,27,12,15
23,16,209,9,16,-7
23,16,210,7,18,-11
23,16,211,13,16,-3
23,16,212,8,19,-11
23,16,213,6,14,-8
23,16,214,5,19,-14
23,16,215,16,19,-3
23,16,216,11,27,-16
23,16,217,17,20,-3
23,16,218,10,32,-22
23,16,219,7,24,-17
23,16,220,21,26,-5
23,16,221,12,22,-10
23,16,222,14,18,-4
23,16,223,10,13,-3
23,16,224,16,22,-6
23,16,225,9,11,-2
23,16,226,7,3,4
23,16,227,7,20,-13
23,16,228,17,19,-2
23,16,229,14,18,-4
23,16,230,10,15,-5
23,16,231,23,30,-7
23,16,232,9,14,-5
23,16,233,17,25,-8
23,16,234,12,14,-2
23,16,235,7,14,-7
23,16,236,11,9,2
23,16,237,12,21,-9
23,16,238,10,16,-6
23,16,239,9,23,-14
23,16,240,13,11,2
23,16,241,13,10,3
23,16,242,20,22,-2
23,16,243,17,13,4
23,16,244,4,4,0
23,16,245,15,14,1
23,16,246,17,20,-3
23,16,247,15,20,-5
23,16,248,9,14,-5
23,16,249,14,9,5
23,16,250,5,21,-16
23,16,251,7,5,2
23,16,252,9,24,-15
23,16,253,15,14,1
23,16,254,13,19,-6
23,16,255,16,14,2
23,16,256,10,22,-12
23,16,257,11,8,3
23,16,258,2,17,-15
23,16,259,8,13,-5
23,16,260,9,18,-9
23,16,261,12,9,3
23,16,262,14,5,9
23,16,263,14,32,-18
23,16,264,15,17,-2
23,16,265,14,17,-3
23,16,266,18,17,1
23,16,267,14,27,-13
23,16,268,14,13,1
23,16,269,11,31,-20
23,16,270,8,10,-2
23,16,271,10,27,-17
23,16,272,10,20,-10
23,16,273,16,20,-4
23,16,274,4,20,-16
23,16,275,19,8,11
23,16,276,32,27,5
23,16,277,10,23,-13
23,16,278,7,12,-5
23,16,279,16,23,-7
23,16,280,22,34,-12
23,16,281,2,4,-2
23,16,282,14,12,2
23,16,283,9,11,-2
23,16,284,13,28,-15
23,16,285,16,12,4
23,16,286,12,28,-16
23,16,287,10,25,-15
23,16,288,7,12,-5
23,16,289,5,8,-3
23,16,290,3,20,-17
23,16,291,7,22,-15
23,16,292,7,11,-4
23,16,293,2,17,-15
23,16,294,16,12,4
23,16,295,9,16,-7
23,16,296,19,21,-2
23,16,297,11,15,-4
23,16,298,16,17,-1
23,16,299,12,14,-2
23,17,0,18,11,7
23,17,1,13,17,-4
23,17,2,4,16,-12
23,17,3,8,15,-7
23,17,4,9,27,-18
23,17,5,5,13,-8
23,17,6,22,21,1
23,17,7,20,28,-8
23,17,8,16,15,1
23,17,9,19,18,1
23,17,10,17,14,3
23,17,11,9,7,2
23,17,12,20,28,-8
23,17,13,11,16,-5
23,17,14,16,15,1
23,17,15,5,10,-5
23,17,16,23,25,-2
23,17,17,19,22,-3
23,17,18,19,25,-6
23,17,19,12,10,2
23,17,20,10,4,6
23,17,21,7,13,-6
23,17,22,15,15,0
23,17,23,24,22,2
23,17,24,11,8,3
23,17,25,16,27,-11
23,17,26,1,1,0
23,17,27,17,20,-3
23,17,28,19,13,6
23,17,29,13,6,7
23,17,30,13,11,2
23,17,31,8,13,-5
23,17,32,18,23,-5
23,17,33,10,21,-11
23,17,34,21,15,6
23,17,35,5,11,-6
23,17,36,8,12,-4
23,17,37,15,23,-8
23,17,38,12,16,-4
23,17,39,18,20,-2
23,17,40,14,34,-20
23,17,41,18,10,8
23,17,42,13,15,-2
23,17,43,12,36,-24
23,17,44,10,21,-11
23,17,45,15,14,1
23,17,46,15,21,-6
23,17,47,11,12,-1
23,17,48,13,12,1
23,17,49,11,18,-7
23,17,50,4,17,-13
23,17,51,19,24,-5
23,17,52,8,5,3
23,17,53,4,11,-7
23,17,54,15,15,0
23,17,55,19,27,-8
23,17,56,9,21,-12
23,17,57,20,22,-2
23,17,58,8,28,-20
23,17,59,24,12,12
23,17,60,9,9,0
23,17,61,12,16,-4
23,17,62,16,14,2
23,17,63,20,21,-1
23,17,64,13,16,-3
23,17,65,13,27,-14
23,17,66,10,27,-17
23,17,67,8,7,1
23,17,68,12,16,-4
23,17,69,21,18,3
23,17,70,7,15,-8
23,17,71,15,17,-2
23,17,72,10,21,-11
23,17,73,7,9,-2
23,17,74,16,13,3
23,17,75,15,24,-9
23,17,76,12,19,-7
23,17,77,17,8,9
23,17,78,6,15,-9
23,17,79,25,23,2
23,17,80,10,15,-5
23,17,81,6,9,-3
23,17,82,14,16,-2
23,17,83,11,18,-7
23,17,84,17,22,-5
23,17,85,14,22,-8
23,17,86,12,11,1
23,17,87,11,20,-9
23,17,88,21,19,2
23,17,89,10,17,-7
23,17,90,3,11,-8
23,17,91,17,20,-3
23,17,92,23,21,2
23,17,93,9,11,-2
23,17,94,16,23,-7
23,17,95,9,12,-3
23,17,96,13,16,-3
23,17,97,4,20,-16
23,17,98,9,24,-15
23,17,99,11,11,0
23,17,100,10,16,-6
23,17,101,20,12,8
23,17,102,17,26,-9
23,17,103,7,17,-10
23,17,104,11,11,0
23,17,105,34,18,16
23,17,106,16,15,1
23,17,107,5,11,-6
23,17,108,24,20,4
23,17,109,23,23,0
23,17,110,4,18,-14
23,17,111,26,26,0
23,17,112,4,25,-21
23,17,113,8,15,-7
23,17,114,6,11,-5
23,17,115,14,25,-11
23,17,116,17,8,9
23,17,117,4,8,-4
23,17,118,17,21,-4
23,17,119,12,9,3
23,17,120,25,14,11
23,17,121,8,15,-7
23,17,122,21,20,1
23,17,123,11,18,-7
23,17,124,27,24,3
23,17,125,8,18,-10
23,17,126,6,16,-10
23,17,127,18,22,-4
23,17,128,19,21,-2
23,17,129,15,27,-12
23,17,130,7,13,-6
23,17,131,14,9,5
23,17,132,6,12,-6
23,17,133,12,17,-5
23,17,134,14,15,-1
23,17,135,9,14,-5
23,17,136,19,13,6
23,17,137,11,17,-6
23,17,138,5,2,3
23,17,139,18,11,7
23,17,140,15,20,-5
23,17,141,18,20,-2
23,17,142,19,28,-9
23,17,143,10,25,-15
23,17,144,16,33,-17
23,17,145,7,22,-15
23,17,146,10,16,-6
23,17,147,9,11,-2
23,17,148,9,18,-9
23,17,149,24,18,6
23,17,150,7,11,-4
23,17,151,14,9,5
23,17,152,6,23,-17
23,17,153,7,26,-19
23,17,154,17,29,-12
23,17,155,9,26,-17
23,17,156,7,12,-5
23,17,157,5,7,-2
23,17,158,7,8,-1
23,17,159,14,17,-3
23,17,160,10,25,-15
23,17,161,13,25,-12
23,17,162,9,25,-16
23,17,163,15,20,-5
23,17,164,14,7,7
23,17,165,5,16,-11
23,17,166,12,10,2
23,17,167,9,17,-8
23,17,168,15,10,5
23,17,169,16,10,6
23,17,170,12,9,3
23,17,171,25,7,18
23,17,172,11,12,-1
23,17,173,2,17,-15
23,17,174,18,21,-3
23,17,175,9,10,-1
23,17,176,5,24,-19
23,17,177,10,18,-8
23,17,178,9,10,-1
23,17,179,14,15,-1
23,17,180,22,12,10
23,17,181,2,15,-13
23,17,182,27,20,7
23,17,183,6,9,-3
23,17,184,15,25,-10
23,17,185,9,19,-10
23,17,186,20,21,-1
23,17,187,13,16,-3
23,17,188,8,15,-7
23,17,189,18,13,5
23,17,190,14,17,-3
23,17,191,17,17,0
23,17,192,4,10,-6
23,17,193,16,16,0
23,17,194,18,23,-5
23,17,195,7,12,-5
23,17,196,5,12,-7
23,17,197,19,9,10
23,17,198,11,15,-4
23,17,199,9,15,-6
23,17,200,11,21,-10
23,17,201,6,7,-1
23,17,202,12,20,-8
23,17,203,11,15,-4
23,17,204,15,11,4
23,17,205,11,5,6
23,17,206,18,16,2
23,17,207,8,19,-11
23,17,208,21,15,6
23,17,209,17,22,-5
23,17,210,18,18,0
23,17,211,18,10,8
23,17,212,6,16,-10
23,17,213,16,11,5
23,17,214,18,12,6
23,17,215,14,14,0
23,17,216,23,27,-4
23,17,217,20,14,6
23,17,218,13,26,-13
23,17,219,13,18,-5
23,17,220,3,20,-17
23,17,221,19,23,-4
23,17,222,13,20,-7
23,17,223,14,20,-6
23,17,224,13,30,-17
23,17,225,13,24,-11
23,17,226,14,19,-5
23,17,227,11,18,-7
23,17,228,15,31,-16
23,17,229,20,11,9
23,17,230,16,27,-11
23,17,231,16,24,-8
23,17,232,18,20,-2
23,17,233,7,11,-4
23,17,234,15,12,3
23,17,235,11,23,-12
23,17,236,12,11,1
23,17,237,20,32,-12
23,17,238,21,10,11
23,17,239,7,12,-5
23,17,240,9,21,-12
23,17,241,14,9,5
23,17,242,10,11,-1
23,17,243,6,24,-18
23,17,244,22,14,8
23,17,245,20,27,-7
23,17,246,14,25,-11
23,17,247,10,22,-12
23,17,248,13,8,5
23,17,249,14,11,3
23,17,250,12,12,0
23,17,251,6,14,-8
23,17,252,9,26,-17
23,17,253,12,21,-9
23,17,254,11,15,-4
23,17,255,13,5,8
23,17,256,17,8,9
23,17,257,14,15,-1
23,17,258,10,3,7
23,17,259,13,29,-16
23,17,260,18,24,-6
23,17,261,8,19,-11
23,17,262,22,29,-7
23,17,263,16,15,1
23,17,264,12,11,1
23,17,265,17,14,3
23,17,266,8,17,-9
23,17,267,13,8,5
23,17,268,18,24,-6
23,17,269,11,15,-4
23,17,270,6,10,-4
23,17,271,12,9,3
23,17,272,19,18,1
23,17,273,19,9,10
23,17,274,8,9,-1
23,17,275,12,12,0
23,17,276,13,21,-8
23,17,277,7,18,-11
23,17,278,16,18,-2
23,17,279,12,16,-4
23,17,280,15,12,3
23,17,281,11,19,-8
23,17,282,13,9,4
23,17,283,12,14,-2
23,17,284,8,17,-9
23,17,285,6,21,-15
23,17,286,16,14,2
23,17,287,10,8,2
23,17,288,14,19,-5
23,17,289,8,15,-7
23,17,290,16,14,2
23,17,291,13,17,-4
23,17,292,11,14,-3
23,17,293,10,15,-5
23,17,294,18,12,6
23,17,295,4,9,-5
23,17,296,11,25,-14
23,17,297,15,27,-12
23,17,298,10,23,-13
23,17,299,8,12,-4
23,18,0,18,8,10
23,18,1,8,7,1
23,18,2,11,13,-2
23,18,3,8,13,-5
23,18,4,12,7,5
23,18,5,7,8,-1
23,18,6,9,9,0
23,18,7,21,17,4
23,18,8,12,15,-3
23,18,9,7,21,-14
23,18,10,16,12,4
23,18,11,9,15,-6
23,18,12,26,10,16
23,18,13,11,14,-3
23,18,14,7,17,-10
23,18,15,22,22,0
23,18,16,11,19,-8
23,18,17,4,33,-29
23,18,18,9,11,-2
23,18,19,18,9,9
23,18,20,11,10,1
23,18,21,1,11,-10
23,18,22,15,18,-3
23,18,23,8,14,-6
23,18,24,16,14,2
23,18,25,21,26,-5
23,18,26,9,15,-6
23,18,27,18,12,6
23,18,28,12,16,-4
23,18,29,15,25,-10
23,18,30,10,18,-8
23,18,31,15,10,5
23,18,32,16,21,-5
23,18,33,17,19,-2
23,18,34,10,10,0
23,18,35,22,22,0
23,18,36,11,18,-7
23,18,37,9,7,2
23,18,38,16,18,-2
23,18,39,9,12,-3
23,18,40,23,30,-7
23,18,41,4,23,-19
23,18,42,5,17,-12
23,18,43,8,15,-7
23,18,44,25,18,7
23,18,45,9,7,2
23,18,46,17,6,11
23,18,47,22,22,0
23,18,48,9,11,-2
23,18,49,4,13,-9
23,18,50,13,21,-8
23,18,51,12,17,-5
23,18,52,7,13,-6
23,18,53,24,18,6
23,18,54,14,13,1
23,18,55,6,8,-2
23,18,56,11,16,-5
23,18,57,11,14,-3
23,18,58,7,9,-2
23,18,59,24,20,4
23,18,60,8,12,-4
23,18,61,5,8,-3
23,18,62,8,18,-10
23,18,63,4,9,-5
23,18,64,10,13,-3
23,18,65,14,18,-4
23,18,66,6,14,-8
23,18,67,21,15,6
23,18,68,14,17,-3
23,18,69,21,18,3
23,18,70,13,21,-8
23,18,71,14,12,2
23,18,72,15,18,-3
23,18,73,2,24,-22
23,18,74,7,9,-2
23,18,75,11,14,-3
23,18,76,12,30,-18
23,18,77,8,12,-4
23,18,78,0,9,-9
23,18,79,4,11,-7
23,18,80,11,17,-6
23,18,81,19,17,2
23,18,82,8,15,-7
23,18,83,8,3,5
23,18,84,0,7,-7
23,18,85,14,20,-6
23,18,86,12,22,-10
23,18,87,16,35,-19
23,18,88,10,12,-2
23,18,89,15,16,-1
23,18,90,19,25,-6
23,18,91,11,17,-6
23,18,92,1,10,-9
23,18,93,2,12,-10
23,18,94,14,18,-4
23,18,95,14,9,5
23,18,96,12,12,0
23,18,97,16,28,-12
23,18,98,10,10,0
23,18,99,19,15,4
23,18,100,8,16,-8
23,18,101,18,11,7
23,18,102,12,26,-14
23,18,103,12,17,-5
23,18,104,7,22,-15
23,18,105,4,9,-5
23,18,106,8,6,2
23,18,107,28,10,18
23,18,108,18,11,7
23,18,109,25,14,11
23,18,110,12,19,-7
23,18,111,16,21,-5
23,18,112,24,17,7
23,18,113,15,11,4
23,18,114,11,18,-7
23,18,115,13,17,-4
23,18,116,4,7,-3
23,18,117,5,24,-19
23,18,118,20,12,8
23,18,119,32,24,8
23,18,120,21,16,5
23,18,121,12,10,2
23,18,122,16,18,-2
23,18,123,17,6,11
23,18,124,14,24,-10
23,18,125,6,16,-10
23,18,126,10,23,-13
23,18,127,10,5,5
23,18,128,10,7,3
23,18,129,17,18,-1
23,18,130,12,19,-7
23,18,131,11,24,-13
23,18,132,17,18,-1
23,18,133,23,9,14
23,18,134,3,20,-17
23,18,135,14,25,-11
23,18,136,12,21,-9
23,18,137,10,18,-8
23,18,138,11,17,-6
23,18,139,17,7,10
23,18,140,16,20,-4
23,18,141,21,17,4
23,18,142,14,18,-4
23,18,143,16,23,-7
23,18,144,8,6,2
23,18,145,12,29,-17
23,18,146,37,24,13
23,18,147,15,9,6
23,18,148,10,22,-12
23,18,149,10,14,-4
23,18,150,19,15,4
23,18,151,14,27,-13
23,18,152,16,20,-4
23,18,153,12,3,9
23,18,154,16,15,1
23,18,155,14,11,3
23,18,156,11,22,-11
23,18,157,14,14,0
23,18,158,28,30,-2
23,18,159,18,22,-4
23,18,160,14,32,-18
23,18,161,14,17,-3
23,18,162,18,16,2
23,18,163,18,25,-7
23,18,164,9,15,-6
23,18,165,16,13,3
23,18,166,11,14,-3
23,18,167,16,9,7
23,18,168,12,11,1
23,18,169,11,22,-11
23,18,170,11,19,-8
23,18,171,12,13,-1
23,18,172,5,12,-7
23,18,173,11,10,1
23,18,174,7,21,-14
23,18,175,13,10,3
23,18,176,19,19,0
23,18,177,17,17,0
23,18,178,9,11,-2
23,18,179,11,11,0
23,18,180,12,9,3
23,18,181,7,7,0
23,18,182,15,12,3
23,18,183,26,25,1
23,18,184,7,18,-11
23,18,185,23,9,14
23,18,186,15,14,1
23,18,187,17,26,-9
23,18,188,18,6,12
23,18,189,13,25,-12
23,18,190,11,11,0
23,18,191,9,16,-7
23,18,192,3,14,-11
23,18,193,11,6,5
23,18,194,8,12,-4
23,18,195,12,19,-7
23,18,196,5,20,-15
23,18,197,14,18,-4
23,18,198,11,14,-3
23,18,199,19,24,-5
23,18,200,16,27,-11
23,18,201,16,7,9
23,18,202,17,16,1
23,18,203,10,8,2
23,18,204,6,6,0
23,18,205,8,22,-14
23,18,206,7,14,-7
23,18,207,8,8,0
23,18,208,19,7,12
23,18,209,11,24,-13
23,18,210,13,4,9
23,18,211,14,22,-8
23,18,212,15,15,0
23,18,213,22,11,11
23,18,214,13,7,6
23,18,215,12,17,-5
23,18,216,11,16,-5
23,18,217,11,20,-9
23,18,218,0,3,-3
23,18,219,7,16,-9
23,18,220,11,21,-10
23,18,221,4,12,-8
23,18,222,15,18,-3
23,18,223,15,19,-4
23,18,224,5,19,-14
23,18,225,24,15,9
23,18,226,22,18,4
23,18,227,9,9,0
23,18,228,6,14,-8
23,18,229,19,17,2
23,18,230,19,5,14
23,18,231,16,10,6
23,18,232,14,20,-6
23,18,233,19,12,7
23,18,234,12,18,-6
23,18,235,14,27,-13
23,18,236,15,4,11
23,18,237,26,17,9
23,18,238,15,15,0
23,18,239,15,10,5
23,18,240,18,22,-4
23,18,241,9,8,1
23,18,242,22,15,7
23,18,243,16,23,-7
23,18,244,13,12,1
23,18,245,22,40,-18
23,18,246,15,20,-5
23,18,247,16,22,-6
23,18,248,14,8,6
23,18,249,18,19,-1
23,18,250,8,7,1
23,18,251,6,7,-1
23,18,252,22,16,6
23,18,253,9,18,-9
23,18,254,11,34,-23
23,18,255,11,6,5
23,18,256,11,8,3
23,18,257,18,8,10
23,18,258,13,10,3
23,18,259,17,19,-2
23,18,260,20,33,-13
23,18,261,13,18,-5
23,18,262,17,20,-3
23,18,263,16,12,4
23,18,264,14,15,-1
23,18,265,15,17,-2
23,18,266,15,17,-2
23,18,267,10,11,-1
23,18,268,23,9,14
23,18,269,15,25,-10
23,18,270,12,19,-7
23,18,271,9,7,2
23,18,272,12,16,-4
23,18,273,2,16,-14
23,18,274,7,12,-5
23,18,275,7,9,-2
23,18,276,10,21,-11
23,18,277,8,17,-9
23,18,278,11,9,2
23,18,279,13,17,-4
23,18,280,9,16,-7
23,18,281,24,11,13
23,18,282,13,4,9
23,18,283,9,23,-14
23,18,284,22,5,17
23,18,285,15,13,2
23,18,286,12,23,-11
23,18,287,15,9,6
23,18,288,11,13,-2
23,18,289,13,19,-6
23,18,290,11,13,-2
23,18,291,25,18,7
23,18,292,25,18,7
23,18,293,5,3,2
23,18,294,21,12,9
23,18,295,9,17,-8
23,18,296,7,17,-10
23,18,297,2,7,-5
23,18,298,24,25,-1
23,18,299,9,26,-17
23,19,0,5,8,-3
23,19,1,4,13,-9
23,19,2,8,9,-1
23,19,3,8,17,-9
23,19,4,0,16,-16
23,19,5,18,17,1
23,19,6,10,8,2
23,19,7,12,18,-6
23,19,8,18,14,4
23,19,9,6,15,-9
23,19,10,22,15,7
23,19,11,21,11,10
23,19,12,9,16,-7
23,19,13,17,23,-6
23,19,14,18,9,9
23,19,15,6,20,-14
23,19,16,16,10,6
23,19,17,12,12,0
23,19,18,13,14,-1
23,19,19,12,15,-3
23,19,20,9,8,1
23,19,21,20,4,16
23,19,22,13,28,-15
23,19,23,29,18,11
23,19,24,18,15,3
23,19,25,27,25,2
23,19,26,16,20,-4
23,19,27,11,21,-10
23,19,28,15,7,8
23,19,29,7,25,-18
23,19,30,14,15,-1
23,19,31,6,33,-27
23,19,32,14,21,-7
23,19,33,11,15,-4
23,19,34,19,21,-2
23,19,35,20,14,6
23,19,36,13,18,-5
23,19,37,22,13,9
23,19,38,8,12,-4
23,19,39,14,17,-3
23,19,40,7,12,-5
23,19,41,23,22,1
23,19,42,11,10,1
23,19,43,11,6,5
23,19,44,8,11,-3
23,19,45,18,14,4
23,19,46,11,13,-2
23,19,47,11,11,0
23,19,48,20,14,6
23,19,49,7,8,-1
23,19,50,16,18,-2
23,19,51,21,27,-6
23,19,52,9,10,-1
23,19,53,21,18,3
23,19,54,2,19,-17
23,19,55,13,21,-8
23,19,56,12,11,1
23,19,57,17,7,10
23,19,58,12,26,-14
23,19,59,15,25,-10
23,19,60,14,22,-8
23,19,61,12,18,-6
23,19,62,12,6,6
23,19,63,7,25,-18
23,19,64,3,18,-15
23,19,65,10,6,4
23,19,66,11,18,-7
23,19,67,13,36,-23
23,19,68,9,11,-2
23,19,69,13,23,-10
23,19,70,23,22,1
23,19,71,15,15,0
23,19,72,14,11,3
23,19,73,14,26,-12
23,19,74,25,13,12
23,19,75,20,21,-1
23,19,76,2,5,-3
23,19,77,15,8,7
23,19,78,7,11,-4
23,19,79,14,3,11
23,19,80,16,20,-4
23,19,81,13,9,4
23,19,82,17,11,6
23,19,83,10,8,2
23,19,84,12,13,-1
23,19,85,21,19,2
23,19,86,17,11,6
23,19,87,14,22,-8
23,19,88,10,14,-4
23,19,89,12,21,-9
23,19,90,16,31,-15
23,19,91,10,11,-1
23,19,92,16,11,5
23,19,93,24,26,-2
23,19,94,13,18,-5
23,19,95,8,17,-9
23,19,96,8,13,-5
23,19,97,6,9,-3
23,19,98,18,23,-5
23,19,99,13,18,-5
23,19,100,16,20,-4
23,19,101,7,13,-6
23,19,102,16,17,-1
23,19,103,16,12,4
23,19,104,21,17,4
23,19,105,16,20,-4
23,19,106,21,24,-3
23,19,107,17,13,4
23,19,108,10,16,-6
23,19,109,8,8,0
23,19,110,15,13,2
23,19,111,9,19,-10
23,19,112,7,9,-2
23,19,113,4,7,-3
23,19,114,10,7,3
23,19,115,17,13,4
23,19,116,14,10,4
23,19,117,19,8,11
23,19,118,14,22,-8
23,19,119,13,16,-3
23,19,120,12,26,-14
23,19,121,17,30,-13
23,19,122,12,13,-1
23,19,123,8,14,-6
23,19,124,13,11,2
23,19,125,16,17,-1
23,19,126,15,24,-9
23,19,127,7,17,-10
23,19,128,21,17,4
23,19,129,15,9,6
23,19,130,7,22,-15
23,19,131,13,22,-9
23,19,132,9,17,-8
23,19,133,20,24,-4
23,19,134,12,15,-3
23,19,135,14,21,-7
23,19,136,7,10,-3
23,19,137,12,10,2
23,19,138,17,16,1
23,19,139,6,14,-8
23,19,140,24,14,10
23,19,141,7,16,-9
23,19,142,5,9,-4
23,19,143,11,11,0
23,19,144,14,18,-4
23,19,145,17,25,-8
23,19,146,8,13,-5
23,19,147,13,17,-4
23,19,148,13,20,-7
23,19,149,16,11,5
23,19,150,18,16,2
23,19,151,10,15,-5
23,19,152,13,16,-3
23,19,153,19,16,3
23,19,154,9,16,-7
23,19,155,11,22,-11
23,19,156,7,13,-6
23,19,157,17,12,5
23,19,158,17,14,3
23,19,159,16,14,2
23,19,160,9,17,-8
23,19,161,13,6,7
23,19,162,11,14,-3
23,19,163,10,14,-4
23,19,164,13,16,-3
23,19,165,13,5,8
23,19,166,14,13,1
23,19,167,9,15,-6
23,19,168,12,19,-7
23,19,169,15,13,2
23,19,170,8,18,-10
23,19,171,8,9,-1
23,19,172,12,9,3
23,19,173,28,18,10
23,19,174,11,8,3
23,19,175,3,8,-5
23,19,176,5,7,-2
23,19,177,18,20,-2
23,19,178,16,22,-6
23,19,179,5,13,-8
23,19,180,8,17,-9
23,19,181,14,14,0
23,19,182,13,18,-5
23,19,183,4,22,-18
23,19,184,13,12,1
23,19,185,14,14,0
23,19,186,19,25,-6
23,19,187,16,18,-2
23,19,188,13,12,1
23,19,189,24,26,-2
23,19,190,12,28,-16
23,19,191,14,10,4
23,19,192,17,21,-4
23,19,193,28,15,13
23,19,194,21,19,2
23,19,195,18,14,4
23,19,196,21,19,2
23,19,197,20,8,12
23,19,198,14,15,-1
23,19,199,7,17,-10
23,19,200,11,20,-9
23,19,201,26,23,3
23,19,202,7,26,-19
23,19,203,7,9,-2
23,19,204,9,23,-14
23,19,205,20,17,3
23,19,206,10,13,-3
23,19,207,26,24,2
23,19,208,16,13,3
23,19,209,27,16,11
23,19,210,11,10,1
23,19,211,20,16,4
23,19,212,16,22,-6
23,19,213,10,25,-15
23,19,214,8,17,-9
23,19,215,8,12,-4
23,19,216,19,18,1
23,19,217,6,11,-5
23,19,218,10,12,-2
23,19,219,15,20,-5
23,19,220,10,20,-10
23,19,221,17,25,-8
23,19,222,2,12,-10
23,19,223,18,24,-6
23,19,224,10,11,-1
23,19,225,21,13,8
23,19,226,11,17,-6
23,19,227,11,19,-8
23,19,228,24,12,12
23,19,229,15,14,1
23,19,230,13,15,-2
23,19,231,16,34,-18
23,19,232,11,32,-21
23,19,233,15,15,0
23,19,234,5,16,-11
23,19,235,17,16,1
23,19,236,16,9,7
23,19,237,11,6,5
23,19,238,14,8,6
23,19,239,12,8,4
23,19,240,18,18,0
23,19,241,20,21,-1
23,19,242,24,27,-3
23,19,243,17,16,1
23,19,244,8,6,2
23,19,245,19,5,14
23,19,246,17,16,1
23,19,247,17,25,-8
23,19,248,17,25,-8
23,19,249,17,7,10
23,19,250,23,14,9
23,19,251,19,7,12
23,19,252,17,18,-1
23,19,253,9,12,-3
23,19,254,11,14,-3
23,19,255,14,18,-4
23,19,256,19,29,-10
23,19,257,17,13,4
23,19,258,20,17,3
23,19,259,14,10,4
23,19,260,15,11,4
23,19,261,15,29,-14
23,19,262,19,21,-2
23,19,263,14,16,-2
23,19,264,19,23,-4
23,19,265,10,16,-6
23,19,266,10,11,-1
23,19,267,16,20,-4
23,19,268,11,11,0
23,19,269,5,11,-6
23,19,270,18,20,-2
23,19,271,10,16,-6
23,19,272,20,22,-2
23,19,273,5,27,-22
23,19,274,11,11,0
23,19,275,17,24,-7
23,19,276,16,5,11
23,19,277,21,11,10
23,19,278,18,25,-7
23,19,279,15,16,-1
23,19,280,11,10,1
23,19,281,16,17,-1
23,19,282,16,9,7
23,19,283,18,16,2
23,19,284,7,9,-2
23,19,285,18,33,-15
23,19,286,12,11,1
23,19,287,10,5,5
23,19,288,15,15,0
23,19,289,18,21,-3
23,19,290,27,36,-9
23,19,291,19,11,8
23,19,292,17,13,4
23,19,293,5,16,-11
23,19,294,7,9,-2
23,19,295,11,24,-13
23,19,296,17,12,5
23,19,297,18,16,2
23,19,298,15,21,-6
23,19,299,16,20,-4
23,20,0,8,13,-5
23,20,1,10,16,-6
23,20,2,12,18,-6
23,20,3,15,18,-3
23,20,4,13,17,-4
23,20,5,2,12,-10
23,20,6,16,12,4
23,20,7,21,22,-1
23,20,8,13,12,1
23,20,9,6,14,-8
23,20,10,24,11,13
23,20,11,5,15,-10
23,20,12,12,18,-6
23,20,13,10,16,-6
23,20,14,13,26,-13
23,20,15,7,7,0
23,20,16,12,13,-1
23,20,17,15,8,7
23,20,18,14,11,3
23,20,19,16,17,-1
23,20,20,15,18,-3
23,20,21,23,13,10
23,20,22,12,27,-15
23,20,23,7,22,-15
23,20,24,17,11,6
23,20,25,16,28,-12
23,20,26,6,17,-11
23,20,27,8,10,-2
23,20,28,19,9,10
23,20,29,6,4,2
23,20,30,11,14,-3
23,20,31,11,7,4
23,20,32,11,14,-3
23,20,33,9,15,-6
23,20,34,5,14,-9
23,20,35,16,20,-4
23,20,36,18,22,-4
23,20,37,21,24,-3
23,20,38,16,20,-4
23,20,39,9,25,-16
23,20,40,12,23,-11
23,20,41,18,24,-6
23,20,42,13,9,4
23,20,43,15,12,3
23,20,44,6,19,-13
23,20,45,10,23,-13
23,20,46,26,13,13
23,20,47,16,14,2
23,20,48,14,8,6
23,20,49,12,18,-6
23,20,50,8,20,-12
23,20,51,5,17,-12
23,20,52,14,11,3
23,20,53,14,17,-3
23,20,54,4,9,-5
23,20,55,15,17,-2
23,20,56,12,26,-14
23,20,57,25,16,9
23,20,58,19,18,1
23,20,59,7,17,-10
23,20,60,10,11,-1
23,20,61,12,11,1
23,20,62,10,15,-5
23,20,63,12,19,-7
23,20,64,12,17,-5
23,20,65,25,23,2
23,20,66,8,17,-9
23,20,67,11,20,-9
23,20,68,18,29,-11
23,20,69,12,18,-6
23,20,70,10,15,-5
23,20,71,10,17,-7
23,20,72,17,12,5
23,20,73,18,25,-7
23,20,74,25,13,12
23,20,75,11,18,-7
23,20,76,19,10,9
23,20,77,14,3,11
23,20,78,13,12,1
23,20,79,12,21,-9
23,20,80,14,14,0
23,20,81,21,26,-5
23,20,82,7,26,-19
23,20,83,9,17,-8
23,20,84,15,24,-9
23,20,85,27,14,13
23,20,86,10,11,-1
23,20,87,17,16,1
23,20,88,9,13,-4
23,20,89,11,12,-1
23,20,90,17,18,-1
23,20,91,17,16,1
23,20,92,22,21,1
23,20,93,26,15,11
23,20,94,10,2,8
23,20,95,23,17,6
23,20,96,7,7,0
23,20,97,6,12,-6
23,20,98,12,21,-9
23,20,99,16,11,5
23,20,100,25,20,5
23,20,101,20,19,1
23,20,102,8,8,0
23,20,103,13,16,-3
23,20,104,9,21,-12
23,20,105,19,8,11
23,20,106,11,18,-7
23,20,107,14,17,-3
23,20,108,9,13,-4
23,20,109,16,20,-4
23,20,110,15,19,-4
23,20,111,6,24,-18
23,20,112,6,13,-7
23,20,113,29,27,2
23,20,114,12,12,0
23,20,115,9,16,-7
23,20,116,22,6,16
23,20,117,15,23,-8
23,20,118,8,10,-2
23,20,119,10,11,-1
23,20,120,5,12,-7
23,20,121,13,18,-5
23,20,122,14,19,-5
23,20,123,9,21,-12
23,20,124,11,23,-12
23,20,125,15,14,1
23,20,126,16,10,6
23,20,127,9,6,3
23,20,128,7,11,-4
23,20,129,14,21,-7
23,20,130,14,12,2
23,20,131,7,6,1
23,20,132,12,16,-4
23,20,133,4,22,-18
23,20,134,14,14,0
23,20,135,14,14,0
23,20,136,3,18,-15
23,20,137,17,14,3
23,20,138,11,19,-8
23,20,139,13,22,-9
23,20,140,15,21,-6
23,20,141,12,15,-3
23,20,142,13,12,1
23,20,143,16,12,4
23,20,144,17,23,-6
23,20,145,8,14,-6
23,20,146,12,7,5
23,20,147,10,20,-10
23,20,148,9,11,-2
23,20,149,17,18,-1
23,20,150,18,23,-5
23,20,151,12,10,2
23,20,152,10,21,-11
23,20,153,10,16,-6
23,20,154,3,10,-7
23,20,155,19,22,-3
23,20,156,11,13,-2
23,20,157,15,17,-2
23,20,158,20,19,1
23,20,159,16,21,-5
23,20,160,8,5,3
23,20,161,17,14,3
23,20,162,17,21,-4
23,20,163,22,16,6
23,20,164,17,7,10
23,20,165,20,11,9
23,20,166,6,16,-10
23,20,167,15,22,-7
23,20,168,5,26,-21
23,20,169,15,16,-1
23,20,170,8,16,-8
23,20,171,23,19,4
23,20,172,4,11,-7
23,20,173,12,15,-3
23,20,174,21,36,-15
23,20,175,11,8,3
23,20,176,12,12,0
23,20,177,7,19,-12
23,20,178,10,13,-3
23,20,179,14,11,3
23,20,180,11,18,-7
23,20,181,24,20,4
23,20,182,10,12,-2
23,20,183,15,18,-3
23,20,184,14,17,-3
23,20,185,12,22,-10
23,20,186,10,15,-5
23,20,187,11,10,1
23,20,188,13,6,7
23,20,189,14,16,-2
23,20,190,11,8,3
23,20,191,26,14,12
23,20,192,25,23,2
23,20,193,13,21,-8
23,20,194,13,15,-2
23,20,195,18,22,-4
23,20,196,12,18,-6
23,20,197,19,9,10
23,20,198,9,31,-22
23,20,199,19,25,-6
23,20,200,14,18,-4
23,20,201,12,22,-10
23,20,202,13,7,6
23,20,203,25,20,5
23,20,204,5,14,-9
23,20,205,19,19,0
23,20,206,21,19,2
23,20,207,21,13,8
23,20,208,29,23,6
23,20,209,12,12,0
23,20,210,9,8,1
23,20,211,9,36,-27
23,20,212,22,16,6
23,20,213,20,18,2
23,20,214,21,19,2
23,20,215,8,17,-9
23,20,216,12,19,-7
23,20,217,14,18,-4
23,20,218,6,10,-4
23,20,219,16,22,-6
23,20,220,16,25,-9
23,20,221,6,8,-2
23,20,222,20,17,3
23,20,223,26,20,6
23,20,224,16,22,-6
23,20,225,23,43,-20
23,20,226,17,26,-9
23,20,227,13,7,6
23,20,228,22,12,10
23,20,229,6,26,-20
23,20,230,18,17,1
23,20,231,12,13,-1
23,20,232,14,15,-1
23,20,233,24,25,-1
23,20,234,14,23,-9
23,20,235,8,15,-7
23,20,236,12,15,-3
23,20,237,9,16,-7
23,20,238,14,15,-1
23,20,239,6,22,-16
23,20,240,14,9,5
23,20,241,5,12,-7
23,20,242,15,19,-4
23,20,243,17,13,4
23,20,244,15,14,1
23,20,245,16,15,1
23,20,246,11,18,-7
23,20,247,11,11,0
23,20,248,14,20,-6
23,20,249,13,16,-3
23,20,250,7,5,2
23,20,251,14,4,10
23,20,252,15,20,-5
23,20,253,13,21,-8
23,20,254,7,18,-11
23,20,255,10,11,-1
23,20,256,7,24,-17
23,20,257,6,14,-8
23,20,258,14,20,-6
23,20,259,11,19,-8
23,20,260,12,16,-4
23,20,261,24,18,6
23,20,262,17,20,-3
23,20,263,19,11,8
23,20,264,10,11,-1
23,20,265,8,14,-6
23,20,266,17,20,-3
23,20,267,25,27,-2
23,20,268,23,17,6
23,20,269,7,24,-17
23,20,270,24,11,13
23,20,271,17,20,-3
23,20,272,7,15,-8
23,20,273,20,16,4
23,20,274,15,20,-5
23,20,275,15,22,-7
23,20,276,6,11,-5
23,20,277,23,9,14
23,20,278,5,5,0
23,20,279,12,29,-17
23,20,280,19,16,3
23,20,281,8,3,5
23,20,282,19,13,6
23,20,283,14,19,-5
23,20,284,6,5,1
23,20,285,12,14,-2
23,20,286,10,11,-1
23,20,287,5,6,-1
23,20,288,20,14,6
23,20,289,15,18,-3
23,20,290,22,8,14
23,20,291,20,21,-1
23,20,292,4,9,-5
23,20,293,14,13,1
23,20,294,15,23,-8
23,20,295,16,10,6
23,20,296,16,20,-4
23,20,297,21,30,-9
23,20,298,8,6,2
23,20,299,7,16,-9
23,21,0,9,8,1
23,21,1,11,10,1
23,21,2,20,26,-6
23,21,3,10,6,4
23,21,4,6,16,-10
23,21,5,17,7,10
23,21,6,18,21,-3
23,21,7,14,16,-2
23,21,8,18,19,-1
23,21,9,19,19,0
23,21,10,19,18,1
23,21,11,6,14,-8
23,21,12,7,23,-16
23,21,13,9,9,0
23,21,14,10,30,-20
23,21,15,8,14,-6
23,21,16,17,19,-2
23,21,17,10,26,-16
23,21,18,12,16,-4
23,21,19,8,17,-9
23,21,20,14,18,-4
23,21,21,5,24,-19
23,21,22,12,14,-2
23,21,23,15,16,-1
23,21,24,9,10,-1
23,21,25,15,19,-4
23,21,26,20,18,2
23,21,27,7,9,-2
23,21,28,13,11,2
23,21,29,10,18,-8
23,21,30,9,24,-15
23,21,31,13,18,-5
23,21,32,12,20,-8
23,21,33,8,11,-3
23,21,34,5,22,-17
23,21,35,4,12,-8
23,21,36,6,4,2
23,21,37,17,20,-3
23,21,38,8,6,2
23,21,39,7,18,-11
23,21,40,13,10,3
23,21,41,5,15,-10
23,21,42,17,12,5
23,21,43,16,20,-4
23,21,44,12,11,1
23,21,45,7,16,-9
23,21,46,17,15,2
23,21,47,22,20,2
23,21,48,10,10,0
23,21,49,11,14,-3
23,21,50,19,8,11
23,21,51,8,27,-19
23,21,52,8,12,-4
23,21,53,10,8,2
23,21,54,7,14,-7
23,21,55,4,9,-5
23,21,56,8,12,-4
23,21,57,11,10,1
23,21,58,8,22,-14
23,21,59,11,16,-5
23,21,60,18,32,-14
23,21,61,13,15,-2
23,21,62,10,8,2
23,21,63,13,19,-6
23,21,64,6,11,-5
23,21,65,20,22,-2
23,21,66,16,15,1
23,21,67,15,17,-2
23,21,68,15,25,-10
23,21,69,16,16,0
23,21,70,13,26,-13
23,21,71,11,9,2
23,21,72,11,16,-5
23,21,73,16,14,2
23,21,74,8,13,-5
23,21,75,3,13,-10
23,21,76,11,18,-7
23,21,77,18,24,-6
23,21,78,12,9,3
23,21,79,22,23,-1
23,21,80,13,20,-7
23,21,81,16,13,3
23,21,82,14,9,5
23,21,83,10,16,-6
23,21,84,8,12,-4
23,21,85,17,17,0
23,21,86,12,8,4
23,21,87,11,8,3
23,21,88,17,12,5
23,21,89,11,2,9
23,21,90,10,11,-1
23,21,91,10,15,-5
23,21,92,13,17,-4
23,21,93,24,17,7
23,21,94,8,13,-5
23,21,95,5,9,-4
23,21,96,17,21,-4
23,21,97,16,23,-7
23,21,98,14,8,6
23,21,99,20,31,-11
23,21,100,12,18,-6
23,21,101,12,23,-11
23,21,102,0,8,-8
23,21,103,16,19,-3
23,21,104,10,14,-4
23,21,105,6,28,-22
23,21,106,8,14,-6
23,21,107,18,8,10
23,21,108,15,16,-1
23,21,109,8,12,-4
23,21,110,13,7,6
23,21,111,16,16,0
23,21,112,11,13,-2
23,21,113,17,12,5
23,21,114,11,14,-3
23,21,115,18,18,0
23,21,116,15,22,-7
23,21,117,12,20,-8
23,21,118,6,9,-3
23,21,119,18,21,-3
23,21,120,16,20,-4
23,21,121,9,20,-11
23,21,122,8,13,-5
23,21,123,12,26,-14
23,21,124,14,16,-2
23,21,125,10,14,-4
23,21,126,27,27,0
23,21,127,14,15,-1
23,21,128,29,17,12
23,21,129,13,20,-7
23,21,130,5,20,-15
23,21,131,26,16,10
23,21,132,12,17,-5
23,21,133,17,11,6
23,21,134,9,14,-5
23,21,135,12,13,-1
23,21,136,4,18,-14
23,21,137,20,14,6
23,21,138,5,11,-6
23,21,139,17,17,0
23,21,140,8,10,-2
23,21,141,16,23,-7
23,21,142,22,19,3
23,21,143,16,30,-14
23,21,144,7,10,-3
23,21,145,25,14,11
23,21,146,24,24,0
23,21,147,13,18,-5
23,21,148,21,30,-9
23,21,149,4,15,-11
23,21,150,6,15,-9
23,21,151,9,11,-2
23,21,152,26,23,3
23,21,153,12,5,7
23,21,154,5,10,-5
23,21,155,19,30,-11
23,21,156,17,17,0
23,21,157,15,16,-1
23,21,158,6,12,-6
23,21,159,14,15,-1
23,21,160,20,17,3
23,21,161,13,27,-14
23,21,162,16,19,-3
23,21,163,9,17,-8
23,21,164,12,15,-3
23,21,165,12,15,-3
23,21,166,9,14,-5
23,21,167,15,34,-19
23,21,168,11,6,5
23,21,169,17,22,-5
23,21,170,7,15,-8
23,21,171,18,26,-8
23,21,172,18,22,-4
23,21,173,24,25,-1
23,21,174,30,22,8
23,21,175,12,12,0
23,21,176,9,12,-3
23,21,177,13,17,-4
23,21,178,7,15,-8
23,21,179,18,22,-4
23,21,180,6,16,-10
23,21,181,17,11,6
23,21,182,9,8,1
23,21,183,7,3,4
23,21,184,6,16,-10
23,21,185,14,23,-9
23,21,186,11,15,-4
23,21,187,13,12,1
23,21,188,17,20,-3
23,21,189,15,21,-6
23,21,190,9,10,-1
23,21,191,9,6,3
23,21,192,19,28,-9
23,21,193,12,13,-1
23,21,194,4,10,-6
23,21,195,10,7,3
23,21,196,20,16,4
23,21,197,12,16,-4
23,21,198,12,15,-3
23,21,199,20,19,1
23,21,200,15,27,-12
23,21,201,14,10,4
23,21,202,20,13,7
23,21,203,6,7,-1
23,21,204,8,16,-8
23,21,205,9,12,-3
23,21,206,11,21,-10
23,21,207,8,11,-3
23,21,208,19,20,-1
23,21,209,8,20,-12
23,21,210,18,10,8
23,21,211,15,17,-2
23,21,212,11,10,1
23,21,213,5,14,-9
23,21,214,21,30,-9
23,21,215,6,13,-7
23,21,216,18,17,1
23,21,217,10,8,2
23,21,218,19,18,1
23,21,219,9,22,-13
23,21,220,16,14,2
23,21,221,13,26,-13
23,21,222,12,19,-7
23,21,223,21,20,1
23,21,224,21,24,-3
23,21,225,10,10,0
23,21,226,10,15,-5
23,21,227,12,12,0
23,21,228,22,17,5
23,21,229,11,15,-4
23,21,230,14,13,1
23,21,231,21,14,7
23,21,232,25,18,7
23,21,233,8,14,-6
23,21,234,15,22,-7
23,21,235,24,30,-6
23,21,236,12,5,7
23,21,237,5,12,-7
23,21,238,5,14,-9
23,21,239,13,13,0
23,21,240,14,14,0
23,21,241,13,7,6
23,21,242,4,18,-14
23,21,243,12,15,-3
23,21,244,14,14,0
23,21,245,23,23,0
23,21,246,22,15,7
23,21,247,6,11,-5
23,21,248,9,21,-12
23,21,249,10,21,-11
23,21,250,12,23,-11
23,21,251,12,13,-1
23,21,252,7,14,-7
23,21,253,18,11,7
23,21,254,18,17,1
23,21,255,11,11,0
23,21,256,7,21,-14
23,21,257,16,16,0
23,21,258,18,12,6
23,21,259,8,23,-15
23,21,260,9,21,-12
23,21,261,13,16,-3
23,21,262,13,11,2
23,21,263,17,21,-4
23,21,264,9,9,0
23,21,265,11,13,-2
23,21,266,28,24,4
23,21,267,14,13,1
23,21,268,9,14,-5
23,21,269,19,21,-2
23,21,270,9,16,-7
23,21,271,5,15,-10
23,21,272,13,12,1
23,21,273,10,16,-6
23,21,274,14,11,3
23,21,275,11,11,0
23,21,276,8,16,-8
23,21,277,19,12,7
23,21,278,9,15,-6
23,21,279,7,8,-1
23,21,280,7,19,-12
23,21,281,22,13,9
23,21,282,12,14,-2
23,21,283,19,27,-8
23,21,284,9,13,-4
23,21,285,7,11,-4
23,21,286,35,17,18
23,21,287,18,10,8
23,21,288,9,26,-17
23,21,289,15,16,-1
23,21,290,14,7,7
23,21,291,14,16,-2
23,21,292,23,32,-9
23,21,293,10,11,-1
23,21,294,10,18,-8
23,21,295,21,12,9
23,21,296,15,11,4
23,21,297,17,13,4
23,21,298,10,18,-8
23,21,299,24,30,-6
23,22,0,12,13,-1
23,22,1,11,8,3
23,22,2,8,8,0
23,22,3,6,15,-9
23,22,4,11,12,-1
23,22,5,5,12,-7
23,22,6,9,20,-11
23,22,7,11,10,1
23,22,8,5,5,0
23,22,9,11,6,5
23,22,10,15,17,-2
23,22,11,15,10,5
23,22,12,20,15,5
23,22,13,12,17,-5
23,22,14,24,13,11
23,22,15,13,11,2
23,22,16,21,19,2
23,22,17,12,23,-11
23,22,18,27,17,10
23,22,19,8,16,-8
23,22,20,21,13,8
23,22,21,12,17,-5
23,22,22,4,15,-11
23,22,23,11,14,-3
23,22,24,12,16,-4
23,22,25,11,21,-10
23,22,26,7,12,-5
23,22,27,12,21,-9
23,22,28,20,12,8
23,22,29,7,5,2
23,22,30,11,14,-3
23,22,31,17,21,-4
23,22,32,21,10,11
23,22,33,14,13,1
23,22,34,13,16,-3
23,22,35,12,6,6
23,22,36,19,19,0
23,22,37,12,20,-8
23,22,38,8,6,2
23,22,39,10,12,-2
23,22,40,10,16,-6
23,22,41,20,20,0
23,22,42,12,15,-3
23,22,43,9,17,-8
23,22,44,16,24,-8
23,22,45,24,16,8
23,22,46,17,27,-10
23,22,47,14,13,1
23,22,48,14,7,7
23,22,49,11,28,-17
23,22,50,14,11,3
23,22,51,14,11,3
23,22,52,11,27,-16
23,22,53,13,13,0
23,22,54,23,16,7
23,22,55,32,16,16
23,22,56,9,6,3
23,22,57,15,13,2
23,22,58,18,18,0
23,22,59,3,17,-14
23,22,60,7,23,-16
23,22,61,9,19,-10
23,22,62,14,22,-8
23,22,63,22,25,-3
23,22,64,18,18,0
23,22,65,8,7,1
23,22,66,17,21,-4
23,22,67,5,14,-9
23,22,68,13,16,-3
23,22,69,16,12,4
23,22,70,1,6,-5
23,22,71,12,12,0
23,22,72,16,7,9
23,22,73,9,11,-2
23,22,74,18,16,2
23,22,75,7,11,-4
23,22,76,9,11,-2
23,22,77,14,15,-1
23,22,78,13,28,-15
23,22,79,4,10,-6
23,22,80,26,16,10
23,22,81,8,16,-8
23,22,82,12,6,6
23,22,83,18,16,2
23,22,84,12,22,-10
23,22,85,8,12,-4
23,22,86,10,20,-10
23,22,87,15,16,-1
23,22,88,11,17,-6
23,22,89,21,22,-1
23,22,90,11,17,-6
23,22,91,18,20,-2
23,22,92,8,16,-8
23,22,93,20,17,3
23,22,94,8,20,-12
23,22,95,13,16,-3
23,22,96,17,9,8
23,22,97,7,12,-5
23,22,98,8,19,-11
23,22,99,24,28,-4
23,22,100,29,20,9
23,22,101,13,12,1
23,22,102,18,14,4
23,22,103,9,9,0
23,22,104,10,12,-2
23,22,105,24,23,1
23,22,106,7,8,-1
23,22,107,13,9,4
23,22,108,8,7,1
23,22,109,12,15,-3
23,22,110,12,15,-3
23,22,111,15,18,-3
23,22,112,8,16,-8
23,22,113,16,23,-7
23,22,114,15,13,2
23,22,115,12,15,-3
23,22,116,16,25,-9
23,22,117,10,13,-3
23,22,118,14,14,0
23,22,119,11,16,-5
23,22,120,11,13,-2
23,22,121,7,18,-11
23,22,122,12,10,2
23,22,123,9,11,-2
23,22,124,15,8,7
23,22,125,10,25,-15
23,22,126,19,11,8
23,22,127,18,7,11
23,22,128,16,17,-1
23,22,129,13,11,2
23,22,130,16,18,-2
23,22,131,14,21,-7
23,22,132,15,12,3
23,22,133,22,12,10
23,22,134,17,4,13
23,22,135,3,12,-9
23,22,136,7,7,0
23,22,137,22,15,7
23,22,138,24,27,-3
23,22,139,10,21,-11
23,22,140,15,17,-2
23,22,141,6,8,-2
23,22,142,15,18,-3
23,22,143,16,22,-6
23,22,144,17,30,-13
23,22,145,15,8,7
23,22,146,25,29,-4
23,22,147,16,22,-6
23,22,148,20,18,2
23,22,149,14,11,3
23,22,150,10,17,-7
23,22,151,22,11,11
23,22,152,12,14,-2
23,22,153,13,11,2
23,22,154,12,8,4
23,22,155,19,15,4
23,22,156,4,8,-4
23,22,157,16,8,8
23,22,158,15,16,-1
23,22,159,28,23,5
23,22,160,13,13,0
23,22,161,15,20,-5
23,22,162,16,21,-5
23,22,163,7,13,-6
23,22,164,5,6,-1
23,22,165,14,26,-12
23,22,166,9,6,3
23,22,167,7,7,0
23,22,168,9,13,-4
23,22,169,12,13,-1
23,22,170,12,18,-6
23,22,171,16,11,5
23,22,172,16,16,0
23,22,173,16,16,0
23,22,174,14,16,-2
23,22,175,10,17,-7
23,22,176,17,8,9
23,22,177,10,11,-1
23,22,178,14,21,-7
23,22,179,18,13,5
23,22,180,3,11,-8
23,22,181,16,14,2
23,22,182,18,11,7
23,22,183,8,15,-7
23,22,184,3,14,-11
23,22,185,14,18,-4
23,22,186,12,14,-2
23,22,187,10,14,-4
23,22,188,15,14,1
23,22,189,8,16,-8
23,22,190,16,30,-14
23,22,191,10,12,-2
23,22,192,25,13,12
23,22,193,11,11,0
23,22,194,12,18,-6
23,22,195,10,7,3
23,22,196,9,12,-3
23,22,197,9,13,-4
23,22,198,11,8,3
23,22,199,9,10,-1
23,22,200,17,18,-1
23,22,201,20,18,2
23,22,202,9,23,-14
23,22,203,7,14,-7
23,22,204,19,15,4
23,22,205,4,11,-7
23,22,206,20,10,10
23,22,207,18,12,6
23,22,208,7,15,-8
23,22,209,12,12,0
23,22,210,8,14,-6
23,22,211,10,14,-4
23,22,212,14,19,-5
23,22,213,26,13,13
23,22,214,12,11,1
23,22,215,14,11,3
23,22,216,13,10,3
23,22,217,14,21,-7
23,22,218,21,18,3
23,22,219,17,13,4
23,22,220,6,13,-7
23,22,221,12,9,3
23,22,222,11,16,-5
23,22,223,6,16,-10
23,22,224,16,21,-5
23,22,225,12,14,-2
23,22,226,9,10,-1
23,22,227,14,15,-1
23,22,228,12,15,-3
23,22,229,11,12,-1
23,22,230,19,21,-2
23,22,231,11,12,-1
23,22,232,22,11,11
23,22,233,16,26,-10
23,22,234,7,18,-11
23,22,235,18,13,5
23,22,236,13,4,9
23,22,237,6,17,-11
23,22,238,13,16,-3
23,22,239,30,18,12
23,22,240,12,5,7
23,22,241,5,10,-5
23,22,242,9,11,-2
23,22,243,8,17,-9
23,22,244,11,15,-4
23,22,245,10,8,2
23,22,246,13,26,-13
23,22,247,9,22,-13
23,22,248,14,17,-3
23,22,249,5,17,-12
23,22,250,10,8,2
23,22,251,10,21,-11
23,22,252,7,10,-3
23,22,253,6,20,-14
23,22,254,22,16,6
23,22,255,18,26,-8
23,22,256,14,16,-2
23,22,257,11,14,-3
23,22,258,15,14,1
23,22,259,20,25,-5
23,22,260,16,23,-7
23,22,261,16,14,2
23,22,262,15,16,-1
23,22,263,9,19,-10
23,22,264,14,1,13
23,22,265,8,6,2
23,22,266,19,9,10
23,22,267,8,19,-11
23,22,268,17,24,-7
23,22,269,18,17,1
23,22,270,17,17,0
23,22,271,13,14,-1
23,22,272,16,15,1
23,22,273,26,12,14
23,22,274,4,21,-17
23,22,275,11,9,2
23,22,276,4,14,-10
23,22,277,28,20,8
23,22,278,24,26,-2
23,22,279,16,16,0
23,22,280,16,19,-3
23,22,281,5,14,-9
23,22,282,16,20,-4
23,22,283,15,14,1
23,22,284,8,16,-8
23,22,285,11,6,5
23,22,286,22,5,17
23,22,287,13,17,-4
23,22,288,19,11,8
23,22,289,7,8,-1
23,22,290,13,22,-9
23,22,291,9,13,-4
23,22,292,8,6,2
23,22,293,16,13,3
23,22,294,17,13,4
23,22,295,7,17,-10
23,22,296,9,15,-6
23,22,297,20,15,5
23,22,298,19,24,-5
23,22,299,5,13,-8
23,23,0,16,18,-2
23,23,1,11,12,-1
23,23,2,5,9,-4
23,23,3,21,10,11
23,23,4,9,10,-1
23,23,5,13,13,0
23,23,6,2,3,-1
23,23,7,9,27,-18
23,23,8,11,11,0
23,23,9,6,14,-8
23,23,10,16,17,-1
23,23,11,3,15,-12
23,23,12,9,16,-7
23,23,13,7,12,-5
23,23,14,14,24,-10
23,23,15,16,5,11
23,23,16,11,14,-3
23,23,17,9,12,-3
23,23,18,7,16,-9
23,23,19,9,21,-12
23,23,20,14,7,7
23,23,21,15,15,0
23,23,22,8,25,-17
23,23,23,9,16,-7
23,23,24,11,19,-8
23,23,25,16,29,-13
23,23,26,13,16,-3
23,23,27,17,8,9
23,23,28,20,14,6
23,23,29,13,5,8
23,23,30,12,14,-2
23,23,31,8,15,-7
23,23,32,29,23,6
23,23,33,11,17,-6
23,23,34,13,16,-3
23,23,35,7,16,-9
23,23,36,14,12,2
23,23,37,11,20,-9
23,23,38,7,8,-1
23,23,39,9,15,-6
23,23,40,10,11,-1
23,23,41,6,24,-18
23,23,42,12,17,-5
23,23,43,6,15,-9
23,23,44,15,16,-1
23,23,45,13,7,6
23,23,46,10,12,-2
23,23,47,18,11,7
23,23,48,10,19,-9
23,23,49,18,20,-2
23,23,50,4,9,-5
23,23,51,7,11,-4
23,23,52,8,12,-4
23,23,53,9,14,-5
23,23,54,10,20,-10
23,23,55,15,14,1
23,23,56,20,22,-2
23,23,57,11,21,-10
23,23,58,16,18,-2
23,23,59,9,12,-3
23,23,60,11,8,3
23,23,61,7,17,-10
23,23,62,12,14,-2
23,23,63,19,14,5
23,23,64,18,7,11
23,23,65,18,18,0
23,23,66,18,17,1
23,23,67,4,10,-6
23,23,68,14,11,3
23,23,69,13,10,3
23,23,70,11,14,-3
23,23,71,22,19,3
23,23,72,18,12,6
23,23,73,6,17,-11
23,23,74,15,10,5
23,23,75,6,9,-3
23,23,76,11,8,3
23,23,77,8,25,-17
23,23,78,15,8,7
23,23,79,17,24,-7
23,23,80,15,19,-4
23,23,81,17,22,-5
23,23,82,12,14,-2
23,23,83,9,6,3
23,23,84,19,18,1
23,23,85,8,10,-2
23,23,86,6,10,-4
23,23,87,11,13,-2
23,23,88,16,20,-4
23,23,89,12,12,0
23,23,90,12,20,-8
23,23,91,12,22,-10
23,23,92,11,21,-10
23,23,93,16,10,6
23,23,94,13,14,-1
23,23,95,8,14,-6
23,23,96,14,14,0
23,23,97,18,18,0
23,23,98,7,18,-11
23,23,99,20,21,-1
23,23,100,10,8,2
23,23,101,10,15,-5
23,23,102,15,19,-4
23,23,103,6,7,-1
23,23,104,14,13,1
23,23,105,14,14,0
23,23,106,25,9,16
23,23,107,15,18,-3
23,23,108,18,19,-1
23,23,109,5,12,-7
23,23,110,7,16,-9
23,23,111,3,8,-5
23,23,112,15,12,3
23,23,113,11,17,-6
23,23,114,7,26,-19
23,23,115,5,14,-9
23,23,116,19,8,11
23,23,117,26,34,-8
23,23,118,11,8,3
23,23,119,21,24,-3
23,23,120,21,18,3
23,23,121,24,17,7
23,23,122,16,30,-14
23,23,123,12,11,1
23,23,124,2,4,-2
23,23,125,17,10,7
23,23,126,3,26,-23
23,23,127,17,19,-2
23,23,128,11,13,-2
23,23,129,15,27,-12
23,23,130,10,18,-8
23,23,131,14,8,6
23,23,132,5,12,-7
23,23,133,24,21,3
23,23,134,14,26,-12
23,23,135,6,5,1
23,23,136,12,23,-11
23,23,137,11,13,-2
23,23,138,6,16,-10
23,23,139,8,10,-2
23,23,140,16,12,4
23,23,141,12,13,-1
23,23,142,19,19,0
23,23,143,8,18,-10
23,23,144,16,9,7
23,23,145,20,17,3
23,23,146,13,14,-1
23,23,147,15,25,-10
23,23,148,21,25,-4
23,23,149,9,5,4
23,23,150,0,3,-3
23,23,151,21,12,9
23,23,152,16,26,-10
23,23,153,24,21,3
23,23,154,4,9,-5
23,23,155,14,23,-9
23,23,156,11,12,-1
23,23,157,15,17,-2
23,23,158,7,14,-7
23,23,159,11,9,2
23,23,160,25,12,13
23,23,161,14,26,-12
23,23,162,11,31,-20
23,23,163,13,12,1
23,23,164,16,17,-1
23,23,165,15,21,-6
23,23,166,23,17,6
23,23,167,18,23,-5
23,23,168,5,25,-20
23,23,169,7,5,2
23,23,170,11,19,-8
23,23,171,7,9,-2
23,23,172,24,12,12
23,23,173,15,22,-7
23,23,174,19,17,2
23,23,175,11,17,-6
23,23,176,17,20,-3
23,23,177,16,13,3
23,23,178,18,8,10
23,23,179,22,13,9
23,23,180,6,7,-1
23,23,181,11,15,-4
23,23,182,15,22,-7
23,23,183,4,14,-10
23,23,184,15,17,-2
23,23,185,10,14,-4
23,23,186,6,8,-2
23,23,187,16,12,4
23,23,188,22,18,4
23,23,189,9,9,0
23,23,190,16,20,-4
23,23,191,5,25,-20
23,23,192,19,18,1
23,23,193,14,6,8
23,23,194,14,18,-4
23,23,195,12,7,5
23,23,196,19,13,6
23,23,197,5,21,-16
23,23,198,14,20,-6
23,23,199,14,16,-2
23,23,200,22,19,3
23,23,201,7,23,-16
23,23,202,12,4,8
23,23,203,15,11,4
23,23,204,25,24,1
23,23,205,11,6,5
23,23,206,15,9,6
23,23,207,19,8,11
23,23,208,12,21,-9
23,23,209,16,6,10
23,23,210,19,12,7
23,23,211,27,15,12
23,23,212,6,11,-5
23,23,213,12,11,1
23,23,214,13,10,3
23,23,215,9,1,8
23,23,216,14,20,-6
23,23,217,18,19,-1
23,23,218,9,9,0
23,23,219,14,23,-9
23,23,220,18,18,0
23,23,221,13,22,-9
23,23,222,9,16,-7
23,23,223,6,12,-6
23,23,224,10,11,-1
23,23,225,13,9,4
23,23,226,13,16,-3
23,23,227,6,19,-13
23,23,228,11,12,-1
23,23,229,24,17,7
23,23,230,8,19,-11
23,23,231,8,15,-7
23,23,232,7,8,-1
23,23,233,16,16,0
23,23,234,10,15,-5
23,23,235,9,16,-7
23,23,236,5,8,-3
23,23,237,5,13,-8
23,23,238,36,31,5
23,23,239,20,19,1
23,23,240,8,21,-13
23,23,241,11,12,-1
23,23,242,7,12,-5
23,23,243,9,13,-4
23,23,244,14,18,-4
23,23,245,22,24,-2
23,23,246,13,22,-9
23,23,247,7,20,-13
23,23,248,7,24,-17
23,23,249,7,12,-5
23,23,250,2,19,-17
23,23,251,5,13,-8
23,23,252,13,8,5
23,23,253,13,7,6
23,23,254,10,28,-18
23,23,255,16,17,-1
23,23,256,23,13,10
23,23,257,14,19,-5
23,23,258,13,14,-1
23,23,259,11,7,4
23,23,260,19,21,-2
23,23,261,14,11,3
23,23,262,9,8,1
23,23,263,14,18,-4
23,23,264,5,12,-7
23,23,265,12,19,-7
23,23,266,13,18,-5
23,23,267,20,18,2
23,23,268,25,12,13
23,23,269,5,13,-8
23,23,270,13,11,2
23,23,271,21,14,7
23,23,272,5,10,-5
23,23,273,14,12,2
23,23,274,9,10,-1
23,23,275,8,12,-4
23,23,276,13,11,2
23,23,277,15,20,-5
23,23,278,11,26,-15
23,23,279,4,11,-7
23,23,280,15,12,3
23,23,281,22,13,9
23,23,282,25,8,17
23,23,283,7,11,-4
23,23,284,16,20,-4
23,23,285,8,15,-7
23,23,286,8,9,-1
23,23,287,11,15,-4
23,23,288,12,15,-3
23,23,289,9,13,-4
23,23,290,7,31,-24
23,23,291,13,12,1
23,23,292,19,15,4
23,23,293,17,11,6
23,23,294,9,18,-9
23,23,295,20,19,1
23,23,296,7,8,-1
23,23,297,14,9,5
23,23,298,7,19,-12
23,23,299,21,12,9
23,24,0,4,10,-6
23,24,1,15,20,-5
23,24,2,15,27,-12
23,24,3,18,6,12
23,24,4,3,17,-14
23,24,5,15,11,4
23,24,6,15,9,6
23,24,7,9,13,-4
23,24,8,4,19,-15
23,24,9,5,6,-1
23,24,10,8,12,-4
23,24,11,15,15,0
23,24,12,16,15,1
23,24,13,7,9,-2
23,24,14,9,19,-10
23,24,15,5,11,-6
23,24,16,16,17,-1
23,24,17,10,6,4
23,24,18,23,22,1
23,24,19,13,15,-2
23,24,20,18,19,-1
23,24,21,28,10,18
23,24,22,14,19,-5
23,24,23,9,20,-11
23,24,24,7,6,1
23,24,25,11,12,-1
23,24,26,14,13,1
23,24,27,11,11,0
23,24,28,11,11,0
23,24,29,8,4,4
23,24,30,18,11,7
23,24,31,7,14,-7
23,24,32,13,17,-4
23,24,33,12,25,-13
23,24,34,22,21,1
23,24,35,15,10,5
23,24,36,27,19,8
23,24,37,12,28,-16
23,24,38,12,26,-14
23,24,39,12,8,4
23,24,40,15,17,-2
23,24,41,7,14,-7
23,24,42,11,34,-23
23,24,43,12,14,-2
23,24,44,17,26,-9
23,24,45,8,12,-4
23,24,46,13,8,5
23,24,47,29,16,13
23,24,48,19,19,0
23,24,49,12,11,1
23,24,50,27,11,16
23,24,51,12,27,-15
23,24,52,17,24,-7
23,24,53,6,11,-5
23,24,54,19,8,11
23,24,55,27,23,4
23,24,56,15,11,4
23,24,57,11,12,-1
23,24,58,11,15,-4
23,24,59,12,26,-14
23,24,60,5,8,-3
23,24,61,10,23,-13
23,24,62,13,16,-3
23,24,63,13,11,2
23,24,64,25,8,17
23,24,65,4,5,-1
23,24,66,13,22,-9
23,24,67,18,18,0
23,24,68,7,22,-15
23,24,69,13,24,-11
23,24,70,26,23,3
23,24,71,12,17,-5
23,24,72,15,31,-16
23,24,73,6,9,-3
23,24,74,22,21,1
23,24,75,11,11,0
23,24,76,12,7,5
23,24,77,15,23,-8
23,24,78,13,14,-1
23,24,79,17,16,1
23,24,80,17,7,10
23,24,81,15,11,4
23,24,82,14,7,7
23,24,83,8,20,-12
23,24,84,13,16,-3
23,24,85,9,18,-9
23,24,86,19,18,1
23,24,87,17,9,8
23,24,88,18,10,8
23,24,89,12,11,1
23,24,90,12,8,4
23,24,91,23,27,-4
23,24,92,5,6,-1
23,24,93,23,26,-3
23,24,94,10,7,3
23,24,95,24,18,6
23,24,96,6,6,0
23,24,97,8,8,0
23,24,98,8,16,-8
23,24,99,10,4,6
23,24,100,11,15,-4
23,24,101,4,22,-18
23,24,102,19,25,-6
23,24,103,23,8,15
23,24,104,18,18,0
23,24,105,21,19,2
23,24,106,13,11,2
23,24,107,23,7,16
23,24,108,12,20,-8
23,24,109,18,24,-6
23,24,110,13,15,-2
23,24,111,13,14,-1
23,24,112,14,19,-5
23,24,113,13,18,-5
23,24,114,14,10,4
23,24,115,11,5,6
23,24,116,19,19,0
23,24,117,17,8,9
23,24,118,19,17,2
23,24,119,16,12,4
23,24,120,8,14,-6
23,24,121,6,6,0
23,24,122,18,18,0
23,24,123,10,9,1
23,24,124,16,25,-9
23,24,125,3,16,-13
23,24,126,14,17,-3
23,24,127,18,17,1
23,24,128,12,14,-2
23,24,129,14,14,0
23,24,130,15,13,2
23,24,131,24,10,14
23,24,132,4,9,-5
23,24,133,20,19,1
23,24,134,13,7,6
23,24,135,18,12,6
23,24,136,6,17,-11
23,24,137,17,17,0
23,24,138,12,17,-5
23,24,139,10,7,3
23,24,140,11,12,-1
23,24,141,17,12,5
23,24,142,11,19,-8
23,24,143,17,28,-11
23,24,144,20,13,7
23,24,145,16,14,2
23,24,146,12,20,-8
23,24,147,12,7,5
23,24,148,13,9,4
23,24,149,17,19,-2
23,24,150,4,4,0
23,24,151,20,21,-1
23,24,152,8,5,3
23,24,153,8,14,-6
23,24,154,12,15,-3
23,24,155,19,26,-7
23,24,156,12,7,5
23,24,157,14,13,1
23,24,158,20,17,3
23,24,159,18,11,7
23,24,160,19,14,5
23,24,161,15,15,0
23,24,162,15,15,0
23,24,163,10,7,3
23,24,164,10,6,4
23,24,165,11,4,7
23,24,166,15,10,5
23,24,167,9,14,-5
23,24,168,5,7,-2
23,24,169,5,12,-7
23,24,170,13,17,-4
23,24,171,23,24,-1
23,24,172,11,10,1
23,24,173,18,26,-8
23,24,174,18,14,4
23,24,175,11,11,0
23,24,176,8,11,-3
23,24,177,6,16,-10
23,24,178,12,14,-2
23,24,179,17,20,-3
23,24,180,14,6,8
23,24,181,3,5,-2
23,24,182,22,9,13
23,24,183,27,21,6
23,24,184,11,9,2
23,24,185,15,10,5
23,24,186,18,15,3
23,24,187,13,31,-18
23,24,188,8,13,-5
23,24,189,12,6,6
23,24,190,5,5,0
23,24,191,8,14,-6
23,24,192,9,10,-1
23,24,193,17,17,0
23,24,194,18,21,-3
23,24,195,9,15,-6
23,24,196,7,15,-8
23,24,197,8,17,-9
23,24,198,11,13,-2
23,24,199,11,6,5
23,24,200,14,15,-1
23,24,201,15,13,2
23,24,202,21,12,9
23,24,203,9,14,-5
23,24,204,7,14,-7
23,24,205,21,21,0
23,24,206,17,14,3
23,24,207,22,17,5
23,24,208,13,11,2
23,24,209,26,14,12
23,24,210,9,4,5
23,24,211,8,17,-9
23,24,212,20,11,9
23,24,213,21,19,2
23,24,214,14,24,-10
23,24,215,12,14,-2
23,24,216,9,5,4
23,24,217,7,8,-1
23,24,218,7,19,-12
23,24,219,3,16,-13
23,24,220,19,15,4
23,24,221,14,16,-2
23,24,222,7,17,-10
23,24,223,18,15,3
23,24,224,18,21,-3
23,24,225,5,5,0
23,24,226,8,9,-1
23,24,227,10,17,-7
23,24,228,25,23,2
23,24,229,21,16,5
23,24,230,11,3,8
23,24,231,8,15,-7
23,24,232,15,12,3
23,24,233,8,8,0
23,24,234,25,26,-1
23,24,235,14,9,5
23,24,236,21,17,4
23,24,237,7,12,-5
23,24,238,12,15,-3
23,24,239,21,29,-8
23,24,240,24,23,1
23,24,241,12,6,6
23,24,242,15,14,1
23,24,243,11,4,7
23,24,244,23,14,9
23,24,245,14,23,-9
23,24,246,18,18,0
23,24,247,19,13,6
23,24,248,8,13,-5
23,24,249,19,9,10
23,24,250,15,13,2
23,24,251,8,11,-3
23,24,252,8,18,-10
23,24,253,17,17,0
23,24,254,30,22,8
23,24,255,1,8,-7
23,24,256,8,10,-2
23,24,257,18,10,8
23,24,258,21,14,7
23,24,259,10,9,1
23,24,260,26,24,2
23,24,261,21,10,11
23,24,262,15,11,4
23,24,263,20,8,12
23,24,264,15,13,2
23,24,265,15,16,-1
23,24,266,16,6,10
23,24,267,24,16,8
23,24,268,6,11,-5
23,24,269,10,12,-2
23,24,270,11,7,4
23,24,271,30,19,11
23,24,272,27,21,6
23,24,273,11,16,-5
23,24,274,16,16,0
23,24,275,17,15,2
23,24,276,20,17,3
23,24,277,19,13,6
23,24,278,13,8,5
23,24,279,25,14,11
23,24,280,19,13,6
23,24,281,11,16,-5
23,24,282,3,12,-9
23,24,283,6,12,-6
23,24,284,7,13,-6
23,24,285,6,2,4
23,24,286,23,12,11
23,24,287,15,12,3
23,24,288,14,12,2
23,24,289,14,32,-18
23,24,290,9,11,-2
23,24,291,18,13,5
23,24,292,20,8,12
23,24,293,14,9,5
23,24,294,13,14,-1
23,24,295,11,16,-5
23,24,296,22,10,12
23,24,297,14,16,-2
23,24,298,10,22,-12
23,24,299,11,12,-1
23,25,0,8,6,2
23,25,1,10,10,0
23,25,2,12,9,3
23,25,3,9,34,-25
23,25,4,13,12,1
23,25,5,8,17,-9
23,25,6,2,6,-4
23,25,7,14,13,1
23,25,8,9,21,-12
23,25,9,18,16,2
23,25,10,15,19,-4
23,25,11,13,11,2
23,25,12,12,13,-1
23,25,13,6,8,-2
23,25,14,15,13,2
23,25,15,15,16,-1
23,25,16,13,15,-2
23,25,17,6,1,5
23,25,18,13,16,-3
23,25,19,3,13,-10
23,25,20,15,13,2
23,25,21,17,15,2
23,25,22,9,13,-4
23,25,23,5,3,2
23,25,24,12,19,-7
23,25,25,17,12,5
23,25,26,17,19,-2
23,25,27,6,11,-5
23,25,28,13,5,8
23,25,29,14,18,-4
23,25,30,13,7,6
23,25,31,14,10,4
23,25,32,7,5,2
23,25,33,9,11,-2
23,25,34,9,9,0
23,25,35,22,14,8
23,25,36,9,15,-6
23,25,37,20,16,4
23,25,38,17,22,-5
23,25,39,9,7,2
23,25,40,24,19,5
23,25,41,9,12,-3
23,25,42,9,13,-4
23,25,43,6,10,-4
23,25,44,7,4,3
23,25,45,21,10,11
23,25,46,11,17,-6
23,25,47,18,19,-1
23,25,48,13,12,1
23,25,49,6,12,-6
23,25,50,26,15,11
23,25,51,10,6,4
23,25,52,26,15,11
23,25,53,11,16,-5
23,25,54,18,15,3
23,25,55,19,26,-7
23,25,56,25,12,13
23,25,57,11,16,-5
23,25,58,7,15,-8
23,25,59,20,13,7
23,25,60,12,6,6
23,25,61,11,11,0
23,25,62,22,21,1
23,25,63,12,10,2
23,25,64,11,20,-9
23,25,65,20,23,-3
23,25,66,21,11,10
23,25,67,8,17,-9
23,25,68,9,13,-4
23,25,69,15,8,7
23,25,70,15,11,4
23,25,71,7,21,-14
23,25,72,5,16,-11
23,25,73,21,6,15
23,25,74,28,17,11
23,25,75,13,9,4
23,25,76,9,17,-8
23,25,77,26,24,2
23,25,78,8,17,-9
23,25,79,20,10,10
23,25,80,17,10,7
23,25,81,9,13,-4
23,25,82,9,11,-2
23,25,83,6,15,-9
23,25,84,9,8,1
23,25,85,12,15,-3
23,25,86,20,9,11
23,25,87,11,12,-1
23,25,88,15,9,6
23,25,89,18,10,8
23,25,90,10,19,-9
23,25,91,25,17,8
23,25,92,8,12,-4
23,25,93,6,10,-4
23,25,94,5,15,-10
23,25,95,16,21,-5
23,25,96,17,10,7
23,25,97,9,13,-4
23,25,98,10,21,-11
23,25,99,18,3,15
23,25,100,20,18,2
23,25,101,3,13,-10
23,25,102,10,6,4
23,25,103,9,15,-6
23,25,104,11,8,3
23,25,105,10,18,-8
23,25,106,11,12,-1
23,25,107,23,13,10
23,25,108,3,11,-8
23,25,109,17,15,2
23,25,110,9,9,0
23,25,111,10,11,-1
23,25,112,16,21,-5
23,25,113,16,13,3
23,25,114,14,9,5
23,25,115,10,18,-8
23,25,116,8,8,0
23,25,117,16,25,-9
23,25,118,11,17,-6
23,25,119,13,17,-4
23,25,120,13,13,0
23,25,121,14,10,4
23,25,122,12,9,3
23,25,123,8,14,-6
23,25,124,18,22,-4
23,25,125,21,5,16
23,25,126,7,16,-9
23,25,127,11,13,-2
23,25,128,21,19,2
23,25,129,21,21,0
23,25,130,18,14,4
23,25,131,10,7,3
23,25,132,11,10,1
23,25,133,12,14,-2
23,25,134,16,13,3
23,25,135,8,13,-5
23,25,136,19,15,4
23,25,137,12,7,5
23,25,138,8,10,-2
23,25,139,15,19,-4
23,25,140,12,10,2
23,25,141,19,11,8
23,25,142,4,5,-1
23,25,143,5,11,-6
23,25,144,9,5,4
23,25,145,4,14,-10
23,25,146,7,25,-18
23,25,147,11,13,-2
23,25,148,9,14,-5
23,25,149,15,17,-2
23,25,150,12,11,1
23,25,151,21,14,7
23,25,152,26,22,4
23,25,153,6,9,-3
23,25,154,13,11,2
23,25,155,10,21,-11
23,25,156,17,19,-2
23,25,157,6,8,-2
23,25,158,12,12,0
23,25,159,18,14,4
23,25,160,14,13,1
23,25,161,10,10,0
23,25,162,23,7,16
23,25,163,16,20,-4
23,25,164,21,11,10
23,25,165,16,27,-11
23,25,166,17,10,7
23,25,167,11,14,-3
23,25,168,13,13,0
23,25,169,11,11,0
23,25,170,27,19,8
23,25,171,13,3,10
23,25,172,22,15,7
23,25,173,17,22,-5
23,25,174,9,11,-2
23,25,175,11,6,5
23,25,176,18,14,4
23,25,177,4,13,-9
23,25,178,9,16,-7
23,25,179,10,17,-7
23,25,180,14,18,-4
23,25,181,18,18,0
23,25,182,9,7,2
23,25,183,12,7,5
23,25,184,12,18,-6
23,25,185,15,17,-2
23,25,186,14,12,2
23,25,187,17,19,-2
23,25,188,17,6,11
23,25,189,16,16,0
23,25,190,17,26,-9
23,25,191,14,20,-6
23,25,192,20,15,5
23,25,193,28,26,2
23,25,194,14,20,-6
23,25,195,8,8,0
23,25,196,11,9,2
23,25,197,23,18,5
23,25,198,11,20,-9
23,25,199,30,20,10
23,25,200,14,14,0
23,25,201,13,19,-6
23,25,202,8,16,-8
23,25,203,10,8,2
23,25,204,6,14,-8
23,25,205,12,9,3
23,25,206,14,18,-4
23,25,207,7,16,-9
23,25,208,8,6,2
23,25,209,3,7,-4
23,25,210,11,9,2
23,25,211,18,22,-4
23,25,212,11,12,-1
23,25,213,11,18,-7
23,25,214,14,15,-1
23,25,215,11,13,-2
23,25,216,12,9,3
23,25,217,17,12,5
23,25,218,24,16,8
23,25,219,15,7,8
23,25,220,7,18,-11
23,25,221,14,18,-4
23,25,222,22,18,4
23,25,223,15,11,4
23,25,224,6,3,3
23,25,225,11,15,-4
23,25,226,11,20,-9
23,25,227,10,16,-6
23,25,228,14,13,1
23,25,229,9,9,0
23,25,230,14,13,1
23,25,231,7,10,-3
23,25,232,6,13,-7
23,25,233,18,16,2
23,25,234,22,19,3
23,25,235,9,13,-4
23,25,236,14,15,-1
23,25,237,12,20,-8
23,25,238,11,10,1
23,25,239,6,6,0
23,25,240,8,12,-4
23,25,241,7,11,-4
23,25,242,11,17,-6
23,25,243,12,18,-6
23,25,244,12,7,5
23,25,245,15,17,-2
23,25,246,9,9,0
23,25,247,18,10,8
23,25,248,8,10,-2
23,25,249,5,14,-9
23,25,250,8,16,-8
23,25,251,10,9,1
23,25,252,25,27,-2
23,25,253,11,4,7
23,25,254,7,10,-3
23,25,255,5,10,-5
23,25,256,18,13,5
23,25,257,13,16,-3
23,25,258,24,11,13
23,25,259,14,17,-3
23,25,260,14,17,-3
23,25,261,5,20,-15
23,25,262,14,28,-14
23,25,263,14,20,-6
23,25,264,8,6,2
23,25,265,8,15,-7
23,25,266,18,20,-2
23,25,267,13,17,-4
23,25,268,12,9,3
23,25,269,7,10,-3
23,25,270,6,18,-12
23,25,271,9,9,0
23,25,272,22,17,5
23,25,273,15,10,5
23,25,274,18,16,2
23,25,275,14,13,1
23,25,276,11,14,-3
23,25,277,12,12,0
23,25,278,13,11,2
23,25,279,26,19,7
23,25,280,19,19,0
23,25,281,16,14,2
23,25,282,14,17,-3
23,25,283,10,4,6
23,25,284,19,19,0
23,25,285,18,25,-7
23,25,286,18,12,6
23,25,287,7,8,-1
23,25,288,12,14,-2
23,25,289,9,17,-8
23,25,290,19,10,9
23,25,291,7,13,-6
23,25,292,32,14,18
23,25,293,4,14,-10
23,25,294,14,12,2
23,25,295,8,12,-4
23,25,296,16,13,3
23,25,297,13,10,3
23,25,298,11,15,-4
23,25,299,16,11,5
23,26,0,9,9,0
23,26,1,15,10,5
23,26,2,25,22,3
23,26,3,19,16,3
23,26,4,22,12,10
23,26,5,10,9,1
23,26,6,11,14,-3
23,26,7,14,8,6
23,26,8,13,20,-7
23,26,9,21,8,13
23,26,10,19,7,12
23,26,11,9,8,1
23,26,12,16,10,6
23,26,13,8,18,-10
23,26,14,10,5,5
23,26,15,11,18,-7
23,26,16,15,9,6
23,26,17,9,9,0
23,26,18,6,12,-6
23,26,19,19,8,11
23,26,20,33,14,19
23,26,21,14,18,-4
23,26,22,6,7,-1
23,26,23,17,14,3
23,26,24,10,5,5
23,26,25,10,11,-1
23,26,26,12,19,-7
23,26,27,10,22,-12
23,26,28,11,11,0
23,26,29,11,5,6
23,26,30,15,19,-4
23,26,31,16,10,6
23,26,32,10,9,1
23,26,33,17,10,7
23,26,34,12,8,4
23,26,35,14,6,8
23,26,36,7,8,-1
23,26,37,8,17,-9
23,26,38,15,17,-2
23,26,39,11,9,2
23,26,40,10,7,3
23,26,41,12,4,8
23,26,42,12,14,-2
23,26,43,14,8,6
23,26,44,5,14,-9
23,26,45,12,11,1
23,26,46,1,12,-11
23,26,47,13,24,-11
23,26,48,17,13,4
23,26,49,10,10,0
23,26,50,25,17,8
23,26,51,0,12,-12
23,26,52,5,23,-18
23,26,53,9,11,-2
23,26,54,17,6,11
23,26,55,13,20,-7
23,26,56,5,6,-1
23,26,57,15,20,-5
23,26,58,8,18,-10
23,26,59,16,16,0
23,26,60,6,13,-7
23,26,61,14,13,1
23,26,62,14,8,6
23,26,63,15,20,-5
23,26,64,21,15,6
23,26,65,19,14,5
23,26,66,13,20,-7
23,26,67,17,17,0
23,26,68,19,19,0
23,26,69,15,14,1
23,26,70,15,9,6
23,26,71,15,11,4
23,26,72,10,5,5
23,26,73,13,11,2
23,26,74,24,9,15
23,26,75,4,7,-3
23,26,76,13,12,1
23,26,77,14,17,-3
23,26,78,12,20,-8
23,26,79,7,13,-6
23,26,80,21,3,18
23,26,81,8,16,-8
23,26,82,16,20,-4
23,26,83,24,15,9
23,26,84,8,23,-15
23,26,85,13,13,0
23,26,86,19,20,-1
23,26,87,18,8,10
23,26,88,14,17,-3
23,26,89,10,14,-4
23,26,90,25,10,15
23,26,91,13,18,-5
23,26,92,16,8,8
23,26,93,29,17,12
23,26,94,10,18,-8
23,26,95,12,11,1
23,26,96,5,5,0
23,26,97,12,21,-9
23,26,98,9,8,1
23,26,99,13,10,3
23,26,100,12,14,-2
23,26,101,2,14,-12
23,26,102,8,12,-4
23,26,103,8,11,-3
23,26,104,12,10,2
23,26,105,15,17,-2
23,26,106,18,6,12
23,26,107,17,7,10
23,26,108,14,9,5
23,26,109,5,7,-2
23,26,110,7,18,-11
23,26,111,18,15,3
23,26,112,9,15,-6
23,26,113,16,17,-1
23,26,114,12,16,-4
23,26,115,12,24,-12
23,26,116,11,7,4
23,26,117,18,12,6
23,26,118,7,20,-13
23,26,119,8,13,-5
23,26,120,15,12,3
23,26,121,9,8,1
23,26,122,10,10,0
23,26,123,13,17,-4
23,26,124,8,9,-1
23,26,125,16,18,-2
23,26,126,4,12,-8
23,26,127,17,5,12
23,26,128,15,9,6
23,26,129,18,12,6
23,26,130,16,19,-3
23,26,131,11,13,-2
23,26,132,7,15,-8
23,26,133,9,12,-3
23,26,134,12,12,0
23,26,135,18,14,4
23,26,136,4,17,-13
23,26,137,14,13,1
23,26,138,9,8,1
23,26,139,6,9,-3
23,26,140,22,17,5
23,26,141,14,19,-5
23,26,142,26,22,4
23,26,143,14,10,4
23,26,144,18,3,15
23,26,145,11,7,4
23,26,146,20,13,7
23,26,147,16,10,6
23,26,148,17,12,5
23,26,149,6,9,-3
23,26,150,4,7,-3
23,26,151,15,13,2
23,26,152,9,10,-1
23,26,153,22,21,1
23,26,154,16,17,-1
23,26,155,9,15,-6
23,26,156,15,18,-3
23,26,157,10,16,-6
23,26,158,13,8,5
23,26,159,9,8,1
23,26,160,25,15,10
23,26,161,22,9,13
23,26,162,9,9,0
23,26,163,13,12,1
23,26,164,12,14,-2
23,26,165,19,6,13
23,26,166,13,15,-2
23,26,167,8,8,0
23,26,168,17,14,3
23,26,169,10,19,-9
23,26,170,18,17,1
23,26,171,12,12,0
23,26,172,19,27,-8
23,26,173,16,11,5
23,26,174,12,14,-2
23,26,175,20,14,6
23,26,176,14,23,-9
23,26,177,10,15,-5
23,26,178,14,21,-7
23,26,179,21,14,7
23,26,180,18,16,2
23,26,181,23,9,14
23,26,182,20,19,1
23,26,183,13,11,2
23,26,184,21,10,11
23,26,185,13,17,-4
23,26,186,9,15,-6
23,26,187,7,13,-6
23,26,188,15,7,8
23,26,189,18,16,2
23,26,190,9,8,1
23,26,191,20,16,4
23,26,192,9,16,-7
23,26,193,24,20,4
23,26,194,6,22,-16
23,26,195,24,28,-4
23,26,196,16,19,-3
23,26,197,14,10,4
23,26,198,21,20,1
23,26,199,9,13,-4
23,26,200,17,18,-1
23,26,201,11,13,-2
23,26,202,8,11,-3
23,26,203,14,9,5
23,26,204,13,16,-3
23,26,205,11,4,7
23,26,206,10,19,-9
23,26,207,29,17,12
23,26,208,7,12,-5
23,26,209,11,6,5
23,26,210,12,16,-4
23,26,211,13,12,1
23,26,212,12,15,-3
23,26,213,18,26,-8
23,26,214,13,14,-1
23,26,215,13,17,-4
23,26,216,11,15,-4
23,26,217,18,14,4
23,26,218,23,20,3
23,26,219,24,35,-11
23,26,220,17,24,-7
23,26,221,11,20,-9
23,26,222,30,14,16
23,26,223,16,17,-1
23,26,224,5,9,-4
23,26,225,24,7,17
23,26,226,10,7,3
23,26,227,16,22,-6
23,26,228,20,17,3
23,26,229,5,10,-5
23,26,230,7,10,-3
23,26,231,7,10,-3
23,26,232,15,20,-5
23,26,233,8,11,-3
23,26,234,12,11,1
23,26,235,11,20,-9
23,26,236,17,17,0
23,26,237,5,8,-3
23,26,238,13,15,-2
23,26,239,10,21,-11
23,26,240,15,10,5
23,26,241,10,8,2
23,26,242,11,8,3
23,26,243,13,7,6
23,26,244,16,8,8
23,26,245,13,7,6
23,26,246,17,17,0
23,26,247,15,16,-1
23,26,248,9,4,5
23,26,249,13,5,8
23,26,250,11,11,0
23,26,251,6,3,3
23,26,252,15,12,3
23,26,253,9,13,-4
23,26,254,9,12,-3
23,26,255,6,7,-1
23,26,256,5,8,-3
23,26,257,16,26,-10
23,26,258,4,6,-2
23,26,259,5,3,2
23,26,260,23,17,6
23,26,261,23,11,12
23,26,262,17,24,-7
23,26,263,8,13,-5
23,26,264,7,11,-4
23,26,265,21,11,10
23,26,266,23,29,-6
23,26,267,11,26,-15
23,26,268,8,17,-9
23,26,269,22,18,4
23,26,270,18,12,6
23,26,271,17,14,3
23,26,272,12,8,4
23,26,273,19,13,6
23,26,274,8,20,-12
23,26,275,13,16,-3
23,26,276,11,12,-1
23,26,277,8,13,-5
23,26,278,11,12,-1
23,26,279,15,14,1
23,26,280,23,8,15
23,26,281,8,15,-7
23,26,282,9,6,3
23,26,283,8,9,-1
23,26,284,13,16,-3
23,26,285,3,7,-4
23,26,286,27,13,14
23,26,287,11,11,0
23,26,288,12,8,4
23,26,289,24,21,3
23,26,290,8,12,-4
23,26,291,15,8,7
23,26,292,17,5,12
23,26,293,16,14,2
23,26,294,16,26,-10
23,26,295,23,14,9
23,26,296,19,19,0
23,26,297,20,15,5
23,26,298,16,10,6
23,26,299,5,5,0
23,27,0,24,17,7
23,27,1,20,9,11
23,27,2,17,7,10
23,27,3,16,6,10
23,27,4,12,16,-4
23,27,5,19,13,6
23,27,6,10,17,-7
23,27,7,16,22,-6
23,27,8,14,19,-5
23,27,9,6,4,2
23,27,10,16,8,8
23,27,11,12,6,6
23,27,12,11,13,-2
23,27,13,20,20,0
23,27,14,13,13,0
23,27,15,8,9,-1
23,27,16,9,18,-9
23,27,17,17,6,11
23,27,18,13,9,4
23,27,19,26,15,11
23,27,20,8,11,-3
23,27,21,19,14,5
23,27,22,12,10,2
23,27,23,28,25,3
23,27,24,19,16,3
23,27,25,9,9,0
23,27,26,21,18,3
23,27,27,11,5,6
23,27,28,16,16,0
23,27,29,19,9,10
23,27,30,4,13,-9
23,27,31,21,17,4
23,27,32,20,14,6
23,27,33,11,8,3
23,27,34,12,20,-8
23,27,35,14,5,9
23,27,36,8,14,-6
23,27,37,17,15,2
23,27,38,11,13,-2
23,27,39,12,15,-3
23,27,40,15,4,11
23,27,41,22,24,-2
23,27,42,13,6,7
23,27,43,5,7,-2
23,27,44,11,11,0
23,27,45,5,8,-3
23,27,46,14,12,2
23,27,47,9,13,-4
23,27,48,15,11,4
23,27,49,9,10,-1
23,27,50,16,14,2
23,27,51,23,18,5
23,27,52,16,15,1
23,27,53,6,6,0
23,27,54,19,14,5
23,27,55,14,8,6
23,27,56,12,19,-7
23,27,57,21,20,1
23,27,58,20,13,7
23,27,59,17,11,6
23,27,60,11,14,-3
23,27,61,10,5,5
23,27,62,19,12,7
23,27,63,8,13,-5
23,27,64,5,10,-5
23,27,65,25,23,2
23,27,66,15,11,4
23,27,67,23,21,2
23,27,68,13,2,11
23,27,69,16,23,-7
23,27,70,14,14,0
23,27,71,11,15,-4
23,27,72,10,17,-7
23,27,73,12,19,-7
23,27,74,19,14,5
23,27,75,11,7,4
23,27,76,18,13,5
23,27,77,9,12,-3
23,27,78,19,14,5
23,27,79,20,9,11
23,27,80,6,6,0
23,27,81,14,9,5
23,27,82,9,17,-8
23,27,83,16,19,-3
23,27,84,17,12,5
23,27,85,11,15,-4
23,27,86,18,14,4
23,27,87,9,9,0
23,27,88,14,14,0
23,27,89,9,7,2
23,27,90,12,7,5
23,27,91,17,19,-2
23,27,92,15,15,0
23,27,93,8,8,0
23,27,94,5,7,-2
23,27,95,15,22,-7
23,27,96,7,7,0
23,27,97,9,4,5
23,27,98,5,11,-6
23,27,99,25,17,8
23,27,100,14,27,-13
23,27,101,16,13,3
23,27,102,26,13,13
23,27,103,14,9,5
23,27,104,21,10,11
23,27,105,14,9,5
23,27,106,15,11,4
23,27,107,17,12,5
23,27,108,24,17,7
23,27,109,8,7,1
23,27,110,16,6,10
23,27,111,30,19,11
23,27,112,10,10,0
23,27,113,18,25,-7
23,27,114,11,14,-3
23,27,115,12,12,0
23,27,116,22,16,6
23,27,117,17,10,7
23,27,118,11,9,2
23,27,119,15,15,0
23,27,120,3,10,-7
23,27,121,11,14,-3
23,27,122,4,11,-7
23,27,123,6,7,-1
23,27,124,15,4,11
23,27,125,15,13,2
23,27,126,16,9,7
23,27,127,22,15,7
23,27,128,15,20,-5
23,27,129,12,14,-2
23,27,130,13,11,2
23,27,131,14,21,-7
23,27,132,11,4,7
23,27,133,15,11,4
23,27,134,20,12,8
23,27,135,16,20,-4
23,27,136,10,10,0
23,27,137,13,11,2
23,27,138,22,13,9
23,27,139,16,6,10
23,27,140,15,17,-2
23,27,141,8,9,-1
23,27,142,21,12,9
23,27,143,8,7,1
23,27,144,13,28,-15
23,27,145,12,8,4
23,27,146,11,17,-6
23,27,147,11,12,-1
23,27,148,12,8,4
23,27,149,5,3,2
23,27,150,12,13,-1
23,27,151,19,15,4
23,27,152,22,18,4
23,27,153,28,11,17
23,27,154,12,18,-6
23,27,155,13,11,2
23,27,156,14,12,2
23,27,157,9,13,-4
23,27,158,21,16,5
23,27,159,14,10,4
23,27,160,9,6,3
23,27,161,15,12,3
23,27,162,14,27,-13
23,27,163,18,19,-1
23,27,164,16,18,-2
23,27,165,12,11,1
23,27,166,6,9,-3
23,27,167,20,21,-1
23,27,168,12,17,-5
23,27,169,17,12,5
23,27,170,15,10,5
23,27,171,9,18,-9
23,27,172,3,5,-2
23,27,173,14,10,4
23,27,174,13,19,-6
23,27,175,13,16,-3
23,27,176,10,11,-1
23,27,177,12,12,0
23,27,178,20,22,-2
23,27,179,23,14,9
23,27,180,10,9,1
23,27,181,17,10,7
23,27,182,23,7,16
23,27,183,18,5,13
23,27,184,9,23,-14
23,27,185,12,18,-6
23,27,186,15,12,3
23,27,187,10,11,-1
23,27,188,14,10,4
23,27,189,11,6,5
23,27,190,11,18,-7
23,27,191,15,9,6
23,27,192,14,12,2
23,27,193,13,11,2
23,27,194,17,13,4
23,27,195,9,2,7
23,27,196,20,22,-2
23,27,197,8,8,0
23,27,198,6,5,1
23,27,199,13,22,-9
23,27,200,5,15,-10
23,27,201,8,16,-8
23,27,202,14,4,10
23,27,203,13,12,1
23,27,204,7,15,-8
23,27,205,19,17,2
23,27,206,10,16,-6
23,27,207,14,10,4
23,27,208,14,17,-3
23,27,209,14,16,-2
23,27,210,9,12,-3
23,27,211,16,21,-5
23,27,212,14,14,0
23,27,213,13,11,2
23,27,214,13,4,9
23,27,215,11,22,-11
23,27,216,6,4,2
23,27,217,15,24,-9
23,27,218,26,19,7
23,27,219,12,3,9
23,27,220,9,14,-5
23,27,221,8,12,-4
23,27,222,21,14,7
23,27,223,13,12,1
23,27,224,13,15,-2
23,27,225,18,10,8
23,27,226,13,11,2
23,27,227,17,11,6
23,27,228,6,15,-9
23,27,229,7,11,-4
23,27,230,16,10,6
23,27,231,17,12,5
23,27,232,21,15,6
23,27,233,19,24,-5
23,27,234,12,14,-2
23,27,235,7,6,1
23,27,236,20,12,8
23,27,237,10,22,-12
23,27,238,4,11,-7
23,27,239,9,18,-9
23,27,240,24,18,6
23,27,241,18,13,5
23,27,242,20,9,11
23,27,243,8,14,-6
23,27,244,15,10,5
23,27,245,5,8,-3
23,27,246,13,22,-9
23,27,247,12,13,-1
23,27,248,19,18,1
23,27,249,8,8,0
23,27,250,15,9,6
23,27,251,11,8,3
23,27,252,15,14,1
23,27,253,19,19,0
23,27,254,20,6,14
23,27,255,5,7,-2
23,27,256,9,8,1
23,27,257,12,17,-5
23,27,258,21,33,-12
23,27,259,7,15,-8
23,27,260,13,7,6
23,27,261,19,31,-12
23,27,262,8,16,-8
23,27,263,10,7,3
23,27,264,17,7,10
23,27,265,16,8,8
23,27,266,12,14,-2
23,27,267,11,12,-1
23,27,268,17,11,6
23,27,269,8,12,-4
23,27,270,11,5,6
23,27,271,10,12,-2
23,27,272,7,12,-5
23,27,273,15,13,2
23,27,274,16,6,10
23,27,275,17,11,6
23,27,276,14,4,10
23,27,277,17,13,4
23,27,278,19,15,4
23,27,279,9,8,1
23,27,280,13,17,-4
23,27,281,15,11,4
23,27,282,18,17,1
23,27,283,27,21,6
23,27,284,15,11,4
23,27,285,19,17,2
23,27,286,13,15,-2
23,27,287,5,6,-1
23,27,288,12,17,-5
23,27,289,17,11,6
23,27,290,5,15,-10
23,27,291,6,7,-1
23,27,292,9,13,-4
23,27,293,14,17,-3
23,27,294,13,12,1
23,27,295,14,17,-3
23,27,296,20,17,3
23,27,297,10,2,8
23,27,298,15,15,0
23,27,299,14,11,3
23,28,0,10,15,-5
23,28,1,14,6,8
23,28,2,26,11,15
23,28,3,13,18,-5
23,28,4,14,25,-11
23,28,5,25,9,16
23,28,6,13,3,10
23,28,7,12,10,2
23,28,8,10,14,-4
23,28,9,18,21,-3
23,28,10,13,9,4
23,28,11,26,25,1
23,28,12,21,8,13
23,28,13,10,9,1
23,28,14,14,6,8
23,28,15,16,10,6
23,28,16,15,16,-1
23,28,17,15,10,5
23,28,18,20,18,2
23,28,19,13,14,-1
23,28,20,23,8,15
23,28,21,7,6,1
23,28,22,7,18,-11
23,28,23,21,19,2
23,28,24,17,21,-4
23,28,25,12,17,-5
23,28,26,11,6,5
23,28,27,15,11,4
23,28,28,14,6,8
23,28,29,12,10,2
23,28,30,13,13,0
23,28,31,27,8,19
23,28,32,5,8,-3
23,28,33,13,12,1
23,28,34,17,22,-5
23,28,35,14,11,3
23,28,36,9,12,-3
23,28,37,11,7,4
23,28,38,14,10,4
23,28,39,2,5,-3
23,28,40,13,23,-10
23,28,41,13,9,4
23,28,42,16,13,3
23,28,43,22,15,7
23,28,44,14,7,7
23,28,45,17,10,7
23,28,46,9,7,2
23,28,47,12,5,7
23,28,48,17,16,1
23,28,49,11,11,0
23,28,50,12,12,0
23,28,51,24,14,10
23,28,52,12,18,-6
23,28,53,14,12,2
23,28,54,13,18,-5
23,28,55,17,20,-3
23,28,56,21,16,5
23,28,57,11,12,-1
23,28,58,10,13,-3
23,28,59,25,33,-8
23,28,60,13,3,10
23,28,61,10,17,-7
23,28,62,17,18,-1
23,28,63,31,18,13
23,28,64,17,21,-4
23,28,65,19,19,0
23,28,66,3,12,-9
23,28,67,12,21,-9
23,28,68,21,12,9
23,28,69,9,8,1
23,28,70,14,11,3
23,28,71,13,10,3
23,28,72,10,12,-2
23,28,73,13,15,-2
23,28,74,20,15,5
23,28,75,5,15,-10
23,28,76,15,20,-5
23,28,77,16,25,-9
23,28,78,15,22,-7
23,28,79,9,8,1
23,28,80,20,4,16
23,28,81,12,9,3
23,28,82,17,10,7
23,28,83,19,11,8
23,28,84,12,13,-1
23,28,85,11,9,2
23,28,86,9,20,-11
23,28,87,6,11,-5
23,28,88,21,21,0
23,28,89,15,14,1
23,28,90,14,22,-8
23,28,91,13,12,1
23,28,92,8,17,-9
23,28,93,20,8,12
23,28,94,14,9,5
23,28,95,12,15,-3
23,28,96,21,5,16
23,28,97,15,17,-2
23,28,98,7,8,-1
23,28,99,14,7,7
23,28,100,18,19,-1
23,28,101,14,12,2
23,28,102,16,12,4
23,28,103,14,6,8
23,28,104,10,17,-7
23,28,105,5,18,-13
23,28,106,11,14,-3
23,28,107,7,11,-4
23,28,108,22,11,11
23,28,109,22,16,6
23,28,110,18,18,0
23,28,111,15,6,9
23,28,112,17,14,3
23,28,113,17,12,5
23,28,114,13,15,-2
23,28,115,10,13,-3
23,28,116,15,12,3
23,28,117,17,11,6
23,28,118,15,7,8
23,28,119,10,5,5
23,28,120,12,16,-4
23,28,121,23,16,7
23,28,122,18,16,2
23,28,123,9,5,4
23,28,124,13,10,3
23,28,125,15,11,4
23,28,126,10,4,6
23,28,127,14,8,6
23,28,128,10,11,-1
23,28,129,14,12,2
23,28,130,15,18,-3
23,28,131,9,10,-1
23,28,132,19,19,0
23,28,133,20,9,11
23,28,134,19,16,3
23,28,135,21,17,4
23,28,136,12,15,-3
23,28,137,24,13,11
23,28,138,20,15,5
23,28,139,16,25,-9
23,28,140,18,12,6
23,28,141,12,19,-7
23,28,142,20,13,7
23,28,143,28,15,13
23,28,144,7,6,1
23,28,145,5,7,-2
23,28,146,16,13,3
23,28,147,17,13,4
23,28,148,7,7,0
23,28,149,13,16,-3
23,28,150,4,6,-2
23,28,151,15,17,-2
23,28,152,5,4,1
23,28,153,18,16,2
23,28,154,8,8,0
23,28,155,8,4,4
23,28,156,13,10,3
23,28,157,15,22,-7
23,28,158,14,20,-6
23,28,159,14,1,13
23,28,160,6,13,-7
23,28,161,20,13,7
23,28,162,21,9,12
23,28,163,18,27,-9
23,28,164,13,6,7
23,28,165,14,5,9
23,28,166,21,17,4
23,28,167,18,6,12
23,28,168,22,17,5
23,28,169,7,5,2
23,28,170,12,16,-4
23,28,171,7,5,2
23,28,172,12,11,1
23,28,173,12,8,4
23,28,174,20,17,3
23,28,175,6,10,-4
23,28,176,9,11,-2
23,28,177,12,13,-1
23,28,178,21,13,8
23,28,179,5,7,-2
23,28,180,2,4,-2
23,28,181,4,9,-5
23,28,182,11,8,3
23,28,183,8,12,-4
23,28,184,10,11,-1
23,28,185,21,16,5
23,28,186,18,25,-7
23,28,187,17,12,5
23,28,188,14,11,3
23,28,189,12,13,-1
23,28,190,7,11,-4
23,28,191,8,11,-3
23,28,192,12,9,3
23,28,193,18,17,1
23,28,194,8,15,-7
23,28,195,18,16,2
23,28,196,15,8,7
23,28,197,14,13,1
23,28,198,11,11,0
23,28,199,22,22,0
23,28,200,12,20,-8
23,28,201,20,20,0
23,28,202,10,8,2
23,28,203,24,6,18
23,28,204,20,17,3
23,28,205,21,19,2
23,28,206,13,15,-2
23,28,207,23,14,9
23,28,208,15,14,1
23,28,209,8,7,1
23,28,210,9,12,-3
23,28,211,4,10,-6
23,28,212,10,4,6
23,28,213,11,5,6
23,28,214,6,7,-1
23,28,215,19,15,4
23,28,216,7,8,-1
23,28,217,11,14,-3
23,28,218,14,9,5
23,28,219,11,9,2
23,28,220,5,7,-2
23,28,221,17,14,3
23,28,222,18,11,7
23,28,223,16,13,3
23,28,224,3,7,-4
23,28,225,10,13,-3
23,28,226,14,9,5
23,28,227,17,18,-1
23,28,228,12,17,-5
23,28,229,29,24,5
23,28,230,21,19,2
23,28,231,19,19,0
23,28,232,11,6,5
23,28,233,10,20,-10
23,28,234,17,8,9
23,28,235,15,21,-6
23,28,236,8,17,-9
23,28,237,17,14,3
23,28,238,16,11,5
23,28,239,16,21,-5
23,28,240,17,14,3
23,28,241,5,4,1
23,28,242,9,9,0
23,28,243,8,11,-3
23,28,244,16,6,10
23,28,245,17,5,12
23,28,246,9,5,4
23,28,247,15,12,3
23,28,248,14,10,4
23,28,249,9,17,-8
23,28,250,13,6,7
23,28,251,3,7,-4
23,28,252,10,10,0
23,28,253,20,21,-1
23,28,254,11,11,0
23,28,255,19,16,3
23,28,256,19,15,4
23,28,257,14,11,3
23,28,258,22,17,5
23,28,259,12,11,1
23,28,260,8,10,-2
23,28,261,6,15,-9
23,28,262,10,15,-5
23,28,263,8,7,1
23,28,264,13,5,8
23,28,265,12,21,-9
23,28,266,12,5,7
23,28,267,24,12,12
23,28,268,9,18,-9
23,28,269,15,7,8
23,28,270,9,22,-13
23,28,271,12,15,-3
23,28,272,11,3,8
23,28,273,10,7,3
23,28,274,14,9,5
23,28,275,12,13,-1
23,28,276,10,14,-4
23,28,277,12,11,1
23,28,278,21,15,6
23,28,279,15,11,4
23,28,280,12,10,2
23,28,281,22,12,10
23,28,282,7,13,-6
23,28,283,12,9,3
23,28,284,21,13,8
23,28,285,21,22,-1
23,28,286,10,3,7
23,28,287,16,12,4
23,28,288,16,30,-14
23,28,289,13,10,3
23,28,290,13,8,5
23,28,291,7,16,-9
23,28,292,6,2,4
23,28,293,20,15,5
23,28,294,15,9,6
23,28,295,13,10,3
23,28,296,12,24,-12
23,28,297,16,8,8
23,28,298,32,20,12
23,28,299,13,11,2
23,29,0,11,21,-10
23,29,1,21,16,5
23,29,2,16,12,4
23,29,3,15,15,0
23,29,4,19,9,10
23,29,5,15,11,4
23,29,6,25,19,6
23,29,7,18,11,7
23,29,8,16,18,-2
23,29,9,20,19,1
23,29,10,11,12,-1
23,29,11,7,15,-8
23,29,12,14,12,2
23,29,13,14,13,1
23,29,14,15,17,-2
23,29,15,26,24,2
23,29,16,12,21,-9
23,29,17,7,16,-9
23,29,18,18,14,4
23,29,19,15,27,-12
23,29,20,15,20,-5
23,29,21,5,4,1
23,29,22,18,20,-2
23,29,23,11,11,0
23,29,24,6,9,-3
23,29,25,11,11,0
23,29,26,11,23,-12
23,29,27,14,21,-7
23,29,28,13,14,-1
23,29,29,5,10,-5
23,29,30,12,23,-11
23,29,31,9,13,-4
23,29,32,16,22,-6
23,29,33,16,28,-12
23,29,34,12,11,1
23,29,35,23,12,11
23,29,36,15,14,1
23,29,37,16,15,1
23,29,38,15,17,-2
23,29,39,16,15,1
23,29,40,15,9,6
23,29,41,7,9,-2
23,29,42,14,11,3
23,29,43,11,14,-3
23,29,44,18,14,4
23,29,45,6,5,1
23,29,46,16,10,6
23,29,47,14,12,2
23,29,48,5,3,2
23,29,49,11,11,0
23,29,50,6,13,-7
23,29,51,2,1,1
23,29,52,4,10,-6
23,29,53,17,16,1
23,29,54,17,18,-1
23,29,55,25,23,2
23,29,56,15,9,6
23,29,57,8,14,-6
23,29,58,28,20,8
23,29,59,10,15,-5
23,29,60,7,11,-4
23,29,61,19,18,1
23,29,62,11,19,-8
23,29,63,16,13,3
23,29,64,15,9,6
23,29,65,11,15,-4
23,29,66,10,7,3
23,29,67,10,5,5
23,29,68,24,17,7
23,29,69,18,32,-14
23,29,70,15,9,6
23,29,71,15,18,-3
23,29,72,11,11,0
23,29,73,10,10,0
23,29,74,19,11,8
23,29,75,18,16,2
23,29,76,10,20,-10
23,29,77,26,25,1
23,29,78,21,28,-7
23,29,79,9,12,-3
23,29,80,11,11,0
23,29,81,5,6,-1
23,29,82,18,4,14
23,29,83,18,14,4
23,29,84,19,2,17
23,29,85,5,6,-1
23,29,86,19,18,1
23,29,87,14,19,-5
23,29,88,18,14,4
23,29,89,15,17,-2
23,29,90,14,10,4
23,29,91,21,11,10
23,29,92,21,22,-1
23,29,93,8,7,1
23,29,94,18,10,8
23,29,95,4,15,-11
23,29,96,13,20,-7
23,29,97,6,16,-10
23,29,98,16,18,-2
23,29,99,7,11,-4
23,29,100,13,8,5
23,29,101,23,27,-4
23,29,102,6,20,-14
23,29,103,14,10,4
23,29,104,14,13,1
23,29,105,9,21,-12
23,29,106,22,8,14
23,29,107,3,7,-4
23,29,108,14,18,-4
23,29,109,15,6,9
23,29,110,8,7,1
23,29,111,6,5,1
23,29,112,13,17,-4
23,29,113,10,5,5
23,29,114,10,9,1
23,29,115,24,15,9
23,29,116,7,4,3
23,29,117,14,13,1
23,29,118,26,19,7
23,29,119,21,12,9
23,29,120,16,14,2
23,29,121,25,10,15
23,29,122,10,13,-3
23,29,123,14,7,7
23,29,124,13,13,0
23,29,125,8,21,-13
23,29,126,7,6,1
23,29,127,15,15,0
23,29,128,14,14,0
23,29,129,19,9,10
23,29,130,20,13,7
23,29,131,10,19,-9
23,29,132,19,23,-4
23,29,133,12,10,2
23,29,134,17,16,1
23,29,135,34,24,10
23,29,136,11,10,1
23,29,137,22,11,11
23,29,138,16,14,2
23,29,139,17,9,8
23,29,140,25,16,9
23,29,141,16,15,1
23,29,142,12,11,1
23,29,143,10,10,0
23,29,144,9,8,1
23,29,145,9,3,6
23,29,146,13,23,-10
23,29,147,21,14,7
23,29,148,13,10,3
23,29,149,9,11,-2
23,29,150,11,5,6
23,29,151,12,4,8
23,29,152,8,13,-5
23,29,153,9,7,2
23,29,154,6,14,-8
23,29,155,13,13,0
23,29,156,19,21,-2
23,29,157,5,11,-6
23,29,158,3,7,-4
23,29,159,3,5,-2
23,29,160,35,19,16
23,29,161,16,12,4
23,29,162,9,10,-1
23,29,163,17,7,10
23,29,164,9,9,0
23,29,165,9,7,2
23,29,166,12,22,-10
23,29,167,23,9,14
23,29,168,3,7,-4
23,29,169,14,10,4
23,29,170,8,4,4
23,29,171,12,14,-2
23,29,172,18,10,8
23,29,173,14,13,1
23,29,174,8,12,-4
23,29,175,10,9,1
23,29,176,15,10,5
23,29,177,11,13,-2
23,29,178,6,25,-19
23,29,179,11,11,0
23,29,180,10,12,-2
23,29,181,11,10,1
23,29,182,25,19,6
23,29,183,12,9,3
23,29,184,13,10,3
23,29,185,4,7,-3
23,29,186,10,1,9
23,29,187,15,21,-6
23,29,188,7,8,-1
23,29,189,10,5,5
23,29,190,15,15,0
23,29,191,21,14,7
23,29,192,13,14,-1
23,29,193,11,10,1
23,29,194,14,11,3
23,29,195,10,18,-8
23,29,196,8,9,-1
23,29,197,8,13,-5
23,29,198,14,17,-3
23,29,199,17,5,12
23,29,200,20,11,9
23,29,201,15,11,4
23,29,202,10,16,-6
23,29,203,19,7,12
23,29,204,15,13,2
23,29,205,24,15,9
23,29,206,6,7,-1
23,29,207,11,19,-8
23,29,208,13,10,3
23,29,209,8,22,-14
23,29,210,21,16,5
23,29,211,8,12,-4
23,29,212,15,6,9
23,29,213,11,19,-8
23,29,214,27,16,11
23,29,215,7,15,-8
23,29,216,14,10,4
23,29,217,21,8,13
23,29,218,15,8,7
23,29,219,13,15,-2
23,29,220,7,7,0
23,29,221,14,8,6
23,29,222,19,7,12
23,29,223,10,11,-1
23,29,224,13,22,-9
23,29,225,13,6,7
23,29,226,13,11,2
23,29,227,13,20,-7
23,29,228,16,10,6
23,29,229,19,37,-18
23,29,230,11,6,5
23,29,231,14,11,3
23,29,232,17,24,-7
23,29,233,13,7,6
23,29,234,17,6,11
23,29,235,6,21,-15
23,29,236,8,9,-1
23,29,237,12,12,0
23,29,238,8,8,0
23,29,239,7,15,-8
23,29,240,6,11,-5
23,29,241,18,13,5
23,29,242,11,23,-12
23,29,243,14,16,-2
23,29,244,11,19,-8
23,29,245,11,14,-3
23,29,246,16,9,7
23,29,247,14,11,3
23,29,248,16,21,-5
23,29,249,17,13,4
23,29,250,6,11,-5
23,29,251,10,2,8
23,29,252,20,23,-3
23,29,253,15,7,8
23,29,254,13,10,3
23,29,255,10,6,4
23,29,256,25,13,12
23,29,257,34,24,10
23,29,258,13,22,-9
23,29,259,10,10,0
23,29,260,11,8,3
23,29,261,13,22,-9
23,29,262,17,12,5
23,29,263,13,6,7
23,29,264,17,21,-4
23,29,265,6,16,-10
23,29,266,5,8,-3
23,29,267,11,17,-6
23,29,268,17,6,11
23,29,269,15,5,10
23,29,270,19,11,8
23,29,271,9,22,-13
23,29,272,8,5,3
23,29,273,18,5,13
23,29,274,2,7,-5
23,29,275,5,17,-12
23,29,276,5,6,-1
23,29,277,9,13,-4
23,29,278,31,19,12
23,29,279,7,3,4
23,29,280,5,12,-7
23,29,281,9,10,-1
23,29,282,12,12,0
23,29,283,16,16,0
23,29,284,10,9,1
23,29,285,16,27,-11
23,29,286,12,24,-12
23,29,287,10,15,-5
23,29,288,9,17,-8
23,29,289,14,16,-2
23,29,290,14,29,-15
23,29,291,13,9,4
23,29,292,13,18,-5
23,29,293,4,9,-5
23,29,294,10,14,-4
23,29,295,9,9,0
23,29,296,20,12,8
23,29,297,26,6,20
23,29,298,33,12,21
23,29,299,6,10,-4
23,30,0,16,16,0
23,30,1,13,9,4
23,30,2,12,11,1
23,30,3,7,7,0
23,30,4,11,1,10
23,30,5,21,15,6
23,30,6,18,14,4
23,30,7,12,8,4
23,30,8,20,15,5
23,30,9,12,12,0
23,30,10,10,10,0
23,30,11,14,16,-2
23,30,12,15,19,-4
23,30,13,10,12,-2
23,30,14,10,15,-5
23,30,15,9,12,-3
23,30,16,15,21,-6
23,30,17,9,9,0
23,30,18,11,7,4
23,30,19,14,9,5
23,30,20,19,15,4
23,30,21,21,12,9
23,30,22,23,12,11
23,30,23,10,11,-1
23,30,24,14,15,-1
23,30,25,20,17,3
23,30,26,13,8,5
23,30,27,9,15,-6
23,30,28,4,7,-3
23,30,29,5,17,-12
23,30,30,8,10,-2
23,30,31,10,13,-3
23,30,32,17,15,2
23,30,33,21,11,10
23,30,34,9,18,-9
23,30,35,12,8,4
23,30,36,11,18,-7
23,30,37,14,14,0
23,30,38,8,7,1
23,30,39,14,14,0
23,30,40,14,9,5
23,30,41,20,20,0
23,30,42,7,13,-6
23,30,43,13,5,8
23,30,44,11,11,0
23,30,45,11,28,-17
23,30,46,6,7,-1
23,30,47,12,6,6
23,30,48,12,8,4
23,30,49,12,11,1
23,30,50,14,13,1
23,30,51,7,8,-1
23,30,52,16,9,7
23,30,53,24,15,9
23,30,54,12,12,0
23,30,55,23,23,0
23,30,56,23,8,15
23,30,57,7,4,3
23,30,58,18,21,-3
23,30,59,14,11,3
23,30,60,12,8,4
23,30,61,21,16,5
23,30,62,18,21,-3
23,30,63,16,14,2
23,30,64,21,18,3
23,30,65,20,14,6
23,30,66,19,18,1
23,30,67,23,7,16
23,30,68,13,12,1
23,30,69,18,6,12
23,30,70,19,15,4
23,30,71,10,10,0
23,30,72,17,25,-8
23,30,73,12,14,-2
23,30,74,14,9,5
23,30,75,20,23,-3
23,30,76,12,14,-2
23,30,77,10,9,1
23,30,78,19,2,17
23,30,79,5,7,-2
23,30,80,17,23,-6
23,30,81,12,1,11
23,30,82,17,15,2
23,30,83,18,9,9
23,30,84,6,12,-6
23,30,85,25,7,18
23,30,86,27,15,12
23,30,87,11,4,7
23,30,88,9,6,3
23,30,89,9,16,-7
23,30,90,17,9,8
23,30,91,10,24,-14
23,30,92,10,7,3
23,30,93,14,14,0
23,30,94,23,6,17
23,30,95,13,11,2
23,30,96,4,10,-6
23,30,97,11,9,2
23,30,98,10,11,-1
23,30,99,16,11,5
23,30,100,16,21,-5
23,30,101,15,18,-3
23,30,102,10,6,4
23,30,103,13,14,-1
23,30,104,8,13,-5
23,30,105,18,8,10
23,30,106,17,19,-2
23,30,107,16,13,3
23,30,108,20,19,1
23,30,109,9,10,-1
23,30,110,9,8,1
23,30,111,13,10,3
23,30,112,15,11,4
23,30,113,15,10,5
23,30,114,16,6,10
23,30,115,20,15,5
23,30,116,4,15,-11
23,30,117,12,19,-7
23,30,118,7,4,3
23,30,119,16,11,5
23,30,120,12,4,8
23,30,121,19,33,-14
23,30,122,21,19,2
23,30,123,11,5,6
23,30,124,14,11,3
23,30,125,8,9,-1
23,30,126,18,13,5
23,30,127,11,17,-6
23,30,128,8,8,0
23,30,129,8,12,-4
23,30,130,15,11,4
23,30,131,16,7,9
23,30,132,8,7,1
23,30,133,8,7,1
23,30,134,13,12,1
23,30,135,14,9,5
23,30,136,8,12,-4
23,30,137,12,5,7
23,30,138,27,15,12
23,30,139,17,16,1
23,30,140,15,17,-2
23,30,141,9,15,-6
23,30,142,17,11,6
23,30,143,8,10,-2
23,30,144,12,12,0
23,30,145,22,7,15
23,30,146,11,6,5
23,30,147,12,7,5
23,30,148,8,13,-5
23,30,149,20,23,-3
23,30,150,21,15,6
23,30,151,16,6,10
23,30,152,15,18,-3
23,30,153,13,8,5
23,30,154,22,9,13
23,30,155,11,13,-2
23,30,156,23,13,10
23,30,157,10,8,2
23,30,158,4,6,-2
23,30,159,12,14,-2
23,30,160,15,9,6
23,30,161,16,8,8
23,30,162,14,8,6
23,30,163,17,16,1
23,30,164,5,18,-13
23,30,165,8,10,-2
23,30,166,10,13,-3
23,30,167,21,10,11
23,30,168,11,12,-1
23,30,169,21,15,6
23,30,170,19,7,12
23,30,171,16,17,-1
23,30,172,10,4,6
23,30,173,19,19,0
23,30,174,15,9,6
23,30,175,10,7,3
23,30,176,13,3,10
23,30,177,15,11,4
23,30,178,6,16,-10
23,30,179,7,13,-6
23,30,180,4,13,-9
23,30,181,11,10,1
23,30,182,13,4,9
23,30,183,12,16,-4
23,30,184,5,2,3
23,30,185,21,16,5
23,30,186,26,7,19
23,30,187,5,4,1
23,30,188,17,13,4
23,30,189,20,11,9
23,30,190,7,8,-1
23,30,191,9,18,-9
23,30,192,9,19,-10
23,30,193,18,12,6
23,30,194,8,0,8
23,30,195,23,18,5
23,30,196,18,7,11
23,30,197,14,18,-4
23,30,198,18,20,-2
23,30,199,9,13,-4
23,30,200,11,6,5
23,30,201,15,14,1
23,30,202,20,8,12
23,30,203,22,8,14
23,30,204,13,10,3
23,30,205,3,3,0
23,30,206,18,18,0
23,30,207,14,12,2
23,30,208,8,12,-4
23,30,209,15,19,-4
23,30,210,13,7,6
23,30,211,10,1,9
23,30,212,11,8,3
23,30,213,9,10,-1
23,30,214,17,11,6
23,30,215,13,4,9
23,30,216,14,7,7
23,30,217,8,11,-3
23,30,218,12,8,4
23,30,219,16,13,3
23,30,220,13,11,2
23,30,221,6,14,-8
23,30,222,24,16,8
23,30,223,10,9,1
23,30,224,6,14,-8
23,30,225,17,18,-1
23,30,226,13,7,6
23,30,227,15,21,-6
23,30,228,6,10,-4
23,30,229,10,11,-1
23,30,230,7,10,-3
23,30,231,12,9,3
23,30,232,9,13,-4
23,30,233,6,6,0
23,30,234,22,12,10
23,30,235,9,11,-2
23,30,236,13,12,1
23,30,237,9,15,-6
23,30,238,20,23,-3
23,30,239,9,10,-1
23,30,240,5,10,-5
23,30,241,11,9,2
23,30,242,6,10,-4
23,30,243,21,13,8
23,30,244,15,11,4
23,30,245,13,2,11
23,30,246,14,13,1
23,30,247,14,9,5
23,30,248,17,11,6
23,30,249,13,12,1
23,30,250,21,18,3
23,30,251,7,10,-3
23,30,252,16,10,6
23,30,253,21,13,8
23,30,254,7,11,-4
23,30,255,15,8,7
23,30,256,14,11,3
23,30,257,16,8,8
23,30,258,17,16,1
23,30,259,5,10,-5
23,30,260,21,10,11
23,30,261,19,19,0
23,30,262,17,10,7
23,30,263,14,14,0
23,30,264,15,7,8
23,30,265,10,13,-3
23,30,266,9,9,0
23,30,267,8,11,-3
23,30,268,20,15,5
23,30,269,19,11,8
23,30,270,25,15,10
23,30,271,17,22,-5
23,30,272,21,23,-2
23,30,273,12,13,-1
23,30,274,14,10,4
23,30,275,21,14,7
23,30,276,13,14,-1
23,30,277,12,12,0
23,30,278,16,10,6
23,30,279,28,12,16
23,30,280,20,13,7
23,30,281,9,10,-1
23,30,282,11,6,5
23,30,283,14,8,6
23,30,284,10,23,-13
23,30,285,21,20,1
23,30,286,6,17,-11
23,30,287,24,15,9
23,30,288,11,2,9
23,30,289,20,36,-16
23,30,290,23,11,12
23,30,291,27,33,-6
23,30,292,9,18,-9
23,30,293,13,3,10
23,30,294,0,9,-9
23,30,295,20,10,10
23,30,296,23,15,8
23,30,297,9,12,-3
23,30,298,11,6,5
23,30,299,8,8,0
24,1,0,16,23,-7
24,1,1,4,16,-12
24,1,2,7,19,-12
24,1,3,10,8,2
24,1,4,5,20,-15
24,1,5,14,20,-6
24,1,6,12,29,-17
24,1,7,11,19,-8
24,1,8,6,11,-5
24,1,9,11,20,-9
24,1,10,1,19,-18
24,1,11,8,20,-12
24,1,12,6,12,-6
24,1,13,3,13,-10
24,1,14,10,9,1
24,1,15,10,36,-26
24,1,16,6,38,-32
24,1,17,7,15,-8
24,1,18,11,13,-2
24,1,19,10,20,-10
24,1,20,9,24,-15
24,1,21,2,14,-12
24,1,22,10,13,-3
24,1,23,5,14,-9
24,1,24,13,16,-3
24,1,25,15,17,-2
24,1,26,7,14,-7
24,1,27,12,9,3
24,1,28,11,13,-2
24,1,29,12,17,-5
24,1,30,7,15,-8
24,1,31,7,15,-8
24,1,32,17,24,-7
24,1,33,6,11,-5
24,1,34,12,21,-9
24,1,35,7,13,-6
24,1,36,9,12,-3
24,1,37,8,15,-7
24,1,38,5,16,-11
24,1,39,7,24,-17
24,1,40,10,18,-8
24,1,41,32,33,-1
24,1,42,9,26,-17
24,1,43,1,17,-16
24,1,44,7,14,-7
24,1,45,3,8,-5
24,1,46,13,19,-6
24,1,47,9,14,-5
24,1,48,8,27,-19
24,1,49,2,17,-15
24,1,50,11,22,-11
24,1,51,6,19,-13
24,1,52,15,29,-14
24,1,53,2,10,-8
24,1,54,5,15,-10
24,1,55,10,26,-16
24,1,56,5,17,-12
24,1,57,15,12,3
24,1,58,5,6,-1
24,1,59,11,18,-7
24,1,60,5,7,-2
24,1,61,9,9,0
24,1,62,17,22,-5
24,1,63,1,8,-7
24,1,64,8,20,-12
24,1,65,12,17,-5
24,1,66,15,18,-3
24,1,67,12,30,-18
24,1,68,5,2,3
24,1,69,3,15,-12
24,1,70,10,11,-1
24,1,71,11,13,-2
24,1,72,15,28,-13
24,1,73,16,16,0
24,1,74,7,9,-2
24,1,75,14,12,2
24,1,76,15,20,-5
24,1,77,14,18,-4
24,1,78,1,13,-12
24,1,79,7,6,1
24,1,80,13,28,-15
24,1,81,8,16,-8
24,1,82,9,20,-11
24,1,83,10,25,-15
24,1,84,10,15,-5
24,1,85,13,19,-6
24,1,86,10,21,-11
24,1,87,12,22,-10
24,1,88,4,6,-2
24,1,89,4,17,-13
24,1,90,10,17,-7
24,1,91,5,17,-12
24,1,92,6,26,-20
24,1,93,3,16,-13
24,1,94,5,14,-9
24,1,95,14,15,-1
24,1,96,1,15,-14
24,1,97,8,33,-25
24,1,98,25,21,4
24,1,99,6,16,-10
24,1,100,7,7,0
24,1,101,3,19,-16
24,1,102,5,19,-14
24,1,103,4,7,-3
24,1,104,12,27,-15
24,1,105,16,16,0
24,1,106,10,7,3
24,1,107,13,20,-7
24,1,108,7,12,-5
24,1,109,3,28,-25
24,1,110,4,9,-5
24,1,111,5,13,-8
24,1,112,8,19,-11
24,1,113,9,23,-14
24,1,114,1,4,-3
24,1,115,2,15,-13
24,1,116,2,13,-11
24,1,117,19,16,3
24,1,118,21,37,-16
24,1,119,5,13,-8
24,1,120,7,11,-4
24,1,121,7,25,-18
24,1,122,6,14,-8
24,1,123,11,22,-11
24,1,124,14,12,2
24,1,125,8,16,-8
24,1,126,8,12,-4
24,1,127,6,12,-6
24,1,128,11,17,-6
24,1,129,10,19,-9
24,1,130,8,20,-12
24,1,131,12,15,-3
24,1,132,6,10,-4
24,1,133,7,30,-23
24,1,134,10,5,5
24,1,135,7,16,-9
24,1,136,5,8,-3
24,1,137,5,18,-13
24,1,138,5,9,-4
24,1,139,11,17,-6
24,1,140,9,25,-16
24,1,141,5,24,-19
24,1,142,21,20,1
24,1,143,10,8,2
24,1,144,4,20,-16
24,1,145,7,19,-12
24,1,146,3,13,-10
24,1,147,14,19,-5
24,1,148,2,10,-8
24,1,149,10,27,-17
24,1,150,7,23,-16
24,1,151,15,13,2
24,1,152,5,19,-14
24,1,153,2,12,-10
24,1,154,9,19,-10
24,1,155,12,20,-8
24,1,156,4,11,-7
24,1,157,6,32,-26
24,1,158,8,24,-16
24,1,159,5,34,-29
24,1,160,7,13,-6
24,1,161,2,18,-16
24,1,162,11,17,-6
24,1,163,3,21,-18
24,1,164,7,11,-4
24,1,165,8,23,-15
24,1,166,6,20,-14
24,1,167,14,13,1
24,1,168,9,15,-6
24,1,169,11,22,-11
24,1,170,5,26,-21
24,1,171,5,29,-24
24,1,172,17,15,2
24,1,173,18,14,4
24,1,174,17,25,-8
24,1,175,9,9,0
24,1,176,11,26,-15
24,1,177,11,19,-8
24,1,178,6,27,-21
24,1,179,5,15,-10
24,1,180,7,8,-1
24,1,181,6,17,-11
24,1,182,2,23,-21
24,1,183,5,16,-11
24,1,184,6,21,-15
24,1,185,6,38,-32
24,1,186,3,33,-30
24,1,187,9,15,-6
24,1,188,4,17,-13
24,1,189,6,18,-12
24,1,190,2,13,-11
24,1,191,10,6,4
24,1,192,8,23,-15
24,1,193,15,28,-13
24,1,194,5,18,-13
24,1,195,4,23,-19
24,1,196,2,3,-1
24,1,197,7,29,-22
24,1,198,10,19,-9
24,1,199,4,12,-8
24,1,200,8,17,-9
24,1,201,11,18,-7
24,1,202,7,17,-10
24,1,203,9,20,-11
24,1,204,7,11,-4
24,1,205,5,13,-8
24,1,206,7,17,-10
24,1,207,16,10,6
24,1,208,2,4,-2
24,1,209,7,16,-9
24,1,210,8,14,-6
24,1,211,9,12,-3
24,1,212,18,32,-14
24,1,213,5,12,-7
24,1,214,3,18,-15
24,1,215,8,6,2
24,1,216,7,23,-16
24,1,217,11,17,-6
24,1,218,6,13,-7
24,1,219,6,8,-2
24,1,220,9,16,-7
24,1,221,12,25,-13
24,1,222,14,8,6
24,1,223,16,13,3
24,1,224,8,15,-7
24,1,225,5,23,-18
24,1,226,6,11,-5
24,1,227,3,11,-8
24,1,228,13,15,-2
24,1,229,11,23,-12
24,1,230,7,14,-7
24,1,231,4,14,-10
24,1,232,7,26,-19
24,1,233,12,21,-9
24,1,234,3,11,-8
24,1,235,8,22,-14
24,1,236,3,14,-11
24,1,237,10,19,-9
24,1,238,9,25,-16
24,1,239,3,7,-4
24,1,240,6,14,-8
24,1,241,3,16,-13
24,1,242,4,21,-17
24,1,243,11,10,1
24,1,244,12,15,-3
24,1,245,4,8,-4
24,1,246,13,17,-4
24,1,247,8,21,-13
24,1,248,16,17,-1
24,1,249,7,12,-5
24,1,250,14,25,-11
24,1,251,6,17,-11
24,1,252,4,26,-22
24,1,253,9,10,-1
24,1,254,10,17,-7
24,1,255,16,22,-6
24,1,256,4,13,-9
24,1,257,3,18,-15
24,1,258,13,25,-12
24,1,259,7,23,-16
24,1,260,3,15,-12
24,1,261,10,21,-11
24,1,262,10,9,1
24,1,263,6,11,-5
24,1,264,10,27,-17
24,1,265,16,16,0
24,1,266,14,32,-18
24,1,267,9,14,-5
24,1,268,3,30,-27
24,1,269,7,16,-9
24,1,270,6,18,-12
24,1,271,6,17,-11
24,1,272,1,13,-12
24,1,273,2,4,-2
24,1,274,5,15,-10
24,1,275,11,32,-21
24,1,276,12,17,-5
24,1,277,11,19,-8
24,1,278,7,10,-3
24,1,279,4,26,-22
24,1,280,10,15,-5
24,1,281,3,23,-20
24,1,282,2,14,-12
24,1,283,14,17,-3
24,1,284,7,20,-13
24,1,285,8,11,-3
24,1,286,5,11,-6
24,1,287,5,14,-9
24,1,288,11,23,-12
24,1,289,6,15,-9
24,1,290,14,16,-2
24,1,291,2,17,-15
24,1,292,6,4,2
24,1,293,10,22,-12
24,1,294,7,23,-16
24,1,295,9,20,-11
24,1,296,8,13,-5
24,1,297,0,10,-10
24,1,298,2,6,-4
24,1,299,9,18,-9
24,2,0,11,19,-8
24,2,1,12,15,-3
24,2,2,8,39,-31
24,2,3,16,32,-16
24,2,4,12,23,-11
24,2,5,6,13,-7
24,2,6,9,9,0
24,2,7,15,17,-2
24,2,8,8,14,-6
24,2,9,11,20,-9
24,2,10,8,13,-5
24,2,11,10,29,-19
24,2,12,11,11,0
24,2,13,4,22,-18
24,2,14,4,13,-9
24,2,15,11,19,-8
24,2,16,15,26,-11
24,2,17,4,28,-24
24,2,18,6,19,-13
24,2,19,2,12,-10
24,2,20,8,22,-14
24,2,21,6,12,-6
24,2,22,4,16,-12
24,2,23,10,14,-4
24,2,24,8,21,-13
24,2,25,10,17,-7
24,2,26,5,30,-25
24,2,27,8,22,-14
24,2,28,10,12,-2
24,2,29,5,15,-10
24,2,30,7,13,-6
24,2,31,7,11,-4
24,2,32,3,16,-13
24,2,33,12,26,-14
24,2,34,8,11,-3
24,2,35,5,14,-9
24,2,36,8,13,-5
24,2,37,5,6,-1
24,2,38,10,15,-5
24,2,39,4,8,-4
24,2,40,3,9,-6
24,2,41,22,25,-3
24,2,42,6,12,-6
24,2,43,7,15,-8
24,2,44,6,35,-29
24,2,45,8,14,-6
24,2,46,11,22,-11
24,2,47,9,10,-1
24,2,48,11,31,-20
24,2,49,14,19,-5
24,2,50,2,3,-1
24,2,51,7,10,-3
24,2,52,7,6,1
24,2,53,8,20,-12
24,2,54,5,17,-12
24,2,55,17,26,-9
24,2,56,17,26,-9
24,2,57,11,12,-1
24,2,58,8,18,-10
24,2,59,8,19,-11
24,2,60,6,11,-5
24,2,61,10,23,-13
24,2,62,6,14,-8
24,2,63,10,12,-2
24,2,64,8,7,1
24,2,65,7,20,-13
24,2,66,5,27,-22
24,2,67,13,34,-21
24,2,68,9,39,-30
24,2,69,3,15,-12
24,2,70,6,13,-7
24,2,71,9,18,-9
24,2,72,8,21,-13
24,2,73,4,28,-24
24,2,74,9,11,-2
24,2,75,9,8,1
24,2,76,19,13,6
24,2,77,2,17,-15
24,2,78,13,18,-5
24,2,79,9,20,-11
24,2,80,9,15,-6
24,2,81,7,14,-7
24,2,82,4,25,-21
24,2,83,0,10,-10
24,2,84,3,11,-8
24,2,85,3,7,-4
24,2,86,7,20,-13
24,2,87,1,9,-8
24,2,88,2,21,-19
24,2,89,14,4,10
24,2,90,9,21,-12
24,2,91,6,34,-28
24,2,92,7,18,-11
24,2,93,7,23,-16
24,2,94,6,20,-14
24,2,95,3,25,-22
24,2,96,8,11,-3
24,2,97,7,2,5
24,2,98,6,15,-9
24,2,99,13,25,-12
24,2,100,7,19,-12
24,2,101,10,21,-11
24,2,102,19,13,6
24,2,103,8,12,-4
24,2,104,6,15,-9
24,2,105,3,21,-18
24,2,106,2,13,-11
24,2,107,17,18,-1
24,2,108,12,20,-8
24,2,109,8,8,0
24,2,110,12,25,-13
24,2,111,3,10,-7
24,2,112,10,30,-20
24,2,113,4,10,-6
24,2,114,17,27,-10
24,2,115,14,24,-10
24,2,116,11,24,-13
24,2,117,10,27,-17
24,2,118,11,18,-7
24,2,119,8,20,-12
24,2,120,10,17,-7
24,2,121,14,12,2
24,2,122,7,14,-7
24,2,123,7,15,-8
24,2,124,6,27,-21
24,2,125,14,17,-3
24,2,126,10,18,-8
24,2,127,15,30,-15
24,2,128,2,14,-12
24,2,129,4,17,-13
24,2,130,8,27,-19
24,2,131,13,16,-3
24,2,132,9,17,-8
24,2,133,4,21,-17
24,2,134,7,12,-5
24,2,135,7,9,-2
24,2,136,8,20,-12
24,2,137,5,16,-11
24,2,138,9,18,-9
24,2,139,8,16,-8
24,2,140,10,8,2
24,2,141,5,10,-5
24,2,142,5,12,-7
24,2,143,9,16,-7
24,2,144,11,12,-1
24,2,145,3,7,-4
24,2,146,10,17,-7
24,2,147,7,23,-16
24,2,148,4,15,-11
24,2,149,13,23,-10
24,2,150,8,15,-7
24,2,151,8,24,-16
24,2,152,4,6,-2
24,2,153,7,22,-15
24,2,154,8,8,0
24,2,155,3,15,-12
24,2,156,15,29,-14
24,2,157,15,25,-10
24,2,158,16,34,-18
24,2,159,2,7,-5
24,2,160,1,17,-16
24,2,161,10,7,3
24,2,162,10,25,-15
24,2,163,2,18,-16
24,2,164,5,12,-7
24,2,165,10,13,-3
24,2,166,7,18,-11
24,2,167,12,40,-28
24,2,168,4,7,-3
24,2,169,10,33,-23
24,2,170,7,24,-17
24,2,171,4,27,-23
24,2,172,7,29,-22
24,2,173,8,24,-16
24,2,174,3,21,-18
24,2,175,14,21,-7
24,2,176,11,14,-3
24,2,177,0,5,-5
24,2,178,8,24,-16
24,2,179,9,11,-2
24,2,180,10,35,-25
24,2,181,6,18,-12
24,2,182,6,11,-5
24,2,183,7,22,-15
24,2,184,7,17,-10
24,2,185,11,13,-2
24,2,186,1,11,-10
24,2,187,8,9,-1
24,2,188,17,15,2
24,2,189,12,17,-5
24,2,190,7,25,-18
24,2,191,7,13,-6
24,2,192,9,32,-23
24,2,193,6,21,-15
24,2,194,9,19,-10
24,2,195,6,16,-10
24,2,196,15,25,-10
24,2,197,5,20,-15
24,2,198,8,21,-13
24,2,199,3,11,-8
24,2,200,5,15,-10
24,2,201,5,12,-7
24,2,202,4,20,-16
24,2,203,8,11,-3
24,2,204,13,21,-8
24,2,205,5,10,-5
24,2,206,9,34,-25
24,2,207,5,24,-19
24,2,208,5,19,-14
24,2,209,12,32,-20
24,2,210,15,22,-7
24,2,211,8,17,-9
24,2,212,0,9,-9
24,2,213,9,25,-16
24,2,214,12,26,-14
24,2,215,7,19,-12
24,2,216,5,10,-5
24,2,217,8,28,-20
24,2,218,6,15,-9
24,2,219,4,31,-27
24,2,220,6,10,-4
24,2,221,8,26,-18
24,2,222,9,23,-14
24,2,223,8,18,-10
24,2,224,7,13,-6
24,2,225,10,27,-17
24,2,226,7,18,-11
24,2,227,8,18,-10
24,2,228,4,12,-8
24,2,229,8,10,-2
24,2,230,7,7,0
24,2,231,7,12,-5
24,2,232,16,23,-7
24,2,233,16,22,-6
24,2,234,7,15,-8
24,2,235,11,31,-20
24,2,236,4,15,-11
24,2,237,25,20,5
24,2,238,4,11,-7
24,2,239,8,22,-14
24,2,240,8,7,1
24,2,241,14,23,-9
24,2,242,5,20,-15
24,2,243,10,24,-14
24,2,244,6,12,-6
24,2,245,2,17,-15
24,2,246,4,13,-9
24,2,247,4,13,-9
24,2,248,10,26,-16
24,2,249,14,31,-17
24,2,250,6,27,-21
24,2,251,10,31,-21
24,2,252,3,15,-12
24,2,253,10,15,-5
24,2,254,11,12,-1
24,2,255,8,15,-7
24,2,256,9,9,0
24,2,257,2,20,-18
24,2,258,3,18,-15
24,2,259,7,14,-7
24,2,260,10,28,-18
24,2,261,4,14,-10
24,2,262,8,16,-8
24,2,263,5,39,-34
24,2,264,8,15,-7
24,2,265,7,16,-9
24,2,266,6,32,-26
24,2,267,4,14,-10
24,2,268,17,23,-6
24,2,269,8,19,-11
24,2,270,3,20,-17
24,2,271,9,17,-8
24,2,272,5,32,-27
24,2,273,8,22,-14
24,2,274,12,29,-17
24,2,275,10,18,-8
24,2,276,5,19,-14
24,2,277,7,29,-22
24,2,278,6,9,-3
24,2,279,11,16,-5
24,2,280,7,18,-11
24,2,281,10,15,-5
24,2,282,15,13,2
24,2,283,13,22,-9
24,2,284,10,34,-24
24,2,285,8,19,-11
24,2,286,5,13,-8
24,2,287,7,4,3
24,2,288,13,30,-17
24,2,289,12,30,-18
24,2,290,4,16,-12
24,2,291,10,22,-12
24,2,292,8,14,-6
24,2,293,8,4,4
24,2,294,13,28,-15
24,2,295,11,20,-9
24,2,296,7,13,-6
24,2,297,9,21,-12
24,2,298,4,12,-8
24,2,299,2,28,-26
24,3,0,15,27,-12
24,3,1,10,28,-18
24,3,2,3,33,-30
24,3,3,7,15,-8
24,3,4,15,39,-24
24,3,5,4,8,-4
24,3,6,10,17,-7
24,3,7,9,26,-17
24,3,8,7,17,-10
24,3,9,10,13,-3
24,3,10,7,16,-9
24,3,11,6,24,-18
24,3,12,13,9,4
24,3,13,11,20,-9
24,3,14,4,10,-6
24,3,15,10,16,-6
24,3,16,10,23,-13
24,3,17,10,8,2
24,3,18,9,30,-21
24,3,19,5,17,-12
24,3,20,6,18,-12
24,3,21,16,17,-1
24,3,22,20,24,-4
24,3,23,6,26,-20
24,3,24,5,15,-10
24,3,25,3,11,-8
24,3,26,13,10,3
24,3,27,8,27,-19
24,3,28,6,31,-25
24,3,29,10,32,-22
24,3,30,6,17,-11
24,3,31,7,16,-9
24,3,32,10,17,-7
24,3,33,14,24,-10
24,3,34,12,28,-16
24,3,35,10,14,-4
24,3,36,21,30,-9
24,3,37,11,16,-5
24,3,38,4,26,-22
24,3,39,11,7,4
24,3,40,6,20,-14
24,3,41,14,24,-10
24,3,42,7,12,-5
24,3,43,3,10,-7
24,3,44,4,10,-6
24,3,45,10,21,-11
24,3,46,7,10,-3
24,3,47,13,14,-1
24,3,48,7,10,-3
24,3,49,5,37,-32
24,3,50,3,7,-4
24,3,51,10,22,-12
24,3,52,6,9,-3
24,3,53,5,16,-11
24,3,54,5,17,-12
24,3,55,7,15,-8
24,3,56,14,22,-8
24,3,57,7,19,-12
24,3,58,4,6,-2
24,3,59,13,28,-15
24,3,60,10,9,1
24,3,61,10,23,-13
24,3,62,8,19,-11
24,3,63,5,9,-4
24,3,64,11,17,-6
24,3,65,11,28,-17
24,3,66,7,23,-16
24,3,67,7,17,-10
24,3,68,11,23,-12
24,3,69,7,12,-5
24,3,70,8,8,0
24,3,71,8,10,-2
24,3,72,5,39,-34
24,3,73,7,23,-16
24,3,74,2,12,-10
24,3,75,9,11,-2
24,3,76,11,18,-7
24,3,77,10,24,-14
24,3,78,5,14,-9
24,3,79,22,28,-6
24,3,80,7,14,-7
24,3,81,13,18,-5
24,3,82,3,17,-14
24,3,83,8,21,-13
24,3,84,3,9,-6
24,3,85,11,18,-7
24,3,86,3,22,-19
24,3,87,5,13,-8
24,3,88,5,16,-11
24,3,89,5,7,-2
24,3,90,10,23,-13
24,3,91,0,9,-9
24,3,92,11,14,-3
24,3,93,13,17,-4
24,3,94,7,19,-12
24,3,95,7,27,-20
24,3,96,6,11,-5
24,3,97,8,21,-13
24,3,98,9,17,-8
24,3,99,4,21,-17
24,3,100,9,28,-19
24,3,101,11,16,-5
24,3,102,14,12,2
24,3,103,6,13,-7
24,3,104,8,16,-8
24,3,105,10,15,-5
24,3,106,14,17,-3
24,3,107,7,9,-2
24,3,108,14,16,-2
24,3,109,11,18,-7
24,3,110,8,22,-14
24,3,111,13,30,-17
24,3,112,6,21,-15
24,3,113,11,17,-6
24,3,114,8,11,-3
24,3,115,5,19,-14
24,3,116,3,9,-6
24,3,117,3,15,-12
24,3,118,7,20,-13
24,3,119,9,34,-25
24,3,120,9,31,-22
24,3,121,20,28,-8
24,3,122,13,14,-1
24,3,123,9,39,-30
24,3,124,7,15,-8
24,3,125,5,32,-27
24,3,126,11,16,-5
24,3,127,12,39,-27
24,3,128,9,20,-11
24,3,129,4,9,-5
24,3,130,5,17,-12
24,3,131,7,26,-19
24,3,132,9,17,-8
24,3,133,2,19,-17
24,3,134,18,18,0
24,3,135,8,45,-37
24,3,136,3,16,-13
24,3,137,10,14,-4
24,3,138,10,24,-14
24,3,139,10,13,-3
24,3,140,5,27,-22
24,3,141,19,30,-11
24,3,142,21,28,-7
24,3,143,5,6,-1
24,3,144,12,19,-7
24,3,145,16,32,-16
24,3,146,12,35,-23
24,3,147,14,27,-13
24,3,148,16,16,0
24,3,149,11,20,-9
24,3,150,16,27,-11
24,3,151,9,40,-31
24,3,152,6,6,0
24,3,153,9,17,-8
24,3,154,12,23,-11
24,3,155,10,31,-21
24,3,156,22,31,-9
24,3,157,7,12,-5
24,3,158,5,23,-18
24,3,159,8,8,0
24,3,160,14,27,-13
24,3,161,10,24,-14
24,3,162,8,25,-17
24,3,163,3,10,-7
24,3,164,13,14,-1
24,3,165,8,15,-7
24,3,166,14,35,-21
24,3,167,10,18,-8
24,3,168,4,3,1
24,3,169,12,23,-11
24,3,170,6,19,-13
24,3,171,10,21,-11
24,3,172,14,12,2
24,3,173,17,26,-9
24,3,174,9,15,-6
24,3,175,8,32,-24
24,3,176,6,12,-6
24,3,177,18,22,-4
24,3,178,9,21,-12
24,3,179,7,14,-7
24,3,180,9,32,-23
24,3,181,11,37,-26
24,3,182,7,30,-23
24,3,183,9,32,-23
24,3,184,3,19,-16
24,3,185,9,7,2
24,3,186,11,7,4
24,3,187,9,15,-6
24,3,188,11,12,-1
24,3,189,6,19,-13
24,3,190,7,6,1
24,3,191,14,16,-2
24,3,192,18,22,-4
24,3,193,11,17,-6
24,3,194,6,17,-11
24,3,195,11,19,-8
24,3,196,7,39,-32
24,3,197,15,23,-8
24,3,198,11,20,-9
24,3,199,13,13,0
24,3,200,11,11,0
24,3,201,8,16,-8
24,3,202,5,9,-4
24,3,203,7,19,-12
24,3,204,14,27,-13
24,3,205,6,22,-16
24,3,206,6,11,-5
24,3,207,12,14,-2
24,3,208,9,19,-10
24,3,209,14,18,-4
24,3,210,8,14,-6
24,3,211,13,24,-11
24,3,212,10,25,-15
24,3,213,25,38,-13
24,3,214,4,10,-6
24,3,215,6,10,-4
24,3,216,8,12,-4
24,3,217,8,27,-19
24,3,218,10,6,4
24,3,219,16,17,-1
24,3,220,11,20,-9
24,3,221,8,13,-5
24,3,222,12,21,-9
24,3,223,15,11,4
24,3,224,12,8,4
24,3,225,6,15,-9
24,3,226,3,36,-33
24,3,227,9,10,-1
24,3,228,5,12,-7
24,3,229,5,17,-12
24,3,230,9,23,-14
24,3,231,5,9,-4
24,3,232,7,14,-7
24,3,233,6,17,-11
24,3,234,8,13,-5
24,3,235,16,31,-15
24,3,236,13,18,-5
24,3,237,10,12,-2
24,3,238,10,21,-11
24,3,239,2,8,-6
24,3,240,19,10,9
24,3,241,17,20,-3
24,3,242,17,25,-8
24,3,243,6,15,-9
24,3,244,14,19,-5
24,3,245,10,28,-18
24,3,246,9,21,-12
24,3,247,15,26,-11
24,3,248,3,18,-15
24,3,249,11,22,-11
24,3,250,17,22,-5
24,3,251,11,27,-16
24,3,252,5,26,-21
24,3,253,12,14,-2
24,3,254,9,15,-6
24,3,255,21,47,-26
24,3,256,5,24,-19
24,3,257,11,20,-9
24,3,258,11,17,-6
24,3,259,2,12,-10
24,3,260,18,22,-4
24,3,261,6,21,-15
24,3,262,8,19,-11
24,3,263,3,14,-11
24,3,264,6,8,-2
24,3,265,4,17,-13
24,3,266,8,12,-4
24,3,267,9,15,-6
24,3,268,6,17,-11
24,3,269,8,29,-21
24,3,270,6,33,-27
24,3,271,3,27,-24
24,3,272,9,13,-4
24,3,273,7,15,-8
24,3,274,10,16,-6
24,3,275,10,31,-21
24,3,276,4,23,-19
24,3,277,7,18,-11
24,3,278,14,19,-5
24,3,279,4,24,-20
24,3,280,5,10,-5
24,3,281,17,28,-11
24,3,282,6,5,1
24,3,283,10,15,-5
24,3,284,1,5,-4
24,3,285,10,27,-17
24,3,286,10,21,-11
24,3,287,11,23,-12
24,3,288,8,7,1
24,3,289,8,14,-6
24,3,290,6,13,-7
24,3,291,7,17,-10
24,3,292,10,23,-13
24,3,293,2,14,-12
24,3,294,1,5,-4
24,3,295,8,17,-9
24,3,296,6,18,-12
24,3,297,5,9,-4
24,3,298,14,23,-9
24,3,299,12,17,-5
24,4,0,8,11,-3
24,4,1,10,22,-12
24,4,2,8,23,-15
24,4,3,3,30,-27
24,4,4,13,24,-11
24,4,5,4,7,-3
24,4,6,12,29,-17
24,4,7,5,14,-9
24,4,8,6,9,-3
24,4,9,3,10,-7
24,4,10,6,26,-20
24,4,11,10,20,-10
24,4,12,10,13,-3
24,4,13,9,20,-11
24,4,14,10,14,-4
24,4,15,10,20,-10
24,4,16,12,11,1
24,4,17,6,11,-5
24,4,18,3,17,-14
24,4,19,10,14,-4
24,4,20,11,22,-11
24,4,21,13,20,-7
24,4,22,4,18,-14
24,4,23,10,16,-6
24,4,24,9,18,-9
24,4,25,6,17,-11
24,4,26,9,12,-3
24,4,27,10,16,-6
24,4,28,14,14,0
24,4,29,11,20,-9
24,4,30,4,23,-19
24,4,31,8,19,-11
24,4,32,16,13,3
24,4,33,12,24,-12
24,4,34,1,10,-9
24,4,35,14,15,-1
24,4,36,7,20,-13
24,4,37,6,16,-10
24,4,38,6,11,-5
24,4,39,13,17,-4
24,4,40,9,9,0
24,4,41,5,19,-14
24,4,42,10,15,-5
24,4,43,5,14,-9
24,4,44,15,33,-18
24,4,45,16,18,-2
24,4,46,11,28,-17
24,4,47,16,23,-7
24,4,48,8,12,-4
24,4,49,9,20,-11
24,4,50,16,17,-1
24,4,51,8,14,-6
24,4,52,15,23,-8
24,4,53,3,21,-18
24,4,54,10,14,-4
24,4,55,14,15,-1
24,4,56,3,11,-8
24,4,57,5,12,-7
24,4,58,5,8,-3
24,4,59,9,18,-9
24,4,60,3,25,-22
24,4,61,13,36,-23
24,4,62,2,11,-9
24,4,63,9,9,0
24,4,64,8,28,-20
24,4,65,7,19,-12
24,4,66,10,20,-10
24,4,67,5,18,-13
24,4,68,7,35,-28
24,4,69,15,34,-19
24,4,70,6,15,-9
24,4,71,4,9,-5
24,4,72,12,17,-5
24,4,73,6,7,-1
24,4,74,7,29,-22
24,4,75,11,14,-3
24,4,76,15,17,-2
24,4,77,1,22,-21
24,4,78,3,6,-3
24,4,79,7,34,-27
24,4,80,4,12,-8
24,4,81,13,16,-3
24,4,82,15,15,0
24,4,83,3,7,-4
24,4,84,4,14,-10
24,4,85,14,41,-27
24,4,86,13,21,-8
24,4,87,13,23,-10
24,4,88,13,13,0
24,4,89,8,31,-23
24,4,90,12,12,0
24,4,91,7,37,-30
24,4,92,12,24,-12
24,4,93,6,21,-15
24,4,94,8,32,-24
24,4,95,6,22,-16
24,4,96,8,26,-18
24,4,97,11,17,-6
24,4,98,9,20,-11
24,4,99,11,21,-10
24,4,100,18,26,-8
24,4,101,13,20,-7
24,4,102,15,14,1
24,4,103,13,17,-4
24,4,104,6,12,-6
24,4,105,8,15,-7
24,4,106,5,29,-24
24,4,107,6,25,-19
24,4,108,6,6,0
24,4,109,9,15,-6
24,4,110,12,21,-9
24,4,111,11,16,-5
24,4,112,5,12,-7
24,4,113,12,22,-10
24,4,114,5,18,-13
24,4,115,6,17,-11
24,4,116,11,25,-14
24,4,117,10,41,-31
24,4,118,20,18,2
24,4,119,3,23,-20
24,4,120,6,14,-8
24,4,121,4,5,-1
24,4,122,10,17,-7
24,4,123,8,14,-6
24,4,124,10,26,-16
24,4,125,7,17,-10
24,4,126,7,15,-8
24,4,127,17,26,-9
24,4,128,4,24,-20
24,4,129,16,15,1
24,4,130,4,11,-7
24,4,131,17,21,-4
24,4,132,11,22,-11
24,4,133,10,13,-3
24,4,134,9,35,-26
24,4,135,9,8,1
24,4,136,11,15,-4
24,4,137,5,35,-30
24,4,138,14,30,-16
24,4,139,6,6,0
24,4,140,12,24,-12
24,4,141,4,22,-18
24,4,142,11,17,-6
24,4,143,6,19,-13
24,4,144,18,28,-10
24,4,145,3,16,-13
24,4,146,9,20,-11
24,4,147,9,19,-10
24,4,148,11,26,-15
24,4,149,7,20,-13
24,4,150,7,11,-4
24,4,151,13,6,7
24,4,152,11,22,-11
24,4,153,3,3,0
24,4,154,11,29,-18
24,4,155,8,29,-21
24,4,156,11,21,-10
24,4,157,5,15,-10
24,4,158,10,10,0
24,4,159,4,20,-16
24,4,160,5,10,-5
24,4,161,14,23,-9
24,4,162,16,29,-13
24,4,163,7,18,-11
24,4,164,17,22,-5
24,4,165,7,29,-22
24,4,166,4,9,-5
24,4,167,2,15,-13
24,4,168,16,26,-10
24,4,169,7,14,-7
24,4,170,10,26,-16
24,4,171,9,11,-2
24,4,172,8,15,-7
24,4,173,6,18,-12
24,4,174,4,20,-16
24,4,175,18,34,-16
24,4,176,9,11,-2
24,4,177,3,9,-6
24,4,178,7,14,-7
24,4,179,9,16,-7
24,4,180,8,18,-10
24,4,181,8,10,-2
24,4,182,2,14,-12
24,4,183,6,22,-16
24,4,184,6,13,-7
24,4,185,7,23,-16
24,4,186,14,28,-14
24,4,187,8,17,-9
24,4,188,4,13,-9
24,4,189,15,18,-3
24,4,190,12,14,-2
24,4,191,11,18,-7
24,4,192,7,14,-7
24,4,193,8,11,-3
24,4,194,5,25,-20
24,4,195,14,6,8
24,4,196,19,24,-5
24,4,197,8,14,-6
24,4,198,7,26,-19
24,4,199,9,25,-16
24,4,200,11,16,-5
24,4,201,9,24,-15
24,4,202,7,29,-22
24,4,203,11,18,-7
24,4,204,10,18,-8
24,4,205,14,24,-10
24,4,206,11,20,-9
24,4,207,9,24,-15
24,4,208,10,14,-4
24,4,209,11,25,-14
24,4,210,5,25,-20
24,4,211,9,18,-9
24,4,212,5,27,-22
24,4,213,12,10,2
24,4,214,8,12,-4
24,4,215,7,23,-16
24,4,216,7,10,-3
24,4,217,2,17,-15
24,4,218,11,36,-25
24,4,219,10,25,-15
24,4,220,10,19,-9
24,4,221,13,25,-12
24,4,222,2,8,-6
24,4,223,8,27,-19
24,4,224,13,19,-6
24,4,225,10,26,-16
24,4,226,6,8,-2
24,4,227,14,24,-10
24,4,228,8,19,-11
24,4,229,13,21,-8
24,4,230,14,19,-5
24,4,231,10,22,-12
24,4,232,9,14,-5
24,4,233,5,21,-16
24,4,234,15,15,0
24,4,235,5,15,-10
24,4,236,20,26,-6
24,4,237,11,17,-6
24,4,238,10,18,-8
24,4,239,8,20,-12
24,4,240,9,20,-11
24,4,241,4,8,-4
24,4,242,7,26,-19
24,4,243,15,21,-6
24,4,244,6,26,-20
24,4,245,6,9,-3
24,4,246,5,17,-12
24,4,247,10,14,-4
24,4,248,7,19,-12
24,4,249,14,22,-8
24,4,250,8,15,-7
24,4,251,6,27,-21
24,4,252,7,19,-12
24,4,253,11,27,-16
24,4,254,12,18,-6
24,4,255,8,17,-9
24,4,256,8,21,-13
24,4,257,5,13,-8
24,4,258,8,16,-8
24,4,259,9,20,-11
24,4,260,8,7,1
24,4,261,12,19,-7
24,4,262,10,15,-5
24,4,263,9,18,-9
24,4,264,10,15,-5
24,4,265,6,26,-20
24,4,266,10,15,-5
24,4,267,9,23,-14
24,4,268,7,20,-13
24,4,269,16,22,-6
24,4,270,7,7,0
24,4,271,4,22,-18
24,4,272,2,13,-11
24,4,273,10,34,-24
24,4,274,4,29,-25
24,4,275,16,20,-4
24,4,276,11,23,-12
24,4,277,6,16,-10
24,4,278,4,22,-18
24,4,279,8,18,-10
24,4,280,2,16,-14
24,4,281,20,17,3
24,4,282,11,24,-13
24,4,283,15,27,-12
24,4,284,13,25,-12
24,4,285,4,15,-11
24,4,286,4,20,-16
24,4,287,6,21,-15
24,4,288,5,13,-8
24,4,289,6,31,-25
24,4,290,12,21,-9
24,4,291,15,22,-7
24,4,292,6,27,-21
24,4,293,5,8,-3
24,4,294,9,20,-11
24,4,295,12,29,-17
24,4,296,8,33,-25
24,4,297,11,21,-10
24,4,298,5,19,-14
24,4,299,6,9,-3
24,5,0,5,19,-14
24,5,1,8,11,-3
24,5,2,3,11,-8
24,5,3,18,18,0
24,5,4,15,16,-1
24,5,5,5,10,-5
24,5,6,14,24,-10
24,5,7,7,16,-9
24,5,8,10,19,-9
24,5,9,4,23,-19
24,5,10,7,24,-17
24,5,11,6,25,-19
24,5,12,12,30,-18
24,5,13,8,18,-10
24,5,14,12,18,-6
24,5,15,6,23,-17
24,5,16,5,18,-13
24,5,17,7,26,-19
24,5,18,5,15,-10
24,5,19,12,22,-10
24,5,20,10,23,-13
24,5,21,10,11,-1
24,5,22,3,21,-18
24,5,23,11,25,-14
24,5,24,10,14,-4
24,5,25,14,25,-11
24,5,26,10,17,-7
24,5,27,8,25,-17
24,5,28,15,30,-15
24,5,29,5,17,-12
24,5,30,4,17,-13
24,5,31,12,19,-7
24,5,32,12,18,-6
24,5,33,13,20,-7
24,5,34,14,14,0
24,5,35,10,28,-18
24,5,36,10,25,-15
24,5,37,6,10,-4
24,5,38,17,32,-15
24,5,39,10,14,-4
24,5,40,4,8,-4
24,5,41,20,21,-1
24,5,42,7,23,-16
24,5,43,14,27,-13
24,5,44,12,23,-11
24,5,45,3,14,-11
24,5,46,9,34,-25
24,5,47,12,28,-16
24,5,48,19,22,-3
24,5,49,4,5,-1
24,5,50,9,14,-5
24,5,51,14,24,-10
24,5,52,3,13,-10
24,5,53,5,15,-10
24,5,54,9,20,-11
24,5,55,17,14,3
24,5,56,22,13,9
24,5,57,11,15,-4
24,5,58,1,10,-9
24,5,59,3,17,-14
24,5,60,16,12,4
24,5,61,6,24,-18
24,5,62,17,22,-5
24,5,63,2,16,-14
24,5,64,13,22,-9
24,5,65,5,34,-29
24,5,66,9,23,-14
24,5,67,4,19,-15
24,5,68,23,19,4
24,5,69,14,18,-4
24,5,70,4,16,-12
24,5,71,10,41,-31
24,5,72,3,25,-22
24,5,73,4,12,-8
24,5,74,8,21,-13
24,5,75,12,30,-18
24,5,76,10,16,-6
24,5,77,8,11,-3
24,5,78,8,10,-2
24,5,79,16,17,-1
24,5,80,6,17,-11
24,5,81,5,15,-10
24,5,82,9,18,-9
24,5,83,10,38,-28
24,5,84,5,16,-11
24,5,85,8,25,-17
24,5,86,12,9,3
24,5,87,3,19,-16
24,5,88,3,21,-18
24,5,89,11,38,-27
24,5,90,14,30,-16
24,5,91,2,6,-4
24,5,92,6,7,-1
24,5,93,11,19,-8
24,5,94,9,23,-14
24,5,95,7,30,-23
24,5,96,18,27,-9
24,5,97,11,21,-10
24,5,98,12,15,-3
24,5,99,8,12,-4
24,5,100,8,27,-19
24,5,101,7,17,-10
24,5,102,8,13,-5
24,5,103,5,21,-16
24,5,104,12,24,-12
24,5,105,17,31,-14
24,5,106,9,18,-9
24,5,107,12,10,2
24,5,108,8,7,1
24,5,109,11,15,-4
24,5,110,6,26,-20
24,5,111,3,10,-7
24,5,112,16,21,-5
24,5,113,13,22,-9
24,5,114,3,10,-7
24,5,115,8,32,-24
24,5,116,1,14,-13
24,5,117,21,20,1
24,5,118,9,34,-25
24,5,119,9,16,-7
24,5,120,5,10,-5
24,5,121,11,34,-23
24,5,122,16,19,-3
24,5,123,9,14,-5
24,5,124,7,24,-17
24,5,125,9,17,-8
24,5,126,11,11,0
24,5,127,11,23,-12
24,5,128,22,33,-11
24,5,129,7,10,-3
24,5,130,13,20,-7
24,5,131,10,17,-7
24,5,132,4,20,-16
24,5,133,14,23,-9
24,5,134,7,24,-17
24,5,135,6,22,-16
24,5,136,8,30,-22
24,5,137,9,25,-16
24,5,138,10,26,-16
24,5,139,15,18,-3
24,5,140,7,12,-5
24,5,141,15,25,-10
24,5,142,9,19,-10
24,5,143,13,25,-12
24,5,144,13,21,-8
24,5,145,14,35,-21
24,5,146,9,14,-5
24,5,147,8,12,-4
24,5,148,11,20,-9
24,5,149,8,17,-9
24,5,150,16,18,-2
24,5,151,8,15,-7
24,5,152,9,26,-17
24,5,153,9,19,-10
24,5,154,8,30,-22
24,5,155,3,18,-15
24,5,156,11,15,-4
24,5,157,8,21,-13
24,5,158,13,23,-10
24,5,159,5,11,-6
24,5,160,18,33,-15
24,5,161,4,20,-16
24,5,162,13,12,1
24,5,163,12,24,-12
24,5,164,6,8,-2
24,5,165,20,21,-1
24,5,166,11,12,-1
24,5,167,11,9,2
24,5,168,2,18,-16
24,5,169,5,16,-11
24,5,170,8,14,-6
24,5,171,12,28,-16
24,5,172,11,22,-11
24,5,173,12,27,-15
24,5,174,6,19,-13
24,5,175,11,30,-19
24,5,176,8,20,-12
24,5,177,13,17,-4
24,5,178,18,31,-13
24,5,179,11,25,-14
24,5,180,15,39,-24
24,5,181,5,10,-5
24,5,182,20,35,-15
24,5,183,15,12,3
24,5,184,6,27,-21
24,5,185,15,26,-11
24,5,186,10,18,-8
24,5,187,8,24,-16
24,5,188,4,28,-24
24,5,189,18,12,6
24,5,190,18,26,-8
24,5,191,5,9,-4
24,5,192,6,14,-8
24,5,193,6,27,-21
24,5,194,18,26,-8
24,5,195,11,35,-24
24,5,196,13,20,-7
24,5,197,13,14,-1
24,5,198,16,29,-13
24,5,199,13,24,-11
24,5,200,16,23,-7
24,5,201,18,25,-7
24,5,202,12,17,-5
24,5,203,10,20,-10
24,5,204,6,8,-2
24,5,205,5,21,-16
24,5,206,11,23,-12
24,5,207,14,19,-5
24,5,208,9,17,-8
24,5,209,14,8,6
24,5,210,5,27,-22
24,5,211,9,20,-11
24,5,212,6,20,-14
24,5,213,9,14,-5
24,5,214,17,35,-18
24,5,215,8,21,-13
24,5,216,15,20,-5
24,5,217,5,21,-16
24,5,218,5,26,-21
24,5,219,14,18,-4
24,5,220,11,25,-14
24,5,221,13,21,-8
24,5,222,13,14,-1
24,5,223,17,43,-26
24,5,224,12,11,1
24,5,225,15,20,-5
24,5,226,2,16,-14
24,5,227,12,23,-11
24,5,228,2,24,-22
24,5,229,12,29,-17
24,5,230,7,21,-14
24,5,231,8,23,-15
24,5,232,20,12,8
24,5,233,8,22,-14
24,5,234,11,15,-4
24,5,235,7,13,-6
24,5,236,11,15,-4
24,5,237,9,38,-29
24,5,238,13,16,-3
24,5,239,7,18,-11
24,5,240,12,23,-11
24,5,241,11,19,-8
24,5,242,18,18,0
24,5,243,10,25,-15
24,5,244,14,26,-12
24,5,245,5,17,-12
24,5,246,11,20,-9
24,5,247,8,19,-11
24,5,248,5,8,-3
24,5,249,8,19,-11
24,5,250,7,20,-13
24,5,251,2,16,-14
24,5,252,7,13,-6
24,5,253,15,31,-16
24,5,254,5,11,-6
24,5,255,12,13,-1
24,5,256,8,31,-23
24,5,257,11,35,-24
24,5,258,9,16,-7
24,5,259,10,32,-22
24,5,260,9,15,-6
24,5,261,10,9,1
24,5,262,10,11,-1
24,5,263,10,14,-4
24,5,264,11,14,-3
24,5,265,11,18,-7
24,5,266,3,10,-7
24,5,267,12,24,-12
24,5,268,12,34,-22
24,5,269,16,24,-8
24,5,270,11,22,-11
24,5,271,11,15,-4
24,5,272,13,16,-3
24,5,273,8,14,-6
24,5,274,2,17,-15
24,5,275,14,29,-15
24,5,276,4,14,-10
24,5,277,6,23,-17
24,5,278,11,37,-26
24,5,279,6,25,-19
24,5,280,18,34,-16
24,5,281,3,16,-13
24,5,282,18,32,-14
24,5,283,9,36,-27
24,5,284,4,23,-19
24,5,285,9,42,-33
24,5,286,8,21,-13
24,5,287,7,9,-2
24,5,288,8,11,-3
24,5,289,18,27,-9
24,5,290,6,24,-18
24,5,291,15,16,-1
24,5,292,6,15,-9
24,5,293,9,22,-13
24,5,294,4,12,-8
24,5,295,7,8,-1
24,5,296,13,11,2
24,5,297,5,18,-13
24,5,298,18,28,-10
24,5,299,16,22,-6
24,6,0,5,31,-26
24,6,1,28,23,5
24,6,2,8,21,-13
24,6,3,10,17,-7
24,6,4,17,18,-1
24,6,5,9,20,-11
24,6,6,11,11,0
24,6,7,14,30,-16
24,6,8,11,20,-9
24,6,9,7,30,-23
24,6,10,16,27,-11
24,6,11,4,12,-8
24,6,12,6,24,-18
24,6,13,29,18,11
24,6,14,4,15,-11
24,6,15,9,7,2
24,6,16,10,14,-4
24,6,17,11,28,-17
24,6,18,15,24,-9
24,6,19,15,15,0
24,6,20,15,33,-18
24,6,21,13,21,-8
24,6,22,10,46,-36
24,6,23,9,22,-13
24,6,24,10,15,-5
24,6,25,15,14,1
24,6,26,10,11,-1
24,6,27,9,16,-7
24,6,28,9,26,-17
24,6,29,13,11,2
24,6,30,6,11,-5
24,6,31,8,15,-7
24,6,32,12,10,2
24,6,33,6,13,-7
24,6,34,3,24,-21
24,6,35,10,35,-25
24,6,36,7,8,-1
24,6,37,11,21,-10
24,6,38,9,31,-22
24,6,39,5,18,-13
24,6,40,12,23,-11
24,6,41,20,22,-2
24,6,42,6,19,-13
24,6,43,10,21,-11
24,6,44,14,26,-12
24,6,45,6,24,-18
24,6,46,12,32,-20
24,6,47,5,18,-13
24,6,48,7,11,-4
24,6,49,1,12,-11
24,6,50,2,19,-17
24,6,51,7,11,-4
24,6,52,7,14,-7
24,6,53,6,12,-6
24,6,54,17,36,-19
24,6,55,13,17,-4
24,6,56,11,16,-5
24,6,57,14,11,3
24,6,58,14,26,-12
24,6,59,11,37,-26
24,6,60,12,37,-25
24,6,61,17,21,-4
24,6,62,7,9,-2
24,6,63,8,13,-5
24,6,64,9,12,-3
24,6,65,7,28,-21
24,6,66,10,17,-7
24,6,67,8,19,-11
24,6,68,7,18,-11
24,6,69,9,1,8
24,6,70,7,20,-13
24,6,71,3,19,-16
24,6,72,19,29,-10
24,6,73,10,25,-15
24,6,74,13,33,-20
24,6,75,16,22,-6
24,6,76,21,31,-10
24,6,77,20,20,0
24,6,78,6,9,-3
24,6,79,17,30,-13
24,6,80,13,28,-15
24,6,81,15,39,-24
24,6,82,9,18,-9
24,6,83,4,10,-6
24,6,84,5,17,-12
24,6,85,7,10,-3
24,6,86,10,24,-14
24,6,87,5,13,-8
24,6,88,8,21,-13
24,6,89,5,18,-13
24,6,90,11,38,-27
24,6,91,9,22,-13
24,6,92,25,28,-3
24,6,93,6,20,-14
24,6,94,11,18,-7
24,6,95,10,11,-1
24,6,96,7,13,-6
24,6,97,18,37,-19
24,6,98,14,21,-7
24,6,99,5,23,-18
24,6,100,10,23,-13
24,6,101,6,14,-8
24,6,102,16,31,-15
24,6,103,16,32,-16
24,6,104,18,27,-9
24,6,105,7,15,-8
24,6,106,13,20,-7
24,6,107,5,18,-13
24,6,108,8,23,-15
24,6,109,11,25,-14
24,6,110,14,23,-9
24,6,111,6,10,-4
24,6,112,15,28,-13
24,6,113,9,9,0
24,6,114,11,11,0
24,6,115,12,22,-10
24,6,116,15,23,-8
24,6,117,10,22,-12
24,6,118,5,15,-10
24,6,119,12,30,-18
24,6,120,11,11,0
24,6,121,9,19,-10
24,6,122,15,27,-12
24,6,123,16,18,-2
24,6,124,9,11,-2
24,6,125,5,25,-20
24,6,126,13,20,-7
24,6,127,10,18,-8
24,6,128,7,13,-6
24,6,129,8,27,-19
24,6,130,4,29,-25
24,6,131,10,21,-11
24,6,132,16,12,4
24,6,133,4,8,-4
24,6,134,13,23,-10
24,6,135,9,23,-14
24,6,136,16,10,6
24,6,137,10,18,-8
24,6,138,9,18,-9
24,6,139,13,17,-4
24,6,140,8,27,-19
24,6,141,11,33,-22
24,6,142,3,20,-17
24,6,143,8,24,-16
24,6,144,4,22,-18
24,6,145,10,28,-18
24,6,146,5,17,-12
24,6,147,16,31,-15
24,6,148,10,15,-5
24,6,149,9,21,-12
24,6,150,10,12,-2
24,6,151,3,8,-5
24,6,152,11,27,-16
24,6,153,8,25,-17
24,6,154,6,3,3
24,6,155,6,22,-16
24,6,156,16,19,-3
24,6,157,13,11,2
24,6,158,17,35,-18
24,6,159,6,9,-3
24,6,160,8,15,-7
24,6,161,6,8,-2
24,6,162,22,31,-9
24,6,163,11,22,-11
24,6,164,9,23,-14
24,6,165,6,13,-7
24,6,166,18,32,-14
24,6,167,10,14,-4
24,6,168,11,13,-2
24,6,169,6,18,-12
24,6,170,8,21,-13
24,6,171,6,21,-15
24,6,172,5,27,-22
24,6,173,9,6,3
24,6,174,14,33,-19
24,6,175,7,14,-7
24,6,176,16,15,1
24,6,177,11,21,-10
24,6,178,15,34,-19
24,6,179,9,22,-13
24,6,180,19,29,-10
24,6,181,7,9,-2
24,6,182,11,14,-3
24,6,183,2,15,-13
24,6,184,10,27,-17
24,6,185,15,25,-10
24,6,186,14,27,-13
24,6,187,8,18,-10
24,6,188,12,29,-17
24,6,189,17,27,-10
24,6,190,3,11,-8
24,6,191,16,25,-9
24,6,192,8,17,-9
24,6,193,8,19,-11
24,6,194,15,24,-9
24,6,195,17,16,1
24,6,196,13,27,-14
24,6,197,13,16,-3
24,6,198,16,19,-3
24,6,199,17,26,-9
24,6,200,10,15,-5
24,6,201,8,24,-16
24,6,202,11,26,-15
24,6,203,5,15,-10
24,6,204,30,32,-2
24,6,205,10,19,-9
24,6,206,9,20,-11
24,6,207,7,23,-16
24,6,208,12,24,-12
24,6,209,5,28,-23
24,6,210,7,16,-9
24,6,211,12,29,-17
24,6,212,5,16,-11
24,6,213,23,32,-9
24,6,214,13,19,-6
24,6,215,13,21,-8
24,6,216,12,21,-9
24,6,217,7,15,-8
24,6,218,5,19,-14
24,6,219,10,14,-4
24,6,220,8,23,-15
24,6,221,10,12,-2
24,6,222,16,19,-3
24,6,223,6,10,-4
24,6,224,13,10,3
24,6,225,13,15,-2
24,6,226,2,3,-1
24,6,227,10,23,-13
24,6,228,7,9,-2
24,6,229,14,28,-14
24,6,230,20,38,-18
24,6,231,6,21,-15
24,6,232,19,31,-12
24,6,233,15,27,-12
24,6,234,5,10,-5
24,6,235,12,14,-2
24,6,236,4,14,-10
24,6,237,15,24,-9
24,6,238,10,18,-8
24,6,239,7,10,-3
24,6,240,10,18,-8
24,6,241,18,10,8
24,6,242,9,19,-10
24,6,243,4,17,-13
24,6,244,12,19,-7
24,6,245,19,40,-21
24,6,246,8,12,-4
24,6,247,11,20,-9
24,6,248,14,34,-20
24,6,249,15,18,-3
24,6,250,4,30,-26
24,6,251,11,13,-2
24,6,252,2,16,-14
24,6,253,6,19,-13
24,6,254,6,18,-12
24,6,255,13,15,-2
24,6,256,7,29,-22
24,6,257,3,15,-12
24,6,258,9,23,-14
24,6,259,7,17,-10
24,6,260,6,26,-20
24,6,261,16,25,-9
24,6,262,11,17,-6
24,6,263,6,14,-8
24,6,264,5,21,-16
24,6,265,6,26,-20
24,6,266,9,19,-10
24,6,267,10,21,-11
24,6,268,5,6,-1
24,6,269,13,17,-4
24,6,270,12,9,3
24,6,271,11,33,-22
24,6,272,6,13,-7
24,6,273,10,17,-7
24,6,274,15,27,-12
24,6,275,10,33,-23
24,6,276,8,13,-5
24,6,277,0,4,-4
24,6,278,11,25,-14
24,6,279,13,31,-18
24,6,280,3,15,-12
24,6,281,8,19,-11
24,6,282,8,20,-12
24,6,283,8,18,-10
24,6,284,9,13,-4
24,6,285,5,14,-9
24,6,286,8,17,-9
24,6,287,11,29,-18
24,6,288,12,22,-10
24,6,289,8,19,-11
24,6,290,19,26,-7
24,6,291,4,17,-13
24,6,292,11,20,-9
24,6,293,7,30,-23
24,6,294,7,10,-3
24,6,295,13,15,-2
24,6,296,13,31,-18
24,6,297,10,37,-27
24,6,298,10,40,-30
24,6,299,8,21,-13
24,7,0,8,18,-10
24,7,1,11,32,-21
24,7,2,10,29,-19
24,7,3,7,25,-18
24,7,4,11,22,-11
24,7,5,10,32,-22
24,7,6,12,22,-10
24,7,7,17,24,-7
24,7,8,16,13,3
24,7,9,11,18,-7
24,7,10,15,23,-8
24,7,11,11,15,-4
24,7,12,9,23,-14
24,7,13,11,13,-2
24,7,14,12,27,-15
24,7,15,7,28,-21
24,7,16,13,10,3
24,7,17,5,11,-6
24,7,18,12,15,-3
24,7,19,8,22,-14
24,7,20,10,21,-11
24,7,21,12,18,-6
24,7,22,13,15,-2
24,7,23,18,19,-1
24,7,24,13,21,-8
24,7,25,11,22,-11
24,7,26,5,26,-21
24,7,27,7,31,-24
24,7,28,13,10,3
24,7,29,16,33,-17
24,7,30,13,25,-12
24,7,31,17,21,-4
24,7,32,12,30,-18
24,7,33,11,22,-11
24,7,34,6,19,-13
24,7,35,2,7,-5
24,7,36,12,26,-14
24,7,37,2,20,-18
24,7,38,4,11,-7
24,7,39,19,17,2
24,7,40,15,18,-3
24,7,41,6,19,-13
24,7,42,13,12,1
24,7,43,16,18,-2
24,7,44,17,20,-3
24,7,45,11,20,-9
24,7,46,8,12,-4
24,7,47,5,21,-16
24,7,48,1,12,-11
24,7,49,7,21,-14
24,7,50,16,19,-3
24,7,51,13,14,-1
24,7,52,4,13,-9
24,7,53,9,18,-9
24,7,54,17,19,-2
24,7,55,10,10,0
24,7,56,13,17,-4
24,7,57,12,16,-4
24,7,58,1,26,-25
24,7,59,14,23,-9
24,7,60,9,16,-7
24,7,61,11,25,-14
24,7,62,10,22,-12
24,7,63,9,16,-7
24,7,64,17,8,9
24,7,65,12,14,-2
24,7,66,10,27,-17
24,7,67,11,22,-11
24,7,68,7,17,-10
24,7,69,10,37,-27
24,7,70,5,12,-7
24,7,71,18,18,0
24,7,72,10,24,-14
24,7,73,12,9,3
24,7,74,13,14,-1
24,7,75,8,24,-16
24,7,76,10,20,-10
24,7,77,5,21,-16
24,7,78,8,32,-24
24,7,79,5,20,-15
24,7,80,13,17,-4
24,7,81,13,29,-16
24,7,82,10,10,0
24,7,83,5,14,-9
24,7,84,9,18,-9
24,7,85,5,10,-5
24,7,86,9,20,-11
24,7,87,8,11,-3
24,7,88,10,23,-13
24,7,89,22,24,-2
24,7,90,7,15,-8
24,7,91,10,17,-7
24,7,92,4,18,-14
24,7,93,13,23,-10
24,7,94,8,15,-7
24,7,95,11,16,-5
24,7,96,10,8,2
24,7,97,14,14,0
24,7,98,8,11,-3
24,7,99,17,18,-1
24,7,100,13,13,0
24,7,101,4,19,-15
24,7,102,7,30,-23
24,7,103,9,24,-15
24,7,104,2,8,-6
24,7,105,17,29,-12
24,7,106,16,10,6
24,7,107,17,20,-3
24,7,108,12,7,5
24,7,109,16,25,-9
24,7,110,12,34,-22
24,7,111,6,12,-6
24,7,112,7,13,-6
24,7,113,8,21,-13
24,7,114,16,17,-1
24,7,115,9,27,-18
24,7,116,12,13,-1
24,7,117,18,36,-18
24,7,118,13,23,-10
24,7,119,12,15,-3
24,7,120,4,13,-9
24,7,121,7,17,-10
24,7,122,11,24,-13
24,7,123,7,17,-10
24,7,124,13,26,-13
24,7,125,12,32,-20
24,7,126,18,10,8
24,7,127,13,21,-8
24,7,128,5,10,-5
24,7,129,17,13,4
24,7,130,5,13,-8
24,7,131,6,25,-19
24,7,132,11,6,5
24,7,133,7,20,-13
24,7,134,21,22,-1
24,7,135,6,20,-14
24,7,136,4,16,-12
24,7,137,13,26,-13
24,7,138,11,24,-13
24,7,139,8,16,-8
24,7,140,13,14,-1
24,7,141,8,29,-21
24,7,142,14,31,-17
24,7,143,9,19,-10
24,7,144,4,29,-25
24,7,145,14,18,-4
24,7,146,7,26,-19
24,7,147,8,19,-11
24,7,148,9,10,-1
24,7,149,7,28,-21
24,7,150,8,18,-10
24,7,151,1,15,-14
24,7,152,10,10,0
24,7,153,15,29,-14
24,7,154,18,24,-6
24,7,155,15,26,-11
24,7,156,8,31,-23
24,7,157,19,23,-4
24,7,158,8,12,-4
24,7,159,14,20,-6
24,7,160,5,11,-6
24,7,161,9,32,-23
24,7,162,5,14,-9
24,7,163,6,19,-13
24,7,164,18,9,9
24,7,165,17,29,-12
24,7,166,7,21,-14
24,7,167,13,20,-7
24,7,168,9,15,-6
24,7,169,9,13,-4
24,7,170,4,29,-25
24,7,171,13,22,-9
24,7,172,7,22,-15
24,7,173,12,32,-20
24,7,174,3,17,-14
24,7,175,13,25,-12
24,7,176,14,18,-4
24,7,177,5,16,-11
24,7,178,18,28,-10
24,7,179,11,21,-10
24,7,180,8,26,-18
24,7,181,19,20,-1
24,7,182,9,14,-5
24,7,183,12,18,-6
24,7,184,12,29,-17
24,7,185,12,33,-21
24,7,186,15,19,-4
24,7,187,10,13,-3
24,7,188,11,14,-3
24,7,189,14,16,-2
24,7,190,14,27,-13
24,7,191,9,32,-23
24,7,192,10,16,-6
24,7,193,3,15,-12
24,7,194,7,16,-9
24,7,195,12,23,-11
24,7,196,11,32,-21
24,7,197,18,26,-8
24,7,198,9,39,-30
24,7,199,10,23,-13
24,7,200,12,7,5
24,7,201,11,22,-11
24,7,202,10,14,-4
24,7,203,16,15,1
24,7,204,7,24,-17
24,7,205,10,22,-12
24,7,206,9,26,-17
24,7,207,13,19,-6
24,7,208,9,19,-10
24,7,209,17,27,-10
24,7,210,7,11,-4
24,7,211,4,5,-1
24,7,212,7,25,-18
24,7,213,8,19,-11
24,7,214,9,17,-8
24,7,215,7,20,-13
24,7,216,23,22,1
24,7,217,9,27,-18
24,7,218,5,21,-16
24,7,219,16,25,-9
24,7,220,8,30,-22
24,7,221,6,5,1
24,7,222,2,18,-16
24,7,223,10,23,-13
24,7,224,15,24,-9
24,7,225,6,13,-7
24,7,226,6,12,-6
24,7,227,10,16,-6
24,7,228,8,25,-17
24,7,229,7,21,-14
24,7,230,12,14,-2
24,7,231,7,10,-3
24,7,232,10,22,-12
24,7,233,20,20,0
24,7,234,6,25,-19
24,7,235,5,18,-13
24,7,236,6,13,-7
24,7,237,9,33,-24
24,7,238,25,15,10
24,7,239,5,13,-8
24,7,240,6,12,-6
24,7,241,8,14,-6
24,7,242,12,20,-8
24,7,243,3,11,-8
24,7,244,13,15,-2
24,7,245,12,23,-11
24,7,246,5,20,-15
24,7,247,14,18,-4
24,7,248,13,28,-15
24,7,249,10,22,-12
24,7,250,15,19,-4
24,7,251,7,22,-15
24,7,252,6,16,-10
24,7,253,11,30,-19
24,7,254,5,21,-16
24,7,255,15,25,-10
24,7,256,12,39,-27
24,7,257,6,20,-14
24,7,258,8,22,-14
24,7,259,5,29,-24
24,7,260,8,11,-3
24,7,261,16,44,-28
24,7,262,9,13,-4
24,7,263,0,14,-14
24,7,264,8,24,-16
24,7,265,10,24,-14
24,7,266,12,22,-10
24,7,267,9,26,-17
24,7,268,16,21,-5
24,7,269,8,20,-12
24,7,270,8,22,-14
24,7,271,5,16,-11
24,7,272,14,36,-22
24,7,273,7,26,-19
24,7,274,3,20,-17
24,7,275,13,16,-3
24,7,276,9,14,-5
24,7,277,5,12,-7
24,7,278,6,21,-15
24,7,279,5,10,-5
24,7,280,8,17,-9
24,7,281,25,35,-10
24,7,282,4,20,-16
24,7,283,4,22,-18
24,7,284,14,22,-8
24,7,285,8,5,3
24,7,286,5,20,-15
24,7,287,7,28,-21
24,7,288,10,31,-21
24,7,289,7,5,2
24,7,290,13,28,-15
24,7,291,11,29,-18
24,7,292,11,21,-10
24,7,293,17,7,10
24,7,294,5,23,-18
24,7,295,4,20,-16
24,7,296,28,28,0
24,7,297,15,33,-18
24,7,298,3,26,-23
24,7,299,6,37,-31
24,8,0,6,35,-29
24,8,1,12,17,-5
24,8,2,9,19,-10
24,8,3,3,24,-21
24,8,4,6,21,-15
24,8,5,7,34,-27
24,8,6,19,19,0
24,8,7,7,20,-13
24,8,8,11,24,-13
24,8,9,8,16,-8
24,8,10,4,7,-3
24,8,11,17,23,-6
24,8,12,8,19,-11
24,8,13,9,14,-5
24,8,14,10,8,2
24,8,15,1,22,-21
24,8,16,7,15,-8
24,8,17,16,31,-15
24,8,18,10,14,-4
24,8,19,11,39,-28
24,8,20,8,24,-16
24,8,21,8,12,-4
24,8,22,13,18,-5
24,8,23,17,12,5
24,8,24,5,8,-3
24,8,25,12,25,-13
24,8,26,7,22,-15
24,8,27,3,13,-10
24,8,28,15,25,-10
24,8,29,11,9,2
24,8,30,8,16,-8
24,8,31,7,21,-14
24,8,32,14,37,-23
24,8,33,6,17,-11
24,8,34,14,28,-14
24,8,35,10,20,-10
24,8,36,12,20,-8
24,8,37,3,15,-12
24,8,38,5,16,-11
24,8,39,20,19,1
24,8,40,2,26,-24
24,8,41,13,33,-20
24,8,42,6,19,-13
24,8,43,18,30,-12
24,8,44,9,17,-8
24,8,45,13,26,-13
24,8,46,12,20,-8
24,8,47,13,14,-1
24,8,48,2,10,-8
24,8,49,5,24,-19
24,8,50,7,15,-8
24,8,51,9,23,-14
24,8,52,15,22,-7
24,8,53,16,21,-5
24,8,54,20,35,-15
24,8,55,5,14,-9
24,8,56,14,13,1
24,8,57,11,35,-24
24,8,58,17,25,-8
24,8,59,7,13,-6
24,8,60,7,16,-9
24,8,61,9,20,-11
24,8,62,7,9,-2
24,8,63,8,23,-15
24,8,64,3,8,-5
24,8,65,8,13,-5
24,8,66,6,10,-4
24,8,67,5,6,-1
24,8,68,16,15,1
24,8,69,17,27,-10
24,8,70,5,14,-9
24,8,71,8,19,-11
24,8,72,10,25,-15
24,8,73,14,21,-7
24,8,74,5,26,-21
24,8,75,18,37,-19
24,8,76,10,20,-10
24,8,77,11,15,-4
24,8,78,4,23,-19
24,8,79,10,22,-12
24,8,80,17,22,-5
24,8,81,3,18,-15
24,8,82,8,13,-5
24,8,83,14,21,-7
24,8,84,13,22,-9
24,8,85,20,30,-10
24,8,86,4,6,-2
24,8,87,12,22,-10
24,8,88,5,13,-8
24,8,89,13,29,-16
24,8,90,7,13,-6
24,8,91,16,16,0
24,8,92,11,22,-11
24,8,93,3,20,-17
24,8,94,10,33,-23
24,8,95,6,10,-4
24,8,96,1,10,-9
24,8,97,5,9,-4
24,8,98,9,6,3
24,8,99,8,25,-17
24,8,100,7,27,-20
24,8,101,12,17,-5
24,8,102,26,28,-2
24,8,103,12,19,-7
24,8,104,6,34,-28
24,8,105,3,5,-2
24,8,106,12,26,-14
24,8,107,16,17,-1
24,8,108,8,21,-13
24,8,109,7,24,-17
24,8,110,11,18,-7
24,8,111,8,13,-5
24,8,112,22,36,-14
24,8,113,12,14,-2
24,8,114,1,13,-12
24,8,115,5,20,-15
24,8,116,8,32,-24
24,8,117,0,4,-4
24,8,118,9,25,-16
24,8,119,11,22,-11
24,8,120,3,16,-13
24,8,121,20,17,3
24,8,122,9,16,-7
24,8,123,9,15,-6
24,8,124,14,27,-13
24,8,125,8,21,-13
24,8,126,9,19,-10
24,8,127,17,26,-9
24,8,128,16,13,3
24,8,129,7,18,-11
24,8,130,12,24,-12
24,8,131,22,44,-22
24,8,132,14,20,-6
24,8,133,11,25,-14
24,8,134,10,22,-12
24,8,135,6,23,-17
24,8,136,8,22,-14
24,8,137,4,24,-20
24,8,138,6,29,-23
24,8,139,25,37,-12
24,8,140,19,12,7
24,8,141,7,27,-20
24,8,142,15,20,-5
24,8,143,15,25,-10
24,8,144,10,11,-1
24,8,145,9,23,-14
24,8,146,15,19,-4
24,8,147,13,18,-5
24,8,148,10,28,-18
24,8,149,6,29,-23
24,8,150,12,27,-15
24,8,151,11,25,-14
24,8,152,7,15,-8
24,8,153,0,20,-20
24,8,154,5,29,-24
24,8,155,10,21,-11
24,8,156,12,27,-15
24,8,157,14,38,-24
24,8,158,14,25,-11
24,8,159,6,20,-14
24,8,160,18,19,-1
24,8,161,2,18,-16
24,8,162,11,28,-17
24,8,163,12,25,-13
24,8,164,5,5,0
24,8,165,12,13,-1
24,8,166,8,16,-8
24,8,167,20,18,2
24,8,168,15,15,0
24,8,169,9,20,-11
24,8,170,16,32,-16
24,8,171,5,21,-16
24,8,172,6,31,-25
24,8,173,14,33,-19
24,8,174,7,23,-16
24,8,175,12,15,-3
24,8,176,11,18,-7
24,8,177,10,16,-6
24,8,178,6,9,-3
24,8,179,9,23,-14
24,8,180,8,15,-7
24,8,181,17,25,-8
24,8,182,7,27,-20
24,8,183,7,21,-14
24,8,184,8,12,-4
24,8,185,6,9,-3
24,8,186,6,23,-17
24,8,187,19,26,-7
24,8,188,10,9,1
24,8,189,7,26,-19
24,8,190,18,20,-2
24,8,191,10,14,-4
24,8,192,8,25,-17
24,8,193,12,38,-26
24,8,194,6,17,-11
24,8,195,13,21,-8
24,8,196,10,19,-9
24,8,197,9,26,-17
24,8,198,21,23,-2
24,8,199,6,15,-9
24,8,200,19,17,2
24,8,201,4,27,-23
24,8,202,11,32,-21
24,8,203,15,28,-13
24,8,204,8,25,-17
24,8,205,13,24,-11
24,8,206,12,26,-14
24,8,207,10,19,-9
24,8,208,21,22,-1
24,8,209,9,21,-12
24,8,210,5,22,-17
24,8,211,11,21,-10
24,8,212,10,18,-8
24,8,213,7,23,-16
24,8,214,14,12,2
24,8,215,3,2,1
24,8,216,6,23,-17
24,8,217,13,24,-11
24,8,218,11,14,-3
24,8,219,27,19,8
24,8,220,14,27,-13
24,8,221,11,21,-10
24,8,222,21,24,-3
24,8,223,13,24,-11
24,8,224,14,28,-14
24,8,225,5,22,-17
24,8,226,11,16,-5
24,8,227,17,20,-3
24,8,228,13,18,-5
24,8,229,7,25,-18
24,8,230,6,16,-10
24,8,231,7,8,-1
24,8,232,19,23,-4
24,8,233,10,14,-4
24,8,234,6,9,-3
24,8,235,14,26,-12
24,8,236,8,10,-2
24,8,237,22,29,-7
24,8,238,4,19,-15
24,8,239,14,27,-13
24,8,240,8,30,-22
24,8,241,8,15,-7
24,8,242,20,26,-6
24,8,243,9,27,-18
24,8,244,12,24,-12
24,8,245,22,24,-2
24,8,246,4,8,-4
24,8,247,2,18,-16
24,8,248,13,14,-1
24,8,249,16,23,-7
24,8,250,12,15,-3
24,8,251,14,9,5
24,8,252,15,19,-4
24,8,253,10,19,-9
24,8,254,18,18,0
24,8,255,11,18,-7
24,8,256,9,26,-17
24,8,257,5,26,-21
24,8,258,14,18,-4
24,8,259,14,25,-11
24,8,260,9,15,-6
24,8,261,13,19,-6
24,8,262,8,8,0
24,8,263,11,18,-7
24,8,264,6,21,-15
24,8,265,12,16,-4
24,8,266,16,24,-8
24,8,267,19,14,5
24,8,268,5,21,-16
24,8,269,9,17,-8
24,8,270,6,13,-7
24,8,271,10,48,-38
24,8,272,18,25,-7
24,8,273,2,15,-13
24,8,274,5,11,-6
24,8,275,8,18,-10
24,8,276,8,21,-13
24,8,277,6,36,-30
24,8,278,10,12,-2
24,8,279,4,15,-11
24,8,280,7,20,-13
24,8,281,9,26,-17
24,8,282,8,19,-11
24,8,283,5,12,-7
24,8,284,8,26,-18
24,8,285,16,18,-2
24,8,286,11,24,-13
24,8,287,21,23,-2
24,8,288,4,13,-9
24,8,289,10,32,-22
24,8,290,7,29,-22
24,8,291,4,22,-18
24,8,292,10,8,2
24,8,293,8,29,-21
24,8,294,10,21,-11
24,8,295,9,12,-3
24,8,296,10,25,-15
24,8,297,6,22,-16
24,8,298,13,17,-4
24,8,299,13,14,-1
24,9,0,16,25,-9
24,9,1,11,18,-7
24,9,2,6,9,-3
24,9,3,16,24,-8
24,9,4,8,23,-15
24,9,5,4,10,-6
24,9,6,15,19,-4
24,9,7,12,11,1
24,9,8,13,21,-8
24,9,9,16,13,3
24,9,10,12,18,-6
24,9,11,4,10,-6
24,9,12,10,16,-6
24,9,13,5,30,-25
24,9,14,15,29,-14
24,9,15,21,37,-16
24,9,16,13,22,-9
24,9,17,12,16,-4
24,9,18,3,12,-9
24,9,19,10,24,-14
24,9,20,11,22,-11
24,9,21,6,13,-7
24,9,22,9,23,-14
24,9,23,20,24,-4
24,9,24,9,15,-6
24,9,25,13,18,-5
24,9,26,13,12,1
24,9,27,15,36,-21
24,9,28,19,13,6
24,9,29,13,25,-12
24,9,30,10,25,-15
24,9,31,5,17,-12
24,9,32,8,15,-7
24,9,33,12,21,-9
24,9,34,10,12,-2
24,9,35,18,13,5
24,9,36,4,9,-5
24,9,37,11,13,-2
24,9,38,15,22,-7
24,9,39,8,17,-9
24,9,40,5,23,-18
24,9,41,17,23,-6
24,9,42,7,14,-7
24,9,43,4,13,-9
24,9,44,8,15,-7
24,9,45,6,12,-6
24,9,46,7,11,-4
24,9,47,17,50,-33
24,9,48,15,32,-17
24,9,49,13,20,-7
24,9,50,5,9,-4
24,9,51,12,18,-6
24,9,52,9,14,-5
24,9,53,12,28,-16
24,9,54,6,15,-9
24,9,55,16,29,-13
24,9,56,9,26,-17
24,9,57,7,12,-5
24,9,58,13,29,-16
24,9,59,12,7,5
24,9,60,15,28,-13
24,9,61,26,34,-8
24,9,62,4,17,-13
24,9,63,15,27,-12
24,9,64,0,12,-12
24,9,65,24,23,1
24,9,66,8,22,-14
24,9,67,7,12,-5
24,9,68,5,8,-3
24,9,69,11,8,3
24,9,70,8,13,-5
24,9,71,13,18,-5
24,9,72,13,13,0
24,9,73,11,25,-14
24,9,74,27,26,1
24,9,75,7,21,-14
24,9,76,9,14,-5
24,9,77,13,19,-6
24,9,78,8,15,-7
24,9,79,8,15,-7
24,9,80,12,27,-15
24,9,81,5,19,-14
24,9,82,3,18,-15
24,9,83,25,23,2
24,9,84,13,24,-11
24,9,85,12,21,-9
24,9,86,17,26,-9
24,9,87,24,22,2
24,9,88,20,33,-13
24,9,89,8,25,-17
24,9,90,11,20,-9
24,9,91,11,23,-12
24,9,92,3,12,-9
24,9,93,19,20,-1
24,9,94,21,40,-19
24,9,95,9,17,-8
24,9,96,8,24,-16
24,9,97,15,14,1
24,9,98,7,23,-16
24,9,99,4,11,-7
24,9,100,16,23,-7
24,9,101,11,11,0
24,9,102,18,23,-5
24,9,103,6,14,-8
24,9,104,14,26,-12
24,9,105,14,31,-17
24,9,106,14,13,1
24,9,107,9,7,2
24,9,108,10,18,-8
24,9,109,4,18,-14
24,9,110,14,17,-3
24,9,111,15,25,-10
24,9,112,5,8,-3
24,9,113,17,18,-1
24,9,114,6,17,-11
24,9,115,5,18,-13
24,9,116,9,27,-18
24,9,117,14,10,4
24,9,118,22,29,-7
24,9,119,7,22,-15
24,9,120,15,27,-12
24,9,121,21,49,-28
24,9,122,4,20,-16
24,9,123,16,23,-7
24,9,124,9,28,-19
24,9,125,5,37,-32
24,9,126,13,19,-6
24,9,127,7,18,-11
24,9,128,10,20,-10
24,9,129,6,10,-4
24,9,130,5,15,-10
24,9,131,13,23,-10
24,9,132,3,6,-3
24,9,133,13,16,-3
24,9,134,19,22,-3
24,9,135,10,17,-7
24,9,136,7,28,-21
24,9,137,18,27,-9
24,9,138,8,22,-14
24,9,139,9,17,-8
24,9,140,9,23,-14
24,9,141,9,18,-9
24,9,142,13,30,-17
24,9,143,13,13,0
24,9,144,14,20,-6
24,9,145,15,18,-3
24,9,146,17,19,-2
24,9,147,22,24,-2
24,9,148,25,32,-7
24,9,149,8,21,-13
24,9,150,20,38,-18
24,9,151,12,20,-8
24,9,152,16,20,-4
24,9,153,11,20,-9
24,9,154,7,21,-14
24,9,155,10,19,-9
24,9,156,6,7,-1
24,9,157,14,19,-5
24,9,158,7,12,-5
24,9,159,12,16,-4
24,9,160,15,8,7
24,9,161,14,22,-8
24,9,162,20,28,-8
24,9,163,21,23,-2
24,9,164,13,27,-14
24,9,165,7,30,-23
24,9,166,13,33,-20
24,9,167,6,19,-13
24,9,168,13,20,-7
24,9,169,18,33,-15
24,9,170,12,7,5
24,9,171,5,16,-11
24,9,172,10,24,-14
24,9,173,7,26,-19
24,9,174,5,24,-19
24,9,175,12,18,-6
24,9,176,18,19,-1
24,9,177,10,9,1
24,9,178,4,20,-16
24,9,179,17,29,-12
24,9,180,10,31,-21
24,9,181,10,16,-6
24,9,182,7,17,-10
24,9,183,13,21,-8
24,9,184,12,27,-15
24,9,185,10,14,-4
24,9,186,14,23,-9
24,9,187,13,28,-15
24,9,188,10,11,-1
24,9,189,9,14,-5
24,9,190,7,22,-15
24,9,191,7,29,-22
24,9,192,15,23,-8
24,9,193,21,24,-3
24,9,194,22,17,5
24,9,195,10,28,-18
24,9,196,6,16,-10
24,9,197,7,12,-5
24,9,198,11,23,-12
24,9,199,3,14,-11
24,9,200,18,20,-2
24,9,201,9,19,-10
24,9,202,17,27,-10
24,9,203,14,14,0
24,9,204,11,21,-10
24,9,205,9,29,-20
24,9,206,14,29,-15
24,9,207,8,14,-6
24,9,208,21,20,1
24,9,209,4,10,-6
24,9,210,10,17,-7
24,9,211,10,24,-14
24,9,212,5,19,-14
24,9,213,11,22,-11
24,9,214,6,14,-8
24,9,215,13,21,-8
24,9,216,12,10,2
24,9,217,6,25,-19
24,9,218,7,26,-19
24,9,219,5,3,2
24,9,220,3,20,-17
24,9,221,15,35,-20
24,9,222,12,16,-4
24,9,223,11,23,-12
24,9,224,13,21,-8
24,9,225,11,20,-9
24,9,226,8,16,-8
24,9,227,5,9,-4
24,9,228,9,19,-10
24,9,229,9,19,-10
24,9,230,8,11,-3
24,9,231,11,21,-10
24,9,232,16,19,-3
24,9,233,16,34,-18
24,9,234,3,15,-12
24,9,235,4,25,-21
24,9,236,9,23,-14
24,9,237,30,23,7
24,9,238,7,18,-11
24,9,239,12,12,0
24,9,240,9,29,-20
24,9,241,5,14,-9
24,9,242,14,20,-6
24,9,243,16,14,2
24,9,244,14,26,-12
24,9,245,11,23,-12
24,9,246,3,15,-12
24,9,247,8,27,-19
24,9,248,14,26,-12
24,9,249,8,19,-11
24,9,250,16,18,-2
24,9,251,9,19,-10
24,9,252,9,23,-14
24,9,253,5,37,-32
24,9,254,21,19,2
24,9,255,7,30,-23
24,9,256,17,21,-4
24,9,257,12,17,-5
24,9,258,9,12,-3
24,9,259,10,21,-11
24,9,260,3,12,-9
24,9,261,9,7,2
24,9,262,12,25,-13
24,9,263,10,16,-6
24,9,264,14,34,-20
24,9,265,6,18,-12
24,9,266,23,29,-6
24,9,267,5,7,-2
24,9,268,8,16,-8
24,9,269,11,37,-26
24,9,270,6,14,-8
24,9,271,11,7,4
24,9,272,5,24,-19
24,9,273,10,16,-6
24,9,274,9,30,-21
24,9,275,8,25,-17
24,9,276,8,18,-10
24,9,277,13,11,2
24,9,278,11,19,-8
24,9,279,9,17,-8
24,9,280,8,18,-10
24,9,281,13,12,1
24,9,282,12,22,-10
24,9,283,10,22,-12
24,9,284,17,19,-2
24,9,285,12,34,-22
24,9,286,16,23,-7
24,9,287,6,26,-20
24,9,288,13,33,-20
24,9,289,8,20,-12
24,9,290,14,23,-9
24,9,291,11,11,0
24,9,292,3,11,-8
24,9,293,12,17,-5
24,9,294,12,14,-2
24,9,295,5,12,-7
24,9,296,9,34,-25
24,9,297,16,26,-10
24,9,298,16,21,-5
24,9,299,20,45,-25
24,10,0,5,5,0
24,10,1,11,23,-12
24,10,2,19,28,-9
24,10,3,17,26,-9
24,10,4,13,22,-9
24,10,5,9,13,-4
24,10,6,6,14,-8
24,10,7,6,6,0
24,10,8,4,27,-23
24,10,9,16,16,0
24,10,10,10,18,-8
24,10,11,6,15,-9
24,10,12,2,8,-6
24,10,13,22,28,-6
24,10,14,11,20,-9
24,10,15,10,33,-23
24,10,16,18,27,-9
24,10,17,9,27,-18
24,10,18,17,23,-6
24,10,19,2,13,-11
24,10,20,8,12,-4
24,10,21,18,20,-2
24,10,22,4,20,-16
24,10,23,9,24,-15
24,10,24,7,21,-14
24,10,25,13,17,-4
24,10,26,11,18,-7
24,10,27,4,20,-16
24,10,28,4,8,-4
24,10,29,9,23,-14
24,10,30,14,7,7
24,10,31,12,29,-17
24,10,32,2,12,-10
24,10,33,4,11,-7
24,10,34,8,16,-8
24,10,35,13,6,7
24,10,36,8,15,-7
24,10,37,9,11,-2
24,10,38,10,21,-11
24,10,39,12,28,-16
24,10,40,14,24,-10
24,10,41,12,21,-9
24,10,42,13,17,-4
24,10,43,3,6,-3
24,10,44,20,20,0
24,10,45,18,27,-9
24,10,46,17,19,-2
24,10,47,13,23,-10
24,10,48,13,18,-5
24,10,49,12,15,-3
24,10,50,21,22,-1
24,10,51,12,22,-10
24,10,52,16,22,-6
24,10,53,13,19,-6
24,10,54,5,21,-16
24,10,55,20,25,-5
24,10,56,8,16,-8
24,10,57,7,10,-3
24,10,58,9,20,-11
24,10,59,13,15,-2
24,10,60,20,29,-9
24,10,61,17,37,-20
24,10,62,8,15,-7
24,10,63,10,19,-9
24,10,64,11,16,-5
24,10,65,16,27,-11
24,10,66,10,23,-13
24,10,67,27,32,-5
24,10,68,10,27,-17
24,10,69,12,12,0
24,10,70,3,11,-8
24,10,71,4,19,-15
24,10,72,12,15,-3
24,10,73,17,29,-12
24,10,74,12,25,-13
24,10,75,15,24,-9
24,10,76,5,12,-7
24,10,77,13,20,-7
24,10,78,4,17,-13
24,10,79,17,30,-13
24,10,80,17,16,1
24,10,81,18,31,-13
24,10,82,11,29,-18
24,10,83,11,15,-4
24,10,84,15,27,-12
24,10,85,9,22,-13
24,10,86,19,24,-5
24,10,87,7,13,-6
24,10,88,14,20,-6
24,10,89,20,24,-4
24,10,90,9,14,-5
24,10,91,7,30,-23
24,10,92,12,14,-2
24,10,93,11,14,-3
24,10,94,9,21,-12
24,10,95,6,19,-13
24,10,96,5,12,-7
24,10,97,11,23,-12
24,10,98,18,32,-14
24,10,99,6,9,-3
24,10,100,8,33,-25
24,10,101,15,18,-3
24,10,102,7,13,-6
24,10,103,14,24,-10
24,10,104,18,19,-1
24,10,105,15,18,-3
24,10,106,11,27,-16
24,10,107,10,25,-15
24,10,108,12,14,-2
24,10,109,11,7,4
24,10,110,9,26,-17
24,10,111,13,25,-12
24,10,112,9,12,-3
24,10,113,14,18,-4
24,10,114,2,8,-6
24,10,115,18,19,-1
24,10,116,15,22,-7
24,10,117,9,27,-18
24,10,118,12,6,6
24,10,119,6,10,-4
24,10,120,25,22,3
24,10,121,9,23,-14
24,10,122,5,35,-30
24,10,123,9,14,-5
24,10,124,10,16,-6
24,10,125,7,23,-16
24,10,126,11,33,-22
24,10,127,14,24,-10
24,10,128,8,12,-4
24,10,129,7,24,-17
24,10,130,9,25,-16
24,10,131,14,13,1
24,10,132,6,19,-13
24,10,133,17,11,6
24,10,134,13,26,-13
24,10,135,9,13,-4
24,10,136,11,14,-3
24,10,137,12,16,-4
24,10,138,23,20,3
24,10,139,13,7,6
24,10,140,12,37,-25
24,10,141,13,18,-5
24,10,142,8,16,-8
24,10,143,14,16,-2
24,10,144,8,21,-13
24,10,145,13,16,-3
24,10,146,13,18,-5
24,10,147,21,21,0
24,10,148,16,18,-2
24,10,149,25,18,7
24,10,150,9,13,-4
24,10,151,17,18,-1
24,10,152,21,37,-16
24,10,153,16,22,-6
24,10,154,14,18,-4
24,10,155,7,9,-2
24,10,156,13,26,-13
24,10,157,7,26,-19
24,10,158,6,28,-22
24,10,159,15,18,-3
24,10,160,10,26,-16
24,10,161,11,13,-2
24,10,162,18,36,-18
24,10,163,11,11,0
24,10,164,18,18,0
24,10,165,4,24,-20
24,10,166,19,28,-9
24,10,167,8,20,-12
24,10,168,20,16,4
24,10,169,12,27,-15
24,10,170,13,13,0
24,10,171,4,26,-22
24,10,172,20,25,-5
24,10,173,10,13,-3
24,10,174,5,14,-9
24,10,175,15,27,-12
24,10,176,10,27,-17
24,10,177,11,14,-3
24,10,178,12,26,-14
24,10,179,11,33,-22
24,10,180,10,16,-6
24,10,181,6,7,-1
24,10,182,17,16,1
24,10,183,10,17,-7
24,10,184,11,15,-4
24,10,185,14,14,0
24,10,186,9,19,-10
24,10,187,11,17,-6
24,10,188,10,19,-9
24,10,189,8,6,2
24,10,190,8,29,-21
24,10,191,6,22,-16
24,10,192,12,26,-14
24,10,193,7,19,-12
24,10,194,16,35,-19
24,10,195,17,22,-5
24,10,196,6,22,-16
24,10,197,5,16,-11
24,10,198,10,19,-9
24,10,199,13,28,-15
24,10,200,8,27,-19
24,10,201,11,24,-13
24,10,202,12,31,-19
24,10,203,5,12,-7
24,10,204,16,20,-4
24,10,205,17,20,-3
24,10,206,14,18,-4
24,10,207,11,24,-13
24,10,208,3,17,-14
24,10,209,10,25,-15
24,10,210,8,15,-7
24,10,211,31,24,7
24,10,212,3,23,-20
24,10,213,4,19,-15
24,10,214,2,29,-27
24,10,215,5,12,-7
24,10,216,13,16,-3
24,10,217,12,25,-13
24,10,218,19,20,-1
24,10,219,7,23,-16
24,10,220,16,30,-14
24,10,221,8,30,-22
24,10,222,16,11,5
24,10,223,11,14,-3
24,10,224,16,17,-1
24,10,225,21,31,-10
24,10,226,6,20,-14
24,10,227,14,37,-23
24,10,228,9,18,-9
24,10,229,13,22,-9
24,10,230,20,32,-12
24,10,231,11,20,-9
24,10,232,6,22,-16
24,10,233,11,16,-5
24,10,234,11,25,-14
24,10,235,11,26,-15
24,10,236,9,24,-15
24,10,237,13,22,-9
24,10,238,13,29,-16
24,10,239,17,21,-4
24,10,240,9,20,-11
24,10,241,15,25,-10
24,10,242,9,27,-18
24,10,243,9,16,-7
24,10,244,10,13,-3
24,10,245,16,28,-12
24,10,246,26,23,3
24,10,247,9,20,-11
24,10,248,12,14,-2
24,10,249,8,21,-13
24,10,250,8,26,-18
24,10,251,6,21,-15
24,10,252,10,17,-7
24,10,253,6,24,-18
24,10,254,14,25,-11
24,10,255,21,20,1
24,10,256,12,17,-5
24,10,257,17,16,1
24,10,258,18,31,-13
24,10,259,15,32,-17
24,10,260,6,20,-14
24,10,261,13,22,-9
24,10,262,12,26,-14
24,10,263,11,22,-11
24,10,264,13,41,-28
24,10,265,8,18,-10
24,10,266,18,26,-8
24,10,267,15,21,-6
24,10,268,16,10,6
24,10,269,8,24,-16
24,10,270,14,19,-5
24,10,271,3,24,-21
24,10,272,9,33,-24
24,10,273,6,20,-14
24,10,274,11,25,-14
24,10,275,21,27,-6
24,10,276,9,22,-13
24,10,277,5,20,-15
24,10,278,9,8,1
24,10,279,13,18,-5
24,10,280,9,11,-2
24,10,281,11,19,-8
24,10,282,7,10,-3
24,10,283,20,20,0
24,10,284,18,23,-5
24,10,285,9,16,-7
24,10,286,12,17,-5
24,10,287,17,25,-8
24,10,288,5,10,-5
24,10,289,16,32,-16
24,10,290,8,26,-18
24,10,291,7,25,-18
24,10,292,9,35,-26
24,10,293,19,44,-25
24,10,294,8,21,-13
24,10,295,8,23,-15
24,10,296,4,21,-17
24,10,297,6,6,0
24,10,298,4,6,-2
24,10,299,9,16,-7
24,11,0,6,14,-8
24,11,1,10,14,-4
24,11,2,13,20,-7
24,11,3,11,25,-14
24,11,4,14,16,-2
24,11,5,12,25,-13
24,11,6,13,24,-11
24,11,7,18,22,-4
24,11,8,17,17,0
24,11,9,7,17,-10
24,11,10,10,23,-13
24,11,11,17,17,0
24,11,12,10,17,-7
24,11,13,22,17,5
24,11,14,22,23,-1
24,11,15,15,18,-3
24,11,16,9,15,-6
24,11,17,6,5,1
24,11,18,9,19,-10
24,11,19,17,22,-5
24,11,20,11,17,-6
24,11,21,11,22,-11
24,11,22,7,12,-5
24,11,23,10,17,-7
24,11,24,16,12,4
24,11,25,22,25,-3
24,11,26,14,14,0
24,11,27,28,29,-1
24,11,28,16,24,-8
24,11,29,12,19,-7
24,11,30,1,12,-11
24,11,31,11,18,-7
24,11,32,11,13,-2
24,11,33,8,16,-8
24,11,34,9,13,-4
24,11,35,14,26,-12
24,11,36,13,27,-14
24,11,37,10,11,-1
24,11,38,21,25,-4
24,11,39,9,16,-7
24,11,40,4,16,-12
24,11,41,16,23,-7
24,11,42,7,28,-21
24,11,43,21,22,-1
24,11,44,12,25,-13
24,11,45,8,14,-6
24,11,46,7,15,-8
24,11,47,10,14,-4
24,11,48,9,3,6
24,11,49,7,12,-5
24,11,50,11,9,2
24,11,51,15,16,-1
24,11,52,8,24,-16
24,11,53,22,18,4
24,11,54,11,19,-8
24,11,55,13,21,-8
24,11,56,13,6,7
24,11,57,9,8,1
24,11,58,14,26,-12
24,11,59,8,21,-13
24,11,60,23,33,-10
24,11,61,15,20,-5
24,11,62,6,17,-11
24,11,63,11,20,-9
24,11,64,9,21,-12
24,11,65,8,22,-14
24,11,66,12,21,-9
24,11,67,14,23,-9
24,11,68,11,23,-12
24,11,69,14,20,-6
24,11,70,7,7,0
24,11,71,7,12,-5
24,11,72,10,20,-10
24,11,73,19,18,1
24,11,74,16,24,-8
24,11,75,11,17,-6
24,11,76,6,15,-9
24,11,77,5,16,-11
24,11,78,14,30,-16
24,11,79,16,27,-11
24,11,80,9,19,-10
24,11,81,9,16,-7
24,11,82,10,21,-11
24,11,83,20,12,8
24,11,84,12,20,-8
24,11,85,8,19,-11
24,11,86,7,15,-8
24,11,87,8,25,-17
24,11,88,6,8,-2
24,11,89,18,10,8
24,11,90,20,16,4
24,11,91,14,30,-16
24,11,92,18,24,-6
24,11,93,10,16,-6
24,11,94,3,4,-1
24,11,95,8,12,-4
24,11,96,17,16,1
24,11,97,12,30,-18
24,11,98,22,32,-10
24,11,99,4,16,-12
24,11,100,11,21,-10
24,11,101,14,20,-6
24,11,102,6,14,-8
24,11,103,9,18,-9
24,11,104,9,22,-13
24,11,105,18,29,-11
24,11,106,7,17,-10
24,11,107,15,20,-5
24,11,108,14,22,-8
24,11,109,13,16,-3
24,11,110,18,41,-23
24,11,111,6,23,-17
24,11,112,11,23,-12
24,11,113,8,16,-8
24,11,114,11,14,-3
24,11,115,12,15,-3
24,11,116,14,18,-4
24,11,117,6,23,-17
24,11,118,11,20,-9
24,11,119,6,17,-11
24,11,120,8,16,-8
24,11,121,10,26,-16
24,11,122,8,20,-12
24,11,123,12,19,-7
24,11,124,14,13,1
24,11,125,4,22,-18
24,11,126,12,12,0
24,11,127,7,20,-13
24,11,128,14,20,-6
24,11,129,14,25,-11
24,11,130,16,24,-8
24,11,131,14,37,-23
24,11,132,13,24,-11
24,11,133,19,21,-2
24,11,134,19,39,-20
24,11,135,15,22,-7
24,11,136,6,18,-12
24,11,137,14,10,4
24,11,138,1,8,-7
24,11,139,12,20,-8
24,11,140,13,8,5
24,11,141,18,32,-14
24,11,142,22,23,-1
24,11,143,11,28,-17
24,11,144,15,26,-11
24,11,145,10,27,-17
24,11,146,16,17,-1
24,11,147,19,18,1
24,11,148,17,27,-10
24,11,149,19,26,-7
24,11,150,6,17,-11
24,11,151,17,25,-8
24,11,152,11,9,2
24,11,153,5,24,-19
24,11,154,4,24,-20
24,11,155,12,15,-3
24,11,156,4,10,-6
24,11,157,10,19,-9
24,11,158,8,22,-14
24,11,159,27,26,1
24,11,160,16,26,-10
24,11,161,8,8,0
24,11,162,17,27,-10
24,11,163,10,17,-7
24,11,164,25,19,6
24,11,165,9,13,-4
24,11,166,9,16,-7
24,11,167,16,20,-4
24,11,168,4,13,-9
24,11,169,10,17,-7
24,11,170,11,9,2
24,11,171,5,20,-15
24,11,172,17,20,-3
24,11,173,20,37,-17
24,11,174,16,14,2
24,11,175,18,12,6
24,11,176,10,10,0
24,11,177,18,41,-23
24,11,178,6,18,-12
24,11,179,9,6,3
24,11,180,23,30,-7
24,11,181,7,20,-13
24,11,182,10,12,-2
24,11,183,13,16,-3
24,11,184,1,14,-13
24,11,185,12,36,-24
24,11,186,10,16,-6
24,11,187,6,17,-11
24,11,188,14,15,-1
24,11,189,4,1,3
24,11,190,7,24,-17
24,11,191,4,15,-11
24,11,192,10,11,-1
24,11,193,17,14,3
24,11,194,1,8,-7
24,11,195,8,16,-8
24,11,196,8,13,-5
24,11,197,13,22,-9
24,11,198,6,21,-15
24,11,199,7,15,-8
24,11,200,17,25,-8
24,11,201,17,26,-9
24,11,202,4,10,-6
24,11,203,8,18,-10
24,11,204,10,25,-15
24,11,205,15,14,1
24,11,206,7,16,-9
24,11,207,18,14,4
24,11,208,7,23,-16
24,11,209,6,10,-4
24,11,210,6,23,-17
24,11,211,12,16,-4
24,11,212,15,15,0
24,11,213,20,15,5
24,11,214,16,30,-14
24,11,215,14,20,-6
24,11,216,16,17,-1
24,11,217,14,17,-3
24,11,218,4,24,-20
24,11,219,16,14,2
24,11,220,11,19,-8
24,11,221,18,15,3
24,11,222,15,24,-9
24,11,223,10,22,-12
24,11,224,15,28,-13
24,11,225,14,25,-11
24,11,226,7,19,-12
24,11,227,9,18,-9
24,11,228,22,27,-5
24,11,229,18,19,-1
24,11,230,13,22,-9
24,11,231,6,18,-12
24,11,232,14,21,-7
24,11,233,10,14,-4
24,11,234,11,24,-13
24,11,235,14,21,-7
24,11,236,13,9,4
24,11,237,12,23,-11
24,11,238,15,19,-4
24,11,239,19,13,6
24,11,240,15,17,-2
24,11,241,3,16,-13
24,11,242,9,29,-20
24,11,243,10,17,-7
24,11,244,8,15,-7
24,11,245,11,16,-5
24,11,246,11,18,-7
24,11,247,5,13,-8
24,11,248,20,25,-5
24,11,249,13,23,-10
24,11,250,12,29,-17
24,11,251,23,25,-2
24,11,252,17,19,-2
24,11,253,17,20,-3
24,11,254,19,15,4
24,11,255,9,11,-2
24,11,256,2,11,-9
24,11,257,8,27,-19
24,11,258,6,11,-5
24,11,259,11,15,-4
24,11,260,6,20,-14
24,11,261,9,14,-5
24,11,262,14,23,-9
24,11,263,6,22,-16
24,11,264,15,14,1
24,11,265,14,20,-6
24,11,266,10,8,2
24,11,267,19,21,-2
24,11,268,8,18,-10
24,11,269,24,29,-5
24,11,270,13,12,1
24,11,271,5,14,-9
24,11,272,10,33,-23
24,11,273,5,24,-19
24,11,274,13,21,-8
24,11,275,8,16,-8
24,11,276,10,25,-15
24,11,277,13,22,-9
24,11,278,12,15,-3
24,11,279,6,19,-13
24,11,280,13,19,-6
24,11,281,9,16,-7
24,11,282,8,14,-6
24,11,283,17,12,5
24,11,284,9,14,-5
24,11,285,9,9,0
24,11,286,18,13,5
24,11,287,12,16,-4
24,11,288,9,15,-6
24,11,289,11,16,-5
24,11,290,15,29,-14
24,11,291,12,14,-2
24,11,292,18,27,-9
24,11,293,15,21,-6
24,11,294,6,17,-11
24,11,295,19,26,-7
24,11,296,18,17,1
24,11,297,23,24,-1
24,11,298,9,21,-12
24,11,299,8,16,-8
24,12,0,8,12,-4
24,12,1,23,27,-4
24,12,2,17,19,-2
24,12,3,8,14,-6
24,12,4,7,18,-11
24,12,5,9,25,-16
24,12,6,3,31,-28
24,12,7,13,26,-13
24,12,8,8,12,-4
24,12,9,17,21,-4
24,12,10,5,22,-17
24,12,11,12,20,-8
24,12,12,17,15,2
24,12,13,4,15,-11
24,12,14,14,24,-10
24,12,15,7,31,-24
24,12,16,12,20,-8
24,12,17,6,15,-9
24,12,18,11,11,0
24,12,19,6,18,-12
24,12,20,7,10,-3
24,12,21,11,16,-5
24,12,22,12,10,2
24,12,23,6,28,-22
24,12,24,13,26,-13
24,12,25,18,27,-9
24,12,26,15,11,4
24,12,27,8,13,-5
24,12,28,14,14,0
24,12,29,7,26,-19
24,12,30,7,18,-11
24,12,31,7,12,-5
24,12,32,10,12,-2
24,12,33,21,14,7
24,12,34,13,29,-16
24,12,35,15,17,-2
24,12,36,3,8,-5
24,12,37,14,23,-9
24,12,38,10,9,1
24,12,39,5,20,-15
24,12,40,8,17,-9
24,12,41,8,29,-21
24,12,42,19,21,-2
24,12,43,8,15,-7
24,12,44,13,32,-19
24,12,45,14,25,-11
24,12,46,13,15,-2
24,12,47,9,17,-8
24,12,48,12,32,-20
24,12,49,9,21,-12
24,12,50,7,25,-18
24,12,51,6,24,-18
24,12,52,17,26,-9
24,12,53,12,24,-12
24,12,54,20,31,-11
24,12,55,16,4,12
24,12,56,15,14,1
24,12,57,14,24,-10
24,12,58,12,21,-9
24,12,59,4,12,-8
24,12,60,18,21,-3
24,12,61,9,34,-25
24,12,62,6,13,-7
24,12,63,10,13,-3
24,12,64,14,22,-8
24,12,65,14,41,-27
24,12,66,13,29,-16
24,12,67,13,19,-6
24,12,68,16,18,-2
24,12,69,11,20,-9
24,12,70,2,14,-12
24,12,71,14,14,0
24,12,72,6,14,-8
24,12,73,21,25,-4
24,12,74,16,17,-1
24,12,75,15,14,1
24,12,76,9,16,-7
24,12,77,12,17,-5
24,12,78,16,15,1
24,12,79,10,12,-2
24,12,80,13,13,0
24,12,81,19,14,5
24,12,82,12,29,-17
24,12,83,5,30,-25
24,12,84,19,36,-17
24,12,85,4,17,-13
24,12,86,10,15,-5
24,12,87,12,18,-6
24,12,88,17,19,-2
24,12,89,5,16,-11
24,12,90,11,25,-14
24,12,91,11,32,-21
24,12,92,7,18,-11
24,12,93,14,18,-4
24,12,94,14,10,4
24,12,95,12,17,-5
24,12,96,10,22,-12
24,12,97,17,26,-9
24,12,98,15,14,1
24,12,99,13,15,-2
24,12,100,6,24,-18
24,12,101,19,24,-5
24,12,102,12,17,-5
24,12,103,8,41,-33
24,12,104,13,15,-2
24,12,105,6,16,-10
24,12,106,27,30,-3
24,12,107,8,17,-9
24,12,108,15,16,-1
24,12,109,15,21,-6
24,12,110,2,10,-8
24,12,111,14,22,-8
24,12,112,10,8,2
24,12,113,11,19,-8
24,12,114,10,19,-9
24,12,115,9,9,0
24,12,116,10,21,-11
24,12,117,13,20,-7
24,12,118,11,23,-12
24,12,119,11,14,-3
24,12,120,26,18,8
24,12,121,11,19,-8
24,12,122,12,23,-11
24,12,123,9,22,-13
24,12,124,10,21,-11
24,12,125,10,12,-2
24,12,126,14,30,-16
24,12,127,8,8,0
24,12,128,15,17,-2
24,12,129,11,7,4
24,12,130,6,15,-9
24,12,131,9,16,-7
24,12,132,21,18,3
24,12,133,5,5,0
24,12,134,8,24,-16
24,12,135,6,13,-7
24,12,136,10,23,-13
24,12,137,13,23,-10
24,12,138,12,12,0
24,12,139,8,6,2
24,12,140,17,24,-7
24,12,141,5,11,-6
24,12,142,6,6,0
24,12,143,14,16,-2
24,12,144,20,39,-19
24,12,145,23,29,-6
24,12,146,5,14,-9
24,12,147,10,25,-15
24,12,148,13,16,-3
24,12,149,10,13,-3
24,12,150,14,14,0
24,12,151,3,19,-16
24,12,152,1,3,-2
24,12,153,20,17,3
24,12,154,4,15,-11
24,12,155,8,12,-4
24,12,156,10,16,-6
24,12,157,14,13,1
24,12,158,11,15,-4
24,12,159,10,13,-3
24,12,160,5,24,-19
24,12,161,16,16,0
24,12,162,2,11,-9
24,12,163,4,24,-20
24,12,164,11,12,-1
24,12,165,8,16,-8
24,12,166,12,18,-6
24,12,167,7,18,-11
24,12,168,10,19,-9
24,12,169,17,18,-1
24,12,170,15,13,2
24,12,171,24,19,5
24,12,172,23,17,6
24,12,173,5,18,-13
24,12,174,23,21,2
24,12,175,10,2,8
24,12,176,16,28,-12
24,12,177,11,28,-17
24,12,178,19,24,-5
24,12,179,8,18,-10
24,12,180,26,33,-7
24,12,181,11,21,-10
24,12,182,10,17,-7
24,12,183,6,9,-3
24,12,184,7,7,0
24,12,185,11,16,-5
24,12,186,11,20,-9
24,12,187,11,21,-10
24,12,188,6,18,-12
24,12,189,6,22,-16
24,12,190,5,25,-20
24,12,191,12,25,-13
24,12,192,13,20,-7
24,12,193,13,5,8
24,12,194,11,13,-2
24,12,195,8,14,-6
24,12,196,6,15,-9
24,12,197,6,20,-14
24,12,198,9,27,-18
24,12,199,13,13,0
24,12,200,8,13,-5
24,12,201,11,23,-12
24,12,202,11,23,-12
24,12,203,21,16,5
24,12,204,3,12,-9
24,12,205,10,14,-4
24,12,206,9,20,-11
24,12,207,9,21,-12
24,12,208,5,9,-4
24,12,209,14,16,-2
24,12,210,20,18,2
24,12,211,13,30,-17
24,12,212,12,13,-1
24,12,213,7,16,-9
24,12,214,22,27,-5
24,12,215,12,20,-8
24,12,216,14,23,-9
24,12,217,5,15,-10
24,12,218,15,35,-20
24,12,219,19,21,-2
24,12,220,9,10,-1
24,12,221,5,18,-13
24,12,222,16,15,1
24,12,223,15,18,-3
24,12,224,11,17,-6
24,12,225,17,14,3
24,12,226,7,12,-5
24,12,227,15,24,-9
24,12,228,17,27,-10
24,12,229,8,14,-6
24,12,230,23,28,-5
24,12,231,7,28,-21
24,12,232,9,24,-15
24,12,233,17,29,-12
24,12,234,7,28,-21
24,12,235,3,10,-7
24,12,236,21,27,-6
24,12,237,14,19,-5
24,12,238,20,27,-7
24,12,239,14,10,4
24,12,240,10,27,-17
24,12,241,13,13,0
24,12,242,17,28,-11
24,12,243,13,11,2
24,12,244,14,21,-7
24,12,245,22,20,2
24,12,246,5,23,-18
24,12,247,11,11,0
24,12,248,8,15,-7
24,12,249,13,9,4
24,12,250,15,13,2
24,12,251,8,12,-4
24,12,252,9,13,-4
24,12,253,9,12,-3
24,12,254,14,21,-7
24,12,255,2,5,-3
24,12,256,15,21,-6
24,12,257,14,18,-4
24,12,258,7,15,-8
24,12,259,8,15,-7
24,12,260,8,11,-3
24,12,261,15,21,-6
24,12,262,9,24,-15
24,12,263,3,10,-7
24,12,264,8,30,-22
24,12,265,6,13,-7
24,12,266,14,16,-2
24,12,267,12,24,-12
24,12,268,14,16,-2
24,12,269,18,41,-23
24,12,270,17,20,-3
24,12,271,21,36,-15
24,12,272,9,12,-3
24,12,273,2,21,-19
24,12,274,6,17,-11
24,12,275,4,33,-29
24,12,276,21,20,1
24,12,277,5,17,-12
24,12,278,6,18,-12
24,12,279,11,18,-7
24,12,280,10,11,-1
24,12,281,7,25,-18
24,12,282,11,8,3
24,12,283,27,23,4
24,12,284,4,11,-7
24,12,285,8,18,-10
24,12,286,11,22,-11
24,12,287,13,32,-19
24,12,288,8,13,-5
24,12,289,19,21,-2
24,12,290,19,16,3
24,12,291,11,8,3
24,12,292,11,16,-5
24,12,293,4,2,2
24,12,294,6,22,-16
24,12,295,15,12,3
24,12,296,6,6,0
24,12,297,16,34,-18
24,12,298,12,20,-8
24,12,299,18,26,-8
24,13,0,8,22,-14
24,13,1,14,11,3
24,13,2,10,10,0
24,13,3,15,23,-8
24,13,4,13,16,-3
24,13,5,11,15,-4
24,13,6,16,13,3
24,13,7,9,8,1
24,13,8,6,16,-10
24,13,9,12,17,-5
24,13,10,18,17,1
24,13,11,15,16,-1
24,13,12,7,26,-19
24,13,13,15,8,7
24,13,14,16,15,1
24,13,15,9,11,-2
24,13,16,11,20,-9
24,13,17,15,24,-9
24,13,18,10,19,-9
24,13,19,10,18,-8
24,13,20,12,24,-12
24,13,21,12,26,-14
24,13,22,8,14,-6
24,13,23,12,12,0
24,13,24,14,24,-10
24,13,25,23,25,-2
24,13,26,15,27,-12
24,13,27,11,32,-21
24,13,28,18,22,-4
24,13,29,6,10,-4
24,13,30,16,20,-4
24,13,31,5,16,-11
24,13,32,19,19,0
24,13,33,10,17,-7
24,13,34,9,16,-7
24,13,35,12,12,0
24,13,36,15,16,-1
24,13,37,8,18,-10
24,13,38,6,9,-3
24,13,39,10,23,-13
24,13,40,3,12,-9
24,13,41,7,20,-13
24,13,42,13,23,-10
24,13,43,12,18,-6
24,13,44,14,22,-8
24,13,45,8,15,-7
24,13,46,25,19,6
24,13,47,22,29,-7
24,13,48,17,17,0
24,13,49,5,17,-12
24,13,50,13,17,-4
24,13,51,17,36,-19
24,13,52,5,17,-12
24,13,53,6,17,-11
24,13,54,8,13,-5
24,13,55,6,7,-1
24,13,56,4,20,-16
24,13,57,16,14,2
24,13,58,7,21,-14
24,13,59,20,17,3
24,13,60,17,12,5
24,13,61,10,22,-12
24,13,62,5,18,-13
24,13,63,14,17,-3
24,13,64,19,25,-6
24,13,65,3,6,-3
24,13,66,16,27,-11
24,13,67,8,13,-5
24,13,68,15,21,-6
24,13,69,11,23,-12
24,13,70,8,9,-1
24,13,71,25,19,6
24,13,72,14,26,-12
24,13,73,11,14,-3
24,13,74,27,25,2
24,13,75,19,15,4
24,13,76,11,27,-16
24,13,77,7,14,-7
24,13,78,15,36,-21
24,13,79,13,10,3
24,13,80,8,19,-11
24,13,81,12,12,0
24,13,82,8,19,-11
24,13,83,8,20,-12
24,13,84,7,32,-25
24,13,85,9,18,-9
24,13,86,7,10,-3
24,13,87,10,32,-22
24,13,88,15,20,-5
24,13,89,5,21,-16
24,13,90,17,19,-2
24,13,91,7,26,-19
24,13,92,13,28,-15
24,13,93,14,20,-6
24,13,94,9,20,-11
24,13,95,9,18,-9
24,13,96,16,9,7
24,13,97,9,10,-1
24,13,98,5,21,-16
24,13,99,6,17,-11
24,13,100,11,18,-7
24,13,101,13,37,-24
24,13,102,21,27,-6
24,13,103,5,7,-2
24,13,104,8,15,-7
24,13,105,14,15,-1
24,13,106,16,21,-5
24,13,107,9,22,-13
24,13,108,3,15,-12
24,13,109,6,27,-21
24,13,110,14,27,-13
24,13,111,20,32,-12
24,13,112,5,14,-9
24,13,113,6,9,-3
24,13,114,15,14,1
24,13,115,10,38,-28
24,13,116,27,25,2
24,13,117,6,20,-14
24,13,118,26,22,4
24,13,119,15,15,0
24,13,120,11,34,-23
24,13,121,8,11,-3
24,13,122,7,12,-5
24,13,123,10,29,-19
24,13,124,9,18,-9
24,13,125,7,8,-1
24,13,126,16,11,5
24,13,127,19,35,-16
24,13,128,11,14,-3
24,13,129,14,24,-10
24,13,130,12,22,-10
24,13,131,16,12,4
24,13,132,16,14,2
24,13,133,4,14,-10
24,13,134,18,15,3
24,13,135,8,26,-18
24,13,136,16,15,1
24,13,137,11,21,-10
24,13,138,10,17,-7
24,13,139,11,26,-15
24,13,140,10,18,-8
24,13,141,9,18,-9
24,13,142,18,15,3
24,13,143,18,26,-8
24,13,144,9,22,-13
24,13,145,14,21,-7
24,13,146,17,17,0
24,13,147,6,15,-9
24,13,148,7,14,-7
24,13,149,22,30,-8
24,13,150,6,13,-7
24,13,151,15,16,-1
24,13,152,3,14,-11
24,13,153,7,14,-7
24,13,154,7,19,-12
24,13,155,9,35,-26
24,13,156,24,11,13
24,13,157,4,12,-8
24,13,158,17,22,-5
24,13,159,8,18,-10
24,13,160,28,19,9
24,13,161,5,14,-9
24,13,162,11,26,-15
24,13,163,22,28,-6
24,13,164,25,23,2
24,13,165,9,18,-9
24,13,166,9,19,-10
24,13,167,8,15,-7
24,13,168,1,10,-9
24,13,169,4,22,-18
24,13,170,7,10,-3
24,13,171,10,14,-4
24,13,172,10,32,-22
24,13,173,12,15,-3
24,13,174,14,9,5
24,13,175,11,22,-11
24,13,176,6,11,-5
24,13,177,15,22,-7
24,13,178,6,9,-3
24,13,179,13,26,-13
24,13,180,14,10,4
24,13,181,4,8,-4
24,13,182,9,18,-9
24,13,183,11,17,-6
24,13,184,25,23,2
24,13,185,4,25,-21
24,13,186,12,25,-13
24,13,187,10,19,-9
24,13,188,15,23,-8
24,13,189,18,18,0
24,13,190,6,19,-13
24,13,191,5,32,-27
24,13,192,11,28,-17
24,13,193,17,15,2
24,13,194,9,18,-9
24,13,195,20,21,-1
24,13,196,14,19,-5
24,13,197,3,20,-17
24,13,198,20,21,-1
24,13,199,11,18,-7
24,13,200,15,25,-10
24,13,201,17,17,0
24,13,202,7,20,-13
24,13,203,4,17,-13
24,13,204,3,15,-12
24,13,205,25,28,-3
24,13,206,6,25,-19
24,13,207,14,26,-12
24,13,208,12,16,-4
24,13,209,14,22,-8
24,13,210,8,29,-21
24,13,211,22,34,-12
24,13,212,13,7,6
24,13,213,17,19,-2
24,13,214,12,18,-6
24,13,215,6,13,-7
24,13,216,6,6,0
24,13,217,17,26,-9
24,13,218,20,22,-2
24,13,219,9,14,-5
24,13,220,11,5,6
24,13,221,6,11,-5
24,13,222,4,15,-11
24,13,223,3,22,-19
24,13,224,7,23,-16
24,13,225,5,18,-13
24,13,226,13,17,-4
24,13,227,11,12,-1
24,13,228,11,15,-4
24,13,229,31,28,3
24,13,230,15,17,-2
24,13,231,19,24,-5
24,13,232,8,15,-7
24,13,233,13,21,-8
24,13,234,5,22,-17
24,13,235,14,16,-2
24,13,236,14,18,-4
24,13,237,8,18,-10
24,13,238,14,17,-3
24,13,239,9,7,2
24,13,240,6,18,-12
24,13,241,13,21,-8
24,13,242,8,19,-11
24,13,243,8,15,-7
24,13,244,11,9,2
24,13,245,11,21,-10
24,13,246,16,9,7
24,13,247,14,11,3
24,13,248,11,19,-8
24,13,249,9,17,-8
24,13,250,14,14,0
24,13,251,15,13,2
24,13,252,10,24,-14
24,13,253,8,10,-2
24,13,254,22,9,13
24,13,255,11,18,-7
24,13,256,15,20,-5
24,13,257,20,23,-3
24,13,258,10,17,-7
24,13,259,16,25,-9
24,13,260,5,21,-16
24,13,261,12,9,3
24,13,262,16,8,8
24,13,263,9,22,-13
24,13,264,22,27,-5
24,13,265,15,16,-1
24,13,266,13,17,-4
24,13,267,12,30,-18
24,13,268,21,17,4
24,13,269,9,15,-6
24,13,270,16,21,-5
24,13,271,6,20,-14
24,13,272,16,34,-18
24,13,273,9,11,-2
24,13,274,12,15,-3
24,13,275,6,15,-9
24,13,276,6,15,-9
24,13,277,13,16,-3
24,13,278,16,19,-3
24,13,279,3,17,-14
24,13,280,13,17,-4
24,13,281,11,10,1
24,13,282,9,21,-12
24,13,283,17,16,1
24,13,284,11,11,0
24,13,285,10,13,-3
24,13,286,22,20,2
24,13,287,19,28,-9
24,13,288,9,13,-4
24,13,289,13,17,-4
24,13,290,10,14,-4
24,13,291,16,8,8
24,13,292,15,19,-4
24,13,293,19,14,5
24,13,294,18,20,-2
24,13,295,12,11,1
24,13,296,9,35,-26
24,13,297,13,8,5
24,13,298,13,17,-4
24,13,299,3,12,-9
24,14,0,10,16,-6
24,14,1,10,21,-11
24,14,2,19,21,-2
24,14,3,10,23,-13
24,14,4,19,35,-16
24,14,5,12,23,-11
24,14,6,11,10,1
24,14,7,7,27,-20
24,14,8,11,22,-11
24,14,9,9,7,2
24,14,10,14,26,-12
24,14,11,7,8,-1
24,14,12,12,13,-1
24,14,13,9,12,-3
24,14,14,7,22,-15
24,14,15,10,18,-8
24,14,16,5,15,-10
24,14,17,11,20,-9
24,14,18,10,21,-11
24,14,19,16,14,2
24,14,20,5,11,-6
24,14,21,19,16,3
24,14,22,5,14,-9
24,14,23,11,8,3
24,14,24,23,17,6
24,14,25,17,19,-2
24,14,26,18,29,-11
24,14,27,16,13,3
24,14,28,26,17,9
24,14,29,16,17,-1
24,14,30,9,23,-14
24,14,31,12,28,-16
24,14,32,6,24,-18
24,14,33,14,11,3
24,14,34,8,17,-9
24,14,35,15,13,2
24,14,36,10,15,-5
24,14,37,9,12,-3
24,14,38,21,11,10
24,14,39,14,20,-6
24,14,40,14,22,-8
24,14,41,13,6,7
24,14,42,14,13,1
24,14,43,8,23,-15
24,14,44,9,14,-5
24,14,45,18,19,-1
24,14,46,12,20,-8
24,14,47,17,12,5
24,14,48,21,24,-3
24,14,49,9,14,-5
24,14,50,13,13,0
24,14,51,20,22,-2
24,14,52,11,12,-1
24,14,53,13,27,-14
24,14,54,9,10,-1
24,14,55,24,24,0
24,14,56,18,18,0
24,14,57,17,18,-1
24,14,58,11,18,-7
24,14,59,5,16,-11
24,14,60,10,5,5
24,14,61,10,18,-8
24,14,62,10,8,2
24,14,63,7,25,-18
24,14,64,7,23,-16
24,14,65,10,15,-5
24,14,66,24,17,7
24,14,67,7,12,-5
24,14,68,4,18,-14
24,14,69,13,9,4
24,14,70,4,15,-11
24,14,71,4,17,-13
24,14,72,16,16,0
24,14,73,17,21,-4
24,14,74,5,8,-3
24,14,75,24,25,-1
24,14,76,4,14,-10
24,14,77,17,18,-1
24,14,78,19,17,2
24,14,79,7,19,-12
24,14,80,12,21,-9
24,14,81,10,24,-14
24,14,82,8,29,-21
24,14,83,5,24,-19
24,14,84,8,16,-8
24,14,85,5,10,-5
24,14,86,12,21,-9
24,14,87,10,14,-4
24,14,88,17,17,0
24,14,89,15,32,-17
24,14,90,17,29,-12
24,14,91,23,24,-1
24,14,92,10,38,-28
24,14,93,27,23,4
24,14,94,14,13,1
24,14,95,12,14,-2
24,14,96,4,7,-3
24,14,97,7,23,-16
24,14,98,15,13,2
24,14,99,7,8,-1
24,14,100,4,15,-11
24,14,101,15,26,-11
24,14,102,20,16,4
24,14,103,15,23,-8
24,14,104,10,12,-2
24,14,105,12,32,-20
24,14,106,19,16,3
24,14,107,8,21,-13
24,14,108,14,16,-2
24,14,109,7,18,-11
24,14,110,9,8,1
24,14,111,20,23,-3
24,14,112,24,15,9
24,14,113,10,26,-16
24,14,114,17,25,-8
24,14,115,11,22,-11
24,14,116,8,26,-18
24,14,117,18,22,-4
24,14,118,6,20,-14
24,14,119,22,33,-11
24,14,120,15,23,-8
24,14,121,20,12,8
24,14,122,16,19,-3
24,14,123,11,17,-6
24,14,124,9,16,-7
24,14,125,15,23,-8
24,14,126,5,13,-8
24,14,127,12,19,-7
24,14,128,8,19,-11
24,14,129,9,22,-13
24,14,130,9,33,-24
24,14,131,9,25,-16
24,14,132,10,10,0
24,14,133,3,20,-17
24,14,134,19,14,5
24,14,135,12,17,-5
24,14,136,4,11,-7
24,14,137,13,22,-9
24,14,138,11,18,-7
24,14,139,14,36,-22
24,14,140,30,25,5
24,14,141,15,22,-7
24,14,142,13,14,-1
24,14,143,13,13,0
24,14,144,6,14,-8
24,14,145,15,19,-4
24,14,146,12,17,-5
24,14,147,12,33,-21
24,14,148,10,9,1
24,14,149,18,16,2
24,14,150,16,14,2
24,14,151,11,17,-6
24,14,152,12,17,-5
24,14,153,12,14,-2
24,14,154,9,14,-5
24,14,155,2,13,-11
24,14,156,19,13,6
24,14,157,27,20,7
24,14,158,5,24,-19
24,14,159,6,9,-3
24,14,160,13,12,1
24,14,161,10,19,-9
24,14,162,10,11,-1
24,14,163,16,26,-10
24,14,164,13,9,4
24,14,165,22,33,-11
24,14,166,21,27,-6
24,14,167,7,20,-13
24,14,168,23,34,-11
24,14,169,13,11,2
24,14,170,30,12,18
24,14,171,5,20,-15
24,14,172,12,8,4
24,14,173,16,21,-5
24,14,174,14,13,1
24,14,175,10,20,-10
24,14,176,2,23,-21
24,14,177,5,23,-18
24,14,178,15,24,-9
24,14,179,11,12,-1
24,14,180,8,26,-18
24,14,181,12,19,-7
24,14,182,14,6,8
24,14,183,16,7,9
24,14,184,8,21,-13
24,14,185,6,19,-13
24,14,186,14,15,-1
24,14,187,10,11,-1
24,14,188,6,9,-3
24,14,189,20,20,0
24,14,190,4,17,-13
24,14,191,12,18,-6
24,14,192,16,23,-7
24,14,193,13,24,-11
24,14,194,7,15,-8
24,14,195,8,15,-7
24,14,196,17,18,-1
24,14,197,21,21,0
24,14,198,21,11,10
24,14,199,6,12,-6
24,14,200,10,13,-3
24,14,201,12,22,-10
24,14,202,11,6,5
24,14,203,16,17,-1
24,14,204,6,27,-21
24,14,205,8,19,-11
24,14,206,12,18,-6
24,14,207,10,14,-4
24,14,208,15,14,1
24,14,209,15,17,-2
24,14,210,20,18,2
24,14,211,11,12,-1
24,14,212,9,22,-13
24,14,213,5,9,-4
24,14,214,10,6,4
24,14,215,7,17,-10
24,14,216,9,14,-5
24,14,217,17,15,2
24,14,218,15,27,-12
24,14,219,14,29,-15
24,14,220,6,12,-6
24,14,221,10,25,-15
24,14,222,12,17,-5
24,14,223,17,22,-5
24,14,224,22,20,2
24,14,225,17,32,-15
24,14,226,9,17,-8
24,14,227,17,24,-7
24,14,228,13,8,5
24,14,229,17,21,-4
24,14,230,5,13,-8
24,14,231,17,27,-10
24,14,232,10,21,-11
24,14,233,9,16,-7
24,14,234,11,13,-2
24,14,235,12,9,3
24,14,236,11,12,-1
24,14,237,11,14,-3
24,14,238,15,21,-6
24,14,239,6,15,-9
24,14,240,7,10,-3
24,14,241,4,19,-15
24,14,242,8,19,-11
24,14,243,9,13,-4
24,14,244,16,23,-7
24,14,245,11,8,3
24,14,246,7,38,-31
24,14,247,3,11,-8
24,14,248,5,12,-7
24,14,249,19,19,0
24,14,250,24,21,3
24,14,251,12,22,-10
24,14,252,8,15,-7
24,14,253,6,12,-6
24,14,254,19,25,-6
24,14,255,16,11,5
24,14,256,14,16,-2
24,14,257,14,21,-7
24,14,258,12,21,-9
24,14,259,8,10,-2
24,14,260,16,26,-10
24,14,261,18,14,4
24,14,262,15,12,3
24,14,263,3,16,-13
24,14,264,6,22,-16
24,14,265,3,8,-5
24,14,266,12,20,-8
24,14,267,18,34,-16
24,14,268,4,10,-6
24,14,269,12,21,-9
24,14,270,14,16,-2
24,14,271,11,18,-7
24,14,272,7,14,-7
24,14,273,4,7,-3
24,14,274,6,15,-9
24,14,275,13,11,2
24,14,276,19,12,7
24,14,277,13,10,3
24,14,278,18,23,-5
24,14,279,8,19,-11
24,14,280,10,27,-17
24,14,281,14,15,-1
24,14,282,12,18,-6
24,14,283,15,18,-3
24,14,284,5,11,-6
24,14,285,20,13,7
24,14,286,13,12,1
24,14,287,19,22,-3
24,14,288,16,27,-11
24,14,289,10,19,-9
24,14,290,11,18,-7
24,14,291,10,25,-15
24,14,292,20,12,8
24,14,293,13,10,3
24,14,294,10,10,0
24,14,295,4,4,0
24,14,296,7,12,-5
24,14,297,12,11,1
24,14,298,16,15,1
24,14,299,7,6,1
24,15,0,16,13,3
24,15,1,8,19,-11
24,15,2,14,12,2
24,15,3,22,15,7
24,15,4,16,13,3
24,15,5,10,25,-15
24,15,6,11,24,-13
24,15,7,8,14,-6
24,15,8,8,10,-2
24,15,9,20,11,9
24,15,10,7,11,-4
24,15,11,13,9,4
24,15,12,14,15,-1
24,15,13,10,29,-19
24,15,14,12,10,2
24,15,15,16,28,-12
24,15,16,25,13,12
24,15,17,8,12,-4
24,15,18,7,13,-6
24,15,19,6,17,-11
24,15,20,11,37,-26
24,15,21,12,8,4
24,15,22,8,13,-5
24,15,23,30,16,14
24,15,24,13,9,4
24,15,25,15,7,8
24,15,26,5,23,-18
24,15,27,18,8,10
24,15,28,21,26,-5
24,15,29,8,25,-17
24,15,30,10,19,-9
24,15,31,12,20,-8
24,15,32,13,16,-3
24,15,33,8,8,0
24,15,34,12,22,-10
24,15,35,15,25,-10
24,15,36,14,13,1
24,15,37,11,15,-4
24,15,38,11,20,-9
24,15,39,9,11,-2
24,15,40,15,14,1
24,15,41,21,22,-1
24,15,42,10,8,2
24,15,43,18,25,-7
24,15,44,12,17,-5
24,15,45,27,28,-1
24,15,46,14,13,1
24,15,47,16,23,-7
24,15,48,9,23,-14
24,15,49,12,26,-14
24,15,50,7,7,0
24,15,51,14,20,-6
24,15,52,9,8,1
24,15,53,10,4,6
24,15,54,12,25,-13
24,15,55,9,25,-16
24,15,56,8,18,-10
24,15,57,16,23,-7
24,15,58,8,11,-3
24,15,59,15,30,-15
24,15,60,8,24,-16
24,15,61,10,14,-4
24,15,62,5,15,-10
24,15,63,11,16,-5
24,15,64,14,17,-3
24,15,65,14,18,-4
24,15,66,13,21,-8
24,15,67,11,19,-8
24,15,68,9,8,1
24,15,69,10,17,-7
24,15,70,27,27,0
24,15,71,13,17,-4
24,15,72,10,21,-11
24,15,73,15,17,-2
24,15,74,13,11,2
24,15,75,6,14,-8
24,15,76,13,23,-10
24,15,77,11,11,0
24,15,78,10,11,-1
24,15,79,22,25,-3
24,15,80,11,8,3
24,15,81,14,26,-12
24,15,82,14,23,-9
24,15,83,10,16,-6
24,15,84,15,16,-1
24,15,85,12,9,3
24,15,86,13,20,-7
24,15,87,13,18,-5
24,15,88,11,19,-8
24,15,89,14,21,-7
24,15,90,16,16,0
24,15,91,22,27,-5
24,15,92,12,25,-13
24,15,93,9,15,-6
24,15,94,18,18,0
24,15,95,20,30,-10
24,15,96,20,27,-7
24,15,97,22,12,10
24,15,98,2,3,-1
24,15,99,10,5,5
24,15,100,12,15,-3
24,15,101,21,12,9
24,15,102,21,18,3
24,15,103,15,17,-2
24,15,104,8,10,-2
24,15,105,13,11,2
24,15,106,7,14,-7
24,15,107,7,18,-11
24,15,108,6,20,-14
24,15,109,26,29,-3
24,15,110,12,17,-5
24,15,111,21,24,-3
24,15,112,18,31,-13
24,15,113,9,20,-11
24,15,114,24,19,5
24,15,115,15,25,-10
24,15,116,17,19,-2
24,15,117,13,18,-5
24,15,118,9,12,-3
24,15,119,10,17,-7
24,15,120,15,10,5
24,15,121,13,18,-5
24,15,122,12,27,-15
24,15,123,13,18,-5
24,15,124,12,16,-4
24,15,125,17,16,1
24,15,126,21,21,0
24,15,127,11,9,2
24,15,128,10,25,-15
24,15,129,5,16,-11
24,15,130,7,14,-7
24,15,131,8,9,-1
24,15,132,16,16,0
24,15,133,7,17,-10
24,15,134,10,18,-8
24,15,135,16,20,-4
24,15,136,23,18,5
24,15,137,5,7,-2
24,15,138,14,34,-20
24,15,139,21,27,-6
24,15,140,7,12,-5
24,15,141,13,14,-1
24,15,142,16,11,5
24,15,143,13,22,-9
24,15,144,17,19,-2
24,15,145,14,9,5
24,15,146,14,20,-6
24,15,147,4,11,-7
24,15,148,15,22,-7
24,15,149,21,21,0
24,15,150,5,18,-13
24,15,151,11,20,-9
24,15,152,8,14,-6
24,15,153,10,16,-6
24,15,154,11,28,-17
24,15,155,12,22,-10
24,15,156,10,20,-10
24,15,157,10,9,1
24,15,158,7,10,-3
24,15,159,4,14,-10
24,15,160,9,13,-4
24,15,161,4,7,-3
24,15,162,19,18,1
24,15,163,13,17,-4
24,15,164,16,23,-7
24,15,165,19,21,-2
24,15,166,12,15,-3
24,15,167,23,24,-1
24,15,168,2,9,-7
24,15,169,13,12,1
24,15,170,19,15,4
24,15,171,19,23,-4
24,15,172,11,13,-2
24,15,173,16,18,-2
24,15,174,9,20,-11
24,15,175,23,25,-2
24,15,176,17,12,5
24,15,177,15,24,-9
24,15,178,5,18,-13
24,15,179,14,17,-3
24,15,180,2,12,-10
24,15,181,14,16,-2
24,15,182,7,16,-9
24,15,183,11,11,0
24,15,184,7,10,-3
24,15,185,6,21,-15
24,15,186,9,11,-2
24,15,187,20,20,0
24,15,188,17,22,-5
24,15,189,9,14,-5
24,15,190,16,16,0
24,15,191,23,28,-5
24,15,192,15,13,2
24,15,193,20,22,-2
24,15,194,12,30,-18
24,15,195,23,17,6
24,15,196,19,27,-8
24,15,197,15,27,-12
24,15,198,7,17,-10
24,15,199,12,20,-8
24,15,200,5,18,-13
24,15,201,13,12,1
24,15,202,10,22,-12
24,15,203,11,10,1
24,15,204,17,24,-7
24,15,205,18,19,-1
24,15,206,12,19,-7
24,15,207,7,19,-12
24,15,208,6,16,-10
24,15,209,18,15,3
24,15,210,6,17,-11
24,15,211,12,16,-4
24,15,212,4,6,-2
24,15,213,12,7,5
24,15,214,20,15,5
24,15,215,8,15,-7
24,15,216,10,19,-9
24,15,217,5,7,-2
24,15,218,25,31,-6
24,15,219,6,9,-3
24,15,220,15,15,0
24,15,221,19,12,7
24,15,222,13,22,-9
24,15,223,16,19,-3
24,15,224,11,18,-7
24,15,225,5,15,-10
24,15,226,7,13,-6
24,15,227,13,10,3
24,15,228,19,17,2
24,15,229,12,30,-18
24,15,230,20,25,-5
24,15,231,13,23,-10
24,15,232,12,9,3
24,15,233,15,25,-10
24,15,234,13,13,0
24,15,235,12,19,-7
24,15,236,22,13,9
24,15,237,9,14,-5
24,15,238,11,13,-2
24,15,239,15,14,1
24,15,240,23,19,4
24,15,241,8,13,-5
24,15,242,9,14,-5
24,15,243,31,17,14
24,15,244,15,22,-7
24,15,245,6,11,-5
24,15,246,11,18,-7
24,15,247,16,16,0
24,15,248,4,23,-19
24,15,249,17,12,5
24,15,250,20,14,6
24,15,251,8,22,-14
24,15,252,12,18,-6
24,15,253,9,20,-11
24,15,254,12,24,-12
24,15,255,11,16,-5
24,15,256,15,6,9
24,15,257,12,21,-9
24,15,258,8,10,-2
24,15,259,8,13,-5
24,15,260,16,19,-3
24,15,261,16,21,-5
24,15,262,12,15,-3
24,15,263,15,19,-4
24,15,264,10,10,0
24,15,265,9,17,-8
24,15,266,6,17,-11
24,15,267,13,8,5
24,15,268,18,26,-8
24,15,269,17,16,1
24,15,270,23,17,6
24,15,271,10,18,-8
24,15,272,15,15,0
24,15,273,14,15,-1
24,15,274,10,18,-8
24,15,275,20,26,-6
24,15,276,14,12,2
24,15,277,12,21,-9
24,15,278,9,26,-17
24,15,279,22,23,-1
24,15,280,20,20,0
24,15,281,8,21,-13
24,15,282,14,22,-8
24,15,283,13,24,-11
24,15,284,8,7,1
24,15,285,10,17,-7
24,15,286,14,14,0
24,15,287,19,19,0
24,15,288,19,17,2
24,15,289,13,17,-4
24,15,290,8,15,-7
24,15,291,6,16,-10
24,15,292,6,24,-18
24,15,293,10,10,0
24,15,294,14,18,-4
24,15,295,13,25,-12
24,15,296,12,18,-6
24,15,297,5,11,-6
24,15,298,8,15,-7
24,15,299,19,12,7
24,16,0,7,14,-7
24,16,1,11,20,-9
24,16,2,6,27,-21
24,16,3,12,16,-4
24,16,4,27,16,11
24,16,5,12,20,-8
24,16,6,15,19,-4
24,16,7,16,14,2
24,16,8,14,27,-13
24,16,9,6,17,-11
24,16,10,14,30,-16
24,16,11,12,24,-12
24,16,12,10,27,-17
24,16,13,26,18,8
24,16,14,18,26,-8
24,16,15,7,15,-8
24,16,16,9,8,1
24,16,17,12,24,-12
24,16,18,6,17,-11
24,16,19,14,23,-9
24,16,20,8,22,-14
24,16,21,4,7,-3
24,16,22,8,16,-8
24,16,23,11,29,-18
24,16,24,9,14,-5
24,16,25,3,19,-16
24,16,26,10,24,-14
24,16,27,19,25,-6
24,16,28,15,21,-6
24,16,29,21,16,5
24,16,30,12,11,1
24,16,31,15,24,-9
24,16,32,11,19,-8
24,16,33,6,5,1
24,16,34,15,15,0
24,16,35,11,15,-4
24,16,36,11,17,-6
24,16,37,15,15,0
24,16,38,8,18,-10
24,16,39,12,15,-3
24,16,40,7,3,4
24,16,41,8,29,-21
24,16,42,11,16,-5
24,16,43,11,21,-10
24,16,44,16,33,-17
24,16,45,14,12,2
24,16,46,0,17,-17
24,16,47,17,8,9
24,16,48,10,12,-2
24,16,49,12,11,1
24,16,50,6,19,-13
24,16,51,19,28,-9
24,16,52,12,17,-5
24,16,53,13,25,-12
24,16,54,11,12,-1
24,16,55,9,16,-7
24,16,56,13,29,-16
24,16,57,8,18,-10
24,16,58,20,9,11
24,16,59,17,25,-8
24,16,60,15,21,-6
24,16,61,16,14,2
24,16,62,9,27,-18
24,16,63,5,18,-13
24,16,64,12,18,-6
24,16,65,7,22,-15
24,16,66,15,16,-1
24,16,67,14,9,5
24,16,68,14,18,-4
24,16,69,13,17,-4
24,16,70,14,20,-6
24,16,71,9,23,-14
24,16,72,14,8,6
24,16,73,10,19,-9
24,16,74,9,7,2
24,16,75,15,18,-3
24,16,76,16,13,3
24,16,77,15,8,7
24,16,78,8,25,-17
24,16,79,5,12,-7
24,16,80,6,13,-7
24,16,81,13,15,-2
24,16,82,17,21,-4
24,16,83,15,26,-11
24,16,84,10,25,-15
24,16,85,17,25,-8
24,16,86,15,14,1
24,16,87,6,19,-13
24,16,88,7,23,-16
24,16,89,13,12,1
24,16,90,9,7,2
24,16,91,20,35,-15
24,16,92,16,15,1
24,16,93,7,21,-14
24,16,94,5,25,-20
24,16,95,8,10,-2
24,16,96,7,16,-9
24,16,97,3,15,-12
24,16,98,29,15,14
24,16,99,6,11,-5
24,16,100,7,16,-9
24,16,101,10,18,-8
24,16,102,13,5,8
24,16,103,12,30,-18
24,16,104,12,11,1
24,16,105,21,13,8
24,16,106,18,16,2
24,16,107,13,10,3
24,16,108,23,25,-2
24,16,109,5,11,-6
24,16,110,4,9,-5
24,16,111,16,20,-4
24,16,112,11,13,-2
24,16,113,14,15,-1
24,16,114,13,13,0
24,16,115,15,13,2
24,16,116,6,17,-11
24,16,117,8,19,-11
24,16,118,12,10,2
24,16,119,16,12,4
24,16,120,11,18,-7
24,16,121,3,22,-19
24,16,122,21,26,-5
24,16,123,5,13,-8
24,16,124,6,14,-8
24,16,125,15,17,-2
24,16,126,8,14,-6
24,16,127,9,14,-5
24,16,128,15,23,-8
24,16,129,13,11,2
24,16,130,4,9,-5
24,16,131,8,19,-11
24,16,132,11,20,-9
24,16,133,5,12,-7
24,16,134,16,26,-10
24,16,135,9,10,-1
24,16,136,5,16,-11
24,16,137,17,12,5
24,16,138,4,8,-4
24,16,139,10,23,-13
24,16,140,18,14,4
24,16,141,22,4,18
24,16,142,20,21,-1
24,16,143,3,14,-11
24,16,144,20,20,0
24,16,145,19,11,8
24,16,146,11,18,-7
24,16,147,14,22,-8
24,16,148,8,18,-10
24,16,149,7,13,-6
24,16,150,9,15,-6
24,16,151,7,16,-9
24,16,152,9,3,6
24,16,153,8,18,-10
24,16,154,10,26,-16
24,16,155,7,13,-6
24,16,156,10,13,-3
24,16,157,21,20,1
24,16,158,6,28,-22
24,16,159,10,22,-12
24,16,160,11,25,-14
24,16,161,19,22,-3
24,16,162,10,29,-19
24,16,163,9,5,4
24,16,164,13,26,-13
24,16,165,14,24,-10
24,16,166,17,19,-2
24,16,167,24,22,2
24,16,168,5,3,2
24,16,169,13,14,-1
24,16,170,6,22,-16
24,16,171,15,6,9
24,16,172,3,8,-5
24,16,173,2,13,-11
24,16,174,19,19,0
24,16,175,7,10,-3
24,16,176,16,19,-3
24,16,177,17,21,-4
24,16,178,6,9,-3
24,16,179,10,21,-11
24,16,180,9,13,-4
24,16,181,18,26,-8
24,16,182,14,17,-3
24,16,183,11,21,-10
24,16,184,16,17,-1
24,16,185,13,7,6
24,16,186,12,10,2
24,16,187,11,26,-15
24,16,188,17,14,3
24,16,189,7,14,-7
24,16,190,11,17,-6
24,16,191,15,15,0
24,16,192,13,22,-9
24,16,193,19,29,-10
24,16,194,8,6,2
24,16,195,5,1,4
24,16,196,20,16,4
24,16,197,6,19,-13
24,16,198,9,14,-5
24,16,199,15,19,-4
24,16,200,7,16,-9
24,16,201,1,9,-8
24,16,202,11,17,-6
24,16,203,16,10,6
24,16,204,16,22,-6
24,16,205,0,12,-12
24,16,206,9,1,8
24,16,207,13,18,-5
24,16,208,6,12,-6
24,16,209,13,10,3
24,16,210,13,17,-4
24,16,211,22,16,6
24,16,212,17,24,-7
24,16,213,23,19,4
24,16,214,8,24,-16
24,16,215,6,10,-4
24,16,216,10,22,-12
24,16,217,16,19,-3
24,16,218,19,26,-7
24,16,219,22,32,-10
24,16,220,10,14,-4
24,16,221,9,18,-9
24,16,222,6,18,-12
24,16,223,9,17,-8
24,16,224,20,20,0
24,16,225,10,24,-14
24,16,226,9,26,-17
24,16,227,13,19,-6
24,16,228,20,16,4
24,16,229,15,20,-5
24,16,230,6,10,-4
24,16,231,7,8,-1
24,16,232,13,12,1
24,16,233,23,19,4
24,16,234,15,11,4
24,16,235,15,46,-31
24,16,236,9,17,-8
24,16,237,22,18,4
24,16,238,12,28,-16
24,16,239,12,14,-2
24,16,240,9,11,-2
24,16,241,6,17,-11
24,16,242,21,22,-1
24,16,243,11,5,6
24,16,244,9,11,-2
24,16,245,4,23,-19
24,16,246,11,11,0
24,16,247,13,11,2
24,16,248,17,25,-8
24,16,249,9,30,-21
24,16,250,21,24,-3
24,16,251,9,13,-4
24,16,252,14,16,-2
24,16,253,10,17,-7
24,16,254,9,17,-8
24,16,255,21,21,0
24,16,256,10,10,0
24,16,257,14,24,-10
24,16,258,17,19,-2
24,16,259,12,12,0
24,16,260,13,24,-11
24,16,261,9,11,-2
24,16,262,11,14,-3
24,16,263,9,15,-6
24,16,264,5,11,-6
24,16,265,16,10,6
24,16,266,13,9,4
24,16,267,11,20,-9
24,16,268,8,6,2
24,16,269,9,8,1
24,16,270,12,15,-3
24,16,271,7,20,-13
24,16,272,8,16,-8
24,16,273,7,13,-6
24,16,274,6,29,-23
24,16,275,17,22,-5
24,16,276,11,14,-3
24,16,277,5,18,-13
24,16,278,12,15,-3
24,16,279,8,16,-8
24,16,280,12,18,-6
24,16,281,22,17,5
24,16,282,9,26,-17
24,16,283,18,19,-1
24,16,284,15,7,8
24,16,285,14,16,-2
24,16,286,15,33,-18
24,16,287,13,37,-24
24,16,288,15,12,3
24,16,289,16,12,4
24,16,290,12,25,-13
24,16,291,6,19,-13
24,16,292,8,8,0
24,16,293,2,10,-8
24,16,294,8,17,-9
24,16,295,7,14,-7
24,16,296,12,14,-2
24,16,297,8,20,-12
24,16,298,23,16,7
24,16,299,20,24,-4
24,17,0,15,25,-10
24,17,1,14,21,-7
24,17,2,5,17,-12
24,17,3,19,18,1
24,17,4,9,16,-7
24,17,5,13,17,-4
24,17,6,13,14,-1
24,17,7,10,27,-17
24,17,8,5,13,-8
24,17,9,12,18,-6
24,17,10,10,11,-1
24,17,11,12,26,-14
24,17,12,14,20,-6
24,17,13,15,14,1
24,17,14,14,15,-1
24,17,15,3,11,-8
24,17,16,15,14,1
24,17,17,14,19,-5
24,17,18,16,4,12
24,17,19,17,11,6
24,17,20,8,22,-14
24,17,21,20,16,4
24,17,22,10,5,5
24,17,23,13,17,-4
24,17,24,12,18,-6
24,17,25,12,22,-10
24,17,26,8,12,-4
24,17,27,16,23,-7
24,17,28,12,23,-11
24,17,29,16,28,-12
24,17,30,7,13,-6
24,17,31,12,28,-16
24,17,32,19,24,-5
24,17,33,15,22,-7
24,17,34,13,12,1
24,17,35,12,17,-5
24,17,36,20,25,-5
24,17,37,11,20,-9
24,17,38,5,7,-2
24,17,39,14,21,-7
24,17,40,7,17,-10
24,17,41,21,15,6
24,17,42,19,19,0
24,17,43,7,11,-4
24,17,44,17,23,-6
24,17,45,18,9,9
24,17,46,12,9,3
24,17,47,3,14,-11
24,17,48,13,16,-3
24,17,49,5,14,-9
24,17,50,9,25,-16
24,17,51,10,21,-11
24,17,52,11,17,-6
24,17,53,9,7,2
24,17,54,8,15,-7
24,17,55,12,28,-16
24,17,56,8,10,-2
24,17,57,6,7,-1
24,17,58,9,22,-13
24,17,59,14,26,-12
24,17,60,8,5,3
24,17,61,10,12,-2
24,17,62,13,21,-8
24,17,63,10,31,-21
24,17,64,4,12,-8
24,17,65,13,10,3
24,17,66,3,8,-5
24,17,67,15,18,-3
24,17,68,3,13,-10
24,17,69,13,19,-6
24,17,70,16,19,-3
24,17,71,11,15,-4
24,17,72,20,14,6
24,17,73,4,15,-11
24,17,74,15,17,-2
24,17,75,9,12,-3
24,17,76,16,22,-6
24,17,77,13,19,-6
24,17,78,15,18,-3
24,17,79,9,21,-12
24,17,80,14,12,2
24,17,81,10,12,-2
24,17,82,14,19,-5
24,17,83,15,25,-10
24,17,84,13,7,6
24,17,85,22,29,-7
24,17,86,8,14,-6
24,17,87,13,24,-11
24,17,88,11,9,2
24,17,89,5,24,-19
24,17,90,11,15,-4
24,17,91,12,17,-5
24,17,92,10,9,1
24,17,93,14,16,-2
24,17,94,8,8,0
24,17,95,4,18,-14
24,17,96,6,8,-2
24,17,97,11,20,-9
24,17,98,14,12,2
24,17,99,19,19,0
24,17,100,19,18,1
24,17,101,15,29,-14
24,17,102,3,6,-3
24,17,103,12,21,-9
24,17,104,7,13,-6
24,17,105,18,22,-4
24,17,106,15,12,3
24,17,107,11,15,-4
24,17,108,18,15,3
24,17,109,10,11,-1
24,17,110,23,21,2
24,17,111,17,22,-5
24,17,112,16,8,8
24,17,113,11,12,-1
24,17,114,7,13,-6
24,17,115,7,11,-4
24,17,116,24,16,8
24,17,117,8,17,-9
24,17,118,8,12,-4
24,17,119,22,23,-1
24,17,120,17,7,10
24,17,121,10,18,-8
24,17,122,17,22,-5
24,17,123,14,22,-8
24,17,124,18,10,8
24,17,125,2,5,-3
24,17,126,12,19,-7
24,17,127,14,30,-16
24,17,128,9,7,2
24,17,129,11,12,-1
24,17,130,8,7,1
24,17,131,7,6,1
24,17,132,20,16,4
24,17,133,9,15,-6
24,17,134,8,14,-6
24,17,135,10,13,-3
24,17,136,7,26,-19
24,17,137,23,22,1
24,17,138,16,12,4
24,17,139,10,7,3
24,17,140,17,11,6
24,17,141,14,16,-2
24,17,142,14,14,0
24,17,143,7,17,-10
24,17,144,16,15,1
24,17,145,20,20,0
24,17,146,14,18,-4
24,17,147,2,18,-16
24,17,148,6,15,-9
24,17,149,10,13,-3
24,17,150,10,16,-6
24,17,151,16,5,11
24,17,152,12,11,1
24,17,153,14,24,-10
24,17,154,17,7,10
24,17,155,6,12,-6
24,17,156,14,16,-2
24,17,157,10,23,-13
24,17,158,4,18,-14
24,17,159,3,12,-9
24,17,160,9,19,-10
24,17,161,8,19,-11
24,17,162,13,14,-1
24,17,163,8,9,-1
24,17,164,4,9,-5
24,17,165,12,21,-9
24,17,166,13,15,-2
24,17,167,15,28,-13
24,17,168,7,16,-9
24,17,169,27,20,7
24,17,170,8,17,-9
24,17,171,21,10,11
24,17,172,8,7,1
24,17,173,10,16,-6
24,17,174,10,12,-2
24,17,175,17,18,-1
24,17,176,7,19,-12
24,17,177,26,21,5
24,17,178,9,8,1
24,17,179,20,29,-9
24,17,180,8,20,-12
24,17,181,8,12,-4
24,17,182,14,17,-3
24,17,183,21,17,4
24,17,184,9,21,-12
24,17,185,7,14,-7
24,17,186,16,33,-17
24,17,187,34,26,8
24,17,188,15,26,-11
24,17,189,14,18,-4
24,17,190,10,27,-17
24,17,191,16,18,-2
24,17,192,10,12,-2
24,17,193,10,13,-3
24,17,194,23,12,11
24,17,195,18,23,-5
24,17,196,12,12,0
24,17,197,12,8,4
24,17,198,6,15,-9
24,17,199,13,16,-3
24,17,200,9,13,-4
24,17,201,7,18,-11
24,17,202,12,24,-12
24,17,203,14,11,3
24,17,204,18,21,-3
24,17,205,28,22,6
24,17,206,16,20,-4
24,17,207,8,29,-21
24,17,208,19,19,0
24,17,209,18,20,-2
24,17,210,12,11,1
24,17,211,12,11,1
24,17,212,11,16,-5
24,17,213,12,9,3
24,17,214,18,20,-2
24,17,215,6,9,-3
24,17,216,11,12,-1
24,17,217,9,19,-10
24,17,218,5,11,-6
24,17,219,11,13,-2
24,17,220,6,13,-7
24,17,221,11,5,6
24,17,222,9,16,-7
24,17,223,15,17,-2
24,17,224,10,18,-8
24,17,225,8,17,-9
24,17,226,13,22,-9
24,17,227,7,8,-1
24,17,228,11,12,-1
24,17,229,5,10,-5
24,17,230,15,25,-10
24,17,231,11,16,-5
24,17,232,16,13,3
24,17,233,7,12,-5
24,17,234,9,12,-3
24,17,235,14,32,-18
24,17,236,23,30,-7
24,17,237,15,11,4
24,17,238,7,8,-1
24,17,239,12,18,-6
24,17,240,2,11,-9
24,17,241,12,28,-16
24,17,242,18,21,-3
24,17,243,13,25,-12
24,17,244,10,7,3
24,17,245,9,6,3
24,17,246,9,6,3
24,17,247,4,9,-5
24,17,248,13,12,1
24,17,249,6,28,-22
24,17,250,11,8,3
24,17,251,15,25,-10
24,17,252,16,14,2
24,17,253,14,28,-14
24,17,254,5,12,-7
24,17,255,15,25,-10
24,17,256,10,9,1
24,17,257,9,12,-3
24,17,258,7,13,-6
24,17,259,8,17,-9
24,17,260,21,31,-10
24,17,261,8,9,-1
24,17,262,9,14,-5
24,17,263,20,16,4
24,17,264,15,7,8
24,17,265,6,5,1
24,17,266,5,15,-10
24,17,267,20,11,9
24,17,268,11,14,-3
24,17,269,9,11,-2
24,17,270,8,9,-1
24,17,271,14,15,-1
24,17,272,12,16,-4
24,17,273,13,29,-16
24,17,274,13,10,3
24,17,275,21,14,7
24,17,276,6,17,-11
24,17,277,16,18,-2
24,17,278,6,11,-5
24,17,279,25,27,-2
24,17,280,21,8,13
24,17,281,10,8,2
24,17,282,11,25,-14
24,17,283,22,21,1
24,17,284,11,12,-1
24,17,285,22,15,7
24,17,286,9,16,-7
24,17,287,21,20,1
24,17,288,12,16,-4
24,17,289,15,20,-5
24,17,290,19,19,0
24,17,291,10,27,-17
24,17,292,24,17,7
24,17,293,16,17,-1
24,17,294,4,24,-20
24,17,295,6,8,-2
24,17,296,13,23,-10
24,17,297,20,16,4
24,17,298,12,14,-2
24,17,299,7,9,-2
24,18,0,18,8,10
24,18,1,14,31,-17
24,18,2,6,21,-15
24,18,3,14,11,3
24,18,4,11,18,-7
24,18,5,24,12,12
24,18,6,5,12,-7
24,18,7,12,11,1
24,18,8,11,8,3
24,18,9,15,21,-6
24,18,10,12,22,-10
24,18,11,10,11,-1
24,18,12,8,6,2
24,18,13,10,28,-18
24,18,14,9,17,-8
24,18,15,7,15,-8
24,18,16,11,13,-2
24,18,17,9,5,4
24,18,18,18,18,0
24,18,19,16,17,-1
24,18,20,8,18,-10
24,18,21,7,14,-7
24,18,22,10,3,7
24,18,23,10,17,-7
24,18,24,18,20,-2
24,18,25,12,13,-1
24,18,26,14,5,9
24,18,27,7,9,-2
24,18,28,21,7,14
24,18,29,14,22,-8
24,18,30,16,26,-10
24,18,31,11,24,-13
24,18,32,13,19,-6
24,18,33,20,19,1
24,18,34,17,14,3
24,18,35,32,17,15
24,18,36,15,18,-3
24,18,37,16,27,-11
24,18,38,8,8,0
24,18,39,13,22,-9
24,18,40,15,21,-6
24,18,41,23,13,10
24,18,42,8,7,1
24,18,43,11,30,-19
24,18,44,14,20,-6
24,18,45,12,20,-8
24,18,46,19,14,5
24,18,47,18,27,-9
24,18,48,11,21,-10
24,18,49,19,28,-9
24,18,50,20,24,-4
24,18,51,31,18,13
24,18,52,19,29,-10
24,18,53,16,18,-2
24,18,54,25,12,13
24,18,55,10,9,1
24,18,56,17,13,4
24,18,57,9,6,3
24,18,58,5,6,-1
24,18,59,13,13,0
24,18,60,22,23,-1
24,18,61,25,19,6
24,18,62,22,24,-2
24,18,63,8,13,-5
24,18,64,15,20,-5
24,18,65,12,9,3
24,18,66,2,25,-23
24,18,67,4,12,-8
24,18,68,7,23,-16
24,18,69,7,23,-16
24,18,70,20,11,9
24,18,71,19,30,-11
24,18,72,8,10,-2
24,18,73,18,16,2
24,18,74,19,20,-1
24,18,75,15,13,2
24,18,76,14,11,3
24,18,77,14,17,-3
24,18,78,15,22,-7
24,18,79,5,9,-4
24,18,80,12,8,4
24,18,81,6,11,-5
24,18,82,11,21,-10
24,18,83,14,15,-1
24,18,84,13,10,3
24,18,85,12,18,-6
24,18,86,17,15,2
24,18,87,20,26,-6
24,18,88,17,23,-6
24,18,89,12,25,-13
24,18,90,11,5,6
24,18,91,8,15,-7
24,18,92,2,18,-16
24,18,93,10,28,-18
24,18,94,9,15,-6
24,18,95,15,9,6
24,18,96,16,10,6
24,18,97,18,11,7
24,18,98,14,26,-12
24,18,99,14,14,0
24,18,100,15,21,-6
24,18,101,10,15,-5
24,18,102,8,9,-1
24,18,103,7,18,-11
24,18,104,10,13,-3
24,18,105,7,7,0
24,18,106,11,19,-8
24,18,107,11,13,-2
24,18,108,12,19,-7
24,18,109,6,9,-3
24,18,110,13,10,3
24,18,111,14,15,-1
24,18,112,6,12,-6
24,18,113,15,15,0
24,18,114,10,14,-4
24,18,115,18,14,4
24,18,116,15,15,0
24,18,117,18,6,12
24,18,118,10,24,-14
24,18,119,19,28,-9
24,18,120,8,12,-4
24,18,121,22,21,1
24,18,122,16,28,-12
24,18,123,21,18,3
24,18,124,20,9,11
24,18,125,3,18,-15
24,18,126,9,14,-5
24,18,127,5,22,-17
24,18,128,11,19,-8
24,18,129,10,7,3
24,18,130,10,27,-17
24,18,131,12,16,-4
24,18,132,16,17,-1
24,18,133,30,20,10
24,18,134,22,17,5
24,18,135,12,16,-4
24,18,136,12,26,-14
24,18,137,12,15,-3
24,18,138,7,17,-10
24,18,139,18,18,0
24,18,140,17,23,-6
24,18,141,13,15,-2
24,18,142,12,19,-7
24,18,143,19,10,9
24,18,144,9,9,0
24,18,145,8,13,-5
24,18,146,18,15,3
24,18,147,13,22,-9
24,18,148,4,18,-14
24,18,149,14,16,-2
24,18,150,15,10,5
24,18,151,8,14,-6
24,18,152,9,13,-4
24,18,153,10,14,-4
24,18,154,8,8,0
24,18,155,14,15,-1
24,18,156,15,18,-3
24,18,157,15,15,0
24,18,158,11,10,1
24,18,159,17,7,10
24,18,160,9,16,-7
24,18,161,9,18,-9
24,18,162,9,9,0
24,18,163,9,19,-10
24,18,164,13,19,-6
24,18,165,9,20,-11
24,18,166,6,16,-10
24,18,167,14,19,-5
24,18,168,24,21,3
24,18,169,18,6,12
24,18,170,13,10,3
24,18,171,8,12,-4
24,18,172,6,14,-8
24,18,173,10,13,-3
24,18,174,13,8,5
24,18,175,11,19,-8
24,18,176,3,11,-8
24,18,177,7,24,-17
24,18,178,6,9,-3
24,18,179,6,6,0
24,18,180,13,17,-4
24,18,181,19,18,1
24,18,182,25,33,-8
24,18,183,22,17,5
24,18,184,17,13,4
24,18,185,3,14,-11
24,18,186,12,25,-13
24,18,187,14,15,-1
24,18,188,13,10,3
24,18,189,10,17,-7
24,18,190,8,11,-3
24,18,191,17,20,-3
24,18,192,6,8,-2
24,18,193,4,19,-15
24,18,194,6,10,-4
24,18,195,13,16,-3
24,18,196,12,19,-7
24,18,197,7,26,-19
24,18,198,17,21,-4
24,18,199,4,4,0
24,18,200,12,23,-11
24,18,201,15,11,4
24,18,202,16,15,1
24,18,203,6,15,-9
24,18,204,14,16,-2
24,18,205,13,26,-13
24,18,206,20,12,8
24,18,207,6,15,-9
24,18,208,10,17,-7
24,18,209,26,24,2
24,18,210,24,21,3
24,18,211,12,17,-5
24,18,212,7,15,-8
24,18,213,15,28,-13
24,18,214,7,10,-3
24,18,215,9,14,-5
24,18,216,16,22,-6
24,18,217,8,10,-2
24,18,218,15,10,5
24,18,219,25,11,14
24,18,220,16,27,-11
24,18,221,10,15,-5
24,18,222,21,21,0
24,18,223,10,10,0
24,18,224,7,26,-19
24,18,225,12,16,-4
24,18,226,16,21,-5
24,18,227,9,14,-5
24,18,228,12,23,-11
24,18,229,17,14,3
24,18,230,13,26,-13
24,18,231,16,15,1
24,18,232,6,14,-8
24,18,233,21,18,3
24,18,234,18,18,0
24,18,235,12,21,-9
24,18,236,13,28,-15
24,18,237,8,15,-7
24,18,238,13,13,0
24,18,239,18,35,-17
24,18,240,6,17,-11
24,18,241,17,25,-8
24,18,242,18,24,-6
24,18,243,11,18,-7
24,18,244,11,13,-2
24,18,245,6,8,-2
24,18,246,8,11,-3
24,18,247,17,14,3
24,18,248,12,9,3
24,18,249,20,17,3
24,18,250,10,12,-2
24,18,251,7,14,-7
24,18,252,12,8,4
24,18,253,19,14,5
24,18,254,12,11,1
24,18,255,17,6,11
24,18,256,7,19,-12
24,18,257,5,11,-6
24,18,258,17,17,0
24,18,259,10,13,-3
24,18,260,13,7,6
24,18,261,5,17,-12
24,18,262,13,23,-10
24,18,263,12,23,-11
24,18,264,15,10,5
24,18,265,15,16,-1
24,18,266,16,24,-8
24,18,267,5,6,-1
24,18,268,9,3,6
24,18,269,6,17,-11
24,18,270,11,11,0
24,18,271,9,14,-5
24,18,272,10,2,8
24,18,273,12,11,1
24,18,274,13,20,-7
24,18,275,10,13,-3
24,18,276,9,13,-4
24,18,277,11,19,-8
24,18,278,10,31,-21
24,18,279,3,10,-7
24,18,280,7,1,6
24,18,281,15,18,-3
24,18,282,14,18,-4
24,18,283,21,13,8
24,18,284,11,13,-2
24,18,285,5,18,-13
24,18,286,10,22,-12
24,18,287,11,26,-15
24,18,288,7,10,-3
24,18,289,16,23,-7
24,18,290,12,8,4
24,18,291,13,8,5
24,18,292,16,12,4
24,18,293,12,22,-10
24,18,294,18,10,8
24,18,295,17,5,12
24,18,296,7,24,-17
24,18,297,10,17,-7
24,18,298,16,15,1
24,18,299,16,30,-14
24,19,0,7,5,2
24,19,1,13,13,0
24,19,2,7,26,-19
24,19,3,24,21,3
24,19,4,10,14,-4
24,19,5,13,14,-1
24,19,6,18,18,0
24,19,7,5,8,-3
24,19,8,22,23,-1
24,19,9,8,13,-5
24,19,10,11,9,2
24,19,11,12,20,-8
24,19,12,15,16,-1
24,19,13,26,23,3
24,19,14,4,11,-7
24,19,15,16,27,-11
24,19,16,8,8,0
24,19,17,9,4,5
24,19,18,17,18,-1
24,19,19,14,29,-15
24,19,20,14,24,-10
24,19,21,7,27,-20
24,19,22,8,19,-11
24,19,23,8,29,-21
24,19,24,9,9,0
24,19,25,11,12,-1
24,19,26,11,12,-1
24,19,27,8,22,-14
24,19,28,10,18,-8
24,19,29,9,21,-12
24,19,30,13,17,-4
24,19,31,14,12,2
24,19,32,14,16,-2
24,19,33,10,14,-4
24,19,34,20,19,1
24,19,35,13,15,-2
24,19,36,5,11,-6
24,19,37,22,19,3
24,19,38,15,24,-9
24,19,39,18,15,3
24,19,40,14,15,-1
24,19,41,6,17,-11
24,19,42,4,14,-10
24,19,43,12,10,2
24,19,44,11,23,-12
24,19,45,13,14,-1
24,19,46,17,14,3
24,19,47,14,13,1
24,19,48,15,33,-18
24,19,49,13,27,-14
24,19,50,11,23,-12
24,19,51,12,8,4
24,19,52,20,17,3
24,19,53,5,6,-1
24,19,54,12,9,3
24,19,55,23,14,9
24,19,56,16,18,-2
24,19,57,20,17,3
24,19,58,8,13,-5
24,19,59,13,29,-16
24,19,60,9,19,-10
24,19,61,16,22,-6
24,19,62,9,7,2
24,19,63,11,17,-6
24,19,64,8,8,0
24,19,65,10,12,-2
24,19,66,6,18,-12
24,19,67,10,19,-9
24,19,68,8,12,-4
24,19,69,8,14,-6
24,19,70,18,15,3
24,19,71,13,9,4
24,19,72,15,15,0
24,19,73,13,11,2
24,19,74,8,13,-5
24,19,75,14,16,-2
24,19,76,14,26,-12
24,19,77,11,15,-4
24,19,78,10,20,-10
24,19,79,10,16,-6
24,19,80,20,20,0
24,19,81,11,10,1
24,19,82,13,12,1
24,19,83,11,9,2
24,19,84,7,7,0
24,19,85,6,7,-1
24,19,86,6,8,-2
24,19,87,15,21,-6
24,19,88,10,10,0
24,19,89,12,11,1
24,19,90,18,17,1
24,19,91,14,11,3
24,19,92,21,15,6
24,19,93,13,12,1
24,19,94,8,14,-6
24,19,95,12,22,-10
24,19,96,12,16,-4
24,19,97,7,14,-7
24,19,98,15,8,7
24,19,99,9,20,-11
24,19,100,11,18,-7
24,19,101,20,19,1
24,19,102,12,13,-1
24,19,103,11,12,-1
24,19,104,20,18,2
24,19,105,17,14,3
24,19,106,28,25,3
24,19,107,11,13,-2
24,19,108,15,15,0
24,19,109,4,8,-4
24,19,110,9,13,-4
24,19,111,16,11,5
24,19,112,11,18,-7
24,19,113,18,17,1
24,19,114,25,22,3
24,19,115,20,23,-3
24,19,116,22,25,-3
24,19,117,19,21,-2
24,19,118,13,28,-15
24,19,119,11,17,-6
24,19,120,12,31,-19
24,19,121,4,15,-11
24,19,122,11,17,-6
24,19,123,13,17,-4
24,19,124,16,12,4
24,19,125,20,23,-3
24,19,126,20,10,10
24,19,127,17,18,-1
24,19,128,12,19,-7
24,19,129,12,24,-12
24,19,130,16,22,-6
24,19,131,14,7,7
24,19,132,9,17,-8
24,19,133,4,14,-10
24,19,134,12,19,-7
24,19,135,22,13,9
24,19,136,10,12,-2
24,19,137,12,23,-11
24,19,138,8,9,-1
24,19,139,12,22,-10
24,19,140,13,6,7
24,19,141,27,28,-1
24,19,142,11,13,-2
24,19,143,15,16,-1
24,19,144,17,27,-10
24,19,145,23,25,-2
24,19,146,8,25,-17
24,19,147,6,16,-10
24,19,148,18,12,6
24,19,149,10,16,-6
24,19,150,14,11,3
24,19,151,12,11,1
24,19,152,12,18,-6
24,19,153,6,17,-11
24,19,154,17,26,-9
24,19,155,12,19,-7
24,19,156,3,15,-12
24,19,157,14,4,10
24,19,158,15,12,3
24,19,159,6,11,-5
24,19,160,16,18,-2
24,19,161,8,13,-5
24,19,162,10,16,-6
24,19,163,17,28,-11
24,19,164,5,20,-15
24,19,165,8,7,1
24,19,166,15,6,9
24,19,167,6,17,-11
24,19,168,9,15,-6
24,19,169,20,19,1
24,19,170,9,12,-3
24,19,171,14,19,-5
24,19,172,3,16,-13
24,19,173,15,17,-2
24,19,174,7,22,-15
24,19,175,7,9,-2
24,19,176,23,15,8
24,19,177,22,22,0
24,19,178,23,27,-4
24,19,179,20,28,-8
24,19,180,8,36,-28
24,19,181,3,13,-10
24,19,182,23,23,0
24,19,183,16,14,2
24,19,184,12,15,-3
24,19,185,9,15,-6
24,19,186,8,15,-7
24,19,187,2,11,-9
24,19,188,15,25,-10
24,19,189,22,26,-4
24,19,190,18,15,3
24,19,191,12,20,-8
24,19,192,5,11,-6
24,19,193,19,17,2
24,19,194,11,14,-3
24,19,195,6,13,-7
24,19,196,6,17,-11
24,19,197,11,22,-11
24,19,198,18,18,0
24,19,199,19,15,4
24,19,200,10,12,-2
24,19,201,16,35,-19
24,19,202,21,22,-1
24,19,203,7,10,-3
24,19,204,7,12,-5
24,19,205,12,11,1
24,19,206,11,21,-10
24,19,207,7,14,-7
24,19,208,12,16,-4
24,19,209,12,7,5
24,19,210,12,15,-3
24,19,211,11,10,1
24,19,212,21,18,3
24,19,213,21,18,3
24,19,214,6,13,-7
24,19,215,14,7,7
24,19,216,14,13,1
24,19,217,10,10,0
24,19,218,17,19,-2
24,19,219,14,16,-2
24,19,220,9,13,-4
24,19,221,9,15,-6
24,19,222,8,12,-4
24,19,223,15,14,1
24,19,224,12,20,-8
24,19,225,8,17,-9
24,19,226,4,15,-11
24,19,227,13,11,2
24,19,228,17,7,10
24,19,229,15,10,5
24,19,230,20,12,8
24,19,231,27,7,20
24,19,232,9,18,-9
24,19,233,14,23,-9
24,19,234,3,5,-2
24,19,235,9,26,-17
24,19,236,11,23,-12
24,19,237,9,18,-9
24,19,238,16,8,8
24,19,239,16,9,7
24,19,240,8,11,-3
24,19,241,20,21,-1
24,19,242,12,16,-4
24,19,243,12,8,4
24,19,244,19,18,1
24,19,245,4,14,-10
24,19,246,11,8,3
24,19,247,23,20,3
24,19,248,16,16,0
24,19,249,12,9,3
24,19,250,14,16,-2
24,19,251,9,23,-14
24,19,252,9,12,-3
24,19,253,11,15,-4
24,19,254,7,19,-12
24,19,255,13,19,-6
24,19,256,19,28,-9
24,19,257,8,22,-14
24,19,258,17,24,-7
24,19,259,18,17,1
24,19,260,6,11,-5
24,19,261,20,21,-1
24,19,262,0,15,-15
24,19,263,7,15,-8
24,19,264,5,14,-9
24,19,265,17,18,-1
24,19,266,21,12,9
24,19,267,9,13,-4
24,19,268,17,24,-7
24,19,269,11,11,0
24,19,270,11,17,-6
24,19,271,13,19,-6
24,19,272,7,13,-6
24,19,273,10,13,-3
24,19,274,14,13,1
24,19,275,5,19,-14
24,19,276,11,18,-7
24,19,277,11,24,-13
24,19,278,10,18,-8
24,19,279,7,17,-10
24,19,280,9,13,-4
24,19,281,10,20,-10
24,19,282,14,8,6
24,19,283,19,12,7
24,19,284,23,28,-5
24,19,285,15,23,-8
24,19,286,16,10,6
24,19,287,15,9,6
24,19,288,15,14,1
24,19,289,4,3,1
24,19,290,20,29,-9
24,19,291,23,19,4
24,19,292,25,19,6
24,19,293,19,20,-1
24,19,294,13,20,-7
24,19,295,8,13,-5
24,19,296,13,13,0
24,19,297,9,8,1
24,19,298,8,17,-9
24,19,299,12,19,-7
24,20,0,16,25,-9
24,20,1,16,17,-1
24,20,2,19,16,3
24,20,3,6,11,-5
24,20,4,18,24,-6
24,20,5,12,19,-7
24,20,6,21,10,11
24,20,7,9,17,-8
24,20,8,27,26,1
24,20,9,7,8,-1
24,20,10,10,13,-3
24,20,11,15,20,-5
24,20,12,11,14,-3
24,20,13,2,32,-30
24,20,14,17,23,-6
24,20,15,17,22,-5
24,20,16,11,22,-11
24,20,17,12,10,2
24,20,18,14,7,7
24,20,19,9,15,-6
24,20,20,6,13,-7
24,20,21,12,18,-6
24,20,22,10,18,-8
24,20,23,15,42,-27
24,20,24,13,14,-1
24,20,25,17,16,1
24,20,26,9,16,-7
24,20,27,11,11,0
24,20,28,14,19,-5
24,20,29,14,32,-18
24,20,30,12,18,-6
24,20,31,11,15,-4
24,20,32,15,21,-6
24,20,33,13,13,0
24,20,34,19,14,5
24,20,35,13,10,3
24,20,36,11,19,-8
24,20,37,4,9,-5
24,20,38,10,13,-3
24,20,39,8,22,-14
24,20,40,11,18,-7
24,20,41,8,5,3
24,20,42,5,17,-12
24,20,43,11,11,0
24,20,44,12,6,6
24,20,45,19,24,-5
24,20,46,6,8,-2
24,20,47,21,16,5
24,20,48,7,7,0
24,20,49,7,10,-3
24,20,50,16,15,1
24,20,51,13,18,-5
24,20,52,16,4,12
24,20,53,18,10,8
24,20,54,17,17,0
24,20,55,16,31,-15
24,20,56,21,16,5
24,20,57,7,17,-10
24,20,58,12,6,6
24,20,59,16,18,-2
24,20,60,4,16,-12
24,20,61,13,26,-13
24,20,62,19,25,-6
24,20,63,21,27,-6
24,20,64,14,9,5
24,20,65,11,15,-4
24,20,66,14,7,7
24,20,67,13,21,-8
24,20,68,6,22,-16
24,20,69,13,24,-11
24,20,70,17,16,1
24,20,71,13,21,-8
24,20,72,14,23,-9
24,20,73,20,25,-5
24,20,74,18,22,-4
24,20,75,12,14,-2
24,20,76,2,22,-20
24,20,77,9,22,-13
24,20,78,10,18,-8
24,20,79,16,23,-7
24,20,80,17,17,0
24,20,81,8,16,-8
24,20,82,11,11,0
24,20,83,12,21,-9
24,20,84,14,21,-7
24,20,85,5,16,-11
24,20,86,15,18,-3
24,20,87,8,7,1
24,20,88,5,14,-9
24,20,89,18,15,3
24,20,90,12,7,5
24,20,91,14,16,-2
24,20,92,13,18,-5
24,20,93,19,7,12
24,20,94,10,15,-5
24,20,95,5,18,-13
24,20,96,25,34,-9
24,20,97,14,16,-2
24,20,98,10,16,-6
24,20,99,10,30,-20
24,20,100,10,9,1
24,20,101,13,11,2
24,20,102,15,15,0
24,20,103,14,14,0
24,20,104,9,18,-9
24,20,105,17,12,5
24,20,106,8,22,-14
24,20,107,26,12,14
24,20,108,13,24,-11
24,20,109,22,22,0
24,20,110,17,19,-2
24,20,111,9,20,-11
24,20,112,19,17,2
24,20,113,10,13,-3
24,20,114,8,16,-8
24,20,115,15,14,1
24,20,116,8,16,-8
24,20,117,5,7,-2
24,20,118,9,25,-16
24,20,119,10,14,-4
24,20,120,7,11,-4
24,20,121,17,18,-1
24,20,122,8,16,-8
24,20,123,7,3,4
24,20,124,18,24,-6
24,20,125,12,14,-2
24,20,126,17,19,-2
24,20,127,16,25,-9
24,20,128,17,14,3
24,20,129,3,15,-12
24,20,130,14,11,3
24,20,131,9,7,2
24,20,132,11,24,-13
24,20,133,17,13,4
24,20,134,15,11,4
24,20,135,27,23,4
24,20,136,14,15,-1
24,20,137,12,8,4
24,20,138,12,10,2
24,20,139,14,15,-1
24,20,140,15,28,-13
24,20,141,11,17,-6
24,20,142,10,22,-12
24,20,143,9,26,-17
24,20,144,10,20,-10
24,20,145,14,20,-6
24,20,146,11,19,-8
24,20,147,17,16,1
24,20,148,14,21,-7
24,20,149,12,17,-5
24,20,150,7,7,0
24,20,151,6,25,-19
24,20,152,11,12,-1
24,20,153,17,7,10
24,20,154,20,22,-2
24,20,155,12,7,5
24,20,156,11,16,-5
24,20,157,3,6,-3
24,20,158,15,19,-4
24,20,159,7,33,-26
24,20,160,11,14,-3
24,20,161,8,8,0
24,20,162,8,19,-11
24,20,163,12,21,-9
24,20,164,25,8,17
24,20,165,5,12,-7
24,20,166,14,9,5
24,20,167,21,11,10
24,20,168,14,19,-5
24,20,169,5,6,-1
24,20,170,10,12,-2
24,20,171,8,13,-5
24,20,172,16,24,-8
24,20,173,12,5,7
24,20,174,12,23,-11
24,20,175,8,7,1
24,20,176,13,17,-4
24,20,177,11,16,-5
24,20,178,19,12,7
24,20,179,26,26,0
24,20,180,16,13,3
24,20,181,10,10,0
24,20,182,8,18,-10
24,20,183,9,17,-8
24,20,184,13,12,1
24,20,185,17,12,5
24,20,186,17,17,0
24,20,187,8,11,-3
24,20,188,5,10,-5
24,20,189,10,10,0
24,20,190,6,7,-1
24,20,191,21,12,9
24,20,192,17,14,3
24,20,193,9,15,-6
24,20,194,21,21,0
24,20,195,21,34,-13
24,20,196,16,24,-8
24,20,197,10,11,-1
24,20,198,24,34,-10
24,20,199,6,9,-3
24,20,200,15,8,7
24,20,201,5,4,1
24,20,202,21,12,9
24,20,203,19,16,3
24,20,204,14,20,-6
24,20,205,8,2,6
24,20,206,14,16,-2
24,20,207,14,19,-5
24,20,208,7,13,-6
24,20,209,17,31,-14
24,20,210,17,23,-6
24,20,211,11,17,-6
24,20,212,2,15,-13
24,20,213,13,20,-7
24,20,214,14,5,9
24,20,215,8,11,-3
24,20,216,13,25,-12
24,20,217,13,14,-1
24,20,218,7,8,-1
24,20,219,15,14,1
24,20,220,10,20,-10
24,20,221,13,13,0
24,20,222,9,22,-13
24,20,223,19,12,7
24,20,224,8,19,-11
24,20,225,16,7,9
24,20,226,15,12,3
24,20,227,10,15,-5
24,20,228,19,9,10
24,20,229,13,14,-1
24,20,230,12,16,-4
24,20,231,11,15,-4
24,20,232,10,20,-10
24,20,233,8,12,-4
24,20,234,20,9,11
24,20,235,16,18,-2
24,20,236,11,13,-2
24,20,237,16,17,-1
24,20,238,12,17,-5
24,20,239,9,13,-4
24,20,240,17,25,-8
24,20,241,13,18,-5
24,20,242,17,14,3
24,20,243,13,18,-5
24,20,244,10,16,-6
24,20,245,14,16,-2
24,20,246,16,21,-5
24,20,247,8,12,-4
24,20,248,24,23,1
24,20,249,8,7,1
24,20,250,25,15,10
24,20,251,10,9,1
24,20,252,20,10,10
24,20,253,20,17,3
24,20,254,24,20,4
24,20,255,17,11,6
24,20,256,24,18,6
24,20,257,17,14,3
24,20,258,6,21,-15
24,20,259,18,23,-5
24,20,260,13,21,-8
24,20,261,24,28,-4
24,20,262,21,25,-4
24,20,263,17,26,-9
24,20,264,19,22,-3
24,20,265,10,34,-24
24,20,266,5,13,-8
24,20,267,6,9,-3
24,20,268,7,13,-6
24,20,269,25,15,10
24,20,270,17,11,6
24,20,271,9,21,-12
24,20,272,17,14,3
24,20,273,11,5,6
24,20,274,17,13,4
24,20,275,11,13,-2
24,20,276,17,12,5
24,20,277,14,18,-4
24,20,278,3,11,-8
24,20,279,7,20,-13
24,20,280,14,19,-5
24,20,281,23,28,-5
24,20,282,14,27,-13
24,20,283,17,27,-10
24,20,284,9,21,-12
24,20,285,11,17,-6
24,20,286,13,8,5
24,20,287,10,12,-2
24,20,288,4,18,-14
24,20,289,15,12,3
24,20,290,10,4,6
24,20,291,9,18,-9
24,20,292,14,11,3
24,20,293,4,10,-6
24,20,294,10,14,-4
24,20,295,17,14,3
24,20,296,8,21,-13
24,20,297,19,17,2
24,20,298,11,21,-10
24,20,299,27,31,-4
24,21,0,12,20,-8
24,21,1,8,20,-12
24,21,2,15,11,4
24,21,3,17,24,-7
24,21,4,21,12,9
24,21,5,10,17,-7
24,21,6,13,20,-7
24,21,7,9,10,-1
24,21,8,12,13,-1
24,21,9,8,7,1
24,21,10,20,13,7
24,21,11,8,11,-3
24,21,12,16,16,0
24,21,13,10,6,4
24,21,14,15,7,8
24,21,15,10,16,-6
24,21,16,11,29,-18
24,21,17,16,14,2
24,21,18,7,13,-6
24,21,19,10,17,-7
24,21,20,20,15,5
24,21,21,20,24,-4
24,21,22,12,15,-3
24,21,23,11,9,2
24,21,24,15,13,2
24,21,25,13,19,-6
24,21,26,10,22,-12
24,21,27,5,11,-6
24,21,28,16,25,-9
24,21,29,22,22,0
24,21,30,15,20,-5
24,21,31,13,9,4
24,21,32,15,9,6
24,21,33,12,6,6
24,21,34,7,16,-9
24,21,35,6,25,-19
24,21,36,20,23,-3
24,21,37,18,10,8
24,21,38,8,11,-3
24,21,39,19,22,-3
24,21,40,21,15,6
24,21,41,4,12,-8
24,21,42,16,29,-13
24,21,43,14,18,-4
24,21,44,12,23,-11
24,21,45,11,17,-6
24,21,46,9,18,-9
24,21,47,5,10,-5
24,21,48,15,7,8
24,21,49,14,12,2
24,21,50,9,6,3
24,21,51,10,9,1
24,21,52,12,11,1
24,21,53,12,22,-10
24,21,54,13,10,3
24,21,55,15,14,1
24,21,56,7,14,-7
24,21,57,15,8,7
24,21,58,10,12,-2
24,21,59,7,17,-10
24,21,60,15,22,-7
24,21,61,12,11,1
24,21,62,21,13,8
24,21,63,27,25,2
24,21,64,4,5,-1
24,21,65,8,10,-2
24,21,66,13,31,-18
24,21,67,18,21,-3
24,21,68,10,7,3
24,21,69,9,13,-4
24,21,70,15,10,5
24,21,71,11,17,-6
24,21,72,14,17,-3
24,21,73,10,17,-7
24,21,74,13,16,-3
24,21,75,12,17,-5
24,21,76,21,20,1
24,21,77,24,15,9
24,21,78,14,9,5
24,21,79,4,20,-16
24,21,80,25,19,6
24,21,81,19,27,-8
24,21,82,7,12,-5
24,21,83,8,7,1
24,21,84,15,15,0
24,21,85,13,4,9
24,21,86,9,16,-7
24,21,87,8,15,-7
24,21,88,20,5,15
24,21,89,7,11,-4
24,21,90,16,18,-2
24,21,91,14,13,1
24,21,92,14,18,-4
24,21,93,15,19,-4
24,21,94,13,14,-1
24,21,95,11,16,-5
24,21,96,7,16,-9
24,21,97,8,13,-5
24,21,98,16,8,8
24,21,99,5,17,-12
24,21,100,19,25,-6
24,21,101,16,10,6
24,21,102,9,17,-8
24,21,103,12,8,4
24,21,104,10,12,-2
24,21,105,8,22,-14
24,21,106,8,11,-3
24,21,107,4,8,-4
24,21,108,10,11,-1
24,21,109,3,17,-14
24,21,110,16,21,-5
24,21,111,9,14,-5
24,21,112,10,19,-9
24,21,113,1,10,-9
24,21,114,14,13,1
24,21,115,16,10,6
24,21,116,18,20,-2
24,21,117,20,16,4
24,21,118,14,23,-9
24,21,119,13,13,0
24,21,120,8,18,-10
24,21,121,13,16,-3
24,21,122,12,22,-10
24,21,123,25,25,0
24,21,124,8,9,-1
24,21,125,4,13,-9
24,21,126,14,14,0
24,21,127,23,22,1
24,21,128,13,17,-4
24,21,129,14,15,-1
24,21,130,18,15,3
24,21,131,4,14,-10
24,21,132,11,15,-4
24,21,133,20,5,15
24,21,134,14,18,-4
24,21,135,9,14,-5
24,21,136,17,31,-14
24,21,137,7,8,-1
24,21,138,11,11,0
24,21,139,29,20,9
24,21,140,34,34,0
24,21,141,9,10,-1
24,21,142,12,21,-9
24,21,143,10,11,-1
24,21,144,16,25,-9
24,21,145,11,19,-8
24,21,146,9,14,-5
24,21,147,22,27,-5
24,21,148,12,24,-12
24,21,149,12,24,-12
24,21,150,15,26,-11
24,21,151,16,26,-10
24,21,152,2,9,-7
24,21,153,22,28,-6
24,21,154,9,20,-11
24,21,155,21,20,1
24,21,156,19,10,9
24,21,157,26,22,4
24,21,158,13,20,-7
24,21,159,11,23,-12
24,21,160,20,22,-2
24,21,161,12,14,-2
24,21,162,7,14,-7
24,21,163,5,11,-6
24,21,164,11,13,-2
24,21,165,5,6,-1
24,21,166,11,9,2
24,21,167,25,10,15
24,21,168,4,12,-8
24,21,169,19,26,-7
24,21,170,11,6,5
24,21,171,14,7,7
24,21,172,8,1,7
24,21,173,17,20,-3
24,21,174,10,16,-6
24,21,175,21,23,-2
24,21,176,19,21,-2
24,21,177,4,9,-5
24,21,178,15,20,-5
24,21,179,13,16,-3
24,21,180,18,14,4
24,21,181,22,13,9
24,21,182,21,22,-1
24,21,183,8,14,-6
24,21,184,8,19,-11
24,21,185,14,7,7
24,21,186,10,8,2
24,21,187,9,15,-6
24,21,188,27,16,11
24,21,189,16,19,-3
24,21,190,6,8,-2
24,21,191,11,16,-5
24,21,192,3,3,0
24,21,193,8,12,-4
24,21,194,9,17,-8
24,21,195,15,29,-14
24,21,196,24,12,12
24,21,197,11,18,-7
24,21,198,6,27,-21
24,21,199,3,14,-11
24,21,200,13,14,-1
24,21,201,9,18,-9
24,21,202,3,10,-7
24,21,203,15,19,-4
24,21,204,23,27,-4
24,21,205,12,22,-10
24,21,206,10,18,-8
24,21,207,5,13,-8
24,21,208,11,17,-6
24,21,209,10,15,-5
24,21,210,13,23,-10
24,21,211,16,27,-11
24,21,212,20,18,2
24,21,213,13,10,3
24,21,214,7,11,-4
24,21,215,11,14,-3
24,21,216,9,17,-8
24,21,217,13,13,0
24,21,218,9,13,-4
24,21,219,9,19,-10
24,21,220,6,11,-5
24,21,221,19,18,1
24,21,222,8,20,-12
24,21,223,10,18,-8
24,21,224,17,16,1
24,21,225,9,22,-13
24,21,226,12,13,-1
24,21,227,9,16,-7
24,21,228,15,11,4
24,21,229,13,7,6
24,21,230,9,12,-3
24,21,231,11,2,9
24,21,232,20,26,-6
24,21,233,9,14,-5
24,21,234,20,16,4
24,21,235,13,23,-10
24,21,236,17,21,-4
24,21,237,12,12,0
24,21,238,16,9,7
24,21,239,11,13,-2
24,21,240,8,10,-2
24,21,241,23,21,2
24,21,242,13,12,1
24,21,243,11,3,8
24,21,244,14,13,1
24,21,245,8,12,-4
24,21,246,21,22,-1
24,21,247,17,14,3
24,21,248,7,9,-2
24,21,249,15,14,1
24,21,250,23,6,17
24,21,251,11,22,-11
24,21,252,13,11,2
24,21,253,10,17,-7
24,21,254,22,15,7
24,21,255,13,9,4
24,21,256,15,17,-2
24,21,257,11,14,-3
24,21,258,17,13,4
24,21,259,18,8,10
24,21,260,11,7,4
24,21,261,18,8,10
24,21,262,16,14,2
24,21,263,6,19,-13
24,21,264,18,15,3
24,21,265,10,15,-5
24,21,266,32,14,18
24,21,267,2,17,-15
24,21,268,13,21,-8
24,21,269,9,17,-8
24,21,270,7,14,-7
24,21,271,13,23,-10
24,21,272,17,17,0
24,21,273,4,10,-6
24,21,274,16,22,-6
24,21,275,8,21,-13
24,21,276,11,5,6
24,21,277,10,16,-6
24,21,278,7,14,-7
24,21,279,10,6,4
24,21,280,10,22,-12
24,21,281,6,10,-4
24,21,282,6,23,-17
24,21,283,39,22,17
24,21,284,12,11,1
24,21,285,11,15,-4
24,21,286,14,14,0
24,21,287,10,19,-9
24,21,288,15,20,-5
24,21,289,16,18,-2
24,21,290,31,14,17
24,21,291,10,16,-6
24,21,292,16,23,-7
24,21,293,15,18,-3
24,21,294,6,15,-9
24,21,295,11,9,2
24,21,296,7,9,-2
24,21,297,14,9,5
24,21,298,21,22,-1
24,21,299,19,22,-3
24,22,0,24,19,5
24,22,1,20,17,3
24,22,2,4,7,-3
24,22,3,8,13,-5
24,22,4,24,11,13
24,22,5,8,13,-5
24,22,6,16,13,3
24,22,7,18,29,-11
24,22,8,11,11,0
24,22,9,9,23,-14
24,22,10,15,17,-2
24,22,11,13,17,-4
24,22,12,10,20,-10
24,22,13,14,17,-3
24,22,14,9,16,-7
24,22,15,14,20,-6
24,22,16,15,15,0
24,22,17,10,16,-6
24,22,18,5,14,-9
24,22,19,10,6,4
24,22,20,22,14,8
24,22,21,8,12,-4
24,22,22,22,28,-6
24,22,23,13,12,1
24,22,24,11,14,-3
24,22,25,16,19,-3
24,22,26,11,8,3
24,22,27,7,13,-6
24,22,28,21,19,2
24,22,29,10,20,-10
24,22,30,5,14,-9
24,22,31,17,16,1
24,22,32,16,14,2
24,22,33,16,19,-3
24,22,34,19,16,3
24,22,35,15,12,3
24,22,36,9,18,-9
24,22,37,4,11,-7
24,22,38,7,10,-3
24,22,39,11,18,-7
24,22,40,10,16,-6
24,22,41,17,10,7
24,22,42,7,15,-8
24,22,43,16,24,-8
24,22,44,6,8,-2
24,22,45,11,20,-9
24,22,46,12,9,3
24,22,47,20,10,10
24,22,48,17,16,1
24,22,49,13,15,-2
24,22,50,18,18,0
24,22,51,13,6,7
24,22,52,12,23,-11
24,22,53,12,20,-8
24,22,54,14,22,-8
24,22,55,4,10,-6
24,22,56,10,21,-11
24,22,57,20,18,2
24,22,58,17,43,-26
24,22,59,13,16,-3
24,22,60,10,6,4
24,22,61,7,13,-6
24,22,62,24,17,7
24,22,63,6,13,-7
24,22,64,32,15,17
24,22,65,9,11,-2
24,22,66,11,9,2
24,22,67,19,23,-4
24,22,68,15,12,3
24,22,69,4,15,-11
24,22,70,19,11,8
24,22,71,21,11,10
24,22,72,12,6,6
24,22,73,13,15,-2
24,22,74,17,12,5
24,22,75,31,16,15
24,22,76,12,21,-9
24,22,77,4,2,2
24,22,78,23,20,3
24,22,79,14,7,7
24,22,80,6,6,0
24,22,81,5,10,-5
24,22,82,7,7,0
24,22,83,8,19,-11
24,22,84,4,9,-5
24,22,85,9,13,-4
24,22,86,6,9,-3
24,22,87,14,16,-2
24,22,88,9,18,-9
24,22,89,8,3,5
24,22,90,6,12,-6
24,22,91,9,10,-1
24,22,92,8,13,-5
24,22,93,8,15,-7
24,22,94,10,10,0
24,22,95,21,10,11
24,22,96,13,16,-3
24,22,97,10,12,-2
24,22,98,4,2,2
24,22,99,11,11,0
24,22,100,8,18,-10
24,22,101,12,12,0
24,22,102,13,6,7
24,22,103,9,12,-3
24,22,104,11,20,-9
24,22,105,10,20,-10
24,22,106,20,26,-6
24,22,107,30,38,-8
24,22,108,21,21,0
24,22,109,5,11,-6
24,22,110,8,8,0
24,22,111,10,10,0
24,22,112,18,29,-11
24,22,113,9,12,-3
24,22,114,6,12,-6
24,22,115,10,15,-5
24,22,116,20,13,7
24,22,117,1,10,-9
24,22,118,10,4,6
24,22,119,7,22,-15
24,22,120,26,26,0
24,22,121,16,14,2
24,22,122,11,4,7
24,22,123,14,16,-2
24,22,124,7,16,-9
24,22,125,12,15,-3
24,22,126,8,13,-5
24,22,127,16,22,-6
24,22,128,13,14,-1
24,22,129,14,12,2
24,22,130,5,12,-7
24,22,131,12,13,-1
24,22,132,7,10,-3
24,22,133,10,15,-5
24,22,134,10,15,-5
24,22,135,14,10,4
24,22,136,11,14,-3
24,22,137,14,21,-7
24,22,138,8,4,4
24,22,139,18,23,-5
24,22,140,8,5,3
24,22,141,20,14,6
24,22,142,10,5,5
24,22,143,18,19,-1
24,22,144,17,14,3
24,22,145,13,26,-13
24,22,146,16,12,4
24,22,147,17,10,7
24,22,148,12,14,-2
24,22,149,14,20,-6
24,22,150,16,22,-6
24,22,151,24,18,6
24,22,152,16,30,-14
24,22,153,12,16,-4
24,22,154,15,21,-6
24,22,155,21,22,-1
24,22,156,11,17,-6
24,22,157,11,10,1
24,22,158,15,12,3
24,22,159,10,11,-1
24,22,160,18,15,3
24,22,161,19,18,1
24,22,162,17,10,7
24,22,163,10,10,0
24,22,164,9,17,-8
24,22,165,16,9,7
24,22,166,9,13,-4
24,22,167,20,13,7
24,22,168,15,17,-2
24,22,169,11,20,-9
24,22,170,24,16,8
24,22,171,18,14,4
24,22,172,14,21,-7
24,22,173,10,15,-5
24,22,174,11,15,-4
24,22,175,13,25,-12
24,22,176,18,21,-3
24,22,177,6,12,-6
24,22,178,12,12,0
24,22,179,19,13,6
24,22,180,21,19,2
24,22,181,15,20,-5
24,22,182,21,32,-11
24,22,183,14,13,1
24,22,184,25,18,7
24,22,185,15,18,-3
24,22,186,7,7,0
24,22,187,18,10,8
24,22,188,17,4,13
24,22,189,14,15,-1
24,22,190,4,8,-4
24,22,191,13,21,-8
24,22,192,18,13,5
24,22,193,16,7,9
24,22,194,8,26,-18
24,22,195,9,17,-8
24,22,196,5,20,-15
24,22,197,11,13,-2
24,22,198,17,18,-1
24,22,199,15,14,1
24,22,200,7,7,0
24,22,201,10,11,-1
24,22,202,3,10,-7
24,22,203,22,29,-7
24,22,204,16,16,0
24,22,205,17,25,-8
24,22,206,23,35,-12
24,22,207,14,15,-1
24,22,208,22,18,4
24,22,209,22,10,12
24,22,210,19,10,9
24,22,211,2,11,-9
24,22,212,4,19,-15
24,22,213,16,21,-5
24,22,214,15,34,-19
24,22,215,7,18,-11
24,22,216,16,24,-8
24,22,217,18,35,-17
24,22,218,10,15,-5
24,22,219,9,13,-4
24,22,220,14,19,-5
24,22,221,14,13,1
24,22,222,15,15,0
24,22,223,15,12,3
24,22,224,9,8,1
24,22,225,2,10,-8
24,22,226,12,19,-7
24,22,227,16,18,-2
24,22,228,16,9,7
24,22,229,7,16,-9
24,22,230,10,10,0
24,22,231,6,14,-8
24,22,232,16,20,-4
24,22,233,16,20,-4
24,22,234,7,21,-14
24,22,235,20,15,5
24,22,236,16,11,5
24,22,237,11,5,6
24,22,238,16,15,1
24,22,239,11,14,-3
24,22,240,21,30,-9
24,22,241,12,23,-11
24,22,242,15,19,-4
24,22,243,14,20,-6
24,22,244,7,7,0
24,22,245,13,8,5
24,22,246,20,9,11
24,22,247,16,13,3
24,22,248,24,17,7
24,22,249,16,12,4
24,22,250,8,8,0
24,22,251,13,27,-14
24,22,252,17,12,5
24,22,253,10,7,3
24,22,254,8,8,0
24,22,255,14,15,-1
24,22,256,16,23,-7
24,22,257,10,25,-15
24,22,258,17,23,-6
24,22,259,12,11,1
24,22,260,14,13,1
24,22,261,17,11,6
24,22,262,20,19,1
24,22,263,21,16,5
24,22,264,22,19,3
24,22,265,21,8,13
24,22,266,6,13,-7
24,22,267,5,13,-8
24,22,268,21,16,5
24,22,269,11,19,-8
24,22,270,21,24,-3
24,22,271,7,17,-10
24,22,272,4,11,-7
24,22,273,8,18,-10
24,22,274,15,12,3
24,22,275,10,11,-1
24,22,276,11,4,7
24,22,277,10,15,-5
24,22,278,21,15,6
24,22,279,23,12,11
24,22,280,13,10,3
24,22,281,6,8,-2
24,22,282,13,12,1
24,22,283,10,22,-12
24,22,284,15,14,1
24,22,285,13,25,-12
24,22,286,7,8,-1
24,22,287,12,18,-6
24,22,288,18,12,6
24,22,289,15,24,-9
24,22,290,15,24,-9
24,22,291,5,12,-7
24,22,292,11,27,-16
24,22,293,22,11,11
24,22,294,14,9,5
24,22,295,10,13,-3
24,22,296,14,8,6
24,22,297,16,16,0
24,22,298,8,3,5
24,22,299,14,12,2
24,23,0,18,20,-2
24,23,1,8,14,-6
24,23,2,12,15,-3
24,23,3,15,14,1
24,23,4,10,22,-12
24,23,5,22,15,7
24,23,6,8,21,-13
24,23,7,10,8,2
24,23,8,8,13,-5
24,23,9,13,5,8
24,23,10,19,28,-9
24,23,11,13,18,-5
24,23,12,7,20,-13
24,23,13,6,14,-8
24,23,14,5,18,-13
24,23,15,22,19,3
24,23,16,13,8,5
24,23,17,21,14,7
24,23,18,10,15,-5
24,23,19,15,4,11
24,23,20,20,19,1
24,23,21,10,8,2
24,23,22,17,20,-3
24,23,23,16,21,-5
24,23,24,17,13,4
24,23,25,11,35,-24
24,23,26,16,30,-14
24,23,27,14,15,-1
24,23,28,11,15,-4
24,23,29,10,18,-8
24,23,30,9,13,-4
24,23,31,4,7,-3
24,23,32,21,19,2
24,23,33,10,12,-2
24,23,34,16,10,6
24,23,35,24,18,6
24,23,36,21,15,6
24,23,37,12,27,-15
24,23,38,10,20,-10
24,23,39,25,21,4
24,23,40,8,16,-8
24,23,41,26,17,9
24,23,42,11,16,-5
24,23,43,7,9,-2
24,23,44,7,12,-5
24,23,45,21,12,9
24,23,46,18,14,4
24,23,47,9,17,-8
24,23,48,10,5,5
24,23,49,14,9,5
24,23,50,11,9,2
24,23,51,13,11,2
24,23,52,10,13,-3
24,23,53,17,14,3
24,23,54,12,14,-2
24,23,55,19,19,0
24,23,56,6,11,-5
24,23,57,27,17,10
24,23,58,18,18,0
24,23,59,10,10,0
24,23,60,19,16,3
24,23,61,16,11,5
24,23,62,11,21,-10
24,23,63,17,27,-10
24,23,64,11,24,-13
24,23,65,15,13,2
24,23,66,12,17,-5
24,23,67,12,9,3
24,23,68,13,11,2
24,23,69,13,17,-4
24,23,70,7,16,-9
24,23,71,18,15,3
24,23,72,13,21,-8
24,23,73,13,18,-5
24,23,74,11,11,0
24,23,75,21,14,7
24,23,76,4,8,-4
24,23,77,24,11,13
24,23,78,13,19,-6
24,23,79,15,16,-1
24,23,80,15,19,-4
24,23,81,11,12,-1
24,23,82,12,17,-5
24,23,83,25,16,9
24,23,84,19,17,2
24,23,85,24,21,3
24,23,86,13,13,0
24,23,87,23,11,12
24,23,88,11,21,-10
24,23,89,20,28,-8
24,23,90,14,11,3
24,23,91,7,12,-5
24,23,92,8,13,-5
24,23,93,21,28,-7
24,23,94,21,16,5
24,23,95,18,8,10
24,23,96,9,20,-11
24,23,97,11,13,-2
24,23,98,9,18,-9
24,23,99,16,19,-3
24,23,100,28,14,14
24,23,101,9,16,-7
24,23,102,14,12,2
24,23,103,6,12,-6
24,23,104,6,8,-2
24,23,105,12,6,6
24,23,106,12,13,-1
24,23,107,17,14,3
24,23,108,17,9,8
24,23,109,14,21,-7
24,23,110,18,15,3
24,23,111,11,5,6
24,23,112,10,9,1
24,23,113,13,8,5
24,23,114,16,14,2
24,23,115,6,10,-4
24,23,116,15,11,4
24,23,117,15,17,-2
24,23,118,23,22,1
24,23,119,7,17,-10
24,23,120,15,14,1
24,23,121,22,8,14
24,23,122,7,9,-2
24,23,123,7,20,-13
24,23,124,19,8,11
24,23,125,4,12,-8
24,23,126,14,17,-3
24,23,127,14,23,-9
24,23,128,20,23,-3
24,23,129,9,14,-5
24,23,130,18,14,4
24,23,131,22,21,1
24,23,132,14,24,-10
24,23,133,4,19,-15
24,23,134,13,10,3
24,23,135,18,16,2
24,23,136,8,11,-3
24,23,137,7,8,-1
24,23,138,14,12,2
24,23,139,19,21,-2
24,23,140,15,10,5
24,23,141,12,10,2
24,23,142,8,16,-8
24,23,143,5,10,-5
24,23,144,15,16,-1
24,23,145,9,6,3
24,23,146,15,14,1
24,23,147,6,22,-16
24,23,148,15,15,0
24,23,149,13,11,2
24,23,150,13,17,-4
24,23,151,19,11,8
24,23,152,17,24,-7
24,23,153,14,21,-7
24,23,154,12,7,5
24,23,155,8,16,-8
24,23,156,21,14,7
24,23,157,15,9,6
24,23,158,10,9,1
24,23,159,10,21,-11
24,23,160,9,6,3
24,23,161,18,13,5
24,23,162,12,11,1
24,23,163,6,10,-4
24,23,164,14,20,-6
24,23,165,11,12,-1
24,23,166,8,14,-6
24,23,167,16,22,-6
24,23,168,16,23,-7
24,23,169,4,13,-9
24,23,170,17,24,-7
24,23,171,10,11,-1
24,23,172,13,19,-6
24,23,173,11,20,-9
24,23,174,18,8,10
24,23,175,2,11,-9
24,23,176,9,8,1
24,23,177,12,13,-1
24,23,178,11,9,2
24,23,179,9,21,-12
24,23,180,18,16,2
24,23,181,19,5,14
24,23,182,21,13,8
24,23,183,15,16,-1
24,23,184,10,14,-4
24,23,185,11,10,1
24,23,186,15,18,-3
24,23,187,8,18,-10
24,23,188,15,13,2
24,23,189,12,21,-9
24,23,190,11,21,-10
24,23,191,5,21,-16
24,23,192,10,15,-5
24,23,193,8,10,-2
24,23,194,14,18,-4
24,23,195,7,5,2
24,23,196,12,17,-5
24,23,197,4,19,-15
24,23,198,11,8,3
24,23,199,18,25,-7
24,23,200,15,21,-6
24,23,201,12,12,0
24,23,202,3,13,-10
24,23,203,18,13,5
24,23,204,11,7,4
24,23,205,12,15,-3
24,23,206,17,27,-10
24,23,207,12,18,-6
24,23,208,6,5,1
24,23,209,5,5,0
24,23,210,21,15,6
24,23,211,22,12,10
24,23,212,11,11,0
24,23,213,14,22,-8
24,23,214,11,19,-8
24,23,215,15,14,1
24,23,216,22,23,-1
24,23,217,21,16,5
24,23,218,15,4,11
24,23,219,23,16,7
24,23,220,6,11,-5
24,23,221,13,8,5
24,23,222,14,12,2
24,23,223,14,16,-2
24,23,224,29,16,13
24,23,225,11,21,-10
24,23,226,11,18,-7
24,23,227,12,25,-13
24,23,228,14,6,8
24,23,229,12,11,1
24,23,230,23,15,8
24,23,231,3,6,-3
24,23,232,7,13,-6
24,23,233,5,22,-17
24,23,234,9,11,-2
24,23,235,18,13,5
24,23,236,12,17,-5
24,23,237,19,28,-9
24,23,238,12,19,-7
24,23,239,13,13,0
24,23,240,13,11,2
24,23,241,15,19,-4
24,23,242,12,21,-9
24,23,243,10,8,2
24,23,244,11,13,-2
24,23,245,14,18,-4
24,23,246,8,11,-3
24,23,247,10,18,-8
24,23,248,8,12,-4
24,23,249,5,21,-16
24,23,250,9,16,-7
24,23,251,19,18,1
24,23,252,8,8,0
24,23,253,6,18,-12
24,23,254,13,18,-5
24,23,255,6,13,-7
24,23,256,12,15,-3
24,23,257,15,17,-2
24,23,258,11,14,-3
24,23,259,16,7,9
24,23,260,13,9,4
24,23,261,11,10,1
24,23,262,14,17,-3
24,23,263,6,8,-2
24,23,264,13,15,-2
24,23,265,14,13,1
24,23,266,30,26,4
24,23,267,12,26,-14
24,23,268,7,11,-4
24,23,269,10,18,-8
24,23,270,7,14,-7
24,23,271,15,14,1
24,23,272,6,3,3
24,23,273,11,21,-10
24,23,274,7,8,-1
24,23,275,14,13,1
24,23,276,3,18,-15
24,23,277,12,14,-2
24,23,278,15,12,3
24,23,279,13,16,-3
24,23,280,10,19,-9
24,23,281,12,27,-15
24,23,282,5,14,-9
24,23,283,10,12,-2
24,23,284,11,13,-2
24,23,285,24,14,10
24,23,286,4,5,-1
24,23,287,0,8,-8
24,23,288,14,19,-5
24,23,289,24,20,4
24,23,290,19,23,-4
24,23,291,22,20,2
24,23,292,13,13,0
24,23,293,13,22,-9
24,23,294,11,13,-2
24,23,295,34,23,11
24,23,296,12,16,-4
24,23,297,8,9,-1
24,23,298,7,10,-3
24,23,299,9,16,-7
24,24,0,6,11,-5
24,24,1,15,21,-6
24,24,2,14,18,-4
24,24,3,15,12,3
24,24,4,13,19,-6
24,24,5,10,23,-13
24,24,6,6,11,-5
24,24,7,3,13,-10
24,24,8,13,21,-8
24,24,9,19,10,9
24,24,10,13,17,-4
24,24,11,14,9,5
24,24,12,10,18,-8
24,24,13,20,22,-2
24,24,14,9,17,-8
24,24,15,24,7,17
24,24,16,10,21,-11
24,24,17,3,23,-20
24,24,18,7,17,-10
24,24,19,13,9,4
24,24,20,4,22,-18
24,24,21,15,10,5
24,24,22,14,6,8
24,24,23,10,16,-6
24,24,24,14,12,2
24,24,25,6,22,-16
24,24,26,8,18,-10
24,24,27,9,18,-9
24,24,28,14,10,4
24,24,29,9,23,-14
24,24,30,6,23,-17
24,24,31,3,4,-1
24,24,32,14,22,-8
24,24,33,14,13,1
24,24,34,15,18,-3
24,24,35,10,29,-19
24,24,36,12,14,-2
24,24,37,9,20,-11
24,24,38,11,9,2
24,24,39,5,24,-19
24,24,40,32,30,2
24,24,41,15,24,-9
24,24,42,11,12,-1
24,24,43,13,18,-5
24,24,44,20,13,7
24,24,45,23,24,-1
24,24,46,28,12,16
24,24,47,12,12,0
24,24,48,15,17,-2
24,24,49,15,17,-2
24,24,50,8,10,-2
24,24,51,9,16,-7
24,24,52,18,6,12
24,24,53,16,16,0
24,24,54,5,16,-11
24,24,55,16,12,4
24,24,56,3,15,-12
24,24,57,25,15,10
24,24,58,24,23,1
24,24,59,14,13,1
24,24,60,10,17,-7
24,24,61,13,22,-9
24,24,62,25,14,11
24,24,63,4,7,-3
24,24,64,9,15,-6
24,24,65,13,13,0
24,24,66,14,11,3
24,24,67,5,10,-5
24,24,68,16,8,8
24,24,69,10,12,-2
24,24,70,4,15,-11
24,24,71,11,14,-3
24,24,72,9,9,0
24,24,73,11,21,-10
24,24,74,17,22,-5
24,24,75,15,16,-1
24,24,76,24,17,7
24,24,77,18,9,9
24,24,78,13,14,-1
24,24,79,20,19,1
24,24,80,21,10,11
24,24,81,16,8,8
24,24,82,15,20,-5
24,24,83,17,17,0
24,24,84,9,18,-9
24,24,85,13,15,-2
24,24,86,14,5,9
24,24,87,19,8,11
24,24,88,6,12,-6
24,24,89,18,7,11
24,24,90,19,21,-2
24,24,91,12,16,-4
24,24,92,16,8,8
24,24,93,3,13,-10
24,24,94,8,10,-2
24,24,95,13,13,0
24,24,96,23,26,-3
24,24,97,14,4,10
24,24,98,11,14,-3
24,24,99,18,21,-3
24,24,100,9,14,-5
24,24,101,9,14,-5
24,24,102,10,5,5
24,24,103,17,10,7
24,24,104,19,22,-3
24,24,105,18,15,3
24,24,106,12,19,-7
24,24,107,8,14,-6
24,24,108,19,22,-3
24,24,109,14,12,2
24,24,110,10,19,-9
24,24,111,7,16,-9
24,24,112,16,20,-4
24,24,113,18,20,-2
24,24,114,12,13,-1
24,24,115,4,11,-7
24,24,116,12,11,1
24,24,117,6,8,-2
24,24,118,12,17,-5
24,24,119,3,6,-3
24,24,120,11,10,1
24,24,121,13,10,3
24,24,122,10,18,-8
24,24,123,13,24,-11
24,24,124,16,13,3
24,24,125,17,16,1
24,24,126,13,23,-10
24,24,127,10,10,0
24,24,128,13,7,6
24,24,129,8,16,-8
24,24,130,14,10,4
24,24,131,22,24,-2
24,24,132,9,12,-3
24,24,133,16,13,3
24,24,134,16,14,2
24,24,135,23,13,10
24,24,136,15,12,3
24,24,137,7,6,1
24,24,138,13,19,-6
24,24,139,6,28,-22
24,24,140,9,6,3
24,24,141,15,17,-2
24,24,142,3,10,-7
24,24,143,5,7,-2
24,24,144,19,20,-1
24,24,145,20,11,9
24,24,146,22,10,12
24,24,147,18,13,5
24,24,148,12,7,5
24,24,149,8,14,-6
24,24,150,14,18,-4
24,24,151,16,19,-3
24,24,152,11,17,-6
24,24,153,8,3,5
24,24,154,9,11,-2
24,24,155,7,9,-2
24,24,156,18,11,7
24,24,157,8,8,0
24,24,158,19,4,15
24,24,159,13,18,-5
24,24,160,5,19,-14
24,24,161,17,15,2
24,24,162,14,27,-13
24,24,163,5,9,-4
24,24,164,19,20,-1
24,24,165,15,14,1
24,24,166,4,17,-13
24,24,167,20,15,5
24,24,168,6,9,-3
24,24,169,6,6,0
24,24,170,14,13,1
24,24,171,14,17,-3
24,24,172,10,7,3
24,24,173,3,18,-15
24,24,174,11,15,-4
24,24,175,25,14,11
24,24,176,15,13,2
24,24,177,13,12,1
24,24,178,23,21,2
24,24,179,10,16,-6
24,24,180,10,14,-4
24,24,181,14,21,-7
24,24,182,3,13,-10
24,24,183,14,12,2
24,24,184,7,7,0
24,24,185,20,13,7
24,24,186,18,23,-5
24,24,187,22,11,11
24,24,188,10,13,-3
24,24,189,6,16,-10
24,24,190,14,11,3
24,24,191,20,27,-7
24,24,192,7,14,-7
24,24,193,12,22,-10
24,24,194,9,12,-3
24,24,195,15,13,2
24,24,196,4,10,-6
24,24,197,11,17,-6
24,24,198,16,8,8
24,24,199,7,9,-2
24,24,200,19,10,9
24,24,201,16,26,-10
24,24,202,16,17,-1
24,24,203,14,11,3
24,24,204,13,16,-3
24,24,205,6,14,-8
24,24,206,9,23,-14
24,24,207,34,21,13
24,24,208,26,23,3
24,24,209,7,19,-12
24,24,210,7,20,-13
24,24,211,16,9,7
24,24,212,9,3,6
24,24,213,13,21,-8
24,24,214,11,9,2
24,24,215,7,13,-6
24,24,216,13,9,4
24,24,217,27,25,2
24,24,218,7,21,-14
24,24,219,11,4,7
24,24,220,16,14,2
24,24,221,5,7,-2
24,24,222,15,6,9
24,24,223,8,12,-4
24,24,224,10,18,-8
24,24,225,11,17,-6
24,24,226,10,13,-3
24,24,227,19,13,6
24,24,228,17,14,3
24,24,229,10,11,-1
24,24,230,4,4,0
24,24,231,10,16,-6
24,24,232,7,11,-4
24,24,233,16,22,-6
24,24,234,16,29,-13
24,24,235,16,8,8
24,24,236,12,18,-6
24,24,237,19,14,5
24,24,238,12,26,-14
24,24,239,15,4,11
24,24,240,19,8,11
24,24,241,7,14,-7
24,24,242,12,11,1
24,24,243,19,13,6
24,24,244,16,0,16
24,24,245,7,10,-3
24,24,246,9,11,-2
24,24,247,4,15,-11
24,24,248,18,19,-1
24,24,249,11,13,-2
24,24,250,20,20,0
24,24,251,16,15,1
24,24,252,18,16,2
24,24,253,32,14,18
24,24,254,9,7,2
24,24,255,11,12,-1
24,24,256,7,10,-3
24,24,257,17,22,-5
24,24,258,12,24,-12
24,24,259,19,5,14
24,24,260,16,17,-1
24,24,261,14,27,-13
24,24,262,14,21,-7
24,24,263,12,10,2
24,24,264,13,18,-5
24,24,265,10,12,-2
24,24,266,6,10,-4
24,24,267,18,14,4
24,24,268,13,16,-3
24,24,269,22,7,15
24,24,270,9,4,5
24,24,271,17,12,5
24,24,272,10,8,2
24,24,273,7,17,-10
24,24,274,13,16,-3
24,24,275,6,6,0
24,24,276,11,9,2
24,24,277,16,12,4
24,24,278,6,7,-1
24,24,279,9,20,-11
24,24,280,21,37,-16
24,24,281,7,10,-3
24,24,282,10,16,-6
24,24,283,17,21,-4
24,24,284,16,15,1
24,24,285,12,12,0
24,24,286,15,18,-3
24,24,287,18,15,3
24,24,288,35,18,17
24,24,289,16,16,0
24,24,290,14,15,-1
24,24,291,5,10,-5
24,24,292,12,12,0
24,24,293,20,16,4
24,24,294,7,10,-3
24,24,295,3,8,-5
24,24,296,7,10,-3
24,24,297,17,17,0
24,24,298,13,14,-1
24,24,299,14,15,-1
24,25,0,18,21,-3
24,25,1,19,15,4
24,25,2,15,10,5
24,25,3,21,22,-1
24,25,4,8,6,2
24,25,5,14,11,3
24,25,6,4,8,-4
24,25,7,10,12,-2
24,25,8,9,14,-5
24,25,9,11,8,3
24,25,10,27,39,-12
24,25,11,6,11,-5
24,25,12,6,1,5
24,25,13,15,19,-4
24,25,14,11,15,-4
24,25,15,13,19,-6
24,25,16,9,14,-5
24,25,17,26,11,15
24,25,18,8,3,5
24,25,19,5,10,-5
24,25,20,21,16,5
24,25,21,14,20,-6
24,25,22,16,21,-5
24,25,23,19,11,8
24,25,24,9,9,0
24,25,25,23,10,13
24,25,26,13,14,-1
24,25,27,6,13,-7
24,25,28,16,14,2
24,25,29,12,21,-9
24,25,30,16,16,0
24,25,31,15,13,2
24,25,32,11,8,3
24,25,33,4,9,-5
24,25,34,11,17,-6
24,25,35,7,15,-8
24,25,36,11,8,3
24,25,37,14,6,8
24,25,38,9,4,5
24,25,39,13,21,-8
24,25,40,11,14,-3
24,25,41,11,16,-5
24,25,42,16,11,5
24,25,43,11,18,-7
24,25,44,21,16,5
24,25,45,1,13,-12
24,25,46,5,11,-6
24,25,47,3,8,-5
24,25,48,13,13,0
24,25,49,21,22,-1
24,25,50,12,24,-12
24,25,51,17,17,0
24,25,52,11,19,-8
24,25,53,20,11,9
24,25,54,12,17,-5
24,25,55,11,11,0
24,25,56,22,17,5
24,25,57,20,12,8
24,25,58,14,14,0
24,25,59,15,10,5
24,25,60,9,10,-1
24,25,61,16,18,-2
24,25,62,23,16,7
24,25,63,17,12,5
24,25,64,14,12,2
24,25,65,18,16,2
24,25,66,3,10,-7
24,25,67,15,19,-4
24,25,68,12,9,3
24,25,69,12,11,1
24,25,70,14,10,4
24,25,71,7,10,-3
24,25,72,12,13,-1
24,25,73,8,18,-10
24,25,74,6,5,1
24,25,75,19,6,13
24,25,76,18,41,-23
24,25,77,10,26,-16
24,25,78,14,5,9
24,25,79,11,11,0
24,25,80,11,7,4
24,25,81,11,15,-4
24,25,82,14,14,0
24,25,83,23,14,9
24,25,84,7,5,2
24,25,85,12,8,4
24,25,86,15,13,2
24,25,87,25,11,14
24,25,88,8,9,-1
24,25,89,12,16,-4
24,25,90,6,16,-10
24,25,91,18,14,4
24,25,92,16,24,-8
24,25,93,5,11,-6
24,25,94,8,5,3
24,25,95,21,14,7
24,25,96,11,9,2
24,25,97,26,16,10
24,25,98,11,13,-2
24,25,99,6,5,1
24,25,100,12,15,-3
24,25,101,20,14,6
24,25,102,14,11,3
24,25,103,12,10,2
24,25,104,12,19,-7
24,25,105,19,12,7
24,25,106,23,10,13
24,25,107,13,7,6
24,25,108,13,14,-1
24,25,109,12,23,-11
24,25,110,14,13,1
24,25,111,11,25,-14
24,25,112,18,16,2
24,25,113,20,3,17
24,25,114,7,6,1
24,25,115,19,17,2
24,25,116,15,12,3
24,25,117,13,7,6
24,25,118,15,13,2
24,25,119,11,23,-12
24,25,120,14,22,-8
24,25,121,12,17,-5
24,25,122,16,28,-12
24,25,123,6,11,-5
24,25,124,12,16,-4
24,25,125,13,13,0
24,25,126,7,15,-8
24,25,127,18,20,-2
24,25,128,23,13,10
24,25,129,7,8,-1
24,25,130,18,15,3
24,25,131,7,4,3
24,25,132,5,9,-4
24,25,133,14,5,9
24,25,134,9,12,-3
24,25,135,10,10,0
24,25,136,18,19,-1
24,25,137,20,23,-3
24,25,138,17,7,10
24,25,139,17,16,1
24,25,140,7,20,-13
24,25,141,6,11,-5
24,25,142,6,14,-8
24,25,143,33,26,7
24,25,144,23,19,4
24,25,145,10,21,-11
24,25,146,11,11,0
24,25,147,9,15,-6
24,25,148,12,12,0
24,25,149,9,8,1
24,25,150,18,13,5
24,25,151,17,19,-2
24,25,152,19,20,-1
24,25,153,21,12,9
24,25,154,16,9,7
24,25,155,17,10,7
24,25,156,7,15,-8
24,25,157,19,15,4
24,25,158,22,11,11
24,25,159,25,21,4
24,25,160,10,3,7
24,25,161,9,9,0
24,25,162,14,25,-11
24,25,163,6,11,-5
24,25,164,17,6,11
24,25,165,12,12,0
24,25,166,18,21,-3
24,25,167,12,20,-8
24,25,168,9,5,4
24,25,169,13,6,7
24,25,170,9,13,-4
24,25,171,13,17,-4
24,25,172,13,7,6
24,25,173,8,8,0
24,25,174,11,13,-2
24,25,175,12,20,-8
24,25,176,13,10,3
24,25,177,26,16,10
24,25,178,15,18,-3
24,25,179,8,7,1
24,25,180,16,6,10
24,25,181,14,17,-3
24,25,182,11,10,1
24,25,183,10,17,-7
24,25,184,6,11,-5
24,25,185,8,10,-2
24,25,186,14,12,2
24,25,187,12,29,-17
24,25,188,22,22,0
24,25,189,19,10,9
24,25,190,19,22,-3
24,25,191,19,13,6
24,25,192,6,16,-10
24,25,193,30,17,13
24,25,194,17,5,12
24,25,195,13,23,-10
24,25,196,32,11,21
24,25,197,10,8,2
24,25,198,11,8,3
24,25,199,18,19,-1
24,25,200,11,7,4
24,25,201,8,17,-9
24,25,202,13,17,-4
24,25,203,10,11,-1
24,25,204,17,11,6
24,25,205,24,8,16
24,25,206,11,17,-6
24,25,207,8,8,0
24,25,208,13,19,-6
24,25,209,15,26,-11
24,25,210,21,18,3
24,25,211,5,12,-7
24,25,212,8,8,0
24,25,213,18,12,6
24,25,214,10,21,-11
24,25,215,18,8,10
24,25,216,16,22,-6
24,25,217,8,20,-12
24,25,218,8,12,-4
24,25,219,20,12,8
24,25,220,19,9,10
24,25,221,17,19,-2
24,25,222,15,18,-3
24,25,223,8,16,-8
24,25,224,20,23,-3
24,25,225,14,17,-3
24,25,226,20,12,8
24,25,227,12,16,-4
24,25,228,18,26,-8
24,25,229,27,14,13
24,25,230,7,10,-3
24,25,231,21,15,6
24,25,232,15,9,6
24,25,233,15,26,-11
24,25,234,18,11,7
24,25,235,21,16,5
24,25,236,12,13,-1
24,25,237,26,6,20
24,25,238,8,11,-3
24,25,239,17,27,-10
24,25,240,8,10,-2
24,25,241,20,22,-2
24,25,242,9,17,-8
24,25,243,8,7,1
24,25,244,16,16,0
24,25,245,8,28,-20
24,25,246,8,9,-1
24,25,247,16,11,5
24,25,248,15,14,1
24,25,249,8,12,-4
24,25,250,12,18,-6
24,25,251,13,14,-1
24,25,252,8,20,-12
24,25,253,19,6,13
24,25,254,9,19,-10
24,25,255,10,5,5
24,25,256,15,10,5
24,25,257,13,10,3
24,25,258,9,5,4
24,25,259,17,20,-3
24,25,260,10,3,7
24,25,261,12,13,-1
24,25,262,19,11,8
24,25,263,13,14,-1
24,25,264,13,15,-2
24,25,265,4,16,-12
24,25,266,10,12,-2
24,25,267,15,8,7
24,25,268,12,13,-1
24,25,269,12,24,-12
24,25,270,12,12,0
24,25,271,14,13,1
24,25,272,10,12,-2
24,25,273,15,11,4
24,25,274,8,12,-4
24,25,275,6,10,-4
24,25,276,19,10,9
24,25,277,17,13,4
24,25,278,13,17,-4
24,25,279,9,12,-3
24,25,280,10,25,-15
24,25,281,14,4,10
24,25,282,10,7,3
24,25,283,10,19,-9
24,25,284,8,12,-4
24,25,285,8,12,-4
24,25,286,21,18,3
24,25,287,9,16,-7
24,25,288,10,6,4
24,25,289,16,29,-13
24,25,290,16,23,-7
24,25,291,16,7,9
24,25,292,13,18,-5
24,25,293,9,14,-5
24,25,294,5,24,-19
24,25,295,11,21,-10
24,25,296,10,9,1
24,25,297,14,16,-2
24,25,298,12,12,0
24,25,299,12,16,-4
24,26,0,8,9,-1
24,26,1,9,14,-5
24,26,2,23,10,13
24,26,3,4,8,-4
24,26,4,11,19,-8
24,26,5,6,11,-5
24,26,6,14,9,5
24,26,7,6,10,-4
24,26,8,10,9,1
24,26,9,17,17,0
24,26,10,9,17,-8
24,26,11,12,25,-13
24,26,12,24,9,15
24,26,13,15,9,6
24,26,14,15,12,3
24,26,15,11,12,-1
24,26,16,19,13,6
24,26,17,28,19,9
24,26,18,9,15,-6
24,26,19,11,17,-6
24,26,20,26,11,15
24,26,21,6,5,1
24,26,22,20,9,11
24,26,23,5,17,-12
24,26,24,8,19,-11
24,26,25,1,4,-3
24,26,26,6,9,-3
24,26,27,18,12,6
24,26,28,5,10,-5
24,26,29,6,8,-2
24,26,30,20,19,1
24,26,31,18,15,3
24,26,32,21,16,5
24,26,33,13,14,-1
24,26,34,5,16,-11
24,26,35,15,9,6
24,26,36,5,5,0
24,26,37,32,23,9
24,26,38,8,12,-4
24,26,39,8,14,-6
24,26,40,20,9,11
24,26,41,7,5,2
24,26,42,14,11,3
24,26,43,21,11,10
24,26,44,19,12,7
24,26,45,8,15,-7
24,26,46,24,16,8
24,26,47,6,6,0
24,26,48,9,12,-3
24,26,49,12,13,-1
24,26,50,6,20,-14
24,26,51,25,19,6
24,26,52,12,14,-2
24,26,53,10,23,-13
24,26,54,12,12,0
24,26,55,16,21,-5
24,26,56,13,4,9
24,26,57,4,8,-4
24,26,58,11,15,-4
24,26,59,11,3,8
24,26,60,16,13,3
24,26,61,11,11,0
24,26,62,10,9,1
24,26,63,5,15,-10
24,26,64,15,9,6
24,26,65,7,14,-7
24,26,66,9,9,0
24,26,67,6,9,-3
24,26,68,9,12,-3
24,26,69,14,19,-5
24,26,70,12,21,-9
24,26,71,24,19,5
24,26,72,15,14,1
24,26,73,7,11,-4
24,26,74,15,17,-2
24,26,75,8,10,-2
24,26,76,26,20,6
24,26,77,20,17,3
24,26,78,12,11,1
24,26,79,13,3,10
24,26,80,15,23,-8
24,26,81,12,5,7
24,26,82,15,22,-7
24,26,83,19,10,9
24,26,84,10,9,1
24,26,85,7,12,-5
24,26,86,11,5,6
24,26,87,15,16,-1
24,26,88,12,9,3
24,26,89,4,17,-13
24,26,90,9,13,-4
24,26,91,12,9,3
24,26,92,11,14,-3
24,26,93,10,23,-13
24,26,94,19,5,14
24,26,95,20,20,0
24,26,96,10,10,0
24,26,97,19,19,0
24,26,98,9,12,-3
24,26,99,8,15,-7
24,26,100,9,18,-9
24,26,101,8,27,-19
24,26,102,18,16,2
24,26,103,15,24,-9
24,26,104,17,10,7
24,26,105,10,12,-2
24,26,106,3,16,-13
24,26,107,22,21,1
24,26,108,11,8,3
24,26,109,10,17,-7
24,26,110,14,13,1
24,26,111,15,28,-13
24,26,112,16,11,5
24,26,113,12,16,-4
24,26,114,14,8,6
24,26,115,10,14,-4
24,26,116,9,14,-5
24,26,117,20,14,6
24,26,118,5,13,-8
24,26,119,16,18,-2
24,26,120,28,21,7
24,26,121,10,12,-2
24,26,122,20,6,14
24,26,123,14,13,1
24,26,124,8,12,-4
24,26,125,7,8,-1
24,26,126,15,8,7
24,26,127,7,9,-2
24,26,128,15,9,6
24,26,129,13,18,-5
24,26,130,19,10,9
24,26,131,14,13,1
24,26,132,6,11,-5
24,26,133,23,11,12
24,26,134,16,3,13
24,26,135,10,14,-4
24,26,136,10,10,0
24,26,137,25,17,8
24,26,138,12,15,-3
24,26,139,13,11,2
24,26,140,10,20,-10
24,26,141,4,16,-12
24,26,142,13,9,4
24,26,143,7,12,-5
24,26,144,14,17,-3
24,26,145,16,20,-4
24,26,146,18,12,6
24,26,147,6,6,0
24,26,148,5,4,1
24,26,149,5,14,-9
24,26,150,12,8,4
24,26,151,12,11,1
24,26,152,15,14,1
24,26,153,25,14,11
24,26,154,7,8,-1
24,26,155,14,8,6
24,26,156,14,8,6
24,26,157,15,7,8
24,26,158,21,20,1
24,26,159,18,7,11
24,26,160,9,5,4
24,26,161,9,16,-7
24,26,162,8,4,4
24,26,163,8,9,-1
24,26,164,13,19,-6
24,26,165,7,6,1
24,26,166,12,14,-2
24,26,167,10,16,-6
24,26,168,10,14,-4
24,26,169,5,11,-6
24,26,170,6,8,-2
24,26,171,17,12,5
24,26,172,17,15,2
24,26,173,6,10,-4
24,26,174,20,24,-4
24,26,175,12,11,1
24,26,176,18,15,3
24,26,177,18,18,0
24,26,178,9,11,-2
24,26,179,13,29,-16
24,26,180,7,13,-6
24,26,181,14,11,3
24,26,182,8,8,0
24,26,183,9,24,-15
24,26,184,23,17,6
24,26,185,18,19,-1
24,26,186,25,8,17
24,26,187,11,17,-6
24,26,188,18,20,-2
24,26,189,9,13,-4
24,26,190,17,21,-4
24,26,191,15,17,-2
24,26,192,20,16,4
24,26,193,14,10,4
24,26,194,19,17,2
24,26,195,15,14,1
24,26,196,11,20,-9
24,26,197,13,12,1
24,26,198,9,14,-5
24,26,199,6,7,-1
24,26,200,7,12,-5
24,26,201,14,14,0
24,26,202,14,12,2
24,26,203,15,10,5
24,26,204,18,14,4
24,26,205,14,8,6
24,26,206,12,15,-3
24,26,207,12,13,-1
24,26,208,22,23,-1
24,26,209,15,18,-3
24,26,210,11,8,3
24,26,211,22,15,7
24,26,212,12,8,4
24,26,213,24,17,7
24,26,214,15,7,8
24,26,215,18,12,6
24,26,216,20,12,8
24,26,217,13,13,0
24,26,218,10,20,-10
24,26,219,17,13,4
24,26,220,11,9,2
24,26,221,1,3,-2
24,26,222,12,11,1
24,26,223,13,10,3
24,26,224,15,13,2
24,26,225,6,10,-4
24,26,226,17,22,-5
24,26,227,10,6,4
24,26,228,15,17,-2
24,26,229,31,21,10
24,26,230,23,21,2
24,26,231,13,12,1
24,26,232,17,21,-4
24,26,233,9,10,-1
24,26,234,18,15,3
24,26,235,14,18,-4
24,26,236,7,9,-2
24,26,237,11,19,-8
24,26,238,5,9,-4
24,26,239,17,12,5
24,26,240,24,13,11
24,26,241,25,15,10
24,26,242,18,22,-4
24,26,243,9,14,-5
24,26,244,17,25,-8
24,26,245,16,6,10
24,26,246,22,13,9
24,26,247,12,3,9
24,26,248,13,6,7
24,26,249,18,21,-3
24,26,250,13,7,6
24,26,251,3,8,-5
24,26,252,18,12,6
24,26,253,10,10,0
24,26,254,13,5,8
24,26,255,10,10,0
24,26,256,16,16,0
24,26,257,15,10,5
24,26,258,15,17,-2
24,26,259,14,20,-6
24,26,260,13,15,-2
24,26,261,21,24,-3
24,26,262,18,14,4
24,26,263,13,10,3
24,26,264,18,14,4
24,26,265,10,4,6
24,26,266,12,18,-6
24,26,267,11,17,-6
24,26,268,15,17,-2
24,26,269,19,10,9
24,26,270,22,23,-1
24,26,271,14,13,1
24,26,272,12,10,2
24,26,273,10,11,-1
24,26,274,16,10,6
24,26,275,15,16,-1
24,26,276,24,6,18
24,26,277,12,12,0
24,26,278,10,7,3
24,26,279,16,18,-2
24,26,280,15,11,4
24,26,281,10,12,-2
24,26,282,31,16,15
24,26,283,13,25,-12
24,26,284,11,19,-8
24,26,285,10,19,-9
24,26,286,13,19,-6
24,26,287,14,7,7
24,26,288,12,5,7
24,26,289,8,8,0
24,26,290,3,27,-24
24,26,291,13,10,3
24,26,292,8,10,-2
24,26,293,19,23,-4
24,26,294,18,19,-1
24,26,295,11,10,1
24,26,296,12,9,3
24,26,297,11,2,9
24,26,298,17,18,-1
24,26,299,13,16,-3
24,27,0,15,13,2
24,27,1,15,16,-1
24,27,2,20,14,6
24,27,3,6,1,5
24,27,4,9,18,-9
24,27,5,15,12,3
24,27,6,16,14,2
24,27,7,16,16,0
24,27,8,11,9,2
24,27,9,12,5,7
24,27,10,9,25,-16
24,27,11,25,17,8
24,27,12,10,12,-2
24,27,13,11,22,-11
24,27,14,18,9,9
24,27,15,13,13,0
24,27,16,11,18,-7
24,27,17,15,23,-8
24,27,18,11,15,-4
24,27,19,12,12,0
24,27,20,8,6,2
24,27,21,12,12,0
24,27,22,13,7,6
24,27,23,14,14,0
24,27,24,13,9,4
24,27,25,18,18,0
24,27,26,15,9,6
24,27,27,17,8,9
24,27,28,14,21,-7
24,27,29,15,8,7
24,27,30,17,9,8
24,27,31,19,5,14
24,27,32,14,7,7
24,27,33,19,10,9
24,27,34,21,24,-3
24,27,35,3,13,-10
24,27,36,15,10,5
24,27,37,12,17,-5
24,27,38,25,18,7
24,27,39,19,26,-7
24,27,40,5,18,-13
24,27,41,14,17,-3
24,27,42,5,17,-12
24,27,43,11,13,-2
24,27,44,13,18,-5
24,27,45,11,13,-2
24,27,46,8,15,-7
24,27,47,13,14,-1
24,27,48,7,10,-3
24,27,49,16,22,-6
24,27,50,17,19,-2
24,27,51,6,6,0
24,27,52,19,11,8
24,27,53,17,10,7
24,27,54,16,9,7
24,27,55,11,13,-2
24,27,56,19,11,8
24,27,57,17,21,-4
24,27,58,16,7,9
24,27,59,7,17,-10
24,27,60,15,16,-1
24,27,61,10,12,-2
24,27,62,12,18,-6
24,27,63,4,4,0
24,27,64,24,18,6
24,27,65,18,31,-13
24,27,66,15,19,-4
24,27,67,27,20,7
24,27,68,12,12,0
24,27,69,16,14,2
24,27,70,13,5,8
24,27,71,7,5,2
24,27,72,4,0,4
24,27,73,18,6,12
24,27,74,20,11,9
24,27,75,8,8,0
24,27,76,12,9,3
24,27,77,5,6,-1
24,27,78,16,14,2
24,27,79,12,8,4
24,27,80,11,12,-1
24,27,81,8,24,-16
24,27,82,31,15,16
24,27,83,15,25,-10
24,27,84,10,3,7
24,27,85,7,19,-12
24,27,86,18,16,2
24,27,87,11,3,8
24,27,88,4,10,-6
24,27,89,17,16,1
24,27,90,4,2,2
24,27,91,10,8,2
24,27,92,10,10,0
24,27,93,3,7,-4
24,27,94,5,21,-16
24,27,95,15,10,5
24,27,96,23,19,4
24,27,97,0,3,-3
24,27,98,14,10,4
24,27,99,7,8,-1
24,27,100,6,8,-2
24,27,101,12,13,-1
24,27,102,13,13,0
24,27,103,4,13,-9
24,27,104,12,18,-6
24,27,105,12,11,1
24,27,106,6,13,-7
24,27,107,18,16,2
24,27,108,14,16,-2
24,27,109,18,13,5
24,27,110,11,25,-14
24,27,111,19,11,8
24,27,112,14,17,-3
24,27,113,12,10,2
24,27,114,21,22,-1
24,27,115,4,8,-4
24,27,116,12,11,1
24,27,117,11,8,3
24,27,118,17,13,4
24,27,119,9,6,3
24,27,120,17,10,7
24,27,121,17,13,4
24,27,122,12,18,-6
24,27,123,18,12,6
24,27,124,15,13,2
24,27,125,20,18,2
24,27,126,6,26,-20
24,27,127,13,17,-4
24,27,128,23,4,19
24,27,129,19,13,6
24,27,130,11,17,-6
24,27,131,9,11,-2
24,27,132,16,19,-3
24,27,133,15,21,-6
24,27,134,13,13,0
24,27,135,10,6,4
24,27,136,8,10,-2
24,27,137,11,22,-11
24,27,138,2,3,-1
24,27,139,18,18,0
24,27,140,5,7,-2
24,27,141,11,11,0
24,27,142,17,31,-14
24,27,143,8,7,1
24,27,144,13,15,-2
24,27,145,7,6,1
24,27,146,14,3,11
24,27,147,18,10,8
24,27,148,11,12,-1
24,27,149,21,22,-1
24,27,150,21,33,-12
24,27,151,13,15,-2
24,27,152,12,12,0
24,27,153,12,10,2
24,27,154,14,8,6
24,27,155,4,6,-2
24,27,156,5,11,-6
24,27,157,13,5,8
24,27,158,27,14,13
24,27,159,14,14,0
24,27,160,11,16,-5
24,27,161,16,13,3
24,27,162,9,17,-8
24,27,163,21,15,6
24,27,164,14,7,7
24,27,165,4,6,-2
24,27,166,11,12,-1
24,27,167,16,10,6
24,27,168,8,7,1
24,27,169,11,11,0
24,27,170,10,10,0
24,27,171,19,12,7
24,27,172,18,19,-1
24,27,173,9,12,-3
24,27,174,19,15,4
24,27,175,12,11,1
24,27,176,10,15,-5
24,27,177,7,14,-7
24,27,178,1,12,-11
24,27,179,19,13,6
24,27,180,8,5,3
24,27,181,17,4,13
24,27,182,19,12,7
24,27,183,7,12,-5
24,27,184,8,11,-3
24,27,185,15,9,6
24,27,186,23,24,-1
24,27,187,14,6,8
24,27,188,21,11,10
24,27,189,5,13,-8
24,27,190,18,14,4
24,27,191,8,9,-1
24,27,192,17,17,0
24,27,193,9,8,1
24,27,194,6,10,-4
24,27,195,12,8,4
24,27,196,15,17,-2
24,27,197,17,22,-5
24,27,198,10,21,-11
24,27,199,5,9,-4
24,27,200,20,16,4
24,27,201,20,15,5
24,27,202,19,17,2
24,27,203,18,15,3
24,27,204,14,21,-7
24,27,205,22,8,14
24,27,206,17,9,8
24,27,207,29,22,7
24,27,208,15,10,5
24,27,209,28,18,10
24,27,210,5,6,-1
24,27,211,14,6,8
24,27,212,14,10,4
24,27,213,11,5,6
24,27,214,5,8,-3
24,27,215,8,14,-6
24,27,216,14,14,0
24,27,217,14,22,-8
24,27,218,8,16,-8
24,27,219,8,20,-12
24,27,220,19,26,-7
24,27,221,26,9,17
24,27,222,8,16,-8
24,27,223,11,9,2
24,27,224,17,12,5
24,27,225,11,13,-2
24,27,226,16,12,4
24,27,227,11,15,-4
24,27,228,20,5,15
24,27,229,19,14,5
24,27,230,9,17,-8
24,27,231,15,14,1
24,27,232,8,22,-14
24,27,233,9,19,-10
24,27,234,24,6,18
24,27,235,14,9,5
24,27,236,12,7,5
24,27,237,16,4,12
24,27,238,20,22,-2
24,27,239,16,7,9
24,27,240,17,13,4
24,27,241,29,15,14
24,27,242,15,13,2
24,27,243,11,9,2
24,27,244,18,13,5
24,27,245,14,8,6
24,27,246,14,17,-3
24,27,247,12,19,-7
24,27,248,9,14,-5
24,27,249,10,7,3
24,27,250,21,18,3
24,27,251,13,11,2
24,27,252,8,8,0
24,27,253,14,12,2
24,27,254,8,5,3
24,27,255,20,11,9
24,27,256,14,17,-3
24,27,257,15,11,4
24,27,258,9,11,-2
24,27,259,7,5,2
24,27,260,12,16,-4
24,27,261,5,11,-6
24,27,262,22,22,0
24,27,263,16,9,7
24,27,264,10,13,-3
24,27,265,7,8,-1
24,27,266,12,9,3
24,27,267,14,7,7
24,27,268,20,24,-4
24,27,269,10,9,1
24,27,270,9,11,-2
24,27,271,8,6,2
24,27,272,7,9,-2
24,27,273,15,17,-2
24,27,274,9,4,5
24,27,275,11,4,7
24,27,276,18,22,-4
24,27,277,10,17,-7
24,27,278,16,20,-4
24,27,279,6,2,4
24,27,280,25,19,6
24,27,281,7,13,-6
24,27,282,5,20,-15
24,27,283,13,9,4
24,27,284,19,7,12
24,27,285,18,12,6
24,27,286,8,6,2
24,27,287,14,15,-1
24,27,288,15,11,4
24,27,289,20,12,8
24,27,290,16,22,-6
24,27,291,11,8,3
24,27,292,17,16,1
24,27,293,10,9,1
24,27,294,15,9,6
24,27,295,14,9,5
24,27,296,10,19,-9
24,27,297,12,8,4
24,27,298,17,14,3
24,27,299,5,13,-8
24,28,0,23,16,7
24,28,1,8,8,0
24,28,2,18,18,0
24,28,3,8,12,-4
24,28,4,8,19,-11
24,28,5,20,14,6
24,28,6,17,10,7
24,28,7,7,5,2
24,28,8,21,20,1
24,28,9,5,15,-10
24,28,10,11,11,0
24,28,11,17,5,12
24,28,12,15,21,-6
24,28,13,17,29,-12
24,28,14,7,16,-9
24,28,15,14,5,9
24,28,16,7,16,-9
24,28,17,11,14,-3
24,28,18,14,9,5
24,28,19,15,18,-3
24,28,20,17,11,6
24,28,21,7,10,-3
24,28,22,17,5,12
24,28,23,9,8,1
24,28,24,11,6,5
24,28,25,12,4,8
24,28,26,18,18,0
24,28,27,10,13,-3
24,28,28,16,8,8
24,28,29,5,13,-8
24,28,30,21,17,4
24,28,31,11,13,-2
24,28,32,18,11,7
24,28,33,23,17,6
24,28,34,20,14,6
24,28,35,12,12,0
24,28,36,16,23,-7
24,28,37,23,25,-2
24,28,38,22,13,9
24,28,39,19,15,4
24,28,40,17,5,12
24,28,41,10,17,-7
24,28,42,15,20,-5
24,28,43,17,22,-5
24,28,44,22,16,6
24,28,45,21,15,6
24,28,46,6,3,3
24,28,47,6,15,-9
24,28,48,19,8,11
24,28,49,26,12,14
24,28,50,12,9,3
24,28,51,8,11,-3
24,28,52,11,12,-1
24,28,53,8,4,4
24,28,54,19,21,-2
24,28,55,27,13,14
24,28,56,20,9,11
24,28,57,20,6,14
24,28,58,18,11,7
24,28,59,15,17,-2
24,28,60,18,18,0
24,28,61,19,6,13
24,28,62,5,20,-15
24,28,63,19,7,12
24,28,64,26,23,3
24,28,65,15,14,1
24,28,66,6,22,-16
24,28,67,15,10,5
24,28,68,18,22,-4
24,28,69,11,6,5
24,28,70,7,18,-11
24,28,71,10,17,-7
24,28,72,20,16,4
24,28,73,15,18,-3
24,28,74,14,11,3
24,28,75,5,7,-2
24,28,76,14,9,5
24,28,77,20,15,5
24,28,78,14,11,3
24,28,79,13,11,2
24,28,80,9,6,3
24,28,81,20,17,3
24,28,82,7,9,-2
24,28,83,12,5,7
24,28,84,13,10,3
24,28,85,8,14,-6
24,28,86,5,10,-5
24,28,87,16,11,5
24,28,88,10,5,5
24,28,89,25,6,19
24,28,90,15,17,-2
24,28,91,31,16,15
24,28,92,14,12,2
24,28,93,19,20,-1
24,28,94,20,11,9
24,28,95,15,8,7
24,28,96,9,16,-7
24,28,97,11,14,-3
24,28,98,6,13,-7
24,28,99,8,12,-4
24,28,100,11,10,1
24,28,101,21,11,10
24,28,102,20,15,5
24,28,103,13,4,9
24,28,104,10,6,4
24,28,105,10,8,2
24,28,106,26,21,5
24,28,107,15,10,5
24,28,108,13,9,4
24,28,109,8,18,-10
24,28,110,11,12,-1
24,28,111,14,8,6
24,28,112,16,13,3
24,28,113,9,12,-3
24,28,114,18,18,0
24,28,115,17,16,1
24,28,116,8,9,-1
24,28,117,21,11,10
24,28,118,2,16,-14
24,28,119,12,12,0
24,28,120,10,19,-9
24,28,121,22,23,-1
24,28,122,7,11,-4
24,28,123,13,11,2
24,28,124,7,15,-8
24,28,125,21,9,12
24,28,126,18,19,-1
24,28,127,16,8,8
24,28,128,23,12,11
24,28,129,18,9,9
24,28,130,8,12,-4
24,28,131,11,8,3
24,28,132,12,17,-5
24,28,133,8,6,2
24,28,134,3,4,-1
24,28,135,13,13,0
24,28,136,14,15,-1
24,28,137,10,13,-3
24,28,138,10,14,-4
24,28,139,17,11,6
24,28,140,7,8,-1
24,28,141,21,14,7
24,28,142,7,9,-2
24,28,143,22,23,-1
24,28,144,13,13,0
24,28,145,8,9,-1
24,28,146,10,27,-17
24,28,147,8,23,-15
24,28,148,27,17,10
24,28,149,12,18,-6
24,28,150,8,14,-6
24,28,151,19,17,2
24,28,152,8,10,-2
24,28,153,10,13,-3
24,28,154,19,5,14
24,28,155,18,19,-1
24,28,156,13,13,0
24,28,157,4,7,-3
24,28,158,10,15,-5
24,28,159,22,10,12
24,28,160,28,25,3
24,28,161,17,5,12
24,28,162,12,17,-5
24,28,163,13,10,3
24,28,164,9,14,-5
24,28,165,19,17,2
24,28,166,13,9,4
24,28,167,15,6,9
24,28,168,13,11,2
24,28,169,10,9,1
24,28,170,13,7,6
24,28,171,14,9,5
24,28,172,6,18,-12
24,28,173,14,1,13
24,28,174,10,16,-6
24,28,175,9,4,5
24,28,176,16,13,3
24,28,177,20,8,12
24,28,178,23,9,14
24,28,179,4,18,-14
24,28,180,8,16,-8
24,28,181,7,16,-9
24,28,182,7,6,1
24,28,183,16,13,3
24,28,184,20,6,14
24,28,185,10,7,3
24,28,186,8,24,-16
24,28,187,10,10,0
24,28,188,7,21,-14
24,28,189,13,10,3
24,28,190,7,13,-6
24,28,191,9,9,0
24,28,192,21,27,-6
24,28,193,9,19,-10
24,28,194,11,14,-3
24,28,195,12,12,0
24,28,196,11,7,4
24,28,197,10,10,0
24,28,198,7,10,-3
24,28,199,8,11,-3
24,28,200,17,11,6
24,28,201,8,6,2
24,28,202,12,14,-2
24,28,203,16,15,1
24,28,204,15,19,-4
24,28,205,9,16,-7
24,28,206,19,9,10
24,28,207,10,5,5
24,28,208,8,13,-5
24,28,209,22,9,13
24,28,210,12,11,1
24,28,211,25,15,10
24,28,212,10,9,1
24,28,213,12,6,6
24,28,214,8,6,2
24,28,215,11,10,1
24,28,216,18,13,5
24,28,217,15,12,3
24,28,218,12,22,-10
24,28,219,9,5,4
24,28,220,16,24,-8
24,28,221,19,18,1
24,28,222,15,8,7
24,28,223,18,10,8
24,28,224,13,7,6
24,28,225,12,22,-10
24,28,226,16,14,2
24,28,227,10,13,-3
24,28,228,14,21,-7
24,28,229,17,17,0
24,28,230,10,13,-3
24,28,231,20,8,12
24,28,232,8,1,7
24,28,233,22,36,-14
24,28,234,17,16,1
24,28,235,19,11,8
24,28,236,15,17,-2
24,28,237,17,22,-5
24,28,238,17,17,0
24,28,239,9,10,-1
24,28,240,18,7,11
24,28,241,10,3,7
24,28,242,10,9,1
24,28,243,7,13,-6
24,28,244,29,17,12
24,28,245,18,36,-18
24,28,246,16,20,-4
24,28,247,8,7,1
24,28,248,7,10,-3
24,28,249,13,6,7
24,28,250,29,18,11
24,28,251,12,14,-2
24,28,252,10,3,7
24,28,253,18,8,10
24,28,254,10,19,-9
24,28,255,12,14,-2
24,28,256,14,10,4
24,28,257,13,8,5
24,28,258,4,4,0
24,28,259,11,22,-11
24,28,260,17,11,6
24,28,261,2,12,-10
24,28,262,20,14,6
24,28,263,10,16,-6
24,28,264,17,9,8
24,28,265,16,8,8
24,28,266,14,12,2
24,28,267,5,10,-5
24,28,268,16,25,-9
24,28,269,10,5,5
24,28,270,8,8,0
24,28,271,7,6,1
24,28,272,16,12,4
24,28,273,10,10,0
24,28,274,6,10,-4
24,28,275,8,17,-9
24,28,276,5,9,-4
24,28,277,7,8,-1
24,28,278,11,10,1
24,28,279,12,17,-5
24,28,280,11,8,3
24,28,281,36,22,14
24,28,282,15,5,10
24,28,283,11,12,-1
24,28,284,6,13,-7
24,28,285,7,14,-7
24,28,286,14,15,-1
24,28,287,7,10,-3
24,28,288,12,10,2
24,28,289,14,13,1
24,28,290,12,6,6
24,28,291,12,6,6
24,28,292,17,24,-7
24,28,293,14,8,6
24,28,294,16,19,-3
24,28,295,11,6,5
24,28,296,10,14,-4
24,28,297,20,18,2
24,28,298,5,7,-2
24,28,299,13,12,1
24,29,0,10,13,-3
24,29,1,8,7,1
24,29,2,6,8,-2
24,29,3,11,7,4
24,29,4,22,18,4
24,29,5,11,9,2
24,29,6,6,11,-5
24,29,7,13,4,9
24,29,8,9,5,4
24,29,9,14,8,6
24,29,10,21,10,11
24,29,11,5,11,-6
24,29,12,10,20,-10
24,29,13,17,18,-1
24,29,14,14,10,4
24,29,15,16,17,-1
24,29,16,18,11,7
24,29,17,19,17,2
24,29,18,4,3,1
24,29,19,12,15,-3
24,29,20,14,7,7
24,29,21,14,20,-6
24,29,22,8,15,-7
24,29,23,7,9,-2
24,29,24,13,6,7
24,29,25,18,7,11
24,29,26,10,6,4
24,29,27,12,9,3
24,29,28,13,11,2
24,29,29,11,14,-3
24,29,30,16,12,4
24,29,31,2,16,-14
24,29,32,15,17,-2
24,29,33,9,6,3
24,29,34,11,21,-10
24,29,35,16,10,6
24,29,36,13,12,1
24,29,37,12,18,-6
24,29,38,9,4,5
24,29,39,15,11,4
24,29,40,8,10,-2
24,29,41,14,7,7
24,29,42,10,5,5
24,29,43,25,15,10
24,29,44,8,12,-4
24,29,45,12,14,-2
24,29,46,7,10,-3
24,29,47,11,16,-5
24,29,48,18,12,6
24,29,49,7,9,-2
24,29,50,16,7,9
24,29,51,7,7,0
24,29,52,13,11,2
24,29,53,15,12,3
24,29,54,32,19,13
24,29,55,8,8,0
24,29,56,11,14,-3
24,29,57,20,7,13
24,29,58,26,23,3
24,29,59,17,10,7
24,29,60,13,8,5
24,29,61,19,16,3
24,29,62,12,11,1
24,29,63,12,12,0
24,29,64,18,3,15
24,29,65,11,14,-3
24,29,66,14,10,4
24,29,67,10,5,5
24,29,68,10,4,6
24,29,69,13,4,9
24,29,70,28,17,11
24,29,71,14,16,-2
24,29,72,20,13,7
24,29,73,12,14,-2
24,29,74,13,26,-13
24,29,75,4,6,-2
24,29,76,24,16,8
24,29,77,34,10,24
24,29,78,12,4,8
24,29,79,12,14,-2
24,29,80,15,4,11
24,29,81,5,12,-7
24,29,82,13,7,6
24,29,83,17,13,4
24,29,84,17,14,3
24,29,85,18,18,0
24,29,86,8,6,2
24,29,87,14,14,0
24,29,88,7,20,-13
24,29,89,33,10,23
24,29,90,6,17,-11
24,29,91,11,18,-7
24,29,92,16,8,8
24,29,93,14,9,5
24,29,94,9,12,-3
24,29,95,11,15,-4
24,29,96,8,3,5
24,29,97,19,6,13
24,29,98,19,9,10
24,29,99,13,6,7
24,29,100,25,12,13
24,29,101,20,17,3
24,29,102,11,13,-2
24,29,103,11,11,0
24,29,104,18,12,6
24,29,105,15,8,7
24,29,106,15,12,3
24,29,107,9,4,5
24,29,108,5,10,-5
24,29,109,19,22,-3
24,29,110,16,21,-5
24,29,111,7,8,-1
24,29,112,11,13,-2
24,29,113,9,14,-5
24,29,114,19,14,5
24,29,115,11,11,0
24,29,116,10,5,5
24,29,117,6,20,-14
24,29,118,17,9,8
24,29,119,11,20,-9
24,29,120,17,12,5
24,29,121,9,9,0
24,29,122,8,14,-6
24,29,123,2,6,-4
24,29,124,14,8,6
24,29,125,7,1,6
24,29,126,8,13,-5
24,29,127,21,21,0
24,29,128,16,18,-2
24,29,129,18,34,-16
24,29,130,21,16,5
24,29,131,18,26,-8
24,29,132,16,5,11
24,29,133,31,21,10
24,29,134,12,6,6
24,29,135,12,20,-8
24,29,136,26,4,22
24,29,137,12,6,6
24,29,138,13,19,-6
24,29,139,16,15,1
24,29,140,18,12,6
24,29,141,12,4,8
24,29,142,17,12,5
24,29,143,17,9,8
24,29,144,29,18,11
24,29,145,15,14,1
24,29,146,18,13,5
24,29,147,6,8,-2
24,29,148,10,13,-3
24,29,149,17,10,7
24,29,150,19,24,-5
24,29,151,18,14,4
24,29,152,16,11,5
24,29,153,15,15,0
24,29,154,11,8,3
24,29,155,19,15,4
24,29,156,11,11,0
24,29,157,20,16,4
24,29,158,17,15,2
24,29,159,16,5,11
24,29,160,9,8,1
24,29,161,16,17,-1
24,29,162,8,22,-14
24,29,163,9,13,-4
24,29,164,11,8,3
24,29,165,13,5,8
24,29,166,17,7,10
24,29,167,13,14,-1
24,29,168,11,13,-2
24,29,169,19,6,13
24,29,170,25,20,5
24,29,171,4,9,-5
24,29,172,12,9,3
24,29,173,17,13,4
24,29,174,4,15,-11
24,29,175,18,15,3
24,29,176,13,18,-5
24,29,177,6,8,-2
24,29,178,20,11,9
24,29,179,6,15,-9
24,29,180,27,15,12
24,29,181,6,6,0
24,29,182,14,16,-2
24,29,183,19,23,-4
24,29,184,5,6,-1
24,29,185,18,10,8
24,29,186,15,7,8
24,29,187,11,13,-2
24,29,188,13,7,6
24,29,189,13,5,8
24,29,190,11,8,3
24,29,191,19,12,7
24,29,192,6,11,-5
24,29,193,11,19,-8
24,29,194,19,3,16
24,29,195,17,14,3
24,29,196,15,13,2
24,29,197,8,6,2
24,29,198,13,10,3
24,29,199,12,16,-4
24,29,200,4,12,-8
24,29,201,17,18,-1
24,29,202,13,9,4
24,29,203,11,18,-7
24,29,204,10,13,-3
24,29,205,11,13,-2
24,29,206,12,16,-4
24,29,207,11,12,-1
24,29,208,6,16,-10
24,29,209,16,20,-4
24,29,210,10,18,-8
24,29,211,20,11,9
24,29,212,30,18,12
24,29,213,8,6,2
24,29,214,12,14,-2
24,29,215,16,13,3
24,29,216,12,12,0
24,29,217,10,4,6
24,29,218,8,14,-6
24,29,219,10,5,5
24,29,220,5,4,1
24,29,221,26,20,6
24,29,222,9,12,-3
24,29,223,18,17,1
24,29,224,5,6,-1
24,29,225,7,15,-8
24,29,226,12,10,2
24,29,227,9,16,-7
24,29,228,22,13,9
24,29,229,16,17,-1
24,29,230,21,18,3
24,29,231,9,9,0
24,29,232,12,13,-1
24,29,233,8,9,-1
24,29,234,6,13,-7
24,29,235,24,12,12
24,29,236,12,19,-7
24,29,237,12,9,3
24,29,238,16,11,5
24,29,239,7,10,-3
24,29,240,21,26,-5
24,29,241,6,21,-15
24,29,242,18,15,3
24,29,243,6,8,-2
24,29,244,20,10,10
24,29,245,14,17,-3
24,29,246,10,14,-4
24,29,247,16,8,8
24,29,248,12,15,-3
24,29,249,9,17,-8
24,29,250,12,20,-8
24,29,251,13,12,1
24,29,252,4,12,-8
24,29,253,8,17,-9
24,29,254,9,13,-4
24,29,255,12,23,-11
24,29,256,17,8,9
24,29,257,3,6,-3
24,29,258,18,16,2
24,29,259,10,19,-9
24,29,260,14,17,-3
24,29,261,16,7,9
24,29,262,14,14,0
24,29,263,28,25,3
24,29,264,13,11,2
24,29,265,14,18,-4
24,29,266,12,10,2
24,29,267,18,15,3
24,29,268,10,7,3
24,29,269,7,14,-7
24,29,270,19,16,3
24,29,271,13,9,4
24,29,272,20,7,13
24,29,273,11,10,1
24,29,274,23,14,9
24,29,275,13,7,6
24,29,276,14,18,-4
24,29,277,11,25,-14
24,29,278,19,17,2
24,29,279,17,30,-13
24,29,280,8,14,-6
24,29,281,29,6,23
24,29,282,17,16,1
24,29,283,13,15,-2
24,29,284,13,11,2
24,29,285,14,17,-3
24,29,286,10,8,2
24,29,287,15,12,3
24,29,288,9,6,3
24,29,289,15,16,-1
24,29,290,9,5,4
24,29,291,22,9,13
24,29,292,14,7,7
24,29,293,10,12,-2
24,29,294,15,14,1
24,29,295,12,15,-3
24,29,296,24,8,16
24,29,297,24,22,2
24,29,298,16,11,5
24,29,299,16,19,-3
24,30,0,23,17,6
24,30,1,6,10,-4
24,30,2,12,13,-1
24,30,3,11,13,-2
24,30,4,25,17,8
24,30,5,14,8,6
24,30,6,21,14,7
24,30,7,18,5,13
24,30,8,7,9,-2
24,30,9,15,11,4
24,30,10,10,12,-2
24,30,11,12,8,4
24,30,12,10,4,6
24,30,13,15,14,1
24,30,14,9,7,2
24,30,15,15,21,-6
24,30,16,13,13,0
24,30,17,12,20,-8
24,30,18,4,15,-11
24,30,19,14,17,-3
24,30,20,13,5,8
24,30,21,9,16,-7
24,30,22,14,18,-4
24,30,23,9,7,2
24,30,24,9,9,0
24,30,25,22,14,8
24,30,26,7,7,0
24,30,27,12,6,6
24,30,28,6,14,-8
24,30,29,16,16,0
24,30,30,10,10,0
24,30,31,15,20,-5
24,30,32,11,3,8
24,30,33,16,8,8
24,30,34,11,14,-3
24,30,35,11,10,1
24,30,36,19,7,12
24,30,37,4,11,-7
24,30,38,18,15,3
24,30,39,12,7,5
24,30,40,2,10,-8
24,30,41,12,12,0
24,30,42,9,6,3
24,30,43,5,3,2
24,30,44,26,21,5
24,30,45,18,7,11
24,30,46,16,11,5
24,30,47,20,16,4
24,30,48,10,13,-3
24,30,49,21,14,7
24,30,50,24,16,8
24,30,51,15,8,7
24,30,52,18,20,-2
24,30,53,16,9,7
24,30,54,22,15,7
24,30,55,17,22,-5
24,30,56,12,4,8
24,30,57,14,14,0
24,30,58,12,14,-2
24,30,59,15,7,8
24,30,60,9,15,-6
24,30,61,12,16,-4
24,30,62,13,7,6
24,30,63,15,9,6
24,30,64,29,13,16
24,30,65,12,7,5
24,30,66,15,13,2
24,30,67,9,12,-3
24,30,68,8,9,-1
24,30,69,17,16,1
24,30,70,17,14,3
24,30,71,6,8,-2
24,30,72,10,8,2
24,30,73,30,12,18
24,30,74,13,16,-3
24,30,75,9,10,-1
24,30,76,13,8,5
24,30,77,13,17,-4
24,30,78,14,9,5
24,30,79,9,11,-2
24,30,80,10,9,1
24,30,81,8,11,-3
24,30,82,13,9,4
24,30,83,30,11,19
24,30,84,13,11,2
24,30,85,8,13,-5
24,30,86,12,25,-13
24,30,87,15,10,5
24,30,88,12,9,3
24,30,89,16,13,3
24,30,90,12,5,7
24,30,91,20,19,1
24,30,92,14,14,0
24,30,93,14,4,10
24,30,94,14,10,4
24,30,95,6,24,-18
24,30,96,20,21,-1
24,30,97,7,8,-1
24,30,98,17,12,5
24,30,99,13,14,-1
24,30,100,21,20,1
24,30,101,13,13,0
24,30,102,10,13,-3
24,30,103,7,8,-1
24,30,104,10,14,-4
24,30,105,13,2,11
24,30,106,17,16,1
24,30,107,10,10,0
24,30,108,16,17,-1
24,30,109,10,8,2
24,30,110,12,13,-1
24,30,111,12,9,3
24,30,112,13,10,3
24,30,113,25,19,6
24,30,114,11,14,-3
24,30,115,16,9,7
24,30,116,15,15,0
24,30,117,18,17,1
24,30,118,7,9,-2
24,30,119,8,5,3
24,30,120,19,14,5
24,30,121,13,9,4
24,30,122,21,23,-2
24,30,123,8,10,-2
24,30,124,11,12,-1
24,30,125,14,7,7
24,30,126,18,20,-2
24,30,127,19,11,8
24,30,128,16,20,-4
24,30,129,6,14,-8
24,30,130,13,20,-7
24,30,131,14,5,9
24,30,132,4,4,0
24,30,133,24,16,8
24,30,134,31,9,22
24,30,135,5,14,-9
24,30,136,11,18,-7
24,30,137,19,11,8
24,30,138,11,14,-3
24,30,139,6,21,-15
24,30,140,13,17,-4
24,30,141,9,16,-7
24,30,142,19,18,1
24,30,143,8,17,-9
24,30,144,26,8,18
24,30,145,19,19,0
24,30,146,7,7,0
24,30,147,18,10,8
24,30,148,16,10,6
24,30,149,9,13,-4
24,30,150,6,18,-12
24,30,151,11,11,0
24,30,152,5,12,-7
24,30,153,8,4,4
24,30,154,10,7,3
24,30,155,23,26,-3
24,30,156,13,24,-11
24,30,157,18,13,5
24,30,158,9,1,8
24,30,159,3,8,-5
24,30,160,9,26,-17
24,30,161,18,10,8
24,30,162,11,7,4
24,30,163,17,15,2
24,30,164,5,13,-8
24,30,165,16,8,8
24,30,166,17,9,8
24,30,167,10,8,2
24,30,168,17,13,4
24,30,169,11,13,-2
24,30,170,15,11,4
24,30,171,9,7,2
24,30,172,16,20,-4
24,30,173,11,12,-1
24,30,174,7,10,-3
24,30,175,6,6,0
24,30,176,12,13,-1
24,30,177,8,4,4
24,30,178,17,25,-8
24,30,179,16,8,8
24,30,180,9,12,-3
24,30,181,24,9,15
24,30,182,4,10,-6
24,30,183,16,8,8
24,30,184,21,16,5
24,30,185,11,11,0
24,30,186,6,8,-2
24,30,187,13,15,-2
24,30,188,15,7,8
24,30,189,16,24,-8
24,30,190,17,12,5
24,30,191,17,13,4
24,30,192,12,7,5
24,30,193,6,6,0
24,30,194,23,15,8
24,30,195,11,17,-6
24,30,196,10,4,6
24,30,197,8,9,-1
24,30,198,3,4,-1
24,30,199,27,18,9
24,30,200,4,8,-4
24,30,201,12,13,-1
24,30,202,16,8,8
24,30,203,11,10,1
24,30,204,4,9,-5
24,30,205,9,15,-6
24,30,206,8,20,-12
24,30,207,13,20,-7
24,30,208,12,14,-2
24,30,209,17,16,1
24,30,210,19,23,-4
24,30,211,8,10,-2
24,30,212,8,7,1
24,30,213,13,12,1
24,30,214,13,18,-5
24,30,215,15,7,8
24,30,216,24,10,14
24,30,217,14,9,5
24,30,218,6,6,0
24,30,219,3,17,-14
24,30,220,16,14,2
24,30,221,10,6,4
24,30,222,10,10,0
24,30,223,10,13,-3
24,30,224,9,11,-2
24,30,225,15,8,7
24,30,226,15,12,3
24,30,227,8,11,-3
24,30,228,13,14,-1
24,30,229,18,5,13
24,30,230,6,10,-4
24,30,231,8,6,2
24,30,232,9,7,2
24,30,233,9,10,-1
24,30,234,5,8,-3
24,30,235,13,12,1
24,30,236,23,14,9
24,30,237,7,6,1
24,30,238,11,9,2
24,30,239,8,6,2
24,30,240,7,6,1
24,30,241,5,8,-3
24,30,242,6,8,-2
24,30,243,20,10,10
24,30,244,11,16,-5
24,30,245,16,15,1
24,30,246,22,8,14
24,30,247,18,13,5
24,30,248,7,15,-8
24,30,249,15,8,7
24,30,250,12,13,-1
24,30,251,2,3,-1
24,30,252,5,25,-20
24,30,253,7,10,-3
24,30,254,10,6,4
24,30,255,11,13,-2
24,30,256,18,17,1
24,30,257,15,9,6
24,30,258,14,9,5
24,30,259,23,9,14
24,30,260,28,15,13
24,30,261,20,11,9
24,30,262,10,10,0
24,30,263,14,6,8
24,30,264,13,11,2
24,30,265,22,8,14
24,30,266,12,13,-1
24,30,267,18,18,0
24,30,268,21,1,20
24,30,269,6,5,1
24,30,270,4,15,-11
24,30,271,3,7,-4
24,30,272,11,7,4
24,30,273,19,15,4
24,30,274,6,5,1
24,30,275,9,12,-3
24,30,276,16,13,3
24,30,277,11,4,7
24,30,278,8,9,-1
24,30,279,22,22,0
24,30,280,10,10,0
24,30,281,21,15,6
24,30,282,9,10,-1
24,30,283,17,10,7
24,30,284,17,17,0
24,30,285,17,8,9
24,30,286,18,7,11
24,30,287,9,23,-14
24,30,288,15,16,-1
24,30,289,19,17,2
24,30,290,12,7,5
24,30,291,26,9,17
24,30,292,9,9,0
24,30,293,13,8,5
24,30,294,19,13,6
24,30,295,8,9,-1
24,30,296,22,38,-16
24,30,297,16,14,2
24,30,298,20,24,-4
24,30,299,16,7,9
25,1,0,7,12,-5
25,1,1,0,10,-10
25,1,2,6,36,-30
25,1,3,17,24,-7
25,1,4,8,25,-17
25,1,5,8,17,-9
25,1,6,5,9,-4
25,1,7,11,21,-10
25,1,8,10,12,-2
25,1,9,16,44,-28
25,1,10,9,21,-12
25,1,11,11,27,-16
25,1,12,14,36,-22
25,1,13,9,13,-4
25,1,14,4,23,-19
25,1,15,4,18,-14
25,1,16,6,14,-8
25,1,17,4,30,-26
25,1,18,7,17,-10
25,1,19,5,12,-7
25,1,20,2,11,-9
25,1,21,6,43,-37
25,1,22,4,11,-7
25,1,23,3,18,-15
25,1,24,7,18,-11
25,1,25,6,9,-3
25,1,26,3,17,-14
25,1,27,9,11,-2
25,1,28,8,15,-7
25,1,29,20,24,-4
25,1,30,15,16,-1
25,1,31,8,13,-5
25,1,32,3,14,-11
25,1,33,6,27,-21
25,1,34,9,11,-2
25,1,35,3,21,-18
25,1,36,5,11,-6
25,1,37,10,29,-19
25,1,38,4,23,-19
25,1,39,5,20,-15
25,1,40,9,10,-1
25,1,41,9,27,-18
25,1,42,5,12,-7
25,1,43,12,11,1
25,1,44,7,15,-8
25,1,45,19,15,4
25,1,46,6,22,-16
25,1,47,7,11,-4
25,1,48,6,23,-17
25,1,49,3,13,-10
25,1,50,20,17,3
25,1,51,7,12,-5
25,1,52,5,25,-20
25,1,53,7,16,-9
25,1,54,14,28,-14
25,1,55,11,21,-10
25,1,56,3,12,-9
25,1,57,4,17,-13
25,1,58,1,30,-29
25,1,59,8,15,-7
25,1,60,6,25,-19
25,1,61,6,14,-8
25,1,62,7,12,-5
25,1,63,9,20,-11
25,1,64,14,24,-10
25,1,65,9,16,-7
25,1,66,8,29,-21
25,1,67,15,21,-6
25,1,68,9,20,-11
25,1,69,7,16,-9
25,1,70,5,13,-8
25,1,71,7,18,-11
25,1,72,11,26,-15
25,1,73,1,17,-16
25,1,74,13,15,-2
25,1,75,6,18,-12
25,1,76,15,22,-7
25,1,77,12,21,-9
25,1,78,4,25,-21
25,1,79,6,5,1
25,1,80,10,17,-7
25,1,81,0,15,-15
25,1,82,10,35,-25
25,1,83,6,36,-30
25,1,84,21,13,8
25,1,85,11,24,-13
25,1,86,4,8,-4
25,1,87,6,18,-12
25,1,88,3,23,-20
25,1,89,7,9,-2
25,1,90,9,26,-17
25,1,91,7,19,-12
25,1,92,8,19,-11
25,1,93,7,12,-5
25,1,94,6,16,-10
25,1,95,9,28,-19
25,1,96,8,11,-3
25,1,97,11,23,-12
25,1,98,5,20,-15
25,1,99,1,5,-4
25,1,100,4,16,-12
25,1,101,3,16,-13
25,1,102,7,16,-9
25,1,103,13,11,2
25,1,104,8,24,-16
25,1,105,9,21,-12
25,1,106,7,20,-13
25,1,107,15,12,3
25,1,108,14,19,-5
25,1,109,11,22,-11
25,1,110,7,22,-15
25,1,111,6,15,-9
25,1,112,0,2,-2
25,1,113,4,9,-5
25,1,114,2,11,-9
25,1,115,6,20,-14
25,1,116,4,7,-3
25,1,117,14,15,-1
25,1,118,3,24,-21
25,1,119,8,14,-6
25,1,120,4,20,-16
25,1,121,6,9,-3
25,1,122,1,18,-17
25,1,123,19,17,2
25,1,124,12,15,-3
25,1,125,14,21,-7
25,1,126,12,12,0
25,1,127,12,18,-6
25,1,128,1,9,-8
25,1,129,9,13,-4
25,1,130,5,9,-4
25,1,131,4,12,-8
25,1,132,6,16,-10
25,1,133,6,24,-18
25,1,134,10,11,-1
25,1,135,10,19,-9
25,1,136,4,18,-14
25,1,137,9,16,-7
25,1,138,3,10,-7
25,1,139,8,11,-3
25,1,140,12,29,-17
25,1,141,4,14,-10
25,1,142,8,19,-11
25,1,143,16,19,-3
25,1,144,15,24,-9
25,1,145,6,9,-3
25,1,146,5,10,-5
25,1,147,5,10,-5
25,1,148,8,13,-5
25,1,149,7,21,-14
25,1,150,22,33,-11
25,1,151,9,13,-4
25,1,152,9,19,-10
25,1,153,11,18,-7
25,1,154,9,15,-6
25,1,155,6,22,-16
25,1,156,10,19,-9
25,1,157,4,25,-21
25,1,158,10,24,-14
25,1,159,4,20,-16
25,1,160,19,23,-4
25,1,161,5,21,-16
25,1,162,3,9,-6
25,1,163,3,10,-7
25,1,164,11,16,-5
25,1,165,7,18,-11
25,1,166,13,12,1
25,1,167,5,16,-11
25,1,168,3,24,-21
25,1,169,0,13,-13
25,1,170,9,12,-3
25,1,171,9,15,-6
25,1,172,15,21,-6
25,1,173,7,25,-18
25,1,174,10,10,0
25,1,175,8,24,-16
25,1,176,4,15,-11
25,1,177,8,8,0
25,1,178,4,14,-10
25,1,179,6,13,-7
25,1,180,3,8,-5
25,1,181,19,30,-11
25,1,182,8,23,-15
25,1,183,3,12,-9
25,1,184,13,26,-13
25,1,185,5,11,-6
25,1,186,4,12,-8
25,1,187,6,9,-3
25,1,188,1,11,-10
25,1,189,7,11,-4
25,1,190,7,26,-19
25,1,191,9,14,-5
25,1,192,2,16,-14
25,1,193,2,16,-14
25,1,194,4,38,-34
25,1,195,13,17,-4
25,1,196,9,29,-20
25,1,197,4,9,-5
25,1,198,6,34,-28
25,1,199,10,35,-25
25,1,200,7,12,-5
25,1,201,9,21,-12
25,1,202,7,29,-22
25,1,203,11,18,-7
25,1,204,17,25,-8
25,1,205,1,12,-11
25,1,206,5,14,-9
25,1,207,8,28,-20
25,1,208,1,9,-8
25,1,209,3,11,-8
25,1,210,4,22,-18
25,1,211,5,18,-13
25,1,212,1,20,-19
25,1,213,6,15,-9
25,1,214,13,20,-7
25,1,215,2,13,-11
25,1,216,8,6,2
25,1,217,3,19,-16
25,1,218,6,11,-5
25,1,219,10,20,-10
25,1,220,10,20,-10
25,1,221,5,17,-12
25,1,222,12,28,-16
25,1,223,13,13,0
25,1,224,15,16,-1
25,1,225,16,31,-15
25,1,226,5,12,-7
25,1,227,15,24,-9
25,1,228,8,23,-15
25,1,229,0,20,-20
25,1,230,6,18,-12
25,1,231,6,12,-6
25,1,232,12,15,-3
25,1,233,8,10,-2
25,1,234,1,8,-7
25,1,235,12,14,-2
25,1,236,10,16,-6
25,1,237,2,18,-16
25,1,238,14,32,-18
25,1,239,4,12,-8
25,1,240,6,23,-17
25,1,241,9,19,-10
25,1,242,8,12,-4
25,1,243,11,19,-8
25,1,244,2,11,-9
25,1,245,10,9,1
25,1,246,4,10,-6
25,1,247,3,14,-11
25,1,248,5,18,-13
25,1,249,8,11,-3
25,1,250,6,18,-12
25,1,251,12,2,10
25,1,252,7,15,-8
25,1,253,6,5,1
25,1,254,5,22,-17
25,1,255,7,23,-16
25,1,256,1,23,-22
25,1,257,14,23,-9
25,1,258,11,17,-6
25,1,259,5,27,-22
25,1,260,4,14,-10
25,1,261,2,13,-11
25,1,262,8,8,0
25,1,263,5,22,-17
25,1,264,4,26,-22
25,1,265,8,36,-28
25,1,266,9,24,-15
25,1,267,5,10,-5
25,1,268,18,26,-8
25,1,269,10,16,-6
25,1,270,10,15,-5
25,1,271,4,12,-8
25,1,272,7,8,-1
25,1,273,9,9,0
25,1,274,16,22,-6
25,1,275,8,18,-10
25,1,276,8,28,-20
25,1,277,8,18,-10
25,1,278,4,3,1
25,1,279,7,22,-15
25,1,280,7,16,-9
25,1,281,1,7,-6
25,1,282,6,6,0
25,1,283,9,18,-9
25,1,284,9,15,-6
25,1,285,2,15,-13
25,1,286,7,12,-5
25,1,287,11,30,-19
25,1,288,4,14,-10
25,1,289,5,6,-1
25,1,290,12,16,-4
25,1,291,3,8,-5
25,1,292,13,18,-5
25,1,293,2,15,-13
25,1,294,5,6,-1
25,1,295,5,19,-14
25,1,296,8,19,-11
25,1,297,3,13,-10
25,1,298,3,17,-14
25,1,299,9,15,-6
25,2,0,13,19,-6
25,2,1,5,14,-9
25,2,2,4,13,-9
25,2,3,23,16,7
25,2,4,7,18,-11
25,2,5,0,11,-11
25,2,6,4,9,-5
25,2,7,8,19,-11
25,2,8,9,20,-11
25,2,9,13,20,-7
25,2,10,5,6,-1
25,2,11,14,26,-12
25,2,12,9,10,-1
25,2,13,12,16,-4
25,2,14,6,17,-11
25,2,15,12,19,-7
25,2,16,4,15,-11
25,2,17,9,19,-10
25,2,18,13,22,-9
25,2,19,14,12,2
25,2,20,10,26,-16
25,2,21,11,24,-13
25,2,22,6,16,-10
25,2,23,7,9,-2
25,2,24,8,23,-15
25,2,25,5,8,-3
25,2,26,10,19,-9
25,2,27,3,18,-15
25,2,28,14,15,-1
25,2,29,4,14,-10
25,2,30,8,24,-16
25,2,31,8,15,-7
25,2,32,14,19,-5
25,2,33,10,19,-9
25,2,34,9,16,-7
25,2,35,10,14,-4
25,2,36,3,28,-25
25,2,37,9,25,-16
25,2,38,11,33,-22
25,2,39,9,20,-11
25,2,40,10,29,-19
25,2,41,7,11,-4
25,2,42,11,23,-12
25,2,43,6,26,-20
25,2,44,10,21,-11
25,2,45,6,21,-15
25,2,46,1,15,-14
25,2,47,10,28,-18
25,2,48,14,16,-2
25,2,49,8,19,-11
25,2,50,13,26,-13
25,2,51,10,12,-2
25,2,52,6,19,-13
25,2,53,5,22,-17
25,2,54,8,14,-6
25,2,55,11,24,-13
25,2,56,8,20,-12
25,2,57,13,19,-6
25,2,58,9,32,-23
25,2,59,5,4,1
25,2,60,6,17,-11
25,2,61,13,15,-2
25,2,62,11,23,-12
25,2,63,9,38,-29
25,2,64,14,19,-5
25,2,65,15,22,-7
25,2,66,4,22,-18
25,2,67,11,10,1
25,2,68,8,15,-7
25,2,69,5,23,-18
25,2,70,3,12,-9
25,2,71,7,10,-3
25,2,72,12,23,-11
25,2,73,5,9,-4
25,2,74,5,25,-20
25,2,75,6,12,-6
25,2,76,17,21,-4
25,2,77,14,21,-7
25,2,78,10,22,-12
25,2,79,7,8,-1
25,2,80,3,23,-20
25,2,81,4,21,-17
25,2,82,8,12,-4
25,2,83,13,13,0
25,2,84,0,21,-21
25,2,85,7,22,-15
25,2,86,10,8,2
25,2,87,5,13,-8
25,2,88,11,27,-16
25,2,89,7,26,-19
25,2,90,7,21,-14
25,2,91,6,18,-12
25,2,92,7,16,-9
25,2,93,8,14,-6
25,2,94,6,17,-11
25,2,95,12,26,-14
25,2,96,7,15,-8
25,2,97,2,32,-30
25,2,98,5,22,-17
25,2,99,4,33,-29
25,2,100,5,26,-21
25,2,101,13,11,2
25,2,102,10,13,-3
25,2,103,13,26,-13
25,2,104,18,20,-2
25,2,105,8,13,-5
25,2,106,2,19,-17
25,2,107,2,7,-5
25,2,108,15,19,-4
25,2,109,5,5,0
25,2,110,10,17,-7
25,2,111,7,18,-11
25,2,112,7,9,-2
25,2,113,21,23,-2
25,2,114,2,12,-10
25,2,115,6,27,-21
25,2,116,13,14,-1
25,2,117,15,21,-6
25,2,118,17,9,8
25,2,119,4,15,-11
25,2,120,7,11,-4
25,2,121,12,17,-5
25,2,122,6,13,-7
25,2,123,4,7,-3
25,2,124,12,15,-3
25,2,125,8,27,-19
25,2,126,3,14,-11
25,2,127,4,24,-20
25,2,128,0,14,-14
25,2,129,8,11,-3
25,2,130,9,21,-12
25,2,131,10,20,-10
25,2,132,4,19,-15
25,2,133,5,15,-10
25,2,134,7,18,-11
25,2,135,4,36,-32
25,2,136,16,25,-9
25,2,137,6,16,-10
25,2,138,7,18,-11
25,2,139,4,11,-7
25,2,140,9,28,-19
25,2,141,5,15,-10
25,2,142,6,17,-11
25,2,143,10,22,-12
25,2,144,2,2,0
25,2,145,7,18,-11
25,2,146,15,15,0
25,2,147,11,14,-3
25,2,148,3,14,-11
25,2,149,3,4,-1
25,2,150,6,10,-4
25,2,151,0,12,-12
25,2,152,11,24,-13
25,2,153,7,19,-12
25,2,154,9,8,1
25,2,155,4,18,-14
25,2,156,10,32,-22
25,2,157,17,43,-26
25,2,158,9,9,0
25,2,159,11,19,-8
25,2,160,3,20,-17
25,2,161,6,8,-2
25,2,162,5,13,-8
25,2,163,0,1,-1
25,2,164,2,17,-15
25,2,165,5,8,-3
25,2,166,14,21,-7
25,2,167,15,17,-2
25,2,168,6,9,-3
25,2,169,17,19,-2
25,2,170,9,18,-9
25,2,171,10,28,-18
25,2,172,7,14,-7
25,2,173,8,19,-11
25,2,174,6,32,-26
25,2,175,5,22,-17
25,2,176,9,18,-9
25,2,177,9,18,-9
25,2,178,6,18,-12
25,2,179,8,21,-13
25,2,180,7,14,-7
25,2,181,3,17,-14
25,2,182,10,15,-5
25,2,183,17,34,-17
25,2,184,2,3,-1
25,2,185,12,25,-13
25,2,186,14,30,-16
25,2,187,10,15,-5
25,2,188,2,16,-14
25,2,189,6,12,-6
25,2,190,5,25,-20
25,2,191,2,19,-17
25,2,192,8,19,-11
25,2,193,12,15,-3
25,2,194,2,16,-14
25,2,195,9,18,-9
25,2,196,10,17,-7
25,2,197,4,17,-13
25,2,198,3,21,-18
25,2,199,13,4,9
25,2,200,7,10,-3
25,2,201,4,10,-6
25,2,202,10,12,-2
25,2,203,10,12,-2
25,2,204,14,22,-8
25,2,205,6,21,-15
25,2,206,9,23,-14
25,2,207,6,24,-18
25,2,208,20,31,-11
25,2,209,11,17,-6
25,2,210,9,20,-11
25,2,211,7,17,-10
25,2,212,12,19,-7
25,2,213,12,19,-7
25,2,214,24,24,0
25,2,215,15,13,2
25,2,216,8,29,-21
25,2,217,4,20,-16
25,2,218,17,23,-6
25,2,219,6,21,-15
25,2,220,9,23,-14
25,2,221,5,9,-4
25,2,222,7,5,2
25,2,223,9,9,0
25,2,224,10,23,-13
25,2,225,5,28,-23
25,2,226,6,27,-21
25,2,227,5,5,0
25,2,228,15,36,-21
25,2,229,6,10,-4
25,2,230,3,13,-10
25,2,231,10,21,-11
25,2,232,6,28,-22
25,2,233,5,24,-19
25,2,234,8,25,-17
25,2,235,10,22,-12
25,2,236,8,24,-16
25,2,237,2,10,-8
25,2,238,7,26,-19
25,2,239,4,17,-13
25,2,240,8,22,-14
25,2,241,7,21,-14
25,2,242,0,10,-10
25,2,243,6,22,-16
25,2,244,14,15,-1
25,2,245,4,14,-10
25,2,246,7,31,-24
25,2,247,1,13,-12
25,2,248,10,19,-9
25,2,249,9,29,-20
25,2,250,6,14,-8
25,2,251,4,15,-11
25,2,252,9,32,-23
25,2,253,18,34,-16
25,2,254,2,11,-9
25,2,255,0,5,-5
25,2,256,10,31,-21
25,2,257,4,13,-9
25,2,258,4,15,-11
25,2,259,10,18,-8
25,2,260,15,21,-6
25,2,261,7,17,-10
25,2,262,6,26,-20
25,2,263,10,25,-15
25,2,264,9,19,-10
25,2,265,6,22,-16
25,2,266,1,18,-17
25,2,267,11,29,-18
25,2,268,11,16,-5
25,2,269,9,11,-2
25,2,270,11,19,-8
25,2,271,5,25,-20
25,2,272,13,12,1
25,2,273,6,29,-23
25,2,274,7,11,-4
25,2,275,18,16,2
25,2,276,8,13,-5
25,2,277,8,33,-25
25,2,278,7,14,-7
25,2,279,7,20,-13
25,2,280,4,15,-11
25,2,281,8,24,-16
25,2,282,8,16,-8
25,2,283,4,9,-5
25,2,284,6,15,-9
25,2,285,6,16,-10
25,2,286,9,21,-12
25,2,287,10,14,-4
25,2,288,4,18,-14
25,2,289,17,29,-12
25,2,290,14,21,-7
25,2,291,5,11,-6
25,2,292,6,26,-20
25,2,293,9,18,-9
25,2,294,6,15,-9
25,2,295,14,19,-5
25,2,296,2,19,-17
25,2,297,14,22,-8
25,2,298,4,11,-7
25,2,299,11,30,-19
25,3,0,7,13,-6
25,3,1,10,24,-14
25,3,2,8,15,-7
25,3,3,12,19,-7
25,3,4,5,20,-15
25,3,5,12,22,-10
25,3,6,12,11,1
25,3,7,6,16,-10
25,3,8,6,14,-8
25,3,9,4,17,-13
25,3,10,3,5,-2
25,3,11,4,20,-16
25,3,12,4,14,-10
25,3,13,12,21,-9
25,3,14,7,12,-5
25,3,15,10,43,-33
25,3,16,10,22,-12
25,3,17,7,28,-21
25,3,18,4,9,-5
25,3,19,1,29,-28
25,3,20,14,15,-1
25,3,21,4,21,-17
25,3,22,11,25,-14
25,3,23,8,11,-3
25,3,24,12,19,-7
25,3,25,8,12,-4
25,3,26,9,16,-7
25,3,27,3,23,-20
25,3,28,1,7,-6
25,3,29,6,12,-6
25,3,30,16,29,-13
25,3,31,8,28,-20
25,3,32,12,22,-10
25,3,33,9,31,-22
25,3,34,6,14,-8
25,3,35,8,18,-10
25,3,36,9,28,-19
25,3,37,9,22,-13
25,3,38,9,27,-18
25,3,39,5,11,-6
25,3,40,3,25,-22
25,3,41,8,21,-13
25,3,42,5,18,-13
25,3,43,5,20,-15
25,3,44,9,27,-18
25,3,45,1,16,-15
25,3,46,12,41,-29
25,3,47,4,24,-20
25,3,48,21,17,4
25,3,49,3,21,-18
25,3,50,8,22,-14
25,3,51,6,15,-9
25,3,52,10,21,-11
25,3,53,10,27,-17
25,3,54,13,35,-22
25,3,55,3,12,-9
25,3,56,19,20,-1
25,3,57,6,18,-12
25,3,58,8,32,-24
25,3,59,11,14,-3
25,3,60,11,21,-10
25,3,61,13,22,-9
25,3,62,22,21,1
25,3,63,2,20,-18
25,3,64,8,15,-7
25,3,65,9,14,-5
25,3,66,9,29,-20
25,3,67,10,20,-10
25,3,68,7,21,-14
25,3,69,7,18,-11
25,3,70,11,24,-13
25,3,71,9,12,-3
25,3,72,8,9,-1
25,3,73,9,16,-7
25,3,74,17,20,-3
25,3,75,10,16,-6
25,3,76,4,23,-19
25,3,77,6,8,-2
25,3,78,9,27,-18
25,3,79,11,18,-7
25,3,80,10,16,-6
25,3,81,9,20,-11
25,3,82,2,14,-12
25,3,83,17,12,5
25,3,84,5,15,-10
25,3,85,10,19,-9
25,3,86,12,26,-14
25,3,87,9,25,-16
25,3,88,5,27,-22
25,3,89,7,15,-8
25,3,90,7,20,-13
25,3,91,9,22,-13
25,3,92,9,9,0
25,3,93,4,14,-10
25,3,94,10,16,-6
25,3,95,6,19,-13
25,3,96,10,16,-6
25,3,97,15,25,-10
25,3,98,2,19,-17
25,3,99,22,33,-11
25,3,100,5,21,-16
25,3,101,2,22,-20
25,3,102,8,19,-11
25,3,103,9,14,-5
25,3,104,14,34,-20
25,3,105,9,26,-17
25,3,106,11,10,1
25,3,107,6,16,-10
25,3,108,9,18,-9
25,3,109,13,19,-6
25,3,110,9,10,-1
25,3,111,2,19,-17
25,3,112,9,21,-12
25,3,113,12,20,-8
25,3,114,11,27,-16
25,3,115,7,17,-10
25,3,116,13,13,0
25,3,117,10,11,-1
25,3,118,15,23,-8
25,3,119,8,23,-15
25,3,120,9,29,-20
25,3,121,16,16,0
25,3,122,14,22,-8
25,3,123,10,22,-12
25,3,124,6,37,-31
25,3,125,7,13,-6
25,3,126,11,16,-5
25,3,127,7,14,-7
25,3,128,7,18,-11
25,3,129,18,27,-9
25,3,130,4,20,-16
25,3,131,9,20,-11
25,3,132,10,10,0
25,3,133,10,20,-10
25,3,134,5,17,-12
25,3,135,14,14,0
25,3,136,9,19,-10
25,3,137,8,16,-8
25,3,138,5,20,-15
25,3,139,15,12,3
25,3,140,12,21,-9
25,3,141,12,29,-17
25,3,142,15,28,-13
25,3,143,4,31,-27
25,3,144,12,32,-20
25,3,145,10,15,-5
25,3,146,3,27,-24
25,3,147,6,14,-8
25,3,148,6,16,-10
25,3,149,13,20,-7
25,3,150,13,22,-9
25,3,151,9,19,-10
25,3,152,4,9,-5
25,3,153,8,33,-25
25,3,154,13,27,-14
25,3,155,7,15,-8
25,3,156,3,14,-11
25,3,157,12,18,-6
25,3,158,4,14,-10
25,3,159,9,25,-16
25,3,160,9,33,-24
25,3,161,10,17,-7
25,3,162,12,46,-34
25,3,163,4,21,-17
25,3,164,13,22,-9
25,3,165,8,16,-8
25,3,166,13,13,0
25,3,167,6,18,-12
25,3,168,9,25,-16
25,3,169,5,7,-2
25,3,170,12,17,-5
25,3,171,7,17,-10
25,3,172,13,23,-10
25,3,173,8,17,-9
25,3,174,5,18,-13
25,3,175,28,19,9
25,3,176,12,22,-10
25,3,177,13,14,-1
25,3,178,9,29,-20
25,3,179,7,24,-17
25,3,180,11,18,-7
25,3,181,6,22,-16
25,3,182,14,21,-7
25,3,183,9,14,-5
25,3,184,6,20,-14
25,3,185,17,15,2
25,3,186,11,11,0
25,3,187,9,16,-7
25,3,188,8,19,-11
25,3,189,5,23,-18
25,3,190,9,9,0
25,3,191,4,19,-15
25,3,192,19,30,-11
25,3,193,13,25,-12
25,3,194,6,25,-19
25,3,195,3,15,-12
25,3,196,22,30,-8
25,3,197,8,10,-2
25,3,198,11,13,-2
25,3,199,5,14,-9
25,3,200,8,25,-17
25,3,201,11,28,-17
25,3,202,8,11,-3
25,3,203,4,18,-14
25,3,204,14,13,1
25,3,205,11,18,-7
25,3,206,12,29,-17
25,3,207,13,26,-13
25,3,208,6,25,-19
25,3,209,3,7,-4
25,3,210,2,23,-21
25,3,211,8,21,-13
25,3,212,5,25,-20
25,3,213,16,20,-4
25,3,214,12,14,-2
25,3,215,10,11,-1
25,3,216,4,23,-19
25,3,217,6,8,-2
25,3,218,4,7,-3
25,3,219,8,13,-5
25,3,220,8,23,-15
25,3,221,1,17,-16
25,3,222,14,25,-11
25,3,223,1,26,-25
25,3,224,7,18,-11
25,3,225,15,31,-16
25,3,226,11,14,-3
25,3,227,13,18,-5
25,3,228,0,20,-20
25,3,229,15,14,1
25,3,230,10,13,-3
25,3,231,3,24,-21
25,3,232,7,14,-7
25,3,233,11,19,-8
25,3,234,15,27,-12
25,3,235,14,25,-11
25,3,236,7,22,-15
25,3,237,6,26,-20
25,3,238,7,18,-11
25,3,239,10,9,1
25,3,240,6,16,-10
25,3,241,6,14,-8
25,3,242,4,18,-14
25,3,243,13,21,-8
25,3,244,2,17,-15
25,3,245,7,17,-10
25,3,246,7,13,-6
25,3,247,10,23,-13
25,3,248,16,16,0
25,3,249,8,38,-30
25,3,250,7,16,-9
25,3,251,11,14,-3
25,3,252,3,33,-30
25,3,253,5,18,-13
25,3,254,8,24,-16
25,3,255,5,13,-8
25,3,256,3,24,-21
25,3,257,8,11,-3
25,3,258,15,21,-6
25,3,259,16,22,-6
25,3,260,7,8,-1
25,3,261,4,16,-12
25,3,262,12,12,0
25,3,263,8,10,-2
25,3,264,9,12,-3
25,3,265,11,11,0
25,3,266,17,21,-4
25,3,267,8,26,-18
25,3,268,11,18,-7
25,3,269,7,16,-9
25,3,270,16,20,-4
25,3,271,3,15,-12
25,3,272,12,23,-11
25,3,273,2,19,-17
25,3,274,9,7,2
25,3,275,8,18,-10
25,3,276,5,22,-17
25,3,277,3,27,-24
25,3,278,14,23,-9
25,3,279,14,13,1
25,3,280,10,17,-7
25,3,281,9,24,-15
25,3,282,5,24,-19
25,3,283,12,29,-17
25,3,284,14,21,-7
25,3,285,13,20,-7
25,3,286,1,16,-15
25,3,287,10,20,-10
25,3,288,14,19,-5
25,3,289,13,23,-10
25,3,290,18,22,-4
25,3,291,7,18,-11
25,3,292,15,29,-14
25,3,293,13,22,-9
25,3,294,18,37,-19
25,3,295,6,11,-5
25,3,296,10,12,-2
25,3,297,14,14,0
25,3,298,5,17,-12
25,3,299,13,22,-9
25,4,0,13,20,-7
25,4,1,2,6,-4
25,4,2,9,9,0
25,4,3,12,22,-10
25,4,4,10,16,-6
25,4,5,7,20,-13
25,4,6,6,25,-19
25,4,7,5,12,-7
25,4,8,6,26,-20
25,4,9,12,13,-1
25,4,10,9,23,-14
25,4,11,6,23,-17
25,4,12,13,18,-5
25,4,13,8,12,-4
25,4,14,11,26,-15
25,4,15,10,15,-5
25,4,16,4,16,-12
25,4,17,6,22,-16
25,4,18,8,5,3
25,4,19,13,10,3
25,4,20,10,28,-18
25,4,21,11,19,-8
25,4,22,5,14,-9
25,4,23,15,46,-31
25,4,24,1,16,-15
25,4,25,13,21,-8
25,4,26,12,22,-10
25,4,27,12,19,-7
25,4,28,15,25,-10
25,4,29,3,15,-12
25,4,30,5,23,-18
25,4,31,4,8,-4
25,4,32,9,22,-13
25,4,33,3,12,-9
25,4,34,11,9,2
25,4,35,5,21,-16
25,4,36,8,13,-5
25,4,37,8,26,-18
25,4,38,5,17,-12
25,4,39,13,29,-16
25,4,40,3,10,-7
25,4,41,15,17,-2
25,4,42,16,27,-11
25,4,43,9,13,-4
25,4,44,6,20,-14
25,4,45,11,17,-6
25,4,46,9,18,-9
25,4,47,12,22,-10
25,4,48,18,18,0
25,4,49,7,15,-8
25,4,50,17,23,-6
25,4,51,8,18,-10
25,4,52,12,26,-14
25,4,53,9,24,-15
25,4,54,18,22,-4
25,4,55,5,21,-16
25,4,56,7,14,-7
25,4,57,17,25,-8
25,4,58,5,15,-10
25,4,59,4,28,-24
25,4,60,6,19,-13
25,4,61,6,26,-20
25,4,62,11,40,-29
25,4,63,14,20,-6
25,4,64,6,16,-10
25,4,65,24,25,-1
25,4,66,5,11,-6
25,4,67,8,29,-21
25,4,68,13,23,-10
25,4,69,9,13,-4
25,4,70,5,22,-17
25,4,71,2,20,-18
25,4,72,7,30,-23
25,4,73,5,22,-17
25,4,74,6,25,-19
25,4,75,3,14,-11
25,4,76,9,21,-12
25,4,77,17,27,-10
25,4,78,3,16,-13
25,4,79,22,13,9
25,4,80,6,18,-12
25,4,81,6,16,-10
25,4,82,13,22,-9
25,4,83,6,20,-14
25,4,84,9,21,-12
25,4,85,5,14,-9
25,4,86,6,14,-8
25,4,87,10,22,-12
25,4,88,15,20,-5
25,4,89,8,11,-3
25,4,90,5,16,-11
25,4,91,4,22,-18
25,4,92,4,35,-31
25,4,93,9,19,-10
25,4,94,18,28,-10
25,4,95,8,11,-3
25,4,96,10,12,-2
25,4,97,5,17,-12
25,4,98,10,14,-4
25,4,99,10,15,-5
25,4,100,13,24,-11
25,4,101,14,24,-10
25,4,102,8,44,-36
25,4,103,13,23,-10
25,4,104,8,26,-18
25,4,105,7,20,-13
25,4,106,11,26,-15
25,4,107,14,11,3
25,4,108,22,16,6
25,4,109,7,14,-7
25,4,110,6,23,-17
25,4,111,11,24,-13
25,4,112,3,11,-8
25,4,113,14,29,-15
25,4,114,6,15,-9
25,4,115,14,16,-2
25,4,116,8,17,-9
25,4,117,4,15,-11
25,4,118,10,19,-9
25,4,119,8,38,-30
25,4,120,8,24,-16
25,4,121,14,27,-13
25,4,122,9,11,-2
25,4,123,1,10,-9
25,4,124,8,14,-6
25,4,125,9,15,-6
25,4,126,6,21,-15
25,4,127,21,39,-18
25,4,128,8,21,-13
25,4,129,5,23,-18
25,4,130,21,20,1
25,4,131,12,28,-16
25,4,132,11,7,4
25,4,133,4,13,-9
25,4,134,5,22,-17
25,4,135,19,17,2
25,4,136,19,31,-12
25,4,137,7,8,-1
25,4,138,13,24,-11
25,4,139,22,16,6
25,4,140,16,20,-4
25,4,141,13,15,-2
25,4,142,5,9,-4
25,4,143,8,28,-20
25,4,144,5,10,-5
25,4,145,9,21,-12
25,4,146,4,15,-11
25,4,147,7,17,-10
25,4,148,2,11,-9
25,4,149,20,22,-2
25,4,150,8,29,-21
25,4,151,5,17,-12
25,4,152,9,22,-13
25,4,153,13,10,3
25,4,154,9,11,-2
25,4,155,12,17,-5
25,4,156,7,7,0
25,4,157,9,28,-19
25,4,158,11,30,-19
25,4,159,3,21,-18
25,4,160,10,16,-6
25,4,161,7,17,-10
25,4,162,5,19,-14
25,4,163,9,24,-15
25,4,164,6,36,-30
25,4,165,2,7,-5
25,4,166,11,37,-26
25,4,167,19,22,-3
25,4,168,11,12,-1
25,4,169,9,11,-2
25,4,170,20,14,6
25,4,171,6,6,0
25,4,172,3,29,-26
25,4,173,21,22,-1
25,4,174,12,35,-23
25,4,175,4,11,-7
25,4,176,6,14,-8
25,4,177,10,26,-16
25,4,178,9,18,-9
25,4,179,16,40,-24
25,4,180,8,16,-8
25,4,181,17,20,-3
25,4,182,11,20,-9
25,4,183,9,22,-13
25,4,184,11,19,-8
25,4,185,7,12,-5
25,4,186,8,23,-15
25,4,187,12,27,-15
25,4,188,6,33,-27
25,4,189,6,5,1
25,4,190,17,25,-8
25,4,191,8,16,-8
25,4,192,13,21,-8
25,4,193,5,12,-7
25,4,194,8,19,-11
25,4,195,10,15,-5
25,4,196,8,12,-4
25,4,197,4,7,-3
25,4,198,7,19,-12
25,4,199,10,13,-3
25,4,200,20,26,-6
25,4,201,6,31,-25
25,4,202,10,11,-1
25,4,203,13,21,-8
25,4,204,14,18,-4
25,4,205,10,22,-12
25,4,206,3,9,-6
25,4,207,9,23,-14
25,4,208,8,41,-33
25,4,209,4,9,-5
25,4,210,6,33,-27
25,4,211,4,14,-10
25,4,212,6,25,-19
25,4,213,4,15,-11
25,4,214,7,11,-4
25,4,215,8,22,-14
25,4,216,11,22,-11
25,4,217,13,18,-5
25,4,218,6,22,-16
25,4,219,9,12,-3
25,4,220,1,17,-16
25,4,221,16,23,-7
25,4,222,8,22,-14
25,4,223,10,20,-10
25,4,224,8,16,-8
25,4,225,9,26,-17
25,4,226,14,22,-8
25,4,227,11,19,-8
25,4,228,8,31,-23
25,4,229,9,22,-13
25,4,230,20,32,-12
25,4,231,11,24,-13
25,4,232,3,12,-9
25,4,233,7,9,-2
25,4,234,13,37,-24
25,4,235,1,10,-9
25,4,236,10,29,-19
25,4,237,1,16,-15
25,4,238,10,20,-10
25,4,239,16,21,-5
25,4,240,21,33,-12
25,4,241,14,20,-6
25,4,242,10,21,-11
25,4,243,9,19,-10
25,4,244,11,18,-7
25,4,245,6,6,0
25,4,246,13,36,-23
25,4,247,15,18,-3
25,4,248,4,16,-12
25,4,249,3,12,-9
25,4,250,14,20,-6
25,4,251,9,18,-9
25,4,252,7,9,-2
25,4,253,14,21,-7
25,4,254,15,18,-3
25,4,255,5,22,-17
25,4,256,12,5,7
25,4,257,6,10,-4
25,4,258,10,10,0
25,4,259,8,23,-15
25,4,260,22,34,-12
25,4,261,14,18,-4
25,4,262,10,24,-14
25,4,263,13,32,-19
25,4,264,9,21,-12
25,4,265,6,15,-9
25,4,266,14,37,-23
25,4,267,7,9,-2
25,4,268,10,27,-17
25,4,269,6,19,-13
25,4,270,7,35,-28
25,4,271,15,20,-5
25,4,272,17,18,-1
25,4,273,4,12,-8
25,4,274,14,20,-6
25,4,275,8,23,-15
25,4,276,12,21,-9
25,4,277,9,31,-22
25,4,278,8,23,-15
25,4,279,7,19,-12
25,4,280,14,19,-5
25,4,281,14,15,-1
25,4,282,21,22,-1
25,4,283,5,15,-10
25,4,284,11,18,-7
25,4,285,3,17,-14
25,4,286,19,24,-5
25,4,287,11,22,-11
25,4,288,8,13,-5
25,4,289,0,8,-8
25,4,290,9,24,-15
25,4,291,1,15,-14
25,4,292,14,19,-5
25,4,293,13,26,-13
25,4,294,8,28,-20
25,4,295,7,18,-11
25,4,296,7,34,-27
25,4,297,7,17,-10
25,4,298,1,15,-14
25,4,299,3,31,-28
25,5,0,19,37,-18
25,5,1,8,20,-12
25,5,2,14,25,-11
25,5,3,6,12,-6
25,5,4,19,37,-18
25,5,5,17,34,-17
25,5,6,13,20,-7
25,5,7,16,31,-15
25,5,8,5,14,-9
25,5,9,5,15,-10
25,5,10,4,20,-16
25,5,11,14,37,-23
25,5,12,2,27,-25
25,5,13,9,27,-18
25,5,14,1,13,-12
25,5,15,19,22,-3
25,5,16,13,10,3
25,5,17,10,32,-22
25,5,18,20,17,3
25,5,19,9,20,-11
25,5,20,11,33,-22
25,5,21,12,20,-8
25,5,22,6,19,-13
25,5,23,7,24,-17
25,5,24,6,14,-8
25,5,25,7,8,-1
25,5,26,5,18,-13
25,5,27,11,15,-4
25,5,28,6,14,-8
25,5,29,1,14,-13
25,5,30,5,34,-29
25,5,31,11,25,-14
25,5,32,9,32,-23
25,5,33,10,26,-16
25,5,34,11,17,-6
25,5,35,10,37,-27
25,5,36,18,27,-9
25,5,37,5,8,-3
25,5,38,6,16,-10
25,5,39,12,32,-20
25,5,40,16,34,-18
25,5,41,8,35,-27
25,5,42,1,15,-14
25,5,43,12,37,-25
25,5,44,6,24,-18
25,5,45,10,27,-17
25,5,46,4,11,-7
25,5,47,10,20,-10
25,5,48,7,21,-14
25,5,49,13,26,-13
25,5,50,7,38,-31
25,5,51,12,30,-18
25,5,52,3,18,-15
25,5,53,10,23,-13
25,5,54,18,37,-19
25,5,55,10,22,-12
25,5,56,11,40,-29
25,5,57,12,34,-22
25,5,58,12,13,-1
25,5,59,7,8,-1
25,5,60,6,29,-23
25,5,61,11,9,2
25,5,62,5,27,-22
25,5,63,11,23,-12
25,5,64,4,32,-28
25,5,65,9,18,-9
25,5,66,12,29,-17
25,5,67,4,26,-22
25,5,68,7,19,-12
25,5,69,8,24,-16
25,5,70,6,14,-8
25,5,71,5,12,-7
25,5,72,9,18,-9
25,5,73,13,22,-9
25,5,74,11,15,-4
25,5,75,11,24,-13
25,5,76,4,16,-12
25,5,77,8,21,-13
25,5,78,9,25,-16
25,5,79,8,14,-6
25,5,80,10,13,-3
25,5,81,11,16,-5
25,5,82,8,14,-6
25,5,83,10,25,-15
25,5,84,8,22,-14
25,5,85,3,3,0
25,5,86,5,22,-17
25,5,87,7,11,-4
25,5,88,11,13,-2
25,5,89,3,13,-10
25,5,90,8,24,-16
25,5,91,14,8,6
25,5,92,10,15,-5
25,5,93,13,32,-19
25,5,94,9,18,-9
25,5,95,7,14,-7
25,5,96,6,15,-9
25,5,97,10,43,-33
25,5,98,6,18,-12
25,5,99,8,14,-6
25,5,100,6,16,-10
25,5,101,12,36,-24
25,5,102,17,42,-25
25,5,103,10,14,-4
25,5,104,9,4,5
25,5,105,5,28,-23
25,5,106,14,24,-10
25,5,107,9,20,-11
25,5,108,11,34,-23
25,5,109,7,18,-11
25,5,110,2,20,-18
25,5,111,11,30,-19
25,5,112,12,15,-3
25,5,113,7,15,-8
25,5,114,7,10,-3
25,5,115,6,21,-15
25,5,116,6,21,-15
25,5,117,5,11,-6
25,5,118,12,23,-11
25,5,119,19,22,-3
25,5,120,7,18,-11
25,5,121,12,10,2
25,5,122,5,9,-4
25,5,123,12,28,-16
25,5,124,5,17,-12
25,5,125,5,24,-19
25,5,126,14,23,-9
25,5,127,6,17,-11
25,5,128,9,23,-14
25,5,129,4,17,-13
25,5,130,6,26,-20
25,5,131,5,15,-10
25,5,132,11,34,-23
25,5,133,9,29,-20
25,5,134,9,20,-11
25,5,135,17,29,-12
25,5,136,6,21,-15
25,5,137,17,22,-5
25,5,138,3,10,-7
25,5,139,15,21,-6
25,5,140,8,15,-7
25,5,141,7,21,-14
25,5,142,13,20,-7
25,5,143,7,21,-14
25,5,144,15,20,-5
25,5,145,3,19,-16
25,5,146,16,28,-12
25,5,147,13,28,-15
25,5,148,11,34,-23
25,5,149,2,26,-24
25,5,150,5,11,-6
25,5,151,10,18,-8
25,5,152,13,14,-1
25,5,153,13,14,-1
25,5,154,14,25,-11
25,5,155,4,15,-11
25,5,156,11,21,-10
25,5,157,1,12,-11
25,5,158,15,25,-10
25,5,159,13,22,-9
25,5,160,1,19,-18
25,5,161,2,18,-16
25,5,162,11,23,-12
25,5,163,5,27,-22
25,5,164,10,26,-16
25,5,165,13,22,-9
25,5,166,6,14,-8
25,5,167,7,36,-29
25,5,168,2,10,-8
25,5,169,7,21,-14
25,5,170,10,33,-23
25,5,171,14,18,-4
25,5,172,7,16,-9
25,5,173,14,19,-5
25,5,174,9,15,-6
25,5,175,5,16,-11
25,5,176,11,22,-11
25,5,177,4,21,-17
25,5,178,6,13,-7
25,5,179,13,35,-22
25,5,180,6,19,-13
25,5,181,5,18,-13
25,5,182,6,14,-8
25,5,183,18,8,10
25,5,184,4,15,-11
25,5,185,12,40,-28
25,5,186,8,16,-8
25,5,187,6,16,-10
25,5,188,14,7,7
25,5,189,14,17,-3
25,5,190,14,16,-2
25,5,191,4,15,-11
25,5,192,8,16,-8
25,5,193,6,24,-18
25,5,194,5,21,-16
25,5,195,7,11,-4
25,5,196,13,43,-30
25,5,197,8,23,-15
25,5,198,13,23,-10
25,5,199,9,12,-3
25,5,200,11,24,-13
25,5,201,6,16,-10
25,5,202,14,27,-13
25,5,203,9,33,-24
25,5,204,31,30,1
25,5,205,9,9,0
25,5,206,13,33,-20
25,5,207,4,9,-5
25,5,208,4,8,-4
25,5,209,17,25,-8
25,5,210,10,26,-16
25,5,211,12,26,-14
25,5,212,7,18,-11
25,5,213,3,12,-9
25,5,214,6,36,-30
25,5,215,17,29,-12
25,5,216,2,12,-10
25,5,217,6,42,-36
25,5,218,18,36,-18
25,5,219,6,19,-13
25,5,220,4,25,-21
25,5,221,4,12,-8
25,5,222,14,19,-5
25,5,223,6,13,-7
25,5,224,3,21,-18
25,5,225,3,36,-33
25,5,226,1,6,-5
25,5,227,10,25,-15
25,5,228,20,23,-3
25,5,229,12,26,-14
25,5,230,4,18,-14
25,5,231,2,19,-17
25,5,232,7,30,-23
25,5,233,12,34,-22
25,5,234,9,26,-17
25,5,235,11,14,-3
25,5,236,9,27,-18
25,5,237,6,14,-8
25,5,238,10,16,-6
25,5,239,8,29,-21
25,5,240,7,19,-12
25,5,241,6,16,-10
25,5,242,0,12,-12
25,5,243,10,14,-4
25,5,244,9,19,-10
25,5,245,8,18,-10
25,5,246,10,24,-14
25,5,247,15,45,-30
25,5,248,8,24,-16
25,5,249,5,15,-10
25,5,250,15,29,-14
25,5,251,10,28,-18
25,5,252,6,11,-5
25,5,253,7,11,-4
25,5,254,8,14,-6
25,5,255,12,36,-24
25,5,256,8,30,-22
25,5,257,10,21,-11
25,5,258,12,23,-11
25,5,259,12,11,1
25,5,260,20,25,-5
25,5,261,5,16,-11
25,5,262,9,18,-9
25,5,263,10,45,-35
25,5,264,2,8,-6
25,5,265,4,11,-7
25,5,266,7,18,-11
25,5,267,6,23,-17
25,5,268,6,15,-9
25,5,269,4,25,-21
25,5,270,16,29,-13
25,5,271,12,25,-13
25,5,272,10,14,-4
25,5,273,11,15,-4
25,5,274,8,12,-4
25,5,275,6,22,-16
25,5,276,14,26,-12
25,5,277,8,18,-10
25,5,278,4,18,-14
25,5,279,14,25,-11
25,5,280,8,16,-8
25,5,281,15,30,-15
25,5,282,8,15,-7
25,5,283,10,30,-20
25,5,284,8,13,-5
25,5,285,2,26,-24
25,5,286,21,20,1
25,5,287,8,14,-6
25,5,288,3,23,-20
25,5,289,8,11,-3
25,5,290,4,11,-7
25,5,291,12,32,-20
25,5,292,13,22,-9
25,5,293,11,27,-16
25,5,294,9,11,-2
25,5,295,10,20,-10
25,5,296,12,25,-13
25,5,297,4,19,-15
25,5,298,9,23,-14
25,5,299,3,8,-5
25,6,0,12,29,-17
25,6,1,9,19,-10
25,6,2,10,18,-8
25,6,3,13,21,-8
25,6,4,9,15,-6
25,6,5,12,25,-13
25,6,6,7,26,-19
25,6,7,5,27,-22
25,6,8,12,15,-3
25,6,9,14,11,3
25,6,10,8,29,-21
25,6,11,9,15,-6
25,6,12,6,17,-11
25,6,13,6,13,-7
25,6,14,8,19,-11
25,6,15,10,18,-8
25,6,16,6,17,-11
25,6,17,12,22,-10
25,6,18,13,17,-4
25,6,19,15,25,-10
25,6,20,12,39,-27
25,6,21,8,9,-1
25,6,22,8,28,-20
25,6,23,7,4,3
25,6,24,14,19,-5
25,6,25,10,38,-28
25,6,26,13,16,-3
25,6,27,3,21,-18
25,6,28,4,25,-21
25,6,29,22,21,1
25,6,30,8,12,-4
25,6,31,9,33,-24
25,6,32,3,20,-17
25,6,33,9,18,-9
25,6,34,12,26,-14
25,6,35,10,15,-5
25,6,36,18,15,3
25,6,37,7,21,-14
25,6,38,12,21,-9
25,6,39,14,25,-11
25,6,40,2,18,-16
25,6,41,7,26,-19
25,6,42,3,7,-4
25,6,43,11,12,-1
25,6,44,12,26,-14
25,6,45,6,24,-18
25,6,46,15,22,-7
25,6,47,14,23,-9
25,6,48,9,11,-2
25,6,49,10,18,-8
25,6,50,5,18,-13
25,6,51,6,27,-21
25,6,52,15,12,3
25,6,53,5,28,-23
25,6,54,13,18,-5
25,6,55,5,16,-11
25,6,56,8,14,-6
25,6,57,3,17,-14
25,6,58,10,19,-9
25,6,59,5,21,-16
25,6,60,9,17,-8
25,6,61,10,28,-18
25,6,62,3,23,-20
25,6,63,7,16,-9
25,6,64,11,29,-18
25,6,65,10,18,-8
25,6,66,10,18,-8
25,6,67,9,17,-8
25,6,68,15,26,-11
25,6,69,19,26,-7
25,6,70,12,32,-20
25,6,71,13,20,-7
25,6,72,11,11,0
25,6,73,16,33,-17
25,6,74,5,21,-16
25,6,75,10,34,-24
25,6,76,6,24,-18
25,6,77,11,19,-8
25,6,78,10,25,-15
25,6,79,7,41,-34
25,6,80,4,12,-8
25,6,81,5,24,-19
25,6,82,14,20,-6
25,6,83,9,27,-18
25,6,84,10,27,-17
25,6,85,9,30,-21
25,6,86,9,26,-17
25,6,87,10,21,-11
25,6,88,16,35,-19
25,6,89,8,26,-18
25,6,90,11,22,-11
25,6,91,13,19,-6
25,6,92,14,18,-4
25,6,93,17,19,-2
25,6,94,8,20,-12
25,6,95,7,37,-30
25,6,96,19,23,-4
25,6,97,4,20,-16
25,6,98,0,7,-7
25,6,99,10,19,-9
25,6,100,12,24,-12
25,6,101,9,15,-6
25,6,102,12,15,-3
25,6,103,3,18,-15
25,6,104,7,18,-11
25,6,105,14,18,-4
25,6,106,5,14,-9
25,6,107,11,30,-19
25,6,108,8,15,-7
25,6,109,9,21,-12
25,6,110,10,20,-10
25,6,111,5,11,-6
25,6,112,13,28,-15
25,6,113,18,31,-13
25,6,114,7,12,-5
25,6,115,11,18,-7
25,6,116,12,18,-6
25,6,117,5,23,-18
25,6,118,19,32,-13
25,6,119,6,42,-36
25,6,120,12,27,-15
25,6,121,7,11,-4
25,6,122,8,21,-13
25,6,123,9,31,-22
25,6,124,8,36,-28
25,6,125,6,17,-11
25,6,126,6,12,-6
25,6,127,9,12,-3
25,6,128,13,18,-5
25,6,129,13,21,-8
25,6,130,3,12,-9
25,6,131,9,25,-16
25,6,132,6,13,-7
25,6,133,9,31,-22
25,6,134,12,15,-3
25,6,135,14,37,-23
25,6,136,6,15,-9
25,6,137,7,14,-7
25,6,138,4,32,-28
25,6,139,10,20,-10
25,6,140,7,24,-17
25,6,141,11,30,-19
25,6,142,12,15,-3
25,6,143,17,22,-5
25,6,144,4,24,-20
25,6,145,18,27,-9
25,6,146,11,23,-12
25,6,147,8,20,-12
25,6,148,8,14,-6
25,6,149,7,19,-12
25,6,150,2,17,-15
25,6,151,2,17,-15
25,6,152,10,19,-9
25,6,153,11,17,-6
25,6,154,4,19,-15
25,6,155,5,11,-6
25,6,156,13,16,-3
25,6,157,13,17,-4
25,6,158,5,3,2
25,6,159,2,12,-10
25,6,160,6,10,-4
25,6,161,19,25,-6
25,6,162,8,16,-8
25,6,163,5,22,-17
25,6,164,10,18,-8
25,6,165,9,23,-14
25,6,166,14,15,-1
25,6,167,9,18,-9
25,6,168,8,22,-14
25,6,169,9,15,-6
25,6,170,13,33,-20
25,6,171,13,22,-9
25,6,172,12,31,-19
25,6,173,5,20,-15
25,6,174,8,5,3
25,6,175,12,20,-8
25,6,176,14,13,1
25,6,177,8,22,-14
25,6,178,12,16,-4
25,6,179,9,20,-11
25,6,180,13,27,-14
25,6,181,7,22,-15
25,6,182,3,14,-11
25,6,183,7,13,-6
25,6,184,11,23,-12
25,6,185,9,22,-13
25,6,186,11,38,-27
25,6,187,10,15,-5
25,6,188,6,18,-12
25,6,189,18,26,-8
25,6,190,13,24,-11
25,6,191,10,22,-12
25,6,192,3,17,-14
25,6,193,12,24,-12
25,6,194,2,7,-5
25,6,195,11,28,-17
25,6,196,15,22,-7
25,6,197,5,18,-13
25,6,198,11,25,-14
25,6,199,15,16,-1
25,6,200,10,35,-25
25,6,201,14,28,-14
25,6,202,12,22,-10
25,6,203,9,8,1
25,6,204,10,24,-14
25,6,205,15,27,-12
25,6,206,10,20,-10
25,6,207,17,13,4
25,6,208,11,29,-18
25,6,209,11,27,-16
25,6,210,4,38,-34
25,6,211,9,30,-21
25,6,212,5,22,-17
25,6,213,7,14,-7
25,6,214,12,13,-1
25,6,215,14,19,-5
25,6,216,14,18,-4
25,6,217,6,11,-5
25,6,218,21,25,-4
25,6,219,9,26,-17
25,6,220,16,28,-12
25,6,221,1,4,-3
25,6,222,12,15,-3
25,6,223,16,21,-5
25,6,224,2,14,-12
25,6,225,14,18,-4
25,6,226,15,16,-1
25,6,227,12,10,2
25,6,228,14,30,-16
25,6,229,2,12,-10
25,6,230,3,27,-24
25,6,231,8,25,-17
25,6,232,2,12,-10
25,6,233,7,14,-7
25,6,234,9,14,-5
25,6,235,5,22,-17
25,6,236,11,24,-13
25,6,237,10,25,-15
25,6,238,16,27,-11
25,6,239,7,37,-30
25,6,240,9,20,-11
25,6,241,5,17,-12
25,6,242,7,14,-7
25,6,243,14,13,1
25,6,244,9,24,-15
25,6,245,12,38,-26
25,6,246,13,36,-23
25,6,247,24,23,1
25,6,248,8,17,-9
25,6,249,18,23,-5
25,6,250,17,44,-27
25,6,251,20,30,-10
25,6,252,12,18,-6
25,6,253,5,18,-13
25,6,254,4,15,-11
25,6,255,12,21,-9
25,6,256,17,25,-8
25,6,257,14,29,-15
25,6,258,15,23,-8
25,6,259,9,25,-16
25,6,260,12,13,-1
25,6,261,6,18,-12
25,6,262,7,21,-14
25,6,263,12,20,-8
25,6,264,7,19,-12
25,6,265,9,28,-19
25,6,266,14,20,-6
25,6,267,12,20,-8
25,6,268,13,19,-6
25,6,269,11,28,-17
25,6,270,9,21,-12
25,6,271,3,21,-18
25,6,272,18,17,1
25,6,273,11,18,-7
25,6,274,14,12,2
25,6,275,9,12,-3
25,6,276,4,13,-9
25,6,277,11,25,-14
25,6,278,17,12,5
25,6,279,14,19,-5
25,6,280,15,23,-8
25,6,281,8,17,-9
25,6,282,8,10,-2
25,6,283,14,15,-1
25,6,284,10,6,4
25,6,285,8,17,-9
25,6,286,18,34,-16
25,6,287,8,14,-6
25,6,288,14,34,-20
25,6,289,6,23,-17
25,6,290,9,27,-18
25,6,291,8,30,-22
25,6,292,7,17,-10
25,6,293,7,19,-12
25,6,294,14,24,-10
25,6,295,11,21,-10
25,6,296,9,20,-11
25,6,297,9,8,1
25,6,298,16,29,-13
25,6,299,8,44,-36
25,7,0,10,30,-20
25,7,1,5,17,-12
25,7,2,1,15,-14
25,7,3,13,16,-3
25,7,4,7,15,-8
25,7,5,9,24,-15
25,7,6,18,35,-17
25,7,7,14,19,-5
25,7,8,8,18,-10
25,7,9,4,25,-21
25,7,10,17,21,-4
25,7,11,10,17,-7
25,7,12,10,15,-5
25,7,13,9,20,-11
25,7,14,7,14,-7
25,7,15,9,15,-6
25,7,16,10,40,-30
25,7,17,11,24,-13
25,7,18,10,10,0
25,7,19,19,9,10
25,7,20,12,21,-9
25,7,21,15,38,-23
25,7,22,8,15,-7
25,7,23,19,18,1
25,7,24,8,17,-9
25,7,25,9,17,-8
25,7,26,2,3,-1
25,7,27,14,33,-19
25,7,28,7,16,-9
25,7,29,13,22,-9
25,7,30,21,26,-5
25,7,31,6,18,-12
25,7,32,11,17,-6
25,7,33,11,16,-5
25,7,34,5,12,-7
25,7,35,8,10,-2
25,7,36,12,18,-6
25,7,37,9,23,-14
25,7,38,10,10,0
25,7,39,7,26,-19
25,7,40,13,40,-27
25,7,41,14,23,-9
25,7,42,12,27,-15
25,7,43,11,13,-2
25,7,44,4,11,-7
25,7,45,19,24,-5
25,7,46,8,23,-15
25,7,47,8,27,-19
25,7,48,12,22,-10
25,7,49,8,12,-4
25,7,50,8,6,2
25,7,51,7,30,-23
25,7,52,8,22,-14
25,7,53,15,14,1
25,7,54,14,22,-8
25,7,55,16,15,1
25,7,56,11,17,-6
25,7,57,8,22,-14
25,7,58,14,16,-2
25,7,59,4,16,-12
25,7,60,13,11,2
25,7,61,27,36,-9
25,7,62,9,11,-2
25,7,63,5,7,-2
25,7,64,10,20,-10
25,7,65,13,30,-17
25,7,66,17,39,-22
25,7,67,11,27,-16
25,7,68,10,21,-11
25,7,69,7,16,-9
25,7,70,5,14,-9
25,7,71,11,34,-23
25,7,72,13,11,2
25,7,73,5,13,-8
25,7,74,9,18,-9
25,7,75,7,24,-17
25,7,76,5,11,-6
25,7,77,12,13,-1
25,7,78,24,18,6
25,7,79,7,20,-13
25,7,80,4,16,-12
25,7,81,13,17,-4
25,7,82,11,34,-23
25,7,83,12,19,-7
25,7,84,8,18,-10
25,7,85,6,8,-2
25,7,86,10,12,-2
25,7,87,13,22,-9
25,7,88,9,23,-14
25,7,89,10,17,-7
25,7,90,11,38,-27
25,7,91,2,22,-20
25,7,92,12,17,-5
25,7,93,10,11,-1
25,7,94,3,25,-22
25,7,95,13,21,-8
25,7,96,9,29,-20
25,7,97,8,22,-14
25,7,98,15,7,8
25,7,99,11,9,2
25,7,100,12,16,-4
25,7,101,13,14,-1
25,7,102,20,18,2
25,7,103,9,20,-11
25,7,104,13,41,-28
25,7,105,11,17,-6
25,7,106,18,24,-6
25,7,107,11,19,-8
25,7,108,10,19,-9
25,7,109,11,18,-7
25,7,110,12,28,-16
25,7,111,8,29,-21
25,7,112,11,22,-11
25,7,113,20,18,2
25,7,114,18,17,1
25,7,115,7,25,-18
25,7,116,7,42,-35
25,7,117,10,16,-6
25,7,118,11,22,-11
25,7,119,13,25,-12
25,7,120,4,15,-11
25,7,121,6,16,-10
25,7,122,9,25,-16
25,7,123,27,24,3
25,7,124,18,21,-3
25,7,125,12,44,-32
25,7,126,7,16,-9
25,7,127,21,34,-13
25,7,128,10,19,-9
25,7,129,16,18,-2
25,7,130,12,31,-19
25,7,131,5,21,-16
25,7,132,3,22,-19
25,7,133,13,33,-20
25,7,134,22,15,7
25,7,135,12,7,5
25,7,136,12,27,-15
25,7,137,5,25,-20
25,7,138,21,19,2
25,7,139,7,20,-13
25,7,140,4,25,-21
25,7,141,12,22,-10
25,7,142,8,14,-6
25,7,143,3,24,-21
25,7,144,3,22,-19
25,7,145,11,31,-20
25,7,146,13,30,-17
25,7,147,21,23,-2
25,7,148,8,23,-15
25,7,149,20,27,-7
25,7,150,10,22,-12
25,7,151,2,15,-13
25,7,152,9,27,-18
25,7,153,6,15,-9
25,7,154,11,25,-14
25,7,155,9,15,-6
25,7,156,13,31,-18
25,7,157,19,30,-11
25,7,158,6,20,-14
25,7,159,1,26,-25
25,7,160,19,11,8
25,7,161,6,14,-8
25,7,162,11,38,-27
25,7,163,9,16,-7
25,7,164,16,20,-4
25,7,165,13,16,-3
25,7,166,6,20,-14
25,7,167,15,26,-11
25,7,168,7,10,-3
25,7,169,11,14,-3
25,7,170,10,40,-30
25,7,171,9,27,-18
25,7,172,11,24,-13
25,7,173,10,7,3
25,7,174,5,19,-14
25,7,175,7,16,-9
25,7,176,8,21,-13
25,7,177,9,35,-26
25,7,178,0,22,-22
25,7,179,5,17,-12
25,7,180,3,11,-8
25,7,181,10,40,-30
25,7,182,8,13,-5
25,7,183,11,20,-9
25,7,184,10,13,-3
25,7,185,16,15,1
25,7,186,6,33,-27
25,7,187,6,9,-3
25,7,188,9,18,-9
25,7,189,17,38,-21
25,7,190,12,23,-11
25,7,191,10,8,2
25,7,192,15,51,-36
25,7,193,10,12,-2
25,7,194,9,28,-19
25,7,195,8,25,-17
25,7,196,3,16,-13
25,7,197,3,21,-18
25,7,198,14,13,1
25,7,199,9,24,-15
25,7,200,5,23,-18
25,7,201,12,13,-1
25,7,202,18,19,-1
25,7,203,16,13,3
25,7,204,14,24,-10
25,7,205,11,23,-12
25,7,206,11,19,-8
25,7,207,8,18,-10
25,7,208,6,7,-1
25,7,209,10,16,-6
25,7,210,9,26,-17
25,7,211,6,19,-13
25,7,212,7,18,-11
25,7,213,9,20,-11
25,7,214,8,18,-10
25,7,215,26,24,2
25,7,216,13,17,-4
25,7,217,12,15,-3
25,7,218,17,15,2
25,7,219,6,32,-26
25,7,220,6,16,-10
25,7,221,14,18,-4
25,7,222,6,26,-20
25,7,223,19,19,0
25,7,224,1,8,-7
25,7,225,13,15,-2
25,7,226,9,14,-5
25,7,227,8,28,-20
25,7,228,13,28,-15
25,7,229,11,17,-6
25,7,230,12,12,0
25,7,231,9,15,-6
25,7,232,7,19,-12
25,7,233,20,11,9
25,7,234,13,35,-22
25,7,235,13,25,-12
25,7,236,2,12,-10
25,7,237,11,8,3
25,7,238,3,14,-11
25,7,239,13,32,-19
25,7,240,15,23,-8
25,7,241,5,28,-23
25,7,242,14,21,-7
25,7,243,7,22,-15
25,7,244,25,15,10
25,7,245,18,21,-3
25,7,246,7,4,3
25,7,247,5,11,-6
25,7,248,14,28,-14
25,7,249,6,16,-10
25,7,250,3,22,-19
25,7,251,15,28,-13
25,7,252,5,11,-6
25,7,253,3,18,-15
25,7,254,9,21,-12
25,7,255,15,20,-5
25,7,256,11,15,-4
25,7,257,8,16,-8
25,7,258,11,11,0
25,7,259,6,22,-16
25,7,260,4,18,-14
25,7,261,10,23,-13
25,7,262,5,11,-6
25,7,263,3,19,-16
25,7,264,11,30,-19
25,7,265,11,33,-22
25,7,266,19,19,0
25,7,267,7,13,-6
25,7,268,7,22,-15
25,7,269,14,24,-10
25,7,270,9,19,-10
25,7,271,9,12,-3
25,7,272,9,32,-23
25,7,273,10,18,-8
25,7,274,6,16,-10
25,7,275,15,16,-1
25,7,276,18,28,-10
25,7,277,4,13,-9
25,7,278,14,36,-22
25,7,279,16,18,-2
25,7,280,16,21,-5
25,7,281,15,13,2
25,7,282,4,21,-17
25,7,283,3,18,-15
25,7,284,10,13,-3
25,7,285,7,10,-3
25,7,286,18,33,-15
25,7,287,9,20,-11
25,7,288,17,30,-13
25,7,289,12,12,0
25,7,290,14,21,-7
25,7,291,3,24,-21
25,7,292,9,19,-10
25,7,293,4,22,-18
25,7,294,10,33,-23
25,7,295,10,22,-12
25,7,296,9,27,-18
25,7,297,6,19,-13
25,7,298,13,27,-14
25,7,299,7,21,-14
25,8,0,12,7,5
25,8,1,20,20,0
25,8,2,10,34,-24
25,8,3,10,21,-11
25,8,4,9,29,-20
25,8,5,9,18,-9
25,8,6,13,33,-20
25,8,7,9,10,-1
25,8,8,8,13,-5
25,8,9,6,34,-28
25,8,10,8,25,-17
25,8,11,10,8,2
25,8,12,14,27,-13
25,8,13,12,32,-20
25,8,14,12,30,-18
25,8,15,15,22,-7
25,8,16,5,19,-14
25,8,17,2,38,-36
25,8,18,14,17,-3
25,8,19,11,35,-24
25,8,20,6,19,-13
25,8,21,12,23,-11
25,8,22,5,16,-11
25,8,23,12,21,-9
25,8,24,3,24,-21
25,8,25,20,15,5
25,8,26,4,10,-6
25,8,27,7,28,-21
25,8,28,15,18,-3
25,8,29,6,5,1
25,8,30,6,18,-12
25,8,31,9,19,-10
25,8,32,8,25,-17
25,8,33,10,16,-6
25,8,34,9,15,-6
25,8,35,14,22,-8
25,8,36,8,19,-11
25,8,37,10,23,-13
25,8,38,19,33,-14
25,8,39,8,11,-3
25,8,40,11,37,-26
25,8,41,5,22,-17
25,8,42,14,14,0
25,8,43,11,25,-14
25,8,44,12,14,-2
25,8,45,9,24,-15
25,8,46,11,31,-20
25,8,47,11,14,-3
25,8,48,13,25,-12
25,8,49,12,20,-8
25,8,50,4,15,-11
25,8,51,3,9,-6
25,8,52,7,16,-9
25,8,53,7,20,-13
25,8,54,12,14,-2
25,8,55,12,18,-6
25,8,56,12,17,-5
25,8,57,13,21,-8
25,8,58,6,21,-15
25,8,59,9,19,-10
25,8,60,19,17,2
25,8,61,12,21,-9
25,8,62,8,13,-5
25,8,63,9,29,-20
25,8,64,18,18,0
25,8,65,14,23,-9
25,8,66,7,21,-14
25,8,67,9,16,-7
25,8,68,15,23,-8
25,8,69,8,5,3
25,8,70,4,21,-17
25,8,71,17,15,2
25,8,72,11,24,-13
25,8,73,19,18,1
25,8,74,12,21,-9
25,8,75,3,16,-13
25,8,76,3,13,-10
25,8,77,14,26,-12
25,8,78,4,17,-13
25,8,79,7,18,-11
25,8,80,9,22,-13
25,8,81,13,29,-16
25,8,82,14,30,-16
25,8,83,10,19,-9
25,8,84,15,20,-5
25,8,85,12,25,-13
25,8,86,7,16,-9
25,8,87,9,20,-11
25,8,88,12,28,-16
25,8,89,9,18,-9
25,8,90,9,15,-6
25,8,91,10,20,-10
25,8,92,6,30,-24
25,8,93,14,11,3
25,8,94,10,35,-25
25,8,95,9,23,-14
25,8,96,6,15,-9
25,8,97,5,26,-21
25,8,98,14,21,-7
25,8,99,15,13,2
25,8,100,24,25,-1
25,8,101,4,13,-9
25,8,102,6,25,-19
25,8,103,4,13,-9
25,8,104,15,21,-6
25,8,105,8,21,-13
25,8,106,9,18,-9
25,8,107,8,20,-12
25,8,108,12,9,3
25,8,109,11,26,-15
25,8,110,20,30,-10
25,8,111,14,33,-19
25,8,112,15,24,-9
25,8,113,13,24,-11
25,8,114,11,27,-16
25,8,115,10,31,-21
25,8,116,8,17,-9
25,8,117,16,16,0
25,8,118,18,26,-8
25,8,119,7,20,-13
25,8,120,8,13,-5
25,8,121,10,12,-2
25,8,122,9,19,-10
25,8,123,24,21,3
25,8,124,12,20,-8
25,8,125,12,20,-8
25,8,126,7,16,-9
25,8,127,15,14,1
25,8,128,13,10,3
25,8,129,15,36,-21
25,8,130,7,24,-17
25,8,131,13,26,-13
25,8,132,8,15,-7
25,8,133,15,30,-15
25,8,134,9,23,-14
25,8,135,17,17,0
25,8,136,8,12,-4
25,8,137,6,14,-8
25,8,138,6,32,-26
25,8,139,10,17,-7
25,8,140,4,6,-2
25,8,141,13,19,-6
25,8,142,9,31,-22
25,8,143,12,22,-10
25,8,144,7,26,-19
25,8,145,13,27,-14
25,8,146,14,33,-19
25,8,147,6,18,-12
25,8,148,15,32,-17
25,8,149,9,20,-11
25,8,150,10,32,-22
25,8,151,7,16,-9
25,8,152,9,25,-16
25,8,153,6,13,-7
25,8,154,14,30,-16
25,8,155,14,16,-2
25,8,156,5,17,-12
25,8,157,10,22,-12
25,8,158,9,12,-3
25,8,159,19,20,-1
25,8,160,11,21,-10
25,8,161,7,21,-14
25,8,162,9,12,-3
25,8,163,13,23,-10
25,8,164,14,14,0
25,8,165,5,22,-17
25,8,166,23,25,-2
25,8,167,7,20,-13
25,8,168,12,28,-16
25,8,169,11,24,-13
25,8,170,8,34,-26
25,8,171,11,16,-5
25,8,172,11,27,-16
25,8,173,19,21,-2
25,8,174,11,39,-28
25,8,175,12,35,-23
25,8,176,9,27,-18
25,8,177,9,17,-8
25,8,178,14,16,-2
25,8,179,7,24,-17
25,8,180,14,14,0
25,8,181,17,27,-10
25,8,182,10,17,-7
25,8,183,11,16,-5
25,8,184,6,15,-9
25,8,185,5,5,0
25,8,186,8,34,-26
25,8,187,14,27,-13
25,8,188,12,13,-1
25,8,189,13,32,-19
25,8,190,20,21,-1
25,8,191,7,31,-24
25,8,192,11,18,-7
25,8,193,7,8,-1
25,8,194,7,20,-13
25,8,195,15,34,-19
25,8,196,11,22,-11
25,8,197,7,17,-10
25,8,198,7,17,-10
25,8,199,14,24,-10
25,8,200,11,18,-7
25,8,201,10,27,-17
25,8,202,11,14,-3
25,8,203,17,23,-6
25,8,204,9,9,0
25,8,205,14,26,-12
25,8,206,8,38,-30
25,8,207,8,34,-26
25,8,208,11,13,-2
25,8,209,4,14,-10
25,8,210,9,22,-13
25,8,211,5,21,-16
25,8,212,14,23,-9
25,8,213,6,26,-20
25,8,214,10,16,-6
25,8,215,4,13,-9
25,8,216,10,32,-22
25,8,217,14,14,0
25,8,218,12,11,1
25,8,219,6,24,-18
25,8,220,17,12,5
25,8,221,7,15,-8
25,8,222,11,26,-15
25,8,223,8,20,-12
25,8,224,15,17,-2
25,8,225,9,34,-25
25,8,226,9,21,-12
25,8,227,17,41,-24
25,8,228,17,22,-5
25,8,229,11,22,-11
25,8,230,10,27,-17
25,8,231,10,19,-9
25,8,232,14,13,1
25,8,233,12,15,-3
25,8,234,16,31,-15
25,8,235,10,18,-8
25,8,236,8,24,-16
25,8,237,5,16,-11
25,8,238,13,27,-14
25,8,239,22,28,-6
25,8,240,17,36,-19
25,8,241,6,20,-14
25,8,242,19,29,-10
25,8,243,10,16,-6
25,8,244,13,31,-18
25,8,245,15,8,7
25,8,246,17,33,-16
25,8,247,1,18,-17
25,8,248,7,26,-19
25,8,249,13,21,-8
25,8,250,10,26,-16
25,8,251,12,16,-4
25,8,252,3,15,-12
25,8,253,9,12,-3
25,8,254,13,16,-3
25,8,255,12,13,-1
25,8,256,17,31,-14
25,8,257,6,24,-18
25,8,258,14,21,-7
25,8,259,14,33,-19
25,8,260,10,21,-11
25,8,261,11,22,-11
25,8,262,12,21,-9
25,8,263,12,17,-5
25,8,264,20,32,-12
25,8,265,21,25,-4
25,8,266,7,18,-11
25,8,267,11,19,-8
25,8,268,10,20,-10
25,8,269,11,12,-1
25,8,270,13,28,-15
25,8,271,4,14,-10
25,8,272,6,17,-11
25,8,273,16,18,-2
25,8,274,18,39,-21
25,8,275,10,16,-6
25,8,276,6,13,-7
25,8,277,9,17,-8
25,8,278,12,17,-5
25,8,279,9,18,-9
25,8,280,9,20,-11
25,8,281,14,34,-20
25,8,282,16,11,5
25,8,283,9,11,-2
25,8,284,10,18,-8
25,8,285,9,15,-6
25,8,286,14,24,-10
25,8,287,14,22,-8
25,8,288,8,21,-13
25,8,289,8,19,-11
25,8,290,19,28,-9
25,8,291,10,27,-17
25,8,292,8,17,-9
25,8,293,8,17,-9
25,8,294,13,24,-11
25,8,295,14,16,-2
25,8,296,4,17,-13
25,8,297,7,20,-13
25,8,298,8,22,-14
25,8,299,7,25,-18
25,9,0,7,11,-4
25,9,1,7,15,-8
25,9,2,18,25,-7
25,9,3,14,23,-9
25,9,4,11,13,-2
25,9,5,4,7,-3
25,9,6,5,19,-14
25,9,7,10,14,-4
25,9,8,11,7,4
25,9,9,19,30,-11
25,9,10,5,15,-10
25,9,11,14,12,2
25,9,12,9,25,-16
25,9,13,10,17,-7
25,9,14,1,25,-24
25,9,15,6,9,-3
25,9,16,13,32,-19
25,9,17,9,14,-5
25,9,18,13,13,0
25,9,19,18,20,-2
25,9,20,10,13,-3
25,9,21,18,31,-13
25,9,22,8,19,-11
25,9,23,14,25,-11
25,9,24,11,23,-12
25,9,25,11,24,-13
25,9,26,10,20,-10
25,9,27,18,25,-7
25,9,28,18,24,-6
25,9,29,2,29,-27
25,9,30,10,19,-9
25,9,31,14,24,-10
25,9,32,12,15,-3
25,9,33,15,22,-7
25,9,34,11,16,-5
25,9,35,11,12,-1
25,9,36,5,19,-14
25,9,37,7,18,-11
25,9,38,4,8,-4
25,9,39,10,43,-33
25,9,40,17,12,5
25,9,41,7,27,-20
25,9,42,15,27,-12
25,9,43,17,21,-4
25,9,44,5,11,-6
25,9,45,5,12,-7
25,9,46,10,28,-18
25,9,47,9,28,-19
25,9,48,16,20,-4
25,9,49,10,15,-5
25,9,50,14,16,-2
25,9,51,8,18,-10
25,9,52,23,21,2
25,9,53,10,21,-11
25,9,54,16,19,-3
25,9,55,11,12,-1
25,9,56,10,27,-17
25,9,57,8,25,-17
25,9,58,13,26,-13
25,9,59,15,15,0
25,9,60,13,15,-2
25,9,61,8,11,-3
25,9,62,13,23,-10
25,9,63,11,21,-10
25,9,64,11,16,-5
25,9,65,11,10,1
25,9,66,11,5,6
25,9,67,11,23,-12
25,9,68,11,10,1
25,9,69,14,14,0
25,9,70,8,6,2
25,9,71,15,14,1
25,9,72,8,24,-16
25,9,73,3,18,-15
25,9,74,4,12,-8
25,9,75,4,13,-9
25,9,76,6,14,-8
25,9,77,10,20,-10
25,9,78,4,14,-10
25,9,79,8,13,-5
25,9,80,13,10,3
25,9,81,17,30,-13
25,9,82,5,20,-15
25,9,83,14,23,-9
25,9,84,10,20,-10
25,9,85,3,25,-22
25,9,86,14,13,1
25,9,87,15,28,-13
25,9,88,8,17,-9
25,9,89,11,17,-6
25,9,90,16,22,-6
25,9,91,7,7,0
25,9,92,8,28,-20
25,9,93,7,23,-16
25,9,94,13,12,1
25,9,95,8,17,-9
25,9,96,6,5,1
25,9,97,10,21,-11
25,9,98,10,23,-13
25,9,99,16,20,-4
25,9,100,10,32,-22
25,9,101,20,26,-6
25,9,102,6,10,-4
25,9,103,4,10,-6
25,9,104,21,19,2
25,9,105,2,8,-6
25,9,106,9,21,-12
25,9,107,11,32,-21
25,9,108,11,22,-11
25,9,109,13,36,-23
25,9,110,11,11,0
25,9,111,5,23,-18
25,9,112,11,23,-12
25,9,113,8,19,-11
25,9,114,7,21,-14
25,9,115,7,23,-16
25,9,116,5,17,-12
25,9,117,12,26,-14
25,9,118,17,20,-3
25,9,119,9,23,-14
25,9,120,15,19,-4
25,9,121,10,23,-13
25,9,122,17,23,-6
25,9,123,10,24,-14
25,9,124,7,27,-20
25,9,125,4,23,-19
25,9,126,20,20,0
25,9,127,7,6,1
25,9,128,6,8,-2
25,9,129,8,25,-17
25,9,130,12,32,-20
25,9,131,7,17,-10
25,9,132,18,21,-3
25,9,133,15,30,-15
25,9,134,10,43,-33
25,9,135,6,12,-6
25,9,136,6,14,-8
25,9,137,16,14,2
25,9,138,7,28,-21
25,9,139,9,21,-12
25,9,140,12,33,-21
25,9,141,10,15,-5
25,9,142,10,22,-12
25,9,143,6,9,-3
25,9,144,17,30,-13
25,9,145,4,20,-16
25,9,146,11,5,6
25,9,147,8,31,-23
25,9,148,4,15,-11
25,9,149,10,28,-18
25,9,150,3,18,-15
25,9,151,24,42,-18
25,9,152,2,10,-8
25,9,153,7,15,-8
25,9,154,10,36,-26
25,9,155,10,24,-14
25,9,156,11,11,0
25,9,157,8,17,-9
25,9,158,0,4,-4
25,9,159,13,11,2
25,9,160,7,22,-15
25,9,161,5,23,-18
25,9,162,14,21,-7
25,9,163,3,16,-13
25,9,164,2,16,-14
25,9,165,13,12,1
25,9,166,9,21,-12
25,9,167,4,4,0
25,9,168,13,29,-16
25,9,169,11,25,-14
25,9,170,8,25,-17
25,9,171,8,35,-27
25,9,172,12,23,-11
25,9,173,10,19,-9
25,9,174,7,21,-14
25,9,175,7,23,-16
25,9,176,6,12,-6
25,9,177,21,33,-12
25,9,178,5,17,-12
25,9,179,8,14,-6
25,9,180,10,7,3
25,9,181,18,15,3
25,9,182,8,21,-13
25,9,183,21,17,4
25,9,184,17,28,-11
25,9,185,22,29,-7
25,9,186,15,10,5
25,9,187,10,33,-23
25,9,188,15,18,-3
25,9,189,7,24,-17
25,9,190,21,11,10
25,9,191,15,27,-12
25,9,192,7,25,-18
25,9,193,14,23,-9
25,9,194,4,31,-27
25,9,195,11,18,-7
25,9,196,14,28,-14
25,9,197,6,20,-14
25,9,198,18,13,5
25,9,199,13,30,-17
25,9,200,10,27,-17
25,9,201,8,14,-6
25,9,202,9,14,-5
25,9,203,12,29,-17
25,9,204,9,11,-2
25,9,205,11,19,-8
25,9,206,8,21,-13
25,9,207,10,23,-13
25,9,208,17,12,5
25,9,209,10,22,-12
25,9,210,13,13,0
25,9,211,9,21,-12
25,9,212,13,8,5
25,9,213,21,20,1
25,9,214,12,31,-19
25,9,215,7,20,-13
25,9,216,2,6,-4
25,9,217,10,18,-8
25,9,218,4,19,-15
25,9,219,15,20,-5
25,9,220,2,26,-24
25,9,221,18,21,-3
25,9,222,10,18,-8
25,9,223,6,10,-4
25,9,224,12,23,-11
25,9,225,8,15,-7
25,9,226,16,14,2
25,9,227,8,19,-11
25,9,228,13,20,-7
25,9,229,1,8,-7
25,9,230,6,24,-18
25,9,231,6,30,-24
25,9,232,7,10,-3
25,9,233,9,17,-8
25,9,234,4,26,-22
25,9,235,12,20,-8
25,9,236,6,0,6
25,9,237,9,12,-3
25,9,238,5,14,-9
25,9,239,10,23,-13
25,9,240,3,24,-21
25,9,241,14,19,-5
25,9,242,14,23,-9
25,9,243,11,14,-3
25,9,244,11,32,-21
25,9,245,14,18,-4
25,9,246,19,36,-17
25,9,247,5,26,-21
25,9,248,9,15,-6
25,9,249,8,20,-12
25,9,250,15,12,3
25,9,251,16,23,-7
25,9,252,14,25,-11
25,9,253,9,6,3
25,9,254,13,27,-14
25,9,255,12,21,-9
25,9,256,5,18,-13
25,9,257,8,22,-14
25,9,258,12,18,-6
25,9,259,9,25,-16
25,9,260,22,18,4
25,9,261,11,21,-10
25,9,262,5,18,-13
25,9,263,11,24,-13
25,9,264,11,26,-15
25,9,265,5,35,-30
25,9,266,21,18,3
25,9,267,6,7,-1
25,9,268,14,20,-6
25,9,269,8,19,-11
25,9,270,6,21,-15
25,9,271,6,14,-8
25,9,272,13,23,-10
25,9,273,10,5,5
25,9,274,7,10,-3
25,9,275,12,14,-2
25,9,276,11,31,-20
25,9,277,10,17,-7
25,9,278,7,12,-5
25,9,279,18,24,-6
25,9,280,8,20,-12
25,9,281,8,22,-14
25,9,282,15,13,2
25,9,283,15,21,-6
25,9,284,10,23,-13
25,9,285,5,23,-18
25,9,286,11,15,-4
25,9,287,23,34,-11
25,9,288,11,12,-1
25,9,289,3,17,-14
25,9,290,11,18,-7
25,9,291,17,23,-6
25,9,292,5,12,-7
25,9,293,10,11,-1
25,9,294,12,7,5
25,9,295,17,29,-12
25,9,296,13,14,-1
25,9,297,8,11,-3
25,9,298,1,12,-11
25,9,299,6,30,-24
25,10,0,13,26,-13
25,10,1,7,13,-6
25,10,2,9,21,-12
25,10,3,16,14,2
25,10,4,18,26,-8
25,10,5,10,20,-10
25,10,6,13,6,7
25,10,7,8,20,-12
25,10,8,17,15,2
25,10,9,15,24,-9
25,10,10,7,20,-13
25,10,11,1,14,-13
25,10,12,9,7,2
25,10,13,7,18,-11
25,10,14,10,19,-9
25,10,15,10,28,-18
25,10,16,18,24,-6
25,10,17,13,16,-3
25,10,18,19,25,-6
25,10,19,16,21,-5
25,10,20,6,13,-7
25,10,21,6,13,-7
25,10,22,8,24,-16
25,10,23,4,6,-2
25,10,24,8,19,-11
25,10,25,14,18,-4
25,10,26,2,7,-5
25,10,27,6,30,-24
25,10,28,17,31,-14
25,10,29,10,35,-25
25,10,30,15,20,-5
25,10,31,10,20,-10
25,10,32,9,10,-1
25,10,33,5,7,-2
25,10,34,12,30,-18
25,10,35,12,23,-11
25,10,36,9,9,0
25,10,37,19,27,-8
25,10,38,21,28,-7
25,10,39,8,19,-11
25,10,40,11,23,-12
25,10,41,12,20,-8
25,10,42,9,17,-8
25,10,43,9,25,-16
25,10,44,8,28,-20
25,10,45,20,22,-2
25,10,46,22,19,3
25,10,47,6,19,-13
25,10,48,13,18,-5
25,10,49,13,35,-22
25,10,50,11,20,-9
25,10,51,4,26,-22
25,10,52,6,18,-12
25,10,53,2,16,-14
25,10,54,7,12,-5
25,10,55,4,19,-15
25,10,56,6,15,-9
25,10,57,5,20,-15
25,10,58,7,23,-16
25,10,59,6,27,-21
25,10,60,13,17,-4
25,10,61,8,24,-16
25,10,62,7,12,-5
25,10,63,9,18,-9
25,10,64,21,31,-10
25,10,65,9,18,-9
25,10,66,10,31,-21
25,10,67,16,27,-11
25,10,68,4,8,-4
25,10,69,10,31,-21
25,10,70,12,13,-1
25,10,71,9,16,-7
25,10,72,6,10,-4
25,10,73,13,15,-2
25,10,74,13,20,-7
25,10,75,8,21,-13
25,10,76,10,25,-15
25,10,77,19,19,0
25,10,78,10,27,-17
25,10,79,9,27,-18
25,10,80,10,8,2
25,10,81,12,14,-2
25,10,82,16,13,3
25,10,83,16,27,-11
25,10,84,9,16,-7
25,10,85,14,21,-7
25,10,86,9,25,-16
25,10,87,6,6,0
25,10,88,2,19,-17
25,10,89,23,15,8
25,10,90,6,29,-23
25,10,91,9,15,-6
25,10,92,7,16,-9
25,10,93,4,12,-8
25,10,94,13,30,-17
25,10,95,14,30,-16
25,10,96,12,20,-8
25,10,97,4,12,-8
25,10,98,7,16,-9
25,10,99,13,12,1
25,10,100,14,23,-9
25,10,101,17,22,-5
25,10,102,7,24,-17
25,10,103,11,17,-6
25,10,104,12,15,-3
25,10,105,7,15,-8
25,10,106,9,22,-13
25,10,107,8,16,-8
25,10,108,5,15,-10
25,10,109,11,21,-10
25,10,110,8,11,-3
25,10,111,14,11,3
25,10,112,14,23,-9
25,10,113,6,20,-14
25,10,114,7,16,-9
25,10,115,5,12,-7
25,10,116,7,20,-13
25,10,117,12,27,-15
25,10,118,5,20,-15
25,10,119,7,13,-6
25,10,120,5,15,-10
25,10,121,13,10,3
25,10,122,12,25,-13
25,10,123,19,27,-8
25,10,124,13,24,-11
25,10,125,8,21,-13
25,10,126,10,20,-10
25,10,127,6,10,-4
25,10,128,15,30,-15
25,10,129,13,23,-10
25,10,130,20,20,0
25,10,131,16,19,-3
25,10,132,11,12,-1
25,10,133,20,29,-9
25,10,134,17,20,-3
25,10,135,9,24,-15
25,10,136,3,20,-17
25,10,137,22,14,8
25,10,138,4,8,-4
25,10,139,18,25,-7
25,10,140,11,21,-10
25,10,141,10,21,-11
25,10,142,13,27,-14
25,10,143,11,21,-10
25,10,144,12,13,-1
25,10,145,7,18,-11
25,10,146,11,10,1
25,10,147,13,13,0
25,10,148,4,17,-13
25,10,149,24,17,7
25,10,150,14,34,-20
25,10,151,12,17,-5
25,10,152,15,20,-5
25,10,153,10,19,-9
25,10,154,6,16,-10
25,10,155,14,16,-2
25,10,156,14,16,-2
25,10,157,6,25,-19
25,10,158,2,20,-18
25,10,159,10,25,-15
25,10,160,12,12,0
25,10,161,12,29,-17
25,10,162,4,23,-19
25,10,163,16,15,1
25,10,164,15,15,0
25,10,165,15,32,-17
25,10,166,23,27,-4
25,10,167,15,26,-11
25,10,168,11,12,-1
25,10,169,10,19,-9
25,10,170,3,20,-17
25,10,171,10,24,-14
25,10,172,13,26,-13
25,10,173,12,9,3
25,10,174,8,14,-6
25,10,175,4,23,-19
25,10,176,15,11,4
25,10,177,15,27,-12
25,10,178,1,21,-20
25,10,179,10,10,0
25,10,180,9,12,-3
25,10,181,11,22,-11
25,10,182,9,10,-1
25,10,183,22,24,-2
25,10,184,9,31,-22
25,10,185,9,30,-21
25,10,186,20,21,-1
25,10,187,14,15,-1
25,10,188,20,31,-11
25,10,189,4,16,-12
25,10,190,10,17,-7
25,10,191,10,16,-6
25,10,192,11,26,-15
25,10,193,13,12,1
25,10,194,9,7,2
25,10,195,17,19,-2
25,10,196,12,18,-6
25,10,197,16,12,4
25,10,198,14,22,-8
25,10,199,3,10,-7
25,10,200,9,24,-15
25,10,201,12,26,-14
25,10,202,13,7,6
25,10,203,15,26,-11
25,10,204,9,14,-5
25,10,205,15,16,-1
25,10,206,13,15,-2
25,10,207,15,25,-10
25,10,208,18,16,2
25,10,209,9,21,-12
25,10,210,24,35,-11
25,10,211,4,14,-10
25,10,212,11,16,-5
25,10,213,16,29,-13
25,10,214,25,21,4
25,10,215,7,16,-9
25,10,216,11,27,-16
25,10,217,18,27,-9
25,10,218,7,29,-22
25,10,219,9,19,-10
25,10,220,15,14,1
25,10,221,12,18,-6
25,10,222,7,22,-15
25,10,223,16,22,-6
25,10,224,15,25,-10
25,10,225,3,15,-12
25,10,226,10,27,-17
25,10,227,8,20,-12
25,10,228,16,12,4
25,10,229,12,22,-10
25,10,230,7,12,-5
25,10,231,9,18,-9
25,10,232,9,14,-5
25,10,233,9,23,-14
25,10,234,9,23,-14
25,10,235,5,15,-10
25,10,236,7,21,-14
25,10,237,9,16,-7
25,10,238,16,38,-22
25,10,239,5,18,-13
25,10,240,9,9,0
25,10,241,14,24,-10
25,10,242,4,30,-26
25,10,243,12,21,-9
25,10,244,13,16,-3
25,10,245,10,16,-6
25,10,246,29,37,-8
25,10,247,12,24,-12
25,10,248,11,20,-9
25,10,249,11,19,-8
25,10,250,9,20,-11
25,10,251,12,11,1
25,10,252,9,20,-11
25,10,253,5,25,-20
25,10,254,9,21,-12
25,10,255,13,27,-14
25,10,256,6,27,-21
25,10,257,18,13,5
25,10,258,17,19,-2
25,10,259,9,22,-13
25,10,260,19,25,-6
25,10,261,12,16,-4
25,10,262,8,21,-13
25,10,263,5,38,-33
25,10,264,7,10,-3
25,10,265,5,26,-21
25,10,266,1,7,-6
25,10,267,9,11,-2
25,10,268,10,17,-7
25,10,269,8,20,-12
25,10,270,5,14,-9
25,10,271,11,30,-19
25,10,272,13,26,-13
25,10,273,4,12,-8
25,10,274,7,8,-1
25,10,275,17,21,-4
25,10,276,16,33,-17
25,10,277,2,9,-7
25,10,278,12,20,-8
25,10,279,8,13,-5
25,10,280,8,10,-2
25,10,281,15,15,0
25,10,282,10,12,-2
25,10,283,8,21,-13
25,10,284,1,19,-18
25,10,285,3,17,-14
25,10,286,14,13,1
25,10,287,11,15,-4
25,10,288,8,24,-16
25,10,289,8,24,-16
25,10,290,18,12,6
25,10,291,12,25,-13
25,10,292,13,19,-6
25,10,293,12,14,-2
25,10,294,8,14,-6
25,10,295,8,22,-14
25,10,296,7,25,-18
25,10,297,16,22,-6
25,10,298,3,13,-10
25,10,299,5,11,-6
25,11,0,19,27,-8
25,11,1,4,10,-6
25,11,2,12,20,-8
25,11,3,15,37,-22
25,11,4,8,18,-10
25,11,5,10,27,-17
25,11,6,5,20,-15
25,11,7,6,17,-11
25,11,8,10,12,-2
25,11,9,16,30,-14
25,11,10,9,19,-10
25,11,11,8,19,-11
25,11,12,8,15,-7
25,11,13,17,20,-3
25,11,14,23,12,11
25,11,15,4,16,-12
25,11,16,8,29,-21
25,11,17,6,20,-14
25,11,18,13,29,-16
25,11,19,11,22,-11
25,11,20,12,11,1
25,11,21,5,19,-14
25,11,22,7,11,-4
25,11,23,8,15,-7
25,11,24,19,28,-9
25,11,25,10,18,-8
25,11,26,8,9,-1
25,11,27,5,11,-6
25,11,28,6,15,-9
25,11,29,14,13,1
25,11,30,15,33,-18
25,11,31,4,18,-14
25,11,32,13,26,-13
25,11,33,15,16,-1
25,11,34,5,14,-9
25,11,35,10,28,-18
25,11,36,12,22,-10
25,11,37,4,16,-12
25,11,38,8,19,-11
25,11,39,10,22,-12
25,11,40,10,16,-6
25,11,41,13,19,-6
25,11,42,14,16,-2
25,11,43,12,21,-9
25,11,44,11,10,1
25,11,45,9,23,-14
25,11,46,6,14,-8
25,11,47,11,23,-12
25,11,48,20,28,-8
25,11,49,5,29,-24
25,11,50,7,35,-28
25,11,51,1,21,-20
25,11,52,7,25,-18
25,11,53,3,8,-5
25,11,54,9,5,4
25,11,55,17,17,0
25,11,56,12,14,-2
25,11,57,5,8,-3
25,11,58,11,34,-23
25,11,59,16,20,-4
25,11,60,6,13,-7
25,11,61,8,21,-13
25,11,62,12,14,-2
25,11,63,8,30,-22
25,11,64,6,16,-10
25,11,65,11,17,-6
25,11,66,19,23,-4
25,11,67,23,10,13
25,11,68,15,18,-3
25,11,69,14,10,4
25,11,70,9,24,-15
25,11,71,12,30,-18
25,11,72,13,24,-11
25,11,73,12,20,-8
25,11,74,5,10,-5
25,11,75,7,25,-18
25,11,76,14,19,-5
25,11,77,10,17,-7
25,11,78,17,14,3
25,11,79,11,16,-5
25,11,80,8,15,-7
25,11,81,21,21,0
25,11,82,11,24,-13
25,11,83,7,18,-11
25,11,84,14,14,0
25,11,85,11,23,-12
25,11,86,19,19,0
25,11,87,10,33,-23
25,11,88,11,9,2
25,11,89,5,16,-11
25,11,90,10,11,-1
25,11,91,5,34,-29
25,11,92,19,34,-15
25,11,93,27,23,4
25,11,94,9,34,-25
25,11,95,9,8,1
25,11,96,5,16,-11
25,11,97,16,24,-8
25,11,98,9,26,-17
25,11,99,9,19,-10
25,11,100,9,26,-17
25,11,101,6,15,-9
25,11,102,12,24,-12
25,11,103,20,24,-4
25,11,104,11,8,3
25,11,105,7,14,-7
25,11,106,10,30,-20
25,11,107,9,24,-15
25,11,108,7,21,-14
25,11,109,12,24,-12
25,11,110,5,21,-16
25,11,111,12,9,3
25,11,112,9,25,-16
25,11,113,7,15,-8
25,11,114,7,24,-17
25,11,115,13,21,-8
25,11,116,9,16,-7
25,11,117,10,25,-15
25,11,118,12,23,-11
25,11,119,7,32,-25
25,11,120,4,23,-19
25,11,121,7,16,-9
25,11,122,15,17,-2
25,11,123,14,18,-4
25,11,124,4,24,-20
25,11,125,5,14,-9
25,11,126,20,32,-12
25,11,127,11,15,-4
25,11,128,13,23,-10
25,11,129,14,36,-22
25,11,130,12,19,-7
25,11,131,17,32,-15
25,11,132,12,18,-6
25,11,133,10,17,-7
25,11,134,10,29,-19
25,11,135,4,24,-20
25,11,136,6,11,-5
25,11,137,12,14,-2
25,11,138,5,18,-13
25,11,139,11,24,-13
25,11,140,6,24,-18
25,11,141,11,33,-22
25,11,142,13,25,-12
25,11,143,16,22,-6
25,11,144,8,19,-11
25,11,145,7,31,-24
25,11,146,13,13,0
25,11,147,9,21,-12
25,11,148,4,21,-17
25,11,149,14,16,-2
25,11,150,11,8,3
25,11,151,12,19,-7
25,11,152,6,15,-9
25,11,153,10,14,-4
25,11,154,8,21,-13
25,11,155,17,24,-7
25,11,156,16,20,-4
25,11,157,11,31,-20
25,11,158,12,21,-9
25,11,159,9,12,-3
25,11,160,10,13,-3
25,11,161,13,15,-2
25,11,162,5,29,-24
25,11,163,16,33,-17
25,11,164,7,7,0
25,11,165,14,33,-19
25,11,166,11,13,-2
25,11,167,5,14,-9
25,11,168,14,21,-7
25,11,169,15,13,2
25,11,170,11,5,6
25,11,171,15,18,-3
25,11,172,11,20,-9
25,11,173,8,19,-11
25,11,174,12,17,-5
25,11,175,3,2,1
25,11,176,16,7,9
25,11,177,6,25,-19
25,11,178,23,16,7
25,11,179,7,18,-11
25,11,180,8,14,-6
25,11,181,10,10,0
25,11,182,11,28,-17
25,11,183,5,16,-11
25,11,184,7,11,-4
25,11,185,3,15,-12
25,11,186,11,20,-9
25,11,187,9,24,-15
25,11,188,9,20,-11
25,11,189,15,21,-6
25,11,190,8,31,-23
25,11,191,8,16,-8
25,11,192,12,14,-2
25,11,193,15,15,0
25,11,194,8,20,-12
25,11,195,6,15,-9
25,11,196,7,19,-12
25,11,197,11,11,0
25,11,198,6,16,-10
25,11,199,11,13,-2
25,11,200,17,19,-2
25,11,201,13,25,-12
25,11,202,3,6,-3
25,11,203,13,13,0
25,11,204,10,8,2
25,11,205,9,19,-10
25,11,206,10,27,-17
25,11,207,14,15,-1
25,11,208,11,30,-19
25,11,209,11,17,-6
25,11,210,12,15,-3
25,11,211,6,19,-13
25,11,212,9,15,-6
25,11,213,10,22,-12
25,11,214,8,12,-4
25,11,215,18,11,7
25,11,216,14,17,-3
25,11,217,10,27,-17
25,11,218,12,22,-10
25,11,219,4,18,-14
25,11,220,8,17,-9
25,11,221,18,25,-7
25,11,222,14,20,-6
25,11,223,15,29,-14
25,11,224,4,18,-14
25,11,225,16,28,-12
25,11,226,5,15,-10
25,11,227,17,24,-7
25,11,228,15,10,5
25,11,229,10,17,-7
25,11,230,11,34,-23
25,11,231,15,18,-3
25,11,232,12,17,-5
25,11,233,4,38,-34
25,11,234,13,15,-2
25,11,235,19,31,-12
25,11,236,16,23,-7
25,11,237,13,9,4
25,11,238,9,21,-12
25,11,239,9,11,-2
25,11,240,5,14,-9
25,11,241,7,13,-6
25,11,242,8,19,-11
25,11,243,12,15,-3
25,11,244,9,18,-9
25,11,245,5,17,-12
25,11,246,14,38,-24
25,11,247,13,26,-13
25,11,248,12,6,6
25,11,249,13,25,-12
25,11,250,15,29,-14
25,11,251,15,26,-11
25,11,252,14,26,-12
25,11,253,26,22,4
25,11,254,18,32,-14
25,11,255,7,25,-18
25,11,256,8,6,2
25,11,257,19,13,6
25,11,258,17,36,-19
25,11,259,18,20,-2
25,11,260,7,28,-21
25,11,261,4,15,-11
25,11,262,7,19,-12
25,11,263,14,14,0
25,11,264,5,23,-18
25,11,265,4,33,-29
25,11,266,11,32,-21
25,11,267,3,14,-11
25,11,268,16,23,-7
25,11,269,16,25,-9
25,11,270,13,19,-6
25,11,271,8,14,-6
25,11,272,14,18,-4
25,11,273,10,21,-11
25,11,274,10,15,-5
25,11,275,7,11,-4
25,11,276,8,24,-16
25,11,277,13,19,-6
25,11,278,11,11,0
25,11,279,27,29,-2
25,11,280,15,16,-1
25,11,281,11,21,-10
25,11,282,27,36,-9
25,11,283,18,20,-2
25,11,284,15,9,6
25,11,285,5,20,-15
25,11,286,2,4,-2
25,11,287,12,13,-1
25,11,288,6,19,-13
25,11,289,15,31,-16
25,11,290,17,33,-16
25,11,291,19,17,2
25,11,292,13,14,-1
25,11,293,13,20,-7
25,11,294,10,24,-14
25,11,295,6,17,-11
25,11,296,8,7,1
25,11,297,7,14,-7
25,11,298,8,22,-14
25,11,299,13,20,-7
25,12,0,15,18,-3
25,12,1,12,12,0
25,12,2,9,17,-8
25,12,3,7,11,-4
25,12,4,16,25,-9
25,12,5,13,22,-9
25,12,6,6,16,-10
25,12,7,1,13,-12
25,12,8,21,28,-7
25,12,9,18,22,-4
25,12,10,15,24,-9
25,12,11,14,26,-12
25,12,12,6,19,-13
25,12,13,13,12,1
25,12,14,7,23,-16
25,12,15,11,15,-4
25,12,16,5,15,-10
25,12,17,12,31,-19
25,12,18,19,19,0
25,12,19,7,13,-6
25,12,20,7,14,-7
25,12,21,9,16,-7
25,12,22,12,15,-3
25,12,23,10,11,-1
25,12,24,14,12,2
25,12,25,13,29,-16
25,12,26,9,20,-11
25,12,27,17,23,-6
25,12,28,9,19,-10
25,12,29,15,15,0
25,12,30,8,30,-22
25,12,31,16,28,-12
25,12,32,17,21,-4
25,12,33,15,19,-4
25,12,34,5,12,-7
25,12,35,7,8,-1
25,12,36,20,40,-20
25,12,37,10,29,-19
25,12,38,8,17,-9
25,12,39,8,19,-11
25,12,40,10,20,-10
25,12,41,15,27,-12
25,12,42,8,26,-18
25,12,43,20,12,8
25,12,44,13,21,-8
25,12,45,9,22,-13
25,12,46,11,19,-8
25,12,47,14,17,-3
25,12,48,14,10,4
25,12,49,13,19,-6
25,12,50,9,25,-16
25,12,51,13,18,-5
25,12,52,10,15,-5
25,12,53,8,16,-8
25,12,54,8,15,-7
25,12,55,11,26,-15
25,12,56,12,14,-2
25,12,57,5,20,-15
25,12,58,15,14,1
25,12,59,10,8,2
25,12,60,9,14,-5
25,12,61,19,14,5
25,12,62,9,9,0
25,12,63,7,13,-6
25,12,64,13,13,0
25,12,65,8,14,-6
25,12,66,6,6,0
25,12,67,11,33,-22
25,12,68,4,28,-24
25,12,69,13,11,2
25,12,70,22,19,3
25,12,71,8,12,-4
25,12,72,2,11,-9
25,12,73,10,24,-14
25,12,74,3,4,-1
25,12,75,12,22,-10
25,12,76,18,15,3
25,12,77,16,14,2
25,12,78,7,15,-8
25,12,79,15,21,-6
25,12,80,15,25,-10
25,12,81,10,13,-3
25,12,82,10,19,-9
25,12,83,6,16,-10
25,12,84,7,32,-25
25,12,85,8,24,-16
25,12,86,7,20,-13
25,12,87,14,19,-5
25,12,88,15,10,5
25,12,89,22,10,12
25,12,90,8,28,-20
25,12,91,10,20,-10
25,12,92,22,15,7
25,12,93,15,23,-8
25,12,94,10,11,-1
25,12,95,14,29,-15
25,12,96,4,20,-16
25,12,97,24,27,-3
25,12,98,18,25,-7
25,12,99,9,23,-14
25,12,100,7,21,-14
25,12,101,14,10,4
25,12,102,9,14,-5
25,12,103,10,19,-9
25,12,104,12,11,1
25,12,105,13,23,-10
25,12,106,19,12,7
25,12,107,10,27,-17
25,12,108,11,14,-3
25,12,109,15,12,3
25,12,110,7,10,-3
25,12,111,12,16,-4
25,12,112,10,26,-16
25,12,113,6,18,-12
25,12,114,4,20,-16
25,12,115,14,20,-6
25,12,116,21,22,-1
25,12,117,18,16,2
25,12,118,19,17,2
25,12,119,10,9,1
25,12,120,7,9,-2
25,12,121,12,17,-5
25,12,122,17,18,-1
25,12,123,7,10,-3
25,12,124,12,16,-4
25,12,125,12,17,-5
25,12,126,14,16,-2
25,12,127,12,17,-5
25,12,128,9,18,-9
25,12,129,10,21,-11
25,12,130,10,18,-8
25,12,131,7,18,-11
25,12,132,7,18,-11
25,12,133,12,19,-7
25,12,134,9,21,-12
25,12,135,7,16,-9
25,12,136,15,17,-2
25,12,137,15,13,2
25,12,138,9,21,-12
25,12,139,14,18,-4
25,12,140,21,19,2
25,12,141,13,26,-13
25,12,142,6,19,-13
25,12,143,5,18,-13
25,12,144,17,12,5
25,12,145,2,25,-23
25,12,146,13,18,-5
25,12,147,4,6,-2
25,12,148,11,16,-5
25,12,149,13,12,1
25,12,150,19,20,-1
25,12,151,20,17,3
25,12,152,15,20,-5
25,12,153,11,15,-4
25,12,154,10,17,-7
25,12,155,3,25,-22
25,12,156,13,21,-8
25,12,157,10,18,-8
25,12,158,15,23,-8
25,12,159,2,11,-9
25,12,160,19,10,9
25,12,161,16,23,-7
25,12,162,14,15,-1
25,12,163,12,10,2
25,12,164,9,14,-5
25,12,165,20,31,-11
25,12,166,5,10,-5
25,12,167,11,16,-5
25,12,168,16,11,5
25,12,169,14,13,1
25,12,170,20,18,2
25,12,171,9,16,-7
25,12,172,16,24,-8
25,12,173,9,12,-3
25,12,174,20,10,10
25,12,175,15,15,0
25,12,176,13,8,5
25,12,177,14,15,-1
25,12,178,10,11,-1
25,12,179,8,27,-19
25,12,180,10,25,-15
25,12,181,10,18,-8
25,12,182,2,11,-9
25,12,183,8,16,-8
25,12,184,4,3,1
25,12,185,15,22,-7
25,12,186,12,24,-12
25,12,187,15,36,-21
25,12,188,6,16,-10
25,12,189,5,17,-12
25,12,190,13,11,2
25,12,191,7,25,-18
25,12,192,12,17,-5
25,12,193,9,24,-15
25,12,194,9,18,-9
25,12,195,18,17,1
25,12,196,14,44,-30
25,12,197,12,25,-13
25,12,198,7,23,-16
25,12,199,14,13,1
25,12,200,10,34,-24
25,12,201,7,5,2
25,12,202,18,24,-6
25,12,203,14,15,-1
25,12,204,9,21,-12
25,12,205,10,19,-9
25,12,206,12,13,-1
25,12,207,12,15,-3
25,12,208,9,16,-7
25,12,209,8,20,-12
25,12,210,6,15,-9
25,12,211,11,37,-26
25,12,212,16,10,6
25,12,213,7,18,-11
25,12,214,11,21,-10
25,12,215,6,13,-7
25,12,216,12,11,1
25,12,217,9,19,-10
25,12,218,8,24,-16
25,12,219,2,14,-12
25,12,220,16,24,-8
25,12,221,18,9,9
25,12,222,10,7,3
25,12,223,18,17,1
25,12,224,9,16,-7
25,12,225,13,15,-2
25,12,226,14,43,-29
25,12,227,13,28,-15
25,12,228,21,26,-5
25,12,229,15,18,-3
25,12,230,17,19,-2
25,12,231,6,15,-9
25,12,232,18,26,-8
25,12,233,19,15,4
25,12,234,15,17,-2
25,12,235,16,7,9
25,12,236,14,36,-22
25,12,237,15,22,-7
25,12,238,10,27,-17
25,12,239,29,28,1
25,12,240,6,16,-10
25,12,241,7,28,-21
25,12,242,9,8,1
25,12,243,13,26,-13
25,12,244,25,29,-4
25,12,245,6,22,-16
25,12,246,28,24,4
25,12,247,12,17,-5
25,12,248,15,13,2
25,12,249,19,23,-4
25,12,250,14,31,-17
25,12,251,7,19,-12
25,12,252,8,22,-14
25,12,253,15,14,1
25,12,254,11,13,-2
25,12,255,17,20,-3
25,12,256,15,15,0
25,12,257,15,17,-2
25,12,258,12,8,4
25,12,259,13,32,-19
25,12,260,9,28,-19
25,12,261,14,10,4
25,12,262,11,20,-9
25,12,263,12,20,-8
25,12,264,10,20,-10
25,12,265,10,22,-12
25,12,266,11,15,-4
25,12,267,5,7,-2
25,12,268,16,22,-6
25,12,269,4,13,-9
25,12,270,9,3,6
25,12,271,15,28,-13
25,12,272,14,29,-15
25,12,273,15,13,2
25,12,274,10,12,-2
25,12,275,16,13,3
25,12,276,12,17,-5
25,12,277,13,25,-12
25,12,278,8,23,-15
25,12,279,4,19,-15
25,12,280,16,18,-2
25,12,281,11,18,-7
25,12,282,17,18,-1
25,12,283,6,16,-10
25,12,284,8,11,-3
25,12,285,18,19,-1
25,12,286,18,8,10
25,12,287,17,21,-4
25,12,288,19,32,-13
25,12,289,9,27,-18
25,12,290,11,19,-8
25,12,291,17,29,-12
25,12,292,17,14,3
25,12,293,17,18,-1
25,12,294,27,25,2
25,12,295,21,20,1
25,12,296,15,19,-4
25,12,297,17,15,2
25,12,298,19,23,-4
25,12,299,18,21,-3
25,13,0,5,15,-10
25,13,1,15,25,-10
25,13,2,21,19,2
25,13,3,11,16,-5
25,13,4,10,25,-15
25,13,5,10,15,-5
25,13,6,7,10,-3
25,13,7,15,31,-16
25,13,8,4,13,-9
25,13,9,11,22,-11
25,13,10,10,23,-13
25,13,11,14,18,-4
25,13,12,14,21,-7
25,13,13,21,24,-3
25,13,14,14,16,-2
25,13,15,5,5,0
25,13,16,12,10,2
25,13,17,17,24,-7
25,13,18,11,24,-13
25,13,19,4,17,-13
25,13,20,7,13,-6
25,13,21,7,20,-13
25,13,22,6,14,-8
25,13,23,11,20,-9
25,13,24,9,13,-4
25,13,25,9,33,-24
25,13,26,4,21,-17
25,13,27,16,14,2
25,13,28,14,43,-29
25,13,29,14,17,-3
25,13,30,17,21,-4
25,13,31,18,16,2
25,13,32,8,14,-6
25,13,33,16,34,-18
25,13,34,13,25,-12
25,13,35,1,18,-17
25,13,36,16,25,-9
25,13,37,3,5,-2
25,13,38,17,25,-8
25,13,39,14,21,-7
25,13,40,8,11,-3
25,13,41,15,14,1
25,13,42,16,24,-8
25,13,43,10,28,-18
25,13,44,15,21,-6
25,13,45,12,10,2
25,13,46,8,10,-2
25,13,47,8,20,-12
25,13,48,12,9,3
25,13,49,12,25,-13
25,13,50,11,26,-15
25,13,51,4,11,-7
25,13,52,13,25,-12
25,13,53,16,21,-5
25,13,54,8,13,-5
25,13,55,7,11,-4
25,13,56,16,16,0
25,13,57,21,17,4
25,13,58,6,15,-9
25,13,59,8,16,-8
25,13,60,13,14,-1
25,13,61,21,20,1
25,13,62,9,7,2
25,13,63,9,15,-6
25,13,64,13,27,-14
25,13,65,5,16,-11
25,13,66,15,24,-9
25,13,67,8,16,-8
25,13,68,7,18,-11
25,13,69,13,12,1
25,13,70,13,11,2
25,13,71,16,38,-22
25,13,72,10,11,-1
25,13,73,7,12,-5
25,13,74,8,19,-11
25,13,75,9,23,-14
25,13,76,9,16,-7
25,13,77,9,31,-22
25,13,78,3,25,-22
25,13,79,13,20,-7
25,13,80,18,20,-2
25,13,81,15,27,-12
25,13,82,11,17,-6
25,13,83,19,10,9
25,13,84,15,29,-14
25,13,85,6,9,-3
25,13,86,12,14,-2
25,13,87,19,23,-4
25,13,88,3,22,-19
25,13,89,7,20,-13
25,13,90,14,15,-1
25,13,91,16,21,-5
25,13,92,11,24,-13
25,13,93,18,10,8
25,13,94,15,26,-11
25,13,95,8,16,-8
25,13,96,5,24,-19
25,13,97,19,14,5
25,13,98,13,17,-4
25,13,99,14,25,-11
25,13,100,8,11,-3
25,13,101,11,31,-20
25,13,102,6,10,-4
25,13,103,14,26,-12
25,13,104,18,15,3
25,13,105,14,24,-10
25,13,106,8,12,-4
25,13,107,11,6,5
25,13,108,15,27,-12
25,13,109,16,20,-4
25,13,110,22,20,2
25,13,111,7,20,-13
25,13,112,1,13,-12
25,13,113,13,25,-12
25,13,114,17,30,-13
25,13,115,9,32,-23
25,13,116,6,19,-13
25,13,117,10,14,-4
25,13,118,14,28,-14
25,13,119,10,14,-4
25,13,120,14,17,-3
25,13,121,13,29,-16
25,13,122,14,21,-7
25,13,123,10,8,2
25,13,124,4,17,-13
25,13,125,11,21,-10
25,13,126,12,28,-16
25,13,127,9,23,-14
25,13,128,13,22,-9
25,13,129,11,22,-11
25,13,130,7,15,-8
25,13,131,8,11,-3
25,13,132,15,23,-8
25,13,133,11,23,-12
25,13,134,9,21,-12
25,13,135,17,28,-11
25,13,136,5,13,-8
25,13,137,17,18,-1
25,13,138,8,3,5
25,13,139,5,17,-12
25,13,140,16,25,-9
25,13,141,10,23,-13
25,13,142,11,26,-15
25,13,143,8,10,-2
25,13,144,2,15,-13
25,13,145,10,9,1
25,13,146,11,31,-20
25,13,147,12,10,2
25,13,148,12,12,0
25,13,149,19,16,3
25,13,150,11,9,2
25,13,151,21,22,-1
25,13,152,10,12,-2
25,13,153,14,17,-3
25,13,154,7,13,-6
25,13,155,9,21,-12
25,13,156,5,18,-13
25,13,157,12,13,-1
25,13,158,14,20,-6
25,13,159,17,27,-10
25,13,160,11,19,-8
25,13,161,1,9,-8
25,13,162,15,20,-5
25,13,163,17,16,1
25,13,164,8,18,-10
25,13,165,10,14,-4
25,13,166,9,14,-5
25,13,167,7,9,-2
25,13,168,7,28,-21
25,13,169,24,20,4
25,13,170,11,8,3
25,13,171,15,20,-5
25,13,172,10,8,2
25,13,173,9,18,-9
25,13,174,12,14,-2
25,13,175,15,12,3
25,13,176,11,7,4
25,13,177,5,26,-21
25,13,178,21,14,7
25,13,179,17,14,3
25,13,180,6,16,-10
25,13,181,19,18,1
25,13,182,11,15,-4
25,13,183,12,19,-7
25,13,184,5,26,-21
25,13,185,5,8,-3
25,13,186,10,7,3
25,13,187,18,15,3
25,13,188,12,22,-10
25,13,189,15,18,-3
25,13,190,10,19,-9
25,13,191,14,26,-12
25,13,192,9,11,-2
25,13,193,7,26,-19
25,13,194,17,15,2
25,13,195,7,7,0
25,13,196,10,17,-7
25,13,197,14,14,0
25,13,198,2,14,-12
25,13,199,9,27,-18
25,13,200,10,13,-3
25,13,201,16,7,9
25,13,202,6,21,-15
25,13,203,12,15,-3
25,13,204,10,30,-20
25,13,205,5,10,-5
25,13,206,4,19,-15
25,13,207,6,11,-5
25,13,208,14,23,-9
25,13,209,26,21,5
25,13,210,16,8,8
25,13,211,7,5,2
25,13,212,6,34,-28
25,13,213,13,16,-3
25,13,214,8,14,-6
25,13,215,6,15,-9
25,13,216,10,19,-9
25,13,217,16,19,-3
25,13,218,14,27,-13
25,13,219,13,17,-4
25,13,220,20,29,-9
25,13,221,8,14,-6
25,13,222,10,20,-10
25,13,223,18,22,-4
25,13,224,20,20,0
25,13,225,8,10,-2
25,13,226,13,16,-3
25,13,227,16,16,0
25,13,228,25,29,-4
25,13,229,13,32,-19
25,13,230,15,24,-9
25,13,231,3,18,-15
25,13,232,15,21,-6
25,13,233,19,16,3
25,13,234,11,16,-5
25,13,235,7,20,-13
25,13,236,11,20,-9
25,13,237,13,28,-15
25,13,238,10,16,-6
25,13,239,15,32,-17
25,13,240,15,8,7
25,13,241,12,26,-14
25,13,242,11,16,-5
25,13,243,15,19,-4
25,13,244,9,13,-4
25,13,245,14,10,4
25,13,246,18,23,-5
25,13,247,13,20,-7
25,13,248,11,20,-9
25,13,249,12,30,-18
25,13,250,13,33,-20
25,13,251,15,14,1
25,13,252,13,13,0
25,13,253,21,22,-1
25,13,254,13,14,-1
25,13,255,6,15,-9
25,13,256,13,25,-12
25,13,257,10,19,-9
25,13,258,12,31,-19
25,13,259,17,22,-5
25,13,260,15,25,-10
25,13,261,2,14,-12
25,13,262,13,17,-4
25,13,263,6,13,-7
25,13,264,10,25,-15
25,13,265,13,26,-13
25,13,266,16,14,2
25,13,267,13,26,-13
25,13,268,7,13,-6
25,13,269,12,16,-4
25,13,270,6,20,-14
25,13,271,16,31,-15
25,13,272,10,9,1
25,13,273,3,16,-13
25,13,274,18,15,3
25,13,275,13,10,3
25,13,276,6,22,-16
25,13,277,9,26,-17
25,13,278,13,29,-16
25,13,279,18,40,-22
25,13,280,16,23,-7
25,13,281,2,14,-12
25,13,282,15,20,-5
25,13,283,6,30,-24
25,13,284,3,19,-16
25,13,285,11,24,-13
25,13,286,16,32,-16
25,13,287,14,38,-24
25,13,288,11,15,-4
25,13,289,8,10,-2
25,13,290,12,14,-2
25,13,291,13,11,2
25,13,292,13,15,-2
25,13,293,11,24,-13
25,13,294,19,24,-5
25,13,295,15,17,-2
25,13,296,12,29,-17
25,13,297,16,19,-3
25,13,298,22,16,6
25,13,299,9,23,-14
25,14,0,7,26,-19
25,14,1,5,24,-19
25,14,2,24,14,10
25,14,3,13,32,-19
25,14,4,10,17,-7
25,14,5,14,28,-14
25,14,6,10,13,-3
25,14,7,14,22,-8
25,14,8,9,13,-4
25,14,9,13,16,-3
25,14,10,21,23,-2
25,14,11,3,13,-10
25,14,12,6,26,-20
25,14,13,9,16,-7
25,14,14,10,17,-7
25,14,15,10,13,-3
25,14,16,10,11,-1
25,14,17,14,13,1
25,14,18,13,30,-17
25,14,19,11,18,-7
25,14,20,16,33,-17
25,14,21,7,18,-11
25,14,22,7,21,-14
25,14,23,6,17,-11
25,14,24,11,16,-5
25,14,25,14,12,2
25,14,26,6,15,-9
25,14,27,18,24,-6
25,14,28,16,20,-4
25,14,29,11,19,-8
25,14,30,12,14,-2
25,14,31,12,15,-3
25,14,32,9,16,-7
25,14,33,8,18,-10
25,14,34,14,30,-16
25,14,35,21,20,1
25,14,36,12,8,4
25,14,37,11,23,-12
25,14,38,17,24,-7
25,14,39,12,9,3
25,14,40,14,11,3
25,14,41,14,19,-5
25,14,42,5,18,-13
25,14,43,8,17,-9
25,14,44,15,12,3
25,14,45,17,19,-2
25,14,46,14,21,-7
25,14,47,15,14,1
25,14,48,9,19,-10
25,14,49,2,12,-10
25,14,50,10,11,-1
25,14,51,11,19,-8
25,14,52,15,23,-8
25,14,53,14,14,0
25,14,54,15,21,-6
25,14,55,6,13,-7
25,14,56,9,14,-5
25,14,57,7,14,-7
25,14,58,8,28,-20
25,14,59,24,16,8
25,14,60,10,16,-6
25,14,61,5,16,-11
25,14,62,10,37,-27
25,14,63,8,9,-1
25,14,64,15,22,-7
25,14,65,18,16,2
25,14,66,13,11,2
25,14,67,11,19,-8
25,14,68,13,31,-18
25,14,69,5,17,-12
25,14,70,11,12,-1
25,14,71,13,16,-3
25,14,72,7,17,-10
25,14,73,16,25,-9
25,14,74,8,17,-9
25,14,75,11,15,-4
25,14,76,14,15,-1
25,14,77,17,11,6
25,14,78,10,24,-14
25,14,79,19,28,-9
25,14,80,12,31,-19
25,14,81,5,7,-2
25,14,82,13,29,-16
25,14,83,18,11,7
25,14,84,16,9,7
25,14,85,15,19,-4
25,14,86,17,23,-6
25,14,87,15,21,-6
25,14,88,8,16,-8
25,14,89,27,23,4
25,14,90,17,21,-4
25,14,91,20,19,1
25,14,92,18,23,-5
25,14,93,3,17,-14
25,14,94,15,13,2
25,14,95,10,15,-5
25,14,96,5,8,-3
25,14,97,10,14,-4
25,14,98,9,20,-11
25,14,99,28,14,14
25,14,100,11,17,-6
25,14,101,4,6,-2
25,14,102,15,13,2
25,14,103,9,15,-6
25,14,104,10,35,-25
25,14,105,6,14,-8
25,14,106,6,16,-10
25,14,107,11,17,-6
25,14,108,12,26,-14
25,14,109,13,18,-5
25,14,110,21,19,2
25,14,111,11,21,-10
25,14,112,9,24,-15
25,14,113,9,20,-11
25,14,114,8,28,-20
25,14,115,21,28,-7
25,14,116,14,16,-2
25,14,117,21,13,8
25,14,118,10,15,-5
25,14,119,10,23,-13
25,14,120,11,18,-7
25,14,121,13,22,-9
25,14,122,14,14,0
25,14,123,9,10,-1
25,14,124,6,23,-17
25,14,125,14,12,2
25,14,126,6,12,-6
25,14,127,10,21,-11
25,14,128,4,2,2
25,14,129,16,18,-2
25,14,130,13,24,-11
25,14,131,15,26,-11
25,14,132,16,13,3
25,14,133,10,29,-19
25,14,134,10,18,-8
25,14,135,11,24,-13
25,14,136,11,18,-7
25,14,137,19,26,-7
25,14,138,15,20,-5
25,14,139,8,16,-8
25,14,140,9,10,-1
25,14,141,13,23,-10
25,14,142,13,16,-3
25,14,143,5,22,-17
25,14,144,13,14,-1
25,14,145,7,11,-4
25,14,146,22,34,-12
25,14,147,6,16,-10
25,14,148,9,23,-14
25,14,149,5,12,-7
25,14,150,9,9,0
25,14,151,12,9,3
25,14,152,3,16,-13
25,14,153,5,15,-10
25,14,154,7,20,-13
25,14,155,12,12,0
25,14,156,20,13,7
25,14,157,4,10,-6
25,14,158,21,16,5
25,14,159,15,18,-3
25,14,160,3,9,-6
25,14,161,15,16,-1
25,14,162,9,19,-10
25,14,163,8,16,-8
25,14,164,11,20,-9
25,14,165,19,22,-3
25,14,166,8,27,-19
25,14,167,7,8,-1
25,14,168,10,16,-6
25,14,169,17,9,8
25,14,170,5,11,-6
25,14,171,13,11,2
25,14,172,16,13,3
25,14,173,7,27,-20
25,14,174,11,15,-4
25,14,175,26,16,10
25,14,176,7,21,-14
25,14,177,31,21,10
25,14,178,9,14,-5
25,14,179,12,9,3
25,14,180,5,17,-12
25,14,181,4,8,-4
25,14,182,13,18,-5
25,14,183,14,14,0
25,14,184,12,15,-3
25,14,185,16,15,1
25,14,186,5,18,-13
25,14,187,16,17,-1
25,14,188,13,24,-11
25,14,189,10,14,-4
25,14,190,12,10,2
25,14,191,7,18,-11
25,14,192,15,24,-9
25,14,193,17,16,1
25,14,194,10,8,2
25,14,195,20,14,6
25,14,196,21,24,-3
25,14,197,8,14,-6
25,14,198,17,30,-13
25,14,199,10,26,-16
25,14,200,4,13,-9
25,14,201,10,22,-12
25,14,202,29,32,-3
25,14,203,19,24,-5
25,14,204,10,16,-6
25,14,205,9,18,-9
25,14,206,12,31,-19
25,14,207,0,13,-13
25,14,208,9,33,-24
25,14,209,19,10,9
25,14,210,12,16,-4
25,14,211,18,16,2
25,14,212,17,23,-6
25,14,213,15,31,-16
25,14,214,13,7,6
25,14,215,5,18,-13
25,14,216,12,20,-8
25,14,217,12,14,-2
25,14,218,6,19,-13
25,14,219,8,20,-12
25,14,220,18,31,-13
25,14,221,11,23,-12
25,14,222,10,9,1
25,14,223,11,30,-19
25,14,224,12,20,-8
25,14,225,10,20,-10
25,14,226,15,25,-10
25,14,227,7,10,-3
25,14,228,7,17,-10
25,14,229,11,13,-2
25,14,230,15,15,0
25,14,231,15,20,-5
25,14,232,24,28,-4
25,14,233,17,12,5
25,14,234,9,21,-12
25,14,235,8,9,-1
25,14,236,13,33,-20
25,14,237,3,3,0
25,14,238,13,23,-10
25,14,239,8,10,-2
25,14,240,12,14,-2
25,14,241,15,18,-3
25,14,242,16,15,1
25,14,243,15,17,-2
25,14,244,4,11,-7
25,14,245,12,15,-3
25,14,246,15,18,-3
25,14,247,18,21,-3
25,14,248,14,23,-9
25,14,249,10,11,-1
25,14,250,3,10,-7
25,14,251,18,19,-1
25,14,252,12,8,4
25,14,253,15,25,-10
25,14,254,6,14,-8
25,14,255,11,20,-9
25,14,256,11,7,4
25,14,257,11,10,1
25,14,258,16,21,-5
25,14,259,5,18,-13
25,14,260,9,23,-14
25,14,261,16,14,2
25,14,262,7,11,-4
25,14,263,16,18,-2
25,14,264,20,12,8
25,14,265,12,11,1
25,14,266,9,18,-9
25,14,267,10,15,-5
25,14,268,7,14,-7
25,14,269,18,28,-10
25,14,270,11,12,-1
25,14,271,8,14,-6
25,14,272,14,14,0
25,14,273,12,14,-2
25,14,274,9,19,-10
25,14,275,14,14,0
25,14,276,9,20,-11
25,14,277,10,20,-10
25,14,278,8,26,-18
25,14,279,8,12,-4
25,14,280,26,21,5
25,14,281,5,13,-8
25,14,282,17,17,0
25,14,283,6,9,-3
25,14,284,6,13,-7
25,14,285,16,27,-11
25,14,286,9,15,-6
25,14,287,10,28,-18
25,14,288,5,13,-8
25,14,289,8,26,-18
25,14,290,10,6,4
25,14,291,12,31,-19
25,14,292,12,14,-2
25,14,293,11,11,0
25,14,294,20,20,0
25,14,295,13,21,-8
25,14,296,11,25,-14
25,14,297,15,27,-12
25,14,298,13,23,-10
25,14,299,6,16,-10
25,15,0,10,15,-5
25,15,1,11,14,-3
25,15,2,10,19,-9
25,15,3,15,10,5
25,15,4,11,14,-3
25,15,5,3,16,-13
25,15,6,11,18,-7
25,15,7,2,12,-10
25,15,8,16,12,4
25,15,9,14,11,3
25,15,10,8,22,-14
25,15,11,9,22,-13
25,15,12,9,23,-14
25,15,13,8,15,-7
25,15,14,18,23,-5
25,15,15,5,15,-10
25,15,16,11,12,-1
25,15,17,6,20,-14
25,15,18,21,17,4
25,15,19,7,10,-3
25,15,20,13,20,-7
25,15,21,18,12,6
25,15,22,11,12,-1
25,15,23,25,43,-18
25,15,24,12,9,3
25,15,25,22,17,5
25,15,26,5,14,-9
25,15,27,13,26,-13
25,15,28,12,17,-5
25,15,29,18,16,2
25,15,30,18,16,2
25,15,31,10,11,-1
25,15,32,13,22,-9
25,15,33,10,21,-11
25,15,34,12,29,-17
25,15,35,10,22,-12
25,15,36,29,23,6
25,15,37,18,21,-3
25,15,38,15,19,-4
25,15,39,13,23,-10
25,15,40,16,21,-5
25,15,41,15,23,-8
25,15,42,15,19,-4
25,15,43,16,31,-15
25,15,44,12,19,-7
25,15,45,13,12,1
25,15,46,17,18,-1
25,15,47,8,24,-16
25,15,48,12,20,-8
25,15,49,17,13,4
25,15,50,8,12,-4
25,15,51,6,10,-4
25,15,52,19,14,5
25,15,53,14,16,-2
25,15,54,8,13,-5
25,15,55,18,27,-9
25,15,56,16,25,-9
25,15,57,5,22,-17
25,15,58,21,20,1
25,15,59,6,10,-4
25,15,60,11,17,-6
25,15,61,8,19,-11
25,15,62,7,16,-9
25,15,63,13,27,-14
25,15,64,19,27,-8
25,15,65,13,19,-6
25,15,66,14,20,-6
25,15,67,12,11,1
25,15,68,11,21,-10
25,15,69,8,9,-1
25,15,70,8,14,-6
25,15,71,19,34,-15
25,15,72,3,16,-13
25,15,73,16,39,-23
25,15,74,11,7,4
25,15,75,17,23,-6
25,15,76,11,8,3
25,15,77,8,23,-15
25,15,78,17,21,-4
25,15,79,14,14,0
25,15,80,10,20,-10
25,15,81,8,24,-16
25,15,82,11,16,-5
25,15,83,15,13,2
25,15,84,17,21,-4
25,15,85,17,24,-7
25,15,86,19,22,-3
25,15,87,17,12,5
25,15,88,7,8,-1
25,15,89,6,25,-19
25,15,90,17,22,-5
25,15,91,15,18,-3
25,15,92,9,19,-10
25,15,93,11,27,-16
25,15,94,16,19,-3
25,15,95,15,13,2
25,15,96,17,24,-7
25,15,97,13,16,-3
25,15,98,20,19,1
25,15,99,8,27,-19
25,15,100,16,12,4
25,15,101,16,18,-2
25,15,102,11,15,-4
25,15,103,13,8,5
25,15,104,7,10,-3
25,15,105,22,22,0
25,15,106,10,15,-5
25,15,107,12,12,0
25,15,108,14,5,9
25,15,109,9,34,-25
25,15,110,6,16,-10
25,15,111,15,18,-3
25,15,112,6,10,-4
25,15,113,10,15,-5
25,15,114,13,23,-10
25,15,115,16,15,1
25,15,116,22,16,6
25,15,117,24,23,1
25,15,118,9,16,-7
25,15,119,5,20,-15
25,15,120,16,17,-1
25,15,121,7,13,-6
25,15,122,11,22,-11
25,15,123,10,28,-18
25,15,124,8,14,-6
25,15,125,18,37,-19
25,15,126,17,27,-10
25,15,127,9,17,-8
25,15,128,13,24,-11
25,15,129,10,18,-8
25,15,130,11,22,-11
25,15,131,13,13,0
25,15,132,7,18,-11
25,15,133,14,26,-12
25,15,134,10,13,-3
25,15,135,10,14,-4
25,15,136,14,14,0
25,15,137,7,3,4
25,15,138,5,12,-7
25,15,139,7,18,-11
25,15,140,9,14,-5
25,15,141,23,14,9
25,15,142,16,22,-6
25,15,143,13,23,-10
25,15,144,11,15,-4
25,15,145,4,19,-15
25,15,146,11,10,1
25,15,147,7,8,-1
25,15,148,5,17,-12
25,15,149,8,12,-4
25,15,150,16,18,-2
25,15,151,17,15,2
25,15,152,10,20,-10
25,15,153,12,20,-8
25,15,154,14,12,2
25,15,155,7,19,-12
25,15,156,11,18,-7
25,15,157,15,26,-11
25,15,158,4,13,-9
25,15,159,9,11,-2
25,15,160,4,9,-5
25,15,161,10,23,-13
25,15,162,13,25,-12
25,15,163,9,10,-1
25,15,164,17,7,10
25,15,165,13,29,-16
25,15,166,11,8,3
25,15,167,11,26,-15
25,15,168,14,13,1
25,15,169,11,23,-12
25,15,170,20,14,6
25,15,171,4,7,-3
25,15,172,10,32,-22
25,15,173,9,27,-18
25,15,174,13,12,1
25,15,175,22,15,7
25,15,176,9,7,2
25,15,177,8,9,-1
25,15,178,4,15,-11
25,15,179,6,14,-8
25,15,180,9,16,-7
25,15,181,15,17,-2
25,15,182,16,13,3
25,15,183,7,12,-5
25,15,184,14,19,-5
25,15,185,5,15,-10
25,15,186,14,16,-2
25,15,187,15,17,-2
25,15,188,13,30,-17
25,15,189,5,13,-8
25,15,190,10,9,1
25,15,191,16,17,-1
25,15,192,5,3,2
25,15,193,13,24,-11
25,15,194,8,20,-12
25,15,195,13,13,0
25,15,196,15,15,0
25,15,197,9,25,-16
25,15,198,8,15,-7
25,15,199,4,17,-13
25,15,200,17,22,-5
25,15,201,9,24,-15
25,15,202,13,19,-6
25,15,203,10,24,-14
25,15,204,24,21,3
25,15,205,24,18,6
25,15,206,4,11,-7
25,15,207,14,27,-13
25,15,208,18,15,3
25,15,209,23,16,7
25,15,210,5,21,-16
25,15,211,4,22,-18
25,15,212,18,23,-5
25,15,213,15,23,-8
25,15,214,10,25,-15
25,15,215,13,17,-4
25,15,216,13,12,1
25,15,217,11,13,-2
25,15,218,14,21,-7
25,15,219,15,12,3
25,15,220,16,18,-2
25,15,221,9,17,-8
25,15,222,14,19,-5
25,15,223,5,19,-14
25,15,224,11,16,-5
25,15,225,11,21,-10
25,15,226,11,9,2
25,15,227,10,16,-6
25,15,228,9,14,-5
25,15,229,11,26,-15
25,15,230,14,22,-8
25,15,231,18,25,-7
25,15,232,13,22,-9
25,15,233,11,20,-9
25,15,234,8,11,-3
25,15,235,12,14,-2
25,15,236,5,13,-8
25,15,237,21,31,-10
25,15,238,13,13,0
25,15,239,18,24,-6
25,15,240,11,23,-12
25,15,241,6,15,-9
25,15,242,22,27,-5
25,15,243,26,28,-2
25,15,244,10,14,-4
25,15,245,9,19,-10
25,15,246,17,10,7
25,15,247,15,25,-10
25,15,248,6,5,1
25,15,249,11,32,-21
25,15,250,5,10,-5
25,15,251,9,14,-5
25,15,252,14,13,1
25,15,253,19,22,-3
25,15,254,10,16,-6
25,15,255,11,20,-9
25,15,256,10,14,-4
25,15,257,11,10,1
25,15,258,5,28,-23
25,15,259,11,10,1
25,15,260,11,20,-9
25,15,261,14,17,-3
25,15,262,14,25,-11
25,15,263,11,18,-7
25,15,264,15,20,-5
25,15,265,14,11,3
25,15,266,5,13,-8
25,15,267,12,19,-7
25,15,268,11,15,-4
25,15,269,20,29,-9
25,15,270,23,36,-13
25,15,271,13,16,-3
25,15,272,15,10,5
25,15,273,6,15,-9
25,15,274,10,6,4
25,15,275,9,19,-10
25,15,276,5,3,2
25,15,277,15,20,-5
25,15,278,23,13,10
25,15,279,5,5,0
25,15,280,10,15,-5
25,15,281,6,10,-4
25,15,282,12,28,-16
25,15,283,17,19,-2
25,15,284,15,23,-8
25,15,285,14,16,-2
25,15,286,16,38,-22
25,15,287,15,15,0
25,15,288,17,24,-7
25,15,289,7,19,-12
25,15,290,11,4,7
25,15,291,14,18,-4
25,15,292,16,26,-10
25,15,293,11,17,-6
25,15,294,9,16,-7
25,15,295,25,28,-3
25,15,296,10,14,-4
25,15,297,13,18,-5
25,15,298,15,16,-1
25,15,299,10,28,-18
25,16,0,7,9,-2
25,16,1,8,29,-21
25,16,2,8,30,-22
25,16,3,21,21,0
25,16,4,19,16,3
25,16,5,16,29,-13
25,16,6,6,29,-23
25,16,7,4,15,-11
25,16,8,14,12,2
25,16,9,7,20,-13
25,16,10,17,12,5
25,16,11,4,4,0
25,16,12,5,17,-12
25,16,13,13,18,-5
25,16,14,12,12,0
25,16,15,13,14,-1
25,16,16,10,10,0
25,16,17,4,9,-5
25,16,18,16,9,7
25,16,19,9,26,-17
25,16,20,20,21,-1
25,16,21,11,19,-8
25,16,22,11,15,-4
25,16,23,7,19,-12
25,16,24,13,20,-7
25,16,25,12,15,-3
25,16,26,4,15,-11
25,16,27,24,31,-7
25,16,28,18,14,4
25,16,29,6,16,-10
25,16,30,19,22,-3
25,16,31,8,9,-1
25,16,32,10,28,-18
25,16,33,15,16,-1
25,16,34,14,20,-6
25,16,35,19,26,-7
25,16,36,8,11,-3
25,16,37,7,10,-3
25,16,38,15,14,1
25,16,39,16,11,5
25,16,40,12,23,-11
25,16,41,14,25,-11
25,16,42,6,10,-4
25,16,43,19,21,-2
25,16,44,10,9,1
25,16,45,18,21,-3
25,16,46,11,25,-14
25,16,47,4,13,-9
25,16,48,12,18,-6
25,16,49,16,24,-8
25,16,50,9,20,-11
25,16,51,16,21,-5
25,16,52,5,11,-6
25,16,53,10,18,-8
25,16,54,8,14,-6
25,16,55,20,16,4
25,16,56,12,20,-8
25,16,57,4,14,-10
25,16,58,5,11,-6
25,16,59,18,13,5
25,16,60,19,16,3
25,16,61,19,29,-10
25,16,62,15,22,-7
25,16,63,8,17,-9
25,16,64,10,23,-13
25,16,65,20,20,0
25,16,66,9,23,-14
25,16,67,6,7,-1
25,16,68,7,21,-14
25,16,69,14,27,-13
25,16,70,16,16,0
25,16,71,18,26,-8
25,16,72,6,12,-6
25,16,73,4,10,-6
25,16,74,18,25,-7
25,16,75,7,13,-6
25,16,76,16,28,-12
25,16,77,9,23,-14
25,16,78,16,23,-7
25,16,79,10,25,-15
25,16,80,3,20,-17
25,16,81,12,16,-4
25,16,82,4,22,-18
25,16,83,18,30,-12
25,16,84,10,12,-2
25,16,85,8,21,-13
25,16,86,16,19,-3
25,16,87,5,20,-15
25,16,88,6,21,-15
25,16,89,9,24,-15
25,16,90,19,27,-8
25,16,91,15,15,0
25,16,92,20,8,12
25,16,93,19,26,-7
25,16,94,15,17,-2
25,16,95,20,19,1
25,16,96,21,16,5
25,16,97,12,12,0
25,16,98,11,15,-4
25,16,99,6,17,-11
25,16,100,6,23,-17
25,16,101,8,17,-9
25,16,102,14,29,-15
25,16,103,14,19,-5
25,16,104,4,13,-9
25,16,105,11,12,-1
25,16,106,4,25,-21
25,16,107,7,10,-3
25,16,108,17,20,-3
25,16,109,18,18,0
25,16,110,7,13,-6
25,16,111,19,18,1
25,16,112,13,20,-7
25,16,113,6,14,-8
25,16,114,17,26,-9
25,16,115,17,16,1
25,16,116,4,11,-7
25,16,117,13,11,2
25,16,118,19,17,2
25,16,119,29,15,14
25,16,120,14,23,-9
25,16,121,9,8,1
25,16,122,14,10,4
25,16,123,10,16,-6
25,16,124,16,33,-17
25,16,125,8,11,-3
25,16,126,12,15,-3
25,16,127,22,28,-6
25,16,128,19,20,-1
25,16,129,11,22,-11
25,16,130,17,23,-6
25,16,131,3,16,-13
25,16,132,4,9,-5
25,16,133,10,16,-6
25,16,134,13,22,-9
25,16,135,12,16,-4
25,16,136,6,14,-8
25,16,137,9,18,-9
25,16,138,19,22,-3
25,16,139,12,14,-2
25,16,140,9,23,-14
25,16,141,15,25,-10
25,16,142,16,13,3
25,16,143,8,19,-11
25,16,144,10,8,2
25,16,145,6,21,-15
25,16,146,12,13,-1
25,16,147,9,9,0
25,16,148,11,14,-3
25,16,149,14,24,-10
25,16,150,11,8,3
25,16,151,12,19,-7
25,16,152,16,20,-4
25,16,153,10,11,-1
25,16,154,12,13,-1
25,16,155,22,23,-1
25,16,156,11,25,-14
25,16,157,13,16,-3
25,16,158,3,3,0
25,16,159,7,19,-12
25,16,160,14,32,-18
25,16,161,23,21,2
25,16,162,21,17,4
25,16,163,8,20,-12
25,16,164,5,6,-1
25,16,165,20,19,1
25,16,166,13,15,-2
25,16,167,9,13,-4
25,16,168,16,13,3
25,16,169,6,12,-6
25,16,170,15,14,1
25,16,171,1,28,-27
25,16,172,2,8,-6
25,16,173,19,20,-1
25,16,174,6,12,-6
25,16,175,11,8,3
25,16,176,17,12,5
25,16,177,16,23,-7
25,16,178,11,13,-2
25,16,179,4,15,-11
25,16,180,5,9,-4
25,16,181,19,15,4
25,16,182,28,23,5
25,16,183,19,23,-4
25,16,184,12,22,-10
25,16,185,8,16,-8
25,16,186,7,20,-13
25,16,187,21,22,-1
25,16,188,10,16,-6
25,16,189,19,19,0
25,16,190,10,11,-1
25,16,191,13,13,0
25,16,192,10,21,-11
25,16,193,5,9,-4
25,16,194,16,14,2
25,16,195,11,29,-18
25,16,196,16,15,1
25,16,197,5,25,-20
25,16,198,9,15,-6
25,16,199,22,24,-2
25,16,200,11,12,-1
25,16,201,22,9,13
25,16,202,11,11,0
25,16,203,8,21,-13
25,16,204,2,10,-8
25,16,205,4,12,-8
25,16,206,6,6,0
25,16,207,14,9,5
25,16,208,9,35,-26
25,16,209,11,14,-3
25,16,210,9,8,1
25,16,211,19,17,2
25,16,212,6,22,-16
25,16,213,12,18,-6
25,16,214,10,18,-8
25,16,215,13,15,-2
25,16,216,14,16,-2
25,16,217,10,18,-8
25,16,218,8,11,-3
25,16,219,6,16,-10
25,16,220,7,20,-13
25,16,221,8,23,-15
25,16,222,8,20,-12
25,16,223,4,14,-10
25,16,224,25,20,5
25,16,225,12,18,-6
25,16,226,17,15,2
25,16,227,20,11,9
25,16,228,7,10,-3
25,16,229,12,23,-11
25,16,230,11,14,-3
25,16,231,10,20,-10
25,16,232,7,3,4
25,16,233,11,18,-7
25,16,234,3,8,-5
25,16,235,4,26,-22
25,16,236,10,17,-7
25,16,237,5,10,-5
25,16,238,3,19,-16
25,16,239,9,5,4
25,16,240,12,9,3
25,16,241,21,30,-9
25,16,242,9,24,-15
25,16,243,12,11,1
25,16,244,14,21,-7
25,16,245,7,7,0
25,16,246,7,14,-7
25,16,247,14,29,-15
25,16,248,17,32,-15
25,16,249,6,11,-5
25,16,250,10,11,-1
25,16,251,8,17,-9
25,16,252,10,17,-7
25,16,253,28,27,1
25,16,254,14,17,-3
25,16,255,12,17,-5
25,16,256,12,23,-11
25,16,257,11,18,-7
25,16,258,15,12,3
25,16,259,17,22,-5
25,16,260,18,14,4
25,16,261,9,13,-4
25,16,262,20,12,8
25,16,263,14,18,-4
25,16,264,14,9,5
25,16,265,10,25,-15
25,16,266,14,7,7
25,16,267,15,20,-5
25,16,268,12,26,-14
25,16,269,12,11,1
25,16,270,20,26,-6
25,16,271,9,14,-5
25,16,272,21,17,4
25,16,273,15,12,3
25,16,274,12,20,-8
25,16,275,9,13,-4
25,16,276,6,16,-10
25,16,277,19,23,-4
25,16,278,4,8,-4
25,16,279,13,15,-2
25,16,280,10,16,-6
25,16,281,16,34,-18
25,16,282,13,10,3
25,16,283,9,13,-4
25,16,284,9,15,-6
25,16,285,11,16,-5
25,16,286,10,21,-11
25,16,287,13,16,-3
25,16,288,12,18,-6
25,16,289,14,15,-1
25,16,290,7,20,-13
25,16,291,6,11,-5
25,16,292,17,24,-7
25,16,293,15,10,5
25,16,294,15,16,-1
25,16,295,11,17,-6
25,16,296,8,30,-22
25,16,297,12,21,-9
25,16,298,9,19,-10
25,16,299,14,23,-9
25,17,0,20,9,11
25,17,1,16,13,3
25,17,2,8,8,0
25,17,3,5,12,-7
25,17,4,13,34,-21
25,17,5,10,11,-1
25,17,6,13,17,-4
25,17,7,13,21,-8
25,17,8,14,10,4
25,17,9,9,12,-3
25,17,10,5,11,-6
25,17,11,7,14,-7
25,17,12,3,6,-3
25,17,13,9,14,-5
25,17,14,5,14,-9
25,17,15,4,13,-9
25,17,16,11,14,-3
25,17,17,7,31,-24
25,17,18,17,12,5
25,17,19,15,8,7
25,17,20,8,9,-1
25,17,21,12,31,-19
25,17,22,11,9,2
25,17,23,11,18,-7
25,17,24,12,12,0
25,17,25,11,3,8
25,17,26,9,15,-6
25,17,27,13,11,2
25,17,28,17,20,-3
25,17,29,6,18,-12
25,17,30,16,13,3
25,17,31,13,9,4
25,17,32,13,29,-16
25,17,33,9,9,0
25,17,34,11,13,-2
25,17,35,6,15,-9
25,17,36,7,23,-16
25,17,37,29,16,13
25,17,38,11,12,-1
25,17,39,5,12,-7
25,17,40,17,15,2
25,17,41,10,23,-13
25,17,42,19,17,2
25,17,43,10,7,3
25,17,44,10,14,-4
25,17,45,24,19,5
25,17,46,18,27,-9
25,17,47,30,29,1
25,17,48,6,12,-6
25,17,49,11,8,3
25,17,50,10,17,-7
25,17,51,17,19,-2
25,17,52,3,13,-10
25,17,53,13,17,-4
25,17,54,10,16,-6
25,17,55,14,6,8
25,17,56,13,14,-1
25,17,57,13,14,-1
25,17,58,19,25,-6
25,17,59,12,13,-1
25,17,60,18,20,-2
25,17,61,4,7,-3
25,17,62,11,12,-1
25,17,63,11,22,-11
25,17,64,17,16,1
25,17,65,10,19,-9
25,17,66,15,23,-8
25,17,67,15,19,-4
25,17,68,16,9,7
25,17,69,17,8,9
25,17,70,14,10,4
25,17,71,9,16,-7
25,17,72,23,40,-17
25,17,73,17,19,-2
25,17,74,13,17,-4
25,17,75,10,19,-9
25,17,76,16,16,0
25,17,77,14,15,-1
25,17,78,6,13,-7
25,17,79,14,20,-6
25,17,80,4,29,-25
25,17,81,2,21,-19
25,17,82,6,17,-11
25,17,83,15,13,2
25,17,84,12,22,-10
25,17,85,7,17,-10
25,17,86,17,8,9
25,17,87,17,14,3
25,17,88,12,22,-10
25,17,89,16,26,-10
25,17,90,13,10,3
25,17,91,7,15,-8
25,17,92,7,12,-5
25,17,93,12,10,2
25,17,94,20,18,2
25,17,95,12,24,-12
25,17,96,14,10,4
25,17,97,12,7,5
25,17,98,12,20,-8
25,17,99,12,16,-4
25,17,100,13,22,-9
25,17,101,9,20,-11
25,17,102,17,20,-3
25,17,103,8,20,-12
25,17,104,17,20,-3
25,17,105,12,26,-14
25,17,106,2,7,-5
25,17,107,17,16,1
25,17,108,9,18,-9
25,17,109,9,17,-8
25,17,110,19,11,8
25,17,111,18,26,-8
25,17,112,5,7,-2
25,17,113,13,30,-17
25,17,114,14,18,-4
25,17,115,14,24,-10
25,17,116,13,10,3
25,17,117,11,13,-2
25,17,118,12,13,-1
25,17,119,17,13,4
25,17,120,13,16,-3
25,17,121,4,14,-10
25,17,122,15,19,-4
25,17,123,14,14,0
25,17,124,4,9,-5
25,17,125,17,21,-4
25,17,126,11,15,-4
25,17,127,12,20,-8
25,17,128,12,27,-15
25,17,129,11,30,-19
25,17,130,12,18,-6
25,17,131,7,13,-6
25,17,132,9,15,-6
25,17,133,9,6,3
25,17,134,12,20,-8
25,17,135,10,20,-10
25,17,136,10,13,-3
25,17,137,8,8,0
25,17,138,15,12,3
25,17,139,9,8,1
25,17,140,20,9,11
25,17,141,8,14,-6
25,17,142,9,17,-8
25,17,143,10,16,-6
25,17,144,12,20,-8
25,17,145,13,14,-1
25,17,146,17,24,-7
25,17,147,42,24,18
25,17,148,18,27,-9
25,17,149,14,20,-6
25,17,150,11,36,-25
25,17,151,16,18,-2
25,17,152,19,23,-4
25,17,153,9,12,-3
25,17,154,21,21,0
25,17,155,10,19,-9
25,17,156,9,28,-19
25,17,157,4,10,-6
25,17,158,13,13,0
25,17,159,8,19,-11
25,17,160,11,13,-2
25,17,161,6,22,-16
25,17,162,5,23,-18
25,17,163,23,27,-4
25,17,164,15,6,9
25,17,165,7,9,-2
25,17,166,15,21,-6
25,17,167,6,11,-5
25,17,168,5,12,-7
25,17,169,6,18,-12
25,17,170,11,20,-9
25,17,171,10,19,-9
25,17,172,13,14,-1
25,17,173,20,15,5
25,17,174,8,18,-10
25,17,175,15,12,3
25,17,176,1,15,-14
25,17,177,5,25,-20
25,17,178,8,11,-3
25,17,179,5,11,-6
25,17,180,18,21,-3
25,17,181,5,8,-3
25,17,182,9,19,-10
25,17,183,6,4,2
25,17,184,23,43,-20
25,17,185,12,23,-11
25,17,186,11,9,2
25,17,187,20,17,3
25,17,188,8,19,-11
25,17,189,22,22,0
25,17,190,7,16,-9
25,17,191,15,15,0
25,17,192,18,12,6
25,17,193,9,15,-6
25,17,194,18,27,-9
25,17,195,5,13,-8
25,17,196,6,15,-9
25,17,197,12,25,-13
25,17,198,17,15,2
25,17,199,20,17,3
25,17,200,13,19,-6
25,17,201,8,27,-19
25,17,202,11,19,-8
25,17,203,8,13,-5
25,17,204,12,24,-12
25,17,205,15,29,-14
25,17,206,9,21,-12
25,17,207,13,15,-2
25,17,208,7,18,-11
25,17,209,10,11,-1
25,17,210,18,28,-10
25,17,211,9,9,0
25,17,212,12,14,-2
25,17,213,6,7,-1
25,17,214,13,21,-8
25,17,215,11,23,-12
25,17,216,14,9,5
25,17,217,5,7,-2
25,17,218,13,18,-5
25,17,219,13,14,-1
25,17,220,11,8,3
25,17,221,19,28,-9
25,17,222,14,21,-7
25,17,223,23,29,-6
25,17,224,12,27,-15
25,17,225,10,8,2
25,17,226,13,15,-2
25,17,227,14,25,-11
25,17,228,5,11,-6
25,17,229,18,16,2
25,17,230,4,21,-17
25,17,231,8,22,-14
25,17,232,10,12,-2
25,17,233,7,9,-2
25,17,234,18,22,-4
25,17,235,17,24,-7
25,17,236,14,28,-14
25,17,237,15,5,10
25,17,238,12,15,-3
25,17,239,6,6,0
25,17,240,19,23,-4
25,17,241,9,22,-13
25,17,242,16,12,4
25,17,243,16,21,-5
25,17,244,12,21,-9
25,17,245,7,10,-3
25,17,246,8,12,-4
25,17,247,7,8,-1
25,17,248,21,37,-16
25,17,249,22,22,0
25,17,250,7,15,-8
25,17,251,14,46,-32
25,17,252,10,15,-5
25,17,253,6,23,-17
25,17,254,6,11,-5
25,17,255,6,17,-11
25,17,256,7,7,0
25,17,257,7,9,-2
25,17,258,7,13,-6
25,17,259,7,12,-5
25,17,260,9,8,1
25,17,261,8,7,1
25,17,262,20,30,-10
25,17,263,9,23,-14
25,17,264,7,5,2
25,17,265,16,14,2
25,17,266,25,26,-1
25,17,267,10,12,-2
25,17,268,9,27,-18
25,17,269,18,8,10
25,17,270,8,3,5
25,17,271,5,3,2
25,17,272,11,34,-23
25,17,273,7,10,-3
25,17,274,7,13,-6
25,17,275,15,13,2
25,17,276,13,25,-12
25,17,277,8,15,-7
25,17,278,6,17,-11
25,17,279,22,15,7
25,17,280,9,19,-10
25,17,281,14,19,-5
25,17,282,15,19,-4
25,17,283,8,38,-30
25,17,284,17,24,-7
25,17,285,5,23,-18
25,17,286,15,19,-4
25,17,287,13,11,2
25,17,288,24,12,12
25,17,289,9,16,-7
25,17,290,17,21,-4
25,17,291,11,10,1
25,17,292,15,15,0
25,17,293,22,17,5
25,17,294,21,22,-1
25,17,295,14,18,-4
25,17,296,8,16,-8
25,17,297,20,31,-11
25,17,298,17,15,2
25,17,299,9,11,-2
25,18,0,8,14,-6
25,18,1,8,14,-6
25,18,2,20,10,10
25,18,3,10,19,-9
25,18,4,23,13,10
25,18,5,18,21,-3
25,18,6,9,21,-12
25,18,7,17,17,0
25,18,8,24,21,3
25,18,9,10,13,-3
25,18,10,17,10,7
25,18,11,16,16,0
25,18,12,28,21,7
25,18,13,8,20,-12
25,18,14,19,16,3
25,18,15,13,17,-4
25,18,16,21,12,9
25,18,17,12,15,-3
25,18,18,16,12,4
25,18,19,21,24,-3
25,18,20,19,15,4
25,18,21,19,24,-5
25,18,22,15,15,0
25,18,23,10,8,2
25,18,24,11,13,-2
25,18,25,22,15,7
25,18,26,23,17,6
25,18,27,16,18,-2
25,18,28,10,12,-2
25,18,29,8,13,-5
25,18,30,14,12,2
25,18,31,9,22,-13
25,18,32,17,14,3
25,18,33,10,13,-3
25,18,34,13,12,1
25,18,35,17,12,5
25,18,36,13,26,-13
25,18,37,6,17,-11
25,18,38,9,13,-4
25,18,39,12,21,-9
25,18,40,11,10,1
25,18,41,16,26,-10
25,18,42,13,15,-2
25,18,43,28,18,10
25,18,44,7,17,-10
25,18,45,13,19,-6
25,18,46,12,5,7
25,18,47,18,17,1
25,18,48,7,19,-12
25,18,49,14,23,-9
25,18,50,10,15,-5
25,18,51,19,5,14
25,18,52,6,16,-10
25,18,53,11,20,-9
25,18,54,21,19,2
25,18,55,11,9,2
25,18,56,12,7,5
25,18,57,12,22,-10
25,18,58,7,14,-7
25,18,59,18,16,2
25,18,60,9,9,0
25,18,61,13,16,-3
25,18,62,22,24,-2
25,18,63,22,17,5
25,18,64,17,11,6
25,18,65,4,9,-5
25,18,66,15,19,-4
25,18,67,11,18,-7
25,18,68,18,19,-1
25,18,69,18,20,-2
25,18,70,3,11,-8
25,18,71,10,18,-8
25,18,72,21,16,5
25,18,73,11,17,-6
25,18,74,15,11,4
25,18,75,12,21,-9
25,18,76,14,7,7
25,18,77,14,13,1
25,18,78,4,15,-11
25,18,79,14,22,-8
25,18,80,8,16,-8
25,18,81,12,24,-12
25,18,82,7,19,-12
25,18,83,7,8,-1
25,18,84,2,11,-9
25,18,85,8,16,-8
25,18,86,7,21,-14
25,18,87,10,8,2
25,18,88,9,13,-4
25,18,89,13,13,0
25,18,90,12,15,-3
25,18,91,12,19,-7
25,18,92,16,15,1
25,18,93,19,13,6
25,18,94,13,16,-3
25,18,95,10,12,-2
25,18,96,7,17,-10
25,18,97,16,14,2
25,18,98,17,19,-2
25,18,99,3,11,-8
25,18,100,5,19,-14
25,18,101,11,6,5
25,18,102,11,16,-5
25,18,103,9,12,-3
25,18,104,18,24,-6
25,18,105,6,8,-2
25,18,106,9,29,-20
25,18,107,14,16,-2
25,18,108,8,14,-6
25,18,109,12,18,-6
25,18,110,14,11,3
25,18,111,8,9,-1
25,18,112,7,9,-2
25,18,113,16,14,2
25,18,114,13,23,-10
25,18,115,17,26,-9
25,18,116,21,17,4
25,18,117,14,21,-7
25,18,118,14,15,-1
25,18,119,8,20,-12
25,18,120,21,9,12
25,18,121,11,14,-3
25,18,122,10,17,-7
25,18,123,10,17,-7
25,18,124,12,16,-4
25,18,125,5,11,-6
25,18,126,5,22,-17
25,18,127,20,12,8
25,18,128,14,18,-4
25,18,129,5,20,-15
25,18,130,16,11,5
25,18,131,12,16,-4
25,18,132,18,19,-1
25,18,133,14,31,-17
25,18,134,13,17,-4
25,18,135,35,35,0
25,18,136,14,8,6
25,18,137,11,16,-5
25,18,138,27,20,7
25,18,139,15,15,0
25,18,140,26,23,3
25,18,141,12,8,4
25,18,142,9,25,-16
25,18,143,5,11,-6
25,18,144,13,11,2
25,18,145,5,14,-9
25,18,146,16,15,1
25,18,147,16,13,3
25,18,148,5,8,-3
25,18,149,7,18,-11
25,18,150,10,15,-5
25,18,151,12,16,-4
25,18,152,8,8,0
25,18,153,11,27,-16
25,18,154,28,17,11
25,18,155,8,14,-6
25,18,156,18,23,-5
25,18,157,9,21,-12
25,18,158,11,18,-7
25,18,159,8,17,-9
25,18,160,7,16,-9
25,18,161,8,10,-2
25,18,162,19,10,9
25,18,163,12,21,-9
25,18,164,13,16,-3
25,18,165,13,10,3
25,18,166,12,9,3
25,18,167,6,18,-12
25,18,168,15,19,-4
25,18,169,2,13,-11
25,18,170,10,18,-8
25,18,171,1,10,-9
25,18,172,18,19,-1
25,18,173,4,15,-11
25,18,174,16,12,4
25,18,175,13,15,-2
25,18,176,8,31,-23
25,18,177,4,13,-9
25,18,178,13,32,-19
25,18,179,16,25,-9
25,18,180,3,5,-2
25,18,181,8,19,-11
25,18,182,13,6,7
25,18,183,9,10,-1
25,18,184,13,12,1
25,18,185,14,15,-1
25,18,186,24,20,4
25,18,187,9,18,-9
25,18,188,5,16,-11
25,18,189,13,10,3
25,18,190,10,10,0
25,18,191,11,16,-5
25,18,192,12,13,-1
25,18,193,18,25,-7
25,18,194,11,16,-5
25,18,195,6,21,-15
25,18,196,3,19,-16
25,18,197,12,9,3
25,18,198,16,14,2
25,18,199,17,20,-3
25,18,200,9,10,-1
25,18,201,8,19,-11
25,18,202,5,10,-5
25,18,203,12,18,-6
25,18,204,5,16,-11
25,18,205,6,25,-19
25,18,206,6,19,-13
25,18,207,11,20,-9
25,18,208,17,23,-6
25,18,209,11,6,5
25,18,210,7,20,-13
25,18,211,12,12,0
25,18,212,11,19,-8
25,18,213,22,24,-2
25,18,214,8,11,-3
25,18,215,17,18,-1
25,18,216,20,15,5
25,18,217,6,13,-7
25,18,218,16,17,-1
25,18,219,9,13,-4
25,18,220,19,19,0
25,18,221,6,10,-4
25,18,222,7,20,-13
25,18,223,10,9,1
25,18,224,13,19,-6
25,18,225,14,9,5
25,18,226,7,9,-2
25,18,227,11,19,-8
25,18,228,19,28,-9
25,18,229,18,21,-3
25,18,230,13,16,-3
25,18,231,24,14,10
25,18,232,23,23,0
25,18,233,12,34,-22
25,18,234,18,21,-3
25,18,235,15,20,-5
25,18,236,5,21,-16
25,18,237,14,17,-3
25,18,238,10,16,-6
25,18,239,8,17,-9
25,18,240,14,26,-12
25,18,241,11,16,-5
25,18,242,26,18,8
25,18,243,7,24,-17
25,18,244,10,14,-4
25,18,245,9,14,-5
25,18,246,20,15,5
25,18,247,12,14,-2
25,18,248,14,10,4
25,18,249,8,14,-6
25,18,250,13,18,-5
25,18,251,9,5,4
25,18,252,13,9,4
25,18,253,10,12,-2
25,18,254,15,24,-9
25,18,255,9,18,-9
25,18,256,17,18,-1
25,18,257,3,7,-4
25,18,258,16,27,-11
25,18,259,16,25,-9
25,18,260,10,14,-4
25,18,261,13,3,10
25,18,262,6,15,-9
25,18,263,7,23,-16
25,18,264,15,29,-14
25,18,265,12,15,-3
25,18,266,14,11,3
25,18,267,15,8,7
25,18,268,10,11,-1
25,18,269,14,13,1
25,18,270,16,12,4
25,18,271,10,15,-5
25,18,272,14,22,-8
25,18,273,5,5,0
25,18,274,11,21,-10
25,18,275,16,12,4
25,18,276,19,20,-1
25,18,277,14,14,0
25,18,278,3,5,-2
25,18,279,9,9,0
25,18,280,22,22,0
25,18,281,8,2,6
25,18,282,17,14,3
25,18,283,13,13,0
25,18,284,13,15,-2
25,18,285,18,15,3
25,18,286,10,11,-1
25,18,287,21,15,6
25,18,288,8,4,4
25,18,289,16,27,-11
25,18,290,8,11,-3
25,18,291,11,10,1
25,18,292,12,29,-17
25,18,293,8,11,-3
25,18,294,6,12,-6
25,18,295,12,23,-11
25,18,296,5,12,-7
25,18,297,4,8,-4
25,18,298,19,20,-1
25,18,299,13,17,-4
25,19,0,8,13,-5
25,19,1,9,17,-8
25,19,2,6,8,-2
25,19,3,13,21,-8
25,19,4,8,28,-20
25,19,5,17,24,-7
25,19,6,20,23,-3
25,19,7,11,17,-6
25,19,8,12,10,2
25,19,9,19,15,4
25,19,10,19,14,5
25,19,11,11,17,-6
25,19,12,17,29,-12
25,19,13,12,14,-2
25,19,14,7,13,-6
25,19,15,6,20,-14
25,19,16,13,12,1
25,19,17,20,27,-7
25,19,18,1,9,-8
25,19,19,15,14,1
25,19,20,3,13,-10
25,19,21,7,19,-12
25,19,22,12,12,0
25,19,23,15,17,-2
25,19,24,12,19,-7
25,19,25,9,14,-5
25,19,26,8,24,-16
25,19,27,10,12,-2
25,19,28,16,10,6
25,19,29,12,22,-10
25,19,30,11,7,4
25,19,31,10,25,-15
25,19,32,6,15,-9
25,19,33,19,17,2
25,19,34,16,7,9
25,19,35,15,10,5
25,19,36,5,14,-9
25,19,37,13,14,-1
25,19,38,7,14,-7
25,19,39,16,26,-10
25,19,40,9,14,-5
25,19,41,14,20,-6
25,19,42,14,16,-2
25,19,43,18,12,6
25,19,44,27,24,3
25,19,45,4,9,-5
25,19,46,7,3,4
25,19,47,15,23,-8
25,19,48,16,16,0
25,19,49,11,12,-1
25,19,50,13,12,1
25,19,51,10,22,-12
25,19,52,15,18,-3
25,19,53,12,9,3
25,19,54,4,16,-12
25,19,55,18,16,2
25,19,56,16,18,-2
25,19,57,10,10,0
25,19,58,16,33,-17
25,19,59,12,22,-10
25,19,60,12,21,-9
25,19,61,18,12,6
25,19,62,12,19,-7
25,19,63,11,11,0
25,19,64,19,24,-5
25,19,65,13,21,-8
25,19,66,20,24,-4
25,19,67,13,17,-4
25,19,68,16,17,-1
25,19,69,16,19,-3
25,19,70,2,9,-7
25,19,71,17,21,-4
25,19,72,16,19,-3
25,19,73,17,22,-5
25,19,74,11,18,-7
25,19,75,18,19,-1
25,19,76,11,8,3
25,19,77,15,22,-7
25,19,78,14,24,-10
25,19,79,10,25,-15
25,19,80,17,14,3
25,19,81,12,11,1
25,19,82,7,17,-10
25,19,83,8,9,-1
25,19,84,15,31,-16
25,19,85,19,15,4
25,19,86,11,26,-15
25,19,87,14,8,6
25,19,88,5,12,-7
25,19,89,7,15,-8
25,19,90,6,15,-9
25,19,91,18,11,7
25,19,92,10,15,-5
25,19,93,19,11,8
25,19,94,5,12,-7
25,19,95,11,15,-4
25,19,96,8,12,-4
25,19,97,11,22,-11
25,19,98,8,17,-9
25,19,99,21,14,7
25,19,100,9,17,-8
25,19,101,10,13,-3
25,19,102,2,27,-25
25,19,103,12,9,3
25,19,104,14,13,1
25,19,105,13,18,-5
25,19,106,14,13,1
25,19,107,13,15,-2
25,19,108,8,16,-8
25,19,109,20,21,-1
25,19,110,9,29,-20
25,19,111,18,39,-21
25,19,112,10,18,-8
25,19,113,8,9,-1
25,19,114,16,23,-7
25,19,115,12,20,-8
25,19,116,19,25,-6
25,19,117,13,14,-1
25,19,118,19,17,2
25,19,119,8,15,-7
25,19,120,11,11,0
25,19,121,25,12,13
25,19,122,23,18,5
25,19,123,5,14,-9
25,19,124,23,27,-4
25,19,125,7,18,-11
25,19,126,10,8,2
25,19,127,6,4,2
25,19,128,10,9,1
25,19,129,8,28,-20
25,19,130,10,17,-7
25,19,131,8,6,2
25,19,132,15,18,-3
25,19,133,7,17,-10
25,19,134,6,23,-17
25,19,135,8,13,-5
25,19,136,3,11,-8
25,19,137,16,18,-2
25,19,138,13,15,-2
25,19,139,14,7,7
25,19,140,13,21,-8
25,19,141,19,15,4
25,19,142,11,27,-16
25,19,143,11,13,-2
25,19,144,10,18,-8
25,19,145,12,17,-5
25,19,146,11,20,-9
25,19,147,8,13,-5
25,19,148,22,8,14
25,19,149,21,26,-5
25,19,150,14,20,-6
25,19,151,8,14,-6
25,19,152,11,13,-2
25,19,153,11,21,-10
25,19,154,12,23,-11
25,19,155,19,8,11
25,19,156,24,25,-1
25,19,157,12,12,0
25,19,158,4,20,-16
25,19,159,7,13,-6
25,19,160,14,13,1
25,19,161,12,21,-9
25,19,162,5,15,-10
25,19,163,14,23,-9
25,19,164,12,9,3
25,19,165,9,13,-4
25,19,166,24,15,9
25,19,167,4,13,-9
25,19,168,6,8,-2
25,19,169,19,22,-3
25,19,170,18,15,3
25,19,171,5,8,-3
25,19,172,13,14,-1
25,19,173,13,11,2
25,19,174,20,25,-5
25,19,175,12,12,0
25,19,176,18,18,0
25,19,177,7,15,-8
25,19,178,8,10,-2
25,19,179,12,17,-5
25,19,180,11,36,-25
25,19,181,13,15,-2
25,19,182,8,12,-4
25,19,183,14,20,-6
25,19,184,16,21,-5
25,19,185,14,12,2
25,19,186,15,20,-5
25,19,187,11,28,-17
25,19,188,4,16,-12
25,19,189,16,12,4
25,19,190,19,12,7
25,19,191,7,16,-9
25,19,192,16,26,-10
25,19,193,13,15,-2
25,19,194,19,19,0
25,19,195,11,15,-4
25,19,196,9,18,-9
25,19,197,17,13,4
25,19,198,18,7,11
25,19,199,16,15,1
25,19,200,4,19,-15
25,19,201,22,19,3
25,19,202,17,31,-14
25,19,203,16,15,1
25,19,204,14,27,-13
25,19,205,9,20,-11
25,19,206,7,5,2
25,19,207,6,6,0
25,19,208,9,22,-13
25,19,209,14,20,-6
25,19,210,2,6,-4
25,19,211,8,20,-12
25,19,212,12,19,-7
25,19,213,15,24,-9
25,19,214,10,7,3
25,19,215,14,2,12
25,19,216,13,15,-2
25,19,217,17,25,-8
25,19,218,11,28,-17
25,19,219,12,10,2
25,19,220,16,17,-1
25,19,221,14,8,6
25,19,222,3,32,-29
25,19,223,15,18,-3
25,19,224,11,33,-22
25,19,225,11,25,-14
25,19,226,16,14,2
25,19,227,15,28,-13
25,19,228,14,17,-3
25,19,229,8,19,-11
25,19,230,6,19,-13
25,19,231,11,24,-13
25,19,232,17,33,-16
25,19,233,13,19,-6
25,19,234,19,27,-8
25,19,235,13,27,-14
25,19,236,16,25,-9
25,19,237,15,16,-1
25,19,238,7,17,-10
25,19,239,15,11,4
25,19,240,13,7,6
25,19,241,14,29,-15
25,19,242,13,21,-8
25,19,243,18,13,5
25,19,244,15,20,-5
25,19,245,8,16,-8
25,19,246,16,23,-7
25,19,247,7,16,-9
25,19,248,6,10,-4
25,19,249,7,9,-2
25,19,250,11,14,-3
25,19,251,8,18,-10
25,19,252,7,16,-9
25,19,253,18,20,-2
25,19,254,15,7,8
25,19,255,16,20,-4
25,19,256,8,10,-2
25,19,257,15,25,-10
25,19,258,12,10,2
25,19,259,10,17,-7
25,19,260,12,14,-2
25,19,261,15,22,-7
25,19,262,16,6,10
25,19,263,19,15,4
25,19,264,13,35,-22
25,19,265,27,18,9
25,19,266,10,4,6
25,19,267,8,14,-6
25,19,268,5,12,-7
25,19,269,15,25,-10
25,19,270,6,9,-3
25,19,271,10,24,-14
25,19,272,19,18,1
25,19,273,17,22,-5
25,19,274,3,13,-10
25,19,275,13,13,0
25,19,276,11,9,2
25,19,277,16,5,11
25,19,278,11,19,-8
25,19,279,25,25,0
25,19,280,10,18,-8
25,19,281,14,20,-6
25,19,282,10,14,-4
25,19,283,11,21,-10
25,19,284,11,17,-6
25,19,285,7,11,-4
25,19,286,8,6,2
25,19,287,19,11,8
25,19,288,11,10,1
25,19,289,18,22,-4
25,19,290,9,19,-10
25,19,291,4,11,-7
25,19,292,16,8,8
25,19,293,15,16,-1
25,19,294,23,26,-3
25,19,295,12,27,-15
25,19,296,10,10,0
25,19,297,22,18,4
25,19,298,11,21,-10
25,19,299,14,20,-6
25,20,0,6,12,-6
25,20,1,15,7,8
25,20,2,8,22,-14
25,20,3,2,9,-7
25,20,4,20,15,5
25,20,5,16,21,-5
25,20,6,10,16,-6
25,20,7,13,8,5
25,20,8,11,24,-13
25,20,9,8,12,-4
25,20,10,5,14,-9
25,20,11,14,13,1
25,20,12,3,10,-7
25,20,13,14,18,-4
25,20,14,5,19,-14
25,20,15,12,21,-9
25,20,16,14,11,3
25,20,17,10,17,-7
25,20,18,21,20,1
25,20,19,25,23,2
25,20,20,11,15,-4
25,20,21,12,15,-3
25,20,22,14,19,-5
25,20,23,11,21,-10
25,20,24,11,23,-12
25,20,25,14,14,0
25,20,26,14,9,5
25,20,27,4,16,-12
25,20,28,9,28,-19
25,20,29,13,13,0
25,20,30,7,11,-4
25,20,31,18,29,-11
25,20,32,9,9,0
25,20,33,19,19,0
25,20,34,12,15,-3
25,20,35,10,18,-8
25,20,36,5,31,-26
25,20,37,6,16,-10
25,20,38,16,19,-3
25,20,39,18,22,-4
25,20,40,17,21,-4
25,20,41,10,28,-18
25,20,42,22,25,-3
25,20,43,12,31,-19
25,20,44,10,5,5
25,20,45,16,23,-7
25,20,46,21,16,5
25,20,47,23,30,-7
25,20,48,10,17,-7
25,20,49,17,13,4
25,20,50,24,20,4
25,20,51,5,13,-8
25,20,52,15,17,-2
25,20,53,7,7,0
25,20,54,10,12,-2
25,20,55,15,12,3
25,20,56,8,23,-15
25,20,57,19,12,7
25,20,58,8,24,-16
25,20,59,13,16,-3
25,20,60,12,16,-4
25,20,61,13,13,0
25,20,62,14,14,0
25,20,63,5,11,-6
25,20,64,23,21,2
25,20,65,12,9,3
25,20,66,15,19,-4
25,20,67,9,17,-8
25,20,68,9,10,-1
25,20,69,10,10,0
25,20,70,12,27,-15
25,20,71,9,21,-12
25,20,72,11,22,-11
25,20,73,4,7,-3
25,20,74,19,27,-8
25,20,75,11,21,-10
25,20,76,20,18,2
25,20,77,10,14,-4
25,20,78,12,7,5
25,20,79,9,7,2
25,20,80,4,5,-1
25,20,81,15,16,-1
25,20,82,17,26,-9
25,20,83,17,14,3
25,20,84,3,5,-2
25,20,85,14,26,-12
25,20,86,9,12,-3
25,20,87,7,12,-5
25,20,88,8,17,-9
25,20,89,13,19,-6
25,20,90,7,26,-19
25,20,91,9,18,-9
25,20,92,13,11,2
25,20,93,17,30,-13
25,20,94,8,16,-8
25,20,95,18,22,-4
25,20,96,12,21,-9
25,20,97,17,21,-4
25,20,98,9,13,-4
25,20,99,15,19,-4
25,20,100,17,18,-1
25,20,101,17,14,3
25,20,102,7,16,-9
25,20,103,17,21,-4
25,20,104,13,11,2
25,20,105,26,24,2
25,20,106,8,12,-4
25,20,107,8,20,-12
25,20,108,8,18,-10
25,20,109,15,9,6
25,20,110,16,22,-6
25,20,111,16,12,4
25,20,112,9,8,1
25,20,113,9,19,-10
25,20,114,20,27,-7
25,20,115,15,13,2
25,20,116,6,12,-6
25,20,117,5,18,-13
25,20,118,6,16,-10
25,20,119,7,16,-9
25,20,120,10,10,0
25,20,121,18,25,-7
25,20,122,8,20,-12
25,20,123,9,12,-3
25,20,124,12,20,-8
25,20,125,14,14,0
25,20,126,11,21,-10
25,20,127,20,25,-5
25,20,128,17,11,6
25,20,129,12,22,-10
25,20,130,5,14,-9
25,20,131,10,12,-2
25,20,132,14,17,-3
25,20,133,7,22,-15
25,20,134,13,8,5
25,20,135,15,17,-2
25,20,136,14,31,-17
25,20,137,13,20,-7
25,20,138,6,20,-14
25,20,139,16,10,6
25,20,140,13,22,-9
25,20,141,7,17,-10
25,20,142,9,17,-8
25,20,143,11,9,2
25,20,144,16,14,2
25,20,145,16,20,-4
25,20,146,10,11,-1
25,20,147,26,19,7
25,20,148,14,25,-11
25,20,149,16,15,1
25,20,150,11,25,-14
25,20,151,10,16,-6
25,20,152,17,12,5
25,20,153,4,12,-8
25,20,154,7,14,-7
25,20,155,21,20,1
25,20,156,20,15,5
25,20,157,10,21,-11
25,20,158,9,18,-9
25,20,159,13,12,1
25,20,160,5,12,-7
25,20,161,28,22,6
25,20,162,12,30,-18
25,20,163,10,21,-11
25,20,164,8,15,-7
25,20,165,19,13,6
25,20,166,10,13,-3
25,20,167,13,12,1
25,20,168,16,17,-1
25,20,169,7,16,-9
25,20,170,13,10,3
25,20,171,24,24,0
25,20,172,13,13,0
25,20,173,21,28,-7
25,20,174,19,14,5
25,20,175,8,10,-2
25,20,176,17,13,4
25,20,177,12,18,-6
25,20,178,1,9,-8
25,20,179,14,23,-9
25,20,180,18,20,-2
25,20,181,7,16,-9
25,20,182,10,22,-12
25,20,183,11,12,-1
25,20,184,13,24,-11
25,20,185,8,34,-26
25,20,186,11,19,-8
25,20,187,15,31,-16
25,20,188,10,15,-5
25,20,189,13,26,-13
25,20,190,13,6,7
25,20,191,14,16,-2
25,20,192,15,20,-5
25,20,193,8,20,-12
25,20,194,9,14,-5
25,20,195,10,19,-9
25,20,196,13,12,1
25,20,197,13,14,-1
25,20,198,9,27,-18
25,20,199,11,20,-9
25,20,200,9,17,-8
25,20,201,5,11,-6
25,20,202,17,17,0
25,20,203,10,17,-7
25,20,204,15,18,-3
25,20,205,5,33,-28
25,20,206,11,5,6
25,20,207,5,17,-12
25,20,208,13,12,1
25,20,209,3,14,-11
25,20,210,21,16,5
25,20,211,23,16,7
25,20,212,18,29,-11
25,20,213,3,13,-10
25,20,214,13,21,-8
25,20,215,4,14,-10
25,20,216,9,15,-6
25,20,217,15,11,4
25,20,218,4,14,-10
25,20,219,18,13,5
25,20,220,17,28,-11
25,20,221,7,18,-11
25,20,222,15,18,-3
25,20,223,24,21,3
25,20,224,10,11,-1
25,20,225,8,24,-16
25,20,226,12,11,1
25,20,227,16,13,3
25,20,228,12,27,-15
25,20,229,14,26,-12
25,20,230,13,11,2
25,20,231,14,15,-1
25,20,232,11,14,-3
25,20,233,8,21,-13
25,20,234,24,18,6
25,20,235,21,20,1
25,20,236,2,8,-6
25,20,237,13,12,1
25,20,238,15,6,9
25,20,239,12,17,-5
25,20,240,25,23,2
25,20,241,10,13,-3
25,20,242,22,11,11
25,20,243,12,17,-5
25,20,244,6,20,-14
25,20,245,10,8,2
25,20,246,10,23,-13
25,20,247,5,16,-11
25,20,248,3,11,-8
25,20,249,14,10,4
25,20,250,15,11,4
25,20,251,17,12,5
25,20,252,6,18,-12
25,20,253,14,10,4
25,20,254,4,12,-8
25,20,255,21,19,2
25,20,256,6,13,-7
25,20,257,10,10,0
25,20,258,15,11,4
25,20,259,26,25,1
25,20,260,12,16,-4
25,20,261,4,11,-7
25,20,262,14,19,-5
25,20,263,10,21,-11
25,20,264,12,30,-18
25,20,265,7,22,-15
25,20,266,13,33,-20
25,20,267,17,12,5
25,20,268,13,13,0
25,20,269,20,20,0
25,20,270,10,12,-2
25,20,271,12,8,4
25,20,272,17,39,-22
25,20,273,9,18,-9
25,20,274,17,12,5
25,20,275,11,7,4
25,20,276,23,20,3
25,20,277,11,15,-4
25,20,278,13,23,-10
25,20,279,15,20,-5
25,20,280,11,20,-9
25,20,281,11,21,-10
25,20,282,6,13,-7
25,20,283,15,15,0
25,20,284,12,17,-5
25,20,285,19,19,0
25,20,286,6,20,-14
25,20,287,21,22,-1
25,20,288,14,6,8
25,20,289,13,11,2
25,20,290,19,17,2
25,20,291,22,18,4
25,20,292,12,12,0
25,20,293,9,13,-4
25,20,294,16,6,10
25,20,295,16,24,-8
25,20,296,15,23,-8
25,20,297,6,9,-3
25,20,298,17,16,1
25,20,299,12,12,0
25,21,0,20,28,-8
25,21,1,3,6,-3
25,21,2,20,18,2
25,21,3,18,19,-1
25,21,4,16,25,-9
25,21,5,9,33,-24
25,21,6,15,15,0
25,21,7,17,12,5
25,21,8,9,11,-2
25,21,9,16,13,3
25,21,10,17,11,6
25,21,11,13,19,-6
25,21,12,14,23,-9
25,21,13,14,12,2
25,21,14,13,13,0
25,21,15,8,8,0
25,21,16,11,15,-4
25,21,17,12,12,0
25,21,18,17,24,-7
25,21,19,17,24,-7
25,21,20,8,10,-2
25,21,21,17,11,6
25,21,22,34,26,8
25,21,23,5,11,-6
25,21,24,10,12,-2
25,21,25,7,15,-8
25,21,26,14,30,-16
25,21,27,9,18,-9
25,21,28,15,22,-7
25,21,29,24,29,-5
25,21,30,14,16,-2
25,21,31,7,18,-11
25,21,32,11,14,-3
25,21,33,12,7,5
25,21,34,12,18,-6
25,21,35,8,10,-2
25,21,36,24,17,7
25,21,37,16,10,6
25,21,38,19,17,2
25,21,39,8,7,1
25,21,40,15,12,3
25,21,41,5,16,-11
25,21,42,8,10,-2
25,21,43,11,8,3
25,21,44,21,23,-2
25,21,45,16,15,1
25,21,46,15,12,3
25,21,47,13,21,-8
25,21,48,11,18,-7
25,21,49,14,24,-10
25,21,50,14,18,-4
25,21,51,7,6,1
25,21,52,5,15,-10
25,21,53,5,12,-7
25,21,54,12,21,-9
25,21,55,12,15,-3
25,21,56,9,23,-14
25,21,57,19,22,-3
25,21,58,16,17,-1
25,21,59,11,13,-2
25,21,60,9,16,-7
25,21,61,26,23,3
25,21,62,10,18,-8
25,21,63,9,9,0
25,21,64,15,17,-2
25,21,65,13,19,-6
25,21,66,12,24,-12
25,21,67,23,12,11
25,21,68,13,17,-4
25,21,69,13,20,-7
25,21,70,7,13,-6
25,21,71,11,16,-5
25,21,72,10,18,-8
25,21,73,11,23,-12
25,21,74,14,16,-2
25,21,75,19,8,11
25,21,76,5,16,-11
25,21,77,16,28,-12
25,21,78,20,23,-3
25,21,79,7,8,-1
25,21,80,11,11,0
25,21,81,7,12,-5
25,21,82,16,17,-1
25,21,83,15,30,-15
25,21,84,10,11,-1
25,21,85,15,12,3
25,21,86,16,25,-9
25,21,87,9,6,3
25,21,88,17,34,-17
25,21,89,10,16,-6
25,21,90,8,17,-9
25,21,91,12,21,-9
25,21,92,11,13,-2
25,21,93,9,12,-3
25,21,94,15,12,3
25,21,95,21,14,7
25,21,96,17,34,-17
25,21,97,19,21,-2
25,21,98,15,13,2
25,21,99,16,22,-6
25,21,100,13,11,2
25,21,101,21,20,1
25,21,102,9,7,2
25,21,103,9,14,-5
25,21,104,15,11,4
25,21,105,11,14,-3
25,21,106,16,11,5
25,21,107,13,9,4
25,21,108,16,30,-14
25,21,109,13,20,-7
25,21,110,18,11,7
25,21,111,10,7,3
25,21,112,9,29,-20
25,21,113,16,13,3
25,21,114,12,28,-16
25,21,115,17,14,3
25,21,116,14,11,3
25,21,117,23,16,7
25,21,118,14,13,1
25,21,119,22,12,10
25,21,120,11,15,-4
25,21,121,17,9,8
25,21,122,9,17,-8
25,21,123,18,5,13
25,21,124,9,28,-19
25,21,125,6,14,-8
25,21,126,18,29,-11
25,21,127,12,12,0
25,21,128,8,19,-11
25,21,129,14,25,-11
25,21,130,15,24,-9
25,21,131,13,7,6
25,21,132,21,21,0
25,21,133,7,17,-10
25,21,134,5,7,-2
25,21,135,9,7,2
25,21,136,5,9,-4
25,21,137,13,31,-18
25,21,138,15,19,-4
25,21,139,8,11,-3
25,21,140,27,23,4
25,21,141,13,13,0
25,21,142,13,16,-3
25,21,143,21,18,3
25,21,144,7,8,-1
25,21,145,24,24,0
25,21,146,8,15,-7
25,21,147,14,14,0
25,21,148,6,18,-12
25,21,149,3,14,-11
25,21,150,15,19,-4
25,21,151,22,16,6
25,21,152,10,18,-8
25,21,153,19,17,2
25,21,154,9,22,-13
25,21,155,19,13,6
25,21,156,16,29,-13
25,21,157,21,15,6
25,21,158,12,1,11
25,21,159,22,25,-3
25,21,160,16,13,3
25,21,161,9,30,-21
25,21,162,17,4,13
25,21,163,12,13,-1
25,21,164,19,11,8
25,21,165,9,17,-8
25,21,166,8,10,-2
25,21,167,17,14,3
25,21,168,6,19,-13
25,21,169,13,9,4
25,21,170,17,14,3
25,21,171,9,19,-10
25,21,172,6,16,-10
25,21,173,8,12,-4
25,21,174,8,9,-1
25,21,175,8,9,-1
25,21,176,1,5,-4
25,21,177,13,19,-6
25,21,178,13,24,-11
25,21,179,7,13,-6
25,21,180,12,19,-7
25,21,181,9,26,-17
25,21,182,20,16,4
25,21,183,11,12,-1
25,21,184,10,12,-2
25,21,185,7,12,-5
25,21,186,12,17,-5
25,21,187,22,14,8
25,21,188,19,23,-4
25,21,189,7,16,-9
25,21,190,12,24,-12
25,21,191,5,6,-1
25,21,192,11,18,-7
25,21,193,7,17,-10
25,21,194,16,33,-17
25,21,195,7,8,-1
25,21,196,5,9,-4
25,21,197,13,33,-20
25,21,198,8,7,1
25,21,199,12,15,-3
25,21,200,5,9,-4
25,21,201,17,25,-8
25,21,202,6,17,-11
25,21,203,18,19,-1
25,21,204,9,14,-5
25,21,205,8,8,0
25,21,206,11,13,-2
25,21,207,13,15,-2
25,21,208,13,12,1
25,21,209,4,8,-4
25,21,210,28,23,5
25,21,211,30,25,5
25,21,212,22,23,-1
25,21,213,16,17,-1
25,21,214,13,25,-12
25,21,215,6,15,-9
25,21,216,17,22,-5
25,21,217,4,3,1
25,21,218,6,19,-13
25,21,219,19,12,7
25,21,220,7,12,-5
25,21,221,9,3,6
25,21,222,16,24,-8
25,21,223,9,21,-12
25,21,224,11,5,6
25,21,225,14,8,6
25,21,226,11,15,-4
25,21,227,21,26,-5
25,21,228,13,17,-4
25,21,229,11,15,-4
25,21,230,7,21,-14
25,21,231,20,16,4
25,21,232,23,13,10
25,21,233,16,22,-6
25,21,234,17,13,4
25,21,235,5,24,-19
25,21,236,13,15,-2
25,21,237,9,12,-3
25,21,238,12,28,-16
25,21,239,18,8,10
25,21,240,10,9,1
25,21,241,13,9,4
25,21,242,24,10,14
25,21,243,13,27,-14
25,21,244,14,12,2
25,21,245,23,24,-1
25,21,246,12,13,-1
25,21,247,7,5,2
25,21,248,11,15,-4
25,21,249,8,6,2
25,21,250,12,22,-10
25,21,251,11,19,-8
25,21,252,17,25,-8
25,21,253,14,18,-4
25,21,254,13,12,1
25,21,255,12,16,-4
25,21,256,12,6,6
25,21,257,9,19,-10
25,21,258,13,16,-3
25,21,259,7,19,-12
25,21,260,17,19,-2
25,21,261,29,16,13
25,21,262,10,19,-9
25,21,263,13,12,1
25,21,264,12,16,-4
25,21,265,6,12,-6
25,21,266,13,13,0
25,21,267,5,6,-1
25,21,268,7,22,-15
25,21,269,8,14,-6
25,21,270,14,22,-8
25,21,271,7,14,-7
25,21,272,7,20,-13
25,21,273,13,19,-6
25,21,274,14,14,0
25,21,275,16,20,-4
25,21,276,9,11,-2
25,21,277,19,14,5
25,21,278,13,20,-7
25,21,279,20,15,5
25,21,280,12,16,-4
25,21,281,14,14,0
25,21,282,7,21,-14
25,21,283,12,12,0
25,21,284,13,13,0
25,21,285,11,18,-7
25,21,286,15,14,1
25,21,287,7,19,-12
25,21,288,14,26,-12
25,21,289,16,9,7
25,21,290,13,20,-7
25,21,291,10,8,2
25,21,292,11,20,-9
25,21,293,1,15,-14
25,21,294,13,26,-13
25,21,295,7,21,-14
25,21,296,11,12,-1
25,21,297,5,14,-9
25,21,298,8,13,-5
25,21,299,7,6,1
25,22,0,9,14,-5
25,22,1,6,13,-7
25,22,2,21,22,-1
25,22,3,9,21,-12
25,22,4,12,14,-2
25,22,5,22,32,-10
25,22,6,19,20,-1
25,22,7,5,18,-13
25,22,8,23,14,9
25,22,9,10,11,-1
25,22,10,12,14,-2
25,22,11,12,14,-2
25,22,12,10,13,-3
25,22,13,3,14,-11
25,22,14,11,22,-11
25,22,15,7,9,-2
25,22,16,12,18,-6
25,22,17,6,10,-4
25,22,18,3,12,-9
25,22,19,17,21,-4
25,22,20,16,4,12
25,22,21,10,17,-7
25,22,22,12,27,-15
25,22,23,15,18,-3
25,22,24,8,16,-8
25,22,25,4,10,-6
25,22,26,15,14,1
25,22,27,17,19,-2
25,22,28,7,19,-12
25,22,29,15,26,-11
25,22,30,10,21,-11
25,22,31,21,20,1
25,22,32,6,9,-3
25,22,33,13,9,4
25,22,34,13,17,-4
25,22,35,21,11,10
25,22,36,10,20,-10
25,22,37,13,23,-10
25,22,38,10,12,-2
25,22,39,18,26,-8
25,22,40,15,17,-2
25,22,41,3,6,-3
25,22,42,18,20,-2
25,22,43,22,24,-2
25,22,44,15,11,4
25,22,45,27,24,3
25,22,46,14,19,-5
25,22,47,23,11,12
25,22,48,4,13,-9
25,22,49,8,14,-6
25,22,50,15,10,5
25,22,51,11,20,-9
25,22,52,20,12,8
25,22,53,14,18,-4
25,22,54,10,11,-1
25,22,55,8,10,-2
25,22,56,7,6,1
25,22,57,12,14,-2
25,22,58,6,9,-3
25,22,59,1,21,-20
25,22,60,11,15,-4
25,22,61,9,12,-3
25,22,62,12,24,-12
25,22,63,15,6,9
25,22,64,10,10,0
25,22,65,8,6,2
25,22,66,12,12,0
25,22,67,25,18,7
25,22,68,23,14,9
25,22,69,13,0,13
25,22,70,9,10,-1
25,22,71,18,15,3
25,22,72,11,5,6
25,22,73,6,9,-3
25,22,74,7,14,-7
25,22,75,8,15,-7
25,22,76,12,25,-13
25,22,77,7,16,-9
25,22,78,23,19,4
25,22,79,21,25,-4
25,22,80,23,28,-5
25,22,81,16,17,-1
25,22,82,8,9,-1
25,22,83,16,20,-4
25,22,84,21,21,0
25,22,85,32,25,7
25,22,86,9,15,-6
25,22,87,13,26,-13
25,22,88,16,17,-1
25,22,89,13,9,4
25,22,90,11,11,0
25,22,91,7,9,-2
25,22,92,16,13,3
25,22,93,22,21,1
25,22,94,13,6,7
25,22,95,14,16,-2
25,22,96,23,18,5
25,22,97,25,14,11
25,22,98,19,15,4
25,22,99,23,13,10
25,22,100,16,10,6
25,22,101,7,7,0
25,22,102,15,21,-6
25,22,103,10,19,-9
25,22,104,10,26,-16
25,22,105,15,7,8
25,22,106,12,13,-1
25,22,107,3,11,-8
25,22,108,19,18,1
25,22,109,12,15,-3
25,22,110,10,20,-10
25,22,111,11,8,3
25,22,112,22,19,3
25,22,113,23,24,-1
25,22,114,15,17,-2
25,22,115,8,6,2
25,22,116,12,5,7
25,22,117,14,16,-2
25,22,118,17,20,-3
25,22,119,18,24,-6
25,22,120,22,12,10
25,22,121,6,16,-10
25,22,122,5,12,-7
25,22,123,9,7,2
25,22,124,5,15,-10
25,22,125,14,21,-7
25,22,126,10,25,-15
25,22,127,13,9,4
25,22,128,11,18,-7
25,22,129,23,28,-5
25,22,130,19,39,-20
25,22,131,19,18,1
25,22,132,15,18,-3
25,22,133,17,21,-4
25,22,134,8,26,-18
25,22,135,13,24,-11
25,22,136,1,21,-20
25,22,137,12,22,-10
25,22,138,6,10,-4
25,22,139,13,19,-6
25,22,140,19,12,7
25,22,141,14,11,3
25,22,142,11,19,-8
25,22,143,9,21,-12
25,22,144,12,12,0
25,22,145,8,20,-12
25,22,146,10,30,-20
25,22,147,11,1,10
25,22,148,8,20,-12
25,22,149,6,33,-27
25,22,150,3,17,-14
25,22,151,23,15,8
25,22,152,22,10,12
25,22,153,13,9,4
25,22,154,26,20,6
25,22,155,11,11,0
25,22,156,10,13,-3
25,22,157,9,15,-6
25,22,158,16,19,-3
25,22,159,15,15,0
25,22,160,13,16,-3
25,22,161,11,11,0
25,22,162,7,4,3
25,22,163,20,11,9
25,22,164,9,7,2
25,22,165,10,16,-6
25,22,166,15,15,0
25,22,167,11,25,-14
25,22,168,12,9,3
25,22,169,13,19,-6
25,22,170,5,12,-7
25,22,171,16,26,-10
25,22,172,10,16,-6
25,22,173,19,22,-3
25,22,174,10,13,-3
25,22,175,10,18,-8
25,22,176,21,28,-7
25,22,177,10,21,-11
25,22,178,12,13,-1
25,22,179,11,16,-5
25,22,180,6,14,-8
25,22,181,18,18,0
25,22,182,9,22,-13
25,22,183,12,15,-3
25,22,184,12,20,-8
25,22,185,1,5,-4
25,22,186,12,19,-7
25,22,187,4,7,-3
25,22,188,18,22,-4
25,22,189,4,8,-4
25,22,190,6,21,-15
25,22,191,27,19,8
25,22,192,2,8,-6
25,22,193,4,7,-3
25,22,194,10,12,-2
25,22,195,14,12,2
25,22,196,14,22,-8
25,22,197,20,17,3
25,22,198,14,7,7
25,22,199,12,16,-4
25,22,200,13,18,-5
25,22,201,11,12,-1
25,22,202,14,13,1
25,22,203,11,10,1
25,22,204,7,20,-13
25,22,205,2,18,-16
25,22,206,10,8,2
25,22,207,12,18,-6
25,22,208,21,17,4
25,22,209,8,21,-13
25,22,210,6,5,1
25,22,211,1,16,-15
25,22,212,9,7,2
25,22,213,18,8,10
25,22,214,6,14,-8
25,22,215,12,16,-4
25,22,216,9,18,-9
25,22,217,12,5,7
25,22,218,8,15,-7
25,22,219,15,17,-2
25,22,220,11,12,-1
25,22,221,12,9,3
25,22,222,3,14,-11
25,22,223,12,7,5
25,22,224,19,19,0
25,22,225,13,17,-4
25,22,226,11,9,2
25,22,227,17,18,-1
25,22,228,13,14,-1
25,22,229,7,9,-2
25,22,230,13,18,-5
25,22,231,11,13,-2
25,22,232,13,20,-7
25,22,233,19,16,3
25,22,234,3,11,-8
25,22,235,7,10,-3
25,22,236,9,13,-4
25,22,237,25,23,2
25,22,238,6,12,-6
25,22,239,9,18,-9
25,22,240,25,21,4
25,22,241,14,9,5
25,22,242,13,18,-5
25,22,243,5,5,0
25,22,244,6,10,-4
25,22,245,17,21,-4
25,22,246,9,15,-6
25,22,247,19,27,-8
25,22,248,18,14,4
25,22,249,17,15,2
25,22,250,13,28,-15
25,22,251,15,17,-2
25,22,252,9,21,-12
25,22,253,8,7,1
25,22,254,16,27,-11
25,22,255,19,16,3
25,22,256,17,23,-6
25,22,257,12,14,-2
25,22,258,23,14,9
25,22,259,8,30,-22
25,22,260,11,9,2
25,22,261,15,14,1
25,22,262,12,15,-3
25,22,263,18,7,11
25,22,264,22,13,9
25,22,265,10,12,-2
25,22,266,8,17,-9
25,22,267,28,10,18
25,22,268,11,23,-12
25,22,269,20,21,-1
25,22,270,21,14,7
25,22,271,15,16,-1
25,22,272,22,15,7
25,22,273,24,8,16
25,22,274,8,3,5
25,22,275,13,9,4
25,22,276,17,21,-4
25,22,277,10,20,-10
25,22,278,19,10,9
25,22,279,15,17,-2
25,22,280,2,12,-10
25,22,281,10,21,-11
25,22,282,7,16,-9
25,22,283,20,18,2
25,22,284,15,11,4
25,22,285,19,34,-15
25,22,286,13,15,-2
25,22,287,21,24,-3
25,22,288,16,12,4
25,22,289,17,21,-4
25,22,290,15,8,7
25,22,291,17,28,-11
25,22,292,9,8,1
25,22,293,16,10,6
25,22,294,22,13,9
25,22,295,14,23,-9
25,22,296,0,9,-9
25,22,297,11,16,-5
25,22,298,8,23,-15
25,22,299,14,18,-4
25,23,0,20,13,7
25,23,1,11,15,-4
25,23,2,12,19,-7
25,23,3,12,15,-3
25,23,4,22,13,9
25,23,5,24,17,7
25,23,6,12,9,3
25,23,7,21,18,3
25,23,8,6,10,-4
25,23,9,7,20,-13
25,23,10,10,17,-7
25,23,11,25,18,7
25,23,12,10,13,-3
25,23,13,13,15,-2
25,23,14,11,16,-5
25,23,15,14,23,-9
25,23,16,17,16,1
25,23,17,6,11,-5
25,23,18,8,7,1
25,23,19,21,20,1
25,23,20,11,7,4
25,23,21,7,13,-6
25,23,22,13,15,-2
25,23,23,16,14,2
25,23,24,20,17,3
25,23,25,6,8,-2
25,23,26,14,16,-2
25,23,27,22,15,7
25,23,28,18,26,-8
25,23,29,25,20,5
25,23,30,10,13,-3
25,23,31,13,28,-15
25,23,32,8,14,-6
25,23,33,13,15,-2
25,23,34,12,13,-1
25,23,35,12,13,-1
25,23,36,7,9,-2
25,23,37,14,17,-3
25,23,38,2,10,-8
25,23,39,12,12,0
25,23,40,13,14,-1
25,23,41,8,11,-3
25,23,42,19,23,-4
25,23,43,14,21,-7
25,23,44,11,4,7
25,23,45,15,16,-1
25,23,46,10,20,-10
25,23,47,18,10,8
25,23,48,6,14,-8
25,23,49,9,22,-13
25,23,50,17,7,10
25,23,51,17,15,2
25,23,52,17,24,-7
25,23,53,11,19,-8
25,23,54,6,31,-25
25,23,55,7,10,-3
25,23,56,9,15,-6
25,23,57,11,8,3
25,23,58,11,24,-13
25,23,59,22,26,-4
25,23,60,25,26,-1
25,23,61,7,13,-6
25,23,62,8,19,-11
25,23,63,12,15,-3
25,23,64,7,15,-8
25,23,65,14,16,-2
25,23,66,11,12,-1
25,23,67,14,20,-6
25,23,68,24,23,1
25,23,69,8,9,-1
25,23,70,9,10,-1
25,23,71,15,16,-1
25,23,72,12,21,-9
25,23,73,18,16,2
25,23,74,17,25,-8
25,23,75,12,8,4
25,23,76,8,9,-1
25,23,77,8,10,-2
25,23,78,16,4,12
25,23,79,14,23,-9
25,23,80,15,16,-1
25,23,81,11,13,-2
25,23,82,17,27,-10
25,23,83,16,12,4
25,23,84,9,9,0
25,23,85,14,25,-11
25,23,86,12,23,-11
25,23,87,14,9,5
25,23,88,26,31,-5
25,23,89,6,19,-13
25,23,90,14,9,5
25,23,91,22,14,8
25,23,92,20,17,3
25,23,93,13,19,-6
25,23,94,10,20,-10
25,23,95,10,9,1
25,23,96,8,26,-18
25,23,97,13,22,-9
25,23,98,24,18,6
25,23,99,3,9,-6
25,23,100,6,15,-9
25,23,101,18,15,3
25,23,102,11,15,-4
25,23,103,10,14,-4
25,23,104,12,12,0
25,23,105,22,37,-15
25,23,106,10,15,-5
25,23,107,22,14,8
25,23,108,8,15,-7
25,23,109,24,18,6
25,23,110,12,14,-2
25,23,111,11,15,-4
25,23,112,10,22,-12
25,23,113,8,11,-3
25,23,114,28,14,14
25,23,115,16,18,-2
25,23,116,12,14,-2
25,23,117,13,9,4
25,23,118,11,20,-9
25,23,119,6,6,0
25,23,120,19,15,4
25,23,121,15,11,4
25,23,122,11,16,-5
25,23,123,11,11,0
25,23,124,18,8,10
25,23,125,21,27,-6
25,23,126,3,12,-9
25,23,127,12,18,-6
25,23,128,6,10,-4
25,23,129,11,10,1
25,23,130,13,15,-2
25,23,131,18,20,-2
25,23,132,2,16,-14
25,23,133,9,20,-11
25,23,134,6,11,-5
25,23,135,12,22,-10
25,23,136,10,10,0
25,23,137,6,12,-6
25,23,138,14,22,-8
25,23,139,11,8,3
25,23,140,7,15,-8
25,23,141,11,15,-4
25,23,142,11,9,2
25,23,143,14,11,3
25,23,144,13,20,-7
25,23,145,19,19,0
25,23,146,17,18,-1
25,23,147,11,20,-9
25,23,148,22,21,1
25,23,149,9,24,-15
25,23,150,5,9,-4
25,23,151,13,23,-10
25,23,152,8,15,-7
25,23,153,23,30,-7
25,23,154,14,14,0
25,23,155,12,11,1
25,23,156,15,7,8
25,23,157,4,13,-9
25,23,158,13,22,-9
25,23,159,23,24,-1
25,23,160,16,11,5
25,23,161,12,23,-11
25,23,162,19,17,2
25,23,163,9,11,-2
25,23,164,12,18,-6
25,23,165,13,33,-20
25,23,166,35,28,7
25,23,167,6,12,-6
25,23,168,15,11,4
25,23,169,11,9,2
25,23,170,18,23,-5
25,23,171,13,10,3
25,23,172,12,9,3
25,23,173,16,11,5
25,23,174,12,22,-10
25,23,175,12,7,5
25,23,176,12,5,7
25,23,177,16,33,-17
25,23,178,16,15,1
25,23,179,7,14,-7
25,23,180,7,17,-10
25,23,181,7,13,-6
25,23,182,11,8,3
25,23,183,5,13,-8
25,23,184,13,10,3
25,23,185,14,24,-10
25,23,186,9,14,-5
25,23,187,13,14,-1
25,23,188,8,8,0
25,23,189,9,21,-12
25,23,190,13,8,5
25,23,191,8,13,-5
25,23,192,17,11,6
25,23,193,20,18,2
25,23,194,15,19,-4
25,23,195,21,25,-4
25,23,196,12,15,-3
25,23,197,15,28,-13
25,23,198,7,15,-8
25,23,199,12,12,0
25,23,200,13,20,-7
25,23,201,8,14,-6
25,23,202,21,18,3
25,23,203,11,20,-9
25,23,204,7,12,-5
25,23,205,16,18,-2
25,23,206,7,8,-1
25,23,207,9,16,-7
25,23,208,12,26,-14
25,23,209,18,14,4
25,23,210,5,7,-2
25,23,211,24,19,5
25,23,212,4,17,-13
25,23,213,9,23,-14
25,23,214,17,13,4
25,23,215,9,20,-11
25,23,216,10,12,-2
25,23,217,19,21,-2
25,23,218,10,19,-9
25,23,219,14,14,0
25,23,220,27,18,9
25,23,221,12,15,-3
25,23,222,11,18,-7
25,23,223,6,9,-3
25,23,224,6,12,-6
25,23,225,11,5,6
25,23,226,13,13,0
25,23,227,9,19,-10
25,23,228,15,28,-13
25,23,229,11,7,4
25,23,230,16,22,-6
25,23,231,12,15,-3
25,23,232,15,18,-3
25,23,233,9,14,-5
25,23,234,22,21,1
25,23,235,18,17,1
25,23,236,12,8,4
25,23,237,21,13,8
25,23,238,17,7,10
25,23,239,10,9,1
25,23,240,12,5,7
25,23,241,16,17,-1
25,23,242,16,17,-1
25,23,243,14,10,4
25,23,244,19,7,12
25,23,245,14,12,2
25,23,246,15,22,-7
25,23,247,6,10,-4
25,23,248,19,12,7
25,23,249,15,24,-9
25,23,250,14,13,1
25,23,251,12,15,-3
25,23,252,4,16,-12
25,23,253,14,14,0
25,23,254,5,17,-12
25,23,255,11,13,-2
25,23,256,12,28,-16
25,23,257,10,15,-5
25,23,258,12,13,-1
25,23,259,7,6,1
25,23,260,18,12,6
25,23,261,10,17,-7
25,23,262,15,15,0
25,23,263,9,9,0
25,23,264,9,17,-8
25,23,265,15,16,-1
25,23,266,6,19,-13
25,23,267,17,16,1
25,23,268,8,12,-4
25,23,269,26,12,14
25,23,270,20,6,14
25,23,271,8,13,-5
25,23,272,1,12,-11
25,23,273,21,18,3
25,23,274,16,10,6
25,23,275,8,16,-8
25,23,276,10,12,-2
25,23,277,9,15,-6
25,23,278,16,21,-5
25,23,279,14,15,-1
25,23,280,11,12,-1
25,23,281,12,10,2
25,23,282,8,11,-3
25,23,283,18,25,-7
25,23,284,5,26,-21
25,23,285,14,18,-4
25,23,286,8,11,-3
25,23,287,19,20,-1
25,23,288,19,3,16
25,23,289,6,12,-6
25,23,290,7,16,-9
25,23,291,10,14,-4
25,23,292,11,28,-17
25,23,293,11,10,1
25,23,294,17,22,-5
25,23,295,10,9,1
25,23,296,13,12,1
25,23,297,7,23,-16
25,23,298,12,17,-5
25,23,299,9,25,-16
25,24,0,5,10,-5
25,24,1,20,17,3
25,24,2,11,15,-4
25,24,3,20,15,5
25,24,4,5,14,-9
25,24,5,26,20,6
25,24,6,28,15,13
25,24,7,11,7,4
25,24,8,10,13,-3
25,24,9,18,10,8
25,24,10,13,23,-10
25,24,11,17,10,7
25,24,12,20,21,-1
25,24,13,16,18,-2
25,24,14,8,11,-3
25,24,15,16,11,5
25,24,16,20,16,4
25,24,17,14,12,2
25,24,18,16,17,-1
25,24,19,6,9,-3
25,24,20,11,9,2
25,24,21,27,17,10
25,24,22,24,17,7
25,24,23,12,26,-14
25,24,24,15,17,-2
25,24,25,9,7,2
25,24,26,21,7,14
25,24,27,11,16,-5
25,24,28,10,17,-7
25,24,29,5,4,1
25,24,30,14,16,-2
25,24,31,20,7,13
25,24,32,8,12,-4
25,24,33,14,14,0
25,24,34,17,18,-1
25,24,35,14,12,2
25,24,36,10,6,4
25,24,37,3,5,-2
25,24,38,7,18,-11
25,24,39,17,12,5
25,24,40,9,21,-12
25,24,41,11,23,-12
25,24,42,10,14,-4
25,24,43,18,23,-5
25,24,44,19,13,6
25,24,45,18,18,0
25,24,46,17,17,0
25,24,47,8,16,-8
25,24,48,2,7,-5
25,24,49,18,13,5
25,24,50,7,11,-4
25,24,51,2,7,-5
25,24,52,12,10,2
25,24,53,15,20,-5
25,24,54,6,13,-7
25,24,55,16,14,2
25,24,56,4,15,-11
25,24,57,10,9,1
25,24,58,17,27,-10
25,24,59,8,12,-4
25,24,60,11,11,0
25,24,61,6,10,-4
25,24,62,22,14,8
25,24,63,15,11,4
25,24,64,16,15,1
25,24,65,8,8,0
25,24,66,7,19,-12
25,24,67,14,12,2
25,24,68,11,27,-16
25,24,69,12,13,-1
25,24,70,4,15,-11
25,24,71,21,16,5
25,24,72,3,9,-6
25,24,73,7,14,-7
25,24,74,14,9,5
25,24,75,13,14,-1
25,24,76,16,12,4
25,24,77,10,17,-7
25,24,78,17,14,3
25,24,79,10,16,-6
25,24,80,16,19,-3
25,24,81,17,11,6
25,24,82,21,20,1
25,24,83,18,10,8
25,24,84,10,9,1
25,24,85,10,6,4
25,24,86,8,7,1
25,24,87,13,32,-19
25,24,88,12,18,-6
25,24,89,13,11,2
25,24,90,10,11,-1
25,24,91,5,11,-6
25,24,92,8,6,2
25,24,93,13,4,9
25,24,94,2,16,-14
25,24,95,25,19,6
25,24,96,11,14,-3
25,24,97,5,8,-3
25,24,98,7,19,-12
25,24,99,16,13,3
25,24,100,14,18,-4
25,24,101,6,12,-6
25,24,102,24,18,6
25,24,103,20,12,8
25,24,104,12,9,3
25,24,105,19,11,8
25,24,106,5,5,0
25,24,107,16,12,4
25,24,108,15,15,0
25,24,109,10,13,-3
25,24,110,11,7,4
25,24,111,11,13,-2
25,24,112,9,14,-5
25,24,113,13,7,6
25,24,114,16,18,-2
25,24,115,18,16,2
25,24,116,5,6,-1
25,24,117,13,18,-5
25,24,118,16,15,1
25,24,119,11,27,-16
25,24,120,15,21,-6
25,24,121,10,18,-8
25,24,122,17,16,1
25,24,123,16,18,-2
25,24,124,14,15,-1
25,24,125,2,8,-6
25,24,126,8,20,-12
25,24,127,4,16,-12
25,24,128,12,13,-1
25,24,129,16,10,6
25,24,130,20,9,11
25,24,131,11,18,-7
25,24,132,13,12,1
25,24,133,14,18,-4
25,24,134,15,20,-5
25,24,135,11,24,-13
25,24,136,15,26,-11
25,24,137,18,14,4
25,24,138,14,12,2
25,24,139,13,8,5
25,24,140,5,18,-13
25,24,141,22,14,8
25,24,142,12,13,-1
25,24,143,14,23,-9
25,24,144,3,14,-11
25,24,145,8,5,3
25,24,146,13,10,3
25,24,147,10,21,-11
25,24,148,14,14,0
25,24,149,9,6,3
25,24,150,15,15,0
25,24,151,26,12,14
25,24,152,9,11,-2
25,24,153,26,15,11
25,24,154,11,12,-1
25,24,155,8,14,-6
25,24,156,24,8,16
25,24,157,21,12,9
25,24,158,8,17,-9
25,24,159,16,10,6
25,24,160,9,7,2
25,24,161,9,10,-1
25,24,162,15,9,6
25,24,163,6,9,-3
25,24,164,18,31,-13
25,24,165,16,22,-6
25,24,166,10,12,-2
25,24,167,13,12,1
25,24,168,20,11,9
25,24,169,18,21,-3
25,24,170,20,14,6
25,24,171,10,22,-12
25,24,172,16,4,12
25,24,173,15,19,-4
25,24,174,18,15,3
25,24,175,13,34,-21
25,24,176,13,8,5
25,24,177,9,10,-1
25,24,178,7,22,-15
25,24,179,13,15,-2
25,24,180,11,17,-6
25,24,181,10,15,-5
25,24,182,7,10,-3
25,24,183,4,5,-1
25,24,184,21,15,6
25,24,185,18,13,5
25,24,186,8,15,-7
25,24,187,14,20,-6
25,24,188,1,21,-20
25,24,189,16,19,-3
25,24,190,9,14,-5
25,24,191,24,16,8
25,24,192,16,13,3
25,24,193,10,13,-3
25,24,194,19,13,6
25,24,195,10,6,4
25,24,196,21,17,4
25,24,197,11,22,-11
25,24,198,9,7,2
25,24,199,10,17,-7
25,24,200,16,20,-4
25,24,201,15,19,-4
25,24,202,10,15,-5
25,24,203,22,17,5
25,24,204,9,25,-16
25,24,205,8,4,4
25,24,206,11,15,-4
25,24,207,4,15,-11
25,24,208,13,18,-5
25,24,209,6,15,-9
25,24,210,13,16,-3
25,24,211,20,17,3
25,24,212,9,21,-12
25,24,213,14,20,-6
25,24,214,15,15,0
25,24,215,20,25,-5
25,24,216,12,15,-3
25,24,217,9,24,-15
25,24,218,16,18,-2
25,24,219,4,10,-6
25,24,220,25,24,1
25,24,221,24,15,9
25,24,222,13,17,-4
25,24,223,10,25,-15
25,24,224,6,11,-5
25,24,225,6,4,2
25,24,226,14,23,-9
25,24,227,7,20,-13
25,24,228,14,15,-1
25,24,229,11,13,-2
25,24,230,11,13,-2
25,24,231,14,5,9
25,24,232,14,26,-12
25,24,233,10,21,-11
25,24,234,7,12,-5
25,24,235,10,17,-7
25,24,236,16,11,5
25,24,237,4,13,-9
25,24,238,18,12,6
25,24,239,12,12,0
25,24,240,8,7,1
25,24,241,16,14,2
25,24,242,19,21,-2
25,24,243,23,16,7
25,24,244,15,13,2
25,24,245,5,15,-10
25,24,246,25,19,6
25,24,247,11,9,2
25,24,248,2,6,-4
25,24,249,2,4,-2
25,24,250,17,12,5
25,24,251,24,20,4
25,24,252,10,23,-13
25,24,253,12,3,9
25,24,254,13,17,-4
25,24,255,17,17,0
25,24,256,15,14,1
25,24,257,12,7,5
25,24,258,11,5,6
25,24,259,16,20,-4
25,24,260,5,10,-5
25,24,261,14,20,-6
25,24,262,8,5,3
25,24,263,19,15,4
25,24,264,17,12,5
25,24,265,12,31,-19
25,24,266,5,15,-10
25,24,267,15,8,7
25,24,268,19,23,-4
25,24,269,12,15,-3
25,24,270,9,16,-7
25,24,271,16,14,2
25,24,272,8,12,-4
25,24,273,12,13,-1
25,24,274,13,10,3
25,24,275,6,7,-1
25,24,276,7,9,-2
25,24,277,18,25,-7
25,24,278,20,14,6
25,24,279,12,11,1
25,24,280,12,29,-17
25,24,281,15,23,-8
25,24,282,13,17,-4
25,24,283,18,11,7
25,24,284,7,19,-12
25,24,285,14,11,3
25,24,286,8,10,-2
25,24,287,13,6,7
25,24,288,8,10,-2
25,24,289,8,12,-4
25,24,290,6,13,-7
25,24,291,8,14,-6
25,24,292,12,11,1
25,24,293,6,16,-10
25,24,294,12,8,4
25,24,295,14,20,-6
25,24,296,11,15,-4
25,24,297,12,25,-13
25,24,298,16,23,-7
25,24,299,7,7,0
25,25,0,17,14,3
25,25,1,11,13,-2
25,25,2,8,17,-9
25,25,3,7,9,-2
25,25,4,12,21,-9
25,25,5,9,6,3
25,25,6,9,14,-5
25,25,7,18,23,-5
25,25,8,9,7,2
25,25,9,10,22,-12
25,25,10,9,9,0
25,25,11,7,14,-7
25,25,12,4,13,-9
25,25,13,18,9,9
25,25,14,10,15,-5
25,25,15,12,24,-12
25,25,16,19,11,8
25,25,17,12,11,1
25,25,18,9,5,4
25,25,19,16,25,-9
25,25,20,10,16,-6
25,25,21,18,11,7
25,25,22,10,1,9
25,25,23,15,12,3
25,25,24,12,21,-9
25,25,25,7,6,1
25,25,26,21,14,7
25,25,27,16,25,-9
25,25,28,18,23,-5
25,25,29,9,6,3
25,25,30,19,11,8
25,25,31,13,17,-4
25,25,32,15,10,5
25,25,33,14,10,4
25,25,34,12,16,-4
25,25,35,10,11,-1
25,25,36,13,23,-10
25,25,37,3,8,-5
25,25,38,9,6,3
25,25,39,10,11,-1
25,25,40,12,14,-2
25,25,41,10,7,3
25,25,42,12,12,0
25,25,43,12,12,0
25,25,44,21,22,-1
25,25,45,14,11,3
25,25,46,12,11,1
25,25,47,19,19,0
25,25,48,5,9,-4
25,25,49,11,7,4
25,25,50,10,13,-3
25,25,51,29,15,14
25,25,52,19,26,-7
25,25,53,11,19,-8
25,25,54,13,11,2
25,25,55,5,7,-2
25,25,56,25,13,12
25,25,57,15,10,5
25,25,58,11,20,-9
25,25,59,14,7,7
25,25,60,13,28,-15
25,25,61,19,14,5
25,25,62,24,21,3
25,25,63,15,10,5
25,25,64,20,17,3
25,25,65,10,17,-7
25,25,66,10,18,-8
25,25,67,7,10,-3
25,25,68,3,11,-8
25,25,69,6,11,-5
25,25,70,20,19,1
25,25,71,8,3,5
25,25,72,8,7,1
25,25,73,15,15,0
25,25,74,16,20,-4
25,25,75,10,10,0
25,25,76,28,24,4
25,25,77,26,17,9
25,25,78,15,13,2
25,25,79,4,11,-7
25,25,80,6,14,-8
25,25,81,9,13,-4
25,25,82,11,11,0
25,25,83,17,8,9
25,25,84,11,12,-1
25,25,85,7,14,-7
25,25,86,6,11,-5
25,25,87,10,9,1
25,25,88,16,15,1
25,25,89,4,23,-19
25,25,90,10,15,-5
25,25,91,4,25,-21
25,25,92,12,17,-5
25,25,93,18,19,-1
25,25,94,2,10,-8
25,25,95,13,21,-8
25,25,96,10,21,-11
25,25,97,7,13,-6
25,25,98,7,6,1
25,25,99,8,12,-4
25,25,100,14,13,1
25,25,101,16,11,5
25,25,102,11,10,1
25,25,103,8,12,-4
25,25,104,8,21,-13
25,25,105,17,16,1
25,25,106,6,8,-2
25,25,107,11,11,0
25,25,108,7,4,3
25,25,109,9,21,-12
25,25,110,10,6,4
25,25,111,2,8,-6
25,25,112,14,11,3
25,25,113,7,12,-5
25,25,114,23,16,7
25,25,115,19,17,2
25,25,116,20,21,-1
25,25,117,5,14,-9
25,25,118,13,11,2
25,25,119,4,10,-6
25,25,120,17,22,-5
25,25,121,8,9,-1
25,25,122,15,24,-9
25,25,123,13,19,-6
25,25,124,13,12,1
25,25,125,7,16,-9
25,25,126,17,5,12
25,25,127,9,13,-4
25,25,128,19,20,-1
25,25,129,10,14,-4
25,25,130,18,7,11
25,25,131,5,12,-7
25,25,132,14,10,4
25,25,133,12,26,-14
25,25,134,8,10,-2
25,25,135,25,13,12
25,25,136,25,17,8
25,25,137,11,20,-9
25,25,138,14,14,0
25,25,139,11,13,-2
25,25,140,11,22,-11
25,25,141,12,17,-5
25,25,142,8,13,-5
25,25,143,14,11,3
25,25,144,10,10,0
25,25,145,15,17,-2
25,25,146,11,8,3
25,25,147,12,23,-11
25,25,148,14,17,-3
25,25,149,7,10,-3
25,25,150,11,13,-2
25,25,151,8,5,3
25,25,152,11,19,-8
25,25,153,21,15,6
25,25,154,13,11,2
25,25,155,11,9,2
25,25,156,13,6,7
25,25,157,12,19,-7
25,25,158,10,11,-1
25,25,159,8,13,-5
25,25,160,7,13,-6
25,25,161,6,10,-4
25,25,162,8,21,-13
25,25,163,9,12,-3
25,25,164,19,13,6
25,25,165,11,20,-9
25,25,166,20,13,7
25,25,167,9,16,-7
25,25,168,3,12,-9
25,25,169,8,21,-13
25,25,170,7,15,-8
25,25,171,13,20,-7
25,25,172,7,7,0
25,25,173,8,16,-8
25,25,174,7,11,-4
25,25,175,12,28,-16
25,25,176,19,13,6
25,25,177,24,15,9
25,25,178,12,19,-7
25,25,179,12,13,-1
25,25,180,7,15,-8
25,25,181,27,26,1
25,25,182,13,16,-3
25,25,183,7,11,-4
25,25,184,10,17,-7
25,25,185,11,16,-5
25,25,186,4,15,-11
25,25,187,10,13,-3
25,25,188,7,8,-1
25,25,189,22,25,-3
25,25,190,2,15,-13
25,25,191,11,9,2
25,25,192,10,15,-5
25,25,193,10,15,-5
25,25,194,6,15,-9
25,25,195,1,20,-19
25,25,196,16,12,4
25,25,197,13,13,0
25,25,198,6,13,-7
25,25,199,6,6,0
25,25,200,9,13,-4
25,25,201,8,11,-3
25,25,202,8,11,-3
25,25,203,9,11,-2
25,25,204,10,7,3
25,25,205,6,15,-9
25,25,206,22,17,5
25,25,207,9,14,-5
25,25,208,11,22,-11
25,25,209,9,10,-1
25,25,210,15,24,-9
25,25,211,21,13,8
25,25,212,24,13,11
25,25,213,8,21,-13
25,25,214,11,11,0
25,25,215,8,24,-16
25,25,216,13,17,-4
25,25,217,9,5,4
25,25,218,9,15,-6
25,25,219,10,17,-7
25,25,220,9,9,0
25,25,221,8,15,-7
25,25,222,16,29,-13
25,25,223,22,14,8
25,25,224,14,19,-5
25,25,225,14,16,-2
25,25,226,14,15,-1
25,25,227,0,3,-3
25,25,228,16,10,6
25,25,229,16,12,4
25,25,230,20,14,6
25,25,231,15,12,3
25,25,232,12,19,-7
25,25,233,6,12,-6
25,25,234,14,20,-6
25,25,235,5,8,-3
25,25,236,16,17,-1
25,25,237,7,16,-9
25,25,238,11,8,3
25,25,239,12,16,-4
25,25,240,9,14,-5
25,25,241,8,22,-14
25,25,242,9,11,-2
25,25,243,6,13,-7
25,25,244,14,15,-1
25,25,245,20,28,-8
25,25,246,7,17,-10
25,25,247,9,14,-5
25,25,248,11,11,0
25,25,249,7,13,-6
25,25,250,13,14,-1
25,25,251,8,15,-7
25,25,252,14,15,-1
25,25,253,8,16,-8
25,25,254,4,19,-15
25,25,255,16,14,2
25,25,256,16,15,1
25,25,257,8,18,-10
25,25,258,17,22,-5
25,25,259,8,15,-7
25,25,260,11,8,3
25,25,261,10,19,-9
25,25,262,8,13,-5
25,25,263,7,8,-1
25,25,264,15,16,-1
25,25,265,14,29,-15
25,25,266,5,10,-5
25,25,267,7,9,-2
25,25,268,19,11,8
25,25,269,27,28,-1
25,25,270,7,10,-3
25,25,271,9,17,-8
25,25,272,17,17,0
25,25,273,6,13,-7
25,25,274,6,10,-4
25,25,275,20,17,3
25,25,276,18,23,-5
25,25,277,12,25,-13
25,25,278,7,12,-5
25,25,279,7,10,-3
25,25,280,18,23,-5
25,25,281,11,6,5
25,25,282,10,15,-5
25,25,283,17,15,2
25,25,284,7,7,0
25,25,285,6,7,-1
25,25,286,17,22,-5
25,25,287,14,18,-4
25,25,288,7,12,-5
25,25,289,11,13,-2
25,25,290,4,11,-7
25,25,291,10,14,-4
25,25,292,9,5,4
25,25,293,9,20,-11
25,25,294,9,19,-10
25,25,295,14,20,-6
25,25,296,9,23,-14
25,25,297,4,8,-4
25,25,298,10,13,-3
25,25,299,14,16,-2
25,26,0,5,14,-9
25,26,1,4,9,-5
25,26,2,11,9,2
25,26,3,9,8,1
25,26,4,7,8,-1
25,26,5,16,7,9
25,26,6,11,22,-11
25,26,7,2,13,-11
25,26,8,11,20,-9
25,26,9,6,13,-7
25,26,10,18,18,0
25,26,11,11,14,-3
25,26,12,10,26,-16
25,26,13,19,20,-1
25,26,14,13,16,-3
25,26,15,14,15,-1
25,26,16,15,13,2
25,26,17,12,2,10
25,26,18,4,6,-2
25,26,19,13,14,-1
25,26,20,11,12,-1
25,26,21,16,20,-4
25,26,22,13,8,5
25,26,23,13,16,-3
25,26,24,12,15,-3
25,26,25,18,21,-3
25,26,26,23,14,9
25,26,27,11,15,-4
25,26,28,12,5,7
25,26,29,8,12,-4
25,26,30,7,15,-8
25,26,31,23,15,8
25,26,32,6,14,-8
25,26,33,11,21,-10
25,26,34,21,16,5
25,26,35,17,10,7
25,26,36,10,6,4
25,26,37,8,14,-6
25,26,38,11,15,-4
25,26,39,14,20,-6
25,26,40,4,8,-4
25,26,41,16,15,1
25,26,42,15,9,6
25,26,43,13,11,2
25,26,44,20,11,9
25,26,45,16,12,4
25,26,46,21,14,7
25,26,47,8,17,-9
25,26,48,10,5,5
25,26,49,15,15,0
25,26,50,15,12,3
25,26,51,13,17,-4
25,26,52,9,12,-3
25,26,53,15,13,2
25,26,54,20,18,2
25,26,55,11,14,-3
25,26,56,29,7,22
25,26,57,21,17,4
25,26,58,7,14,-7
25,26,59,26,15,11
25,26,60,4,12,-8
25,26,61,19,35,-16
25,26,62,8,10,-2
25,26,63,10,15,-5
25,26,64,11,15,-4
25,26,65,5,13,-8
25,26,66,11,10,1
25,26,67,9,7,2
25,26,68,14,19,-5
25,26,69,13,14,-1
25,26,70,13,10,3
25,26,71,9,13,-4
25,26,72,11,8,3
25,26,73,21,15,6
25,26,74,10,14,-4
25,26,75,21,17,4
25,26,76,16,12,4
25,26,77,10,20,-10
25,26,78,16,6,10
25,26,79,18,21,-3
25,26,80,21,8,13
25,26,81,28,23,5
25,26,82,19,10,9
25,26,83,15,10,5
25,26,84,15,12,3
25,26,85,13,15,-2
25,26,86,8,21,-13
25,26,87,31,16,15
25,26,88,14,9,5
25,26,89,14,18,-4
25,26,90,11,16,-5
25,26,91,12,20,-8
25,26,92,9,13,-4
25,26,93,3,5,-2
25,26,94,12,15,-3
25,26,95,27,15,12
25,26,96,9,11,-2
25,26,97,10,6,4
25,26,98,9,20,-11
25,26,99,20,14,6
25,26,100,16,10,6
25,26,101,9,9,0
25,26,102,12,9,3
25,26,103,20,6,14
25,26,104,8,21,-13
25,26,105,10,16,-6
25,26,106,11,19,-8
25,26,107,14,12,2
25,26,108,5,11,-6
25,26,109,6,5,1
25,26,110,11,11,0
25,26,111,6,13,-7
25,26,112,14,10,4
25,26,113,20,26,-6
25,26,114,8,20,-12
25,26,115,7,8,-1
25,26,116,9,13,-4
25,26,117,13,21,-8
25,26,118,11,19,-8
25,26,119,18,11,7
25,26,120,12,16,-4
25,26,121,15,17,-2
25,26,122,16,14,2
25,26,123,15,17,-2
25,26,124,16,8,8
25,26,125,14,12,2
25,26,126,19,33,-14
25,26,127,11,8,3
25,26,128,21,17,4
25,26,129,8,3,5
25,26,130,18,17,1
25,26,131,23,13,10
25,26,132,12,14,-2
25,26,133,5,12,-7
25,26,134,3,9,-6
25,26,135,10,12,-2
25,26,136,13,18,-5
25,26,137,9,22,-13
25,26,138,19,7,12
25,26,139,7,13,-6
25,26,140,14,10,4
25,26,141,20,16,4
25,26,142,22,23,-1
25,26,143,13,10,3
25,26,144,7,15,-8
25,26,145,16,14,2
25,26,146,11,12,-1
25,26,147,16,20,-4
25,26,148,9,10,-1
25,26,149,14,13,1
25,26,150,12,20,-8
25,26,151,6,14,-8
25,26,152,5,21,-16
25,26,153,12,15,-3
25,26,154,9,9,0
25,26,155,20,10,10
25,26,156,21,31,-10
25,26,157,10,11,-1
25,26,158,23,12,11
25,26,159,15,12,3
25,26,160,13,15,-2
25,26,161,8,10,-2
25,26,162,15,7,8
25,26,163,22,17,5
25,26,164,10,14,-4
25,26,165,20,8,12
25,26,166,12,16,-4
25,26,167,22,25,-3
25,26,168,7,16,-9
25,26,169,9,16,-7
25,26,170,20,12,8
25,26,171,5,17,-12
25,26,172,7,11,-4
25,26,173,9,4,5
25,26,174,7,8,-1
25,26,175,10,11,-1
25,26,176,18,7,11
25,26,177,8,10,-2
25,26,178,13,11,2
25,26,179,20,12,8
25,26,180,14,10,4
25,26,181,12,6,6
25,26,182,11,13,-2
25,26,183,5,26,-21
25,26,184,19,13,6
25,26,185,21,11,10
25,26,186,14,4,10
25,26,187,11,12,-1
25,26,188,13,8,5
25,26,189,7,6,1
25,26,190,24,18,6
25,26,191,16,20,-4
25,26,192,10,14,-4
25,26,193,13,17,-4
25,26,194,12,17,-5
25,26,195,22,14,8
25,26,196,10,16,-6
25,26,197,15,14,1
25,26,198,12,20,-8
25,26,199,25,23,2
25,26,200,8,9,-1
25,26,201,13,18,-5
25,26,202,20,7,13
25,26,203,17,9,8
25,26,204,3,1,2
25,26,205,7,12,-5
25,26,206,18,25,-7
25,26,207,21,4,17
25,26,208,11,12,-1
25,26,209,12,20,-8
25,26,210,7,4,3
25,26,211,14,15,-1
25,26,212,7,10,-3
25,26,213,16,20,-4
25,26,214,10,11,-1
25,26,215,6,19,-13
25,26,216,19,13,6
25,26,217,5,1,4
25,26,218,9,13,-4
25,26,219,19,9,10
25,26,220,25,19,6
25,26,221,4,9,-5
25,26,222,10,19,-9
25,26,223,7,13,-6
25,26,224,12,13,-1
25,26,225,17,15,2
25,26,226,13,18,-5
25,26,227,19,15,4
25,26,228,11,15,-4
25,26,229,5,9,-4
25,26,230,9,21,-12
25,26,231,14,13,1
25,26,232,14,9,5
25,26,233,13,6,7
25,26,234,14,14,0
25,26,235,20,14,6
25,26,236,14,8,6
25,26,237,20,22,-2
25,26,238,8,17,-9
25,26,239,18,10,8
25,26,240,15,18,-3
25,26,241,18,11,7
25,26,242,12,27,-15
25,26,243,14,8,6
25,26,244,7,19,-12
25,26,245,8,9,-1
25,26,246,15,12,3
25,26,247,21,4,17
25,26,248,12,10,2
25,26,249,8,11,-3
25,26,250,8,13,-5
25,26,251,12,15,-3
25,26,252,9,10,-1
25,26,253,15,12,3
25,26,254,17,6,11
25,26,255,16,15,1
25,26,256,11,15,-4
25,26,257,20,14,6
25,26,258,15,19,-4
25,26,259,23,18,5
25,26,260,1,10,-9
25,26,261,15,11,4
25,26,262,6,13,-7
25,26,263,17,14,3
25,26,264,11,7,4
25,26,265,12,19,-7
25,26,266,21,21,0
25,26,267,9,13,-4
25,26,268,3,8,-5
25,26,269,14,10,4
25,26,270,7,12,-5
25,26,271,18,11,7
25,26,272,17,23,-6
25,26,273,9,15,-6
25,26,274,20,10,10
25,26,275,17,23,-6
25,26,276,16,23,-7
25,26,277,10,14,-4
25,26,278,10,12,-2
25,26,279,10,6,4
25,26,280,10,5,5
25,26,281,14,8,6
25,26,282,16,27,-11
25,26,283,17,12,5
25,26,284,9,7,2
25,26,285,14,20,-6
25,26,286,10,18,-8
25,26,287,19,12,7
25,26,288,14,16,-2
25,26,289,4,3,1
25,26,290,15,15,0
25,26,291,14,26,-12
25,26,292,20,18,2
25,26,293,6,17,-11
25,26,294,12,7,5
25,26,295,24,15,9
25,26,296,14,24,-10
25,26,297,17,4,13
25,26,298,13,23,-10
25,26,299,21,16,5
25,27,0,3,10,-7
25,27,1,14,7,7
25,27,2,12,22,-10
25,27,3,11,6,5
25,27,4,21,11,10
25,27,5,14,18,-4
25,27,6,18,10,8
25,27,7,13,19,-6
25,27,8,16,8,8
25,27,9,18,14,4
25,27,10,20,17,3
25,27,11,18,15,3
25,27,12,15,24,-9
25,27,13,11,15,-4
25,27,14,19,14,5
25,27,15,13,9,4
25,27,16,15,8,7
25,27,17,16,15,1
25,27,18,13,18,-5
25,27,19,6,7,-1
25,27,20,13,8,5
25,27,21,12,15,-3
25,27,22,8,19,-11
25,27,23,8,15,-7
25,27,24,4,16,-12
25,27,25,7,4,3
25,27,26,7,13,-6
25,27,27,22,15,7
25,27,28,13,12,1
25,27,29,8,19,-11
25,27,30,17,15,2
25,27,31,4,19,-15
25,27,32,14,15,-1
25,27,33,8,13,-5
25,27,34,11,12,-1
25,27,35,15,12,3
25,27,36,10,10,0
25,27,37,10,13,-3
25,27,38,20,11,9
25,27,39,8,17,-9
25,27,40,13,10,3
25,27,41,11,9,2
25,27,42,13,7,6
25,27,43,27,8,19
25,27,44,4,10,-6
25,27,45,9,14,-5
25,27,46,13,7,6
25,27,47,19,13,6
25,27,48,14,22,-8
25,27,49,22,17,5
25,27,50,4,6,-2
25,27,51,12,19,-7
25,27,52,11,16,-5
25,27,53,10,18,-8
25,27,54,14,4,10
25,27,55,20,12,8
25,27,56,9,9,0
25,27,57,14,16,-2
25,27,58,11,7,4
25,27,59,14,12,2
25,27,60,12,18,-6
25,27,61,21,5,16
25,27,62,5,8,-3
25,27,63,29,16,13
25,27,64,11,7,4
25,27,65,15,7,8
25,27,66,15,11,4
25,27,67,9,12,-3
25,27,68,19,11,8
25,27,69,12,16,-4
25,27,70,4,10,-6
25,27,71,16,14,2
25,27,72,8,14,-6
25,27,73,16,9,7
25,27,74,8,8,0
25,27,75,14,10,4
25,27,76,6,10,-4
25,27,77,13,7,6
25,27,78,14,13,1
25,27,79,2,11,-9
25,27,80,5,3,2
25,27,81,10,29,-19
25,27,82,22,19,3
25,27,83,10,17,-7
25,27,84,15,16,-1
25,27,85,5,7,-2
25,27,86,21,15,6
25,27,87,16,9,7
25,27,88,15,12,3
25,27,89,27,14,13
25,27,90,8,4,4
25,27,91,10,4,6
25,27,92,14,25,-11
25,27,93,7,13,-6
25,27,94,31,18,13
25,27,95,27,9,18
25,27,96,15,13,2
25,27,97,9,10,-1
25,27,98,15,12,3
25,27,99,30,16,14
25,27,100,15,12,3
25,27,101,11,9,2
25,27,102,8,21,-13
25,27,103,7,13,-6
25,27,104,11,7,4
25,27,105,20,16,4
25,27,106,20,19,1
25,27,107,15,11,4
25,27,108,8,19,-11
25,27,109,5,4,1
25,27,110,15,11,4
25,27,111,16,24,-8
25,27,112,13,8,5
25,27,113,10,7,3
25,27,114,23,26,-3
25,27,115,4,4,0
25,27,116,17,18,-1
25,27,117,8,4,4
25,27,118,13,13,0
25,27,119,3,6,-3
25,27,120,24,15,9
25,27,121,17,15,2
25,27,122,4,11,-7
25,27,123,11,2,9
25,27,124,14,11,3
25,27,125,16,14,2
25,27,126,18,24,-6
25,27,127,4,3,1
25,27,128,13,15,-2
25,27,129,13,6,7
25,27,130,10,16,-6
25,27,131,11,20,-9
25,27,132,10,3,7
25,27,133,3,14,-11
25,27,134,8,17,-9
25,27,135,8,12,-4
25,27,136,22,20,2
25,27,137,6,17,-11
25,27,138,6,6,0
25,27,139,21,6,15
25,27,140,14,8,6
25,27,141,6,18,-12
25,27,142,10,14,-4
25,27,143,17,14,3
25,27,144,25,11,14
25,27,145,13,10,3
25,27,146,20,23,-3
25,27,147,5,2,3
25,27,148,7,19,-12
25,27,149,17,4,13
25,27,150,15,23,-8
25,27,151,17,12,5
25,27,152,4,20,-16
25,27,153,9,12,-3
25,27,154,22,20,2
25,27,155,15,20,-5
25,27,156,8,13,-5
25,27,157,12,21,-9
25,27,158,16,4,12
25,27,159,10,6,4
25,27,160,14,4,10
25,27,161,13,14,-1
25,27,162,16,31,-15
25,27,163,12,9,3
25,27,164,13,19,-6
25,27,165,17,23,-6
25,27,166,14,9,5
25,27,167,9,3,6
25,27,168,6,11,-5
25,27,169,8,27,-19
25,27,170,12,17,-5
25,27,171,12,14,-2
25,27,172,9,8,1
25,27,173,9,7,2
25,27,174,12,10,2
25,27,175,21,6,15
25,27,176,22,13,9
25,27,177,7,16,-9
25,27,178,16,5,11
25,27,179,11,17,-6
25,27,180,7,8,-1
25,27,181,5,8,-3
25,27,182,15,15,0
25,27,183,10,4,6
25,27,184,7,19,-12
25,27,185,11,7,4
25,27,186,11,5,6
25,27,187,11,4,7
25,27,188,17,11,6
25,27,189,8,13,-5
25,27,190,15,10,5
25,27,191,11,6,5
25,27,192,6,3,3
25,27,193,24,10,14
25,27,194,6,1,5
25,27,195,18,15,3
25,27,196,20,11,9
25,27,197,16,18,-2
25,27,198,12,28,-16
25,27,199,17,11,6
25,27,200,7,2,5
25,27,201,9,15,-6
25,27,202,10,6,4
25,27,203,15,13,2
25,27,204,3,7,-4
25,27,205,13,19,-6
25,27,206,19,21,-2
25,27,207,9,8,1
25,27,208,18,17,1
25,27,209,11,8,3
25,27,210,11,15,-4
25,27,211,9,13,-4
25,27,212,15,12,3
25,27,213,15,7,8
25,27,214,6,15,-9
25,27,215,10,15,-5
25,27,216,10,13,-3
25,27,217,10,25,-15
25,27,218,15,18,-3
25,27,219,9,19,-10
25,27,220,9,8,1
25,27,221,5,9,-4
25,27,222,13,7,6
25,27,223,15,16,-1
25,27,224,7,13,-6
25,27,225,11,11,0
25,27,226,18,11,7
25,27,227,6,6,0
25,27,228,6,8,-2
25,27,229,11,15,-4
25,27,230,11,15,-4
25,27,231,13,18,-5
25,27,232,16,23,-7
25,27,233,18,18,0
25,27,234,17,12,5
25,27,235,14,17,-3
25,27,236,10,9,1
25,27,237,10,3,7
25,27,238,11,22,-11
25,27,239,13,4,9
25,27,240,8,4,4
25,27,241,10,12,-2
25,27,242,11,15,-4
25,27,243,6,12,-6
25,27,244,23,9,14
25,27,245,19,12,7
25,27,246,14,14,0
25,27,247,6,5,1
25,27,248,26,18,8
25,27,249,7,4,3
25,27,250,20,28,-8
25,27,251,9,10,-1
25,27,252,18,13,5
25,27,253,12,8,4
25,27,254,7,10,-3
25,27,255,12,10,2
25,27,256,17,19,-2
25,27,257,8,19,-11
25,27,258,16,22,-6
25,27,259,3,6,-3
25,27,260,8,13,-5
25,27,261,15,19,-4
25,27,262,16,12,4
25,27,263,4,8,-4
25,27,264,15,8,7
25,27,265,11,8,3
25,27,266,6,21,-15
25,27,267,16,21,-5
25,27,268,6,5,1
25,27,269,17,22,-5
25,27,270,11,7,4
25,27,271,9,12,-3
25,27,272,14,11,3
25,27,273,10,11,-1
25,27,274,10,8,2
25,27,275,8,11,-3
25,27,276,13,12,1
25,27,277,12,12,0
25,27,278,11,19,-8
25,27,279,25,19,6
25,27,280,20,13,7
25,27,281,14,19,-5
25,27,282,8,10,-2
25,27,283,11,17,-6
25,27,284,17,19,-2
25,27,285,19,11,8
25,27,286,10,11,-1
25,27,287,10,10,0
25,27,288,14,8,6
25,27,289,7,11,-4
25,27,290,13,5,8
25,27,291,5,8,-3
25,27,292,14,7,7
25,27,293,15,7,8
25,27,294,6,17,-11
25,27,295,17,7,10
25,27,296,12,17,-5
25,27,297,14,7,7
25,27,298,9,11,-2
25,27,299,9,8,1
25,28,0,20,8,12
25,28,1,14,6,8
25,28,2,18,17,1
25,28,3,12,11,1
25,28,4,14,17,-3
25,28,5,10,12,-2
25,28,6,10,13,-3
25,28,7,18,9,9
25,28,8,9,17,-8
25,28,9,12,17,-5
25,28,10,7,8,-1
25,28,11,16,12,4
25,28,12,17,12,5
25,28,13,20,19,1
25,28,14,16,13,3
25,28,15,11,13,-2
25,28,16,16,12,4
25,28,17,7,18,-11
25,28,18,12,11,1
25,28,19,19,7,12
25,28,20,4,18,-14
25,28,21,20,9,11
25,28,22,8,7,1
25,28,23,8,7,1
25,28,24,5,9,-4
25,28,25,14,5,9
25,28,26,20,25,-5
25,28,27,11,15,-4
25,28,28,9,18,-9
25,28,29,10,15,-5
25,28,30,5,5,0
25,28,31,20,7,13
25,28,32,5,10,-5
25,28,33,6,13,-7
25,28,34,4,9,-5
25,28,35,10,11,-1
25,28,36,14,10,4
25,28,37,9,8,1
25,28,38,4,7,-3
25,28,39,8,10,-2
25,28,40,16,13,3
25,28,41,18,18,0
25,28,42,19,13,6
25,28,43,20,18,2
25,28,44,27,13,14
25,28,45,6,13,-7
25,28,46,0,7,-7
25,28,47,10,10,0
25,28,48,14,8,6
25,28,49,16,19,-3
25,28,50,26,29,-3
25,28,51,4,4,0
25,28,52,9,10,-1
25,28,53,8,6,2
25,28,54,12,9,3
25,28,55,13,11,2
25,28,56,18,9,9
25,28,57,7,16,-9
25,28,58,9,5,4
25,28,59,10,18,-8
25,28,60,9,20,-11
25,28,61,13,9,4
25,28,62,21,11,10
25,28,63,10,20,-10
25,28,64,21,8,13
25,28,65,7,18,-11
25,28,66,12,12,0
25,28,67,5,2,3
25,28,68,8,7,1
25,28,69,5,7,-2
25,28,70,8,14,-6
25,28,71,12,9,3
25,28,72,17,12,5
25,28,73,5,5,0
25,28,74,10,14,-4
25,28,75,10,24,-14
25,28,76,10,13,-3
25,28,77,20,14,6
25,28,78,4,21,-17
25,28,79,19,10,9
25,28,80,21,14,7
25,28,81,10,14,-4
25,28,82,9,6,3
25,28,83,23,18,5
25,28,84,8,9,-1
25,28,85,14,10,4
25,28,86,8,19,-11
25,28,87,17,17,0
25,28,88,18,10,8
25,28,89,14,5,9
25,28,90,7,9,-2
25,28,91,17,15,2
25,28,92,15,13,2
25,28,93,10,9,1
25,28,94,17,22,-5
25,28,95,9,7,2
25,28,96,17,14,3
25,28,97,10,14,-4
25,28,98,17,22,-5
25,28,99,4,6,-2
25,28,100,12,12,0
25,28,101,21,5,16
25,28,102,8,11,-3
25,28,103,18,9,9
25,28,104,16,15,1
25,28,105,0,25,-25
25,28,106,18,17,1
25,28,107,4,12,-8
25,28,108,14,20,-6
25,28,109,7,10,-3
25,28,110,31,10,21
25,28,111,21,10,11
25,28,112,3,6,-3
25,28,113,19,11,8
25,28,114,20,14,6
25,28,115,24,20,4
25,28,116,13,9,4
25,28,117,12,7,5
25,28,118,14,13,1
25,28,119,12,9,3
25,28,120,21,10,11
25,28,121,10,20,-10
25,28,122,5,9,-4
25,28,123,10,16,-6
25,28,124,17,15,2
25,28,125,18,7,11
25,28,126,11,13,-2
25,28,127,4,19,-15
25,28,128,16,14,2
25,28,129,18,14,4
25,28,130,3,14,-11
25,28,131,10,5,5
25,28,132,9,10,-1
25,28,133,21,13,8
25,28,134,7,9,-2
25,28,135,8,2,6
25,28,136,9,13,-4
25,28,137,5,13,-8
25,28,138,11,9,2
25,28,139,6,9,-3
25,28,140,10,11,-1
25,28,141,20,9,11
25,28,142,4,6,-2
25,28,143,8,10,-2
25,28,144,7,6,1
25,28,145,19,8,11
25,28,146,24,11,13
25,28,147,10,5,5
25,28,148,19,4,15
25,28,149,24,10,14
25,28,150,11,13,-2
25,28,151,4,13,-9
25,28,152,18,15,3
25,28,153,8,10,-2
25,28,154,7,5,2
25,28,155,10,10,0
25,28,156,14,16,-2
25,28,157,6,13,-7
25,28,158,23,12,11
25,28,159,9,13,-4
25,28,160,8,23,-15
25,28,161,18,6,12
25,28,162,12,6,6
25,28,163,15,18,-3
25,28,164,14,7,7
25,28,165,10,6,4
25,28,166,9,22,-13
25,28,167,15,8,7
25,28,168,9,9,0
25,28,169,8,14,-6
25,28,170,13,6,7
25,28,171,12,7,5
25,28,172,24,17,7
25,28,173,11,19,-8
25,28,174,9,21,-12
25,28,175,14,19,-5
25,28,176,12,10,2
25,28,177,15,16,-1
25,28,178,16,13,3
25,28,179,17,10,7
25,28,180,16,12,4
25,28,181,13,10,3
25,28,182,12,12,0
25,28,183,6,14,-8
25,28,184,14,6,8
25,28,185,4,6,-2
25,28,186,7,11,-4
25,28,187,6,12,-6
25,28,188,5,7,-2
25,28,189,11,19,-8
25,28,190,7,8,-1
25,28,191,11,2,9
25,28,192,12,15,-3
25,28,193,18,10,8
25,28,194,18,18,0
25,28,195,17,15,2
25,28,196,12,19,-7
25,28,197,14,14,0
25,28,198,11,17,-6
25,28,199,9,9,0
25,28,200,10,12,-2
25,28,201,10,14,-4
25,28,202,8,13,-5
25,28,203,15,12,3
25,28,204,7,11,-4
25,28,205,8,23,-15
25,28,206,12,9,3
25,28,207,17,13,4
25,28,208,2,10,-8
25,28,209,5,6,-1
25,28,210,19,13,6
25,28,211,15,3,12
25,28,212,40,17,23
25,28,213,21,15,6
25,28,214,15,18,-3
25,28,215,10,21,-11
25,28,216,23,11,12
25,28,217,7,10,-3
25,28,218,7,8,-1
25,28,219,12,22,-10
25,28,220,7,7,0
25,28,221,6,13,-7
25,28,222,2,22,-20
25,28,223,9,9,0
25,28,224,16,18,-2
25,28,225,17,15,2
25,28,226,20,6,14
25,28,227,17,13,4
25,28,228,7,10,-3
25,28,229,14,20,-6
25,28,230,6,8,-2
25,28,231,8,13,-5
25,28,232,11,7,4
25,28,233,19,13,6
25,28,234,13,11,2
25,28,235,26,13,13
25,28,236,10,26,-16
25,28,237,20,11,9
25,28,238,15,18,-3
25,28,239,17,10,7
25,28,240,11,13,-2
25,28,241,15,6,9
25,28,242,13,16,-3
25,28,243,17,11,6
25,28,244,14,5,9
25,28,245,8,15,-7
25,28,246,19,14,5
25,28,247,26,17,9
25,28,248,11,9,2
25,28,249,20,7,13
25,28,250,17,9,8
25,28,251,10,12,-2
25,28,252,8,11,-3
25,28,253,12,15,-3
25,28,254,12,12,0
25,28,255,19,14,5
25,28,256,7,10,-3
25,28,257,6,15,-9
25,28,258,12,13,-1
25,28,259,13,17,-4
25,28,260,9,7,2
25,28,261,13,8,5
25,28,262,20,15,5
25,28,263,10,6,4
25,28,264,21,19,2
25,28,265,14,8,6
25,28,266,22,24,-2
25,28,267,13,8,5
25,28,268,2,11,-9
25,28,269,16,12,4
25,28,270,17,12,5
25,28,271,25,16,9
25,28,272,18,11,7
25,28,273,20,7,13
25,28,274,6,21,-15
25,28,275,14,24,-10
25,28,276,3,6,-3
25,28,277,12,9,3
25,28,278,5,3,2
25,28,279,11,10,1
25,28,280,8,11,-3
25,28,281,9,19,-10
25,28,282,16,15,1
25,28,283,16,15,1
25,28,284,20,18,2
25,28,285,11,16,-5
25,28,286,7,8,-1
25,28,287,9,19,-10
25,28,288,11,11,0
25,28,289,8,13,-5
25,28,290,18,18,0
25,28,291,12,17,-5
25,28,292,10,13,-3
25,28,293,6,16,-10
25,28,294,9,14,-5
25,28,295,6,14,-8
25,28,296,19,7,12
25,28,297,17,20,-3
25,28,298,20,16,4
25,28,299,11,10,1
25,29,0,13,18,-5
25,29,1,11,7,4
25,29,2,3,2,1
25,29,3,16,17,-1
25,29,4,9,12,-3
25,29,5,1,5,-4
25,29,6,18,10,8
25,29,7,6,8,-2
25,29,8,24,28,-4
25,29,9,10,9,1
25,29,10,19,17,2
25,29,11,16,13,3
25,29,12,18,15,3
25,29,13,15,16,-1
25,29,14,5,9,-4
25,29,15,5,17,-12
25,29,16,12,18,-6
25,29,17,18,22,-4
25,29,18,8,12,-4
25,29,19,6,12,-6
25,29,20,12,15,-3
25,29,21,14,5,9
25,29,22,10,8,2
25,29,23,21,15,6
25,29,24,6,13,-7
25,29,25,14,7,7
25,29,26,20,16,4
25,29,27,28,6,22
25,29,28,4,6,-2
25,29,29,7,8,-1
25,29,30,9,7,2
25,29,31,12,10,2
25,29,32,9,11,-2
25,29,33,18,20,-2
25,29,34,20,10,10
25,29,35,15,19,-4
25,29,36,18,9,9
25,29,37,5,13,-8
25,29,38,12,14,-2
25,29,39,18,12,6
25,29,40,6,13,-7
25,29,41,25,15,10
25,29,42,4,0,4
25,29,43,9,8,1
25,29,44,12,21,-9
25,29,45,6,7,-1
25,29,46,16,16,0
25,29,47,8,10,-2
25,29,48,15,21,-6
25,29,49,6,17,-11
25,29,50,12,5,7
25,29,51,13,19,-6
25,29,52,10,11,-1
25,29,53,12,15,-3
25,29,54,13,11,2
25,29,55,6,7,-1
25,29,56,6,10,-4
25,29,57,9,17,-8
25,29,58,7,6,1
25,29,59,7,10,-3
25,29,60,23,6,17
25,29,61,11,17,-6
25,29,62,5,11,-6
25,29,63,9,0,9
25,29,64,7,13,-6
25,29,65,22,14,8
25,29,66,12,9,3
25,29,67,6,12,-6
25,29,68,11,6,5
25,29,69,14,12,2
25,29,70,8,10,-2
25,29,71,5,7,-2
25,29,72,6,2,4
25,29,73,9,14,-5
25,29,74,17,13,4
25,29,75,13,11,2
25,29,76,14,8,6
25,29,77,8,15,-7
25,29,78,10,7,3
25,29,79,17,12,5
25,29,80,4,11,-7
25,29,81,13,12,1
25,29,82,11,22,-11
25,29,83,11,25,-14
25,29,84,10,14,-4
25,29,85,13,14,-1
25,29,86,11,15,-4
25,29,87,12,17,-5
25,29,88,8,14,-6
25,29,89,13,7,6
25,29,90,5,16,-11
25,29,91,16,14,2
25,29,92,13,19,-6
25,29,93,19,4,15
25,29,94,9,12,-3
25,29,95,6,8,-2
25,29,96,15,15,0
25,29,97,14,13,1
25,29,98,21,11,10
25,29,99,22,12,10
25,29,100,11,4,7
25,29,101,18,22,-4
25,29,102,8,7,1
25,29,103,15,11,4
25,29,104,30,18,12
25,29,105,15,8,7
25,29,106,9,17,-8
25,29,107,6,14,-8
25,29,108,5,5,0
25,29,109,16,16,0
25,29,110,18,22,-4
25,29,111,8,6,2
25,29,112,12,8,4
25,29,113,17,16,1
25,29,114,16,11,5
25,29,115,16,17,-1
25,29,116,16,7,9
25,29,117,8,9,-1
25,29,118,15,7,8
25,29,119,10,7,3
25,29,120,11,9,2
25,29,121,18,18,0
25,29,122,10,16,-6
25,29,123,19,12,7
25,29,124,9,6,3
25,29,125,9,12,-3
25,29,126,8,12,-4
25,29,127,7,2,5
25,29,128,24,12,12
25,29,129,12,8,4
25,29,130,13,9,4
25,29,131,9,9,0
25,29,132,13,11,2
25,29,133,10,5,5
25,29,134,17,8,9
25,29,135,13,8,5
25,29,136,7,15,-8
25,29,137,20,15,5
25,29,138,11,5,6
25,29,139,17,13,4
25,29,140,13,29,-16
25,29,141,13,18,-5
25,29,142,15,16,-1
25,29,143,17,7,10
25,29,144,9,3,6
25,29,145,7,15,-8
25,29,146,6,10,-4
25,29,147,15,4,11
25,29,148,12,11,1
25,29,149,15,19,-4
25,29,150,16,11,5
25,29,151,10,28,-18
25,29,152,4,7,-3
25,29,153,11,11,0
25,29,154,12,24,-12
25,29,155,15,11,4
25,29,156,6,15,-9
25,29,157,14,8,6
25,29,158,9,12,-3
25,29,159,19,15,4
25,29,160,18,23,-5
25,29,161,20,18,2
25,29,162,19,25,-6
25,29,163,9,1,8
25,29,164,16,2,14
25,29,165,22,15,7
25,29,166,17,10,7
25,29,167,14,10,4
25,29,168,13,18,-5
25,29,169,11,14,-3
25,29,170,21,17,4
25,29,171,19,26,-7
25,29,172,16,20,-4
25,29,173,11,5,6
25,29,174,13,17,-4
25,29,175,16,14,2
25,29,176,8,5,3
25,29,177,8,17,-9
25,29,178,18,7,11
25,29,179,6,3,3
25,29,180,5,1,4
25,29,181,11,13,-2
25,29,182,17,12,5
25,29,183,19,18,1
25,29,184,14,9,5
25,29,185,7,7,0
25,29,186,28,12,16
25,29,187,2,5,-3
25,29,188,18,21,-3
25,29,189,8,2,6
25,29,190,12,15,-3
25,29,191,9,14,-5
25,29,192,17,11,6
25,29,193,18,13,5
25,29,194,17,10,7
25,29,195,20,18,2
25,29,196,25,15,10
25,29,197,7,8,-1
25,29,198,8,14,-6
25,29,199,16,5,11
25,29,200,19,15,4
25,29,201,13,21,-8
25,29,202,8,17,-9
25,29,203,5,12,-7
25,29,204,20,9,11
25,29,205,7,13,-6
25,29,206,4,14,-10
25,29,207,14,6,8
25,29,208,22,11,11
25,29,209,20,20,0
25,29,210,10,12,-2
25,29,211,19,11,8
25,29,212,15,15,0
25,29,213,19,15,4
25,29,214,11,12,-1
25,29,215,18,11,7
25,29,216,7,6,1
25,29,217,12,8,4
25,29,218,6,5,1
25,29,219,12,8,4
25,29,220,16,14,2
25,29,221,22,14,8
25,29,222,10,14,-4
25,29,223,10,9,1
25,29,224,5,4,1
25,29,225,23,20,3
25,29,226,12,20,-8
25,29,227,7,14,-7
25,29,228,10,15,-5
25,29,229,7,25,-18
25,29,230,18,18,0
25,29,231,13,7,6
25,29,232,15,7,8
25,29,233,17,11,6
25,29,234,17,12,5
25,29,235,17,19,-2
25,29,236,10,7,3
25,29,237,17,12,5
25,29,238,19,14,5
25,29,239,16,13,3
25,29,240,13,14,-1
25,29,241,10,5,5
25,29,242,9,13,-4
25,29,243,15,16,-1
25,29,244,17,12,5
25,29,245,11,7,4
25,29,246,14,5,9
25,29,247,22,12,10
25,29,248,14,19,-5
25,29,249,11,16,-5
25,29,250,14,6,8
25,29,251,21,12,9
25,29,252,7,8,-1
25,29,253,3,16,-13
25,29,254,10,10,0
25,29,255,8,12,-4
25,29,256,27,17,10
25,29,257,14,17,-3
25,29,258,20,23,-3
25,29,259,12,15,-3
25,29,260,13,17,-4
25,29,261,7,11,-4
25,29,262,12,13,-1
25,29,263,15,16,-1
25,29,264,12,3,9
25,29,265,15,4,11
25,29,266,10,11,-1
25,29,267,18,11,7
25,29,268,18,11,7
25,29,269,11,6,5
25,29,270,6,12,-6
25,29,271,8,6,2
25,29,272,23,20,3
25,29,273,11,7,4
25,29,274,13,5,8
25,29,275,16,12,4
25,29,276,5,10,-5
25,29,277,11,15,-4
25,29,278,9,8,1
25,29,279,9,4,5
25,29,280,17,15,2
25,29,281,6,26,-20
25,29,282,24,19,5
25,29,283,5,10,-5
25,29,284,17,15,2
25,29,285,8,1,7
25,29,286,24,21,3
25,29,287,15,8,7
25,29,288,6,8,-2
25,29,289,15,8,7
25,29,290,12,19,-7
25,29,291,15,22,-7
25,29,292,7,8,-1
25,29,293,8,24,-16
25,29,294,16,15,1
25,29,295,10,10,0
25,29,296,14,19,-5
25,29,297,21,11,10
25,29,298,18,12,6
25,29,299,14,11,3
25,30,0,6,2,4
25,30,1,23,24,-1
25,30,2,11,7,4
25,30,3,14,7,7
25,30,4,14,13,1
25,30,5,14,25,-11
25,30,6,19,8,11
25,30,7,7,8,-1
25,30,8,15,21,-6
25,30,9,13,15,-2
25,30,10,6,8,-2
25,30,11,8,12,-4
25,30,12,13,20,-7
25,30,13,16,18,-2
25,30,14,12,19,-7
25,30,15,9,9,0
25,30,16,14,17,-3
25,30,17,18,13,5
25,30,18,7,7,0
25,30,19,13,16,-3
25,30,20,7,1,6
25,30,21,12,16,-4
25,30,22,13,8,5
25,30,23,14,16,-2
25,30,24,8,13,-5
25,30,25,20,11,9
25,30,26,7,7,0
25,30,27,13,13,0
25,30,28,3,10,-7
25,30,29,11,6,5
25,30,30,11,8,3
25,30,31,20,8,12
25,30,32,23,8,15
25,30,33,8,11,-3
25,30,34,7,14,-7
25,30,35,4,12,-8
25,30,36,17,11,6
25,30,37,13,15,-2
25,30,38,21,16,5
25,30,39,4,8,-4
25,30,40,14,13,1
25,30,41,13,13,0
25,30,42,14,16,-2
25,30,43,13,15,-2
25,30,44,10,7,3
25,30,45,17,18,-1
25,30,46,17,4,13
25,30,47,17,19,-2
25,30,48,30,18,12
25,30,49,9,11,-2
25,30,50,7,4,3
25,30,51,20,20,0
25,30,52,13,12,1
25,30,53,16,10,6
25,30,54,10,15,-5
25,30,55,9,4,5
25,30,56,9,7,2
25,30,57,13,5,8
25,30,58,17,11,6
25,30,59,5,15,-10
25,30,60,8,5,3
25,30,61,8,9,-1
25,30,62,10,5,5
25,30,63,20,11,9
25,30,64,15,19,-4
25,30,65,15,7,8
25,30,66,22,19,3
25,30,67,19,9,10
25,30,68,18,11,7
25,30,69,9,15,-6
25,30,70,11,15,-4
25,30,71,9,13,-4
25,30,72,8,8,0
25,30,73,24,10,14
25,30,74,3,9,-6
25,30,75,17,10,7
25,30,76,15,6,9
25,30,77,10,6,4
25,30,78,11,7,4
25,30,79,11,7,4
25,30,80,4,10,-6
25,30,81,28,19,9
25,30,82,6,14,-8
25,30,83,16,16,0
25,30,84,4,8,-4
25,30,85,17,18,-1
25,30,86,5,11,-6
25,30,87,18,11,7
25,30,88,10,12,-2
25,30,89,23,15,8
25,30,90,9,9,0
25,30,91,20,16,4
25,30,92,12,16,-4
25,30,93,17,16,1
25,30,94,13,10,3
25,30,95,16,12,4
25,30,96,17,20,-3
25,30,97,10,12,-2
25,30,98,12,19,-7
25,30,99,18,17,1
25,30,100,15,15,0
25,30,101,5,10,-5
25,30,102,9,11,-2
25,30,103,17,10,7
25,30,104,26,19,7
25,30,105,16,15,1
25,30,106,5,14,-9
25,30,107,9,11,-2
25,30,108,8,9,-1
25,30,109,10,16,-6
25,30,110,20,16,4
25,30,111,13,10,3
25,30,112,20,13,7
25,30,113,11,15,-4
25,30,114,10,10,0
25,30,115,9,8,1
25,30,116,9,11,-2
25,30,117,17,17,0
25,30,118,13,11,2
25,30,119,21,13,8
25,30,120,18,17,1
25,30,121,15,15,0
25,30,122,20,10,10
25,30,123,9,11,-2
25,30,124,16,12,4
25,30,125,8,11,-3
25,30,126,27,26,1
25,30,127,15,21,-6
25,30,128,14,13,1
25,30,129,15,14,1
25,30,130,17,15,2
25,30,131,15,18,-3
25,30,132,4,3,1
25,30,133,9,11,-2
25,30,134,8,9,-1
25,30,135,23,11,12
25,30,136,4,12,-8
25,30,137,12,4,8
25,30,138,14,20,-6
25,30,139,15,15,0
25,30,140,22,12,10
25,30,141,27,13,14
25,30,142,15,10,5
25,30,143,6,15,-9
25,30,144,19,9,10
25,30,145,5,4,1
25,30,146,14,16,-2
25,30,147,10,7,3
25,30,148,10,12,-2
25,30,149,18,4,14
25,30,150,13,10,3
25,30,151,25,13,12
25,30,152,6,15,-9
25,30,153,15,15,0
25,30,154,13,21,-8
25,30,155,13,8,5
25,30,156,13,18,-5
25,30,157,10,8,2
25,30,158,15,8,7
25,30,159,12,18,-6
25,30,160,12,6,6
25,30,161,7,5,2
25,30,162,13,25,-12
25,30,163,4,9,-5
25,30,164,7,13,-6
25,30,165,9,6,3
25,30,166,17,7,10
25,30,167,8,16,-8
25,30,168,12,8,4
25,30,169,12,13,-1
25,30,170,14,7,7
25,30,171,5,11,-6
25,30,172,13,11,2
25,30,173,15,1,14
25,30,174,20,23,-3
25,30,175,15,10,5
25,30,176,13,10,3
25,30,177,19,7,12
25,30,178,12,14,-2
25,30,179,8,20,-12
25,30,180,10,7,3
25,30,181,17,27,-10
25,30,182,11,12,-1
25,30,183,20,9,11
25,30,184,9,18,-9
25,30,185,16,26,-10
25,30,186,12,9,3
25,30,187,12,12,0
25,30,188,16,4,12
25,30,189,15,14,1
25,30,190,9,19,-10
25,30,191,10,4,6
25,30,192,30,23,7
25,30,193,16,11,5
25,30,194,12,14,-2
25,30,195,16,15,1
25,30,196,19,23,-4
25,30,197,4,8,-4
25,30,198,21,16,5
25,30,199,8,14,-6
25,30,200,19,24,-5
25,30,201,8,17,-9
25,30,202,10,26,-16
25,30,203,7,14,-7
25,30,204,27,16,11
25,30,205,19,17,2
25,30,206,12,11,1
25,30,207,19,8,11
25,30,208,4,16,-12
25,30,209,9,12,-3
25,30,210,16,19,-3
25,30,211,14,4,10
25,30,212,12,3,9
25,30,213,2,9,-7
25,30,214,16,17,-1
25,30,215,10,16,-6
25,30,216,9,10,-1
25,30,217,18,7,11
25,30,218,13,12,1
25,30,219,4,7,-3
25,30,220,2,3,-1
25,30,221,17,12,5
25,30,222,6,9,-3
25,30,223,15,10,5
25,30,224,9,31,-22
25,30,225,15,17,-2
25,30,226,13,14,-1
25,30,227,12,15,-3
25,30,228,8,5,3
25,30,229,12,6,6
25,30,230,18,13,5
25,30,231,0,11,-11
25,30,232,20,17,3
25,30,233,23,9,14
25,30,234,22,17,5
25,30,235,7,17,-10
25,30,236,11,10,1
25,30,237,8,15,-7
25,30,238,11,21,-10
25,30,239,23,10,13
25,30,240,12,12,0
25,30,241,8,16,-8
25,30,242,12,12,0
25,30,243,14,22,-8
25,30,244,17,10,7
25,30,245,17,16,1
25,30,246,8,14,-6
25,30,247,18,5,13
25,30,248,14,2,12
25,30,249,12,8,4
25,30,250,19,9,10
25,30,251,35,20,15
25,30,252,15,19,-4
25,30,253,12,16,-4
25,30,254,11,12,-1
25,30,255,10,17,-7
25,30,256,12,14,-2
25,30,257,10,21,-11
25,30,258,16,12,4
25,30,259,7,11,-4
25,30,260,19,4,15
25,30,261,14,12,2
25,30,262,14,12,2
25,30,263,19,12,7
25,30,264,14,10,4
25,30,265,6,5,1
25,30,266,9,3,6
25,30,267,15,2,13
25,30,268,22,18,4
25,30,269,13,3,10
25,30,270,13,14,-1
25,30,271,11,10,1
25,30,272,15,14,1
25,30,273,8,12,-4
25,30,274,12,9,3
25,30,275,11,7,4
25,30,276,20,41,-21
25,30,277,15,8,7
25,30,278,14,27,-13
25,30,279,14,10,4
25,30,280,8,6,2
25,30,281,11,21,-10
25,30,282,8,16,-8
25,30,283,15,12,3
25,30,284,4,7,-3
25,30,285,14,10,4
25,30,286,13,13,0
25,30,287,13,12,1
25,30,288,2,13,-11
25,30,289,11,13,-2
25,30,290,13,13,0
25,30,291,12,15,-3
25,30,292,15,15,0
25,30,293,6,9,-3
25,30,294,14,16,-2
25,30,295,12,11,1
25,30,296,14,12,2
25,30,297,13,8,5
25,30,298,9,11,-2
25,30,299,7,6,1
