# frame_skip_agent_A, frame_skip_agent_B, episode, score_A, score_B, reward
16,1,0,22,18,4
16,1,1,11,32,-21
16,1,2,9,7,2
16,1,3,11,13,-2
16,1,4,4,9,-5
16,1,5,4,21,-17
16,1,6,2,11,-9
16,1,7,9,17,-8
16,1,8,7,14,-7
16,1,9,9,8,1
16,1,10,7,10,-3
16,1,11,5,27,-22
16,1,12,21,11,10
16,1,13,1,10,-9
16,1,14,12,9,3
16,1,15,7,17,-10
16,1,16,10,25,-15
16,1,17,21,21,0
16,1,18,4,11,-7
16,1,19,8,7,1
16,1,20,17,25,-8
16,1,21,3,22,-19
16,1,22,4,15,-11
16,1,23,8,18,-10
16,1,24,5,13,-8
16,1,25,15,13,2
16,1,26,2,22,-20
16,1,27,16,14,2
16,1,28,4,6,-2
16,1,29,7,12,-5
16,1,30,4,9,-5
16,1,31,0,8,-8
16,1,32,10,32,-22
16,1,33,12,19,-7
16,1,34,9,26,-17
16,1,35,11,11,0
16,1,36,14,28,-14
16,1,37,7,12,-5
16,1,38,5,5,0
16,1,39,5,11,-6
16,1,40,8,11,-3
16,1,41,10,9,1
16,1,42,5,20,-15
16,1,43,8,21,-13
16,1,44,24,17,7
16,1,45,9,11,-2
16,1,46,7,28,-21
16,1,47,6,21,-15
16,1,48,9,11,-2
16,1,49,8,13,-5
16,1,50,8,19,-11
16,1,51,15,13,2
16,1,52,12,12,0
16,1,53,14,22,-8
16,1,54,8,7,1
16,1,55,10,12,-2
16,1,56,10,7,3
16,1,57,12,22,-10
16,1,58,6,13,-7
16,1,59,11,20,-9
16,1,60,2,13,-11
16,1,61,6,14,-8
16,1,62,4,21,-17
16,1,63,2,6,-4
16,1,64,10,24,-14
16,1,65,7,15,-8
16,1,66,3,12,-9
16,1,67,24,12,12
16,1,68,20,17,3
16,1,69,10,17,-7
16,1,70,13,18,-5
16,1,71,7,13,-6
16,1,72,5,8,-3
16,1,73,6,14,-8
16,1,74,14,4,10
16,1,75,8,10,-2
16,1,76,16,21,-5
16,1,77,8,15,-7
16,1,78,11,21,-10
16,1,79,8,12,-4
16,1,80,11,13,-2
16,1,81,4,16,-12
16,1,82,14,18,-4
16,1,83,17,26,-9
16,1,84,16,18,-2
16,1,85,6,25,-19
16,1,86,11,19,-8
16,1,87,23,10,13
16,1,88,22,15,7
16,1,89,1,24,-23
16,1,90,9,17,-8
16,1,91,14,28,-14
16,1,92,4,10,-6
16,1,93,8,10,-2
16,1,94,19,28,-9
16,1,95,13,14,-1
16,1,96,6,22,-16
16,1,97,12,20,-8
16,1,98,4,10,-6
16,1,99,21,19,2
16,1,100,6,23,-17
16,1,101,0,5,-5
16,1,102,8,23,-15
16,1,103,6,8,-2
16,1,104,17,17,0
16,1,105,11,18,-7
16,1,106,8,22,-14
16,1,107,11,17,-6
16,1,108,7,12,-5
16,1,109,9,9,0
16,1,110,7,20,-13
16,1,111,8,32,-24
16,1,112,7,13,-6
16,1,113,15,16,-1
16,1,114,9,13,-4
16,1,115,11,14,-3
16,1,116,5,1,4
16,1,117,7,9,-2
16,1,118,4,7,-3
16,1,119,4,20,-16
16,1,120,16,18,-2
16,1,121,6,13,-7
16,1,122,5,13,-8
16,1,123,8,14,-6
16,1,124,10,22,-12
16,1,125,13,28,-15
16,1,126,12,26,-14
16,1,127,11,33,-22
16,1,128,13,14,-1
16,1,129,1,10,-9
16,1,130,9,12,-3
16,1,131,7,24,-17
16,1,132,9,24,-15
16,1,133,13,17,-4
16,1,134,4,4,0
16,1,135,12,23,-11
16,1,136,16,34,-18
16,1,137,4,3,1
16,1,138,6,21,-15
16,1,139,16,23,-7
16,1,140,9,17,-8
16,1,141,10,19,-9
16,1,142,6,10,-4
16,1,143,5,16,-11
16,1,144,12,7,5
16,1,145,9,13,-4
16,1,146,4,11,-7
16,1,147,14,21,-7
16,1,148,8,9,-1
16,1,149,14,10,4
16,1,150,7,15,-8
16,1,151,14,18,-4
16,1,152,12,12,0
16,1,153,8,18,-10
16,1,154,4,11,-7
16,1,155,13,11,2
16,1,156,2,13,-11
16,1,157,11,22,-11
16,1,158,7,15,-8
16,1,159,6,25,-19
16,1,160,4,8,-4
16,1,161,6,5,1
16,1,162,10,11,-1
16,1,163,4,16,-12
16,1,164,4,7,-3
16,1,165,10,19,-9
16,1,166,7,18,-11
16,1,167,6,44,-38
16,1,168,4,30,-26
16,1,169,8,10,-2
16,1,170,6,14,-8
16,1,171,6,9,-3
16,1,172,4,9,-5
16,1,173,12,16,-4
16,1,174,12,13,-1
16,1,175,11,22,-11
16,1,176,10,19,-9
16,1,177,17,25,-8
16,1,178,13,9,4
16,1,179,11,12,-1
16,1,180,5,21,-16
16,1,181,4,10,-6
16,1,182,9,14,-5
16,1,183,5,14,-9
16,1,184,14,27,-13
16,1,185,13,13,0
16,1,186,5,10,-5
16,1,187,14,21,-7
16,1,188,9,20,-11
16,1,189,11,8,3
16,1,190,10,7,3
16,1,191,10,18,-8
16,1,192,2,12,-10
16,1,193,10,11,-1
16,1,194,8,13,-5
16,1,195,15,19,-4
16,1,196,9,5,4
16,1,197,13,20,-7
16,1,198,11,15,-4
16,1,199,5,10,-5
16,1,200,8,27,-19
16,1,201,7,9,-2
16,1,202,6,19,-13
16,1,203,6,9,-3
16,1,204,3,11,-8
16,1,205,5,9,-4
16,1,206,14,14,0
16,1,207,2,7,-5
16,1,208,8,7,1
16,1,209,15,22,-7
16,1,210,7,15,-8
16,1,211,6,9,-3
16,1,212,7,19,-12
16,1,213,4,14,-10
16,1,214,11,13,-2
16,1,215,9,23,-14
16,1,216,7,12,-5
16,1,217,7,17,-10
16,1,218,11,9,2
16,1,219,9,20,-11
16,1,220,2,11,-9
16,1,221,7,9,-2
16,1,222,16,21,-5
16,1,223,6,22,-16
16,1,224,11,20,-9
16,1,225,10,16,-6
16,1,226,5,24,-19
16,1,227,7,14,-7
16,1,228,13,33,-20
16,1,229,13,27,-14
16,1,230,14,14,0
16,1,231,11,8,3
16,1,232,13,9,4
16,1,233,17,21,-4
16,1,234,18,12,6
16,1,235,3,16,-13
16,1,236,2,11,-9
16,1,237,17,11,6
16,1,238,6,18,-12
16,1,239,8,28,-20
16,1,240,7,7,0
16,1,241,5,12,-7
16,1,242,6,16,-10
16,1,243,3,8,-5
16,1,244,5,8,-3
16,1,245,2,6,-4
16,1,246,11,19,-8
16,1,247,18,32,-14
16,1,248,14,21,-7
16,1,249,15,9,6
16,1,250,7,21,-14
16,1,251,13,22,-9
16,1,252,13,15,-2
16,1,253,15,23,-8
16,1,254,4,19,-15
16,1,255,6,16,-10
16,1,256,7,16,-9
16,1,257,5,11,-6
16,1,258,6,11,-5
16,1,259,7,14,-7
16,1,260,15,19,-4
16,1,261,9,9,0
16,1,262,7,9,-2
16,1,263,4,16,-12
16,1,264,9,14,-5
16,1,265,9,10,-1
16,1,266,16,14,2
16,1,267,17,18,-1
16,1,268,5,14,-9
16,1,269,10,13,-3
16,1,270,2,5,-3
16,1,271,11,14,-3
16,1,272,7,11,-4
16,1,273,10,26,-16
16,1,274,8,20,-12
16,1,275,18,15,3
16,1,276,11,23,-12
16,1,277,4,14,-10
16,1,278,17,19,-2
16,1,279,2,11,-9
16,1,280,7,13,-6
16,1,281,5,9,-4
16,1,282,11,22,-11
16,1,283,10,11,-1
16,1,284,8,5,3
16,1,285,3,12,-9
16,1,286,7,19,-12
16,1,287,14,16,-2
16,1,288,12,22,-10
16,1,289,5,11,-6
16,1,290,2,13,-11
16,1,291,5,13,-8
16,1,292,10,14,-4
16,1,293,7,18,-11
16,1,294,13,24,-11
16,1,295,12,32,-20
16,1,296,14,20,-6
16,1,297,32,23,9
16,1,298,8,15,-7
16,1,299,8,13,-5
16,2,0,7,11,-4
16,2,1,6,11,-5
16,2,2,10,16,-6
16,2,3,9,15,-6
16,2,4,6,7,-1
16,2,5,18,30,-12
16,2,6,12,17,-5
16,2,7,4,10,-6
16,2,8,18,10,8
16,2,9,8,20,-12
16,2,10,7,24,-17
16,2,11,9,13,-4
16,2,12,15,6,9
16,2,13,8,13,-5
16,2,14,14,23,-9
16,2,15,3,26,-23
16,2,16,15,24,-9
16,2,17,7,7,0
16,2,18,6,28,-22
16,2,19,11,29,-18
16,2,20,16,9,7
16,2,21,10,17,-7
16,2,22,7,18,-11
16,2,23,9,13,-4
16,2,24,14,16,-2
16,2,25,12,25,-13
16,2,26,14,17,-3
16,2,27,5,25,-20
16,2,28,9,23,-14
16,2,29,5,9,-4
16,2,30,13,14,-1
16,2,31,12,33,-21
16,2,32,13,21,-8
16,2,33,13,16,-3
16,2,34,5,19,-14
16,2,35,5,13,-8
16,2,36,15,10,5
16,2,37,8,15,-7
16,2,38,5,17,-12
16,2,39,8,18,-10
16,2,40,12,26,-14
16,2,41,8,4,4
16,2,42,4,15,-11
16,2,43,14,8,6
16,2,44,13,21,-8
16,2,45,9,15,-6
16,2,46,12,19,-7
16,2,47,7,18,-11
16,2,48,10,42,-32
16,2,49,6,12,-6
16,2,50,11,20,-9
16,2,51,6,6,0
16,2,52,16,9,7
16,2,53,7,6,1
16,2,54,6,20,-14
16,2,55,12,23,-11
16,2,56,8,11,-3
16,2,57,19,11,8
16,2,58,3,24,-21
16,2,59,2,12,-10
16,2,60,9,18,-9
16,2,61,18,14,4
16,2,62,7,14,-7
16,2,63,3,17,-14
16,2,64,8,20,-12
16,2,65,4,5,-1
16,2,66,12,22,-10
16,2,67,8,18,-10
16,2,68,3,18,-15
16,2,69,9,25,-16
16,2,70,10,21,-11
16,2,71,7,12,-5
16,2,72,1,11,-10
16,2,73,12,14,-2
16,2,74,11,23,-12
16,2,75,5,13,-8
16,2,76,5,7,-2
16,2,77,0,16,-16
16,2,78,13,16,-3
16,2,79,7,15,-8
16,2,80,12,21,-9
16,2,81,11,17,-6
16,2,82,2,10,-8
16,2,83,6,19,-13
16,2,84,2,22,-20
16,2,85,6,9,-3
16,2,86,7,20,-13
16,2,87,6,24,-18
16,2,88,12,20,-8
16,2,89,5,8,-3
16,2,90,9,9,0
16,2,91,25,25,0
16,2,92,7,26,-19
16,2,93,5,17,-12
16,2,94,12,28,-16
16,2,95,1,10,-9
16,2,96,17,14,3
16,2,97,16,24,-8
16,2,98,12,17,-5
16,2,99,7,23,-16
16,2,100,9,11,-2
16,2,101,3,10,-7
16,2,102,7,14,-7
16,2,103,3,3,0
16,2,104,3,6,-3
16,2,105,7,13,-6
16,2,106,10,18,-8
16,2,107,11,16,-5
16,2,108,0,2,-2
16,2,109,9,26,-17
16,2,110,11,19,-8
16,2,111,10,15,-5
16,2,112,10,17,-7
16,2,113,8,6,2
16,2,114,10,10,0
16,2,115,8,17,-9
16,2,116,18,21,-3
16,2,117,10,13,-3
16,2,118,6,16,-10
16,2,119,17,8,9
16,2,120,14,9,5
16,2,121,13,17,-4
16,2,122,9,21,-12
16,2,123,10,11,-1
16,2,124,7,16,-9
16,2,125,13,10,3
16,2,126,13,10,3
16,2,127,11,18,-7
16,2,128,3,18,-15
16,2,129,8,10,-2
16,2,130,14,9,5
16,2,131,17,26,-9
16,2,132,10,17,-7
16,2,133,7,19,-12
16,2,134,11,20,-9
16,2,135,8,13,-5
16,2,136,17,14,3
16,2,137,10,30,-20
16,2,138,9,13,-4
16,2,139,14,14,0
16,2,140,11,17,-6
16,2,141,3,8,-5
16,2,142,6,7,-1
16,2,143,9,12,-3
16,2,144,13,13,0
16,2,145,9,16,-7
16,2,146,13,18,-5
16,2,147,11,21,-10
16,2,148,6,15,-9
16,2,149,10,23,-13
16,2,150,6,18,-12
16,2,151,10,15,-5
16,2,152,6,8,-2
16,2,153,13,20,-7
16,2,154,8,17,-9
16,2,155,5,19,-14
16,2,156,8,8,0
16,2,157,8,4,4
16,2,158,11,21,-10
16,2,159,6,9,-3
16,2,160,9,14,-5
16,2,161,2,16,-14
16,2,162,11,14,-3
16,2,163,11,19,-8
16,2,164,11,11,0
16,2,165,7,20,-13
16,2,166,11,20,-9
16,2,167,8,11,-3
16,2,168,12,21,-9
16,2,169,10,11,-1
16,2,170,7,14,-7
16,2,171,11,20,-9
16,2,172,8,20,-12
16,2,173,7,16,-9
16,2,174,5,9,-4
16,2,175,4,18,-14
16,2,176,14,19,-5
16,2,177,17,18,-1
16,2,178,7,9,-2
16,2,179,12,16,-4
16,2,180,11,16,-5
16,2,181,6,16,-10
16,2,182,4,13,-9
16,2,183,13,29,-16
16,2,184,7,19,-12
16,2,185,8,15,-7
16,2,186,7,15,-8
16,2,187,10,23,-13
16,2,188,10,16,-6
16,2,189,4,9,-5
16,2,190,11,23,-12
16,2,191,5,19,-14
16,2,192,9,20,-11
16,2,193,3,10,-7
16,2,194,14,12,2
16,2,195,8,39,-31
16,2,196,14,21,-7
16,2,197,15,6,9
16,2,198,10,11,-1
16,2,199,6,20,-14
16,2,200,10,12,-2
16,2,201,3,25,-22
16,2,202,7,10,-3
16,2,203,5,15,-10
16,2,204,8,30,-22
16,2,205,8,22,-14
16,2,206,10,23,-13
16,2,207,11,14,-3
16,2,208,14,16,-2
16,2,209,13,13,0
16,2,210,6,14,-8
16,2,211,19,22,-3
16,2,212,19,30,-11
16,2,213,1,20,-19
16,2,214,5,7,-2
16,2,215,16,32,-16
16,2,216,22,37,-15
16,2,217,9,23,-14
16,2,218,15,8,7
16,2,219,14,20,-6
16,2,220,4,13,-9
16,2,221,4,9,-5
16,2,222,11,23,-12
16,2,223,8,6,2
16,2,224,8,12,-4
16,2,225,0,3,-3
16,2,226,12,19,-7
16,2,227,12,29,-17
16,2,228,1,10,-9
16,2,229,15,24,-9
16,2,230,15,7,8
16,2,231,18,26,-8
16,2,232,14,19,-5
16,2,233,9,24,-15
16,2,234,7,10,-3
16,2,235,9,13,-4
16,2,236,8,13,-5
16,2,237,10,10,0
16,2,238,10,24,-14
16,2,239,13,17,-4
16,2,240,8,16,-8
16,2,241,11,20,-9
16,2,242,5,7,-2
16,2,243,5,26,-21
16,2,244,8,15,-7
16,2,245,3,1,2
16,2,246,9,27,-18
16,2,247,20,26,-6
16,2,248,4,22,-18
16,2,249,14,23,-9
16,2,250,18,23,-5
16,2,251,26,7,19
16,2,252,6,31,-25
16,2,253,2,14,-12
16,2,254,4,14,-10
16,2,255,9,25,-16
16,2,256,7,33,-26
16,2,257,9,14,-5
16,2,258,7,23,-16
16,2,259,4,12,-8
16,2,260,13,35,-22
16,2,261,5,28,-23
16,2,262,6,10,-4
16,2,263,9,13,-4
16,2,264,22,25,-3
16,2,265,6,12,-6
16,2,266,11,11,0
16,2,267,12,19,-7
16,2,268,4,16,-12
16,2,269,14,21,-7
16,2,270,6,23,-17
16,2,271,3,15,-12
16,2,272,8,16,-8
16,2,273,8,19,-11
16,2,274,8,10,-2
16,2,275,8,11,-3
16,2,276,8,10,-2
16,2,277,20,26,-6
16,2,278,15,18,-3
16,2,279,20,16,4
16,2,280,14,30,-16
16,2,281,7,23,-16
16,2,282,20,38,-18
16,2,283,4,29,-25
16,2,284,5,24,-19
16,2,285,3,11,-8
16,2,286,10,13,-3
16,2,287,1,16,-15
16,2,288,8,19,-11
16,2,289,11,20,-9
16,2,290,7,12,-5
16,2,291,6,18,-12
16,2,292,17,21,-4
16,2,293,12,34,-22
16,2,294,11,21,-10
16,2,295,11,15,-4
16,2,296,13,29,-16
16,2,297,7,26,-19
16,2,298,4,8,-4
16,2,299,6,6,0
16,3,0,6,17,-11
16,3,1,4,16,-12
16,3,2,7,19,-12
16,3,3,7,14,-7
16,3,4,10,19,-9
16,3,5,9,11,-2
16,3,6,10,25,-15
16,3,7,10,7,3
16,3,8,12,16,-4
16,3,9,19,16,3
16,3,10,6,9,-3
16,3,11,9,25,-16
16,3,12,16,6,10
16,3,13,16,10,6
16,3,14,10,22,-12
16,3,15,10,18,-8
16,3,16,14,19,-5
16,3,17,6,9,-3
16,3,18,15,26,-11
16,3,19,11,12,-1
16,3,20,15,21,-6
16,3,21,19,15,4
16,3,22,13,12,1
16,3,23,15,30,-15
16,3,24,11,20,-9
16,3,25,20,38,-18
16,3,26,4,26,-22
16,3,27,8,15,-7
16,3,28,7,15,-8
16,3,29,19,14,5
16,3,30,7,22,-15
16,3,31,8,12,-4
16,3,32,13,19,-6
16,3,33,5,16,-11
16,3,34,6,15,-9
16,3,35,8,10,-2
16,3,36,7,15,-8
16,3,37,8,15,-7
16,3,38,11,16,-5
16,3,39,10,13,-3
16,3,40,7,26,-19
16,3,41,12,17,-5
16,3,42,6,11,-5
16,3,43,13,19,-6
16,3,44,15,15,0
16,3,45,8,9,-1
16,3,46,17,9,8
16,3,47,14,11,3
16,3,48,10,16,-6
16,3,49,17,19,-2
16,3,50,5,19,-14
16,3,51,5,13,-8
16,3,52,5,15,-10
16,3,53,9,28,-19
16,3,54,14,22,-8
16,3,55,12,22,-10
16,3,56,17,15,2
16,3,57,10,16,-6
16,3,58,9,14,-5
16,3,59,6,25,-19
16,3,60,6,15,-9
16,3,61,12,16,-4
16,3,62,17,23,-6
16,3,63,5,18,-13
16,3,64,9,29,-20
16,3,65,13,18,-5
16,3,66,6,21,-15
16,3,67,13,16,-3
16,3,68,14,25,-11
16,3,69,5,25,-20
16,3,70,9,25,-16
16,3,71,10,20,-10
16,3,72,8,9,-1
16,3,73,4,10,-6
16,3,74,13,30,-17
16,3,75,9,18,-9
16,3,76,15,15,0
16,3,77,9,24,-15
16,3,78,5,15,-10
16,3,79,8,11,-3
16,3,80,9,28,-19
16,3,81,6,23,-17
16,3,82,10,12,-2
16,3,83,10,18,-8
16,3,84,11,23,-12
16,3,85,17,15,2
16,3,86,3,11,-8
16,3,87,18,13,5
16,3,88,21,20,1
16,3,89,11,30,-19
16,3,90,15,12,3
16,3,91,11,19,-8
16,3,92,3,21,-18
16,3,93,10,11,-1
16,3,94,7,21,-14
16,3,95,7,11,-4
16,3,96,14,20,-6
16,3,97,5,14,-9
16,3,98,14,10,4
16,3,99,7,13,-6
16,3,100,15,21,-6
16,3,101,4,8,-4
16,3,102,15,18,-3
16,3,103,11,23,-12
16,3,104,12,21,-9
16,3,105,15,13,2
16,3,106,8,11,-3
16,3,107,15,22,-7
16,3,108,16,28,-12
16,3,109,3,18,-15
16,3,110,19,22,-3
16,3,111,7,21,-14
16,3,112,1,20,-19
16,3,113,4,16,-12
16,3,114,15,18,-3
16,3,115,10,7,3
16,3,116,9,7,2
16,3,117,27,23,4
16,3,118,9,10,-1
16,3,119,15,16,-1
16,3,120,10,19,-9
16,3,121,7,12,-5
16,3,122,10,23,-13
16,3,123,14,17,-3
16,3,124,11,6,5
16,3,125,7,20,-13
16,3,126,0,3,-3
16,3,127,7,26,-19
16,3,128,15,17,-2
16,3,129,13,24,-11
16,3,130,8,14,-6
16,3,131,18,20,-2
16,3,132,7,14,-7
16,3,133,10,17,-7
16,3,134,11,20,-9
16,3,135,3,9,-6
16,3,136,4,7,-3
16,3,137,15,9,6
16,3,138,5,16,-11
16,3,139,12,24,-12
16,3,140,5,10,-5
16,3,141,2,20,-18
16,3,142,19,21,-2
16,3,143,2,8,-6
16,3,144,16,20,-4
16,3,145,4,7,-3
16,3,146,24,23,1
16,3,147,4,20,-16
16,3,148,6,13,-7
16,3,149,7,20,-13
16,3,150,11,6,5
16,3,151,12,9,3
16,3,152,5,12,-7
16,3,153,13,8,5
16,3,154,8,20,-12
16,3,155,9,10,-1
16,3,156,10,6,4
16,3,157,5,10,-5
16,3,158,20,26,-6
16,3,159,11,10,1
16,3,160,16,16,0
16,3,161,10,17,-7
16,3,162,4,14,-10
16,3,163,27,21,6
16,3,164,10,25,-15
16,3,165,9,22,-13
16,3,166,8,14,-6
16,3,167,14,14,0
16,3,168,11,20,-9
16,3,169,9,11,-2
16,3,170,9,28,-19
16,3,171,20,26,-6
16,3,172,11,13,-2
16,3,173,12,12,0
16,3,174,6,16,-10
16,3,175,14,24,-10
16,3,176,6,18,-12
16,3,177,6,16,-10
16,3,178,4,15,-11
16,3,179,13,25,-12
16,3,180,12,11,1
16,3,181,6,26,-20
16,3,182,7,29,-22
16,3,183,12,18,-6
16,3,184,22,22,0
16,3,185,15,29,-14
16,3,186,11,12,-1
16,3,187,14,16,-2
16,3,188,10,23,-13
16,3,189,8,25,-17
16,3,190,9,12,-3
16,3,191,11,25,-14
16,3,192,11,18,-7
16,3,193,12,13,-1
16,3,194,18,17,1
16,3,195,7,27,-20
16,3,196,24,12,12
16,3,197,9,26,-17
16,3,198,9,13,-4
16,3,199,20,22,-2
16,3,200,8,11,-3
16,3,201,5,7,-2
16,3,202,14,27,-13
16,3,203,23,25,-2
16,3,204,15,36,-21
16,3,205,9,18,-9
16,3,206,9,13,-4
16,3,207,14,17,-3
16,3,208,9,16,-7
16,3,209,4,9,-5
16,3,210,22,25,-3
16,3,211,9,6,3
16,3,212,13,15,-2
16,3,213,13,16,-3
16,3,214,10,12,-2
16,3,215,10,20,-10
16,3,216,12,12,0
16,3,217,6,3,3
16,3,218,5,26,-21
16,3,219,12,14,-2
16,3,220,11,7,4
16,3,221,11,20,-9
16,3,222,4,19,-15
16,3,223,6,20,-14
16,3,224,7,15,-8
16,3,225,15,29,-14
16,3,226,12,22,-10
16,3,227,17,23,-6
16,3,228,15,20,-5
16,3,229,10,12,-2
16,3,230,6,20,-14
16,3,231,5,16,-11
16,3,232,15,16,-1
16,3,233,12,21,-9
16,3,234,6,11,-5
16,3,235,2,16,-14
16,3,236,6,18,-12
16,3,237,8,22,-14
16,3,238,4,19,-15
16,3,239,8,28,-20
16,3,240,4,31,-27
16,3,241,6,12,-6
16,3,242,8,14,-6
16,3,243,5,23,-18
16,3,244,8,27,-19
16,3,245,12,16,-4
16,3,246,8,8,0
16,3,247,3,20,-17
16,3,248,5,23,-18
16,3,249,12,22,-10
16,3,250,12,9,3
16,3,251,7,18,-11
16,3,252,16,23,-7
16,3,253,10,31,-21
16,3,254,13,19,-6
16,3,255,11,33,-22
16,3,256,9,13,-4
16,3,257,1,11,-10
16,3,258,10,7,3
16,3,259,16,12,4
16,3,260,5,12,-7
16,3,261,15,23,-8
16,3,262,23,20,3
16,3,263,5,15,-10
16,3,264,8,13,-5
16,3,265,13,17,-4
16,3,266,7,43,-36
16,3,267,5,25,-20
16,3,268,8,21,-13
16,3,269,1,14,-13
16,3,270,7,12,-5
16,3,271,11,22,-11
16,3,272,9,22,-13
16,3,273,11,18,-7
16,3,274,13,20,-7
16,3,275,6,20,-14
16,3,276,7,9,-2
16,3,277,4,13,-9
16,3,278,4,20,-16
16,3,279,9,19,-10
16,3,280,12,16,-4
16,3,281,16,11,5
16,3,282,11,11,0
16,3,283,9,25,-16
16,3,284,10,25,-15
16,3,285,18,23,-5
16,3,286,11,10,1
16,3,287,12,32,-20
16,3,288,8,18,-10
16,3,289,13,22,-9
16,3,290,11,15,-4
16,3,291,6,12,-6
16,3,292,10,24,-14
16,3,293,14,12,2
16,3,294,7,20,-13
16,3,295,11,26,-15
16,3,296,16,15,1
16,3,297,6,9,-3
16,3,298,7,8,-1
16,3,299,12,15,-3
16,4,0,14,18,-4
16,4,1,14,25,-11
16,4,2,14,25,-11
16,4,3,21,14,7
16,4,4,5,3,2
16,4,5,14,24,-10
16,4,6,15,21,-6
16,4,7,8,18,-10
16,4,8,10,14,-4
16,4,9,6,12,-6
16,4,10,17,27,-10
16,4,11,9,17,-8
16,4,12,5,10,-5
16,4,13,13,15,-2
16,4,14,13,19,-6
16,4,15,7,21,-14
16,4,16,7,17,-10
16,4,17,9,24,-15
16,4,18,7,28,-21
16,4,19,4,26,-22
16,4,20,5,19,-14
16,4,21,17,16,1
16,4,22,5,22,-17
16,4,23,21,19,2
16,4,24,11,30,-19
16,4,25,18,7,11
16,4,26,4,5,-1
16,4,27,9,28,-19
16,4,28,7,18,-11
16,4,29,5,15,-10
16,4,30,11,19,-8
16,4,31,4,7,-3
16,4,32,10,32,-22
16,4,33,10,19,-9
16,4,34,12,16,-4
16,4,35,21,22,-1
16,4,36,12,30,-18
16,4,37,5,12,-7
16,4,38,15,23,-8
16,4,39,7,20,-13
16,4,40,10,12,-2
16,4,41,12,31,-19
16,4,42,16,23,-7
16,4,43,22,21,1
16,4,44,3,18,-15
16,4,45,11,16,-5
16,4,46,7,18,-11
16,4,47,11,22,-11
16,4,48,7,16,-9
16,4,49,4,23,-19
16,4,50,18,24,-6
16,4,51,22,23,-1
16,4,52,13,21,-8
16,4,53,6,19,-13
16,4,54,17,30,-13
16,4,55,3,9,-6
16,4,56,6,9,-3
16,4,57,29,23,6
16,4,58,13,12,1
16,4,59,4,16,-12
16,4,60,13,23,-10
16,4,61,20,19,1
16,4,62,7,33,-26
16,4,63,9,13,-4
16,4,64,6,24,-18
16,4,65,14,35,-21
16,4,66,9,16,-7
16,4,67,5,16,-11
16,4,68,7,6,1
16,4,69,10,13,-3
16,4,70,12,12,0
16,4,71,14,16,-2
16,4,72,7,17,-10
16,4,73,13,18,-5
16,4,74,3,10,-7
16,4,75,6,16,-10
16,4,76,10,22,-12
16,4,77,2,8,-6
16,4,78,16,9,7
16,4,79,14,19,-5
16,4,80,6,14,-8
16,4,81,10,22,-12
16,4,82,7,22,-15
16,4,83,7,25,-18
16,4,84,13,20,-7
16,4,85,15,21,-6
16,4,86,13,22,-9
16,4,87,4,20,-16
16,4,88,10,24,-14
16,4,89,9,15,-6
16,4,90,15,26,-11
16,4,91,7,14,-7
16,4,92,21,14,7
16,4,93,17,20,-3
16,4,94,10,16,-6
16,4,95,9,20,-11
16,4,96,10,6,4
16,4,97,16,21,-5
16,4,98,8,5,3
16,4,99,14,18,-4
16,4,100,5,11,-6
16,4,101,11,20,-9
16,4,102,13,17,-4
16,4,103,6,19,-13
16,4,104,11,17,-6
16,4,105,8,12,-4
16,4,106,9,23,-14
16,4,107,6,9,-3
16,4,108,11,14,-3
16,4,109,7,21,-14
16,4,110,11,25,-14
16,4,111,5,10,-5
16,4,112,11,12,-1
16,4,113,10,27,-17
16,4,114,5,19,-14
16,4,115,19,27,-8
16,4,116,3,17,-14
16,4,117,15,10,5
16,4,118,11,10,1
16,4,119,10,21,-11
16,4,120,17,22,-5
16,4,121,16,45,-29
16,4,122,16,32,-16
16,4,123,10,12,-2
16,4,124,5,12,-7
16,4,125,7,20,-13
16,4,126,12,31,-19
16,4,127,5,10,-5
16,4,128,6,15,-9
16,4,129,8,37,-29
16,4,130,7,17,-10
16,4,131,11,15,-4
16,4,132,5,17,-12
16,4,133,10,18,-8
16,4,134,13,12,1
16,4,135,8,15,-7
16,4,136,12,15,-3
16,4,137,20,20,0
16,4,138,10,13,-3
16,4,139,3,17,-14
16,4,140,13,17,-4
16,4,141,7,13,-6
16,4,142,9,25,-16
16,4,143,15,28,-13
16,4,144,9,21,-12
16,4,145,10,14,-4
16,4,146,9,7,2
16,4,147,16,13,3
16,4,148,11,19,-8
16,4,149,12,26,-14
16,4,150,14,16,-2
16,4,151,17,11,6
16,4,152,14,16,-2
16,4,153,8,25,-17
16,4,154,6,18,-12
16,4,155,4,27,-23
16,4,156,5,14,-9
16,4,157,7,17,-10
16,4,158,6,16,-10
16,4,159,12,24,-12
16,4,160,16,31,-15
16,4,161,25,12,13
16,4,162,14,19,-5
16,4,163,12,33,-21
16,4,164,16,17,-1
16,4,165,12,21,-9
16,4,166,6,11,-5
16,4,167,13,11,2
16,4,168,18,18,0
16,4,169,18,20,-2
16,4,170,13,13,0
16,4,171,11,11,0
16,4,172,8,15,-7
16,4,173,17,13,4
16,4,174,11,24,-13
16,4,175,4,5,-1
16,4,176,12,14,-2
16,4,177,6,16,-10
16,4,178,3,10,-7
16,4,179,10,45,-35
16,4,180,6,28,-22
16,4,181,6,14,-8
16,4,182,15,14,1
16,4,183,12,17,-5
16,4,184,7,8,-1
16,4,185,6,24,-18
16,4,186,8,12,-4
16,4,187,7,9,-2
16,4,188,5,15,-10
16,4,189,8,17,-9
16,4,190,15,22,-7
16,4,191,8,13,-5
16,4,192,8,24,-16
16,4,193,11,26,-15
16,4,194,10,26,-16
16,4,195,4,16,-12
16,4,196,7,17,-10
16,4,197,11,14,-3
16,4,198,11,20,-9
16,4,199,7,17,-10
16,4,200,12,24,-12
16,4,201,17,20,-3
16,4,202,7,32,-25
16,4,203,11,3,8
16,4,204,9,21,-12
16,4,205,2,4,-2
16,4,206,17,7,10
16,4,207,8,19,-11
16,4,208,20,15,5
16,4,209,20,20,0
16,4,210,10,25,-15
16,4,211,9,22,-13
16,4,212,11,17,-6
16,4,213,5,17,-12
16,4,214,8,25,-17
16,4,215,14,16,-2
16,4,216,7,17,-10
16,4,217,13,20,-7
16,4,218,13,30,-17
16,4,219,3,9,-6
16,4,220,4,13,-9
16,4,221,8,12,-4
16,4,222,5,18,-13
16,4,223,5,7,-2
16,4,224,11,19,-8
16,4,225,5,17,-12
16,4,226,8,27,-19
16,4,227,12,17,-5
16,4,228,7,12,-5
16,4,229,6,26,-20
16,4,230,9,36,-27
16,4,231,22,24,-2
16,4,232,13,22,-9
16,4,233,10,27,-17
16,4,234,15,14,1
16,4,235,7,12,-5
16,4,236,9,22,-13
16,4,237,12,20,-8
16,4,238,4,11,-7
16,4,239,3,11,-8
16,4,240,14,13,1
16,4,241,14,25,-11
16,4,242,14,27,-13
16,4,243,4,21,-17
16,4,244,15,26,-11
16,4,245,22,24,-2
16,4,246,6,14,-8
16,4,247,10,24,-14
16,4,248,5,12,-7
16,4,249,15,19,-4
16,4,250,15,44,-29
16,4,251,7,14,-7
16,4,252,13,20,-7
16,4,253,8,13,-5
16,4,254,11,29,-18
16,4,255,4,10,-6
16,4,256,7,9,-2
16,4,257,16,23,-7
16,4,258,12,10,2
16,4,259,17,27,-10
16,4,260,16,6,10
16,4,261,11,15,-4
16,4,262,9,24,-15
16,4,263,21,23,-2
16,4,264,4,12,-8
16,4,265,5,18,-13
16,4,266,21,25,-4
16,4,267,8,39,-31
16,4,268,7,20,-13
16,4,269,11,14,-3
16,4,270,3,22,-19
16,4,271,6,21,-15
16,4,272,5,14,-9
16,4,273,15,11,4
16,4,274,20,24,-4
16,4,275,12,16,-4
16,4,276,11,24,-13
16,4,277,5,16,-11
16,4,278,11,9,2
16,4,279,4,10,-6
16,4,280,13,20,-7
16,4,281,4,15,-11
16,4,282,7,24,-17
16,4,283,18,21,-3
16,4,284,6,7,-1
16,4,285,15,15,0
16,4,286,11,35,-24
16,4,287,6,15,-9
16,4,288,13,20,-7
16,4,289,21,26,-5
16,4,290,3,17,-14
16,4,291,9,23,-14
16,4,292,1,8,-7
16,4,293,11,31,-20
16,4,294,16,13,3
16,4,295,17,13,4
16,4,296,8,10,-2
16,4,297,12,20,-8
16,4,298,7,14,-7
16,4,299,15,28,-13
16,5,0,7,5,2
16,5,1,2,10,-8
16,5,2,7,15,-8
16,5,3,4,10,-6
16,5,4,7,17,-10
16,5,5,12,19,-7
16,5,6,9,10,-1
16,5,7,4,23,-19
16,5,8,19,17,2
16,5,9,8,10,-2
16,5,10,6,17,-11
16,5,11,4,17,-13
16,5,12,5,13,-8
16,5,13,12,13,-1
16,5,14,11,12,-1
16,5,15,5,29,-24
16,5,16,16,15,1
16,5,17,5,14,-9
16,5,18,7,19,-12
16,5,19,3,7,-4
16,5,20,9,14,-5
16,5,21,17,22,-5
16,5,22,11,20,-9
16,5,23,9,16,-7
16,5,24,25,26,-1
16,5,25,11,21,-10
16,5,26,11,12,-1
16,5,27,7,17,-10
16,5,28,8,16,-8
16,5,29,6,17,-11
16,5,30,12,13,-1
16,5,31,22,30,-8
16,5,32,5,16,-11
16,5,33,10,14,-4
16,5,34,3,25,-22
16,5,35,8,6,2
16,5,36,5,19,-14
16,5,37,12,18,-6
16,5,38,14,30,-16
16,5,39,21,33,-12
16,5,40,4,3,1
16,5,41,6,14,-8
16,5,42,6,23,-17
16,5,43,18,17,1
16,5,44,16,18,-2
16,5,45,22,15,7
16,5,46,11,16,-5
16,5,47,16,38,-22
16,5,48,11,17,-6
16,5,49,11,13,-2
16,5,50,9,10,-1
16,5,51,18,21,-3
16,5,52,10,24,-14
16,5,53,5,5,0
16,5,54,20,32,-12
16,5,55,8,12,-4
16,5,56,14,22,-8
16,5,57,9,8,1
16,5,58,16,27,-11
16,5,59,10,24,-14
16,5,60,7,17,-10
16,5,61,5,14,-9
16,5,62,21,21,0
16,5,63,27,15,12
16,5,64,12,14,-2
16,5,65,5,21,-16
16,5,66,11,18,-7
16,5,67,7,20,-13
16,5,68,7,8,-1
16,5,69,19,24,-5
16,5,70,9,20,-11
16,5,71,9,17,-8
16,5,72,13,18,-5
16,5,73,10,13,-3
16,5,74,5,9,-4
16,5,75,7,20,-13
16,5,76,8,36,-28
16,5,77,14,10,4
16,5,78,12,9,3
16,5,79,10,19,-9
16,5,80,5,14,-9
16,5,81,3,19,-16
16,5,82,13,16,-3
16,5,83,11,20,-9
16,5,84,10,16,-6
16,5,85,12,15,-3
16,5,86,9,0,9
16,5,87,10,11,-1
16,5,88,3,11,-8
16,5,89,12,20,-8
16,5,90,8,10,-2
16,5,91,12,9,3
16,5,92,3,12,-9
16,5,93,11,33,-22
16,5,94,13,22,-9
16,5,95,8,11,-3
16,5,96,9,6,3
16,5,97,8,13,-5
16,5,98,18,14,4
16,5,99,5,12,-7
16,5,100,10,14,-4
16,5,101,7,8,-1
16,5,102,11,25,-14
16,5,103,16,19,-3
16,5,104,14,18,-4
16,5,105,8,10,-2
16,5,106,8,22,-14
16,5,107,23,26,-3
16,5,108,18,26,-8
16,5,109,12,17,-5
16,5,110,12,19,-7
16,5,111,8,19,-11
16,5,112,7,11,-4
16,5,113,8,18,-10
16,5,114,0,15,-15
16,5,115,5,13,-8
16,5,116,19,32,-13
16,5,117,10,30,-20
16,5,118,9,10,-1
16,5,119,9,9,0
16,5,120,10,14,-4
16,5,121,31,32,-1
16,5,122,8,12,-4
16,5,123,21,29,-8
16,5,124,11,17,-6
16,5,125,19,16,3
16,5,126,8,15,-7
16,5,127,15,17,-2
16,5,128,14,19,-5
16,5,129,20,28,-8
16,5,130,8,12,-4
16,5,131,11,23,-12
16,5,132,14,24,-10
16,5,133,13,19,-6
16,5,134,12,13,-1
16,5,135,24,20,4
16,5,136,5,23,-18
16,5,137,12,22,-10
16,5,138,6,10,-4
16,5,139,5,18,-13
16,5,140,12,15,-3
16,5,141,13,5,8
16,5,142,7,12,-5
16,5,143,5,12,-7
16,5,144,12,14,-2
16,5,145,13,25,-12
16,5,146,9,24,-15
16,5,147,20,22,-2
16,5,148,8,22,-14
16,5,149,13,30,-17
16,5,150,8,20,-12
16,5,151,11,19,-8
16,5,152,16,22,-6
16,5,153,13,26,-13
16,5,154,14,27,-13
16,5,155,6,17,-11
16,5,156,22,24,-2
16,5,157,9,12,-3
16,5,158,13,15,-2
16,5,159,6,33,-27
16,5,160,13,20,-7
16,5,161,9,20,-11
16,5,162,10,12,-2
16,5,163,9,15,-6
16,5,164,11,15,-4
16,5,165,14,16,-2
16,5,166,10,18,-8
16,5,167,3,28,-25
16,5,168,21,44,-23
16,5,169,11,10,1
16,5,170,8,16,-8
16,5,171,10,11,-1
16,5,172,13,31,-18
16,5,173,24,11,13
16,5,174,12,23,-11
16,5,175,7,12,-5
16,5,176,14,22,-8
16,5,177,6,10,-4
16,5,178,9,12,-3
16,5,179,11,25,-14
16,5,180,6,23,-17
16,5,181,7,19,-12
16,5,182,12,27,-15
16,5,183,22,15,7
16,5,184,6,9,-3
16,5,185,18,22,-4
16,5,186,10,21,-11
16,5,187,2,6,-4
16,5,188,7,21,-14
16,5,189,4,17,-13
16,5,190,8,19,-11
16,5,191,21,21,0
16,5,192,7,30,-23
16,5,193,12,23,-11
16,5,194,2,12,-10
16,5,195,11,20,-9
16,5,196,5,12,-7
16,5,197,8,13,-5
16,5,198,2,9,-7
16,5,199,10,17,-7
16,5,200,11,12,-1
16,5,201,18,22,-4
16,5,202,21,20,1
16,5,203,5,7,-2
16,5,204,11,10,1
16,5,205,3,11,-8
16,5,206,7,28,-21
16,5,207,3,11,-8
16,5,208,5,23,-18
16,5,209,16,28,-12
16,5,210,6,28,-22
16,5,211,6,20,-14
16,5,212,14,14,0
16,5,213,13,12,1
16,5,214,12,8,4
16,5,215,17,14,3
16,5,216,4,31,-27
16,5,217,4,10,-6
16,5,218,11,21,-10
16,5,219,15,22,-7
16,5,220,8,19,-11
16,5,221,10,10,0
16,5,222,6,16,-10
16,5,223,23,16,7
16,5,224,10,18,-8
16,5,225,18,13,5
16,5,226,9,28,-19
16,5,227,7,14,-7
16,5,228,5,16,-11
16,5,229,10,23,-13
16,5,230,12,27,-15
16,5,231,23,13,10
16,5,232,13,21,-8
16,5,233,13,26,-13
16,5,234,9,18,-9
16,5,235,16,22,-6
16,5,236,8,15,-7
16,5,237,14,32,-18
16,5,238,3,15,-12
16,5,239,22,33,-11
16,5,240,9,23,-14
16,5,241,7,10,-3
16,5,242,8,25,-17
16,5,243,12,11,1
16,5,244,12,35,-23
16,5,245,7,13,-6
16,5,246,7,27,-20
16,5,247,23,21,2
16,5,248,13,19,-6
16,5,249,8,14,-6
16,5,250,6,12,-6
16,5,251,15,19,-4
16,5,252,6,16,-10
16,5,253,13,13,0
16,5,254,17,25,-8
16,5,255,22,18,4
16,5,256,10,23,-13
16,5,257,6,15,-9
16,5,258,13,26,-13
16,5,259,5,20,-15
16,5,260,14,17,-3
16,5,261,16,27,-11
16,5,262,9,9,0
16,5,263,16,19,-3
16,5,264,13,12,1
16,5,265,3,15,-12
16,5,266,6,23,-17
16,5,267,20,33,-13
16,5,268,11,25,-14
16,5,269,12,16,-4
16,5,270,4,9,-5
16,5,271,14,19,-5
16,5,272,1,13,-12
16,5,273,6,6,0
16,5,274,19,27,-8
16,5,275,11,16,-5
16,5,276,11,21,-10
16,5,277,12,16,-4
16,5,278,1,12,-11
16,5,279,23,23,0
16,5,280,12,7,5
16,5,281,6,15,-9
16,5,282,8,4,4
16,5,283,11,14,-3
16,5,284,17,20,-3
16,5,285,7,19,-12
16,5,286,8,19,-11
16,5,287,7,36,-29
16,5,288,19,22,-3
16,5,289,8,35,-27
16,5,290,6,15,-9
16,5,291,10,18,-8
16,5,292,7,15,-8
16,5,293,16,13,3
16,5,294,12,10,2
16,5,295,13,28,-15
16,5,296,7,18,-11
16,5,297,6,24,-18
16,5,298,13,15,-2
16,5,299,5,12,-7
16,6,0,22,13,9
16,6,1,6,20,-14
16,6,2,23,11,12
16,6,3,15,22,-7
16,6,4,4,10,-6
16,6,5,8,20,-12
16,6,6,10,9,1
16,6,7,10,15,-5
16,6,8,13,19,-6
16,6,9,13,32,-19
16,6,10,5,12,-7
16,6,11,8,24,-16
16,6,12,18,28,-10
16,6,13,7,19,-12
16,6,14,12,16,-4
16,6,15,15,9,6
16,6,16,17,10,7
16,6,17,19,11,8
16,6,18,11,12,-1
16,6,19,6,14,-8
16,6,20,8,19,-11
16,6,21,11,38,-27
16,6,22,16,20,-4
16,6,23,3,8,-5
16,6,24,13,15,-2
16,6,25,3,13,-10
16,6,26,17,16,1
16,6,27,8,17,-9
16,6,28,6,6,0
16,6,29,9,16,-7
16,6,30,10,18,-8
16,6,31,14,13,1
16,6,32,20,9,11
16,6,33,20,22,-2
16,6,34,9,14,-5
16,6,35,11,26,-15
16,6,36,18,20,-2
16,6,37,16,22,-6
16,6,38,13,19,-6
16,6,39,7,17,-10
16,6,40,5,23,-18
16,6,41,10,25,-15
16,6,42,8,18,-10
16,6,43,25,27,-2
16,6,44,14,12,2
16,6,45,6,26,-20
16,6,46,10,16,-6
16,6,47,8,16,-8
16,6,48,3,12,-9
16,6,49,18,31,-13
16,6,50,7,28,-21
16,6,51,14,21,-7
16,6,52,7,28,-21
16,6,53,25,21,4
16,6,54,10,31,-21
16,6,55,16,9,7
16,6,56,15,16,-1
16,6,57,10,31,-21
16,6,58,18,32,-14
16,6,59,13,20,-7
16,6,60,15,20,-5
16,6,61,12,19,-7
16,6,62,23,24,-1
16,6,63,5,25,-20
16,6,64,4,18,-14
16,6,65,10,23,-13
16,6,66,8,14,-6
16,6,67,7,21,-14
16,6,68,13,15,-2
16,6,69,14,15,-1
16,6,70,9,16,-7
16,6,71,20,10,10
16,6,72,8,19,-11
16,6,73,7,9,-2
16,6,74,9,15,-6
16,6,75,12,20,-8
16,6,76,13,24,-11
16,6,77,10,19,-9
16,6,78,14,14,0
16,6,79,10,11,-1
16,6,80,11,15,-4
16,6,81,8,13,-5
16,6,82,14,15,-1
16,6,83,16,34,-18
16,6,84,12,35,-23
16,6,85,8,17,-9
16,6,86,10,16,-6
16,6,87,13,23,-10
16,6,88,10,17,-7
16,6,89,13,11,2
16,6,90,9,21,-12
16,6,91,6,19,-13
16,6,92,22,27,-5
16,6,93,9,19,-10
16,6,94,16,9,7
16,6,95,3,13,-10
16,6,96,14,28,-14
16,6,97,18,24,-6
16,6,98,25,29,-4
16,6,99,15,23,-8
16,6,100,11,12,-1
16,6,101,8,19,-11
16,6,102,11,14,-3
16,6,103,8,25,-17
16,6,104,5,9,-4
16,6,105,20,17,3
16,6,106,8,17,-9
16,6,107,9,26,-17
16,6,108,25,18,7
16,6,109,8,17,-9
16,6,110,8,12,-4
16,6,111,12,13,-1
16,6,112,15,30,-15
16,6,113,19,20,-1
16,6,114,9,20,-11
16,6,115,18,31,-13
16,6,116,13,7,6
16,6,117,6,15,-9
16,6,118,4,15,-11
16,6,119,5,24,-19
16,6,120,5,21,-16
16,6,121,8,26,-18
16,6,122,17,21,-4
16,6,123,19,27,-8
16,6,124,15,11,4
16,6,125,10,17,-7
16,6,126,12,22,-10
16,6,127,10,20,-10
16,6,128,14,22,-8
16,6,129,22,28,-6
16,6,130,4,25,-21
16,6,131,18,28,-10
16,6,132,5,21,-16
16,6,133,15,22,-7
16,6,134,6,23,-17
16,6,135,5,8,-3
16,6,136,15,15,0
16,6,137,16,20,-4
16,6,138,9,12,-3
16,6,139,17,24,-7
16,6,140,11,20,-9
16,6,141,8,10,-2
16,6,142,12,23,-11
16,6,143,9,25,-16
16,6,144,14,26,-12
16,6,145,5,23,-18
16,6,146,5,13,-8
16,6,147,14,20,-6
16,6,148,13,22,-9
16,6,149,24,21,3
16,6,150,17,27,-10
16,6,151,17,12,5
16,6,152,11,33,-22
16,6,153,13,18,-5
16,6,154,11,15,-4
16,6,155,9,10,-1
16,6,156,13,15,-2
16,6,157,13,12,1
16,6,158,4,23,-19
16,6,159,8,17,-9
16,6,160,24,30,-6
16,6,161,11,26,-15
16,6,162,12,28,-16
16,6,163,11,23,-12
16,6,164,5,14,-9
16,6,165,7,25,-18
16,6,166,7,24,-17
16,6,167,18,20,-2
16,6,168,3,12,-9
16,6,169,13,19,-6
16,6,170,11,19,-8
16,6,171,4,31,-27
16,6,172,12,20,-8
16,6,173,13,24,-11
16,6,174,14,12,2
16,6,175,10,34,-24
16,6,176,20,30,-10
16,6,177,14,17,-3
16,6,178,10,17,-7
16,6,179,10,30,-20
16,6,180,13,7,6
16,6,181,18,22,-4
16,6,182,4,14,-10
16,6,183,10,19,-9
16,6,184,20,14,6
16,6,185,12,25,-13
16,6,186,15,28,-13
16,6,187,13,29,-16
16,6,188,4,12,-8
16,6,189,15,26,-11
16,6,190,13,24,-11
16,6,191,10,30,-20
16,6,192,8,7,1
16,6,193,10,14,-4
16,6,194,11,31,-20
16,6,195,17,21,-4
16,6,196,11,11,0
16,6,197,9,23,-14
16,6,198,1,12,-11
16,6,199,13,15,-2
16,6,200,6,34,-28
16,6,201,14,20,-6
16,6,202,7,38,-31
16,6,203,7,25,-18
16,6,204,2,6,-4
16,6,205,7,19,-12
16,6,206,21,19,2
16,6,207,9,10,-1
16,6,208,10,15,-5
16,6,209,12,23,-11
16,6,210,0,16,-16
16,6,211,5,5,0
16,6,212,11,10,1
16,6,213,9,30,-21
16,6,214,7,26,-19
16,6,215,21,13,8
16,6,216,9,17,-8
16,6,217,5,34,-29
16,6,218,7,18,-11
16,6,219,8,20,-12
16,6,220,4,12,-8
16,6,221,14,19,-5
16,6,222,11,29,-18
16,6,223,6,20,-14
16,6,224,19,16,3
16,6,225,14,24,-10
16,6,226,14,26,-12
16,6,227,10,23,-13
16,6,228,10,11,-1
16,6,229,14,18,-4
16,6,230,8,14,-6
16,6,231,10,12,-2
16,6,232,22,32,-10
16,6,233,7,21,-14
16,6,234,19,13,6
16,6,235,14,31,-17
16,6,236,11,18,-7
16,6,237,19,28,-9
16,6,238,12,27,-15
16,6,239,5,13,-8
16,6,240,19,33,-14
16,6,241,12,24,-12
16,6,242,16,17,-1
16,6,243,12,15,-3
16,6,244,11,13,-2
16,6,245,22,16,6
16,6,246,15,23,-8
16,6,247,10,22,-12
16,6,248,22,19,3
16,6,249,17,27,-10
16,6,250,17,30,-13
16,6,251,12,14,-2
16,6,252,10,29,-19
16,6,253,15,11,4
16,6,254,7,31,-24
16,6,255,10,22,-12
16,6,256,7,15,-8
16,6,257,10,14,-4
16,6,258,8,24,-16
16,6,259,1,8,-7
16,6,260,15,28,-13
16,6,261,13,14,-1
16,6,262,14,17,-3
16,6,263,9,18,-9
16,6,264,14,20,-6
16,6,265,13,8,5
16,6,266,9,6,3
16,6,267,7,9,-2
16,6,268,20,24,-4
16,6,269,11,16,-5
16,6,270,16,26,-10
16,6,271,12,10,2
16,6,272,12,21,-9
16,6,273,12,19,-7
16,6,274,12,21,-9
16,6,275,6,11,-5
16,6,276,9,9,0
16,6,277,8,13,-5
16,6,278,4,12,-8
16,6,279,13,14,-1
16,6,280,12,13,-1
16,6,281,13,28,-15
16,6,282,12,19,-7
16,6,283,15,17,-2
16,6,284,8,23,-15
16,6,285,14,31,-17
16,6,286,5,3,2
16,6,287,8,27,-19
16,6,288,13,32,-19
16,6,289,11,27,-16
16,6,290,8,19,-11
16,6,291,20,26,-6
16,6,292,10,8,2
16,6,293,5,28,-23
16,6,294,16,22,-6
16,6,295,18,20,-2
16,6,296,8,17,-9
16,6,297,13,12,1
16,6,298,12,36,-24
16,6,299,15,15,0
16,7,0,17,24,-7
16,7,1,4,23,-19
16,7,2,7,10,-3
16,7,3,12,17,-5
16,7,4,16,13,3
16,7,5,10,21,-11
16,7,6,16,12,4
16,7,7,14,11,3
16,7,8,11,14,-3
16,7,9,13,23,-10
16,7,10,14,39,-25
16,7,11,11,17,-6
16,7,12,14,14,0
16,7,13,21,11,10
16,7,14,17,26,-9
16,7,15,21,21,0
16,7,16,3,22,-19
16,7,17,12,13,-1
16,7,18,18,24,-6
16,7,19,16,17,-1
16,7,20,11,14,-3
16,7,21,13,16,-3
16,7,22,14,21,-7
16,7,23,11,25,-14
16,7,24,19,27,-8
16,7,25,21,32,-11
16,7,26,10,17,-7
16,7,27,12,22,-10
16,7,28,9,28,-19
16,7,29,11,33,-22
16,7,30,11,12,-1
16,7,31,9,15,-6
16,7,32,14,16,-2
16,7,33,6,18,-12
16,7,34,8,12,-4
16,7,35,10,10,0
16,7,36,7,27,-20
16,7,37,18,19,-1
16,7,38,22,27,-5
16,7,39,16,26,-10
16,7,40,9,17,-8
16,7,41,5,7,-2
16,7,42,13,4,9
16,7,43,19,10,9
16,7,44,5,29,-24
16,7,45,10,20,-10
16,7,46,15,33,-18
16,7,47,11,26,-15
16,7,48,14,24,-10
16,7,49,13,21,-8
16,7,50,10,11,-1
16,7,51,9,18,-9
16,7,52,10,13,-3
16,7,53,14,22,-8
16,7,54,3,8,-5
16,7,55,17,16,1
16,7,56,14,22,-8
16,7,57,11,27,-16
16,7,58,11,13,-2
16,7,59,14,24,-10
16,7,60,14,25,-11
16,7,61,14,22,-8
16,7,62,17,14,3
16,7,63,12,14,-2
16,7,64,20,25,-5
16,7,65,12,23,-11
16,7,66,8,16,-8
16,7,67,2,15,-13
16,7,68,15,15,0
16,7,69,27,35,-8
16,7,70,16,7,9
16,7,71,26,20,6
16,7,72,12,13,-1
16,7,73,19,16,3
16,7,74,12,14,-2
16,7,75,3,20,-17
16,7,76,11,19,-8
16,7,77,5,18,-13
16,7,78,14,14,0
16,7,79,9,25,-16
16,7,80,10,13,-3
16,7,81,16,17,-1
16,7,82,18,16,2
16,7,83,13,8,5
16,7,84,11,14,-3
16,7,85,15,23,-8
16,7,86,20,21,-1
16,7,87,6,20,-14
16,7,88,13,15,-2
16,7,89,16,20,-4
16,7,90,19,16,3
16,7,91,7,9,-2
16,7,92,4,9,-5
16,7,93,16,13,3
16,7,94,17,27,-10
16,7,95,14,16,-2
16,7,96,8,13,-5
16,7,97,12,24,-12
16,7,98,9,17,-8
16,7,99,10,22,-12
16,7,100,21,15,6
16,7,101,15,16,-1
16,7,102,18,24,-6
16,7,103,14,17,-3
16,7,104,3,14,-11
16,7,105,16,20,-4
16,7,106,16,20,-4
16,7,107,22,17,5
16,7,108,12,17,-5
16,7,109,13,37,-24
16,7,110,23,20,3
16,7,111,8,27,-19
16,7,112,19,26,-7
16,7,113,10,26,-16
16,7,114,5,16,-11
16,7,115,7,10,-3
16,7,116,11,25,-14
16,7,117,7,11,-4
16,7,118,15,22,-7
16,7,119,11,20,-9
16,7,120,17,22,-5
16,7,121,21,29,-8
16,7,122,5,14,-9
16,7,123,13,28,-15
16,7,124,6,16,-10
16,7,125,14,26,-12
16,7,126,10,16,-6
16,7,127,21,14,7
16,7,128,10,14,-4
16,7,129,11,13,-2
16,7,130,15,17,-2
16,7,131,4,24,-20
16,7,132,8,5,3
16,7,133,12,19,-7
16,7,134,15,6,9
16,7,135,9,17,-8
16,7,136,9,12,-3
16,7,137,6,23,-17
16,7,138,8,12,-4
16,7,139,9,24,-15
16,7,140,12,33,-21
16,7,141,11,17,-6
16,7,142,19,10,9
16,7,143,8,22,-14
16,7,144,15,18,-3
16,7,145,4,16,-12
16,7,146,6,14,-8
16,7,147,7,21,-14
16,7,148,26,29,-3
16,7,149,15,15,0
16,7,150,10,11,-1
16,7,151,14,19,-5
16,7,152,17,15,2
16,7,153,8,14,-6
16,7,154,10,10,0
16,7,155,10,21,-11
16,7,156,3,24,-21
16,7,157,9,23,-14
16,7,158,25,22,3
16,7,159,13,12,1
16,7,160,6,15,-9
16,7,161,8,37,-29
16,7,162,9,11,-2
16,7,163,27,21,6
16,7,164,10,18,-8
16,7,165,16,20,-4
16,7,166,21,21,0
16,7,167,18,18,0
16,7,168,2,7,-5
16,7,169,14,25,-11
16,7,170,10,14,-4
16,7,171,5,23,-18
16,7,172,12,24,-12
16,7,173,12,18,-6
16,7,174,11,25,-14
16,7,175,8,11,-3
16,7,176,18,21,-3
16,7,177,25,18,7
16,7,178,14,21,-7
16,7,179,10,17,-7
16,7,180,9,11,-2
16,7,181,5,8,-3
16,7,182,16,29,-13
16,7,183,11,16,-5
16,7,184,17,23,-6
16,7,185,10,21,-11
16,7,186,3,5,-2
16,7,187,7,17,-10
16,7,188,12,21,-9
16,7,189,11,17,-6
16,7,190,11,6,5
16,7,191,11,18,-7
16,7,192,20,23,-3
16,7,193,9,16,-7
16,7,194,18,15,3
16,7,195,11,26,-15
16,7,196,22,32,-10
16,7,197,10,23,-13
16,7,198,18,17,1
16,7,199,17,21,-4
16,7,200,12,14,-2
16,7,201,16,25,-9
16,7,202,10,19,-9
16,7,203,13,22,-9
16,7,204,18,15,3
16,7,205,18,20,-2
16,7,206,6,11,-5
16,7,207,10,6,4
16,7,208,17,12,5
16,7,209,18,13,5
16,7,210,16,23,-7
16,7,211,13,21,-8
16,7,212,9,19,-10
16,7,213,13,28,-15
16,7,214,8,10,-2
16,7,215,13,18,-5
16,7,216,17,28,-11
16,7,217,9,16,-7
16,7,218,14,19,-5
16,7,219,9,28,-19
16,7,220,13,9,4
16,7,221,3,3,0
16,7,222,9,22,-13
16,7,223,11,19,-8
16,7,224,8,12,-4
16,7,225,5,17,-12
16,7,226,21,35,-14
16,7,227,12,23,-11
16,7,228,11,5,6
16,7,229,13,27,-14
16,7,230,11,26,-15
16,7,231,10,19,-9
16,7,232,6,9,-3
16,7,233,8,12,-4
16,7,234,9,21,-12
16,7,235,9,21,-12
16,7,236,11,14,-3
16,7,237,19,14,5
16,7,238,14,12,2
16,7,239,14,20,-6
16,7,240,16,15,1
16,7,241,8,13,-5
16,7,242,8,14,-6
16,7,243,15,25,-10
16,7,244,6,12,-6
16,7,245,11,15,-4
16,7,246,8,17,-9
16,7,247,14,13,1
16,7,248,5,18,-13
16,7,249,4,19,-15
16,7,250,15,20,-5
16,7,251,16,12,4
16,7,252,15,22,-7
16,7,253,3,3,0
16,7,254,4,25,-21
16,7,255,13,9,4
16,7,256,18,17,1
16,7,257,9,18,-9
16,7,258,13,27,-14
16,7,259,12,26,-14
16,7,260,19,24,-5
16,7,261,16,38,-22
16,7,262,6,16,-10
16,7,263,6,26,-20
16,7,264,8,14,-6
16,7,265,8,34,-26
16,7,266,13,15,-2
16,7,267,7,14,-7
16,7,268,11,13,-2
16,7,269,14,22,-8
16,7,270,10,14,-4
16,7,271,10,18,-8
16,7,272,12,22,-10
16,7,273,19,16,3
16,7,274,16,14,2
16,7,275,10,15,-5
16,7,276,19,11,8
16,7,277,4,9,-5
16,7,278,15,16,-1
16,7,279,6,9,-3
16,7,280,11,14,-3
16,7,281,5,13,-8
16,7,282,10,21,-11
16,7,283,6,22,-16
16,7,284,13,13,0
16,7,285,9,19,-10
16,7,286,2,26,-24
16,7,287,10,29,-19
16,7,288,7,12,-5
16,7,289,11,11,0
16,7,290,9,10,-1
16,7,291,11,15,-4
16,7,292,18,8,10
16,7,293,19,10,9
16,7,294,3,10,-7
16,7,295,6,16,-10
16,7,296,13,23,-10
16,7,297,17,6,11
16,7,298,8,19,-11
16,7,299,3,10,-7
16,8,0,8,16,-8
16,8,1,19,28,-9
16,8,2,23,11,12
16,8,3,8,15,-7
16,8,4,14,15,-1
16,8,5,10,16,-6
16,8,6,6,13,-7
16,8,7,22,22,0
16,8,8,12,22,-10
16,8,9,9,22,-13
16,8,10,8,11,-3
16,8,11,21,29,-8
16,8,12,10,20,-10
16,8,13,8,14,-6
16,8,14,16,15,1
16,8,15,21,29,-8
16,8,16,13,21,-8
16,8,17,8,18,-10
16,8,18,13,22,-9
16,8,19,13,14,-1
16,8,20,11,10,1
16,8,21,10,19,-9
16,8,22,15,18,-3
16,8,23,23,27,-4
16,8,24,14,30,-16
16,8,25,15,12,3
16,8,26,19,18,1
16,8,27,21,11,10
16,8,28,10,13,-3
16,8,29,14,25,-11
16,8,30,13,33,-20
16,8,31,12,33,-21
16,8,32,13,38,-25
16,8,33,7,7,0
16,8,34,18,14,4
16,8,35,11,12,-1
16,8,36,12,35,-23
16,8,37,9,11,-2
16,8,38,15,29,-14
16,8,39,11,20,-9
16,8,40,13,15,-2
16,8,41,2,9,-7
16,8,42,15,18,-3
16,8,43,7,17,-10
16,8,44,18,19,-1
16,8,45,14,15,-1
16,8,46,4,22,-18
16,8,47,5,17,-12
16,8,48,17,21,-4
16,8,49,20,15,5
16,8,50,8,29,-21
16,8,51,16,17,-1
16,8,52,12,31,-19
16,8,53,9,21,-12
16,8,54,15,22,-7
16,8,55,14,19,-5
16,8,56,5,9,-4
16,8,57,12,20,-8
16,8,58,10,19,-9
16,8,59,11,28,-17
16,8,60,8,21,-13
16,8,61,15,31,-16
16,8,62,10,7,3
16,8,63,19,22,-3
16,8,64,17,28,-11
16,8,65,9,14,-5
16,8,66,11,24,-13
16,8,67,15,19,-4
16,8,68,12,8,4
16,8,69,7,13,-6
16,8,70,6,7,-1
16,8,71,18,24,-6
16,8,72,12,21,-9
16,8,73,9,25,-16
16,8,74,9,20,-11
16,8,75,9,13,-4
16,8,76,8,16,-8
16,8,77,22,15,7
16,8,78,7,26,-19
16,8,79,3,13,-10
16,8,80,17,11,6
16,8,81,6,12,-6
16,8,82,11,18,-7
16,8,83,5,12,-7
16,8,84,10,20,-10
16,8,85,11,25,-14
16,8,86,15,14,1
16,8,87,10,38,-28
16,8,88,14,20,-6
16,8,89,17,29,-12
16,8,90,28,21,7
16,8,91,15,24,-9
16,8,92,11,21,-10
16,8,93,21,25,-4
16,8,94,11,19,-8
16,8,95,8,17,-9
16,8,96,10,22,-12
16,8,97,10,15,-5
16,8,98,8,24,-16
16,8,99,15,25,-10
16,8,100,9,25,-16
16,8,101,13,19,-6
16,8,102,16,20,-4
16,8,103,1,16,-15
16,8,104,10,23,-13
16,8,105,9,20,-11
16,8,106,8,15,-7
16,8,107,9,19,-10
16,8,108,8,19,-11
16,8,109,3,16,-13
16,8,110,12,26,-14
16,8,111,13,17,-4
16,8,112,2,23,-21
16,8,113,18,19,-1
16,8,114,13,22,-9
16,8,115,12,16,-4
16,8,116,9,12,-3
16,8,117,10,18,-8
16,8,118,12,21,-9
16,8,119,9,21,-12
16,8,120,25,27,-2
16,8,121,8,22,-14
16,8,122,7,7,0
16,8,123,22,14,8
16,8,124,12,17,-5
16,8,125,12,23,-11
16,8,126,3,31,-28
16,8,127,6,1,5
16,8,128,6,9,-3
16,8,129,19,22,-3
16,8,130,7,7,0
16,8,131,10,10,0
16,8,132,8,28,-20
16,8,133,7,14,-7
16,8,134,10,11,-1
16,8,135,11,7,4
16,8,136,27,18,9
16,8,137,15,5,10
16,8,138,11,28,-17
16,8,139,9,19,-10
16,8,140,4,10,-6
16,8,141,14,21,-7
16,8,142,14,17,-3
16,8,143,9,22,-13
16,8,144,14,17,-3
16,8,145,13,20,-7
16,8,146,17,28,-11
16,8,147,7,6,1
16,8,148,18,25,-7
16,8,149,13,21,-8
16,8,150,8,13,-5
16,8,151,13,32,-19
16,8,152,14,24,-10
16,8,153,14,15,-1
16,8,154,22,23,-1
16,8,155,4,31,-27
16,8,156,18,12,6
16,8,157,15,20,-5
16,8,158,5,5,0
16,8,159,7,9,-2
16,8,160,11,19,-8
16,8,161,8,23,-15
16,8,162,24,22,2
16,8,163,13,10,3
16,8,164,14,19,-5
16,8,165,5,7,-2
16,8,166,17,12,5
16,8,167,13,20,-7
16,8,168,13,13,0
16,8,169,8,20,-12
16,8,170,24,19,5
16,8,171,21,15,6
16,8,172,20,20,0
16,8,173,11,18,-7
16,8,174,9,11,-2
16,8,175,15,15,0
16,8,176,14,15,-1
16,8,177,13,24,-11
16,8,178,15,24,-9
16,8,179,15,22,-7
16,8,180,15,28,-13
16,8,181,10,13,-3
16,8,182,16,24,-8
16,8,183,8,12,-4
16,8,184,11,18,-7
16,8,185,14,15,-1
16,8,186,9,13,-4
16,8,187,15,17,-2
16,8,188,11,14,-3
16,8,189,13,24,-11
16,8,190,13,17,-4
16,8,191,7,24,-17
16,8,192,14,16,-2
16,8,193,17,18,-1
16,8,194,13,20,-7
16,8,195,6,16,-10
16,8,196,18,23,-5
16,8,197,15,4,11
16,8,198,18,39,-21
16,8,199,4,13,-9
16,8,200,7,31,-24
16,8,201,18,10,8
16,8,202,18,15,3
16,8,203,7,27,-20
16,8,204,22,20,2
16,8,205,12,19,-7
16,8,206,9,11,-2
16,8,207,21,13,8
16,8,208,6,19,-13
16,8,209,9,21,-12
16,8,210,18,23,-5
16,8,211,14,22,-8
16,8,212,17,13,4
16,8,213,15,14,1
16,8,214,15,19,-4
16,8,215,15,22,-7
16,8,216,8,10,-2
16,8,217,13,17,-4
16,8,218,8,17,-9
16,8,219,4,18,-14
16,8,220,7,19,-12
16,8,221,7,19,-12
16,8,222,17,19,-2
16,8,223,20,14,6
16,8,224,19,26,-7
16,8,225,23,14,9
16,8,226,9,20,-11
16,8,227,24,24,0
16,8,228,25,11,14
16,8,229,7,18,-11
16,8,230,2,28,-26
16,8,231,13,15,-2
16,8,232,18,21,-3
16,8,233,21,14,7
16,8,234,25,30,-5
16,8,235,13,27,-14
16,8,236,13,27,-14
16,8,237,20,12,8
16,8,238,21,16,5
16,8,239,14,28,-14
16,8,240,18,35,-17
16,8,241,10,19,-9
16,8,242,9,17,-8
16,8,243,12,14,-2
16,8,244,10,15,-5
16,8,245,13,16,-3
16,8,246,15,14,1
16,8,247,14,21,-7
16,8,248,12,27,-15
16,8,249,9,14,-5
16,8,250,7,13,-6
16,8,251,11,7,4
16,8,252,16,12,4
16,8,253,22,29,-7
16,8,254,16,20,-4
16,8,255,6,22,-16
16,8,256,6,23,-17
16,8,257,10,12,-2
16,8,258,16,15,1
16,8,259,14,17,-3
16,8,260,8,13,-5
16,8,261,11,6,5
16,8,262,2,11,-9
16,8,263,10,19,-9
16,8,264,9,7,2
16,8,265,8,7,1
16,8,266,32,27,5
16,8,267,6,18,-12
16,8,268,15,17,-2
16,8,269,16,17,-1
16,8,270,8,30,-22
16,8,271,16,22,-6
16,8,272,24,26,-2
16,8,273,19,21,-2
16,8,274,12,20,-8
16,8,275,12,7,5
16,8,276,9,33,-24
16,8,277,12,18,-6
16,8,278,9,16,-7
16,8,279,11,16,-5
16,8,280,12,15,-3
16,8,281,11,26,-15
16,8,282,9,12,-3
16,8,283,12,25,-13
16,8,284,9,25,-16
16,8,285,9,25,-16
16,8,286,6,17,-11
16,8,287,13,18,-5
16,8,288,5,10,-5
16,8,289,13,22,-9
16,8,290,8,16,-8
16,8,291,13,27,-14
16,8,292,7,18,-11
16,8,293,18,21,-3
16,8,294,10,16,-6
16,8,295,11,16,-5
16,8,296,17,21,-4
16,8,297,4,13,-9
16,8,298,8,20,-12
16,8,299,13,24,-11
16,9,0,32,17,15
16,9,1,12,31,-19
16,9,2,21,8,13
16,9,3,8,11,-3
16,9,4,15,14,1
16,9,5,13,17,-4
16,9,6,9,15,-6
16,9,7,3,7,-4
16,9,8,22,18,4
16,9,9,11,22,-11
16,9,10,16,19,-3
16,9,11,4,15,-11
16,9,12,8,16,-8
16,9,13,7,23,-16
16,9,14,32,41,-9
16,9,15,21,13,8
16,9,16,12,31,-19
16,9,17,14,12,2
16,9,18,6,13,-7
16,9,19,11,21,-10
16,9,20,10,7,3
16,9,21,17,18,-1
16,9,22,8,16,-8
16,9,23,15,19,-4
16,9,24,26,24,2
16,9,25,26,17,9
16,9,26,5,18,-13
16,9,27,25,13,12
16,9,28,19,37,-18
16,9,29,22,43,-21
16,9,30,10,13,-3
16,9,31,10,18,-8
16,9,32,11,14,-3
16,9,33,7,15,-8
16,9,34,13,29,-16
16,9,35,12,21,-9
16,9,36,8,15,-7
16,9,37,21,21,0
16,9,38,16,15,1
16,9,39,20,43,-23
16,9,40,15,19,-4
16,9,41,18,17,1
16,9,42,20,14,6
16,9,43,5,29,-24
16,9,44,10,17,-7
16,9,45,24,25,-1
16,9,46,21,19,2
16,9,47,11,16,-5
16,9,48,12,18,-6
16,9,49,9,21,-12
16,9,50,10,14,-4
16,9,51,18,26,-8
16,9,52,15,22,-7
16,9,53,4,14,-10
16,9,54,16,15,1
16,9,55,4,19,-15
16,9,56,10,12,-2
16,9,57,12,24,-12
16,9,58,10,8,2
16,9,59,11,27,-16
16,9,60,11,15,-4
16,9,61,17,20,-3
16,9,62,8,17,-9
16,9,63,12,9,3
16,9,64,13,17,-4
16,9,65,18,14,4
16,9,66,5,16,-11
16,9,67,10,7,3
16,9,68,3,15,-12
16,9,69,5,18,-13
16,9,70,17,20,-3
16,9,71,16,12,4
16,9,72,19,19,0
16,9,73,10,23,-13
16,9,74,19,22,-3
16,9,75,10,21,-11
16,9,76,12,27,-15
16,9,77,9,27,-18
16,9,78,8,7,1
16,9,79,11,23,-12
16,9,80,23,23,0
16,9,81,15,24,-9
16,9,82,11,20,-9
16,9,83,16,23,-7
16,9,84,15,11,4
16,9,85,16,18,-2
16,9,86,8,19,-11
16,9,87,9,21,-12
16,9,88,13,15,-2
16,9,89,4,16,-12
16,9,90,10,25,-15
16,9,91,21,31,-10
16,9,92,17,37,-20
16,9,93,6,12,-6
16,9,94,8,14,-6
16,9,95,5,31,-26
16,9,96,11,15,-4
16,9,97,20,26,-6
16,9,98,19,9,10
16,9,99,8,15,-7
16,9,100,10,10,0
16,9,101,17,25,-8
16,9,102,7,18,-11
16,9,103,13,26,-13
16,9,104,8,17,-9
16,9,105,5,15,-10
16,9,106,8,35,-27
16,9,107,11,29,-18
16,9,108,12,22,-10
16,9,109,8,30,-22
16,9,110,8,12,-4
16,9,111,11,9,2
16,9,112,20,15,5
16,9,113,16,12,4
16,9,114,10,17,-7
16,9,115,14,12,2
16,9,116,5,14,-9
16,9,117,12,15,-3
16,9,118,9,7,2
16,9,119,10,17,-7
16,9,120,14,22,-8
16,9,121,19,10,9
16,9,122,7,12,-5
16,9,123,8,9,-1
16,9,124,14,22,-8
16,9,125,6,26,-20
16,9,126,17,15,2
16,9,127,21,25,-4
16,9,128,8,14,-6
16,9,129,7,18,-11
16,9,130,10,17,-7
16,9,131,10,21,-11
16,9,132,7,15,-8
16,9,133,10,19,-9
16,9,134,24,19,5
16,9,135,9,11,-2
16,9,136,16,19,-3
16,9,137,25,26,-1
16,9,138,13,24,-11
16,9,139,8,14,-6
16,9,140,13,11,2
16,9,141,10,20,-10
16,9,142,9,13,-4
16,9,143,9,22,-13
16,9,144,8,20,-12
16,9,145,8,13,-5
16,9,146,9,13,-4
16,9,147,7,10,-3
16,9,148,23,16,7
16,9,149,18,20,-2
16,9,150,3,6,-3
16,9,151,7,6,1
16,9,152,14,11,3
16,9,153,10,18,-8
16,9,154,7,14,-7
16,9,155,9,10,-1
16,9,156,21,15,6
16,9,157,9,21,-12
16,9,158,11,10,1
16,9,159,7,22,-15
16,9,160,17,13,4
16,9,161,17,12,5
16,9,162,10,20,-10
16,9,163,24,17,7
16,9,164,8,17,-9
16,9,165,13,14,-1
16,9,166,10,11,-1
16,9,167,2,4,-2
16,9,168,20,18,2
16,9,169,10,22,-12
16,9,170,17,23,-6
16,9,171,3,13,-10
16,9,172,14,18,-4
16,9,173,8,20,-12
16,9,174,16,11,5
16,9,175,11,8,3
16,9,176,11,10,1
16,9,177,5,10,-5
16,9,178,20,22,-2
16,9,179,21,20,1
16,9,180,17,27,-10
16,9,181,10,33,-23
16,9,182,9,10,-1
16,9,183,21,28,-7
16,9,184,14,21,-7
16,9,185,17,25,-8
16,9,186,6,11,-5
16,9,187,18,21,-3
16,9,188,10,18,-8
16,9,189,20,8,12
16,9,190,18,20,-2
16,9,191,4,21,-17
16,9,192,9,23,-14
16,9,193,16,13,3
16,9,194,11,16,-5
16,9,195,8,14,-6
16,9,196,23,20,3
16,9,197,10,35,-25
16,9,198,14,12,2
16,9,199,4,14,-10
16,9,200,17,17,0
16,9,201,12,16,-4
16,9,202,9,17,-8
16,9,203,3,11,-8
16,9,204,15,20,-5
16,9,205,6,14,-8
16,9,206,14,18,-4
16,9,207,18,23,-5
16,9,208,17,22,-5
16,9,209,19,23,-4
16,9,210,11,33,-22
16,9,211,8,27,-19
16,9,212,15,15,0
16,9,213,20,18,2
16,9,214,10,29,-19
16,9,215,21,22,-1
16,9,216,13,24,-11
16,9,217,24,19,5
16,9,218,19,12,7
16,9,219,7,8,-1
16,9,220,12,17,-5
16,9,221,11,24,-13
16,9,222,18,13,5
16,9,223,11,10,1
16,9,224,6,26,-20
16,9,225,14,19,-5
16,9,226,12,12,0
16,9,227,9,18,-9
16,9,228,3,21,-18
16,9,229,19,18,1
16,9,230,22,32,-10
16,9,231,9,5,4
16,9,232,8,11,-3
16,9,233,20,23,-3
16,9,234,12,6,6
16,9,235,21,15,6
16,9,236,2,13,-11
16,9,237,18,27,-9
16,9,238,10,6,4
16,9,239,16,20,-4
16,9,240,17,8,9
16,9,241,18,34,-16
16,9,242,13,28,-15
16,9,243,8,16,-8
16,9,244,26,22,4
16,9,245,7,12,-5
16,9,246,24,17,7
16,9,247,6,12,-6
16,9,248,11,11,0
16,9,249,6,7,-1
16,9,250,16,25,-9
16,9,251,8,28,-20
16,9,252,7,17,-10
16,9,253,17,16,1
16,9,254,7,13,-6
16,9,255,20,18,2
16,9,256,21,18,3
16,9,257,18,20,-2
16,9,258,16,10,6
16,9,259,5,12,-7
16,9,260,3,8,-5
16,9,261,5,8,-3
16,9,262,9,16,-7
16,9,263,8,9,-1
16,9,264,7,10,-3
16,9,265,11,11,0
16,9,266,8,15,-7
16,9,267,12,15,-3
16,9,268,10,26,-16
16,9,269,6,12,-6
16,9,270,5,3,2
16,9,271,10,24,-14
16,9,272,10,14,-4
16,9,273,5,13,-8
16,9,274,14,19,-5
16,9,275,20,23,-3
16,9,276,11,13,-2
16,9,277,17,12,5
16,9,278,22,16,6
16,9,279,12,18,-6
16,9,280,10,27,-17
16,9,281,13,20,-7
16,9,282,9,16,-7
16,9,283,12,27,-15
16,9,284,23,16,7
16,9,285,9,14,-5
16,9,286,16,36,-20
16,9,287,15,11,4
16,9,288,15,37,-22
16,9,289,15,18,-3
16,9,290,26,19,7
16,9,291,11,8,3
16,9,292,13,23,-10
16,9,293,14,10,4
16,9,294,9,14,-5
16,9,295,21,22,-1
16,9,296,10,21,-11
16,9,297,13,18,-5
16,9,298,19,21,-2
16,9,299,11,12,-1
16,10,0,10,10,0
16,10,1,9,15,-6
16,10,2,11,26,-15
16,10,3,16,10,6
16,10,4,9,24,-15
16,10,5,7,29,-22
16,10,6,11,12,-1
16,10,7,10,20,-10
16,10,8,14,25,-11
16,10,9,15,18,-3
16,10,10,7,16,-9
16,10,11,9,18,-9
16,10,12,12,11,1
16,10,13,13,13,0
16,10,14,10,13,-3
16,10,15,15,14,1
16,10,16,15,18,-3
16,10,17,17,25,-8
16,10,18,16,21,-5
16,10,19,15,27,-12
16,10,20,17,27,-10
16,10,21,4,12,-8
16,10,22,15,14,1
16,10,23,21,28,-7
16,10,24,16,31,-15
16,10,25,8,19,-11
16,10,26,7,17,-10
16,10,27,29,22,7
16,10,28,5,24,-19
16,10,29,13,11,2
16,10,30,12,25,-13
16,10,31,10,23,-13
16,10,32,19,30,-11
16,10,33,12,11,1
16,10,34,15,31,-16
16,10,35,15,18,-3
16,10,36,2,6,-4
16,10,37,31,32,-1
16,10,38,10,14,-4
16,10,39,21,32,-11
16,10,40,21,15,6
16,10,41,12,25,-13
16,10,42,20,28,-8
16,10,43,11,15,-4
16,10,44,8,14,-6
16,10,45,12,16,-4
16,10,46,13,5,8
16,10,47,6,12,-6
16,10,48,9,12,-3
16,10,49,15,18,-3
16,10,50,14,28,-14
16,10,51,18,25,-7
16,10,52,11,16,-5
16,10,53,8,22,-14
16,10,54,11,24,-13
16,10,55,23,31,-8
16,10,56,18,13,5
16,10,57,13,29,-16
16,10,58,21,26,-5
16,10,59,10,5,5
16,10,60,11,26,-15
16,10,61,6,16,-10
16,10,62,22,12,10
16,10,63,19,27,-8
16,10,64,11,11,0
16,10,65,6,28,-22
16,10,66,9,11,-2
16,10,67,13,12,1
16,10,68,22,11,11
16,10,69,26,26,0
16,10,70,8,14,-6
16,10,71,6,5,1
16,10,72,12,14,-2
16,10,73,14,14,0
16,10,74,16,27,-11
16,10,75,18,16,2
16,10,76,15,11,4
16,10,77,8,24,-16
16,10,78,27,23,4
16,10,79,2,13,-11
16,10,80,12,12,0
16,10,81,16,15,1
16,10,82,18,32,-14
16,10,83,9,9,0
16,10,84,13,14,-1
16,10,85,8,22,-14
16,10,86,12,16,-4
16,10,87,14,23,-9
16,10,88,8,12,-4
16,10,89,17,22,-5
16,10,90,8,10,-2
16,10,91,14,21,-7
16,10,92,13,12,1
16,10,93,15,25,-10
16,10,94,14,24,-10
16,10,95,22,23,-1
16,10,96,7,17,-10
16,10,97,14,3,11
16,10,98,7,16,-9
16,10,99,20,36,-16
16,10,100,10,8,2
16,10,101,17,22,-5
16,10,102,8,2,6
16,10,103,7,14,-7
16,10,104,11,18,-7
16,10,105,6,15,-9
16,10,106,16,9,7
16,10,107,13,19,-6
16,10,108,14,18,-4
16,10,109,15,19,-4
16,10,110,21,17,4
16,10,111,17,23,-6
16,10,112,6,17,-11
16,10,113,9,21,-12
16,10,114,15,29,-14
16,10,115,14,24,-10
16,10,116,20,12,8
16,10,117,19,16,3
16,10,118,9,23,-14
16,10,119,8,20,-12
16,10,120,10,20,-10
16,10,121,5,12,-7
16,10,122,21,24,-3
16,10,123,10,14,-4
16,10,124,20,16,4
16,10,125,15,20,-5
16,10,126,9,23,-14
16,10,127,32,18,14
16,10,128,7,22,-15
16,10,129,12,29,-17
16,10,130,13,22,-9
16,10,131,6,19,-13
16,10,132,11,22,-11
16,10,133,6,22,-16
16,10,134,11,31,-20
16,10,135,12,16,-4
16,10,136,13,13,0
16,10,137,23,13,10
16,10,138,11,24,-13
16,10,139,5,10,-5
16,10,140,10,12,-2
16,10,141,3,26,-23
16,10,142,17,11,6
16,10,143,5,24,-19
16,10,144,11,12,-1
16,10,145,17,17,0
16,10,146,17,38,-21
16,10,147,20,8,12
16,10,148,9,19,-10
16,10,149,8,8,0
16,10,150,14,25,-11
16,10,151,16,18,-2
16,10,152,7,20,-13
16,10,153,10,23,-13
16,10,154,16,16,0
16,10,155,18,23,-5
16,10,156,12,18,-6
16,10,157,16,16,0
16,10,158,11,17,-6
16,10,159,12,23,-11
16,10,160,19,24,-5
16,10,161,15,13,2
16,10,162,15,24,-9
16,10,163,11,13,-2
16,10,164,5,16,-11
16,10,165,15,15,0
16,10,166,6,3,3
16,10,167,8,5,3
16,10,168,4,14,-10
16,10,169,18,17,1
16,10,170,20,27,-7
16,10,171,16,16,0
16,10,172,18,12,6
16,10,173,12,12,0
16,10,174,9,12,-3
16,10,175,23,22,1
16,10,176,17,14,3
16,10,177,9,8,1
16,10,178,8,15,-7
16,10,179,18,18,0
16,10,180,7,16,-9
16,10,181,10,16,-6
16,10,182,8,24,-16
16,10,183,16,22,-6
16,10,184,5,8,-3
16,10,185,14,13,1
16,10,186,13,11,2
16,10,187,12,13,-1
16,10,188,10,30,-20
16,10,189,8,7,1
16,10,190,12,22,-10
16,10,191,19,18,1
16,10,192,11,9,2
16,10,193,14,16,-2
16,10,194,11,8,3
16,10,195,17,32,-15
16,10,196,18,26,-8
16,10,197,9,14,-5
16,10,198,8,16,-8
16,10,199,14,27,-13
16,10,200,10,18,-8
16,10,201,21,15,6
16,10,202,4,18,-14
16,10,203,32,17,15
16,10,204,20,21,-1
16,10,205,27,21,6
16,10,206,10,19,-9
16,10,207,19,26,-7
16,10,208,21,11,10
16,10,209,9,20,-11
16,10,210,19,19,0
16,10,211,8,18,-10
16,10,212,11,22,-11
16,10,213,14,17,-3
16,10,214,10,18,-8
16,10,215,5,9,-4
16,10,216,18,28,-10
16,10,217,15,9,6
16,10,218,12,23,-11
16,10,219,14,17,-3
16,10,220,7,15,-8
16,10,221,11,13,-2
16,10,222,10,20,-10
16,10,223,21,18,3
16,10,224,28,21,7
16,10,225,2,8,-6
16,10,226,33,18,15
16,10,227,13,18,-5
16,10,228,22,9,13
16,10,229,20,29,-9
16,10,230,10,19,-9
16,10,231,16,17,-1
16,10,232,16,20,-4
16,10,233,5,12,-7
16,10,234,8,19,-11
16,10,235,10,18,-8
16,10,236,10,9,1
16,10,237,8,25,-17
16,10,238,11,12,-1
16,10,239,8,14,-6
16,10,240,21,35,-14
16,10,241,17,14,3
16,10,242,10,11,-1
16,10,243,10,21,-11
16,10,244,10,17,-7
16,10,245,13,11,2
16,10,246,9,21,-12
16,10,247,5,20,-15
16,10,248,10,22,-12
16,10,249,14,11,3
16,10,250,16,12,4
16,10,251,16,19,-3
16,10,252,15,33,-18
16,10,253,4,12,-8
16,10,254,11,12,-1
16,10,255,16,15,1
16,10,256,9,22,-13
16,10,257,3,18,-15
16,10,258,11,12,-1
16,10,259,8,16,-8
16,10,260,6,28,-22
16,10,261,15,18,-3
16,10,262,14,19,-5
16,10,263,18,12,6
16,10,264,16,25,-9
16,10,265,9,19,-10
16,10,266,9,8,1
16,10,267,17,16,1
16,10,268,13,14,-1
16,10,269,10,20,-10
16,10,270,24,23,1
16,10,271,8,18,-10
16,10,272,17,15,2
16,10,273,25,9,16
16,10,274,23,28,-5
16,10,275,17,28,-11
16,10,276,21,22,-1
16,10,277,16,31,-15
16,10,278,19,23,-4
16,10,279,23,29,-6
16,10,280,21,11,10
16,10,281,13,19,-6
16,10,282,18,15,3
16,10,283,16,26,-10
16,10,284,9,13,-4
16,10,285,20,22,-2
16,10,286,13,13,0
16,10,287,10,21,-11
16,10,288,14,37,-23
16,10,289,14,10,4
16,10,290,7,13,-6
16,10,291,8,15,-7
16,10,292,15,14,1
16,10,293,13,17,-4
16,10,294,11,12,-1
16,10,295,13,15,-2
16,10,296,7,15,-8
16,10,297,14,28,-14
16,10,298,10,20,-10
16,10,299,24,25,-1
16,11,0,16,10,6
16,11,1,16,15,1
16,11,2,11,14,-3
16,11,3,20,23,-3
16,11,4,6,14,-8
16,11,5,7,8,-1
16,11,6,10,15,-5
16,11,7,8,15,-7
16,11,8,4,16,-12
16,11,9,19,12,7
16,11,10,28,28,0
16,11,11,8,15,-7
16,11,12,13,12,1
16,11,13,14,16,-2
16,11,14,12,10,2
16,11,15,17,24,-7
16,11,16,10,14,-4
16,11,17,8,9,-1
16,11,18,11,9,2
16,11,19,14,11,3
16,11,20,15,11,4
16,11,21,14,8,6
16,11,22,15,17,-2
16,11,23,17,13,4
16,11,24,11,27,-16
16,11,25,10,5,5
16,11,26,7,16,-9
16,11,27,7,28,-21
16,11,28,16,25,-9
16,11,29,17,30,-13
16,11,30,10,18,-8
16,11,31,21,29,-8
16,11,32,9,7,2
16,11,33,25,29,-4
16,11,34,17,16,1
16,11,35,31,12,19
16,11,36,29,22,7
16,11,37,9,17,-8
16,11,38,15,31,-16
16,11,39,12,22,-10
16,11,40,7,13,-6
16,11,41,19,17,2
16,11,42,10,14,-4
16,11,43,2,18,-16
16,11,44,10,26,-16
16,11,45,17,18,-1
16,11,46,8,20,-12
16,11,47,13,18,-5
16,11,48,15,19,-4
16,11,49,10,9,1
16,11,50,19,13,6
16,11,51,14,23,-9
16,11,52,18,15,3
16,11,53,16,28,-12
16,11,54,13,18,-5
16,11,55,15,12,3
16,11,56,19,22,-3
16,11,57,12,8,4
16,11,58,19,4,15
16,11,59,17,18,-1
16,11,60,12,13,-1
16,11,61,15,27,-12
16,11,62,21,22,-1
16,11,63,14,21,-7
16,11,64,7,8,-1
16,11,65,4,17,-13
16,11,66,14,10,4
16,11,67,16,29,-13
16,11,68,23,24,-1
16,11,69,25,23,2
16,11,70,3,20,-17
16,11,71,25,19,6
16,11,72,15,27,-12
16,11,73,9,17,-8
16,11,74,8,28,-20
16,11,75,16,14,2
16,11,76,11,20,-9
16,11,77,7,19,-12
16,11,78,13,22,-9
16,11,79,22,24,-2
16,11,80,15,15,0
16,11,81,11,9,2
16,11,82,12,16,-4
16,11,83,4,22,-18
16,11,84,9,31,-22
16,11,85,17,24,-7
16,11,86,6,11,-5
16,11,87,27,27,0
16,11,88,10,14,-4
16,11,89,10,20,-10
16,11,90,17,22,-5
16,11,91,8,7,1
16,11,92,14,15,-1
16,11,93,11,12,-1
16,11,94,11,13,-2
16,11,95,16,15,1
16,11,96,15,15,0
16,11,97,11,11,0
16,11,98,19,11,8
16,11,99,9,8,1
16,11,100,10,14,-4
16,11,101,25,21,4
16,11,102,14,31,-17
16,11,103,26,19,7
16,11,104,8,6,2
16,11,105,11,26,-15
16,11,106,16,19,-3
16,11,107,16,18,-2
16,11,108,17,28,-11
16,11,109,20,21,-1
16,11,110,15,22,-7
16,11,111,17,23,-6
16,11,112,10,25,-15
16,11,113,6,12,-6
16,11,114,7,15,-8
16,11,115,22,20,2
16,11,116,7,11,-4
16,11,117,14,25,-11
16,11,118,10,20,-10
16,11,119,18,25,-7
16,11,120,16,17,-1
16,11,121,7,10,-3
16,11,122,11,24,-13
16,11,123,17,20,-3
16,11,124,9,12,-3
16,11,125,7,24,-17
16,11,126,10,11,-1
16,11,127,19,13,6
16,11,128,18,16,2
16,11,129,8,18,-10
16,11,130,7,17,-10
16,11,131,15,21,-6
16,11,132,22,24,-2
16,11,133,7,20,-13
16,11,134,9,10,-1
16,11,135,18,16,2
16,11,136,15,15,0
16,11,137,22,16,6
16,11,138,14,10,4
16,11,139,25,25,0
16,11,140,11,25,-14
16,11,141,20,22,-2
16,11,142,14,19,-5
16,11,143,14,17,-3
16,11,144,19,19,0
16,11,145,11,10,1
16,11,146,16,18,-2
16,11,147,15,13,2
16,11,148,7,14,-7
16,11,149,9,4,5
16,11,150,10,14,-4
16,11,151,15,17,-2
16,11,152,20,19,1
16,11,153,10,21,-11
16,11,154,18,20,-2
16,11,155,11,10,1
16,11,156,12,17,-5
16,11,157,13,11,2
16,11,158,9,17,-8
16,11,159,20,13,7
16,11,160,13,21,-8
16,11,161,8,8,0
16,11,162,12,7,5
16,11,163,7,13,-6
16,11,164,13,15,-2
16,11,165,5,24,-19
16,11,166,17,9,8
16,11,167,19,19,0
16,11,168,12,18,-6
16,11,169,15,25,-10
16,11,170,18,12,6
16,11,171,14,16,-2
16,11,172,27,33,-6
16,11,173,14,21,-7
16,11,174,8,8,0
16,11,175,4,19,-15
16,11,176,15,16,-1
16,11,177,10,16,-6
16,11,178,2,10,-8
16,11,179,7,12,-5
16,11,180,17,20,-3
16,11,181,25,20,5
16,11,182,20,25,-5
16,11,183,8,13,-5
16,11,184,11,8,3
16,11,185,19,35,-16
16,11,186,14,25,-11
16,11,187,10,15,-5
16,11,188,15,14,1
16,11,189,12,20,-8
16,11,190,8,24,-16
16,11,191,8,17,-9
16,11,192,12,30,-18
16,11,193,16,16,0
16,11,194,17,25,-8
16,11,195,12,24,-12
16,11,196,7,20,-13
16,11,197,12,6,6
16,11,198,12,21,-9
16,11,199,26,19,7
16,11,200,9,21,-12
16,11,201,10,11,-1
16,11,202,24,20,4
16,11,203,13,9,4
16,11,204,24,11,13
16,11,205,23,39,-16
16,11,206,14,19,-5
16,11,207,15,20,-5
16,11,208,14,24,-10
16,11,209,17,12,5
16,11,210,19,19,0
16,11,211,13,14,-1
16,11,212,17,22,-5
16,11,213,21,15,6
16,11,214,15,26,-11
16,11,215,8,12,-4
16,11,216,9,16,-7
16,11,217,11,21,-10
16,11,218,20,31,-11
16,11,219,13,19,-6
16,11,220,32,28,4
16,11,221,24,13,11
16,11,222,12,18,-6
16,11,223,21,22,-1
16,11,224,16,21,-5
16,11,225,15,12,3
16,11,226,16,21,-5
16,11,227,9,11,-2
16,11,228,13,15,-2
16,11,229,5,19,-14
16,11,230,16,19,-3
16,11,231,8,15,-7
16,11,232,6,23,-17
16,11,233,7,31,-24
16,11,234,15,10,5
16,11,235,12,23,-11
16,11,236,12,23,-11
16,11,237,10,18,-8
16,11,238,10,15,-5
16,11,239,14,11,3
16,11,240,15,6,9
16,11,241,14,5,9
16,11,242,5,24,-19
16,11,243,10,17,-7
16,11,244,17,16,1
16,11,245,13,16,-3
16,11,246,22,29,-7
16,11,247,13,23,-10
16,11,248,8,25,-17
16,11,249,21,27,-6
16,11,250,16,15,1
16,11,251,14,16,-2
16,11,252,6,6,0
16,11,253,5,21,-16
16,11,254,16,17,-1
16,11,255,7,9,-2
16,11,256,17,11,6
16,11,257,12,16,-4
16,11,258,10,27,-17
16,11,259,19,20,-1
16,11,260,6,6,0
16,11,261,18,26,-8
16,11,262,10,21,-11
16,11,263,4,6,-2
16,11,264,24,22,2
16,11,265,8,9,-1
16,11,266,20,21,-1
16,11,267,6,6,0
16,11,268,13,21,-8
16,11,269,7,15,-8
16,11,270,10,13,-3
16,11,271,14,22,-8
16,11,272,7,10,-3
16,11,273,16,9,7
16,11,274,19,26,-7
16,11,275,10,11,-1
16,11,276,12,24,-12
16,11,277,14,25,-11
16,11,278,11,16,-5
16,11,279,16,30,-14
16,11,280,14,14,0
16,11,281,13,17,-4
16,11,282,10,6,4
16,11,283,3,9,-6
16,11,284,22,26,-4
16,11,285,10,20,-10
16,11,286,10,25,-15
16,11,287,12,22,-10
16,11,288,16,23,-7
16,11,289,21,23,-2
16,11,290,18,24,-6
16,11,291,7,28,-21
16,11,292,18,11,7
16,11,293,28,14,14
16,11,294,18,29,-11
16,11,295,12,14,-2
16,11,296,15,12,3
16,11,297,12,20,-8
16,11,298,17,13,4
16,11,299,9,16,-7
16,12,0,11,12,-1
16,12,1,12,6,6
16,12,2,14,11,3
16,12,3,14,11,3
16,12,4,11,18,-7
16,12,5,14,10,4
16,12,6,15,25,-10
16,12,7,17,16,1
16,12,8,12,29,-17
16,12,9,14,18,-4
16,12,10,7,16,-9
16,12,11,10,26,-16
16,12,12,22,22,0
16,12,13,13,17,-4
16,12,14,14,13,1
16,12,15,19,20,-1
16,12,16,5,13,-8
16,12,17,7,18,-11
16,12,18,20,30,-10
16,12,19,25,21,4
16,12,20,16,23,-7
16,12,21,14,10,4
16,12,22,11,15,-4
16,12,23,11,13,-2
16,12,24,6,8,-2
16,12,25,8,17,-9
16,12,26,15,31,-16
16,12,27,12,16,-4
16,12,28,9,18,-9
16,12,29,5,19,-14
16,12,30,10,24,-14
16,12,31,10,18,-8
16,12,32,21,24,-3
16,12,33,18,9,9
16,12,34,13,25,-12
16,12,35,17,16,1
16,12,36,25,15,10
16,12,37,25,21,4
16,12,38,5,8,-3
16,12,39,24,7,17
16,12,40,9,23,-14
16,12,41,12,11,1
16,12,42,16,22,-6
16,12,43,13,27,-14
16,12,44,14,9,5
16,12,45,16,17,-1
16,12,46,15,25,-10
16,12,47,15,15,0
16,12,48,21,12,9
16,12,49,12,30,-18
16,12,50,11,19,-8
16,12,51,4,6,-2
16,12,52,20,25,-5
16,12,53,19,16,3
16,12,54,21,21,0
16,12,55,10,16,-6
16,12,56,17,22,-5
16,12,57,10,23,-13
16,12,58,8,13,-5
16,12,59,12,12,0
16,12,60,7,22,-15
16,12,61,13,16,-3
16,12,62,15,30,-15
16,12,63,10,15,-5
16,12,64,10,21,-11
16,12,65,6,6,0
16,12,66,19,12,7
16,12,67,22,26,-4
16,12,68,9,17,-8
16,12,69,13,20,-7
16,12,70,21,12,9
16,12,71,14,24,-10
16,12,72,11,29,-18
16,12,73,13,13,0
16,12,74,17,18,-1
16,12,75,11,16,-5
16,12,76,17,30,-13
16,12,77,17,26,-9
16,12,78,13,12,1
16,12,79,5,4,1
16,12,80,18,16,2
16,12,81,18,9,9
16,12,82,5,10,-5
16,12,83,9,5,4
16,12,84,8,10,-2
16,12,85,9,8,1
16,12,86,16,18,-2
16,12,87,8,8,0
16,12,88,14,20,-6
16,12,89,22,24,-2
16,12,90,12,5,7
16,12,91,7,6,1
16,12,92,8,19,-11
16,12,93,16,23,-7
16,12,94,11,10,1
16,12,95,12,7,5
16,12,96,13,11,2
16,12,97,16,25,-9
16,12,98,12,14,-2
16,12,99,17,30,-13
16,12,100,5,18,-13
16,12,101,12,13,-1
16,12,102,13,13,0
16,12,103,15,19,-4
16,12,104,10,13,-3
16,12,105,17,11,6
16,12,106,10,21,-11
16,12,107,9,8,1
16,12,108,8,17,-9
16,12,109,15,13,2
16,12,110,9,10,-1
16,12,111,2,10,-8
16,12,112,20,21,-1
16,12,113,7,15,-8
16,12,114,10,10,0
16,12,115,12,9,3
16,12,116,13,16,-3
16,12,117,11,20,-9
16,12,118,22,24,-2
16,12,119,12,28,-16
16,12,120,17,14,3
16,12,121,23,27,-4
16,12,122,11,11,0
16,12,123,17,22,-5
16,12,124,11,11,0
16,12,125,20,9,11
16,12,126,16,22,-6
16,12,127,12,19,-7
16,12,128,29,18,11
16,12,129,10,12,-2
16,12,130,8,21,-13
16,12,131,8,10,-2
16,12,132,15,24,-9
16,12,133,12,23,-11
16,12,134,20,24,-4
16,12,135,15,26,-11
16,12,136,13,25,-12
16,12,137,12,21,-9
16,12,138,15,15,0
16,12,139,12,32,-20
16,12,140,20,21,-1
16,12,141,17,9,8
16,12,142,14,17,-3
16,12,143,15,26,-11
16,12,144,17,10,7
16,12,145,15,15,0
16,12,146,17,24,-7
16,12,147,9,7,2
16,12,148,7,34,-27
16,12,149,14,21,-7
16,12,150,12,13,-1
16,12,151,11,29,-18
16,12,152,15,30,-15
16,12,153,6,17,-11
16,12,154,15,17,-2
16,12,155,12,19,-7
16,12,156,8,20,-12
16,12,157,21,9,12
16,12,158,9,20,-11
16,12,159,11,15,-4
16,12,160,17,16,1
16,12,161,14,14,0
16,12,162,10,14,-4
16,12,163,14,31,-17
16,12,164,12,19,-7
16,12,165,10,23,-13
16,12,166,6,13,-7
16,12,167,21,20,1
16,12,168,14,22,-8
16,12,169,19,12,7
16,12,170,11,18,-7
16,12,171,15,11,4
16,12,172,17,16,1
16,12,173,10,23,-13
16,12,174,8,14,-6
16,12,175,13,14,-1
16,12,176,7,10,-3
16,12,177,19,16,3
16,12,178,24,5,19
16,12,179,18,20,-2
16,12,180,21,29,-8
16,12,181,16,18,-2
16,12,182,18,15,3
16,12,183,36,19,17
16,12,184,17,12,5
16,12,185,18,19,-1
16,12,186,10,19,-9
16,12,187,9,29,-20
16,12,188,17,33,-16
16,12,189,10,12,-2
16,12,190,27,14,13
16,12,191,18,21,-3
16,12,192,14,30,-16
16,12,193,14,12,2
16,12,194,3,9,-6
16,12,195,15,26,-11
16,12,196,8,12,-4
16,12,197,6,18,-12
16,12,198,11,23,-12
16,12,199,13,4,9
16,12,200,10,7,3
16,12,201,17,30,-13
16,12,202,23,25,-2
16,12,203,14,22,-8
16,12,204,11,16,-5
16,12,205,33,19,14
16,12,206,14,21,-7
16,12,207,8,5,3
16,12,208,13,18,-5
16,12,209,0,7,-7
16,12,210,14,13,1
16,12,211,9,20,-11
16,12,212,14,17,-3
16,12,213,10,15,-5
16,12,214,2,13,-11
16,12,215,18,23,-5
16,12,216,24,22,2
16,12,217,5,5,0
16,12,218,20,22,-2
16,12,219,16,10,6
16,12,220,20,37,-17
16,12,221,19,9,10
16,12,222,12,23,-11
16,12,223,12,12,0
16,12,224,8,20,-12
16,12,225,11,15,-4
16,12,226,17,20,-3
16,12,227,15,25,-10
16,12,228,12,9,3
16,12,229,13,27,-14
16,12,230,9,20,-11
16,12,231,8,15,-7
16,12,232,10,21,-11
16,12,233,16,24,-8
16,12,234,19,20,-1
16,12,235,15,18,-3
16,12,236,3,13,-10
16,12,237,18,26,-8
16,12,238,22,22,0
16,12,239,10,4,6
16,12,240,15,15,0
16,12,241,22,25,-3
16,12,242,12,10,2
16,12,243,8,21,-13
16,12,244,13,15,-2
16,12,245,23,10,13
16,12,246,11,20,-9
16,12,247,13,17,-4
16,12,248,11,14,-3
16,12,249,19,27,-8
16,12,250,23,17,6
16,12,251,19,18,1
16,12,252,19,17,2
16,12,253,16,12,4
16,12,254,14,16,-2
16,12,255,12,9,3
16,12,256,5,18,-13
16,12,257,20,20,0
16,12,258,24,14,10
16,12,259,17,20,-3
16,12,260,19,26,-7
16,12,261,14,14,0
16,12,262,7,17,-10
16,12,263,16,23,-7
16,12,264,13,23,-10
16,12,265,22,15,7
16,12,266,16,18,-2
16,12,267,10,26,-16
16,12,268,19,15,4
16,12,269,14,20,-6
16,12,270,11,11,0
16,12,271,10,16,-6
16,12,272,10,6,4
16,12,273,4,11,-7
16,12,274,25,8,17
16,12,275,29,27,2
16,12,276,11,22,-11
16,12,277,15,18,-3
16,12,278,11,10,1
16,12,279,11,15,-4
16,12,280,13,18,-5
16,12,281,12,8,4
16,12,282,15,18,-3
16,12,283,18,23,-5
16,12,284,15,22,-7
16,12,285,7,26,-19
16,12,286,16,22,-6
16,12,287,5,18,-13
16,12,288,7,9,-2
16,12,289,16,19,-3
16,12,290,18,24,-6
16,12,291,7,11,-4
16,12,292,14,8,6
16,12,293,14,23,-9
16,12,294,10,5,5
16,12,295,12,14,-2
16,12,296,14,28,-14
16,12,297,9,7,2
16,12,298,8,16,-8
16,12,299,14,11,3
16,13,0,17,19,-2
16,13,1,6,14,-8
16,13,2,15,17,-2
16,13,3,20,22,-2
16,13,4,25,14,11
16,13,5,13,20,-7
16,13,6,5,15,-10
16,13,7,11,9,2
16,13,8,25,19,6
16,13,9,27,13,14
16,13,10,13,9,4
16,13,11,15,13,2
16,13,12,8,19,-11
16,13,13,25,30,-5
16,13,14,15,12,3
16,13,15,11,27,-16
16,13,16,12,8,4
16,13,17,12,5,7
16,13,18,21,15,6
16,13,19,12,18,-6
16,13,20,22,18,4
16,13,21,5,9,-4
16,13,22,10,25,-15
16,13,23,16,20,-4
16,13,24,20,15,5
16,13,25,6,12,-6
16,13,26,11,19,-8
16,13,27,2,18,-16
16,13,28,8,16,-8
16,13,29,18,16,2
16,13,30,14,32,-18
16,13,31,6,17,-11
16,13,32,23,20,3
16,13,33,17,16,1
16,13,34,9,18,-9
16,13,35,19,14,5
16,13,36,11,14,-3
16,13,37,9,19,-10
16,13,38,21,20,1
16,13,39,14,27,-13
16,13,40,10,22,-12
16,13,41,13,20,-7
16,13,42,19,17,2
16,13,43,25,11,14
16,13,44,12,14,-2
16,13,45,3,6,-3
16,13,46,14,7,7
16,13,47,27,29,-2
16,13,48,21,24,-3
16,13,49,12,20,-8
16,13,50,16,29,-13
16,13,51,13,24,-11
16,13,52,17,19,-2
16,13,53,23,16,7
16,13,54,12,11,1
16,13,55,15,18,-3
16,13,56,16,15,1
16,13,57,11,23,-12
16,13,58,18,17,1
16,13,59,21,26,-5
16,13,60,17,23,-6
16,13,61,15,9,6
16,13,62,11,9,2
16,13,63,9,10,-1
16,13,64,15,13,2
16,13,65,11,15,-4
16,13,66,16,19,-3
16,13,67,6,8,-2
16,13,68,9,16,-7
16,13,69,6,8,-2
16,13,70,16,21,-5
16,13,71,16,15,1
16,13,72,10,22,-12
16,13,73,8,18,-10
16,13,74,13,13,0
16,13,75,6,24,-18
16,13,76,6,14,-8
16,13,77,12,27,-15
16,13,78,15,17,-2
16,13,79,8,19,-11
16,13,80,11,11,0
16,13,81,13,14,-1
16,13,82,14,17,-3
16,13,83,9,11,-2
16,13,84,16,11,5
16,13,85,27,17,10
16,13,86,24,9,15
16,13,87,8,17,-9
16,13,88,11,27,-16
16,13,89,14,11,3
16,13,90,22,5,17
16,13,91,16,13,3
16,13,92,37,25,12
16,13,93,5,32,-27
16,13,94,13,13,0
16,13,95,21,26,-5
16,13,96,12,24,-12
16,13,97,18,14,4
16,13,98,21,16,5
16,13,99,11,16,-5
16,13,100,13,26,-13
16,13,101,8,23,-15
16,13,102,11,10,1
16,13,103,19,22,-3
16,13,104,13,23,-10
16,13,105,18,16,2
16,13,106,20,18,2
16,13,107,12,29,-17
16,13,108,20,22,-2
16,13,109,31,26,5
16,13,110,4,4,0
16,13,111,13,22,-9
16,13,112,21,19,2
16,13,113,9,9,0
16,13,114,12,18,-6
16,13,115,29,20,9
16,13,116,14,17,-3
16,13,117,7,21,-14
16,13,118,10,14,-4
16,13,119,9,7,2
16,13,120,10,11,-1
16,13,121,14,7,7
16,13,122,20,15,5
16,13,123,16,14,2
16,13,124,22,20,2
16,13,125,9,15,-6
16,13,126,8,22,-14
16,13,127,11,13,-2
16,13,128,8,34,-26
16,13,129,18,25,-7
16,13,130,7,18,-11
16,13,131,8,8,0
16,13,132,3,9,-6
16,13,133,19,8,11
16,13,134,10,22,-12
16,13,135,18,12,6
16,13,136,15,21,-6
16,13,137,16,12,4
16,13,138,6,8,-2
16,13,139,19,26,-7
16,13,140,19,16,3
16,13,141,15,19,-4
16,13,142,19,12,7
16,13,143,4,14,-10
16,13,144,9,10,-1
16,13,145,4,7,-3
16,13,146,18,22,-4
16,13,147,16,26,-10
16,13,148,11,12,-1
16,13,149,17,13,4
16,13,150,14,33,-19
16,13,151,9,17,-8
16,13,152,19,17,2
16,13,153,18,24,-6
16,13,154,10,13,-3
16,13,155,11,9,2
16,13,156,9,11,-2
16,13,157,21,26,-5
16,13,158,12,13,-1
16,13,159,18,21,-3
16,13,160,17,20,-3
16,13,161,6,18,-12
16,13,162,11,7,4
16,13,163,6,13,-7
16,13,164,3,13,-10
16,13,165,10,33,-23
16,13,166,10,16,-6
16,13,167,14,8,6
16,13,168,13,22,-9
16,13,169,9,8,1
16,13,170,15,17,-2
16,13,171,25,24,1
16,13,172,21,36,-15
16,13,173,26,20,6
16,13,174,18,23,-5
16,13,175,14,30,-16
16,13,176,20,19,1
16,13,177,16,16,0
16,13,178,11,13,-2
16,13,179,12,15,-3
16,13,180,18,16,2
16,13,181,10,19,-9
16,13,182,21,21,0
16,13,183,6,18,-12
16,13,184,7,7,0
16,13,185,19,24,-5
16,13,186,16,15,1
16,13,187,10,11,-1
16,13,188,13,18,-5
16,13,189,21,16,5
16,13,190,8,23,-15
16,13,191,26,28,-2
16,13,192,11,8,3
16,13,193,16,16,0
16,13,194,6,7,-1
16,13,195,17,26,-9
16,13,196,23,18,5
16,13,197,9,18,-9
16,13,198,20,18,2
16,13,199,12,30,-18
16,13,200,9,16,-7
16,13,201,9,11,-2
16,13,202,13,21,-8
16,13,203,24,23,1
16,13,204,6,24,-18
16,13,205,17,7,10
16,13,206,10,14,-4
16,13,207,16,26,-10
16,13,208,18,8,10
16,13,209,9,4,5
16,13,210,17,24,-7
16,13,211,13,15,-2
16,13,212,15,19,-4
16,13,213,8,8,0
16,13,214,18,14,4
16,13,215,4,21,-17
16,13,216,23,10,13
16,13,217,9,7,2
16,13,218,15,24,-9
16,13,219,16,14,2
16,13,220,19,20,-1
16,13,221,16,36,-20
16,13,222,9,21,-12
16,13,223,16,26,-10
16,13,224,12,9,3
16,13,225,17,26,-9
16,13,226,7,13,-6
16,13,227,21,27,-6
16,13,228,14,28,-14
16,13,229,13,10,3
16,13,230,12,12,0
16,13,231,18,17,1
16,13,232,8,6,2
16,13,233,14,13,1
16,13,234,11,7,4
16,13,235,12,15,-3
16,13,236,4,7,-3
16,13,237,14,18,-4
16,13,238,11,24,-13
16,13,239,11,10,1
16,13,240,25,15,10
16,13,241,22,16,6
16,13,242,6,10,-4
16,13,243,22,27,-5
16,13,244,14,13,1
16,13,245,10,23,-13
16,13,246,10,4,6
16,13,247,11,16,-5
16,13,248,6,22,-16
16,13,249,14,9,5
16,13,250,18,11,7
16,13,251,23,24,-1
16,13,252,14,17,-3
16,13,253,12,12,0
16,13,254,10,23,-13
16,13,255,25,9,16
16,13,256,16,12,4
16,13,257,11,23,-12
16,13,258,16,24,-8
16,13,259,18,19,-1
16,13,260,14,15,-1
16,13,261,13,13,0
16,13,262,18,38,-20
16,13,263,15,18,-3
16,13,264,11,17,-6
16,13,265,10,30,-20
16,13,266,13,16,-3
16,13,267,6,10,-4
16,13,268,28,17,11
16,13,269,15,16,-1
16,13,270,9,10,-1
16,13,271,25,13,12
16,13,272,16,16,0
16,13,273,12,7,5
16,13,274,9,23,-14
16,13,275,7,21,-14
16,13,276,12,6,6
16,13,277,5,12,-7
16,13,278,9,12,-3
16,13,279,17,6,11
16,13,280,9,16,-7
16,13,281,9,15,-6
16,13,282,17,18,-1
16,13,283,6,13,-7
16,13,284,15,22,-7
16,13,285,15,14,1
16,13,286,6,12,-6
16,13,287,15,25,-10
16,13,288,23,16,7
16,13,289,9,24,-15
16,13,290,15,19,-4
16,13,291,9,17,-8
16,13,292,7,20,-13
16,13,293,7,10,-3
16,13,294,14,13,1
16,13,295,15,49,-34
16,13,296,24,27,-3
16,13,297,22,26,-4
16,13,298,18,19,-1
16,13,299,9,14,-5
16,14,0,9,16,-7
16,14,1,7,6,1
16,14,2,10,10,0
16,14,3,23,31,-8
16,14,4,16,25,-9
16,14,5,29,19,10
16,14,6,11,4,7
16,14,7,13,15,-2
16,14,8,27,21,6
16,14,9,7,13,-6
16,14,10,25,32,-7
16,14,11,11,23,-12
16,14,12,11,19,-8
16,14,13,10,9,1
16,14,14,10,5,5
16,14,15,20,25,-5
16,14,16,21,13,8
16,14,17,26,20,6
16,14,18,27,16,11
16,14,19,18,18,0
16,14,20,8,14,-6
16,14,21,19,23,-4
16,14,22,19,23,-4
16,14,23,12,22,-10
16,14,24,21,14,7
16,14,25,21,27,-6
16,14,26,13,17,-4
16,14,27,17,21,-4
16,14,28,12,14,-2
16,14,29,9,23,-14
16,14,30,24,16,8
16,14,31,8,6,2
16,14,32,15,15,0
16,14,33,7,11,-4
16,14,34,13,16,-3
16,14,35,23,12,11
16,14,36,16,20,-4
16,14,37,5,11,-6
16,14,38,23,25,-2
16,14,39,10,3,7
16,14,40,9,30,-21
16,14,41,21,23,-2
16,14,42,16,16,0
16,14,43,9,11,-2
16,14,44,17,17,0
16,14,45,25,25,0
16,14,46,16,16,0
16,14,47,24,18,6
16,14,48,15,13,2
16,14,49,30,19,11
16,14,50,9,22,-13
16,14,51,15,15,0
16,14,52,15,14,1
16,14,53,11,17,-6
16,14,54,13,12,1
16,14,55,7,16,-9
16,14,56,4,9,-5
16,14,57,5,12,-7
16,14,58,10,20,-10
16,14,59,12,13,-1
16,14,60,12,15,-3
16,14,61,22,12,10
16,14,62,16,24,-8
16,14,63,15,11,4
16,14,64,10,9,1
16,14,65,13,6,7
16,14,66,14,11,3
16,14,67,15,14,1
16,14,68,9,15,-6
16,14,69,10,13,-3
16,14,70,25,16,9
16,14,71,3,20,-17
16,14,72,21,10,11
16,14,73,9,27,-18
16,14,74,11,16,-5
16,14,75,7,12,-5
16,14,76,17,10,7
16,14,77,11,15,-4
16,14,78,17,28,-11
16,14,79,19,14,5
16,14,80,11,9,2
16,14,81,13,18,-5
16,14,82,20,16,4
16,14,83,11,13,-2
16,14,84,17,11,6
16,14,85,10,18,-8
16,14,86,7,23,-16
16,14,87,11,21,-10
16,14,88,21,19,2
16,14,89,6,12,-6
16,14,90,18,31,-13
16,14,91,15,7,8
16,14,92,11,11,0
16,14,93,27,22,5
16,14,94,8,26,-18
16,14,95,5,13,-8
16,14,96,7,7,0
16,14,97,14,15,-1
16,14,98,11,13,-2
16,14,99,14,25,-11
16,14,100,10,16,-6
16,14,101,15,26,-11
16,14,102,10,17,-7
16,14,103,26,22,4
16,14,104,9,9,0
16,14,105,22,8,14
16,14,106,9,16,-7
16,14,107,11,26,-15
16,14,108,17,23,-6
16,14,109,15,19,-4
16,14,110,22,12,10
16,14,111,21,34,-13
16,14,112,11,17,-6
16,14,113,8,13,-5
16,14,114,15,14,1
16,14,115,17,23,-6
16,14,116,15,17,-2
16,14,117,6,16,-10
16,14,118,15,18,-3
16,14,119,18,18,0
16,14,120,10,13,-3
16,14,121,10,17,-7
16,14,122,12,16,-4
16,14,123,16,20,-4
16,14,124,18,26,-8
16,14,125,6,11,-5
16,14,126,16,13,3
16,14,127,27,22,5
16,14,128,13,25,-12
16,14,129,13,22,-9
16,14,130,17,19,-2
16,14,131,11,13,-2
16,14,132,11,16,-5
16,14,133,24,35,-11
16,14,134,18,19,-1
16,14,135,27,7,20
16,14,136,23,22,1
16,14,137,23,17,6
16,14,138,19,26,-7
16,14,139,21,31,-10
16,14,140,7,12,-5
16,14,141,11,14,-3
16,14,142,6,6,0
16,14,143,13,11,2
16,14,144,21,18,3
16,14,145,14,26,-12
16,14,146,20,19,1
16,14,147,11,10,1
16,14,148,11,15,-4
16,14,149,22,18,4
16,14,150,29,12,17
16,14,151,12,16,-4
16,14,152,23,15,8
16,14,153,13,17,-4
16,14,154,20,17,3
16,14,155,14,22,-8
16,14,156,20,20,0
16,14,157,13,25,-12
16,14,158,22,24,-2
16,14,159,14,20,-6
16,14,160,9,16,-7
16,14,161,7,10,-3
16,14,162,9,15,-6
16,14,163,10,19,-9
16,14,164,15,23,-8
16,14,165,10,10,0
16,14,166,11,13,-2
16,14,167,20,13,7
16,14,168,10,17,-7
16,14,169,17,15,2
16,14,170,10,32,-22
16,14,171,8,15,-7
16,14,172,23,13,10
16,14,173,19,19,0
16,14,174,16,25,-9
16,14,175,6,10,-4
16,14,176,8,15,-7
16,14,177,27,12,15
16,14,178,9,12,-3
16,14,179,24,28,-4
16,14,180,22,9,13
16,14,181,7,10,-3
16,14,182,18,9,9
16,14,183,7,15,-8
16,14,184,14,18,-4
16,14,185,24,11,13
16,14,186,24,19,5
16,14,187,23,16,7
16,14,188,20,13,7
16,14,189,14,13,1
16,14,190,18,28,-10
16,14,191,7,15,-8
16,14,192,17,16,1
16,14,193,10,16,-6
16,14,194,14,24,-10
16,14,195,16,11,5
16,14,196,12,14,-2
16,14,197,10,26,-16
16,14,198,17,12,5
16,14,199,7,10,-3
16,14,200,18,9,9
16,14,201,25,24,1
16,14,202,12,22,-10
16,14,203,9,18,-9
16,14,204,17,11,6
16,14,205,20,12,8
16,14,206,9,7,2
16,14,207,23,16,7
16,14,208,8,15,-7
16,14,209,31,23,8
16,14,210,19,18,1
16,14,211,17,38,-21
16,14,212,10,8,2
16,14,213,17,12,5
16,14,214,16,23,-7
16,14,215,21,19,2
16,14,216,10,24,-14
16,14,217,21,31,-10
16,14,218,16,18,-2
16,14,219,10,16,-6
16,14,220,24,25,-1
16,14,221,20,20,0
16,14,222,17,13,4
16,14,223,14,13,1
16,14,224,21,24,-3
16,14,225,9,27,-18
16,14,226,36,20,16
16,14,227,13,15,-2
16,14,228,5,7,-2
16,14,229,16,22,-6
16,14,230,5,9,-4
16,14,231,13,36,-23
16,14,232,11,15,-4
16,14,233,9,13,-4
16,14,234,20,24,-4
16,14,235,19,21,-2
16,14,236,10,23,-13
16,14,237,13,18,-5
16,14,238,14,15,-1
16,14,239,17,28,-11
16,14,240,17,13,4
16,14,241,13,23,-10
16,14,242,9,9,0
16,14,243,18,11,7
16,14,244,26,14,12
16,14,245,22,25,-3
16,14,246,17,28,-11
16,14,247,7,13,-6
16,14,248,23,18,5
16,14,249,9,21,-12
16,14,250,24,25,-1
16,14,251,23,22,1
16,14,252,21,20,1
16,14,253,8,9,-1
16,14,254,19,14,5
16,14,255,16,20,-4
16,14,256,7,3,4
16,14,257,9,18,-9
16,14,258,19,25,-6
16,14,259,12,29,-17
16,14,260,11,23,-12
16,14,261,20,15,5
16,14,262,12,14,-2
16,14,263,13,12,1
16,14,264,20,16,4
16,14,265,15,29,-14
16,14,266,27,31,-4
16,14,267,4,15,-11
16,14,268,16,17,-1
16,14,269,7,20,-13
16,14,270,12,21,-9
16,14,271,16,14,2
16,14,272,14,25,-11
16,14,273,18,22,-4
16,14,274,11,20,-9
16,14,275,26,19,7
16,14,276,13,12,1
16,14,277,14,22,-8
16,14,278,9,33,-24
16,14,279,11,15,-4
16,14,280,20,14,6
16,14,281,15,14,1
16,14,282,9,10,-1
16,14,283,17,13,4
16,14,284,20,12,8
16,14,285,15,20,-5
16,14,286,8,21,-13
16,14,287,9,4,5
16,14,288,13,9,4
16,14,289,16,16,0
16,14,290,3,14,-11
16,14,291,14,26,-12
16,14,292,25,19,6
16,14,293,4,17,-13
16,14,294,27,17,10
16,14,295,10,19,-9
16,14,296,15,14,1
16,14,297,8,13,-5
16,14,298,11,13,-2
16,14,299,21,23,-2
16,15,0,17,15,2
16,15,1,21,6,15
16,15,2,10,13,-3
16,15,3,18,22,-4
16,15,4,14,10,4
16,15,5,15,29,-14
16,15,6,12,26,-14
16,15,7,22,17,5
16,15,8,29,22,7
16,15,9,19,20,-1
16,15,10,9,13,-4
16,15,11,4,11,-7
16,15,12,14,11,3
16,15,13,9,11,-2
16,15,14,15,7,8
16,15,15,16,16,0
16,15,16,20,26,-6
16,15,17,17,26,-9
16,15,18,5,12,-7
16,15,19,7,17,-10
16,15,20,18,11,7
16,15,21,18,27,-9
16,15,22,16,23,-7
16,15,23,13,10,3
16,15,24,10,20,-10
16,15,25,18,24,-6
16,15,26,15,23,-8
16,15,27,16,22,-6
16,15,28,18,18,0
16,15,29,20,18,2
16,15,30,12,16,-4
16,15,31,5,15,-10
16,15,32,14,9,5
16,15,33,29,15,14
16,15,34,12,16,-4
16,15,35,18,16,2
16,15,36,12,17,-5
16,15,37,16,25,-9
16,15,38,21,8,13
16,15,39,10,20,-10
16,15,40,14,12,2
16,15,41,15,20,-5
16,15,42,19,33,-14
16,15,43,16,25,-9
16,15,44,14,17,-3
16,15,45,18,22,-4
16,15,46,12,18,-6
16,15,47,19,14,5
16,15,48,11,14,-3
16,15,49,16,8,8
16,15,50,4,14,-10
16,15,51,8,11,-3
16,15,52,26,19,7
16,15,53,10,11,-1
16,15,54,8,14,-6
16,15,55,9,14,-5
16,15,56,8,15,-7
16,15,57,34,13,21
16,15,58,18,11,7
16,15,59,17,8,9
16,15,60,14,13,1
16,15,61,5,10,-5
16,15,62,16,14,2
16,15,63,5,15,-10
16,15,64,12,9,3
16,15,65,15,14,1
16,15,66,20,28,-8
16,15,67,16,12,4
16,15,68,21,24,-3
16,15,69,15,20,-5
16,15,70,28,18,10
16,15,71,13,20,-7
16,15,72,27,31,-4
16,15,73,16,8,8
16,15,74,14,16,-2
16,15,75,10,14,-4
16,15,76,24,20,4
16,15,77,10,17,-7
16,15,78,13,11,2
16,15,79,22,21,1
16,15,80,12,18,-6
16,15,81,12,26,-14
16,15,82,20,31,-11
16,15,83,17,25,-8
16,15,84,10,10,0
16,15,85,16,9,7
16,15,86,7,22,-15
16,15,87,21,26,-5
16,15,88,14,15,-1
16,15,89,15,19,-4
16,15,90,10,14,-4
16,15,91,15,18,-3
16,15,92,6,19,-13
16,15,93,20,11,9
16,15,94,14,18,-4
16,15,95,13,11,2
16,15,96,11,19,-8
16,15,97,8,11,-3
16,15,98,9,15,-6
16,15,99,14,10,4
16,15,100,11,18,-7
16,15,101,11,8,3
16,15,102,16,18,-2
16,15,103,26,27,-1
16,15,104,20,23,-3
16,15,105,19,17,2
16,15,106,8,18,-10
16,15,107,13,18,-5
16,15,108,17,16,1
16,15,109,11,19,-8
16,15,110,15,28,-13
16,15,111,12,14,-2
16,15,112,4,11,-7
16,15,113,7,12,-5
16,15,114,23,12,11
16,15,115,9,12,-3
16,15,116,23,17,6
16,15,117,19,12,7
16,15,118,11,14,-3
16,15,119,22,27,-5
16,15,120,14,10,4
16,15,121,14,14,0
16,15,122,22,15,7
16,15,123,13,13,0
16,15,124,24,23,1
16,15,125,16,12,4
16,15,126,11,11,0
16,15,127,19,16,3
16,15,128,22,22,0
16,15,129,15,22,-7
16,15,130,8,19,-11
16,15,131,21,20,1
16,15,132,19,18,1
16,15,133,19,22,-3
16,15,134,8,21,-13
16,15,135,16,15,1
16,15,136,25,17,8
16,15,137,18,10,8
16,15,138,10,18,-8
16,15,139,14,18,-4
16,15,140,8,20,-12
16,15,141,5,11,-6
16,15,142,11,4,7
16,15,143,9,18,-9
16,15,144,16,19,-3
16,15,145,13,13,0
16,15,146,13,24,-11
16,15,147,14,23,-9
16,15,148,7,8,-1
16,15,149,20,39,-19
16,15,150,14,17,-3
16,15,151,14,31,-17
16,15,152,10,6,4
16,15,153,7,15,-8
16,15,154,26,16,10
16,15,155,11,16,-5
16,15,156,12,15,-3
16,15,157,12,21,-9
16,15,158,10,19,-9
16,15,159,15,17,-2
16,15,160,16,11,5
16,15,161,16,17,-1
16,15,162,19,17,2
16,15,163,14,22,-8
16,15,164,17,12,5
16,15,165,20,17,3
16,15,166,23,18,5
16,15,167,21,17,4
16,15,168,11,13,-2
16,15,169,15,22,-7
16,15,170,12,8,4
16,15,171,18,21,-3
16,15,172,9,11,-2
16,15,173,17,10,7
16,15,174,14,12,2
16,15,175,15,9,6
16,15,176,25,17,8
16,15,177,21,21,0
16,15,178,27,36,-9
16,15,179,17,15,2
16,15,180,15,16,-1
16,15,181,18,23,-5
16,15,182,9,16,-7
16,15,183,7,13,-6
16,15,184,24,14,10
16,15,185,20,20,0
16,15,186,22,18,4
16,15,187,13,12,1
16,15,188,12,17,-5
16,15,189,17,10,7
16,15,190,13,16,-3
16,15,191,11,16,-5
16,15,192,12,7,5
16,15,193,15,13,2
16,15,194,11,14,-3
16,15,195,10,13,-3
16,15,196,11,14,-3
16,15,197,15,14,1
16,15,198,20,21,-1
16,15,199,18,19,-1
16,15,200,13,13,0
16,15,201,22,13,9
16,15,202,3,10,-7
16,15,203,12,22,-10
16,15,204,21,13,8
16,15,205,9,5,4
16,15,206,15,17,-2
16,15,207,14,20,-6
16,15,208,17,12,5
16,15,209,10,17,-7
16,15,210,6,13,-7
16,15,211,18,14,4
16,15,212,8,13,-5
16,15,213,9,9,0
16,15,214,4,13,-9
16,15,215,21,12,9
16,15,216,24,22,2
16,15,217,18,25,-7
16,15,218,17,21,-4
16,15,219,12,16,-4
16,15,220,10,12,-2
16,15,221,11,17,-6
16,15,222,19,28,-9
16,15,223,11,12,-1
16,15,224,16,19,-3
16,15,225,13,8,5
16,15,226,18,17,1
16,15,227,14,11,3
16,15,228,18,13,5
16,15,229,16,20,-4
16,15,230,11,17,-6
16,15,231,13,6,7
16,15,232,16,10,6
16,15,233,16,30,-14
16,15,234,10,19,-9
16,15,235,15,11,4
16,15,236,19,21,-2
16,15,237,12,14,-2
16,15,238,13,12,1
16,15,239,16,18,-2
16,15,240,25,26,-1
16,15,241,22,17,5
16,15,242,16,27,-11
16,15,243,10,10,0
16,15,244,9,10,-1
16,15,245,17,27,-10
16,15,246,19,13,6
16,15,247,14,29,-15
16,15,248,19,19,0
16,15,249,10,24,-14
16,15,250,17,14,3
16,15,251,20,16,4
16,15,252,24,19,5
16,15,253,19,14,5
16,15,254,4,10,-6
16,15,255,15,18,-3
16,15,256,5,18,-13
16,15,257,6,17,-11
16,15,258,4,10,-6
16,15,259,11,18,-7
16,15,260,21,11,10
16,15,261,27,9,18
16,15,262,31,26,5
16,15,263,4,11,-7
16,15,264,17,31,-14
16,15,265,13,26,-13
16,15,266,13,25,-12
16,15,267,1,10,-9
16,15,268,20,11,9
16,15,269,17,18,-1
16,15,270,17,22,-5
16,15,271,24,18,6
16,15,272,23,31,-8
16,15,273,9,15,-6
16,15,274,9,12,-3
16,15,275,17,19,-2
16,15,276,18,19,-1
16,15,277,17,28,-11
16,15,278,19,15,4
16,15,279,10,17,-7
16,15,280,11,12,-1
16,15,281,10,11,-1
16,15,282,6,12,-6
16,15,283,14,18,-4
16,15,284,13,10,3
16,15,285,14,29,-15
16,15,286,7,10,-3
16,15,287,9,7,2
16,15,288,12,11,1
16,15,289,22,18,4
16,15,290,16,10,6
16,15,291,22,26,-4
16,15,292,20,20,0
16,15,293,18,16,2
16,15,294,25,6,19
16,15,295,17,12,5
16,15,296,7,21,-14
16,15,297,16,26,-10
16,15,298,11,9,2
16,15,299,15,4,11
16,16,0,12,11,1
16,16,1,6,20,-14
16,16,2,20,17,3
16,16,3,13,20,-7
16,16,4,20,17,3
16,16,5,14,9,5
16,16,6,15,19,-4
16,16,7,11,15,-4
16,16,8,30,12,18
16,16,9,22,22,0
16,16,10,22,21,1
16,16,11,11,30,-19
16,16,12,14,3,11
16,16,13,18,25,-7
16,16,14,8,5,3
16,16,15,21,26,-5
16,16,16,8,17,-9
16,16,17,17,7,10
16,16,18,13,12,1
16,16,19,6,18,-12
16,16,20,8,25,-17
16,16,21,9,25,-16
16,16,22,7,9,-2
16,16,23,19,17,2
16,16,24,16,15,1
16,16,25,3,17,-14
16,16,26,18,19,-1
16,16,27,11,7,4
16,16,28,18,26,-8
16,16,29,8,14,-6
16,16,30,18,14,4
16,16,31,11,20,-9
16,16,32,10,21,-11
16,16,33,6,8,-2
16,16,34,11,6,5
16,16,35,22,29,-7
16,16,36,18,12,6
16,16,37,21,11,10
16,16,38,21,12,9
16,16,39,13,24,-11
16,16,40,13,7,6
16,16,41,9,7,2
16,16,42,24,15,9
16,16,43,14,19,-5
16,16,44,9,7,2
16,16,45,17,19,-2
16,16,46,19,24,-5
16,16,47,15,13,2
16,16,48,15,16,-1
16,16,49,15,2,13
16,16,50,15,14,1
16,16,51,27,11,16
16,16,52,7,17,-10
16,16,53,7,9,-2
16,16,54,6,16,-10
16,16,55,27,13,14
16,16,56,3,12,-9
16,16,57,20,21,-1
16,16,58,5,10,-5
16,16,59,22,20,2
16,16,60,17,15,2
16,16,61,13,26,-13
16,16,62,18,18,0
16,16,63,24,17,7
16,16,64,13,14,-1
16,16,65,17,17,0
16,16,66,2,17,-15
16,16,67,10,12,-2
16,16,68,10,12,-2
16,16,69,8,15,-7
16,16,70,7,27,-20
16,16,71,18,17,1
16,16,72,27,19,8
16,16,73,10,19,-9
16,16,74,19,8,11
16,16,75,8,15,-7
16,16,76,18,16,2
16,16,77,21,24,-3
16,16,78,14,15,-1
16,16,79,14,16,-2
16,16,80,10,17,-7
16,16,81,13,20,-7
16,16,82,17,17,0
16,16,83,17,15,2
16,16,84,13,11,2
16,16,85,11,4,7
16,16,86,6,16,-10
16,16,87,6,22,-16
16,16,88,10,12,-2
16,16,89,18,12,6
16,16,90,14,10,4
16,16,91,17,16,1
16,16,92,16,13,3
16,16,93,13,11,2
16,16,94,16,14,2
16,16,95,7,6,1
16,16,96,27,29,-2
16,16,97,14,28,-14
16,16,98,8,9,-1
16,16,99,12,15,-3
16,16,100,16,15,1
16,16,101,19,21,-2
16,16,102,7,13,-6
16,16,103,14,13,1
16,16,104,7,16,-9
16,16,105,16,18,-2
16,16,106,13,8,5
16,16,107,29,12,17
16,16,108,7,15,-8
16,16,109,8,29,-21
16,16,110,17,10,7
16,16,111,33,25,8
16,16,112,19,13,6
16,16,113,15,13,2
16,16,114,14,10,4
16,16,115,11,20,-9
16,16,116,11,13,-2
16,16,117,29,21,8
16,16,118,12,19,-7
16,16,119,24,10,14
16,16,120,18,20,-2
16,16,121,21,16,5
16,16,122,15,15,0
16,16,123,15,13,2
16,16,124,6,8,-2
16,16,125,19,22,-3
16,16,126,10,10,0
16,16,127,20,12,8
16,16,128,23,27,-4
16,16,129,10,18,-8
16,16,130,25,30,-5
16,16,131,7,6,1
16,16,132,11,25,-14
16,16,133,6,12,-6
16,16,134,7,12,-5
16,16,135,14,10,4
16,16,136,17,13,4
16,16,137,20,12,8
16,16,138,4,13,-9
16,16,139,14,31,-17
16,16,140,20,25,-5
16,16,141,12,8,4
16,16,142,22,13,9
16,16,143,22,7,15
16,16,144,6,13,-7
16,16,145,7,15,-8
16,16,146,7,11,-4
16,16,147,5,17,-12
16,16,148,12,14,-2
16,16,149,9,14,-5
16,16,150,6,7,-1
16,16,151,12,7,5
16,16,152,15,13,2
16,16,153,20,23,-3
16,16,154,20,24,-4
16,16,155,16,26,-10
16,16,156,24,8,16
16,16,157,6,4,2
16,16,158,16,9,7
16,16,159,12,20,-8
16,16,160,9,18,-9
16,16,161,9,8,1
16,16,162,16,14,2
16,16,163,8,10,-2
16,16,164,14,26,-12
16,16,165,10,22,-12
16,16,166,6,23,-17
16,16,167,10,18,-8
16,16,168,12,27,-15
16,16,169,13,18,-5
16,16,170,15,12,3
16,16,171,13,18,-5
16,16,172,17,18,-1
16,16,173,19,17,2
16,16,174,10,21,-11
16,16,175,10,20,-10
16,16,176,16,24,-8
16,16,177,10,12,-2
16,16,178,9,12,-3
16,16,179,13,8,5
16,16,180,26,21,5
16,16,181,13,14,-1
16,16,182,8,11,-3
16,16,183,19,18,1
16,16,184,20,19,1
16,16,185,13,20,-7
16,16,186,9,19,-10
16,16,187,8,11,-3
16,16,188,13,20,-7
16,16,189,14,17,-3
16,16,190,13,26,-13
16,16,191,12,12,0
16,16,192,7,9,-2
16,16,193,9,11,-2
16,16,194,19,13,6
16,16,195,12,4,8
16,16,196,13,17,-4
16,16,197,14,25,-11
16,16,198,22,24,-2
16,16,199,18,22,-4
16,16,200,11,17,-6
16,16,201,17,20,-3
16,16,202,19,25,-6
16,16,203,12,19,-7
16,16,204,21,14,7
16,16,205,12,13,-1
16,16,206,0,2,-2
16,16,207,16,8,8
16,16,208,14,19,-5
16,16,209,29,27,2
16,16,210,14,15,-1
16,16,211,18,13,5
16,16,212,14,14,0
16,16,213,5,5,0
16,16,214,14,14,0
16,16,215,19,15,4
16,16,216,26,37,-11
16,16,217,13,18,-5
16,16,218,17,30,-13
16,16,219,15,22,-7
16,16,220,15,12,3
16,16,221,5,13,-8
16,16,222,9,15,-6
16,16,223,5,12,-7
16,16,224,16,23,-7
16,16,225,10,9,1
16,16,226,15,21,-6
16,16,227,3,13,-10
16,16,228,18,13,5
16,16,229,11,20,-9
16,16,230,22,18,4
16,16,231,14,17,-3
16,16,232,17,14,3
16,16,233,5,3,2
16,16,234,8,16,-8
16,16,235,11,18,-7
16,16,236,5,14,-9
16,16,237,6,7,-1
16,16,238,19,16,3
16,16,239,19,31,-12
16,16,240,14,17,-3
16,16,241,7,5,2
16,16,242,20,31,-11
16,16,243,8,9,-1
16,16,244,16,18,-2
16,16,245,4,20,-16
16,16,246,15,16,-1
16,16,247,19,19,0
16,16,248,18,23,-5
16,16,249,23,21,2
16,16,250,8,25,-17
16,16,251,14,11,3
16,16,252,9,16,-7
16,16,253,10,23,-13
16,16,254,15,15,0
16,16,255,10,14,-4
16,16,256,10,10,0
16,16,257,14,10,4
16,16,258,18,29,-11
16,16,259,10,12,-2
16,16,260,16,19,-3
16,16,261,20,26,-6
16,16,262,19,12,7
16,16,263,28,21,7
16,16,264,16,13,3
16,16,265,18,18,0
16,16,266,16,19,-3
16,16,267,11,26,-15
16,16,268,13,19,-6
16,16,269,9,15,-6
16,16,270,2,10,-8
16,16,271,21,22,-1
16,16,272,19,11,8
16,16,273,17,11,6
16,16,274,15,16,-1
16,16,275,12,15,-3
16,16,276,11,12,-1
16,16,277,14,15,-1
16,16,278,5,9,-4
16,16,279,8,17,-9
16,16,280,12,13,-1
16,16,281,14,18,-4
16,16,282,13,16,-3
16,16,283,10,9,1
16,16,284,10,16,-6
16,16,285,7,20,-13
16,16,286,17,15,2
16,16,287,14,16,-2
16,16,288,8,20,-12
16,16,289,14,12,2
16,16,290,20,19,1
16,16,291,14,8,6
16,16,292,6,21,-15
16,16,293,9,20,-11
16,16,294,19,19,0
16,16,295,19,18,1
16,16,296,10,18,-8
16,16,297,11,22,-11
16,16,298,7,6,1
16,16,299,3,3,0
16,17,0,31,17,14
16,17,1,21,12,9
16,17,2,17,16,1
16,17,3,18,17,1
16,17,4,20,16,4
16,17,5,22,12,10
16,17,6,4,15,-11
16,17,7,3,13,-10
16,17,8,18,31,-13
16,17,9,12,11,1
16,17,10,11,8,3
16,17,11,17,30,-13
16,17,12,5,6,-1
16,17,13,8,12,-4
16,17,14,15,11,4
16,17,15,14,20,-6
16,17,16,10,18,-8
16,17,17,14,29,-15
16,17,18,16,11,5
16,17,19,23,26,-3
16,17,20,15,14,1
16,17,21,5,7,-2
16,17,22,13,8,5
16,17,23,5,17,-12
16,17,24,6,17,-11
16,17,25,17,9,8
16,17,26,18,20,-2
16,17,27,19,14,5
16,17,28,17,23,-6
16,17,29,23,20,3
16,17,30,21,4,17
16,17,31,15,11,4
16,17,32,14,22,-8
16,17,33,11,16,-5
16,17,34,11,11,0
16,17,35,11,16,-5
16,17,36,10,16,-6
16,17,37,16,10,6
16,17,38,18,11,7
16,17,39,23,15,8
16,17,40,10,19,-9
16,17,41,20,13,7
16,17,42,16,23,-7
16,17,43,20,13,7
16,17,44,16,16,0
16,17,45,14,9,5
16,17,46,10,10,0
16,17,47,13,12,1
16,17,48,13,18,-5
16,17,49,23,14,9
16,17,50,15,8,7
16,17,51,16,18,-2
16,17,52,16,21,-5
16,17,53,20,19,1
16,17,54,13,10,3
16,17,55,4,15,-11
16,17,56,21,11,10
16,17,57,18,17,1
16,17,58,13,11,2
16,17,59,21,24,-3
16,17,60,16,15,1
16,17,61,13,18,-5
16,17,62,14,10,4
16,17,63,22,31,-9
16,17,64,12,6,6
16,17,65,20,20,0
16,17,66,6,16,-10
16,17,67,14,18,-4
16,17,68,27,19,8
16,17,69,9,13,-4
16,17,70,19,10,9
16,17,71,10,14,-4
16,17,72,15,15,0
16,17,73,19,23,-4
16,17,74,15,8,7
16,17,75,10,12,-2
16,17,76,4,8,-4
16,17,77,26,18,8
16,17,78,14,11,3
16,17,79,18,33,-15
16,17,80,19,33,-14
16,17,81,8,16,-8
16,17,82,21,27,-6
16,17,83,8,8,0
16,17,84,11,28,-17
16,17,85,8,7,1
16,17,86,27,34,-7
16,17,87,18,20,-2
16,17,88,15,12,3
16,17,89,12,20,-8
16,17,90,10,19,-9
16,17,91,23,19,4
16,17,92,17,15,2
16,17,93,21,11,10
16,17,94,11,6,5
16,17,95,7,7,0
16,17,96,19,17,2
16,17,97,9,9,0
16,17,98,24,34,-10
16,17,99,18,17,1
16,17,100,11,3,8
16,17,101,16,22,-6
16,17,102,24,17,7
16,17,103,11,7,4
16,17,104,16,18,-2
16,17,105,4,9,-5
16,17,106,7,5,2
16,17,107,3,9,-6
16,17,108,21,19,2
16,17,109,10,20,-10
16,17,110,10,11,-1
16,17,111,29,19,10
16,17,112,22,17,5
16,17,113,23,8,15
16,17,114,19,15,4
16,17,115,17,15,2
16,17,116,16,21,-5
16,17,117,10,18,-8
16,17,118,11,14,-3
16,17,119,14,20,-6
16,17,120,16,19,-3
16,17,121,10,11,-1
16,17,122,15,18,-3
16,17,123,19,20,-1
16,17,124,10,18,-8
16,17,125,17,18,-1
16,17,126,13,27,-14
16,17,127,30,14,16
16,17,128,15,11,4
16,17,129,10,16,-6
16,17,130,11,12,-1
16,17,131,7,10,-3
16,17,132,10,7,3
16,17,133,16,16,0
16,17,134,10,8,2
16,17,135,17,9,8
16,17,136,11,16,-5
16,17,137,7,16,-9
16,17,138,12,27,-15
16,17,139,13,14,-1
16,17,140,16,18,-2
16,17,141,14,14,0
16,17,142,13,14,-1
16,17,143,19,16,3
16,17,144,18,11,7
16,17,145,19,6,13
16,17,146,4,13,-9
16,17,147,10,14,-4
16,17,148,30,25,5
16,17,149,23,16,7
16,17,150,17,18,-1
16,17,151,10,12,-2
16,17,152,35,10,25
16,17,153,12,6,6
16,17,154,11,16,-5
16,17,155,12,28,-16
16,17,156,21,6,15
16,17,157,14,17,-3
16,17,158,12,18,-6
16,17,159,31,24,7
16,17,160,10,16,-6
16,17,161,15,16,-1
16,17,162,10,8,2
16,17,163,19,13,6
16,17,164,14,5,9
16,17,165,4,16,-12
16,17,166,13,10,3
16,17,167,11,21,-10
16,17,168,8,3,5
16,17,169,6,20,-14
16,17,170,13,4,9
16,17,171,17,15,2
16,17,172,10,10,0
16,17,173,17,12,5
16,17,174,10,11,-1
16,17,175,16,20,-4
16,17,176,20,14,6
16,17,177,8,13,-5
16,17,178,5,5,0
16,17,179,21,16,5
16,17,180,15,19,-4
16,17,181,13,16,-3
16,17,182,12,21,-9
16,17,183,6,18,-12
16,17,184,17,10,7
16,17,185,14,15,-1
16,17,186,11,2,9
16,17,187,21,19,2
16,17,188,22,19,3
16,17,189,16,15,1
16,17,190,22,22,0
16,17,191,8,6,2
16,17,192,10,13,-3
16,17,193,15,24,-9
16,17,194,12,14,-2
16,17,195,22,18,4
16,17,196,14,28,-14
16,17,197,20,14,6
16,17,198,25,20,5
16,17,199,11,18,-7
16,17,200,12,7,5
16,17,201,22,24,-2
16,17,202,4,7,-3
16,17,203,15,26,-11
16,17,204,10,16,-6
16,17,205,10,15,-5
16,17,206,11,14,-3
16,17,207,15,17,-2
16,17,208,19,12,7
16,17,209,17,14,3
16,17,210,23,18,5
16,17,211,12,25,-13
16,17,212,16,19,-3
16,17,213,18,14,4
16,17,214,9,6,3
16,17,215,22,11,11
16,17,216,13,13,0
16,17,217,9,8,1
16,17,218,27,12,15
16,17,219,15,12,3
16,17,220,8,11,-3
16,17,221,6,11,-5
16,17,222,5,6,-1
16,17,223,11,14,-3
16,17,224,22,26,-4
16,17,225,22,15,7
16,17,226,13,23,-10
16,17,227,4,12,-8
16,17,228,20,31,-11
16,17,229,11,9,2
16,17,230,13,18,-5
16,17,231,19,21,-2
16,17,232,11,9,2
16,17,233,15,6,9
16,17,234,10,15,-5
16,17,235,14,16,-2
16,17,236,21,23,-2
16,17,237,12,19,-7
16,17,238,17,25,-8
16,17,239,19,11,8
16,17,240,15,18,-3
16,17,241,17,15,2
16,17,242,15,9,6
16,17,243,12,8,4
16,17,244,36,26,10
16,17,245,26,12,14
16,17,246,11,12,-1
16,17,247,20,13,7
16,17,248,15,11,4
16,17,249,22,29,-7
16,17,250,15,19,-4
16,17,251,7,12,-5
16,17,252,5,17,-12
16,17,253,4,20,-16
16,17,254,7,12,-5
16,17,255,24,30,-6
16,17,256,13,9,4
16,17,257,5,17,-12
16,17,258,23,15,8
16,17,259,11,24,-13
16,17,260,9,7,2
16,17,261,14,14,0
16,17,262,24,17,7
16,17,263,22,13,9
16,17,264,10,11,-1
16,17,265,2,9,-7
16,17,266,16,21,-5
16,17,267,8,13,-5
16,17,268,15,14,1
16,17,269,8,15,-7
16,17,270,17,13,4
16,17,271,13,16,-3
16,17,272,12,8,4
16,17,273,11,24,-13
16,17,274,10,15,-5
16,17,275,13,1,12
16,17,276,13,20,-7
16,17,277,28,16,12
16,17,278,15,4,11
16,17,279,22,24,-2
16,17,280,12,10,2
16,17,281,16,27,-11
16,17,282,20,13,7
16,17,283,24,15,9
16,17,284,20,20,0
16,17,285,20,9,11
16,17,286,26,13,13
16,17,287,17,25,-8
16,17,288,8,8,0
16,17,289,13,6,7
16,17,290,21,5,16
16,17,291,11,16,-5
16,17,292,16,22,-6
16,17,293,23,14,9
16,17,294,15,7,8
16,17,295,11,12,-1
16,17,296,17,10,7
16,17,297,21,21,0
16,17,298,30,17,13
16,17,299,23,25,-2
16,18,0,12,18,-6
16,18,1,13,14,-1
16,18,2,17,16,1
16,18,3,23,8,15
16,18,4,8,15,-7
16,18,5,11,9,2
16,18,6,13,8,5
16,18,7,15,19,-4
16,18,8,22,14,8
16,18,9,10,11,-1
16,18,10,14,7,7
16,18,11,20,12,8
16,18,12,28,17,11
16,18,13,8,18,-10
16,18,14,12,21,-9
16,18,15,13,12,1
16,18,16,25,29,-4
16,18,17,12,13,-1
16,18,18,16,19,-3
16,18,19,8,18,-10
16,18,20,11,18,-7
16,18,21,19,11,8
16,18,22,25,15,10
16,18,23,9,16,-7
16,18,24,16,8,8
16,18,25,18,10,8
16,18,26,19,21,-2
16,18,27,24,17,7
16,18,28,13,17,-4
16,18,29,10,17,-7
16,18,30,35,26,9
16,18,31,13,12,1
16,18,32,17,13,4
16,18,33,14,16,-2
16,18,34,18,18,0
16,18,35,26,23,3
16,18,36,12,12,0
16,18,37,9,8,1
16,18,38,19,21,-2
16,18,39,18,15,3
16,18,40,16,23,-7
16,18,41,23,21,2
16,18,42,15,15,0
16,18,43,10,18,-8
16,18,44,22,11,11
16,18,45,13,17,-4
16,18,46,19,18,1
16,18,47,21,37,-16
16,18,48,27,13,14
16,18,49,19,14,5
16,18,50,16,7,9
16,18,51,14,24,-10
16,18,52,5,8,-3
16,18,53,10,24,-14
16,18,54,16,18,-2
16,18,55,12,19,-7
16,18,56,17,13,4
16,18,57,9,11,-2
16,18,58,18,11,7
16,18,59,14,14,0
16,18,60,21,12,9
16,18,61,16,20,-4
16,18,62,14,10,4
16,18,63,21,13,8
16,18,64,13,22,-9
16,18,65,14,25,-11
16,18,66,8,10,-2
16,18,67,22,10,12
16,18,68,15,7,8
16,18,69,19,21,-2
16,18,70,16,20,-4
16,18,71,5,4,1
16,18,72,10,16,-6
16,18,73,17,3,14
16,18,74,18,10,8
16,18,75,12,14,-2
16,18,76,21,23,-2
16,18,77,18,10,8
16,18,78,10,7,3
16,18,79,11,7,4
16,18,80,15,9,6
16,18,81,19,25,-6
16,18,82,18,15,3
16,18,83,17,20,-3
16,18,84,13,14,-1
16,18,85,7,14,-7
16,18,86,13,14,-1
16,18,87,20,18,2
16,18,88,18,25,-7
16,18,89,18,14,4
16,18,90,9,10,-1
16,18,91,14,14,0
16,18,92,13,4,9
16,18,93,29,17,12
16,18,94,25,23,2
16,18,95,27,19,8
16,18,96,10,6,4
16,18,97,18,14,4
16,18,98,14,24,-10
16,18,99,11,10,1
16,18,100,18,12,6
16,18,101,17,16,1
16,18,102,20,15,5
16,18,103,7,9,-2
16,18,104,15,16,-1
16,18,105,15,1,14
16,18,106,10,15,-5
16,18,107,11,15,-4
16,18,108,18,21,-3
16,18,109,14,20,-6
16,18,110,14,14,0
16,18,111,20,12,8
16,18,112,9,11,-2
16,18,113,30,11,19
16,18,114,15,10,5
16,18,115,19,16,3
16,18,116,17,6,11
16,18,117,19,13,6
16,18,118,9,13,-4
16,18,119,12,22,-10
16,18,120,17,18,-1
16,18,121,17,13,4
16,18,122,10,20,-10
16,18,123,14,14,0
16,18,124,15,19,-4
16,18,125,5,15,-10
16,18,126,16,20,-4
16,18,127,16,17,-1
16,18,128,15,16,-1
16,18,129,24,28,-4
16,18,130,9,12,-3
16,18,131,17,14,3
16,18,132,24,8,16
16,18,133,14,15,-1
16,18,134,23,24,-1
16,18,135,13,3,10
16,18,136,19,19,0
16,18,137,6,18,-12
16,18,138,13,12,1
16,18,139,13,11,2
16,18,140,21,19,2
16,18,141,8,30,-22
16,18,142,30,23,7
16,18,143,18,16,2
16,18,144,12,16,-4
16,18,145,17,19,-2
16,18,146,9,15,-6
16,18,147,12,22,-10
16,18,148,21,8,13
16,18,149,14,14,0
16,18,150,4,9,-5
16,18,151,28,20,8
16,18,152,16,18,-2
16,18,153,16,25,-9
16,18,154,9,20,-11
16,18,155,19,16,3
16,18,156,14,19,-5
16,18,157,13,11,2
16,18,158,12,17,-5
16,18,159,12,10,2
16,18,160,15,13,2
16,18,161,7,17,-10
16,18,162,13,14,-1
16,18,163,15,14,1
16,18,164,27,25,2
16,18,165,25,24,1
16,18,166,17,15,2
16,18,167,12,3,9
16,18,168,12,9,3
16,18,169,14,14,0
16,18,170,8,12,-4
16,18,171,11,12,-1
16,18,172,10,9,1
16,18,173,14,17,-3
16,18,174,8,10,-2
16,18,175,11,18,-7
16,18,176,17,24,-7
16,18,177,16,16,0
16,18,178,13,18,-5
16,18,179,20,15,5
16,18,180,17,17,0
16,18,181,16,11,5
16,18,182,5,9,-4
16,18,183,10,14,-4
16,18,184,18,13,5
16,18,185,25,12,13
16,18,186,28,17,11
16,18,187,16,24,-8
16,18,188,13,12,1
16,18,189,7,19,-12
16,18,190,15,23,-8
16,18,191,1,17,-16
16,18,192,17,11,6
16,18,193,18,27,-9
16,18,194,16,11,5
16,18,195,17,14,3
16,18,196,10,10,0
16,18,197,22,28,-6
16,18,198,16,12,4
16,18,199,15,10,5
16,18,200,18,33,-15
16,18,201,11,22,-11
16,18,202,11,21,-10
16,18,203,15,13,2
16,18,204,20,15,5
16,18,205,6,10,-4
16,18,206,5,11,-6
16,18,207,11,19,-8
16,18,208,12,8,4
16,18,209,11,21,-10
16,18,210,11,11,0
16,18,211,10,18,-8
16,18,212,9,13,-4
16,18,213,13,23,-10
16,18,214,10,22,-12
16,18,215,17,9,8
16,18,216,20,25,-5
16,18,217,27,15,12
16,18,218,6,18,-12
16,18,219,18,10,8
16,18,220,7,13,-6
16,18,221,16,16,0
16,18,222,17,11,6
16,18,223,11,21,-10
16,18,224,23,21,2
16,18,225,8,18,-10
16,18,226,17,15,2
16,18,227,8,7,1
16,18,228,8,6,2
16,18,229,13,11,2
16,18,230,20,15,5
16,18,231,3,8,-5
16,18,232,20,31,-11
16,18,233,13,13,0
16,18,234,15,18,-3
16,18,235,19,11,8
16,18,236,14,19,-5
16,18,237,14,25,-11
16,18,238,22,23,-1
16,18,239,5,14,-9
16,18,240,8,4,4
16,18,241,17,16,1
16,18,242,30,29,1
16,18,243,10,18,-8
16,18,244,17,21,-4
16,18,245,14,16,-2
16,18,246,15,11,4
16,18,247,4,9,-5
16,18,248,11,11,0
16,18,249,12,15,-3
16,18,250,12,17,-5
16,18,251,20,21,-1
16,18,252,15,9,6
16,18,253,18,25,-7
16,18,254,16,8,8
16,18,255,9,9,0
16,18,256,11,4,7
16,18,257,18,14,4
16,18,258,4,10,-6
16,18,259,9,13,-4
16,18,260,13,13,0
16,18,261,16,19,-3
16,18,262,6,9,-3
16,18,263,20,20,0
16,18,264,17,16,1
16,18,265,10,11,-1
16,18,266,16,10,6
16,18,267,19,12,7
16,18,268,25,23,2
16,18,269,8,16,-8
16,18,270,10,18,-8
16,18,271,14,26,-12
16,18,272,23,15,8
16,18,273,8,13,-5
16,18,274,20,28,-8
16,18,275,4,7,-3
16,18,276,11,2,9
16,18,277,14,13,1
16,18,278,12,12,0
16,18,279,13,12,1
16,18,280,11,8,3
16,18,281,18,14,4
16,18,282,12,13,-1
16,18,283,18,19,-1
16,18,284,11,16,-5
16,18,285,25,8,17
16,18,286,24,20,4
16,18,287,23,15,8
16,18,288,23,13,10
16,18,289,24,11,13
16,18,290,12,8,4
16,18,291,16,11,5
16,18,292,10,5,5
16,18,293,8,0,8
16,18,294,8,15,-7
16,18,295,18,22,-4
16,18,296,24,25,-1
16,18,297,14,17,-3
16,18,298,5,7,-2
16,18,299,10,13,-3
16,19,0,9,12,-3
16,19,1,3,13,-10
16,19,2,13,7,6
16,19,3,13,12,1
16,19,4,26,10,16
16,19,5,19,22,-3
16,19,6,10,9,1
16,19,7,11,8,3
16,19,8,11,16,-5
16,19,9,21,20,1
16,19,10,19,17,2
16,19,11,20,18,2
16,19,12,18,15,3
16,19,13,25,27,-2
16,19,14,31,11,20
16,19,15,14,16,-2
16,19,16,16,4,12
16,19,17,19,22,-3
16,19,18,13,20,-7
16,19,19,15,14,1
16,19,20,23,18,5
16,19,21,25,11,14
16,19,22,23,31,-8
16,19,23,15,14,1
16,19,24,18,17,1
16,19,25,11,8,3
16,19,26,20,26,-6
16,19,27,13,25,-12
16,19,28,13,10,3
16,19,29,19,15,4
16,19,30,7,1,6
16,19,31,17,22,-5
16,19,32,18,15,3
16,19,33,20,28,-8
16,19,34,24,10,14
16,19,35,11,8,3
16,19,36,28,10,18
16,19,37,13,10,3
16,19,38,11,22,-11
16,19,39,17,15,2
16,19,40,16,13,3
16,19,41,12,13,-1
16,19,42,11,21,-10
16,19,43,17,21,-4
16,19,44,8,21,-13
16,19,45,29,18,11
16,19,46,15,11,4
16,19,47,19,19,0
16,19,48,18,15,3
16,19,49,17,20,-3
16,19,50,16,13,3
16,19,51,12,10,2
16,19,52,21,20,1
16,19,53,19,11,8
16,19,54,8,11,-3
16,19,55,17,18,-1
16,19,56,10,8,2
16,19,57,20,14,6
16,19,58,10,17,-7
16,19,59,10,11,-1
16,19,60,14,9,5
16,19,61,13,11,2
16,19,62,4,4,0
16,19,63,16,20,-4
16,19,64,18,13,5
16,19,65,11,4,7
16,19,66,23,12,11
16,19,67,22,21,1
16,19,68,6,8,-2
16,19,69,14,21,-7
16,19,70,19,11,8
16,19,71,8,25,-17
16,19,72,10,14,-4
16,19,73,8,7,1
16,19,74,17,13,4
16,19,75,5,10,-5
16,19,76,15,21,-6
16,19,77,10,4,6
16,19,78,9,14,-5
16,19,79,15,10,5
16,19,80,19,31,-12
16,19,81,23,16,7
16,19,82,2,14,-12
16,19,83,19,16,3
16,19,84,5,13,-8
16,19,85,31,35,-4
16,19,86,19,8,11
16,19,87,11,17,-6
16,19,88,18,13,5
16,19,89,15,18,-3
16,19,90,12,11,1
16,19,91,10,12,-2
16,19,92,11,11,0
16,19,93,21,13,8
16,19,94,15,14,1
16,19,95,18,10,8
16,19,96,18,14,4
16,19,97,31,22,9
16,19,98,22,14,8
16,19,99,11,7,4
16,19,100,9,8,1
16,19,101,13,19,-6
16,19,102,20,23,-3
16,19,103,8,17,-9
16,19,104,14,33,-19
16,19,105,6,9,-3
16,19,106,16,12,4
16,19,107,7,8,-1
16,19,108,25,13,12
16,19,109,8,15,-7
16,19,110,21,7,14
16,19,111,8,23,-15
16,19,112,21,11,10
16,19,113,9,18,-9
16,19,114,5,9,-4
16,19,115,7,11,-4
16,19,116,13,15,-2
16,19,117,19,4,15
16,19,118,13,19,-6
16,19,119,7,7,0
16,19,120,23,20,3
16,19,121,7,24,-17
16,19,122,27,21,6
16,19,123,14,12,2
16,19,124,14,11,3
16,19,125,15,13,2
16,19,126,26,26,0
16,19,127,17,18,-1
16,19,128,11,9,2
16,19,129,7,6,1
16,19,130,10,5,5
16,19,131,28,12,16
16,19,132,21,18,3
16,19,133,12,17,-5
16,19,134,16,25,-9
16,19,135,25,27,-2
16,19,136,8,12,-4
16,19,137,12,9,3
16,19,138,14,36,-22
16,19,139,10,8,2
16,19,140,7,15,-8
16,19,141,15,23,-8
16,19,142,15,15,0
16,19,143,19,18,1
16,19,144,16,28,-12
16,19,145,14,10,4
16,19,146,13,9,4
16,19,147,9,13,-4
16,19,148,24,20,4
16,19,149,16,16,0
16,19,150,19,13,6
16,19,151,16,21,-5
16,19,152,20,15,5
16,19,153,17,11,6
16,19,154,6,16,-10
16,19,155,23,16,7
16,19,156,13,10,3
16,19,157,11,6,5
16,19,158,16,23,-7
16,19,159,15,41,-26
16,19,160,10,9,1
16,19,161,17,14,3
16,19,162,20,16,4
16,19,163,19,14,5
16,19,164,11,9,2
16,19,165,23,14,9
16,19,166,7,19,-12
16,19,167,28,17,11
16,19,168,25,14,11
16,19,169,15,9,6
16,19,170,16,21,-5
16,19,171,11,27,-16
16,19,172,12,17,-5
16,19,173,15,13,2
16,19,174,6,16,-10
16,19,175,13,13,0
16,19,176,14,15,-1
16,19,177,18,22,-4
16,19,178,8,12,-4
16,19,179,18,13,5
16,19,180,15,19,-4
16,19,181,11,11,0
16,19,182,11,14,-3
16,19,183,23,33,-10
16,19,184,19,17,2
16,19,185,11,16,-5
16,19,186,20,11,9
16,19,187,10,11,-1
16,19,188,15,19,-4
16,19,189,13,16,-3
16,19,190,27,9,18
16,19,191,13,22,-9
16,19,192,14,7,7
16,19,193,19,10,9
16,19,194,14,9,5
16,19,195,10,15,-5
16,19,196,13,8,5
16,19,197,24,15,9
16,19,198,17,16,1
16,19,199,15,24,-9
16,19,200,14,12,2
16,19,201,41,17,24
16,19,202,14,8,6
16,19,203,13,14,-1
16,19,204,14,14,0
16,19,205,19,15,4
16,19,206,18,11,7
16,19,207,11,8,3
16,19,208,12,12,0
16,19,209,11,10,1
16,19,210,7,10,-3
16,19,211,9,10,-1
16,19,212,21,24,-3
16,19,213,15,13,2
16,19,214,20,19,1
16,19,215,24,13,11
16,19,216,17,17,0
16,19,217,20,21,-1
16,19,218,17,17,0
16,19,219,8,14,-6
16,19,220,24,9,15
16,19,221,24,18,6
16,19,222,17,13,4
16,19,223,1,7,-6
16,19,224,11,12,-1
16,19,225,4,21,-17
16,19,226,16,21,-5
16,19,227,6,12,-6
16,19,228,17,16,1
16,19,229,9,28,-19
16,19,230,18,15,3
16,19,231,18,10,8
16,19,232,15,15,0
16,19,233,13,15,-2
16,19,234,19,24,-5
16,19,235,18,14,4
16,19,236,13,14,-1
16,19,237,16,7,9
16,19,238,20,20,0
16,19,239,28,28,0
16,19,240,11,9,2
16,19,241,23,11,12
16,19,242,7,15,-8
16,19,243,8,12,-4
16,19,244,23,13,10
16,19,245,22,17,5
16,19,246,12,26,-14
16,19,247,14,11,3
16,19,248,18,28,-10
16,19,249,17,30,-13
16,19,250,20,36,-16
16,19,251,16,13,3
16,19,252,12,7,5
16,19,253,20,21,-1
16,19,254,17,12,5
16,19,255,8,4,4
16,19,256,14,18,-4
16,19,257,21,13,8
16,19,258,12,11,1
16,19,259,5,15,-10
16,19,260,14,18,-4
16,19,261,16,20,-4
16,19,262,6,8,-2
16,19,263,15,11,4
16,19,264,17,11,6
16,19,265,13,12,1
16,19,266,24,14,10
16,19,267,22,6,16
16,19,268,18,9,9
16,19,269,9,13,-4
16,19,270,8,27,-19
16,19,271,22,10,12
16,19,272,14,18,-4
16,19,273,27,7,20
16,19,274,18,7,11
16,19,275,5,10,-5
16,19,276,17,13,4
16,19,277,27,22,5
16,19,278,18,21,-3
16,19,279,18,7,11
16,19,280,15,14,1
16,19,281,15,28,-13
16,19,282,9,25,-16
16,19,283,16,14,2
16,19,284,8,14,-6
16,19,285,12,14,-2
16,19,286,10,14,-4
16,19,287,13,17,-4
16,19,288,8,7,1
16,19,289,12,11,1
16,19,290,9,8,1
16,19,291,19,13,6
16,19,292,16,16,0
16,19,293,8,11,-3
16,19,294,12,17,-5
16,19,295,15,15,0
16,19,296,3,18,-15
16,19,297,12,9,3
16,19,298,10,24,-14
16,19,299,28,9,19
16,20,0,14,7,7
16,20,1,18,25,-7
16,20,2,10,11,-1
16,20,3,15,16,-1
16,20,4,14,21,-7
16,20,5,18,17,1
16,20,6,9,6,3
16,20,7,31,22,9
16,20,8,17,15,2
16,20,9,14,15,-1
16,20,10,19,9,10
16,20,11,13,19,-6
16,20,12,12,15,-3
16,20,13,7,14,-7
16,20,14,18,9,9
16,20,15,24,18,6
16,20,16,24,14,10
16,20,17,9,6,3
16,20,18,24,16,8
16,20,19,4,25,-21
16,20,20,17,12,5
16,20,21,14,25,-11
16,20,22,29,18,11
16,20,23,10,15,-5
16,20,24,18,16,2
16,20,25,18,5,13
16,20,26,16,12,4
16,20,27,13,12,1
16,20,28,3,6,-3
16,20,29,13,20,-7
16,20,30,9,11,-2
16,20,31,15,15,0
16,20,32,10,12,-2
16,20,33,10,12,-2
16,20,34,13,7,6
16,20,35,25,24,1
16,20,36,10,3,7
16,20,37,23,12,11
16,20,38,22,17,5
16,20,39,29,16,13
16,20,40,23,17,6
16,20,41,12,14,-2
16,20,42,6,8,-2
16,20,43,29,19,10
16,20,44,18,18,0
16,20,45,15,9,6
16,20,46,16,10,6
16,20,47,18,15,3
16,20,48,18,22,-4
16,20,49,14,1,13
16,20,50,16,13,3
16,20,51,10,17,-7
16,20,52,10,14,-4
16,20,53,24,20,4
16,20,54,17,7,10
16,20,55,28,28,0
16,20,56,17,17,0
16,20,57,7,13,-6
16,20,58,14,15,-1
16,20,59,15,9,6
16,20,60,18,28,-10
16,20,61,18,16,2
16,20,62,22,21,1
16,20,63,22,12,10
16,20,64,14,10,4
16,20,65,13,15,-2
16,20,66,31,14,17
16,20,67,15,12,3
16,20,68,18,26,-8
16,20,69,25,26,-1
16,20,70,29,21,8
16,20,71,18,10,8
16,20,72,24,17,7
16,20,73,8,4,4
16,20,74,11,22,-11
16,20,75,16,21,-5
16,20,76,32,36,-4
16,20,77,13,11,2
16,20,78,19,15,4
16,20,79,10,9,1
16,20,80,9,15,-6
16,20,81,19,14,5
16,20,82,11,24,-13
16,20,83,6,17,-11
16,20,84,11,23,-12
16,20,85,11,17,-6
16,20,86,24,17,7
16,20,87,24,18,6
16,20,88,15,14,1
16,20,89,11,4,7
16,20,90,19,23,-4
16,20,91,7,7,0
16,20,92,16,13,3
16,20,93,11,17,-6
16,20,94,19,13,6
16,20,95,9,13,-4
16,20,96,16,21,-5
16,20,97,22,17,5
16,20,98,13,19,-6
16,20,99,4,10,-6
16,20,100,13,16,-3
16,20,101,13,11,2
16,20,102,11,15,-4
16,20,103,12,5,7
16,20,104,31,22,9
16,20,105,8,24,-16
16,20,106,18,16,2
16,20,107,9,16,-7
16,20,108,18,7,11
16,20,109,19,20,-1
16,20,110,13,3,10
16,20,111,5,20,-15
16,20,112,12,24,-12
16,20,113,14,13,1
16,20,114,17,10,7
16,20,115,24,21,3
16,20,116,6,7,-1
16,20,117,18,13,5
16,20,118,10,13,-3
16,20,119,15,20,-5
16,20,120,7,5,2
16,20,121,9,15,-6
16,20,122,11,7,4
16,20,123,15,7,8
16,20,124,15,13,2
16,20,125,18,9,9
16,20,126,18,17,1
16,20,127,12,15,-3
16,20,128,5,14,-9
16,20,129,6,19,-13
16,20,130,20,13,7
16,20,131,21,17,4
16,20,132,22,28,-6
16,20,133,14,8,6
16,20,134,25,9,16
16,20,135,17,13,4
16,20,136,15,18,-3
16,20,137,26,20,6
16,20,138,36,19,17
16,20,139,12,7,5
16,20,140,14,19,-5
16,20,141,22,17,5
16,20,142,19,16,3
16,20,143,5,5,0
16,20,144,13,12,1
16,20,145,15,13,2
16,20,146,17,16,1
16,20,147,17,29,-12
16,20,148,21,16,5
16,20,149,17,15,2
16,20,150,16,9,7
16,20,151,19,18,1
16,20,152,11,18,-7
16,20,153,15,22,-7
16,20,154,22,12,10
16,20,155,12,5,7
16,20,156,14,11,3
16,20,157,14,15,-1
16,20,158,10,20,-10
16,20,159,11,13,-2
16,20,160,6,14,-8
16,20,161,6,21,-15
16,20,162,15,16,-1
16,20,163,16,17,-1
16,20,164,12,11,1
16,20,165,14,6,8
16,20,166,10,13,-3
16,20,167,10,10,0
16,20,168,12,29,-17
16,20,169,9,5,4
16,20,170,12,9,3
16,20,171,17,11,6
16,20,172,16,15,1
16,20,173,10,22,-12
16,20,174,13,15,-2
16,20,175,8,24,-16
16,20,176,18,16,2
16,20,177,16,16,0
16,20,178,17,10,7
16,20,179,20,25,-5
16,20,180,21,26,-5
16,20,181,10,19,-9
16,20,182,21,17,4
16,20,183,14,16,-2
16,20,184,9,17,-8
16,20,185,15,16,-1
16,20,186,14,9,5
16,20,187,8,6,2
16,20,188,15,19,-4
16,20,189,11,13,-2
16,20,190,9,34,-25
16,20,191,6,19,-13
16,20,192,19,6,13
16,20,193,21,22,-1
16,20,194,12,8,4
16,20,195,16,22,-6
16,20,196,10,12,-2
16,20,197,7,13,-6
16,20,198,17,18,-1
16,20,199,12,24,-12
16,20,200,12,25,-13
16,20,201,19,19,0
16,20,202,28,22,6
16,20,203,12,18,-6
16,20,204,17,17,0
16,20,205,19,17,2
16,20,206,5,12,-7
16,20,207,16,12,4
16,20,208,4,22,-18
16,20,209,10,13,-3
16,20,210,19,7,12
16,20,211,12,16,-4
16,20,212,21,8,13
16,20,213,9,11,-2
16,20,214,10,14,-4
16,20,215,25,12,13
16,20,216,30,20,10
16,20,217,15,15,0
16,20,218,26,14,12
16,20,219,23,20,3
16,20,220,8,8,0
16,20,221,23,20,3
16,20,222,10,9,1
16,20,223,11,12,-1
16,20,224,18,17,1
16,20,225,10,15,-5
16,20,226,12,23,-11
16,20,227,16,13,3
16,20,228,8,18,-10
16,20,229,13,14,-1
16,20,230,19,14,5
16,20,231,23,8,15
16,20,232,13,12,1
16,20,233,10,8,2
16,20,234,42,21,21
16,20,235,16,22,-6
16,20,236,17,8,9
16,20,237,19,16,3
16,20,238,21,9,12
16,20,239,14,16,-2
16,20,240,15,11,4
16,20,241,18,13,5
16,20,242,6,8,-2
16,20,243,7,18,-11
16,20,244,2,5,-3
16,20,245,29,21,8
16,20,246,21,17,4
16,20,247,22,18,4
16,20,248,10,27,-17
16,20,249,12,5,7
16,20,250,24,19,5
16,20,251,16,18,-2
16,20,252,22,18,4
16,20,253,14,11,3
16,20,254,13,17,-4
16,20,255,12,18,-6
16,20,256,26,26,0
16,20,257,14,16,-2
16,20,258,24,12,12
16,20,259,25,7,18
16,20,260,22,17,5
16,20,261,13,9,4
16,20,262,17,29,-12
16,20,263,24,23,1
16,20,264,22,22,0
16,20,265,11,21,-10
16,20,266,13,8,5
16,20,267,18,12,6
16,20,268,11,4,7
16,20,269,20,8,12
16,20,270,17,18,-1
16,20,271,17,26,-9
16,20,272,14,11,3
16,20,273,19,21,-2
16,20,274,11,19,-8
16,20,275,14,9,5
16,20,276,25,14,11
16,20,277,18,2,16
16,20,278,10,17,-7
16,20,279,21,26,-5
16,20,280,21,20,1
16,20,281,21,10,11
16,20,282,9,17,-8
16,20,283,14,12,2
16,20,284,12,18,-6
16,20,285,13,14,-1
16,20,286,15,14,1
16,20,287,14,18,-4
16,20,288,12,8,4
16,20,289,15,20,-5
16,20,290,12,27,-15
16,20,291,40,24,16
16,20,292,27,19,8
16,20,293,27,22,5
16,20,294,11,14,-3
16,20,295,7,10,-3
16,20,296,13,20,-7
16,20,297,14,12,2
16,20,298,3,16,-13
16,20,299,16,11,5
16,21,0,8,18,-10
16,21,1,11,12,-1
16,21,2,10,11,-1
16,21,3,16,23,-7
16,21,4,20,8,12
16,21,5,9,11,-2
16,21,6,10,16,-6
16,21,7,10,11,-1
16,21,8,21,24,-3
16,21,9,11,7,4
16,21,10,24,14,10
16,21,11,14,19,-5
16,21,12,9,4,5
16,21,13,17,15,2
16,21,14,9,7,2
16,21,15,18,15,3
16,21,16,22,18,4
16,21,17,10,8,2
16,21,18,13,12,1
16,21,19,27,24,3
16,21,20,26,18,8
16,21,21,14,19,-5
16,21,22,15,7,8
16,21,23,13,17,-4
16,21,24,7,14,-7
16,21,25,17,15,2
16,21,26,10,19,-9
16,21,27,19,18,1
16,21,28,19,27,-8
16,21,29,8,23,-15
16,21,30,10,21,-11
16,21,31,20,9,11
16,21,32,16,7,9
16,21,33,12,16,-4
16,21,34,12,8,4
16,21,35,9,12,-3
16,21,36,23,20,3
16,21,37,12,12,0
16,21,38,22,16,6
16,21,39,20,16,4
16,21,40,29,17,12
16,21,41,10,11,-1
16,21,42,16,10,6
16,21,43,16,20,-4
16,21,44,8,14,-6
16,21,45,8,11,-3
16,21,46,26,28,-2
16,21,47,13,13,0
16,21,48,9,24,-15
16,21,49,21,14,7
16,21,50,11,9,2
16,21,51,22,12,10
16,21,52,18,22,-4
16,21,53,20,8,12
16,21,54,8,10,-2
16,21,55,26,20,6
16,21,56,13,8,5
16,21,57,16,20,-4
16,21,58,19,14,5
16,21,59,24,14,10
16,21,60,27,23,4
16,21,61,22,16,6
16,21,62,12,14,-2
16,21,63,17,16,1
16,21,64,22,11,11
16,21,65,12,30,-18
16,21,66,15,17,-2
16,21,67,27,24,3
16,21,68,17,15,2
16,21,69,20,12,8
16,21,70,21,14,7
16,21,71,5,11,-6
16,21,72,21,13,8
16,21,73,19,9,10
16,21,74,19,22,-3
16,21,75,14,21,-7
16,21,76,19,8,11
16,21,77,14,22,-8
16,21,78,21,22,-1
16,21,79,17,10,7
16,21,80,21,20,1
16,21,81,25,12,13
16,21,82,14,15,-1
16,21,83,15,13,2
16,21,84,19,11,8
16,21,85,23,20,3
16,21,86,15,5,10
16,21,87,13,11,2
16,21,88,10,20,-10
16,21,89,11,16,-5
16,21,90,20,17,3
16,21,91,22,16,6
16,21,92,11,6,5
16,21,93,18,15,3
16,21,94,8,18,-10
16,21,95,17,17,0
16,21,96,17,15,2
16,21,97,10,5,5
16,21,98,13,15,-2
16,21,99,19,16,3
16,21,100,8,28,-20
16,21,101,8,27,-19
16,21,102,18,16,2
16,21,103,15,11,4
16,21,104,9,16,-7
16,21,105,17,13,4
16,21,106,21,18,3
16,21,107,14,9,5
16,21,108,12,28,-16
16,21,109,16,19,-3
16,21,110,7,13,-6
16,21,111,23,15,8
16,21,112,19,20,-1
16,21,113,21,13,8
16,21,114,15,20,-5
16,21,115,25,17,8
16,21,116,15,18,-3
16,21,117,14,19,-5
16,21,118,14,8,6
16,21,119,23,20,3
16,21,120,25,28,-3
16,21,121,11,4,7
16,21,122,9,2,7
16,21,123,21,17,4
16,21,124,25,13,12
16,21,125,14,7,7
16,21,126,8,17,-9
16,21,127,14,21,-7
16,21,128,10,24,-14
16,21,129,26,11,15
16,21,130,13,15,-2
16,21,131,9,8,1
16,21,132,20,19,1
16,21,133,14,10,4
16,21,134,17,11,6
16,21,135,21,16,5
16,21,136,21,25,-4
16,21,137,22,33,-11
16,21,138,11,13,-2
16,21,139,13,15,-2
16,21,140,5,22,-17
16,21,141,9,10,-1
16,21,142,7,7,0
16,21,143,12,10,2
16,21,144,12,15,-3
16,21,145,11,20,-9
16,21,146,11,16,-5
16,21,147,18,27,-9
16,21,148,16,11,5
16,21,149,21,17,4
16,21,150,9,13,-4
16,21,151,19,14,5
16,21,152,12,10,2
16,21,153,14,9,5
16,21,154,17,10,7
16,21,155,21,10,11
16,21,156,16,17,-1
16,21,157,29,30,-1
16,21,158,12,15,-3
16,21,159,15,17,-2
16,21,160,17,19,-2
16,21,161,6,9,-3
16,21,162,14,9,5
16,21,163,15,18,-3
16,21,164,10,24,-14
16,21,165,28,17,11
16,21,166,13,21,-8
16,21,167,9,7,2
16,21,168,19,30,-11
16,21,169,17,15,2
16,21,170,13,15,-2
16,21,171,9,15,-6
16,21,172,12,27,-15
16,21,173,24,11,13
16,21,174,7,10,-3
16,21,175,3,4,-1
16,21,176,16,9,7
16,21,177,22,16,6
16,21,178,7,5,2
16,21,179,7,12,-5
16,21,180,20,13,7
16,21,181,25,27,-2
16,21,182,18,16,2
16,21,183,29,26,3
16,21,184,13,12,1
16,21,185,13,11,2
16,21,186,8,11,-3
16,21,187,10,7,3
16,21,188,7,5,2
16,21,189,14,17,-3
16,21,190,13,16,-3
16,21,191,14,16,-2
16,21,192,16,11,5
16,21,193,22,12,10
16,21,194,16,20,-4
16,21,195,22,18,4
16,21,196,12,15,-3
16,21,197,16,29,-13
16,21,198,10,20,-10
16,21,199,24,13,11
16,21,200,21,22,-1
16,21,201,13,5,8
16,21,202,13,12,1
16,21,203,16,11,5
16,21,204,11,11,0
16,21,205,11,21,-10
16,21,206,12,12,0
16,21,207,15,18,-3
16,21,208,20,22,-2
16,21,209,14,10,4
16,21,210,22,17,5
16,21,211,23,12,11
16,21,212,16,14,2
16,21,213,11,22,-11
16,21,214,21,11,10
16,21,215,21,16,5
16,21,216,5,9,-4
16,21,217,17,16,1
16,21,218,12,8,4
16,21,219,14,24,-10
16,21,220,26,13,13
16,21,221,15,16,-1
16,21,222,8,9,-1
16,21,223,15,23,-8
16,21,224,7,11,-4
16,21,225,15,9,6
16,21,226,24,12,12
16,21,227,26,10,16
16,21,228,15,6,9
16,21,229,14,29,-15
16,21,230,20,17,3
16,21,231,10,10,0
16,21,232,4,5,-1
16,21,233,15,18,-3
16,21,234,15,11,4
16,21,235,20,11,9
16,21,236,14,10,4
16,21,237,16,9,7
16,21,238,10,7,3
16,21,239,15,15,0
16,21,240,16,25,-9
16,21,241,12,28,-16
16,21,242,16,12,4
16,21,243,19,21,-2
16,21,244,6,6,0
16,21,245,22,9,13
16,21,246,14,6,8
16,21,247,25,12,13
16,21,248,11,10,1
16,21,249,6,16,-10
16,21,250,13,14,-1
16,21,251,2,2,0
16,21,252,26,24,2
16,21,253,11,12,-1
16,21,254,15,10,5
16,21,255,15,18,-3
16,21,256,23,10,13
16,21,257,16,11,5
16,21,258,9,14,-5
16,21,259,8,11,-3
16,21,260,11,25,-14
16,21,261,8,12,-4
16,21,262,21,21,0
16,21,263,14,20,-6
16,21,264,12,16,-4
16,21,265,15,8,7
16,21,266,13,14,-1
16,21,267,7,10,-3
16,21,268,21,13,8
16,21,269,15,13,2
16,21,270,30,19,11
16,21,271,15,15,0
16,21,272,19,26,-7
16,21,273,23,29,-6
16,21,274,22,13,9
16,21,275,18,16,2
16,21,276,8,13,-5
16,21,277,15,17,-2
16,21,278,10,10,0
16,21,279,12,19,-7
16,21,280,13,5,8
16,21,281,18,16,2
16,21,282,21,14,7
16,21,283,33,17,16
16,21,284,17,17,0
16,21,285,9,14,-5
16,21,286,21,17,4
16,21,287,13,19,-6
16,21,288,17,9,8
16,21,289,19,23,-4
16,21,290,16,6,10
16,21,291,20,4,16
16,21,292,11,9,2
16,21,293,24,19,5
16,21,294,11,17,-6
16,21,295,20,24,-4
16,21,296,12,8,4
16,21,297,10,11,-1
16,21,298,9,8,1
16,21,299,12,11,1
16,22,0,18,23,-5
16,22,1,18,19,-1
16,22,2,14,28,-14
16,22,3,26,26,0
16,22,4,13,8,5
16,22,5,12,18,-6
16,22,6,21,21,0
16,22,7,10,12,-2
16,22,8,25,7,18
16,22,9,4,12,-8
16,22,10,20,14,6
16,22,11,12,23,-11
16,22,12,20,18,2
16,22,13,20,22,-2
16,22,14,12,20,-8
16,22,15,23,18,5
16,22,16,8,7,1
16,22,17,19,15,4
16,22,18,7,14,-7
16,22,19,16,35,-19
16,22,20,18,8,10
16,22,21,15,15,0
16,22,22,14,17,-3
16,22,23,18,14,4
16,22,24,11,13,-2
16,22,25,16,14,2
16,22,26,15,23,-8
16,22,27,7,12,-5
16,22,28,5,11,-6
16,22,29,26,12,14
16,22,30,19,12,7
16,22,31,13,12,1
16,22,32,10,22,-12
16,22,33,17,24,-7
16,22,34,16,21,-5
16,22,35,8,12,-4
16,22,36,15,14,1
16,22,37,16,10,6
16,22,38,20,17,3
16,22,39,11,15,-4
16,22,40,22,11,11
16,22,41,18,12,6
16,22,42,19,10,9
16,22,43,9,14,-5
16,22,44,16,19,-3
16,22,45,13,25,-12
16,22,46,9,17,-8
16,22,47,20,10,10
16,22,48,9,16,-7
16,22,49,25,22,3
16,22,50,19,21,-2
16,22,51,11,22,-11
16,22,52,17,14,3
16,22,53,19,15,4
16,22,54,17,14,3
16,22,55,18,12,6
16,22,56,12,19,-7
16,22,57,9,15,-6
16,22,58,15,16,-1
16,22,59,15,16,-1
16,22,60,22,17,5
16,22,61,11,14,-3
16,22,62,23,20,3
16,22,63,33,31,2
16,22,64,16,9,7
16,22,65,27,25,2
16,22,66,12,11,1
16,22,67,29,18,11
16,22,68,16,9,7
16,22,69,28,16,12
16,22,70,8,9,-1
16,22,71,16,10,6
16,22,72,8,23,-15
16,22,73,16,20,-4
16,22,74,22,21,1
16,22,75,4,16,-12
16,22,76,26,13,13
16,22,77,19,19,0
16,22,78,17,24,-7
16,22,79,9,4,5
16,22,80,12,9,3
16,22,81,18,11,7
16,22,82,7,8,-1
16,22,83,17,10,7
16,22,84,10,5,5
16,22,85,26,27,-1
16,22,86,8,8,0
16,22,87,15,15,0
16,22,88,24,9,15
16,22,89,16,13,3
16,22,90,24,23,1
16,22,91,18,22,-4
16,22,92,6,12,-6
16,22,93,17,11,6
16,22,94,18,24,-6
16,22,95,23,17,6
16,22,96,4,10,-6
16,22,97,14,24,-10
16,22,98,15,20,-5
16,22,99,13,6,7
16,22,100,15,16,-1
16,22,101,17,26,-9
16,22,102,11,17,-6
16,22,103,16,17,-1
16,22,104,8,4,4
16,22,105,6,16,-10
16,22,106,16,18,-2
16,22,107,16,17,-1
16,22,108,8,11,-3
16,22,109,13,18,-5
16,22,110,14,7,7
16,22,111,23,18,5
16,22,112,22,22,0
16,22,113,13,19,-6
16,22,114,10,16,-6
16,22,115,17,11,6
16,22,116,11,3,8
16,22,117,21,14,7
16,22,118,16,14,2
16,22,119,24,23,1
16,22,120,23,22,1
16,22,121,12,8,4
16,22,122,21,8,13
16,22,123,13,12,1
16,22,124,15,2,13
16,22,125,7,8,-1
16,22,126,23,11,12
16,22,127,23,15,8
16,22,128,11,11,0
16,22,129,11,13,-2
16,22,130,11,15,-4
16,22,131,15,13,2
16,22,132,19,19,0
16,22,133,23,12,11
16,22,134,16,25,-9
16,22,135,14,13,1
16,22,136,14,18,-4
16,22,137,12,9,3
16,22,138,18,11,7
16,22,139,28,19,9
16,22,140,19,21,-2
16,22,141,16,15,1
16,22,142,24,26,-2
16,22,143,28,16,12
16,22,144,16,21,-5
16,22,145,17,12,5
16,22,146,14,12,2
16,22,147,8,14,-6
16,22,148,31,22,9
16,22,149,9,10,-1
16,22,150,16,11,5
16,22,151,15,11,4
16,22,152,16,10,6
16,22,153,10,19,-9
16,22,154,13,18,-5
16,22,155,14,18,-4
16,22,156,12,12,0
16,22,157,18,13,5
16,22,158,5,11,-6
16,22,159,9,18,-9
16,22,160,14,8,6
16,22,161,22,9,13
16,22,162,15,13,2
16,22,163,16,11,5
16,22,164,13,13,0
16,22,165,9,20,-11
16,22,166,16,15,1
16,22,167,21,29,-8
16,22,168,19,27,-8
16,22,169,7,8,-1
16,22,170,16,28,-12
16,22,171,17,7,10
16,22,172,19,11,8
16,22,173,21,19,2
16,22,174,3,15,-12
16,22,175,14,11,3
16,22,176,16,15,1
16,22,177,9,15,-6
16,22,178,19,10,9
16,22,179,9,13,-4
16,22,180,24,21,3
16,22,181,15,20,-5
16,22,182,25,11,14
16,22,183,16,6,10
16,22,184,6,6,0
16,22,185,11,9,2
16,22,186,9,13,-4
16,22,187,17,9,8
16,22,188,16,14,2
16,22,189,16,23,-7
16,22,190,38,15,23
16,22,191,8,11,-3
16,22,192,19,5,14
16,22,193,6,12,-6
16,22,194,12,10,2
16,22,195,26,24,2
16,22,196,18,17,1
16,22,197,16,15,1
16,22,198,15,12,3
16,22,199,15,28,-13
16,22,200,16,19,-3
16,22,201,8,6,2
16,22,202,11,5,6
16,22,203,16,18,-2
16,22,204,24,13,11
16,22,205,6,10,-4
16,22,206,22,11,11
16,22,207,10,14,-4
16,22,208,17,12,5
16,22,209,12,6,6
16,22,210,22,11,11
16,22,211,19,18,1
16,22,212,15,26,-11
16,22,213,10,16,-6
16,22,214,9,17,-8
16,22,215,12,17,-5
16,22,216,18,33,-15
16,22,217,9,16,-7
16,22,218,9,8,1
16,22,219,13,12,1
16,22,220,23,19,4
16,22,221,17,9,8
16,22,222,8,10,-2
16,22,223,23,7,16
16,22,224,14,10,4
16,22,225,23,25,-2
16,22,226,18,17,1
16,22,227,15,8,7
16,22,228,25,7,18
16,22,229,5,13,-8
16,22,230,12,15,-3
16,22,231,24,14,10
16,22,232,14,12,2
16,22,233,16,17,-1
16,22,234,21,23,-2
16,22,235,20,9,11
16,22,236,12,17,-5
16,22,237,15,20,-5
16,22,238,6,6,0
16,22,239,19,7,12
16,22,240,16,16,0
16,22,241,15,13,2
16,22,242,8,12,-4
16,22,243,17,15,2
16,22,244,23,10,13
16,22,245,16,14,2
16,22,246,35,21,14
16,22,247,14,19,-5
16,22,248,18,14,4
16,22,249,14,15,-1
16,22,250,8,13,-5
16,22,251,18,17,1
16,22,252,12,9,3
16,22,253,18,28,-10
16,22,254,10,4,6
16,22,255,12,18,-6
16,22,256,17,19,-2
16,22,257,21,18,3
16,22,258,10,4,6
16,22,259,16,10,6
16,22,260,3,4,-1
16,22,261,14,11,3
16,22,262,14,5,9
16,22,263,16,7,9
16,22,264,11,9,2
16,22,265,14,8,6
16,22,266,31,18,13
16,22,267,21,21,0
16,22,268,8,11,-3
16,22,269,18,17,1
16,22,270,20,21,-1
16,22,271,17,24,-7
16,22,272,23,23,0
16,22,273,22,21,1
16,22,274,17,23,-6
16,22,275,31,19,12
16,22,276,22,12,10
16,22,277,24,21,3
16,22,278,15,6,9
16,22,279,20,13,7
16,22,280,10,14,-4
16,22,281,26,19,7
16,22,282,17,17,0
16,22,283,9,11,-2
16,22,284,11,15,-4
16,22,285,28,18,10
16,22,286,13,6,7
16,22,287,18,16,2
16,22,288,28,10,18
16,22,289,10,7,3
16,22,290,23,18,5
16,22,291,8,15,-7
16,22,292,19,23,-4
16,22,293,13,11,2
16,22,294,11,19,-8
16,22,295,10,8,2
16,22,296,25,16,9
16,22,297,25,20,5
16,22,298,7,12,-5
16,22,299,25,11,14
16,23,0,16,8,8
16,23,1,23,10,13
16,23,2,24,14,10
16,23,3,16,15,1
16,23,4,21,11,10
16,23,5,15,17,-2
16,23,6,10,14,-4
16,23,7,4,11,-7
16,23,8,13,11,2
16,23,9,27,21,6
16,23,10,19,16,3
16,23,11,22,11,11
16,23,12,19,23,-4
16,23,13,17,16,1
16,23,14,16,15,1
16,23,15,15,12,3
16,23,16,8,8,0
16,23,17,10,16,-6
16,23,18,22,18,4
16,23,19,10,8,2
16,23,20,25,7,18
16,23,21,22,9,13
16,23,22,15,5,10
16,23,23,14,13,1
16,23,24,2,27,-25
16,23,25,8,6,2
16,23,26,10,26,-16
16,23,27,19,19,0
16,23,28,14,7,7
16,23,29,8,11,-3
16,23,30,18,9,9
16,23,31,13,9,4
16,23,32,11,16,-5
16,23,33,15,25,-10
16,23,34,7,20,-13
16,23,35,23,10,13
16,23,36,16,14,2
16,23,37,16,19,-3
16,23,38,12,13,-1
16,23,39,14,13,1
16,23,40,33,16,17
16,23,41,20,16,4
16,23,42,18,25,-7
16,23,43,16,23,-7
16,23,44,21,14,7
16,23,45,20,14,6
16,23,46,10,14,-4
16,23,47,9,29,-20
16,23,48,11,13,-2
16,23,49,12,15,-3
16,23,50,18,16,2
16,23,51,13,16,-3
16,23,52,12,8,4
16,23,53,7,11,-4
16,23,54,20,13,7
16,23,55,20,18,2
16,23,56,19,11,8
16,23,57,15,9,6
16,23,58,23,27,-4
16,23,59,14,7,7
16,23,60,23,10,13
16,23,61,19,5,14
16,23,62,17,10,7
16,23,63,16,11,5
16,23,64,5,6,-1
16,23,65,16,16,0
16,23,66,8,19,-11
16,23,67,19,17,2
16,23,68,16,14,2
16,23,69,15,11,4
16,23,70,16,21,-5
16,23,71,16,7,9
16,23,72,14,15,-1
16,23,73,18,11,7
16,23,74,11,11,0
16,23,75,18,15,3
16,23,76,15,12,3
16,23,77,13,30,-17
16,23,78,13,10,3
16,23,79,21,14,7
16,23,80,13,20,-7
16,23,81,16,5,11
16,23,82,18,13,5
16,23,83,16,14,2
16,23,84,21,25,-4
16,23,85,21,18,3
16,23,86,21,15,6
16,23,87,21,9,12
16,23,88,11,7,4
16,23,89,17,11,6
16,23,90,24,16,8
16,23,91,25,9,16
16,23,92,19,16,3
16,23,93,19,9,10
16,23,94,8,12,-4
16,23,95,12,14,-2
16,23,96,8,13,-5
16,23,97,23,10,13
16,23,98,11,15,-4
16,23,99,17,19,-2
16,23,100,21,17,4
16,23,101,31,12,19
16,23,102,10,10,0
16,23,103,10,14,-4
16,23,104,9,8,1
16,23,105,14,13,1
16,23,106,5,5,0
16,23,107,15,7,8
16,23,108,16,20,-4
16,23,109,21,10,11
16,23,110,12,11,1
16,23,111,14,10,4
16,23,112,15,5,10
16,23,113,24,13,11
16,23,114,15,10,5
16,23,115,16,14,2
16,23,116,26,27,-1
16,23,117,7,10,-3
16,23,118,23,8,15
16,23,119,17,9,8
16,23,120,9,12,-3
16,23,121,26,27,-1
16,23,122,16,7,9
16,23,123,11,10,1
16,23,124,9,15,-6
16,23,125,15,19,-4
16,23,126,10,6,4
16,23,127,12,12,0
16,23,128,13,22,-9
16,23,129,23,10,13
16,23,130,13,22,-9
16,23,131,9,18,-9
16,23,132,14,9,5
16,23,133,23,18,5
16,23,134,13,4,9
16,23,135,17,14,3
16,23,136,15,10,5
16,23,137,17,15,2
16,23,138,11,17,-6
16,23,139,17,27,-10
16,23,140,11,19,-8
16,23,141,14,5,9
16,23,142,16,17,-1
16,23,143,17,19,-2
16,23,144,13,18,-5
16,23,145,7,9,-2
16,23,146,23,15,8
16,23,147,12,13,-1
16,23,148,16,9,7
16,23,149,12,12,0
16,23,150,14,11,3
16,23,151,10,12,-2
16,23,152,16,23,-7
16,23,153,13,7,6
16,23,154,6,8,-2
16,23,155,9,7,2
16,23,156,11,16,-5
16,23,157,13,6,7
16,23,158,19,16,3
16,23,159,16,12,4
16,23,160,18,15,3
16,23,161,11,12,-1
16,23,162,9,4,5
16,23,163,20,14,6
16,23,164,21,23,-2
16,23,165,16,7,9
16,23,166,14,13,1
16,23,167,14,12,2
16,23,168,26,22,4
16,23,169,15,12,3
16,23,170,9,23,-14
16,23,171,12,11,1
16,23,172,21,11,10
16,23,173,17,12,5
16,23,174,12,7,5
16,23,175,31,16,15
16,23,176,25,16,9
16,23,177,9,12,-3
16,23,178,15,18,-3
16,23,179,22,16,6
16,23,180,10,15,-5
16,23,181,12,16,-4
16,23,182,18,33,-15
16,23,183,11,6,5
16,23,184,16,11,5
16,23,185,9,12,-3
16,23,186,18,12,6
16,23,187,14,11,3
16,23,188,15,10,5
16,23,189,12,15,-3
16,23,190,20,18,2
16,23,191,10,21,-11
16,23,192,25,9,16
16,23,193,4,11,-7
16,23,194,24,14,10
16,23,195,20,8,12
16,23,196,14,18,-4
16,23,197,22,8,14
16,23,198,11,20,-9
16,23,199,19,16,3
16,23,200,16,13,3
16,23,201,30,21,9
16,23,202,10,14,-4
16,23,203,12,10,2
16,23,204,8,16,-8
16,23,205,14,10,4
16,23,206,30,20,10
16,23,207,11,7,4
16,23,208,22,15,7
16,23,209,13,8,5
16,23,210,16,12,4
16,23,211,10,15,-5
16,23,212,15,15,0
16,23,213,9,27,-18
16,23,214,11,13,-2
16,23,215,9,7,2
16,23,216,14,18,-4
16,23,217,12,5,7
16,23,218,22,15,7
16,23,219,8,12,-4
16,23,220,20,13,7
16,23,221,15,10,5
16,23,222,8,8,0
16,23,223,4,9,-5
16,23,224,11,24,-13
16,23,225,5,9,-4
16,23,226,19,20,-1
16,23,227,13,11,2
16,23,228,19,10,9
16,23,229,17,12,5
16,23,230,17,12,5
16,23,231,30,15,15
16,23,232,22,19,3
16,23,233,17,24,-7
16,23,234,15,20,-5
16,23,235,8,6,2
16,23,236,8,12,-4
16,23,237,19,14,5
16,23,238,15,8,7
16,23,239,14,14,0
16,23,240,12,10,2
16,23,241,13,18,-5
16,23,242,10,13,-3
16,23,243,14,22,-8
16,23,244,20,16,4
16,23,245,16,8,8
16,23,246,17,10,7
16,23,247,10,6,4
16,23,248,27,22,5
16,23,249,23,9,14
16,23,250,11,16,-5
16,23,251,17,16,1
16,23,252,12,19,-7
16,23,253,16,11,5
16,23,254,16,14,2
16,23,255,10,11,-1
16,23,256,15,21,-6
16,23,257,18,10,8
16,23,258,14,16,-2
16,23,259,13,10,3
16,23,260,28,12,16
16,23,261,16,14,2
16,23,262,9,17,-8
16,23,263,9,11,-2
16,23,264,9,13,-4
16,23,265,17,11,6
16,23,266,12,12,0
16,23,267,18,28,-10
16,23,268,24,19,5
16,23,269,23,16,7
16,23,270,15,12,3
16,23,271,26,23,3
16,23,272,29,23,6
16,23,273,10,18,-8
16,23,274,10,12,-2
16,23,275,15,17,-2
16,23,276,13,13,0
16,23,277,14,7,7
16,23,278,21,10,11
16,23,279,15,19,-4
16,23,280,14,15,-1
16,23,281,16,15,1
16,23,282,13,20,-7
16,23,283,18,16,2
16,23,284,21,18,3
16,23,285,19,13,6
16,23,286,13,26,-13
16,23,287,11,12,-1
16,23,288,19,11,8
16,23,289,13,8,5
16,23,290,18,13,5
16,23,291,17,12,5
16,23,292,18,19,-1
16,23,293,6,7,-1
16,23,294,11,12,-1
16,23,295,6,17,-11
16,23,296,10,17,-7
16,23,297,17,4,13
16,23,298,26,18,8
16,23,299,12,18,-6
16,24,0,22,14,8
16,24,1,24,9,15
16,24,2,26,12,14
16,24,3,11,6,5
16,24,4,9,3,6
16,24,5,17,15,2
16,24,6,18,13,5
16,24,7,17,20,-3
16,24,8,7,10,-3
16,24,9,8,11,-3
16,24,10,7,14,-7
16,24,11,12,18,-6
16,24,12,11,12,-1
16,24,13,9,5,4
16,24,14,24,16,8
16,24,15,19,11,8
16,24,16,25,10,15
16,24,17,7,10,-3
16,24,18,10,12,-2
16,24,19,13,9,4
16,24,20,8,13,-5
16,24,21,21,19,2
16,24,22,22,19,3
16,24,23,23,20,3
16,24,24,11,15,-4
16,24,25,17,9,8
16,24,26,17,24,-7
16,24,27,21,12,9
16,24,28,15,10,5
16,24,29,18,14,4
16,24,30,8,12,-4
16,24,31,22,12,10
16,24,32,14,11,3
16,24,33,20,18,2
16,24,34,10,13,-3
16,24,35,13,11,2
16,24,36,24,12,12
16,24,37,17,18,-1
16,24,38,6,8,-2
16,24,39,11,15,-4
16,24,40,13,6,7
16,24,41,17,19,-2
16,24,42,19,14,5
16,24,43,15,10,5
16,24,44,10,7,3
16,24,45,17,9,8
16,24,46,20,27,-7
16,24,47,20,16,4
16,24,48,16,18,-2
16,24,49,16,9,7
16,24,50,12,15,-3
16,24,51,9,2,7
16,24,52,10,6,4
16,24,53,21,21,0
16,24,54,18,16,2
16,24,55,22,17,5
16,24,56,10,8,2
16,24,57,5,10,-5
16,24,58,12,16,-4
16,24,59,22,11,11
16,24,60,25,7,18
16,24,61,23,7,16
16,24,62,20,9,11
16,24,63,18,16,2
16,24,64,12,19,-7
16,24,65,10,15,-5
16,24,66,14,11,3
16,24,67,14,17,-3
16,24,68,29,28,1
16,24,69,11,8,3
16,24,70,15,6,9
16,24,71,6,12,-6
16,24,72,12,19,-7
16,24,73,8,11,-3
16,24,74,20,11,9
16,24,75,17,14,3
16,24,76,26,10,16
16,24,77,10,5,5
16,24,78,11,7,4
16,24,79,12,12,0
16,24,80,5,4,1
16,24,81,10,9,1
16,24,82,13,18,-5
16,24,83,26,11,15
16,24,84,9,8,1
16,24,85,18,12,6
16,24,86,24,9,15
16,24,87,16,10,6
16,24,88,21,27,-6
16,24,89,26,23,3
16,24,90,25,21,4
16,24,91,18,7,11
16,24,92,12,3,9
16,24,93,6,10,-4
16,24,94,18,18,0
16,24,95,20,9,11
16,24,96,18,16,2
16,24,97,18,11,7
16,24,98,22,22,0
16,24,99,15,12,3
16,24,100,10,23,-13
16,24,101,11,14,-3
16,24,102,3,3,0
16,24,103,8,11,-3
16,24,104,18,12,6
16,24,105,21,23,-2
16,24,106,18,7,11
16,24,107,14,18,-4
16,24,108,16,19,-3
16,24,109,11,14,-3
16,24,110,9,2,7
16,24,111,14,19,-5
16,24,112,14,17,-3
16,24,113,19,14,5
16,24,114,2,14,-12
16,24,115,16,12,4
16,24,116,11,7,4
16,24,117,17,25,-8
16,24,118,14,17,-3
16,24,119,15,28,-13
16,24,120,16,12,4
16,24,121,9,18,-9
16,24,122,15,15,0
16,24,123,18,11,7
16,24,124,11,9,2
16,24,125,8,10,-2
16,24,126,31,18,13
16,24,127,26,14,12
16,24,128,22,16,6
16,24,129,21,13,8
16,24,130,14,23,-9
16,24,131,27,34,-7
16,24,132,18,13,5
16,24,133,10,17,-7
16,24,134,12,10,2
16,24,135,13,10,3
16,24,136,11,12,-1
16,24,137,30,16,14
16,24,138,6,4,2
16,24,139,21,23,-2
16,24,140,17,10,7
16,24,141,8,7,1
16,24,142,21,18,3
16,24,143,12,6,6
16,24,144,18,20,-2
16,24,145,12,9,3
16,24,146,24,24,0
16,24,147,17,15,2
16,24,148,13,7,6
16,24,149,22,21,1
16,24,150,25,19,6
16,24,151,21,14,7
16,24,152,9,14,-5
16,24,153,12,20,-8
16,24,154,20,15,5
16,24,155,15,16,-1
16,24,156,18,8,10
16,24,157,6,5,1
16,24,158,22,21,1
16,24,159,14,9,5
16,24,160,15,20,-5
16,24,161,25,4,21
16,24,162,24,12,12
16,24,163,20,14,6
16,24,164,11,7,4
16,24,165,8,4,4
16,24,166,23,17,6
16,24,167,19,17,2
16,24,168,10,4,6
16,24,169,5,5,0
16,24,170,20,15,5
16,24,171,11,20,-9
16,24,172,18,24,-6
16,24,173,11,6,5
16,24,174,20,16,4
16,24,175,13,6,7
16,24,176,13,6,7
16,24,177,21,11,10
16,24,178,16,16,0
16,24,179,14,7,7
16,24,180,13,9,4
16,24,181,20,27,-7
16,24,182,17,16,1
16,24,183,14,6,8
16,24,184,24,10,14
16,24,185,6,20,-14
16,24,186,9,16,-7
16,24,187,16,13,3
16,24,188,14,11,3
16,24,189,14,6,8
16,24,190,19,24,-5
16,24,191,5,14,-9
16,24,192,11,8,3
16,24,193,18,15,3
16,24,194,29,26,3
16,24,195,10,14,-4
16,24,196,24,16,8
16,24,197,18,16,2
16,24,198,14,9,5
16,24,199,30,15,15
16,24,200,8,13,-5
16,24,201,5,9,-4
16,24,202,9,4,5
16,24,203,19,7,12
16,24,204,12,13,-1
16,24,205,15,13,2
16,24,206,13,17,-4
16,24,207,12,16,-4
16,24,208,18,11,7
16,24,209,20,9,11
16,24,210,5,8,-3
16,24,211,27,25,2
16,24,212,16,26,-10
16,24,213,17,9,8
16,24,214,22,9,13
16,24,215,18,13,5
16,24,216,2,5,-3
16,24,217,13,7,6
16,24,218,5,3,2
16,24,219,22,10,12
16,24,220,17,11,6
16,24,221,24,19,5
16,24,222,15,9,6
16,24,223,13,17,-4
16,24,224,15,17,-2
16,24,225,10,12,-2
16,24,226,20,11,9
16,24,227,11,5,6
16,24,228,13,18,-5
16,24,229,24,22,2
16,24,230,10,17,-7
16,24,231,13,17,-4
16,24,232,9,12,-3
16,24,233,10,23,-13
16,24,234,24,8,16
16,24,235,16,22,-6
16,24,236,19,17,2
16,24,237,17,12,5
16,24,238,16,24,-8
16,24,239,13,10,3
16,24,240,13,9,4
16,24,241,12,13,-1
16,24,242,14,26,-12
16,24,243,10,15,-5
16,24,244,8,10,-2
16,24,245,29,19,10
16,24,246,17,21,-4
16,24,247,15,17,-2
16,24,248,7,20,-13
16,24,249,9,12,-3
16,24,250,9,9,0
16,24,251,17,12,5
16,24,252,18,14,4
16,24,253,12,8,4
16,24,254,10,8,2
16,24,255,14,8,6
16,24,256,9,16,-7
16,24,257,13,17,-4
16,24,258,19,12,7
16,24,259,25,20,5
16,24,260,25,18,7
16,24,261,25,10,15
16,24,262,24,10,14
16,24,263,5,8,-3
16,24,264,10,11,-1
16,24,265,13,11,2
16,24,266,16,10,6
16,24,267,19,15,4
16,24,268,19,16,3
16,24,269,9,12,-3
16,24,270,10,12,-2
16,24,271,21,20,1
16,24,272,11,10,1
16,24,273,12,20,-8
16,24,274,10,17,-7
16,24,275,8,9,-1
16,24,276,12,11,1
16,24,277,15,15,0
16,24,278,15,9,6
16,24,279,23,12,11
16,24,280,27,12,15
16,24,281,19,15,4
16,24,282,11,18,-7
16,24,283,11,16,-5
16,24,284,22,17,5
16,24,285,20,23,-3
16,24,286,11,18,-7
16,24,287,25,17,8
16,24,288,7,11,-4
16,24,289,18,15,3
16,24,290,12,10,2
16,24,291,6,17,-11
16,24,292,11,15,-4
16,24,293,19,15,4
16,24,294,11,9,2
16,24,295,9,18,-9
16,24,296,8,13,-5
16,24,297,15,12,3
16,24,298,7,16,-9
16,24,299,28,23,5
16,25,0,14,17,-3
16,25,1,20,14,6
16,25,2,18,21,-3
16,25,3,31,14,17
16,25,4,21,7,14
16,25,5,9,10,-1
16,25,6,11,7,4
16,25,7,17,13,4
16,25,8,21,11,10
16,25,9,17,15,2
16,25,10,15,16,-1
16,25,11,35,17,18
16,25,12,17,17,0
16,25,13,19,17,2
16,25,14,16,7,9
16,25,15,7,3,4
16,25,16,19,15,4
16,25,17,13,8,5
16,25,18,16,8,8
16,25,19,17,5,12
16,25,20,16,15,1
16,25,21,13,12,1
16,25,22,15,18,-3
16,25,23,12,23,-11
16,25,24,17,19,-2
16,25,25,10,14,-4
16,25,26,19,10,9
16,25,27,28,12,16
16,25,28,16,11,5
16,25,29,15,12,3
16,25,30,24,10,14
16,25,31,20,20,0
16,25,32,18,13,5
16,25,33,22,18,4
16,25,34,12,15,-3
16,25,35,20,5,15
16,25,36,22,22,0
16,25,37,26,19,7
16,25,38,19,17,2
16,25,39,21,11,10
16,25,40,11,6,5
16,25,41,17,14,3
16,25,42,16,20,-4
16,25,43,9,9,0
16,25,44,20,9,11
16,25,45,13,12,1
16,25,46,16,16,0
16,25,47,21,15,6
16,25,48,11,6,5
16,25,49,10,18,-8
16,25,50,16,12,4
16,25,51,16,12,4
16,25,52,12,11,1
16,25,53,20,11,9
16,25,54,10,15,-5
16,25,55,17,5,12
16,25,56,15,11,4
16,25,57,20,18,2
16,25,58,16,18,-2
16,25,59,16,14,2
16,25,60,9,18,-9
16,25,61,16,11,5
16,25,62,15,17,-2
16,25,63,18,24,-6
16,25,64,10,6,4
16,25,65,14,15,-1
16,25,66,8,9,-1
16,25,67,11,12,-1
16,25,68,11,14,-3
16,25,69,17,4,13
16,25,70,5,12,-7
16,25,71,16,8,8
16,25,72,26,11,15
16,25,73,16,20,-4
16,25,74,20,14,6
16,25,75,17,19,-2
16,25,76,19,14,5
16,25,77,8,20,-12
16,25,78,24,5,19
16,25,79,19,24,-5
16,25,80,6,5,1
16,25,81,18,13,5
16,25,82,15,4,11
16,25,83,20,18,2
16,25,84,19,13,6
16,25,85,26,16,10
16,25,86,18,20,-2
16,25,87,36,28,8
16,25,88,20,23,-3
16,25,89,23,15,8
16,25,90,7,12,-5
16,25,91,17,9,8
16,25,92,16,11,5
16,25,93,18,15,3
16,25,94,10,17,-7
16,25,95,13,3,10
16,25,96,7,12,-5
16,25,97,11,10,1
16,25,98,17,12,5
16,25,99,24,14,10
16,25,100,26,15,11
16,25,101,19,9,10
16,25,102,5,21,-16
16,25,103,15,14,1
16,25,104,19,12,7
16,25,105,11,12,-1
16,25,106,14,14,0
16,25,107,16,11,5
16,25,108,11,13,-2
16,25,109,20,10,10
16,25,110,12,14,-2
16,25,111,17,19,-2
16,25,112,13,8,5
16,25,113,22,6,16
16,25,114,20,18,2
16,25,115,14,23,-9
16,25,116,20,10,10
16,25,117,22,5,17
16,25,118,22,14,8
16,25,119,15,19,-4
16,25,120,16,20,-4
16,25,121,14,19,-5
16,25,122,35,14,21
16,25,123,7,9,-2
16,25,124,21,11,10
16,25,125,19,12,7
16,25,126,16,8,8
16,25,127,12,17,-5
16,25,128,16,8,8
16,25,129,17,10,7
16,25,130,10,11,-1
16,25,131,25,23,2
16,25,132,13,11,2
16,25,133,21,11,10
16,25,134,23,27,-4
16,25,135,18,14,4
16,25,136,24,11,13
16,25,137,10,9,1
16,25,138,8,17,-9
16,25,139,16,12,4
16,25,140,16,24,-8
16,25,141,21,17,4
16,25,142,17,13,4
16,25,143,9,8,1
16,25,144,14,6,8
16,25,145,20,20,0
16,25,146,21,13,8
16,25,147,24,12,12
16,25,148,23,9,14
16,25,149,21,11,10
16,25,150,16,7,9
16,25,151,16,8,8
16,25,152,15,10,5
16,25,153,13,9,4
16,25,154,10,11,-1
16,25,155,7,20,-13
16,25,156,13,18,-5
16,25,157,13,20,-7
16,25,158,22,10,12
16,25,159,6,2,4
16,25,160,15,8,7
16,25,161,20,18,2
16,25,162,14,10,4
16,25,163,9,6,3
16,25,164,18,11,7
16,25,165,13,22,-9
16,25,166,22,16,6
16,25,167,24,20,4
16,25,168,8,10,-2
16,25,169,25,23,2
16,25,170,24,13,11
16,25,171,26,18,8
16,25,172,25,11,14
16,25,173,10,13,-3
16,25,174,18,8,10
16,25,175,23,4,19
16,25,176,21,14,7
16,25,177,20,18,2
16,25,178,14,16,-2
16,25,179,23,17,6
16,25,180,9,11,-2
16,25,181,5,10,-5
16,25,182,10,4,6
16,25,183,9,18,-9
16,25,184,17,17,0
16,25,185,20,13,7
16,25,186,13,12,1
16,25,187,29,12,17
16,25,188,21,25,-4
16,25,189,15,14,1
16,25,190,26,9,17
16,25,191,16,9,7
16,25,192,13,12,1
16,25,193,20,8,12
16,25,194,11,11,0
16,25,195,11,14,-3
16,25,196,12,14,-2
16,25,197,15,11,4
16,25,198,11,11,0
16,25,199,19,20,-1
16,25,200,17,17,0
16,25,201,20,7,13
16,25,202,7,4,3
16,25,203,11,14,-3
16,25,204,7,13,-6
16,25,205,20,16,4
16,25,206,18,14,4
16,25,207,16,8,8
16,25,208,24,18,6
16,25,209,20,9,11
16,25,210,21,19,2
16,25,211,22,15,7
16,25,212,21,15,6
16,25,213,17,4,13
16,25,214,21,17,4
16,25,215,14,6,8
16,25,216,11,9,2
16,25,217,15,10,5
16,25,218,6,32,-26
16,25,219,12,9,3
16,25,220,14,4,10
16,25,221,15,14,1
16,25,222,12,8,4
16,25,223,11,11,0
16,25,224,12,4,8
16,25,225,10,15,-5
16,25,226,9,3,6
16,25,227,10,15,-5
16,25,228,8,3,5
16,25,229,21,5,16
16,25,230,15,10,5
16,25,231,22,16,6
16,25,232,21,10,11
16,25,233,24,10,14
16,25,234,20,13,7
16,25,235,8,7,1
16,25,236,10,13,-3
16,25,237,17,12,5
16,25,238,25,18,7
16,25,239,10,21,-11
16,25,240,30,15,15
16,25,241,10,4,6
16,25,242,14,7,7
16,25,243,21,14,7
16,25,244,7,6,1
16,25,245,27,27,0
16,25,246,9,10,-1
16,25,247,9,18,-9
16,25,248,19,10,9
16,25,249,20,7,13
16,25,250,20,17,3
16,25,251,12,16,-4
16,25,252,11,3,8
16,25,253,16,18,-2
16,25,254,9,11,-2
16,25,255,14,8,6
16,25,256,22,14,8
16,25,257,7,18,-11
16,25,258,17,16,1
16,25,259,18,23,-5
16,25,260,11,4,7
16,25,261,18,9,9
16,25,262,26,19,7
16,25,263,18,16,2
16,25,264,14,18,-4
16,25,265,9,6,3
16,25,266,8,11,-3
16,25,267,12,17,-5
16,25,268,16,23,-7
16,25,269,22,18,4
16,25,270,17,12,5
16,25,271,10,6,4
16,25,272,15,16,-1
16,25,273,20,10,10
16,25,274,13,14,-1
16,25,275,9,8,1
16,25,276,13,8,5
16,25,277,10,9,1
16,25,278,13,17,-4
16,25,279,14,13,1
16,25,280,12,6,6
16,25,281,17,19,-2
16,25,282,17,13,4
16,25,283,27,21,6
16,25,284,26,24,2
16,25,285,27,23,4
16,25,286,27,19,8
16,25,287,12,16,-4
16,25,288,17,10,7
16,25,289,28,16,12
16,25,290,10,17,-7
16,25,291,10,20,-10
16,25,292,30,15,15
16,25,293,18,11,7
16,25,294,16,29,-13
16,25,295,20,14,6
16,25,296,17,20,-3
16,25,297,14,22,-8
16,25,298,4,11,-7
16,25,299,22,19,3
16,26,0,23,11,12
16,26,1,9,17,-8
16,26,2,26,22,4
16,26,3,23,20,3
16,26,4,4,8,-4
16,26,5,21,10,11
16,26,6,17,6,11
16,26,7,15,6,9
16,26,8,22,15,7
16,26,9,17,9,8
16,26,10,27,15,12
16,26,11,17,8,9
16,26,12,8,8,0
16,26,13,19,13,6
16,26,14,13,18,-5
16,26,15,7,8,-1
16,26,16,22,9,13
16,26,17,17,9,8
16,26,18,16,11,5
16,26,19,13,12,1
16,26,20,14,15,-1
16,26,21,32,13,19
16,26,22,22,19,3
16,26,23,13,14,-1
16,26,24,13,13,0
16,26,25,14,8,6
16,26,26,16,7,9
16,26,27,21,14,7
16,26,28,15,15,0
16,26,29,16,14,2
16,26,30,17,4,13
16,26,31,14,13,1
16,26,32,8,4,4
16,26,33,31,12,19
16,26,34,24,15,9
16,26,35,15,12,3
16,26,36,19,10,9
16,26,37,4,6,-2
16,26,38,26,20,6
16,26,39,18,10,8
16,26,40,13,10,3
16,26,41,17,10,7
16,26,42,15,16,-1
16,26,43,12,13,-1
16,26,44,9,14,-5
16,26,45,15,13,2
16,26,46,6,13,-7
16,26,47,16,13,3
16,26,48,14,8,6
16,26,49,8,3,5
16,26,50,30,15,15
16,26,51,20,17,3
16,26,52,6,29,-23
16,26,53,21,20,1
16,26,54,18,22,-4
16,26,55,11,13,-2
16,26,56,27,15,12
16,26,57,35,20,15
16,26,58,25,23,2
16,26,59,15,18,-3
16,26,60,20,26,-6
16,26,61,16,11,5
16,26,62,33,18,15
16,26,63,8,12,-4
16,26,64,27,5,22
16,26,65,7,12,-5
16,26,66,21,15,6
16,26,67,14,8,6
16,26,68,13,17,-4
16,26,69,26,13,13
16,26,70,10,12,-2
16,26,71,20,12,8
16,26,72,12,20,-8
16,26,73,17,5,12
16,26,74,12,15,-3
16,26,75,24,19,5
16,26,76,17,18,-1
16,26,77,20,9,11
16,26,78,23,19,4
16,26,79,15,23,-8
16,26,80,21,19,2
16,26,81,11,11,0
16,26,82,11,19,-8
16,26,83,7,8,-1
16,26,84,30,22,8
16,26,85,15,11,4
16,26,86,8,10,-2
16,26,87,23,19,4
16,26,88,17,17,0
16,26,89,14,15,-1
16,26,90,17,9,8
16,26,91,22,6,16
16,26,92,14,16,-2
16,26,93,23,19,4
16,26,94,10,9,1
16,26,95,15,18,-3
16,26,96,14,25,-11
16,26,97,14,16,-2
16,26,98,14,14,0
16,26,99,18,4,14
16,26,100,6,5,1
16,26,101,23,17,6
16,26,102,14,13,1
16,26,103,19,13,6
16,26,104,24,9,15
16,26,105,7,9,-2
16,26,106,4,13,-9
16,26,107,12,21,-9
16,26,108,18,19,-1
16,26,109,16,11,5
16,26,110,13,11,2
16,26,111,24,10,14
16,26,112,13,8,5
16,26,113,4,9,-5
16,26,114,17,17,0
16,26,115,11,11,0
16,26,116,14,16,-2
16,26,117,16,15,1
16,26,118,17,19,-2
16,26,119,14,11,3
16,26,120,14,16,-2
16,26,121,15,20,-5
16,26,122,17,12,5
16,26,123,17,12,5
16,26,124,9,14,-5
16,26,125,19,16,3
16,26,126,15,7,8
16,26,127,17,4,13
16,26,128,11,17,-6
16,26,129,14,3,11
16,26,130,21,18,3
16,26,131,12,12,0
16,26,132,10,9,1
16,26,133,22,14,8
16,26,134,13,11,2
16,26,135,6,22,-16
16,26,136,10,22,-12
16,26,137,12,16,-4
16,26,138,19,14,5
16,26,139,14,9,5
16,26,140,24,10,14
16,26,141,17,16,1
16,26,142,19,11,8
16,26,143,9,16,-7
16,26,144,12,8,4
16,26,145,16,19,-3
16,26,146,13,11,2
16,26,147,22,15,7
16,26,148,26,12,14
16,26,149,23,14,9
16,26,150,9,8,1
16,26,151,27,13,14
16,26,152,21,14,7
16,26,153,19,12,7
16,26,154,19,6,13
16,26,155,19,13,6
16,26,156,16,9,7
16,26,157,18,7,11
16,26,158,19,15,4
16,26,159,16,10,6
16,26,160,17,13,4
16,26,161,20,7,13
16,26,162,16,12,4
16,26,163,8,21,-13
16,26,164,15,20,-5
16,26,165,15,10,5
16,26,166,15,14,1
16,26,167,13,13,0
16,26,168,17,15,2
16,26,169,30,12,18
16,26,170,7,6,1
16,26,171,14,9,5
16,26,172,17,12,5
16,26,173,24,18,6
16,26,174,17,12,5
16,26,175,15,12,3
16,26,176,29,18,11
16,26,177,11,11,0
16,26,178,24,13,11
16,26,179,36,23,13
16,26,180,18,13,5
16,26,181,17,14,3
16,26,182,10,5,5
16,26,183,7,9,-2
16,26,184,16,6,10
16,26,185,20,11,9
16,26,186,19,13,6
16,26,187,9,18,-9
16,26,188,16,6,10
16,26,189,12,15,-3
16,26,190,18,14,4
16,26,191,22,17,5
16,26,192,26,18,8
16,26,193,22,11,11
16,26,194,20,14,6
16,26,195,28,14,14
16,26,196,14,15,-1
16,26,197,13,2,11
16,26,198,16,15,1
16,26,199,8,10,-2
16,26,200,20,21,-1
16,26,201,27,16,11
16,26,202,14,11,3
16,26,203,6,12,-6
16,26,204,22,19,3
16,26,205,24,11,13
16,26,206,24,14,10
16,26,207,31,15,16
16,26,208,21,15,6
16,26,209,15,12,3
16,26,210,14,8,6
16,26,211,12,18,-6
16,26,212,24,20,4
16,26,213,22,21,1
16,26,214,10,14,-4
16,26,215,23,7,16
16,26,216,13,13,0
16,26,217,12,10,2
16,26,218,24,19,5
16,26,219,10,8,2
16,26,220,13,9,4
16,26,221,22,11,11
16,26,222,11,18,-7
16,26,223,9,19,-10
16,26,224,11,13,-2
16,26,225,21,8,13
16,26,226,14,12,2
16,26,227,17,7,10
16,26,228,17,18,-1
16,26,229,12,15,-3
16,26,230,18,12,6
16,26,231,13,16,-3
16,26,232,2,16,-14
16,26,233,19,12,7
16,26,234,7,8,-1
16,26,235,29,8,21
16,26,236,23,13,10
16,26,237,24,15,9
16,26,238,13,23,-10
16,26,239,18,25,-7
16,26,240,20,15,5
16,26,241,13,15,-2
16,26,242,17,10,7
16,26,243,11,11,0
16,26,244,12,9,3
16,26,245,22,21,1
16,26,246,14,20,-6
16,26,247,18,25,-7
16,26,248,15,6,9
16,26,249,29,9,20
16,26,250,17,15,2
16,26,251,22,16,6
16,26,252,16,9,7
16,26,253,7,17,-10
16,26,254,10,18,-8
16,26,255,12,6,6
16,26,256,14,14,0
16,26,257,9,8,1
16,26,258,10,16,-6
16,26,259,9,23,-14
16,26,260,13,5,8
16,26,261,10,11,-1
16,26,262,8,13,-5
16,26,263,11,15,-4
16,26,264,14,8,6
16,26,265,20,16,4
16,26,266,17,10,7
16,26,267,15,17,-2
16,26,268,23,23,0
16,26,269,21,11,10
16,26,270,19,12,7
16,26,271,11,19,-8
16,26,272,11,16,-5
16,26,273,10,13,-3
16,26,274,10,10,0
16,26,275,11,11,0
16,26,276,13,11,2
16,26,277,18,16,2
16,26,278,16,6,10
16,26,279,23,19,4
16,26,280,9,6,3
16,26,281,14,10,4
16,26,282,16,14,2
16,26,283,33,12,21
16,26,284,18,12,6
16,26,285,18,12,6
16,26,286,22,8,14
16,26,287,19,13,6
16,26,288,18,12,6
16,26,289,13,10,3
16,26,290,5,6,-1
16,26,291,10,14,-4
16,26,292,20,17,3
16,26,293,19,16,3
16,26,294,7,11,-4
16,26,295,8,11,-3
16,26,296,21,7,14
16,26,297,7,12,-5
16,26,298,9,16,-7
16,26,299,16,16,0
16,27,0,25,7,18
16,27,1,12,16,-4
16,27,2,9,18,-9
16,27,3,8,7,1
16,27,4,14,14,0
16,27,5,17,14,3
16,27,6,15,17,-2
16,27,7,22,13,9
16,27,8,14,9,5
16,27,9,14,9,5
16,27,10,18,2,16
16,27,11,20,19,1
16,27,12,11,12,-1
16,27,13,7,22,-15
16,27,14,29,10,19
16,27,15,8,13,-5
16,27,16,23,19,4
16,27,17,16,24,-8
16,27,18,25,15,10
16,27,19,10,10,0
16,27,20,12,10,2
16,27,21,16,20,-4
16,27,22,13,4,9
16,27,23,12,19,-7
16,27,24,8,12,-4
16,27,25,15,3,12
16,27,26,21,1,20
16,27,27,12,11,1
16,27,28,14,12,2
16,27,29,15,11,4
16,27,30,17,30,-13
16,27,31,13,12,1
16,27,32,17,9,8
16,27,33,19,8,11
16,27,34,12,11,1
16,27,35,10,15,-5
16,27,36,11,14,-3
16,27,37,22,15,7
16,27,38,27,12,15
16,27,39,9,6,3
16,27,40,12,3,9
16,27,41,21,15,6
16,27,42,11,4,7
16,27,43,23,11,12
16,27,44,23,15,8
16,27,45,29,7,22
16,27,46,11,5,6
16,27,47,24,12,12
16,27,48,16,15,1
16,27,49,17,9,8
16,27,50,14,10,4
16,27,51,13,9,4
16,27,52,22,10,12
16,27,53,10,7,3
16,27,54,17,9,8
16,27,55,14,18,-4
16,27,56,8,7,1
16,27,57,22,19,3
16,27,58,11,12,-1
16,27,59,22,14,8
16,27,60,17,10,7
16,27,61,18,20,-2
16,27,62,28,12,16
16,27,63,29,13,16
16,27,64,17,7,10
16,27,65,18,15,3
16,27,66,12,10,2
16,27,67,9,10,-1
16,27,68,15,10,5
16,27,69,25,8,17
16,27,70,21,5,16
16,27,71,11,9,2
16,27,72,15,6,9
16,27,73,11,19,-8
16,27,74,20,5,15
16,27,75,9,14,-5
16,27,76,25,7,18
16,27,77,9,11,-2
16,27,78,17,13,4
16,27,79,8,12,-4
16,27,80,15,8,7
16,27,81,12,11,1
16,27,82,15,14,1
16,27,83,9,14,-5
16,27,84,26,15,11
16,27,85,8,12,-4
16,27,86,13,7,6
16,27,87,18,17,1
16,27,88,18,12,6
16,27,89,21,14,7
16,27,90,17,5,12
16,27,91,15,9,6
16,27,92,15,13,2
16,27,93,14,8,6
16,27,94,12,18,-6
16,27,95,16,15,1
16,27,96,16,11,5
16,27,97,5,8,-3
16,27,98,23,15,8
16,27,99,13,7,6
16,27,100,20,16,4
16,27,101,16,9,7
16,27,102,12,17,-5
16,27,103,14,11,3
16,27,104,31,12,19
16,27,105,15,9,6
16,27,106,15,9,6
16,27,107,10,9,1
16,27,108,15,16,-1
16,27,109,10,5,5
16,27,110,19,13,6
16,27,111,16,16,0
16,27,112,20,15,5
16,27,113,6,10,-4
16,27,114,6,11,-5
16,27,115,33,16,17
16,27,116,7,2,5
16,27,117,19,17,2
16,27,118,20,10,10
16,27,119,10,13,-3
16,27,120,13,7,6
16,27,121,13,9,4
16,27,122,11,8,3
16,27,123,12,17,-5
16,27,124,17,8,9
16,27,125,18,20,-2
16,27,126,21,21,0
16,27,127,13,16,-3
16,27,128,21,15,6
16,27,129,13,16,-3
16,27,130,25,12,13
16,27,131,28,29,-1
16,27,132,12,16,-4
16,27,133,12,3,9
16,27,134,15,8,7
16,27,135,10,11,-1
16,27,136,8,10,-2
16,27,137,12,9,3
16,27,138,11,12,-1
16,27,139,12,11,1
16,27,140,19,13,6
16,27,141,9,11,-2
16,27,142,27,20,7
16,27,143,12,7,5
16,27,144,11,12,-1
16,27,145,19,17,2
16,27,146,7,19,-12
16,27,147,19,25,-6
16,27,148,16,4,12
16,27,149,25,8,17
16,27,150,15,9,6
16,27,151,16,6,10
16,27,152,8,22,-14
16,27,153,11,12,-1
16,27,154,15,9,6
16,27,155,21,19,2
16,27,156,10,17,-7
16,27,157,21,7,14
16,27,158,12,7,5
16,27,159,8,9,-1
16,27,160,22,6,16
16,27,161,29,18,11
16,27,162,23,16,7
16,27,163,19,14,5
16,27,164,20,11,9
16,27,165,13,9,4
16,27,166,30,17,13
16,27,167,14,15,-1
16,27,168,5,13,-8
16,27,169,17,16,1
16,27,170,20,13,7
16,27,171,10,12,-2
16,27,172,10,16,-6
16,27,173,17,20,-3
16,27,174,33,15,18
16,27,175,31,21,10
16,27,176,18,20,-2
16,27,177,16,14,2
16,27,178,18,9,9
16,27,179,24,23,1
16,27,180,5,4,1
16,27,181,10,6,4
16,27,182,21,15,6
16,27,183,32,21,11
16,27,184,29,19,10
16,27,185,22,12,10
16,27,186,25,16,9
16,27,187,4,13,-9
16,27,188,10,8,2
16,27,189,20,4,16
16,27,190,16,11,5
16,27,191,19,21,-2
16,27,192,20,7,13
16,27,193,26,17,9
16,27,194,8,12,-4
16,27,195,17,12,5
16,27,196,21,8,13
16,27,197,16,15,1
16,27,198,19,11,8
16,27,199,20,15,5
16,27,200,12,13,-1
16,27,201,22,14,8
16,27,202,9,12,-3
16,27,203,14,12,2
16,27,204,16,18,-2
16,27,205,9,10,-1
16,27,206,18,17,1
16,27,207,12,6,6
16,27,208,7,9,-2
16,27,209,12,13,-1
16,27,210,17,15,2
16,27,211,18,10,8
16,27,212,21,12,9
16,27,213,27,11,16
16,27,214,24,22,2
16,27,215,18,7,11
16,27,216,10,15,-5
16,27,217,27,16,11
16,27,218,10,8,2
16,27,219,17,12,5
16,27,220,37,14,23
16,27,221,13,9,4
16,27,222,14,23,-9
16,27,223,32,19,13
16,27,224,11,6,5
16,27,225,25,27,-2
16,27,226,13,11,2
16,27,227,23,13,10
16,27,228,5,15,-10
16,27,229,23,10,13
16,27,230,13,10,3
16,27,231,21,20,1
16,27,232,17,6,11
16,27,233,13,8,5
16,27,234,22,12,10
16,27,235,21,12,9
16,27,236,15,13,2
16,27,237,25,12,13
16,27,238,16,10,6
16,27,239,19,23,-4
16,27,240,13,7,6
16,27,241,22,17,5
16,27,242,16,18,-2
16,27,243,18,12,6
16,27,244,8,6,2
16,27,245,11,4,7
16,27,246,18,21,-3
16,27,247,21,15,6
16,27,248,27,17,10
16,27,249,10,15,-5
16,27,250,13,16,-3
16,27,251,19,8,11
16,27,252,10,6,4
16,27,253,9,15,-6
16,27,254,13,10,3
16,27,255,12,7,5
16,27,256,13,9,4
16,27,257,10,16,-6
16,27,258,14,17,-3
16,27,259,29,7,22
16,27,260,24,20,4
16,27,261,14,19,-5
16,27,262,8,7,1
16,27,263,14,5,9
16,27,264,24,9,15
16,27,265,10,15,-5
16,27,266,21,16,5
16,27,267,15,9,6
16,27,268,16,5,11
16,27,269,29,13,16
16,27,270,14,11,3
16,27,271,6,15,-9
16,27,272,12,17,-5
16,27,273,19,14,5
16,27,274,9,6,3
16,27,275,14,9,5
16,27,276,12,8,4
16,27,277,20,7,13
16,27,278,20,21,-1
16,27,279,9,13,-4
16,27,280,14,14,0
16,27,281,19,12,7
16,27,282,12,10,2
16,27,283,29,9,20
16,27,284,8,17,-9
16,27,285,14,11,3
16,27,286,21,19,2
16,27,287,9,7,2
16,27,288,28,19,9
16,27,289,15,25,-10
16,27,290,7,11,-4
16,27,291,23,15,8
16,27,292,8,14,-6
16,27,293,24,11,13
16,27,294,18,12,6
16,27,295,19,12,7
16,27,296,16,28,-12
16,27,297,12,9,3
16,27,298,23,12,11
16,27,299,7,11,-4
16,28,0,7,17,-10
16,28,1,16,8,8
16,28,2,4,7,-3
16,28,3,21,20,1
16,28,4,9,12,-3
16,28,5,21,2,19
16,28,6,23,18,5
16,28,7,10,11,-1
16,28,8,18,12,6
16,28,9,16,22,-6
16,28,10,22,19,3
16,28,11,17,8,9
16,28,12,16,15,1
16,28,13,19,20,-1
16,28,14,17,2,15
16,28,15,21,6,15
16,28,16,20,8,12
16,28,17,14,12,2
16,28,18,21,15,6
16,28,19,21,19,2
16,28,20,13,12,1
16,28,21,23,17,6
16,28,22,3,13,-10
16,28,23,12,12,0
16,28,24,18,16,2
16,28,25,12,15,-3
16,28,26,19,18,1
16,28,27,11,12,-1
16,28,28,15,14,1
16,28,29,19,7,12
16,28,30,19,6,13
16,28,31,32,10,22
16,28,32,21,13,8
16,28,33,12,17,-5
16,28,34,24,17,7
16,28,35,17,10,7
16,28,36,12,16,-4
16,28,37,16,10,6
16,28,38,10,19,-9
16,28,39,18,11,7
16,28,40,21,7,14
16,28,41,21,18,3
16,28,42,18,16,2
16,28,43,19,15,4
16,28,44,18,11,7
16,28,45,20,17,3
16,28,46,7,9,-2
16,28,47,14,15,-1
16,28,48,16,3,13
16,28,49,17,12,5
16,28,50,25,12,13
16,28,51,10,10,0
16,28,52,20,12,8
16,28,53,21,11,10
16,28,54,14,12,2
16,28,55,11,7,4
16,28,56,18,11,7
16,28,57,19,11,8
16,28,58,20,5,15
16,28,59,12,5,7
16,28,60,15,6,9
16,28,61,21,12,9
16,28,62,26,18,8
16,28,63,12,3,9
16,28,64,17,6,11
16,28,65,22,15,7
16,28,66,22,12,10
16,28,67,14,13,1
16,28,68,17,9,8
16,28,69,21,19,2
16,28,70,24,15,9
16,28,71,27,16,11
16,28,72,16,10,6
16,28,73,22,14,8
16,28,74,15,18,-3
16,28,75,8,12,-4
16,28,76,5,13,-8
16,28,77,20,18,2
16,28,78,7,7,0
16,28,79,20,9,11
16,28,80,11,15,-4
16,28,81,8,13,-5
16,28,82,19,12,7
16,28,83,17,17,0
16,28,84,27,5,22
16,28,85,13,8,5
16,28,86,20,33,-13
16,28,87,25,10,15
16,28,88,13,8,5
16,28,89,20,17,3
16,28,90,15,11,4
16,28,91,20,11,9
16,28,92,11,12,-1
16,28,93,17,3,14
16,28,94,34,17,17
16,28,95,19,15,4
16,28,96,15,13,2
16,28,97,11,13,-2
16,28,98,7,8,-1
16,28,99,9,12,-3
16,28,100,18,3,15
16,28,101,28,22,6
16,28,102,10,17,-7
16,28,103,17,18,-1
16,28,104,21,15,6
16,28,105,16,17,-1
16,28,106,29,21,8
16,28,107,10,6,4
16,28,108,20,22,-2
16,28,109,16,11,5
16,28,110,17,5,12
16,28,111,10,22,-12
16,28,112,17,8,9
16,28,113,6,7,-1
16,28,114,6,15,-9
16,28,115,10,11,-1
16,28,116,23,17,6
16,28,117,25,11,14
16,28,118,17,21,-4
16,28,119,19,10,9
16,28,120,8,7,1
16,28,121,24,18,6
16,28,122,21,9,12
16,28,123,14,10,4
16,28,124,21,12,9
16,28,125,18,7,11
16,28,126,27,13,14
16,28,127,28,15,13
16,28,128,18,10,8
16,28,129,15,14,1
16,28,130,9,12,-3
16,28,131,11,15,-4
16,28,132,23,12,11
16,28,133,19,7,12
16,28,134,4,11,-7
16,28,135,1,2,-1
16,28,136,5,8,-3
16,28,137,15,8,7
16,28,138,17,6,11
16,28,139,14,7,7
16,28,140,9,7,2
16,28,141,20,13,7
16,28,142,23,15,8
16,28,143,8,6,2
16,28,144,8,4,4
16,28,145,8,6,2
16,28,146,22,20,2
16,28,147,8,12,-4
16,28,148,8,10,-2
16,28,149,12,16,-4
16,28,150,25,14,11
16,28,151,7,19,-12
16,28,152,16,14,2
16,28,153,18,14,4
16,28,154,30,14,16
16,28,155,16,13,3
16,28,156,14,12,2
16,28,157,21,20,1
16,28,158,21,6,15
16,28,159,8,9,-1
16,28,160,14,8,6
16,28,161,19,18,1
16,28,162,11,14,-3
16,28,163,20,10,10
16,28,164,15,21,-6
16,28,165,14,11,3
16,28,166,14,16,-2
16,28,167,11,4,7
16,28,168,21,21,0
16,28,169,7,8,-1
16,28,170,12,7,5
16,28,171,12,19,-7
16,28,172,18,17,1
16,28,173,14,18,-4
16,28,174,23,8,15
16,28,175,18,9,9
16,28,176,15,12,3
16,28,177,8,9,-1
16,28,178,16,16,0
16,28,179,15,21,-6
16,28,180,9,9,0
16,28,181,29,14,15
16,28,182,25,25,0
16,28,183,18,16,2
16,28,184,18,13,5
16,28,185,14,9,5
16,28,186,26,24,2
16,28,187,27,17,10
16,28,188,17,5,12
16,28,189,10,11,-1
16,28,190,5,1,4
16,28,191,10,12,-2
16,28,192,16,17,-1
16,28,193,8,5,3
16,28,194,15,9,6
16,28,195,25,15,10
16,28,196,14,11,3
16,28,197,15,16,-1
16,28,198,21,20,1
16,28,199,7,13,-6
16,28,200,9,13,-4
16,28,201,12,5,7
16,28,202,9,8,1
16,28,203,21,8,13
16,28,204,18,5,13
16,28,205,27,14,13
16,28,206,16,17,-1
16,28,207,18,8,10
16,28,208,12,9,3
16,28,209,6,10,-4
16,28,210,21,15,6
16,28,211,16,19,-3
16,28,212,15,15,0
16,28,213,8,2,6
16,28,214,8,11,-3
16,28,215,16,14,2
16,28,216,21,17,4
16,28,217,12,5,7
16,28,218,21,21,0
16,28,219,7,12,-5
16,28,220,11,17,-6
16,28,221,16,18,-2
16,28,222,13,8,5
16,28,223,8,14,-6
16,28,224,18,6,12
16,28,225,20,13,7
16,28,226,18,12,6
16,28,227,14,10,4
16,28,228,10,16,-6
16,28,229,17,15,2
16,28,230,7,4,3
16,28,231,13,6,7
16,28,232,23,12,11
16,28,233,15,19,-4
16,28,234,11,11,0
16,28,235,17,7,10
16,28,236,14,6,8
16,28,237,7,16,-9
16,28,238,19,19,0
16,28,239,8,10,-2
16,28,240,8,8,0
16,28,241,15,21,-6
16,28,242,25,16,9
16,28,243,4,6,-2
16,28,244,25,18,7
16,28,245,16,8,8
16,28,246,24,14,10
16,28,247,16,11,5
16,28,248,13,15,-2
16,28,249,24,14,10
16,28,250,11,13,-2
16,28,251,11,23,-12
16,28,252,20,17,3
16,28,253,14,14,0
16,28,254,22,30,-8
16,28,255,25,19,6
16,28,256,14,7,7
16,28,257,14,10,4
16,28,258,16,14,2
16,28,259,16,19,-3
16,28,260,15,17,-2
16,28,261,15,13,2
16,28,262,13,15,-2
16,28,263,17,16,1
16,28,264,21,10,11
16,28,265,11,16,-5
16,28,266,6,9,-3
16,28,267,15,13,2
16,28,268,16,15,1
16,28,269,14,15,-1
16,28,270,11,7,4
16,28,271,29,18,11
16,28,272,10,5,5
16,28,273,19,8,11
16,28,274,7,18,-11
16,28,275,20,14,6
16,28,276,14,8,6
16,28,277,14,10,4
16,28,278,8,9,-1
16,28,279,3,4,-1
16,28,280,8,4,4
16,28,281,10,10,0
16,28,282,16,16,0
16,28,283,10,7,3
16,28,284,18,19,-1
16,28,285,28,7,21
16,28,286,20,17,3
16,28,287,17,15,2
16,28,288,15,12,3
16,28,289,19,8,11
16,28,290,18,9,9
16,28,291,22,20,2
16,28,292,18,21,-3
16,28,293,24,15,9
16,28,294,12,19,-7
16,28,295,10,19,-9
16,28,296,10,13,-3
16,28,297,14,13,1
16,28,298,17,33,-16
16,28,299,7,5,2
16,29,0,14,3,11
16,29,1,27,13,14
16,29,2,17,13,4
16,29,3,27,11,16
16,29,4,25,5,20
16,29,5,28,10,18
16,29,6,17,14,3
16,29,7,8,15,-7
16,29,8,3,13,-10
16,29,9,13,10,3
16,29,10,30,19,11
16,29,11,6,9,-3
16,29,12,24,16,8
16,29,13,14,15,-1
16,29,14,18,9,9
16,29,15,11,5,6
16,29,16,13,14,-1
16,29,17,10,20,-10
16,29,18,19,9,10
16,29,19,21,20,1
16,29,20,6,3,3
16,29,21,18,18,0
16,29,22,16,5,11
16,29,23,11,9,2
16,29,24,14,15,-1
16,29,25,11,16,-5
16,29,26,11,13,-2
16,29,27,11,5,6
16,29,28,5,9,-4
16,29,29,16,9,7
16,29,30,15,11,4
16,29,31,18,7,11
16,29,32,13,15,-2
16,29,33,19,11,8
16,29,34,20,9,11
16,29,35,16,18,-2
16,29,36,26,14,12
16,29,37,19,13,6
16,29,38,26,12,14
16,29,39,26,18,8
16,29,40,12,8,4
16,29,41,7,5,2
16,29,42,13,21,-8
16,29,43,21,12,9
16,29,44,19,12,7
16,29,45,14,11,3
16,29,46,18,14,4
16,29,47,20,13,7
16,29,48,21,15,6
16,29,49,15,11,4
16,29,50,12,11,1
16,29,51,20,15,5
16,29,52,15,8,7
16,29,53,18,8,10
16,29,54,11,12,-1
16,29,55,44,16,28
16,29,56,15,11,4
16,29,57,24,15,9
16,29,58,17,13,4
16,29,59,13,8,5
16,29,60,23,7,16
16,29,61,19,20,-1
16,29,62,9,8,1
16,29,63,15,8,7
16,29,64,20,4,16
16,29,65,18,12,6
16,29,66,11,15,-4
16,29,67,13,19,-6
16,29,68,18,10,8
16,29,69,15,11,4
16,29,70,28,14,14
16,29,71,11,6,5
16,29,72,15,9,6
16,29,73,18,15,3
16,29,74,9,15,-6
16,29,75,26,7,19
16,29,76,14,9,5
16,29,77,18,1,17
16,29,78,26,8,18
16,29,79,24,16,8
16,29,80,19,11,8
16,29,81,11,15,-4
16,29,82,10,3,7
16,29,83,18,8,10
16,29,84,9,9,0
16,29,85,15,6,9
16,29,86,12,11,1
16,29,87,10,7,3
16,29,88,15,15,0
16,29,89,16,10,6
16,29,90,16,10,6
16,29,91,24,10,14
16,29,92,25,18,7
16,29,93,20,14,6
16,29,94,23,21,2
16,29,95,16,8,8
16,29,96,9,12,-3
16,29,97,15,7,8
16,29,98,18,16,2
16,29,99,23,7,16
16,29,100,27,15,12
16,29,101,16,7,9
16,29,102,13,22,-9
16,29,103,16,12,4
16,29,104,13,8,5
16,29,105,28,20,8
16,29,106,5,2,3
16,29,107,22,7,15
16,29,108,21,15,6
16,29,109,29,9,20
16,29,110,28,13,15
16,29,111,14,21,-7
16,29,112,14,11,3
16,29,113,13,9,4
16,29,114,23,7,16
16,29,115,13,10,3
16,29,116,22,15,7
16,29,117,18,13,5
16,29,118,26,8,18
16,29,119,7,4,3
16,29,120,42,6,36
16,29,121,20,15,5
16,29,122,20,14,6
16,29,123,14,3,11
16,29,124,28,18,10
16,29,125,16,10,6
16,29,126,11,6,5
16,29,127,18,9,9
16,29,128,26,14,12
16,29,129,9,14,-5
16,29,130,12,6,6
16,29,131,18,9,9
16,29,132,20,9,11
16,29,133,6,6,0
16,29,134,20,8,12
16,29,135,13,7,6
16,29,136,10,12,-2
16,29,137,30,5,25
16,29,138,10,8,2
16,29,139,23,8,15
16,29,140,23,14,9
16,29,141,8,7,1
16,29,142,34,28,6
16,29,143,14,15,-1
16,29,144,11,13,-2
16,29,145,18,14,4
16,29,146,19,9,10
16,29,147,20,10,10
16,29,148,11,16,-5
16,29,149,18,9,9
16,29,150,24,14,10
16,29,151,12,9,3
16,29,152,29,17,12
16,29,153,9,8,1
16,29,154,11,10,1
16,29,155,25,17,8
16,29,156,18,4,14
16,29,157,21,11,10
16,29,158,30,22,8
16,29,159,19,21,-2
16,29,160,15,11,4
16,29,161,21,11,10
16,29,162,28,15,13
16,29,163,18,10,8
16,29,164,15,11,4
16,29,165,5,10,-5
16,29,166,9,9,0
16,29,167,15,11,4
16,29,168,3,15,-12
16,29,169,18,8,10
16,29,170,4,17,-13
16,29,171,6,14,-8
16,29,172,20,11,9
16,29,173,17,5,12
16,29,174,14,12,2
16,29,175,8,14,-6
16,29,176,10,16,-6
16,29,177,8,1,7
16,29,178,8,8,0
16,29,179,13,4,9
16,29,180,12,10,2
16,29,181,25,17,8
16,29,182,24,12,12
16,29,183,12,5,7
16,29,184,13,16,-3
16,29,185,11,7,4
16,29,186,11,18,-7
16,29,187,22,10,12
16,29,188,12,14,-2
16,29,189,12,15,-3
16,29,190,22,12,10
16,29,191,5,3,2
16,29,192,21,19,2
16,29,193,17,14,3
16,29,194,15,4,11
16,29,195,18,13,5
16,29,196,18,6,12
16,29,197,18,12,6
16,29,198,13,22,-9
16,29,199,13,10,3
16,29,200,17,18,-1
16,29,201,13,25,-12
16,29,202,12,7,5
16,29,203,22,10,12
16,29,204,9,7,2
16,29,205,24,24,0
16,29,206,16,12,4
16,29,207,18,13,5
16,29,208,16,12,4
16,29,209,15,9,6
16,29,210,21,9,12
16,29,211,21,13,8
16,29,212,16,11,5
16,29,213,11,12,-1
16,29,214,9,12,-3
16,29,215,19,20,-1
16,29,216,3,14,-11
16,29,217,13,11,2
16,29,218,29,23,6
16,29,219,14,21,-7
16,29,220,16,8,8
16,29,221,10,15,-5
16,29,222,11,15,-4
16,29,223,11,8,3
16,29,224,28,11,17
16,29,225,17,13,4
16,29,226,8,5,3
16,29,227,17,9,8
16,29,228,8,23,-15
16,29,229,14,18,-4
16,29,230,20,12,8
16,29,231,20,19,1
16,29,232,27,25,2
16,29,233,14,12,2
16,29,234,15,7,8
16,29,235,22,12,10
16,29,236,7,15,-8
16,29,237,17,10,7
16,29,238,18,7,11
16,29,239,19,11,8
16,29,240,21,8,13
16,29,241,24,16,8
16,29,242,18,13,5
16,29,243,10,13,-3
16,29,244,26,20,6
16,29,245,14,14,0
16,29,246,12,19,-7
16,29,247,28,18,10
16,29,248,9,13,-4
16,29,249,24,5,19
16,29,250,19,7,12
16,29,251,29,17,12
16,29,252,15,10,5
16,29,253,29,10,19
16,29,254,21,10,11
16,29,255,23,10,13
16,29,256,11,4,7
16,29,257,25,10,15
16,29,258,20,18,2
16,29,259,10,11,-1
16,29,260,13,10,3
16,29,261,23,16,7
16,29,262,10,12,-2
16,29,263,18,9,9
16,29,264,11,11,0
16,29,265,31,10,21
16,29,266,13,9,4
16,29,267,13,9,4
16,29,268,23,8,15
16,29,269,12,2,10
16,29,270,19,15,4
16,29,271,15,10,5
16,29,272,17,6,11
16,29,273,15,10,5
16,29,274,25,13,12
16,29,275,14,11,3
16,29,276,18,8,10
16,29,277,18,18,0
16,29,278,5,4,1
16,29,279,21,11,10
16,29,280,19,11,8
16,29,281,25,7,18
16,29,282,24,16,8
16,29,283,19,24,-5
16,29,284,23,5,18
16,29,285,16,13,3
16,29,286,16,11,5
16,29,287,14,12,2
16,29,288,24,9,15
16,29,289,19,16,3
16,29,290,12,13,-1
16,29,291,17,9,8
16,29,292,15,12,3
16,29,293,13,10,3
16,29,294,9,12,-3
16,29,295,9,12,-3
16,29,296,17,16,1
16,29,297,21,14,7
16,29,298,16,9,7
16,29,299,18,17,1
16,30,0,13,6,7
16,30,1,24,15,9
16,30,2,9,10,-1
16,30,3,14,9,5
16,30,4,38,21,17
16,30,5,15,12,3
16,30,6,8,15,-7
16,30,7,4,7,-3
16,30,8,20,15,5
16,30,9,7,11,-4
16,30,10,13,10,3
16,30,11,14,16,-2
16,30,12,6,5,1
16,30,13,8,11,-3
16,30,14,17,7,10
16,30,15,9,6,3
16,30,16,10,9,1
16,30,17,23,12,11
16,30,18,13,7,6
16,30,19,13,11,2
16,30,20,17,16,1
16,30,21,14,8,6
16,30,22,25,4,21
16,30,23,15,5,10
16,30,24,9,10,-1
16,30,25,13,13,0
16,30,26,17,12,5
16,30,27,12,11,1
16,30,28,14,6,8
16,30,29,12,12,0
16,30,30,18,7,11
16,30,31,17,15,2
16,30,32,8,10,-2
16,30,33,17,18,-1
16,30,34,21,16,5
16,30,35,8,13,-5
16,30,36,13,12,1
16,30,37,16,18,-2
16,30,38,8,6,2
16,30,39,19,5,14
16,30,40,16,16,0
16,30,41,24,7,17
16,30,42,14,12,2
16,30,43,22,8,14
16,30,44,17,11,6
16,30,45,24,15,9
16,30,46,17,8,9
16,30,47,9,8,1
16,30,48,9,10,-1
16,30,49,7,13,-6
16,30,50,10,4,6
16,30,51,22,9,13
16,30,52,18,12,6
16,30,53,23,10,13
16,30,54,21,17,4
16,30,55,14,5,9
16,30,56,16,15,1
16,30,57,17,19,-2
16,30,58,22,8,14
16,30,59,21,4,17
16,30,60,10,12,-2
16,30,61,18,8,10
16,30,62,18,4,14
16,30,63,20,11,9
16,30,64,11,3,8
16,30,65,16,12,4
16,30,66,20,13,7
16,30,67,19,6,13
16,30,68,25,16,9
16,30,69,25,18,7
16,30,70,14,13,1
16,30,71,6,8,-2
16,30,72,15,18,-3
16,30,73,9,13,-4
16,30,74,20,17,3
16,30,75,14,9,5
16,30,76,8,1,7
16,30,77,9,10,-1
16,30,78,11,16,-5
16,30,79,15,6,9
16,30,80,12,9,3
16,30,81,6,4,2
16,30,82,16,3,13
16,30,83,15,11,4
16,30,84,13,13,0
16,30,85,5,13,-8
16,30,86,15,16,-1
16,30,87,18,9,9
16,30,88,26,17,9
16,30,89,23,12,11
16,30,90,12,12,0
16,30,91,16,13,3
16,30,92,18,8,10
16,30,93,10,6,4
16,30,94,29,13,16
16,30,95,21,11,10
16,30,96,19,15,4
16,30,97,17,11,6
16,30,98,2,5,-3
16,30,99,27,7,20
16,30,100,9,13,-4
16,30,101,18,7,11
16,30,102,31,14,17
16,30,103,16,11,5
16,30,104,32,8,24
16,30,105,14,8,6
16,30,106,20,9,11
16,30,107,18,7,11
16,30,108,28,18,10
16,30,109,30,11,19
16,30,110,17,12,5
16,30,111,20,12,8
16,30,112,12,6,6
16,30,113,30,9,21
16,30,114,12,15,-3
16,30,115,8,12,-4
16,30,116,5,13,-8
16,30,117,21,14,7
16,30,118,23,15,8
16,30,119,14,10,4
16,30,120,21,8,13
16,30,121,15,10,5
16,30,122,13,10,3
16,30,123,20,16,4
16,30,124,18,7,11
16,30,125,14,11,3
16,30,126,16,9,7
16,30,127,14,2,12
16,30,128,14,11,3
16,30,129,16,17,-1
16,30,130,20,10,10
16,30,131,21,21,0
16,30,132,34,4,30
16,30,133,18,15,3
16,30,134,16,13,3
16,30,135,12,19,-7
16,30,136,11,11,0
16,30,137,14,9,5
16,30,138,18,4,14
16,30,139,20,18,2
16,30,140,8,6,2
16,30,141,16,10,6
16,30,142,22,19,3
16,30,143,9,7,2
16,30,144,17,7,10
16,30,145,11,10,1
16,30,146,24,5,19
16,30,147,10,11,-1
16,30,148,23,17,6
16,30,149,23,18,5
16,30,150,7,14,-7
16,30,151,15,19,-4
16,30,152,21,12,9
16,30,153,13,5,8
16,30,154,11,12,-1
16,30,155,4,9,-5
16,30,156,21,6,15
16,30,157,12,5,7
16,30,158,16,11,5
16,30,159,10,4,6
16,30,160,12,13,-1
16,30,161,28,13,15
16,30,162,20,5,15
16,30,163,27,8,19
16,30,164,10,6,4
16,30,165,19,21,-2
16,30,166,9,10,-1
16,30,167,29,19,10
16,30,168,17,11,6
16,30,169,12,15,-3
16,30,170,7,6,1
16,30,171,15,21,-6
16,30,172,11,7,4
16,30,173,11,11,0
16,30,174,23,14,9
16,30,175,13,11,2
16,30,176,15,7,8
16,30,177,9,19,-10
16,30,178,15,19,-4
16,30,179,16,12,4
16,30,180,14,3,11
16,30,181,6,15,-9
16,30,182,14,14,0
16,30,183,10,4,6
16,30,184,7,8,-1
16,30,185,16,9,7
16,30,186,19,17,2
16,30,187,19,16,3
16,30,188,6,14,-8
16,30,189,17,12,5
16,30,190,16,5,11
16,30,191,29,16,13
16,30,192,20,12,8
16,30,193,17,15,2
16,30,194,12,12,0
16,30,195,10,1,9
16,30,196,17,9,8
16,30,197,42,23,19
16,30,198,22,21,1
16,30,199,11,11,0
16,30,200,8,10,-2
16,30,201,13,16,-3
16,30,202,12,12,0
16,30,203,16,8,8
16,30,204,17,11,6
16,30,205,21,9,12
16,30,206,16,11,5
16,30,207,11,16,-5
16,30,208,11,11,0
16,30,209,13,8,5
16,30,210,12,9,3
16,30,211,21,30,-9
16,30,212,3,5,-2
16,30,213,12,11,1
16,30,214,17,14,3
16,30,215,8,4,4
16,30,216,14,8,6
16,30,217,14,10,4
16,30,218,19,13,6
16,30,219,13,10,3
16,30,220,15,3,12
16,30,221,12,19,-7
16,30,222,27,13,14
16,30,223,11,5,6
16,30,224,7,12,-5
16,30,225,14,10,4
16,30,226,3,13,-10
16,30,227,9,12,-3
16,30,228,18,13,5
16,30,229,17,12,5
16,30,230,20,15,5
16,30,231,23,13,10
16,30,232,19,19,0
16,30,233,16,8,8
16,30,234,19,10,9
16,30,235,20,13,7
16,30,236,24,18,6
16,30,237,19,4,15
16,30,238,13,12,1
16,30,239,21,6,15
16,30,240,4,7,-3
16,30,241,9,16,-7
16,30,242,7,7,0
16,30,243,30,23,7
16,30,244,13,14,-1
16,30,245,19,16,3
16,30,246,20,14,6
16,30,247,10,15,-5
16,30,248,12,12,0
16,30,249,10,12,-2
16,30,250,26,12,14
16,30,251,21,16,5
16,30,252,11,16,-5
16,30,253,23,14,9
16,30,254,21,15,6
16,30,255,11,6,5
16,30,256,7,3,4
16,30,257,4,8,-4
16,30,258,24,8,16
16,30,259,14,20,-6
16,30,260,6,8,-2
16,30,261,13,6,7
16,30,262,17,9,8
16,30,263,11,18,-7
16,30,264,18,20,-2
16,30,265,16,10,6
16,30,266,13,19,-6
16,30,267,13,6,7
16,30,268,19,7,12
16,30,269,4,17,-13
16,30,270,19,15,4
16,30,271,23,7,16
16,30,272,29,19,10
16,30,273,19,13,6
16,30,274,17,5,12
16,30,275,23,6,17
16,30,276,20,11,9
16,30,277,24,9,15
16,30,278,13,10,3
16,30,279,24,13,11
16,30,280,12,13,-1
16,30,281,10,11,-1
16,30,282,11,9,2
16,30,283,17,13,4
16,30,284,17,19,-2
16,30,285,14,3,11
16,30,286,19,12,7
16,30,287,7,12,-5
16,30,288,14,15,-1
16,30,289,16,6,10
16,30,290,23,16,7
16,30,291,6,7,-1
16,30,292,22,11,11
16,30,293,7,11,-4
16,30,294,15,7,8
16,30,295,20,14,6
16,30,296,14,1,13
16,30,297,13,8,5
16,30,298,21,11,10
16,30,299,27,20,7
17,1,0,5,23,-18
17,1,1,12,11,1
17,1,2,6,15,-9
17,1,3,12,17,-5
17,1,4,7,4,3
17,1,5,9,18,-9
17,1,6,9,8,1
17,1,7,11,13,-2
17,1,8,12,16,-4
17,1,9,5,14,-9
17,1,10,10,17,-7
17,1,11,9,12,-3
17,1,12,15,18,-3
17,1,13,8,16,-8
17,1,14,7,15,-8
17,1,15,8,20,-12
17,1,16,21,12,9
17,1,17,8,16,-8
17,1,18,12,12,0
17,1,19,12,18,-6
17,1,20,8,21,-13
17,1,21,7,17,-10
17,1,22,4,16,-12
17,1,23,9,18,-9
17,1,24,13,23,-10
17,1,25,9,30,-21
17,1,26,8,15,-7
17,1,27,1,19,-18
17,1,28,16,26,-10
17,1,29,10,9,1
17,1,30,10,24,-14
17,1,31,12,14,-2
17,1,32,8,18,-10
17,1,33,7,43,-36
17,1,34,8,26,-18
17,1,35,9,16,-7
17,1,36,11,22,-11
17,1,37,5,25,-20
17,1,38,14,19,-5
17,1,39,15,21,-6
17,1,40,1,6,-5
17,1,41,15,18,-3
17,1,42,13,14,-1
17,1,43,4,12,-8
17,1,44,6,7,-1
17,1,45,8,5,3
17,1,46,11,18,-7
17,1,47,17,19,-2
17,1,48,11,13,-2
17,1,49,14,19,-5
17,1,50,11,16,-5
17,1,51,4,5,-1
17,1,52,1,13,-12
17,1,53,13,9,4
17,1,54,15,23,-8
17,1,55,14,22,-8
17,1,56,5,16,-11
17,1,57,12,20,-8
17,1,58,16,14,2
17,1,59,5,3,2
17,1,60,13,36,-23
17,1,61,13,8,5
17,1,62,4,13,-9
17,1,63,11,28,-17
17,1,64,5,16,-11
17,1,65,10,20,-10
17,1,66,7,14,-7
17,1,67,16,14,2
17,1,68,4,14,-10
17,1,69,15,14,1
17,1,70,4,15,-11
17,1,71,4,9,-5
17,1,72,5,14,-9
17,1,73,11,27,-16
17,1,74,15,14,1
17,1,75,4,10,-6
17,1,76,4,3,1
17,1,77,0,6,-6
17,1,78,1,6,-5
17,1,79,4,19,-15
17,1,80,0,8,-8
17,1,81,9,24,-15
17,1,82,5,17,-12
17,1,83,4,11,-7
17,1,84,6,15,-9
17,1,85,10,23,-13
17,1,86,14,25,-11
17,1,87,10,17,-7
17,1,88,6,18,-12
17,1,89,7,14,-7
17,1,90,12,13,-1
17,1,91,8,10,-2
17,1,92,11,27,-16
17,1,93,5,8,-3
17,1,94,5,16,-11
17,1,95,8,8,0
17,1,96,2,12,-10
17,1,97,17,15,2
17,1,98,4,16,-12
17,1,99,7,25,-18
17,1,100,8,14,-6
17,1,101,10,18,-8
17,1,102,9,14,-5
17,1,103,12,11,1
17,1,104,17,17,0
17,1,105,19,21,-2
17,1,106,17,19,-2
17,1,107,7,18,-11
17,1,108,7,12,-5
17,1,109,7,19,-12
17,1,110,5,14,-9
17,1,111,10,18,-8
17,1,112,12,17,-5
17,1,113,7,15,-8
17,1,114,6,15,-9
17,1,115,8,18,-10
17,1,116,5,12,-7
17,1,117,12,21,-9
17,1,118,9,23,-14
17,1,119,3,21,-18
17,1,120,14,15,-1
17,1,121,7,22,-15
17,1,122,6,11,-5
17,1,123,8,16,-8
17,1,124,2,14,-12
17,1,125,11,28,-17
17,1,126,5,10,-5
17,1,127,14,34,-20
17,1,128,8,13,-5
17,1,129,2,13,-11
17,1,130,6,14,-8
17,1,131,4,7,-3
17,1,132,3,11,-8
17,1,133,12,22,-10
17,1,134,13,22,-9
17,1,135,7,9,-2
17,1,136,6,6,0
17,1,137,10,32,-22
17,1,138,8,9,-1
17,1,139,1,16,-15
17,1,140,9,11,-2
17,1,141,13,15,-2
17,1,142,7,12,-5
17,1,143,7,21,-14
17,1,144,0,9,-9
17,1,145,11,12,-1
17,1,146,7,5,2
17,1,147,8,6,2
17,1,148,12,11,1
17,1,149,12,27,-15
17,1,150,6,18,-12
17,1,151,4,10,-6
17,1,152,7,10,-3
17,1,153,9,23,-14
17,1,154,6,20,-14
17,1,155,14,15,-1
17,1,156,11,12,-1
17,1,157,10,23,-13
17,1,158,5,15,-10
17,1,159,13,12,1
17,1,160,7,10,-3
17,1,161,4,24,-20
17,1,162,6,9,-3
17,1,163,10,14,-4
17,1,164,4,10,-6
17,1,165,10,19,-9
17,1,166,11,12,-1
17,1,167,4,13,-9
17,1,168,5,15,-10
17,1,169,4,18,-14
17,1,170,9,6,3
17,1,171,10,16,-6
17,1,172,3,12,-9
17,1,173,13,23,-10
17,1,174,22,11,11
17,1,175,7,13,-6
17,1,176,10,11,-1
17,1,177,16,26,-10
17,1,178,15,14,1
17,1,179,0,19,-19
17,1,180,6,15,-9
17,1,181,4,18,-14
17,1,182,14,16,-2
17,1,183,10,17,-7
17,1,184,5,18,-13
17,1,185,13,22,-9
17,1,186,12,29,-17
17,1,187,7,18,-11
17,1,188,11,17,-6
17,1,189,7,16,-9
17,1,190,4,7,-3
17,1,191,7,20,-13
17,1,192,14,14,0
17,1,193,11,14,-3
17,1,194,8,17,-9
17,1,195,4,10,-6
17,1,196,8,10,-2
17,1,197,10,15,-5
17,1,198,7,17,-10
17,1,199,8,15,-7
17,1,200,12,17,-5
17,1,201,9,27,-18
17,1,202,13,19,-6
17,1,203,14,18,-4
17,1,204,12,14,-2
17,1,205,10,9,1
17,1,206,0,7,-7
17,1,207,11,16,-5
17,1,208,12,7,5
17,1,209,8,8,0
17,1,210,19,16,3
17,1,211,15,40,-25
17,1,212,17,20,-3
17,1,213,4,9,-5
17,1,214,13,20,-7
17,1,215,9,5,4
17,1,216,19,17,2
17,1,217,0,12,-12
17,1,218,5,15,-10
17,1,219,11,11,0
17,1,220,13,15,-2
17,1,221,3,6,-3
17,1,222,3,16,-13
17,1,223,5,10,-5
17,1,224,9,18,-9
17,1,225,17,12,5
17,1,226,5,21,-16
17,1,227,5,8,-3
17,1,228,12,19,-7
17,1,229,8,15,-7
17,1,230,10,7,3
17,1,231,4,22,-18
17,1,232,5,2,3
17,1,233,16,17,-1
17,1,234,8,6,2
17,1,235,16,24,-8
17,1,236,13,18,-5
17,1,237,8,21,-13
17,1,238,4,17,-13
17,1,239,6,15,-9
17,1,240,8,20,-12
17,1,241,6,9,-3
17,1,242,7,16,-9
17,1,243,6,13,-7
17,1,244,8,8,0
17,1,245,2,10,-8
17,1,246,5,11,-6
17,1,247,10,13,-3
17,1,248,6,12,-6
17,1,249,10,10,0
17,1,250,9,19,-10
17,1,251,4,15,-11
17,1,252,14,21,-7
17,1,253,8,15,-7
17,1,254,7,9,-2
17,1,255,13,16,-3
17,1,256,7,15,-8
17,1,257,5,9,-4
17,1,258,11,12,-1
17,1,259,6,13,-7
17,1,260,6,18,-12
17,1,261,10,27,-17
17,1,262,7,12,-5
17,1,263,9,22,-13
17,1,264,6,8,-2
17,1,265,1,5,-4
17,1,266,9,9,0
17,1,267,10,27,-17
17,1,268,13,27,-14
17,1,269,6,26,-20
17,1,270,10,17,-7
17,1,271,7,12,-5
17,1,272,2,18,-16
17,1,273,6,28,-22
17,1,274,3,27,-24
17,1,275,9,10,-1
17,1,276,4,7,-3
17,1,277,6,10,-4
17,1,278,6,26,-20
17,1,279,4,8,-4
17,1,280,5,19,-14
17,1,281,7,7,0
17,1,282,18,10,8
17,1,283,0,3,-3
17,1,284,2,13,-11
17,1,285,4,14,-10
17,1,286,4,18,-14
17,1,287,8,20,-12
17,1,288,9,21,-12
17,1,289,18,33,-15
17,1,290,4,10,-6
17,1,291,5,14,-9
17,1,292,7,19,-12
17,1,293,2,10,-8
17,1,294,8,11,-3
17,1,295,6,8,-2
17,1,296,11,18,-7
17,1,297,11,12,-1
17,1,298,10,16,-6
17,1,299,20,23,-3
17,2,0,5,20,-15
17,2,1,12,18,-6
17,2,2,9,12,-3
17,2,3,3,19,-16
17,2,4,6,24,-18
17,2,5,3,12,-9
17,2,6,6,3,3
17,2,7,4,10,-6
17,2,8,12,16,-4
17,2,9,10,19,-9
17,2,10,3,18,-15
17,2,11,22,16,6
17,2,12,10,17,-7
17,2,13,8,9,-1
17,2,14,1,13,-12
17,2,15,8,12,-4
17,2,16,5,13,-8
17,2,17,17,13,4
17,2,18,10,14,-4
17,2,19,16,13,3
17,2,20,5,18,-13
17,2,21,10,15,-5
17,2,22,10,11,-1
17,2,23,9,14,-5
17,2,24,13,26,-13
17,2,25,9,11,-2
17,2,26,8,14,-6
17,2,27,4,6,-2
17,2,28,5,26,-21
17,2,29,1,10,-9
17,2,30,4,13,-9
17,2,31,14,15,-1
17,2,32,9,23,-14
17,2,33,14,12,2
17,2,34,1,9,-8
17,2,35,8,16,-8
17,2,36,10,13,-3
17,2,37,15,19,-4
17,2,38,22,40,-18
17,2,39,6,15,-9
17,2,40,7,14,-7
17,2,41,22,22,0
17,2,42,8,20,-12
17,2,43,2,7,-5
17,2,44,10,14,-4
17,2,45,9,28,-19
17,2,46,15,22,-7
17,2,47,23,14,9
17,2,48,5,21,-16
17,2,49,4,24,-20
17,2,50,12,15,-3
17,2,51,7,17,-10
17,2,52,11,12,-1
17,2,53,2,19,-17
17,2,54,4,12,-8
17,2,55,3,25,-22
17,2,56,2,3,-1
17,2,57,14,15,-1
17,2,58,7,15,-8
17,2,59,4,20,-16
17,2,60,5,13,-8
17,2,61,17,23,-6
17,2,62,10,27,-17
17,2,63,7,30,-23
17,2,64,6,18,-12
17,2,65,11,10,1
17,2,66,8,18,-10
17,2,67,9,20,-11
17,2,68,6,5,1
17,2,69,11,19,-8
17,2,70,11,25,-14
17,2,71,12,25,-13
17,2,72,10,14,-4
17,2,73,15,21,-6
17,2,74,13,16,-3
17,2,75,7,22,-15
17,2,76,3,17,-14
17,2,77,10,7,3
17,2,78,10,14,-4
17,2,79,6,14,-8
17,2,80,11,8,3
17,2,81,8,20,-12
17,2,82,9,10,-1
17,2,83,8,9,-1
17,2,84,8,15,-7
17,2,85,13,14,-1
17,2,86,5,16,-11
17,2,87,8,8,0
17,2,88,11,24,-13
17,2,89,7,21,-14
17,2,90,3,19,-16
17,2,91,16,13,3
17,2,92,15,20,-5
17,2,93,6,16,-10
17,2,94,8,27,-19
17,2,95,11,26,-15
17,2,96,4,25,-21
17,2,97,13,23,-10
17,2,98,10,12,-2
17,2,99,4,12,-8
17,2,100,13,30,-17
17,2,101,17,25,-8
17,2,102,12,16,-4
17,2,103,8,11,-3
17,2,104,20,19,1
17,2,105,7,4,3
17,2,106,9,15,-6
17,2,107,5,16,-11
17,2,108,7,8,-1
17,2,109,15,13,2
17,2,110,12,14,-2
17,2,111,4,4,0
17,2,112,9,23,-14
17,2,113,11,10,1
17,2,114,1,11,-10
17,2,115,7,23,-16
17,2,116,11,19,-8
17,2,117,5,3,2
17,2,118,9,16,-7
17,2,119,5,11,-6
17,2,120,18,16,2
17,2,121,3,7,-4
17,2,122,12,17,-5
17,2,123,11,18,-7
17,2,124,6,6,0
17,2,125,12,18,-6
17,2,126,9,17,-8
17,2,127,4,17,-13
17,2,128,11,12,-1
17,2,129,8,26,-18
17,2,130,6,7,-1
17,2,131,7,18,-11
17,2,132,11,16,-5
17,2,133,19,19,0
17,2,134,8,26,-18
17,2,135,10,25,-15
17,2,136,4,8,-4
17,2,137,12,24,-12
17,2,138,4,10,-6
17,2,139,13,12,1
17,2,140,4,12,-8
17,2,141,13,8,5
17,2,142,10,16,-6
17,2,143,8,13,-5
17,2,144,9,16,-7
17,2,145,19,7,12
17,2,146,11,24,-13
17,2,147,7,11,-4
17,2,148,23,29,-6
17,2,149,13,7,6
17,2,150,7,26,-19
17,2,151,6,12,-6
17,2,152,5,17,-12
17,2,153,7,33,-26
17,2,154,13,21,-8
17,2,155,1,24,-23
17,2,156,4,24,-20
17,2,157,9,8,1
17,2,158,8,12,-4
17,2,159,4,23,-19
17,2,160,7,17,-10
17,2,161,10,26,-16
17,2,162,5,21,-16
17,2,163,4,18,-14
17,2,164,5,11,-6
17,2,165,8,11,-3
17,2,166,13,11,2
17,2,167,9,8,1
17,2,168,12,20,-8
17,2,169,12,14,-2
17,2,170,12,29,-17
17,2,171,17,22,-5
17,2,172,6,24,-18
17,2,173,9,18,-9
17,2,174,11,22,-11
17,2,175,11,15,-4
17,2,176,16,14,2
17,2,177,9,21,-12
17,2,178,7,23,-16
17,2,179,9,23,-14
17,2,180,5,20,-15
17,2,181,7,17,-10
17,2,182,3,19,-16
17,2,183,11,17,-6
17,2,184,14,23,-9
17,2,185,12,23,-11
17,2,186,9,31,-22
17,2,187,16,12,4
17,2,188,15,14,1
17,2,189,11,15,-4
17,2,190,6,21,-15
17,2,191,5,21,-16
17,2,192,3,18,-15
17,2,193,13,6,7
17,2,194,12,11,1
17,2,195,5,9,-4
17,2,196,4,19,-15
17,2,197,8,16,-8
17,2,198,4,5,-1
17,2,199,14,21,-7
17,2,200,15,8,7
17,2,201,2,11,-9
17,2,202,9,16,-7
17,2,203,2,19,-17
17,2,204,10,32,-22
17,2,205,7,16,-9
17,2,206,18,12,6
17,2,207,5,8,-3
17,2,208,21,23,-2
17,2,209,5,11,-6
17,2,210,12,8,4
17,2,211,11,9,2
17,2,212,5,24,-19
17,2,213,7,34,-27
17,2,214,16,24,-8
17,2,215,4,15,-11
17,2,216,14,13,1
17,2,217,15,27,-12
17,2,218,16,12,4
17,2,219,9,17,-8
17,2,220,9,11,-2
17,2,221,18,31,-13
17,2,222,4,24,-20
17,2,223,14,14,0
17,2,224,5,34,-29
17,2,225,13,9,4
17,2,226,16,10,6
17,2,227,7,15,-8
17,2,228,8,7,1
17,2,229,9,24,-15
17,2,230,11,15,-4
17,2,231,4,17,-13
17,2,232,10,11,-1
17,2,233,17,25,-8
17,2,234,12,17,-5
17,2,235,5,11,-6
17,2,236,6,19,-13
17,2,237,4,24,-20
17,2,238,7,16,-9
17,2,239,16,21,-5
17,2,240,17,11,6
17,2,241,6,16,-10
17,2,242,11,16,-5
17,2,243,4,18,-14
17,2,244,13,13,0
17,2,245,9,14,-5
17,2,246,6,16,-10
17,2,247,18,33,-15
17,2,248,5,28,-23
17,2,249,10,27,-17
17,2,250,5,7,-2
17,2,251,14,17,-3
17,2,252,5,19,-14
17,2,253,10,9,1
17,2,254,7,11,-4
17,2,255,10,21,-11
17,2,256,18,19,-1
17,2,257,5,7,-2
17,2,258,8,4,4
17,2,259,13,22,-9
17,2,260,7,26,-19
17,2,261,7,13,-6
17,2,262,11,36,-25
17,2,263,20,19,1
17,2,264,8,15,-7
17,2,265,16,18,-2
17,2,266,9,23,-14
17,2,267,15,32,-17
17,2,268,10,21,-11
17,2,269,6,21,-15
17,2,270,4,13,-9
17,2,271,4,4,0
17,2,272,12,9,3
17,2,273,3,15,-12
17,2,274,20,16,4
17,2,275,12,18,-6
17,2,276,5,16,-11
17,2,277,13,25,-12
17,2,278,13,20,-7
17,2,279,8,26,-18
17,2,280,5,13,-8
17,2,281,11,15,-4
17,2,282,1,4,-3
17,2,283,6,7,-1
17,2,284,14,25,-11
17,2,285,4,19,-15
17,2,286,20,22,-2
17,2,287,22,23,-1
17,2,288,6,10,-4
17,2,289,13,29,-16
17,2,290,2,15,-13
17,2,291,11,23,-12
17,2,292,4,17,-13
17,2,293,12,16,-4
17,2,294,6,6,0
17,2,295,12,18,-6
17,2,296,21,16,5
17,2,297,6,18,-12
17,2,298,14,18,-4
17,2,299,9,13,-4
17,3,0,3,0,3
17,3,1,18,24,-6
17,3,2,13,24,-11
17,3,3,9,20,-11
17,3,4,4,18,-14
17,3,5,9,17,-8
17,3,6,2,17,-15
17,3,7,7,27,-20
17,3,8,24,12,12
17,3,9,10,17,-7
17,3,10,8,22,-14
17,3,11,3,21,-18
17,3,12,9,24,-15
17,3,13,22,29,-7
17,3,14,7,17,-10
17,3,15,10,16,-6
17,3,16,11,19,-8
17,3,17,5,11,-6
17,3,18,9,10,-1
17,3,19,5,11,-6
17,3,20,8,24,-16
17,3,21,8,13,-5
17,3,22,8,16,-8
17,3,23,4,23,-19
17,3,24,8,19,-11
17,3,25,8,21,-13
17,3,26,16,14,2
17,3,27,7,22,-15
17,3,28,9,14,-5
17,3,29,10,15,-5
17,3,30,4,24,-20
17,3,31,10,16,-6
17,3,32,3,12,-9
17,3,33,18,16,2
17,3,34,5,18,-13
17,3,35,9,13,-4
17,3,36,5,8,-3
17,3,37,11,24,-13
17,3,38,9,26,-17
17,3,39,4,21,-17
17,3,40,6,8,-2
17,3,41,12,18,-6
17,3,42,9,10,-1
17,3,43,6,19,-13
17,3,44,2,5,-3
17,3,45,12,10,2
17,3,46,10,16,-6
17,3,47,13,24,-11
17,3,48,5,18,-13
17,3,49,12,19,-7
17,3,50,9,28,-19
17,3,51,15,10,5
17,3,52,17,18,-1
17,3,53,10,22,-12
17,3,54,7,8,-1
17,3,55,8,9,-1
17,3,56,15,16,-1
17,3,57,13,7,6
17,3,58,4,12,-8
17,3,59,12,19,-7
17,3,60,7,14,-7
17,3,61,14,30,-16
17,3,62,8,17,-9
17,3,63,10,12,-2
17,3,64,13,23,-10
17,3,65,7,12,-5
17,3,66,8,22,-14
17,3,67,9,14,-5
17,3,68,6,6,0
17,3,69,8,10,-2
17,3,70,6,17,-11
17,3,71,9,15,-6
17,3,72,8,10,-2
17,3,73,13,9,4
17,3,74,1,11,-10
17,3,75,15,26,-11
17,3,76,4,6,-2
17,3,77,12,16,-4
17,3,78,8,15,-7
17,3,79,14,38,-24
17,3,80,12,11,1
17,3,81,14,19,-5
17,3,82,14,18,-4
17,3,83,8,7,1
17,3,84,8,13,-5
17,3,85,2,11,-9
17,3,86,6,12,-6
17,3,87,11,16,-5
17,3,88,18,28,-10
17,3,89,17,19,-2
17,3,90,17,23,-6
17,3,91,27,28,-1
17,3,92,12,22,-10
17,3,93,12,17,-5
17,3,94,8,27,-19
17,3,95,13,22,-9
17,3,96,11,28,-17
17,3,97,8,20,-12
17,3,98,8,20,-12
17,3,99,11,13,-2
17,3,100,22,28,-6
17,3,101,6,8,-2
17,3,102,4,14,-10
17,3,103,5,20,-15
17,3,104,10,5,5
17,3,105,18,26,-8
17,3,106,3,15,-12
17,3,107,3,27,-24
17,3,108,8,22,-14
17,3,109,18,22,-4
17,3,110,5,17,-12
17,3,111,12,25,-13
17,3,112,10,32,-22
17,3,113,7,18,-11
17,3,114,16,16,0
17,3,115,1,13,-12
17,3,116,18,11,7
17,3,117,4,8,-4
17,3,118,8,25,-17
17,3,119,10,24,-14
17,3,120,7,18,-11
17,3,121,8,19,-11
17,3,122,11,25,-14
17,3,123,5,11,-6
17,3,124,20,23,-3
17,3,125,8,16,-8
17,3,126,14,20,-6
17,3,127,3,14,-11
17,3,128,14,13,1
17,3,129,14,13,1
17,3,130,10,22,-12
17,3,131,14,19,-5
17,3,132,8,15,-7
17,3,133,4,16,-12
17,3,134,7,28,-21
17,3,135,17,18,-1
17,3,136,9,8,1
17,3,137,6,17,-11
17,3,138,9,12,-3
17,3,139,11,18,-7
17,3,140,10,19,-9
17,3,141,3,15,-12
17,3,142,8,10,-2
17,3,143,9,9,0
17,3,144,21,18,3
17,3,145,9,21,-12
17,3,146,9,14,-5
17,3,147,4,14,-10
17,3,148,6,15,-9
17,3,149,3,17,-14
17,3,150,14,12,2
17,3,151,4,21,-17
17,3,152,7,13,-6
17,3,153,6,17,-11
17,3,154,16,5,11
17,3,155,12,18,-6
17,3,156,3,21,-18
17,3,157,5,9,-4
17,3,158,5,5,0
17,3,159,10,17,-7
17,3,160,6,6,0
17,3,161,9,15,-6
17,3,162,14,22,-8
17,3,163,18,21,-3
17,3,164,5,16,-11
17,3,165,13,16,-3
17,3,166,10,11,-1
17,3,167,16,22,-6
17,3,168,9,1,8
17,3,169,10,16,-6
17,3,170,11,17,-6
17,3,171,11,17,-6
17,3,172,15,22,-7
17,3,173,8,11,-3
17,3,174,23,14,9
17,3,175,4,15,-11
17,3,176,9,23,-14
17,3,177,11,19,-8
17,3,178,9,21,-12
17,3,179,9,9,0
17,3,180,11,17,-6
17,3,181,8,20,-12
17,3,182,9,14,-5
17,3,183,14,19,-5
17,3,184,7,23,-16
17,3,185,7,18,-11
17,3,186,9,22,-13
17,3,187,11,17,-6
17,3,188,6,21,-15
17,3,189,8,24,-16
17,3,190,7,18,-11
17,3,191,13,23,-10
17,3,192,10,12,-2
17,3,193,8,11,-3
17,3,194,7,12,-5
17,3,195,11,25,-14
17,3,196,5,9,-4
17,3,197,7,21,-14
17,3,198,7,18,-11
17,3,199,6,27,-21
17,3,200,8,14,-6
17,3,201,16,23,-7
17,3,202,6,14,-8
17,3,203,12,9,3
17,3,204,16,15,1
17,3,205,10,12,-2
17,3,206,18,20,-2
17,3,207,21,8,13
17,3,208,12,8,4
17,3,209,12,38,-26
17,3,210,13,9,4
17,3,211,6,24,-18
17,3,212,11,14,-3
17,3,213,13,8,5
17,3,214,14,23,-9
17,3,215,14,22,-8
17,3,216,10,10,0
17,3,217,8,12,-4
17,3,218,14,17,-3
17,3,219,12,7,5
17,3,220,16,18,-2
17,3,221,14,13,1
17,3,222,9,11,-2
17,3,223,8,15,-7
17,3,224,5,12,-7
17,3,225,1,32,-31
17,3,226,8,23,-15
17,3,227,30,22,8
17,3,228,10,18,-8
17,3,229,4,13,-9
17,3,230,5,6,-1
17,3,231,6,12,-6
17,3,232,14,9,5
17,3,233,8,21,-13
17,3,234,13,38,-25
17,3,235,2,24,-22
17,3,236,15,26,-11
17,3,237,18,27,-9
17,3,238,10,20,-10
17,3,239,11,19,-8
17,3,240,8,20,-12
17,3,241,8,17,-9
17,3,242,7,18,-11
17,3,243,6,15,-9
17,3,244,7,6,1
17,3,245,9,19,-10
17,3,246,16,14,2
17,3,247,6,29,-23
17,3,248,7,6,1
17,3,249,10,13,-3
17,3,250,4,11,-7
17,3,251,1,11,-10
17,3,252,11,22,-11
17,3,253,8,14,-6
17,3,254,13,32,-19
17,3,255,12,19,-7
17,3,256,14,16,-2
17,3,257,20,21,-1
17,3,258,7,20,-13
17,3,259,14,36,-22
17,3,260,8,12,-4
17,3,261,6,22,-16
17,3,262,8,13,-5
17,3,263,7,13,-6
17,3,264,10,21,-11
17,3,265,6,17,-11
17,3,266,10,26,-16
17,3,267,6,20,-14
17,3,268,4,18,-14
17,3,269,18,22,-4
17,3,270,6,25,-19
17,3,271,7,14,-7
17,3,272,16,20,-4
17,3,273,5,10,-5
17,3,274,8,24,-16
17,3,275,14,15,-1
17,3,276,6,21,-15
17,3,277,10,19,-9
17,3,278,7,17,-10
17,3,279,14,16,-2
17,3,280,5,20,-15
17,3,281,12,8,4
17,3,282,10,23,-13
17,3,283,3,18,-15
17,3,284,5,18,-13
17,3,285,17,15,2
17,3,286,20,18,2
17,3,287,5,15,-10
17,3,288,8,23,-15
17,3,289,3,13,-10
17,3,290,8,11,-3
17,3,291,8,9,-1
17,3,292,9,11,-2
17,3,293,14,21,-7
17,3,294,1,16,-15
17,3,295,8,12,-4
17,3,296,8,16,-8
17,3,297,9,18,-9
17,3,298,6,9,-3
17,3,299,9,29,-20
17,4,0,8,20,-12
17,4,1,15,11,4
17,4,2,10,21,-11
17,4,3,7,19,-12
17,4,4,15,22,-7
17,4,5,8,25,-17
17,4,6,11,18,-7
17,4,7,21,17,4
17,4,8,9,19,-10
17,4,9,4,12,-8
17,4,10,10,23,-13
17,4,11,15,20,-5
17,4,12,9,18,-9
17,4,13,7,15,-8
17,4,14,8,5,3
17,4,15,4,15,-11
17,4,16,3,11,-8
17,4,17,13,17,-4
17,4,18,15,25,-10
17,4,19,9,25,-16
17,4,20,7,22,-15
17,4,21,8,19,-11
17,4,22,7,23,-16
17,4,23,18,31,-13
17,4,24,16,22,-6
17,4,25,4,7,-3
17,4,26,16,16,0
17,4,27,9,8,1
17,4,28,16,14,2
17,4,29,5,7,-2
17,4,30,4,10,-6
17,4,31,11,21,-10
17,4,32,8,14,-6
17,4,33,14,18,-4
17,4,34,10,19,-9
17,4,35,2,22,-20
17,4,36,4,24,-20
17,4,37,8,19,-11
17,4,38,12,27,-15
17,4,39,14,18,-4
17,4,40,10,15,-5
17,4,41,7,18,-11
17,4,42,21,12,9
17,4,43,28,11,17
17,4,44,10,15,-5
17,4,45,20,15,5
17,4,46,9,24,-15
17,4,47,12,17,-5
17,4,48,10,21,-11
17,4,49,7,22,-15
17,4,50,12,13,-1
17,4,51,13,27,-14
17,4,52,18,30,-12
17,4,53,7,6,1
17,4,54,14,29,-15
17,4,55,19,31,-12
17,4,56,15,23,-8
17,4,57,15,26,-11
17,4,58,7,11,-4
17,4,59,24,12,12
17,4,60,11,24,-13
17,4,61,21,19,2
17,4,62,11,15,-4
17,4,63,4,8,-4
17,4,64,6,7,-1
17,4,65,9,13,-4
17,4,66,4,6,-2
17,4,67,7,20,-13
17,4,68,17,21,-4
17,4,69,15,22,-7
17,4,70,6,22,-16
17,4,71,14,22,-8
17,4,72,7,14,-7
17,4,73,12,15,-3
17,4,74,10,14,-4
17,4,75,14,15,-1
17,4,76,8,11,-3
17,4,77,5,12,-7
17,4,78,5,12,-7
17,4,79,19,14,5
17,4,80,8,13,-5
17,4,81,10,28,-18
17,4,82,12,14,-2
17,4,83,11,19,-8
17,4,84,3,20,-17
17,4,85,8,9,-1
17,4,86,11,23,-12
17,4,87,11,14,-3
17,4,88,18,23,-5
17,4,89,12,36,-24
17,4,90,15,17,-2
17,4,91,14,22,-8
17,4,92,10,18,-8
17,4,93,19,21,-2
17,4,94,19,30,-11
17,4,95,9,6,3
17,4,96,10,18,-8
17,4,97,14,10,4
17,4,98,12,20,-8
17,4,99,14,27,-13
17,4,100,5,13,-8
17,4,101,16,25,-9
17,4,102,6,3,3
17,4,103,6,14,-8
17,4,104,7,25,-18
17,4,105,13,17,-4
17,4,106,9,6,3
17,4,107,8,11,-3
17,4,108,8,17,-9
17,4,109,4,28,-24
17,4,110,6,10,-4
17,4,111,17,6,11
17,4,112,8,18,-10
17,4,113,10,15,-5
17,4,114,14,23,-9
17,4,115,11,15,-4
17,4,116,7,21,-14
17,4,117,6,20,-14
17,4,118,2,17,-15
17,4,119,12,12,0
17,4,120,26,24,2
17,4,121,16,11,5
17,4,122,11,35,-24
17,4,123,7,17,-10
17,4,124,8,15,-7
17,4,125,2,33,-31
17,4,126,4,20,-16
17,4,127,9,15,-6
17,4,128,16,23,-7
17,4,129,3,18,-15
17,4,130,19,21,-2
17,4,131,15,36,-21
17,4,132,8,21,-13
17,4,133,9,20,-11
17,4,134,8,10,-2
17,4,135,8,14,-6
17,4,136,10,17,-7
17,4,137,5,14,-9
17,4,138,12,12,0
17,4,139,10,24,-14
17,4,140,12,16,-4
17,4,141,19,18,1
17,4,142,7,14,-7
17,4,143,5,13,-8
17,4,144,16,15,1
17,4,145,9,22,-13
17,4,146,13,31,-18
17,4,147,8,17,-9
17,4,148,12,23,-11
17,4,149,8,6,2
17,4,150,3,23,-20
17,4,151,13,25,-12
17,4,152,4,16,-12
17,4,153,8,10,-2
17,4,154,18,21,-3
17,4,155,11,27,-16
17,4,156,12,34,-22
17,4,157,27,30,-3
17,4,158,8,14,-6
17,4,159,9,18,-9
17,4,160,13,14,-1
17,4,161,18,26,-8
17,4,162,1,11,-10
17,4,163,18,33,-15
17,4,164,12,20,-8
17,4,165,12,7,5
17,4,166,5,23,-18
17,4,167,5,13,-8
17,4,168,15,17,-2
17,4,169,18,18,0
17,4,170,10,11,-1
17,4,171,14,24,-10
17,4,172,6,21,-15
17,4,173,8,29,-21
17,4,174,9,39,-30
17,4,175,1,29,-28
17,4,176,13,27,-14
17,4,177,6,22,-16
17,4,178,25,14,11
17,4,179,10,37,-27
17,4,180,8,19,-11
17,4,181,4,22,-18
17,4,182,6,17,-11
17,4,183,12,17,-5
17,4,184,14,19,-5
17,4,185,8,3,5
17,4,186,16,9,7
17,4,187,18,6,12
17,4,188,15,17,-2
17,4,189,2,25,-23
17,4,190,11,17,-6
17,4,191,16,40,-24
17,4,192,15,19,-4
17,4,193,11,16,-5
17,4,194,25,22,3
17,4,195,23,22,1
17,4,196,12,23,-11
17,4,197,11,25,-14
17,4,198,10,28,-18
17,4,199,6,19,-13
17,4,200,18,16,2
17,4,201,1,14,-13
17,4,202,6,8,-2
17,4,203,19,18,1
17,4,204,5,11,-6
17,4,205,15,16,-1
17,4,206,6,18,-12
17,4,207,0,7,-7
17,4,208,12,13,-1
17,4,209,6,21,-15
17,4,210,15,27,-12
17,4,211,11,24,-13
17,4,212,13,13,0
17,4,213,9,19,-10
17,4,214,13,28,-15
17,4,215,4,16,-12
17,4,216,14,16,-2
17,4,217,22,33,-11
17,4,218,16,20,-4
17,4,219,11,10,1
17,4,220,7,18,-11
17,4,221,12,19,-7
17,4,222,2,13,-11
17,4,223,14,20,-6
17,4,224,6,11,-5
17,4,225,8,28,-20
17,4,226,8,21,-13
17,4,227,7,16,-9
17,4,228,13,28,-15
17,4,229,8,18,-10
17,4,230,19,25,-6
17,4,231,11,17,-6
17,4,232,7,18,-11
17,4,233,13,22,-9
17,4,234,4,29,-25
17,4,235,10,17,-7
17,4,236,11,26,-15
17,4,237,6,17,-11
17,4,238,7,17,-10
17,4,239,5,12,-7
17,4,240,7,24,-17
17,4,241,3,10,-7
17,4,242,16,19,-3
17,4,243,7,18,-11
17,4,244,4,12,-8
17,4,245,13,18,-5
17,4,246,7,4,3
17,4,247,19,20,-1
17,4,248,5,21,-16
17,4,249,15,11,4
17,4,250,7,4,3
17,4,251,9,15,-6
17,4,252,10,18,-8
17,4,253,9,10,-1
17,4,254,9,20,-11
17,4,255,11,13,-2
17,4,256,6,22,-16
17,4,257,11,19,-8
17,4,258,26,18,8
17,4,259,7,27,-20
17,4,260,12,25,-13
17,4,261,11,15,-4
17,4,262,3,12,-9
17,4,263,8,15,-7
17,4,264,8,26,-18
17,4,265,8,13,-5
17,4,266,6,15,-9
17,4,267,8,21,-13
17,4,268,5,26,-21
17,4,269,14,16,-2
17,4,270,6,16,-10
17,4,271,7,15,-8
17,4,272,7,22,-15
17,4,273,8,30,-22
17,4,274,5,19,-14
17,4,275,6,13,-7
17,4,276,13,30,-17
17,4,277,9,9,0
17,4,278,5,16,-11
17,4,279,13,16,-3
17,4,280,13,19,-6
17,4,281,12,26,-14
17,4,282,14,23,-9
17,4,283,14,26,-12
17,4,284,14,26,-12
17,4,285,5,19,-14
17,4,286,15,43,-28
17,4,287,10,15,-5
17,4,288,13,29,-16
17,4,289,16,18,-2
17,4,290,11,32,-21
17,4,291,7,13,-6
17,4,292,24,24,0
17,4,293,9,18,-9
17,4,294,6,6,0
17,4,295,6,7,-1
17,4,296,13,22,-9
17,4,297,7,18,-11
17,4,298,7,17,-10
17,4,299,8,8,0
17,5,0,3,8,-5
17,5,1,15,29,-14
17,5,2,6,3,3
17,5,3,6,7,-1
17,5,4,26,34,-8
17,5,5,6,8,-2
17,5,6,10,12,-2
17,5,7,13,19,-6
17,5,8,10,13,-3
17,5,9,4,10,-6
17,5,10,16,19,-3
17,5,11,9,10,-1
17,5,12,4,20,-16
17,5,13,18,22,-4
17,5,14,20,24,-4
17,5,15,14,36,-22
17,5,16,6,22,-16
17,5,17,9,15,-6
17,5,18,8,29,-21
17,5,19,7,20,-13
17,5,20,9,25,-16
17,5,21,7,14,-7
17,5,22,7,12,-5
17,5,23,9,23,-14
17,5,24,14,12,2
17,5,25,8,10,-2
17,5,26,10,19,-9
17,5,27,2,16,-14
17,5,28,13,17,-4
17,5,29,9,4,5
17,5,30,5,15,-10
17,5,31,17,18,-1
17,5,32,10,6,4
17,5,33,13,36,-23
17,5,34,14,18,-4
17,5,35,11,10,1
17,5,36,8,12,-4
17,5,37,14,22,-8
17,5,38,10,14,-4
17,5,39,21,17,4
17,5,40,18,24,-6
17,5,41,8,8,0
17,5,42,12,20,-8
17,5,43,13,14,-1
17,5,44,4,24,-20
17,5,45,18,26,-8
17,5,46,7,17,-10
17,5,47,9,21,-12
17,5,48,9,19,-10
17,5,49,15,11,4
17,5,50,7,23,-16
17,5,51,10,26,-16
17,5,52,7,13,-6
17,5,53,8,18,-10
17,5,54,18,37,-19
17,5,55,10,10,0
17,5,56,5,22,-17
17,5,57,8,7,1
17,5,58,6,20,-14
17,5,59,11,20,-9
17,5,60,15,25,-10
17,5,61,7,32,-25
17,5,62,8,28,-20
17,5,63,10,21,-11
17,5,64,15,18,-3
17,5,65,17,18,-1
17,5,66,4,13,-9
17,5,67,16,10,6
17,5,68,9,16,-7
17,5,69,8,19,-11
17,5,70,5,6,-1
17,5,71,13,8,5
17,5,72,8,15,-7
17,5,73,18,25,-7
17,5,74,12,18,-6
17,5,75,13,12,1
17,5,76,18,18,0
17,5,77,7,22,-15
17,5,78,7,20,-13
17,5,79,9,16,-7
17,5,80,11,17,-6
17,5,81,14,17,-3
17,5,82,9,18,-9
17,5,83,16,23,-7
17,5,84,6,6,0
17,5,85,16,26,-10
17,5,86,13,31,-18
17,5,87,13,29,-16
17,5,88,21,34,-13
17,5,89,13,13,0
17,5,90,5,19,-14
17,5,91,9,29,-20
17,5,92,16,28,-12
17,5,93,8,22,-14
17,5,94,8,17,-9
17,5,95,10,9,1
17,5,96,5,13,-8
17,5,97,9,12,-3
17,5,98,15,14,1
17,5,99,15,35,-20
17,5,100,9,6,3
17,5,101,21,18,3
17,5,102,6,19,-13
17,5,103,17,19,-2
17,5,104,8,23,-15
17,5,105,10,17,-7
17,5,106,14,14,0
17,5,107,8,13,-5
17,5,108,11,48,-37
17,5,109,15,18,-3
17,5,110,8,14,-6
17,5,111,8,8,0
17,5,112,10,15,-5
17,5,113,16,24,-8
17,5,114,13,27,-14
17,5,115,21,15,6
17,5,116,10,16,-6
17,5,117,9,23,-14
17,5,118,16,22,-6
17,5,119,5,23,-18
17,5,120,10,22,-12
17,5,121,10,18,-8
17,5,122,5,9,-4
17,5,123,9,17,-8
17,5,124,14,9,5
17,5,125,12,12,0
17,5,126,6,10,-4
17,5,127,12,21,-9
17,5,128,8,13,-5
17,5,129,10,23,-13
17,5,130,11,23,-12
17,5,131,9,20,-11
17,5,132,10,18,-8
17,5,133,7,19,-12
17,5,134,23,25,-2
17,5,135,10,8,2
17,5,136,6,4,2
17,5,137,11,19,-8
17,5,138,7,22,-15
17,5,139,9,9,0
17,5,140,11,20,-9
17,5,141,18,23,-5
17,5,142,10,21,-11
17,5,143,12,18,-6
17,5,144,11,22,-11
17,5,145,8,9,-1
17,5,146,14,9,5
17,5,147,6,24,-18
17,5,148,5,16,-11
17,5,149,8,23,-15
17,5,150,7,26,-19
17,5,151,14,18,-4
17,5,152,8,20,-12
17,5,153,8,30,-22
17,5,154,21,25,-4
17,5,155,2,22,-20
17,5,156,21,15,6
17,5,157,13,13,0
17,5,158,12,29,-17
17,5,159,12,14,-2
17,5,160,13,20,-7
17,5,161,10,21,-11
17,5,162,16,14,2
17,5,163,10,9,1
17,5,164,12,21,-9
17,5,165,10,25,-15
17,5,166,17,17,0
17,5,167,12,24,-12
17,5,168,7,29,-22
17,5,169,4,13,-9
17,5,170,23,31,-8
17,5,171,15,28,-13
17,5,172,6,22,-16
17,5,173,12,15,-3
17,5,174,16,15,1
17,5,175,6,33,-27
17,5,176,15,33,-18
17,5,177,8,28,-20
17,5,178,9,29,-20
17,5,179,13,20,-7
17,5,180,12,21,-9
17,5,181,6,25,-19
17,5,182,9,21,-12
17,5,183,8,24,-16
17,5,184,6,20,-14
17,5,185,9,14,-5
17,5,186,12,21,-9
17,5,187,18,27,-9
17,5,188,14,27,-13
17,5,189,10,22,-12
17,5,190,8,25,-17
17,5,191,6,12,-6
17,5,192,10,25,-15
17,5,193,9,17,-8
17,5,194,4,26,-22
17,5,195,15,14,1
17,5,196,11,29,-18
17,5,197,16,14,2
17,5,198,18,25,-7
17,5,199,10,24,-14
17,5,200,16,21,-5
17,5,201,12,14,-2
17,5,202,0,10,-10
17,5,203,12,25,-13
17,5,204,9,18,-9
17,5,205,10,20,-10
17,5,206,19,24,-5
17,5,207,4,22,-18
17,5,208,7,22,-15
17,5,209,9,8,1
17,5,210,9,20,-11
17,5,211,8,12,-4
17,5,212,12,22,-10
17,5,213,11,23,-12
17,5,214,11,25,-14
17,5,215,6,16,-10
17,5,216,7,18,-11
17,5,217,14,14,0
17,5,218,6,9,-3
17,5,219,10,11,-1
17,5,220,17,16,1
17,5,221,22,31,-9
17,5,222,15,14,1
17,5,223,23,26,-3
17,5,224,8,20,-12
17,5,225,20,23,-3
17,5,226,7,14,-7
17,5,227,8,14,-6
17,5,228,12,23,-11
17,5,229,11,16,-5
17,5,230,11,17,-6
17,5,231,8,29,-21
17,5,232,13,11,2
17,5,233,18,32,-14
17,5,234,6,18,-12
17,5,235,24,15,9
17,5,236,9,10,-1
17,5,237,15,12,3
17,5,238,16,27,-11
17,5,239,12,21,-9
17,5,240,15,8,7
17,5,241,10,12,-2
17,5,242,5,16,-11
17,5,243,16,19,-3
17,5,244,6,32,-26
17,5,245,11,8,3
17,5,246,24,16,8
17,5,247,14,20,-6
17,5,248,10,27,-17
17,5,249,6,30,-24
17,5,250,16,24,-8
17,5,251,21,26,-5
17,5,252,15,19,-4
17,5,253,10,25,-15
17,5,254,3,10,-7
17,5,255,18,24,-6
17,5,256,12,12,0
17,5,257,12,16,-4
17,5,258,11,24,-13
17,5,259,12,33,-21
17,5,260,14,17,-3
17,5,261,6,12,-6
17,5,262,11,15,-4
17,5,263,11,10,1
17,5,264,14,18,-4
17,5,265,11,19,-8
17,5,266,8,13,-5
17,5,267,13,28,-15
17,5,268,16,13,3
17,5,269,13,22,-9
17,5,270,6,40,-34
17,5,271,11,26,-15
17,5,272,16,37,-21
17,5,273,19,26,-7
17,5,274,10,12,-2
17,5,275,8,29,-21
17,5,276,15,21,-6
17,5,277,3,24,-21
17,5,278,13,18,-5
17,5,279,9,17,-8
17,5,280,12,22,-10
17,5,281,9,30,-21
17,5,282,6,15,-9
17,5,283,7,17,-10
17,5,284,7,15,-8
17,5,285,8,18,-10
17,5,286,11,16,-5
17,5,287,22,13,9
17,5,288,8,13,-5
17,5,289,2,18,-16
17,5,290,16,30,-14
17,5,291,11,25,-14
17,5,292,7,14,-7
17,5,293,12,26,-14
17,5,294,11,10,1
17,5,295,5,23,-18
17,5,296,13,25,-12
17,5,297,18,13,5
17,5,298,6,18,-12
17,5,299,6,10,-4
17,6,0,6,23,-17
17,6,1,17,24,-7
17,6,2,15,31,-16
17,6,3,5,15,-10
17,6,4,14,16,-2
17,6,5,10,22,-12
17,6,6,12,17,-5
17,6,7,19,13,6
17,6,8,13,18,-5
17,6,9,9,16,-7
17,6,10,16,29,-13
17,6,11,15,27,-12
17,6,12,14,24,-10
17,6,13,4,8,-4
17,6,14,11,8,3
17,6,15,13,19,-6
17,6,16,9,20,-11
17,6,17,3,11,-8
17,6,18,5,12,-7
17,6,19,5,22,-17
17,6,20,5,9,-4
17,6,21,19,18,1
17,6,22,7,8,-1
17,6,23,7,7,0
17,6,24,10,14,-4
17,6,25,8,19,-11
17,6,26,5,7,-2
17,6,27,7,20,-13
17,6,28,8,19,-11
17,6,29,11,19,-8
17,6,30,16,25,-9
17,6,31,7,14,-7
17,6,32,7,13,-6
17,6,33,16,10,6
17,6,34,10,27,-17
17,6,35,13,9,4
17,6,36,15,12,3
17,6,37,14,32,-18
17,6,38,7,14,-7
17,6,39,12,24,-12
17,6,40,12,30,-18
17,6,41,7,13,-6
17,6,42,21,22,-1
17,6,43,12,17,-5
17,6,44,20,18,2
17,6,45,8,10,-2
17,6,46,9,18,-9
17,6,47,6,19,-13
17,6,48,11,11,0
17,6,49,11,8,3
17,6,50,16,16,0
17,6,51,12,16,-4
17,6,52,4,21,-17
17,6,53,19,32,-13
17,6,54,8,12,-4
17,6,55,12,27,-15
17,6,56,6,10,-4
17,6,57,9,19,-10
17,6,58,13,11,2
17,6,59,7,16,-9
17,6,60,8,23,-15
17,6,61,15,17,-2
17,6,62,8,22,-14
17,6,63,19,23,-4
17,6,64,23,20,3
17,6,65,12,9,3
17,6,66,10,51,-41
17,6,67,8,25,-17
17,6,68,3,25,-22
17,6,69,16,34,-18
17,6,70,9,16,-7
17,6,71,6,16,-10
17,6,72,14,14,0
17,6,73,12,17,-5
17,6,74,4,26,-22
17,6,75,10,13,-3
17,6,76,9,19,-10
17,6,77,6,15,-9
17,6,78,8,28,-20
17,6,79,8,17,-9
17,6,80,11,22,-11
17,6,81,10,22,-12
17,6,82,7,9,-2
17,6,83,11,30,-19
17,6,84,11,17,-6
17,6,85,9,19,-10
17,6,86,16,22,-6
17,6,87,17,20,-3
17,6,88,25,41,-16
17,6,89,12,13,-1
17,6,90,12,15,-3
17,6,91,10,19,-9
17,6,92,14,27,-13
17,6,93,11,17,-6
17,6,94,4,17,-13
17,6,95,8,26,-18
17,6,96,8,17,-9
17,6,97,18,31,-13
17,6,98,11,16,-5
17,6,99,16,28,-12
17,6,100,16,15,1
17,6,101,8,26,-18
17,6,102,5,15,-10
17,6,103,12,15,-3
17,6,104,8,23,-15
17,6,105,10,16,-6
17,6,106,14,14,0
17,6,107,6,30,-24
17,6,108,11,13,-2
17,6,109,4,10,-6
17,6,110,1,7,-6
17,6,111,9,22,-13
17,6,112,7,17,-10
17,6,113,8,19,-11
17,6,114,12,32,-20
17,6,115,15,28,-13
17,6,116,15,18,-3
17,6,117,16,14,2
17,6,118,13,19,-6
17,6,119,13,13,0
17,6,120,14,29,-15
17,6,121,6,13,-7
17,6,122,16,22,-6
17,6,123,5,33,-28
17,6,124,12,16,-4
17,6,125,16,14,2
17,6,126,18,28,-10
17,6,127,9,9,0
17,6,128,10,22,-12
17,6,129,14,25,-11
17,6,130,15,15,0
17,6,131,11,24,-13
17,6,132,14,18,-4
17,6,133,15,34,-19
17,6,134,6,11,-5
17,6,135,14,16,-2
17,6,136,5,20,-15
17,6,137,12,21,-9
17,6,138,7,23,-16
17,6,139,17,30,-13
17,6,140,15,23,-8
17,6,141,11,15,-4
17,6,142,10,8,2
17,6,143,16,31,-15
17,6,144,25,23,2
17,6,145,7,16,-9
17,6,146,12,21,-9
17,6,147,15,16,-1
17,6,148,11,12,-1
17,6,149,12,9,3
17,6,150,17,16,1
17,6,151,13,21,-8
17,6,152,15,25,-10
17,6,153,7,21,-14
17,6,154,16,10,6
17,6,155,3,12,-9
17,6,156,5,31,-26
17,6,157,7,14,-7
17,6,158,4,14,-10
17,6,159,11,12,-1
17,6,160,13,21,-8
17,6,161,18,25,-7
17,6,162,13,23,-10
17,6,163,16,19,-3
17,6,164,13,13,0
17,6,165,3,15,-12
17,6,166,13,27,-14
17,6,167,20,34,-14
17,6,168,15,17,-2
17,6,169,10,21,-11
17,6,170,5,12,-7
17,6,171,22,23,-1
17,6,172,18,21,-3
17,6,173,8,23,-15
17,6,174,17,17,0
17,6,175,20,37,-17
17,6,176,13,15,-2
17,6,177,2,18,-16
17,6,178,20,14,6
17,6,179,14,14,0
17,6,180,9,19,-10
17,6,181,6,13,-7
17,6,182,5,13,-8
17,6,183,15,18,-3
17,6,184,13,29,-16
17,6,185,6,13,-7
17,6,186,13,20,-7
17,6,187,13,17,-4
17,6,188,14,11,3
17,6,189,15,33,-18
17,6,190,10,20,-10
17,6,191,11,15,-4
17,6,192,12,28,-16
17,6,193,9,19,-10
17,6,194,14,23,-9
17,6,195,19,25,-6
17,6,196,10,28,-18
17,6,197,12,24,-12
17,6,198,2,6,-4
17,6,199,7,16,-9
17,6,200,5,17,-12
17,6,201,15,24,-9
17,6,202,15,19,-4
17,6,203,14,15,-1
17,6,204,11,27,-16
17,6,205,19,13,6
17,6,206,13,16,-3
17,6,207,13,31,-18
17,6,208,9,19,-10
17,6,209,11,20,-9
17,6,210,14,18,-4
17,6,211,8,10,-2
17,6,212,5,17,-12
17,6,213,8,10,-2
17,6,214,13,7,6
17,6,215,13,31,-18
17,6,216,16,21,-5
17,6,217,8,20,-12
17,6,218,15,20,-5
17,6,219,6,17,-11
17,6,220,19,23,-4
17,6,221,25,16,9
17,6,222,9,32,-23
17,6,223,12,26,-14
17,6,224,18,22,-4
17,6,225,18,46,-28
17,6,226,11,12,-1
17,6,227,6,14,-8
17,6,228,10,20,-10
17,6,229,9,9,0
17,6,230,8,28,-20
17,6,231,18,20,-2
17,6,232,7,29,-22
17,6,233,14,20,-6
17,6,234,10,22,-12
17,6,235,5,16,-11
17,6,236,11,25,-14
17,6,237,12,24,-12
17,6,238,6,10,-4
17,6,239,9,33,-24
17,6,240,21,24,-3
17,6,241,2,1,1
17,6,242,7,13,-6
17,6,243,5,16,-11
17,6,244,15,25,-10
17,6,245,6,10,-4
17,6,246,7,10,-3
17,6,247,7,33,-26
17,6,248,7,18,-11
17,6,249,5,15,-10
17,6,250,10,10,0
17,6,251,5,16,-11
17,6,252,16,10,6
17,6,253,7,21,-14
17,6,254,9,17,-8
17,6,255,13,17,-4
17,6,256,10,16,-6
17,6,257,15,7,8
17,6,258,15,11,4
17,6,259,6,30,-24
17,6,260,10,23,-13
17,6,261,9,14,-5
17,6,262,13,22,-9
17,6,263,8,17,-9
17,6,264,14,18,-4
17,6,265,14,34,-20
17,6,266,12,23,-11
17,6,267,10,20,-10
17,6,268,23,39,-16
17,6,269,17,18,-1
17,6,270,10,17,-7
17,6,271,9,14,-5
17,6,272,13,32,-19
17,6,273,8,33,-25
17,6,274,3,20,-17
17,6,275,17,18,-1
17,6,276,12,35,-23
17,6,277,12,29,-17
17,6,278,8,6,2
17,6,279,15,8,7
17,6,280,11,19,-8
17,6,281,10,17,-7
17,6,282,3,10,-7
17,6,283,10,12,-2
17,6,284,3,22,-19
17,6,285,8,10,-2
17,6,286,13,24,-11
17,6,287,7,14,-7
17,6,288,5,17,-12
17,6,289,10,9,1
17,6,290,11,23,-12
17,6,291,14,26,-12
17,6,292,8,17,-9
17,6,293,11,22,-11
17,6,294,4,19,-15
17,6,295,11,13,-2
17,6,296,12,15,-3
17,6,297,5,7,-2
17,6,298,12,31,-19
17,6,299,15,24,-9
17,7,0,18,21,-3
17,7,1,17,23,-6
17,7,2,17,22,-5
17,7,3,20,36,-16
17,7,4,10,15,-5
17,7,5,9,15,-6
17,7,6,1,9,-8
17,7,7,8,16,-8
17,7,8,19,21,-2
17,7,9,20,19,1
17,7,10,23,27,-4
17,7,11,8,21,-13
17,7,12,8,21,-13
17,7,13,9,25,-16
17,7,14,13,11,2
17,7,15,7,21,-14
17,7,16,12,16,-4
17,7,17,7,14,-7
17,7,18,14,19,-5
17,7,19,2,23,-21
17,7,20,9,31,-22
17,7,21,12,22,-10
17,7,22,18,21,-3
17,7,23,12,33,-21
17,7,24,15,22,-7
17,7,25,16,26,-10
17,7,26,12,16,-4
17,7,27,11,25,-14
17,7,28,9,22,-13
17,7,29,21,30,-9
17,7,30,12,20,-8
17,7,31,0,10,-10
17,7,32,14,14,0
17,7,33,18,17,1
17,7,34,12,6,6
17,7,35,16,22,-6
17,7,36,8,7,1
17,7,37,7,16,-9
17,7,38,8,15,-7
17,7,39,21,31,-10
17,7,40,14,14,0
17,7,41,12,24,-12
17,7,42,11,34,-23
17,7,43,25,10,15
17,7,44,9,20,-11
17,7,45,8,17,-9
17,7,46,6,18,-12
17,7,47,17,21,-4
17,7,48,22,36,-14
17,7,49,10,1,9
17,7,50,13,12,1
17,7,51,3,3,0
17,7,52,16,22,-6
17,7,53,7,21,-14
17,7,54,5,21,-16
17,7,55,14,12,2
17,7,56,19,13,6
17,7,57,6,18,-12
17,7,58,14,22,-8
17,7,59,16,24,-8
17,7,60,16,8,8
17,7,61,9,15,-6
17,7,62,12,11,1
17,7,63,13,15,-2
17,7,64,19,18,1
17,7,65,22,20,2
17,7,66,14,30,-16
17,7,67,16,9,7
17,7,68,10,18,-8
17,7,69,10,33,-23
17,7,70,9,16,-7
17,7,71,9,16,-7
17,7,72,12,11,1
17,7,73,20,20,0
17,7,74,14,19,-5
17,7,75,11,24,-13
17,7,76,20,37,-17
17,7,77,15,24,-9
17,7,78,15,23,-8
17,7,79,10,26,-16
17,7,80,9,16,-7
17,7,81,17,24,-7
17,7,82,22,33,-11
17,7,83,10,18,-8
17,7,84,9,20,-11
17,7,85,14,12,2
17,7,86,15,30,-15
17,7,87,10,14,-4
17,7,88,12,12,0
17,7,89,10,24,-14
17,7,90,20,17,3
17,7,91,12,11,1
17,7,92,10,18,-8
17,7,93,7,14,-7
17,7,94,13,24,-11
17,7,95,9,27,-18
17,7,96,11,6,5
17,7,97,18,17,1
17,7,98,4,23,-19
17,7,99,11,18,-7
17,7,100,10,10,0
17,7,101,20,18,2
17,7,102,10,29,-19
17,7,103,12,23,-11
17,7,104,10,22,-12
17,7,105,27,13,14
17,7,106,9,25,-16
17,7,107,17,23,-6
17,7,108,12,25,-13
17,7,109,14,21,-7
17,7,110,19,17,2
17,7,111,7,16,-9
17,7,112,10,8,2
17,7,113,16,10,6
17,7,114,6,22,-16
17,7,115,22,28,-6
17,7,116,20,41,-21
17,7,117,16,11,5
17,7,118,15,27,-12
17,7,119,8,22,-14
17,7,120,8,18,-10
17,7,121,7,15,-8
17,7,122,7,19,-12
17,7,123,9,29,-20
17,7,124,10,17,-7
17,7,125,18,20,-2
17,7,126,10,21,-11
17,7,127,21,33,-12
17,7,128,9,10,-1
17,7,129,13,12,1
17,7,130,15,23,-8
17,7,131,11,15,-4
17,7,132,10,20,-10
17,7,133,10,5,5
17,7,134,3,5,-2
17,7,135,5,14,-9
17,7,136,12,14,-2
17,7,137,12,24,-12
17,7,138,6,15,-9
17,7,139,8,10,-2
17,7,140,3,25,-22
17,7,141,12,17,-5
17,7,142,14,23,-9
17,7,143,10,22,-12
17,7,144,18,24,-6
17,7,145,15,25,-10
17,7,146,19,28,-9
17,7,147,21,20,1
17,7,148,1,9,-8
17,7,149,5,14,-9
17,7,150,16,22,-6
17,7,151,6,21,-15
17,7,152,5,18,-13
17,7,153,17,28,-11
17,7,154,11,18,-7
17,7,155,9,24,-15
17,7,156,13,14,-1
17,7,157,10,21,-11
17,7,158,16,32,-16
17,7,159,8,20,-12
17,7,160,8,16,-8
17,7,161,9,26,-17
17,7,162,14,19,-5
17,7,163,9,14,-5
17,7,164,20,24,-4
17,7,165,9,21,-12
17,7,166,12,14,-2
17,7,167,2,8,-6
17,7,168,15,23,-8
17,7,169,13,28,-15
17,7,170,6,17,-11
17,7,171,19,26,-7
17,7,172,14,18,-4
17,7,173,7,21,-14
17,7,174,8,14,-6
17,7,175,7,15,-8
17,7,176,11,13,-2
17,7,177,10,23,-13
17,7,178,8,10,-2
17,7,179,14,38,-24
17,7,180,8,24,-16
17,7,181,27,16,11
17,7,182,5,11,-6
17,7,183,6,27,-21
17,7,184,8,20,-12
17,7,185,6,23,-17
17,7,186,4,24,-20
17,7,187,3,18,-15
17,7,188,16,20,-4
17,7,189,9,28,-19
17,7,190,7,22,-15
17,7,191,8,8,0
17,7,192,5,16,-11
17,7,193,19,13,6
17,7,194,10,15,-5
17,7,195,13,17,-4
17,7,196,11,12,-1
17,7,197,11,17,-6
17,7,198,12,27,-15
17,7,199,7,7,0
17,7,200,13,11,2
17,7,201,6,19,-13
17,7,202,8,17,-9
17,7,203,12,18,-6
17,7,204,10,19,-9
17,7,205,7,23,-16
17,7,206,8,29,-21
17,7,207,25,27,-2
17,7,208,14,16,-2
17,7,209,10,13,-3
17,7,210,9,28,-19
17,7,211,7,14,-7
17,7,212,20,11,9
17,7,213,11,15,-4
17,7,214,14,35,-21
17,7,215,12,41,-29
17,7,216,7,27,-20
17,7,217,13,12,1
17,7,218,18,16,2
17,7,219,9,32,-23
17,7,220,13,19,-6
17,7,221,14,21,-7
17,7,222,24,24,0
17,7,223,21,35,-14
17,7,224,13,19,-6
17,7,225,14,13,1
17,7,226,14,23,-9
17,7,227,7,6,1
17,7,228,15,25,-10
17,7,229,24,21,3
17,7,230,5,16,-11
17,7,231,8,8,0
17,7,232,3,29,-26
17,7,233,12,20,-8
17,7,234,25,22,3
17,7,235,21,17,4
17,7,236,21,33,-12
17,7,237,9,12,-3
17,7,238,5,17,-12
17,7,239,11,14,-3
17,7,240,12,16,-4
17,7,241,7,11,-4
17,7,242,11,23,-12
17,7,243,7,20,-13
17,7,244,9,10,-1
17,7,245,12,14,-2
17,7,246,15,25,-10
17,7,247,27,27,0
17,7,248,21,20,1
17,7,249,11,10,1
17,7,250,8,16,-8
17,7,251,14,19,-5
17,7,252,23,21,2
17,7,253,18,20,-2
17,7,254,15,9,6
17,7,255,15,17,-2
17,7,256,5,17,-12
17,7,257,8,16,-8
17,7,258,10,10,0
17,7,259,10,20,-10
17,7,260,6,16,-10
17,7,261,17,23,-6
17,7,262,11,10,1
17,7,263,7,8,-1
17,7,264,12,18,-6
17,7,265,7,8,-1
17,7,266,12,16,-4
17,7,267,7,18,-11
17,7,268,14,21,-7
17,7,269,11,46,-35
17,7,270,7,19,-12
17,7,271,11,22,-11
17,7,272,15,18,-3
17,7,273,3,11,-8
17,7,274,14,22,-8
17,7,275,13,20,-7
17,7,276,23,20,3
17,7,277,5,18,-13
17,7,278,12,29,-17
17,7,279,5,15,-10
17,7,280,20,35,-15
17,7,281,10,24,-14
17,7,282,4,17,-13
17,7,283,16,23,-7
17,7,284,12,17,-5
17,7,285,15,16,-1
17,7,286,4,11,-7
17,7,287,6,17,-11
17,7,288,8,20,-12
17,7,289,14,13,1
17,7,290,10,9,1
17,7,291,8,12,-4
17,7,292,22,21,1
17,7,293,10,22,-12
17,7,294,12,18,-6
17,7,295,10,28,-18
17,7,296,10,6,4
17,7,297,9,18,-9
17,7,298,20,20,0
17,7,299,13,24,-11
17,8,0,9,10,-1
17,8,1,5,15,-10
17,8,2,20,21,-1
17,8,3,13,32,-19
17,8,4,6,11,-5
17,8,5,8,25,-17
17,8,6,14,17,-3
17,8,7,17,16,1
17,8,8,24,22,2
17,8,9,13,17,-4
17,8,10,13,18,-5
17,8,11,15,24,-9
17,8,12,5,24,-19
17,8,13,7,22,-15
17,8,14,20,20,0
17,8,15,15,16,-1
17,8,16,18,24,-6
17,8,17,12,13,-1
17,8,18,18,15,3
17,8,19,17,16,1
17,8,20,11,14,-3
17,8,21,6,16,-10
17,8,22,15,18,-3
17,8,23,15,7,8
17,8,24,12,18,-6
17,8,25,14,23,-9
17,8,26,19,27,-8
17,8,27,15,17,-2
17,8,28,6,16,-10
17,8,29,9,12,-3
17,8,30,8,24,-16
17,8,31,17,5,12
17,8,32,18,34,-16
17,8,33,12,21,-9
17,8,34,14,16,-2
17,8,35,9,7,2
17,8,36,20,26,-6
17,8,37,8,6,2
17,8,38,11,29,-18
17,8,39,8,18,-10
17,8,40,11,11,0
17,8,41,14,22,-8
17,8,42,7,22,-15
17,8,43,13,21,-8
17,8,44,10,23,-13
17,8,45,2,6,-4
17,8,46,20,26,-6
17,8,47,22,22,0
17,8,48,12,10,2
17,8,49,10,17,-7
17,8,50,20,27,-7
17,8,51,9,7,2
17,8,52,21,21,0
17,8,53,18,13,5
17,8,54,19,24,-5
17,8,55,14,17,-3
17,8,56,12,20,-8
17,8,57,15,17,-2
17,8,58,12,28,-16
17,8,59,21,14,7
17,8,60,10,28,-18
17,8,61,17,27,-10
17,8,62,10,39,-29
17,8,63,13,27,-14
17,8,64,8,19,-11
17,8,65,7,11,-4
17,8,66,7,7,0
17,8,67,15,23,-8
17,8,68,20,28,-8
17,8,69,12,22,-10
17,8,70,9,19,-10
17,8,71,24,13,11
17,8,72,16,21,-5
17,8,73,12,17,-5
17,8,74,16,31,-15
17,8,75,5,5,0
17,8,76,7,14,-7
17,8,77,15,19,-4
17,8,78,20,22,-2
17,8,79,5,12,-7
17,8,80,10,12,-2
17,8,81,5,20,-15
17,8,82,5,12,-7
17,8,83,17,9,8
17,8,84,11,19,-8
17,8,85,26,22,4
17,8,86,9,13,-4
17,8,87,11,16,-5
17,8,88,3,13,-10
17,8,89,15,39,-24
17,8,90,13,27,-14
17,8,91,14,17,-3
17,8,92,10,22,-12
17,8,93,6,23,-17
17,8,94,20,22,-2
17,8,95,23,12,11
17,8,96,11,19,-8
17,8,97,11,22,-11
17,8,98,14,15,-1
17,8,99,12,23,-11
17,8,100,24,24,0
17,8,101,14,29,-15
17,8,102,8,9,-1
17,8,103,4,19,-15
17,8,104,9,11,-2
17,8,105,12,18,-6
17,8,106,20,53,-33
17,8,107,4,16,-12
17,8,108,13,8,5
17,8,109,8,26,-18
17,8,110,13,25,-12
17,8,111,13,10,3
17,8,112,0,7,-7
17,8,113,6,22,-16
17,8,114,14,17,-3
17,8,115,12,27,-15
17,8,116,17,13,4
17,8,117,7,31,-24
17,8,118,17,21,-4
17,8,119,9,25,-16
17,8,120,8,30,-22
17,8,121,5,10,-5
17,8,122,10,35,-25
17,8,123,22,26,-4
17,8,124,12,23,-11
17,8,125,14,19,-5
17,8,126,12,24,-12
17,8,127,20,19,1
17,8,128,8,13,-5
17,8,129,5,8,-3
17,8,130,9,24,-15
17,8,131,7,6,1
17,8,132,8,27,-19
17,8,133,7,22,-15
17,8,134,7,20,-13
17,8,135,6,22,-16
17,8,136,4,12,-8
17,8,137,8,19,-11
17,8,138,14,8,6
17,8,139,7,9,-2
17,8,140,6,29,-23
17,8,141,18,14,4
17,8,142,14,37,-23
17,8,143,14,8,6
17,8,144,10,25,-15
17,8,145,15,17,-2
17,8,146,15,23,-8
17,8,147,12,14,-2
17,8,148,11,25,-14
17,8,149,13,10,3
17,8,150,12,10,2
17,8,151,7,30,-23
17,8,152,12,7,5
17,8,153,12,20,-8
17,8,154,13,16,-3
17,8,155,11,27,-16
17,8,156,11,11,0
17,8,157,12,13,-1
17,8,158,18,27,-9
17,8,159,10,18,-8
17,8,160,8,15,-7
17,8,161,12,19,-7
17,8,162,10,14,-4
17,8,163,9,26,-17
17,8,164,10,22,-12
17,8,165,14,23,-9
17,8,166,9,16,-7
17,8,167,7,12,-5
17,8,168,5,13,-8
17,8,169,19,26,-7
17,8,170,12,26,-14
17,8,171,7,7,0
17,8,172,12,18,-6
17,8,173,18,25,-7
17,8,174,17,26,-9
17,8,175,6,15,-9
17,8,176,5,13,-8
17,8,177,19,20,-1
17,8,178,11,21,-10
17,8,179,11,18,-7
17,8,180,2,22,-20
17,8,181,10,14,-4
17,8,182,17,13,4
17,8,183,9,17,-8
17,8,184,8,22,-14
17,8,185,12,19,-7
17,8,186,9,16,-7
17,8,187,20,14,6
17,8,188,17,19,-2
17,8,189,13,17,-4
17,8,190,9,7,2
17,8,191,7,14,-7
17,8,192,12,37,-25
17,8,193,22,25,-3
17,8,194,19,36,-17
17,8,195,7,26,-19
17,8,196,6,23,-17
17,8,197,9,16,-7
17,8,198,14,30,-16
17,8,199,12,19,-7
17,8,200,22,37,-15
17,8,201,10,22,-12
17,8,202,7,14,-7
17,8,203,17,15,2
17,8,204,15,26,-11
17,8,205,9,17,-8
17,8,206,10,31,-21
17,8,207,7,28,-21
17,8,208,19,7,12
17,8,209,11,15,-4
17,8,210,9,21,-12
17,8,211,18,29,-11
17,8,212,9,21,-12
17,8,213,15,29,-14
17,8,214,17,36,-19
17,8,215,15,17,-2
17,8,216,6,13,-7
17,8,217,9,12,-3
17,8,218,8,27,-19
17,8,219,15,22,-7
17,8,220,13,29,-16
17,8,221,25,33,-8
17,8,222,9,22,-13
17,8,223,9,19,-10
17,8,224,12,7,5
17,8,225,5,12,-7
17,8,226,9,21,-12
17,8,227,18,22,-4
17,8,228,14,10,4
17,8,229,5,32,-27
17,8,230,5,7,-2
17,8,231,6,10,-4
17,8,232,14,20,-6
17,8,233,10,33,-23
17,8,234,15,9,6
17,8,235,18,30,-12
17,8,236,8,11,-3
17,8,237,15,33,-18
17,8,238,10,20,-10
17,8,239,10,14,-4
17,8,240,8,13,-5
17,8,241,10,12,-2
17,8,242,24,20,4
17,8,243,19,12,7
17,8,244,15,8,7
17,8,245,7,12,-5
17,8,246,10,21,-11
17,8,247,15,28,-13
17,8,248,13,18,-5
17,8,249,14,23,-9
17,8,250,9,19,-10
17,8,251,6,13,-7
17,8,252,11,18,-7
17,8,253,21,22,-1
17,8,254,14,21,-7
17,8,255,8,17,-9
17,8,256,8,39,-31
17,8,257,13,22,-9
17,8,258,17,30,-13
17,8,259,13,21,-8
17,8,260,20,24,-4
17,8,261,12,14,-2
17,8,262,4,15,-11
17,8,263,11,21,-10
17,8,264,7,23,-16
17,8,265,7,24,-17
17,8,266,16,20,-4
17,8,267,11,33,-22
17,8,268,9,21,-12
17,8,269,9,14,-5
17,8,270,14,34,-20
17,8,271,5,19,-14
17,8,272,5,10,-5
17,8,273,11,22,-11
17,8,274,6,15,-9
17,8,275,6,21,-15
17,8,276,13,15,-2
17,8,277,17,14,3
17,8,278,3,13,-10
17,8,279,18,26,-8
17,8,280,21,19,2
17,8,281,11,14,-3
17,8,282,10,24,-14
17,8,283,14,22,-8
17,8,284,20,37,-17
17,8,285,8,16,-8
17,8,286,10,24,-14
17,8,287,10,20,-10
17,8,288,16,26,-10
17,8,289,6,11,-5
17,8,290,6,13,-7
17,8,291,11,8,3
17,8,292,24,22,2
17,8,293,5,16,-11
17,8,294,7,11,-4
17,8,295,12,8,4
17,8,296,10,14,-4
17,8,297,20,41,-21
17,8,298,18,17,1
17,8,299,12,14,-2
17,9,0,17,18,-1
17,9,1,6,19,-13
17,9,2,15,28,-13
17,9,3,17,9,8
17,9,4,5,9,-4
17,9,5,30,43,-13
17,9,6,19,10,9
17,9,7,13,11,2
17,9,8,12,16,-4
17,9,9,6,8,-2
17,9,10,10,16,-6
17,9,11,17,13,4
17,9,12,11,12,-1
17,9,13,12,19,-7
17,9,14,19,21,-2
17,9,15,9,42,-33
17,9,16,12,21,-9
17,9,17,12,21,-9
17,9,18,6,20,-14
17,9,19,16,14,2
17,9,20,10,22,-12
17,9,21,4,16,-12
17,9,22,13,13,0
17,9,23,9,20,-11
17,9,24,9,16,-7
17,9,25,17,27,-10
17,9,26,12,36,-24
17,9,27,8,12,-4
17,9,28,17,18,-1
17,9,29,12,25,-13
17,9,30,18,15,3
17,9,31,18,27,-9
17,9,32,20,15,5
17,9,33,11,6,5
17,9,34,16,26,-10
17,9,35,12,22,-10
17,9,36,16,17,-1
17,9,37,20,17,3
17,9,38,5,5,0
17,9,39,19,19,0
17,9,40,12,24,-12
17,9,41,6,10,-4
17,9,42,12,14,-2
17,9,43,7,9,-2
17,9,44,7,24,-17
17,9,45,17,14,3
17,9,46,16,24,-8
17,9,47,5,10,-5
17,9,48,28,22,6
17,9,49,13,26,-13
17,9,50,6,21,-15
17,9,51,19,18,1
17,9,52,15,17,-2
17,9,53,25,11,14
17,9,54,10,23,-13
17,9,55,10,6,4
17,9,56,10,18,-8
17,9,57,7,18,-11
17,9,58,10,11,-1
17,9,59,8,19,-11
17,9,60,4,15,-11
17,9,61,13,20,-7
17,9,62,8,16,-8
17,9,63,15,17,-2
17,9,64,19,30,-11
17,9,65,18,17,1
17,9,66,11,10,1
17,9,67,17,16,1
17,9,68,11,22,-11
17,9,69,8,20,-12
17,9,70,12,30,-18
17,9,71,14,10,4
17,9,72,1,4,-3
17,9,73,9,10,-1
17,9,74,18,18,0
17,9,75,11,8,3
17,9,76,12,21,-9
17,9,77,12,26,-14
17,9,78,1,4,-3
17,9,79,14,26,-12
17,9,80,18,26,-8
17,9,81,11,15,-4
17,9,82,13,12,1
17,9,83,15,18,-3
17,9,84,10,18,-8
17,9,85,19,16,3
17,9,86,14,11,3
17,9,87,21,18,3
17,9,88,12,20,-8
17,9,89,16,26,-10
17,9,90,6,12,-6
17,9,91,4,26,-22
17,9,92,6,15,-9
17,9,93,11,19,-8
17,9,94,11,14,-3
17,9,95,8,18,-10
17,9,96,8,21,-13
17,9,97,10,16,-6
17,9,98,3,5,-2
17,9,99,19,23,-4
17,9,100,14,25,-11
17,9,101,8,21,-13
17,9,102,15,37,-22
17,9,103,11,30,-19
17,9,104,8,11,-3
17,9,105,11,12,-1
17,9,106,8,11,-3
17,9,107,8,15,-7
17,9,108,10,18,-8
17,9,109,21,14,7
17,9,110,19,29,-10
17,9,111,18,24,-6
17,9,112,17,11,6
17,9,113,11,18,-7
17,9,114,14,24,-10
17,9,115,15,19,-4
17,9,116,11,17,-6
17,9,117,16,27,-11
17,9,118,13,8,5
17,9,119,17,19,-2
17,9,120,13,24,-11
17,9,121,19,12,7
17,9,122,14,23,-9
17,9,123,24,34,-10
17,9,124,12,10,2
17,9,125,17,25,-8
17,9,126,7,14,-7
17,9,127,13,18,-5
17,9,128,11,18,-7
17,9,129,17,22,-5
17,9,130,16,22,-6
17,9,131,12,17,-5
17,9,132,7,12,-5
17,9,133,7,19,-12
17,9,134,1,32,-31
17,9,135,15,17,-2
17,9,136,12,26,-14
17,9,137,13,20,-7
17,9,138,9,23,-14
17,9,139,14,12,2
17,9,140,15,16,-1
17,9,141,20,33,-13
17,9,142,13,20,-7
17,9,143,21,16,5
17,9,144,10,19,-9
17,9,145,15,20,-5
17,9,146,8,10,-2
17,9,147,14,23,-9
17,9,148,9,14,-5
17,9,149,17,14,3
17,9,150,11,28,-17
17,9,151,18,30,-12
17,9,152,9,10,-1
17,9,153,21,22,-1
17,9,154,28,29,-1
17,9,155,9,15,-6
17,9,156,15,17,-2
17,9,157,10,26,-16
17,9,158,15,18,-3
17,9,159,5,8,-3
17,9,160,15,23,-8
17,9,161,14,15,-1
17,9,162,7,37,-30
17,9,163,7,19,-12
17,9,164,18,19,-1
17,9,165,21,21,0
17,9,166,14,25,-11
17,9,167,27,26,1
17,9,168,12,34,-22
17,9,169,10,23,-13
17,9,170,14,19,-5
17,9,171,22,24,-2
17,9,172,9,23,-14
17,9,173,14,13,1
17,9,174,11,13,-2
17,9,175,11,19,-8
17,9,176,18,26,-8
17,9,177,15,20,-5
17,9,178,3,13,-10
17,9,179,13,26,-13
17,9,180,11,26,-15
17,9,181,10,17,-7
17,9,182,12,29,-17
17,9,183,16,17,-1
17,9,184,2,14,-12
17,9,185,24,17,7
17,9,186,11,15,-4
17,9,187,8,24,-16
17,9,188,7,23,-16
17,9,189,12,24,-12
17,9,190,5,9,-4
17,9,191,11,22,-11
17,9,192,14,23,-9
17,9,193,13,31,-18
17,9,194,11,16,-5
17,9,195,9,17,-8
17,9,196,6,18,-12
17,9,197,8,13,-5
17,9,198,13,8,5
17,9,199,19,16,3
17,9,200,12,20,-8
17,9,201,19,20,-1
17,9,202,12,18,-6
17,9,203,13,33,-20
17,9,204,13,28,-15
17,9,205,26,19,7
17,9,206,13,17,-4
17,9,207,12,17,-5
17,9,208,14,24,-10
17,9,209,11,20,-9
17,9,210,9,17,-8
17,9,211,23,10,13
17,9,212,14,24,-10
17,9,213,11,22,-11
17,9,214,17,20,-3
17,9,215,14,21,-7
17,9,216,12,28,-16
17,9,217,10,8,2
17,9,218,15,15,0
17,9,219,9,16,-7
17,9,220,5,10,-5
17,9,221,12,12,0
17,9,222,5,15,-10
17,9,223,7,11,-4
17,9,224,8,19,-11
17,9,225,6,14,-8
17,9,226,10,21,-11
17,9,227,3,11,-8
17,9,228,12,17,-5
17,9,229,9,11,-2
17,9,230,9,11,-2
17,9,231,12,10,2
17,9,232,26,26,0
17,9,233,9,12,-3
17,9,234,5,10,-5
17,9,235,12,18,-6
17,9,236,5,32,-27
17,9,237,5,5,0
17,9,238,8,20,-12
17,9,239,14,21,-7
17,9,240,13,12,1
17,9,241,8,18,-10
17,9,242,24,21,3
17,9,243,13,8,5
17,9,244,9,11,-2
17,9,245,19,23,-4
17,9,246,9,15,-6
17,9,247,11,15,-4
17,9,248,12,9,3
17,9,249,21,17,4
17,9,250,14,15,-1
17,9,251,14,35,-21
17,9,252,17,24,-7
17,9,253,20,24,-4
17,9,254,13,14,-1
17,9,255,14,7,7
17,9,256,10,21,-11
17,9,257,3,10,-7
17,9,258,8,19,-11
17,9,259,17,20,-3
17,9,260,6,16,-10
17,9,261,12,21,-9
17,9,262,12,24,-12
17,9,263,12,4,8
17,9,264,15,11,4
17,9,265,17,17,0
17,9,266,8,11,-3
17,9,267,14,15,-1
17,9,268,22,14,8
17,9,269,10,9,1
17,9,270,22,18,4
17,9,271,6,24,-18
17,9,272,13,11,2
17,9,273,2,13,-11
17,9,274,24,23,1
17,9,275,7,16,-9
17,9,276,17,17,0
17,9,277,20,16,4
17,9,278,16,21,-5
17,9,279,20,10,10
17,9,280,7,19,-12
17,9,281,13,9,4
17,9,282,15,15,0
17,9,283,13,21,-8
17,9,284,3,17,-14
17,9,285,10,12,-2
17,9,286,9,11,-2
17,9,287,24,23,1
17,9,288,14,8,6
17,9,289,7,13,-6
17,9,290,15,25,-10
17,9,291,14,30,-16
17,9,292,17,27,-10
17,9,293,17,15,2
17,9,294,12,21,-9
17,9,295,22,15,7
17,9,296,18,29,-11
17,9,297,26,27,-1
17,9,298,7,11,-4
17,9,299,14,13,1
17,10,0,25,26,-1
17,10,1,8,16,-8
17,10,2,13,24,-11
17,10,3,7,25,-18
17,10,4,6,8,-2
17,10,5,8,23,-15
17,10,6,18,16,2
17,10,7,15,20,-5
17,10,8,13,19,-6
17,10,9,16,12,4
17,10,10,16,28,-12
17,10,11,14,21,-7
17,10,12,8,10,-2
17,10,13,7,27,-20
17,10,14,8,8,0
17,10,15,10,13,-3
17,10,16,17,14,3
17,10,17,7,17,-10
17,10,18,2,11,-9
17,10,19,18,20,-2
17,10,20,9,25,-16
17,10,21,14,18,-4
17,10,22,6,11,-5
17,10,23,13,18,-5
17,10,24,14,23,-9
17,10,25,21,15,6
17,10,26,8,8,0
17,10,27,17,16,1
17,10,28,20,18,2
17,10,29,11,10,1
17,10,30,12,30,-18
17,10,31,16,17,-1
17,10,32,6,29,-23
17,10,33,16,13,3
17,10,34,10,25,-15
17,10,35,13,24,-11
17,10,36,3,21,-18
17,10,37,21,16,5
17,10,38,5,7,-2
17,10,39,5,23,-18
17,10,40,14,18,-4
17,10,41,11,16,-5
17,10,42,16,38,-22
17,10,43,19,11,8
17,10,44,15,14,1
17,10,45,18,23,-5
17,10,46,9,18,-9
17,10,47,10,23,-13
17,10,48,12,14,-2
17,10,49,6,13,-7
17,10,50,15,19,-4
17,10,51,15,32,-17
17,10,52,10,23,-13
17,10,53,17,22,-5
17,10,54,15,23,-8
17,10,55,16,20,-4
17,10,56,16,10,6
17,10,57,8,9,-1
17,10,58,22,21,1
17,10,59,11,20,-9
17,10,60,9,20,-11
17,10,61,10,15,-5
17,10,62,19,22,-3
17,10,63,24,23,1
17,10,64,11,16,-5
17,10,65,14,6,8
17,10,66,15,20,-5
17,10,67,7,18,-11
17,10,68,30,23,7
17,10,69,4,19,-15
17,10,70,7,28,-21
17,10,71,8,11,-3
17,10,72,12,10,2
17,10,73,20,18,2
17,10,74,21,29,-8
17,10,75,19,18,1
17,10,76,15,13,2
17,10,77,9,23,-14
17,10,78,8,27,-19
17,10,79,12,22,-10
17,10,80,13,19,-6
17,10,81,9,33,-24
17,10,82,5,13,-8
17,10,83,14,20,-6
17,10,84,11,24,-13
17,10,85,6,17,-11
17,10,86,9,19,-10
17,10,87,5,13,-8
17,10,88,14,13,1
17,10,89,9,19,-10
17,10,90,6,8,-2
17,10,91,24,25,-1
17,10,92,11,16,-5
17,10,93,12,18,-6
17,10,94,7,16,-9
17,10,95,6,17,-11
17,10,96,9,8,1
17,10,97,15,26,-11
17,10,98,16,22,-6
17,10,99,7,19,-12
17,10,100,17,4,13
17,10,101,12,10,2
17,10,102,8,15,-7
17,10,103,10,19,-9
17,10,104,16,21,-5
17,10,105,12,26,-14
17,10,106,9,29,-20
17,10,107,12,11,1
17,10,108,18,16,2
17,10,109,15,19,-4
17,10,110,11,22,-11
17,10,111,4,14,-10
17,10,112,11,22,-11
17,10,113,15,28,-13
17,10,114,10,16,-6
17,10,115,13,16,-3
17,10,116,13,10,3
17,10,117,5,14,-9
17,10,118,9,4,5
17,10,119,15,26,-11
17,10,120,17,25,-8
17,10,121,8,30,-22
17,10,122,7,10,-3
17,10,123,6,24,-18
17,10,124,2,6,-4
17,10,125,15,11,4
17,10,126,11,22,-11
17,10,127,11,18,-7
17,10,128,8,10,-2
17,10,129,18,26,-8
17,10,130,17,21,-4
17,10,131,9,19,-10
17,10,132,12,16,-4
17,10,133,17,24,-7
17,10,134,10,26,-16
17,10,135,14,15,-1
17,10,136,13,22,-9
17,10,137,7,22,-15
17,10,138,20,20,0
17,10,139,7,23,-16
17,10,140,9,20,-11
17,10,141,10,31,-21
17,10,142,14,17,-3
17,10,143,8,24,-16
17,10,144,14,16,-2
17,10,145,17,18,-1
17,10,146,13,10,3
17,10,147,3,17,-14
17,10,148,13,29,-16
17,10,149,6,12,-6
17,10,150,11,11,0
17,10,151,8,10,-2
17,10,152,15,17,-2
17,10,153,10,15,-5
17,10,154,15,15,0
17,10,155,15,19,-4
17,10,156,14,25,-11
17,10,157,9,7,2
17,10,158,16,23,-7
17,10,159,10,7,3
17,10,160,9,18,-9
17,10,161,7,20,-13
17,10,162,6,11,-5
17,10,163,13,11,2
17,10,164,12,22,-10
17,10,165,14,27,-13
17,10,166,16,21,-5
17,10,167,14,21,-7
17,10,168,5,12,-7
17,10,169,13,21,-8
17,10,170,11,18,-7
17,10,171,16,30,-14
17,10,172,1,9,-8
17,10,173,15,21,-6
17,10,174,5,23,-18
17,10,175,5,15,-10
17,10,176,19,25,-6
17,10,177,27,23,4
17,10,178,18,16,2
17,10,179,17,20,-3
17,10,180,3,13,-10
17,10,181,4,19,-15
17,10,182,13,19,-6
17,10,183,12,13,-1
17,10,184,9,15,-6
17,10,185,1,3,-2
17,10,186,10,16,-6
17,10,187,13,15,-2
17,10,188,25,28,-3
17,10,189,8,10,-2
17,10,190,6,9,-3
17,10,191,12,28,-16
17,10,192,8,14,-6
17,10,193,17,17,0
17,10,194,21,17,4
17,10,195,11,18,-7
17,10,196,12,26,-14
17,10,197,21,17,4
17,10,198,11,9,2
17,10,199,16,21,-5
17,10,200,19,6,13
17,10,201,3,4,-1
17,10,202,13,31,-18
17,10,203,7,19,-12
17,10,204,17,17,0
17,10,205,10,23,-13
17,10,206,14,21,-7
17,10,207,15,24,-9
17,10,208,7,9,-2
17,10,209,6,14,-8
17,10,210,28,13,15
17,10,211,9,20,-11
17,10,212,16,12,4
17,10,213,4,6,-2
17,10,214,19,17,2
17,10,215,4,12,-8
17,10,216,11,16,-5
17,10,217,13,19,-6
17,10,218,8,11,-3
17,10,219,12,16,-4
17,10,220,20,18,2
17,10,221,22,41,-19
17,10,222,12,12,0
17,10,223,13,16,-3
17,10,224,18,11,7
17,10,225,10,13,-3
17,10,226,10,12,-2
17,10,227,7,21,-14
17,10,228,15,38,-23
17,10,229,7,14,-7
17,10,230,10,9,1
17,10,231,6,10,-4
17,10,232,16,12,4
17,10,233,6,28,-22
17,10,234,8,3,5
17,10,235,15,20,-5
17,10,236,7,12,-5
17,10,237,12,14,-2
17,10,238,5,12,-7
17,10,239,14,11,3
17,10,240,14,16,-2
17,10,241,6,11,-5
17,10,242,18,19,-1
17,10,243,1,22,-21
17,10,244,18,15,3
17,10,245,21,20,1
17,10,246,21,22,-1
17,10,247,11,12,-1
17,10,248,13,15,-2
17,10,249,10,14,-4
17,10,250,13,16,-3
17,10,251,8,8,0
17,10,252,16,31,-15
17,10,253,8,12,-4
17,10,254,21,13,8
17,10,255,18,6,12
17,10,256,15,32,-17
17,10,257,10,20,-10
17,10,258,16,23,-7
17,10,259,15,13,2
17,10,260,10,18,-8
17,10,261,20,19,1
17,10,262,16,8,8
17,10,263,11,25,-14
17,10,264,16,19,-3
17,10,265,9,16,-7
17,10,266,17,15,2
17,10,267,5,11,-6
17,10,268,12,9,3
17,10,269,7,9,-2
17,10,270,22,11,11
17,10,271,11,26,-15
17,10,272,4,9,-5
17,10,273,10,20,-10
17,10,274,12,31,-19
17,10,275,11,17,-6
17,10,276,25,30,-5
17,10,277,18,32,-14
17,10,278,21,22,-1
17,10,279,5,7,-2
17,10,280,16,26,-10
17,10,281,9,14,-5
17,10,282,6,7,-1
17,10,283,15,18,-3
17,10,284,11,20,-9
17,10,285,9,16,-7
17,10,286,10,9,1
17,10,287,6,25,-19
17,10,288,10,18,-8
17,10,289,15,19,-4
17,10,290,26,21,5
17,10,291,13,32,-19
17,10,292,14,15,-1
17,10,293,20,31,-11
17,10,294,6,9,-3
17,10,295,10,8,2
17,10,296,13,43,-30
17,10,297,16,7,9
17,10,298,13,19,-6
17,10,299,7,16,-9
17,11,0,28,18,10
17,11,1,7,13,-6
17,11,2,10,34,-24
17,11,3,11,21,-10
17,11,4,14,20,-6
17,11,5,16,23,-7
17,11,6,11,13,-2
17,11,7,8,18,-10
17,11,8,10,18,-8
17,11,9,14,16,-2
17,11,10,13,20,-7
17,11,11,13,9,4
17,11,12,14,27,-13
17,11,13,16,13,3
17,11,14,4,10,-6
17,11,15,10,10,0
17,11,16,5,25,-20
17,11,17,8,23,-15
17,11,18,10,13,-3
17,11,19,10,44,-34
17,11,20,10,20,-10
17,11,21,12,30,-18
17,11,22,16,18,-2
17,11,23,9,19,-10
17,11,24,23,27,-4
17,11,25,23,18,5
17,11,26,8,19,-11
17,11,27,10,17,-7
17,11,28,23,21,2
17,11,29,8,15,-7
17,11,30,6,11,-5
17,11,31,11,15,-4
17,11,32,17,21,-4
17,11,33,14,17,-3
17,11,34,13,23,-10
17,11,35,20,15,5
17,11,36,20,23,-3
17,11,37,5,24,-19
17,11,38,22,28,-6
17,11,39,5,19,-14
17,11,40,26,26,0
17,11,41,19,16,3
17,11,42,4,6,-2
17,11,43,15,11,4
17,11,44,5,22,-17
17,11,45,10,25,-15
17,11,46,6,17,-11
17,11,47,10,12,-2
17,11,48,16,14,2
17,11,49,15,23,-8
17,11,50,13,16,-3
17,11,51,14,30,-16
17,11,52,22,22,0
17,11,53,10,10,0
17,11,54,17,20,-3
17,11,55,9,17,-8
17,11,56,5,12,-7
17,11,57,13,18,-5
17,11,58,10,17,-7
17,11,59,25,31,-6
17,11,60,11,29,-18
17,11,61,14,21,-7
17,11,62,5,4,1
17,11,63,1,7,-6
17,11,64,11,14,-3
17,11,65,9,9,0
17,11,66,9,14,-5
17,11,67,9,9,0
17,11,68,20,27,-7
17,11,69,10,16,-6
17,11,70,19,15,4
17,11,71,13,23,-10
17,11,72,12,29,-17
17,11,73,13,26,-13
17,11,74,21,23,-2
17,11,75,4,13,-9
17,11,76,19,25,-6
17,11,77,26,27,-1
17,11,78,17,14,3
17,11,79,12,17,-5
17,11,80,16,21,-5
17,11,81,14,24,-10
17,11,82,13,12,1
17,11,83,26,10,16
17,11,84,7,21,-14
17,11,85,9,13,-4
17,11,86,15,19,-4
17,11,87,22,14,8
17,11,88,14,27,-13
17,11,89,10,15,-5
17,11,90,12,26,-14
17,11,91,10,22,-12
17,11,92,18,20,-2
17,11,93,10,18,-8
17,11,94,8,7,1
17,11,95,13,28,-15
17,11,96,16,12,4
17,11,97,13,20,-7
17,11,98,12,18,-6
17,11,99,13,11,2
17,11,100,11,19,-8
17,11,101,17,11,6
17,11,102,14,12,2
17,11,103,11,30,-19
17,11,104,8,23,-15
17,11,105,26,35,-9
17,11,106,18,29,-11
17,11,107,13,20,-7
17,11,108,21,26,-5
17,11,109,5,9,-4
17,11,110,10,19,-9
17,11,111,10,17,-7
17,11,112,20,29,-9
17,11,113,10,25,-15
17,11,114,10,18,-8
17,11,115,9,11,-2
17,11,116,12,19,-7
17,11,117,13,24,-11
17,11,118,17,22,-5
17,11,119,10,19,-9
17,11,120,21,24,-3
17,11,121,9,25,-16
17,11,122,8,14,-6
17,11,123,10,21,-11
17,11,124,21,17,4
17,11,125,19,13,6
17,11,126,12,33,-21
17,11,127,7,18,-11
17,11,128,10,15,-5
17,11,129,16,17,-1
17,11,130,27,35,-8
17,11,131,15,17,-2
17,11,132,15,9,6
17,11,133,8,18,-10
17,11,134,11,19,-8
17,11,135,8,13,-5
17,11,136,13,13,0
17,11,137,8,21,-13
17,11,138,13,13,0
17,11,139,14,23,-9
17,11,140,15,24,-9
17,11,141,4,19,-15
17,11,142,20,17,3
17,11,143,10,12,-2
17,11,144,3,13,-10
17,11,145,12,14,-2
17,11,146,29,31,-2
17,11,147,2,20,-18
17,11,148,11,18,-7
17,11,149,16,18,-2
17,11,150,12,18,-6
17,11,151,6,21,-15
17,11,152,24,27,-3
17,11,153,9,36,-27
17,11,154,18,19,-1
17,11,155,19,25,-6
17,11,156,12,27,-15
17,11,157,12,15,-3
17,11,158,5,30,-25
17,11,159,8,10,-2
17,11,160,7,22,-15
17,11,161,11,21,-10
17,11,162,11,9,2
17,11,163,18,25,-7
17,11,164,10,22,-12
17,11,165,15,30,-15
17,11,166,5,13,-8
17,11,167,21,23,-2
17,11,168,6,26,-20
17,11,169,11,23,-12
17,11,170,20,23,-3
17,11,171,8,19,-11
17,11,172,8,18,-10
17,11,173,6,16,-10
17,11,174,11,26,-15
17,11,175,16,15,1
17,11,176,19,24,-5
17,11,177,3,28,-25
17,11,178,17,10,7
17,11,179,11,27,-16
17,11,180,23,32,-9
17,11,181,26,25,1
17,11,182,14,28,-14
17,11,183,13,17,-4
17,11,184,9,18,-9
17,11,185,9,11,-2
17,11,186,11,32,-21
17,11,187,13,23,-10
17,11,188,3,9,-6
17,11,189,10,12,-2
17,11,190,13,19,-6
17,11,191,12,17,-5
17,11,192,9,20,-11
17,11,193,8,20,-12
17,11,194,16,16,0
17,11,195,11,14,-3
17,11,196,8,16,-8
17,11,197,13,35,-22
17,11,198,11,11,0
17,11,199,4,12,-8
17,11,200,18,30,-12
17,11,201,2,17,-15
17,11,202,21,19,2
17,11,203,13,12,1
17,11,204,13,23,-10
17,11,205,14,28,-14
17,11,206,12,24,-12
17,11,207,17,12,5
17,11,208,13,14,-1
17,11,209,12,22,-10
17,11,210,7,13,-6
17,11,211,15,18,-3
17,11,212,10,16,-6
17,11,213,2,10,-8
17,11,214,16,24,-8
17,11,215,15,11,4
17,11,216,15,16,-1
17,11,217,10,15,-5
17,11,218,11,15,-4
17,11,219,9,8,1
17,11,220,7,22,-15
17,11,221,19,24,-5
17,11,222,6,17,-11
17,11,223,14,21,-7
17,11,224,13,13,0
17,11,225,12,13,-1
17,11,226,8,8,0
17,11,227,8,9,-1
17,11,228,7,9,-2
17,11,229,13,15,-2
17,11,230,5,14,-9
17,11,231,19,22,-3
17,11,232,17,28,-11
17,11,233,36,25,11
17,11,234,13,17,-4
17,11,235,26,19,7
17,11,236,11,15,-4
17,11,237,10,17,-7
17,11,238,17,23,-6
17,11,239,9,12,-3
17,11,240,16,17,-1
17,11,241,7,19,-12
17,11,242,8,18,-10
17,11,243,11,11,0
17,11,244,6,12,-6
17,11,245,10,22,-12
17,11,246,5,19,-14
17,11,247,30,34,-4
17,11,248,12,14,-2
17,11,249,14,23,-9
17,11,250,10,9,1
17,11,251,19,32,-13
17,11,252,12,7,5
17,11,253,19,33,-14
17,11,254,9,9,0
17,11,255,21,24,-3
17,11,256,8,9,-1
17,11,257,20,17,3
17,11,258,6,12,-6
17,11,259,23,20,3
17,11,260,8,13,-5
17,11,261,17,17,0
17,11,262,15,15,0
17,11,263,13,19,-6
17,11,264,17,12,5
17,11,265,29,22,7
17,11,266,17,17,0
17,11,267,17,14,3
17,11,268,15,11,4
17,11,269,17,19,-2
17,11,270,5,13,-8
17,11,271,13,19,-6
17,11,272,9,15,-6
17,11,273,11,19,-8
17,11,274,21,21,0
17,11,275,14,36,-22
17,11,276,12,16,-4
17,11,277,4,25,-21
17,11,278,22,23,-1
17,11,279,5,10,-5
17,11,280,17,15,2
17,11,281,22,18,4
17,11,282,12,22,-10
17,11,283,10,32,-22
17,11,284,5,15,-10
17,11,285,10,20,-10
17,11,286,15,15,0
17,11,287,13,21,-8
17,11,288,40,34,6
17,11,289,20,21,-1
17,11,290,22,16,6
17,11,291,16,17,-1
17,11,292,18,22,-4
17,11,293,18,41,-23
17,11,294,13,12,1
17,11,295,15,13,2
17,11,296,23,19,4
17,11,297,19,16,3
17,11,298,14,23,-9
17,11,299,11,8,3
17,12,0,7,11,-4
17,12,1,9,19,-10
17,12,2,10,7,3
17,12,3,10,28,-18
17,12,4,12,17,-5
17,12,5,14,10,4
17,12,6,12,21,-9
17,12,7,19,36,-17
17,12,8,13,16,-3
17,12,9,7,18,-11
17,12,10,20,6,14
17,12,11,19,31,-12
17,12,12,9,13,-4
17,12,13,11,19,-8
17,12,14,10,12,-2
17,12,15,9,16,-7
17,12,16,12,4,8
17,12,17,11,22,-11
17,12,18,16,13,3
17,12,19,17,23,-6
17,12,20,2,18,-16
17,12,21,17,21,-4
17,12,22,19,21,-2
17,12,23,7,15,-8
17,12,24,2,5,-3
17,12,25,8,22,-14
17,12,26,12,14,-2
17,12,27,16,7,9
17,12,28,8,15,-7
17,12,29,11,8,3
17,12,30,3,9,-6
17,12,31,12,18,-6
17,12,32,7,19,-12
17,12,33,25,13,12
17,12,34,10,16,-6
17,12,35,10,10,0
17,12,36,13,9,4
17,12,37,19,14,5
17,12,38,14,37,-23
17,12,39,16,18,-2
17,12,40,12,19,-7
17,12,41,5,14,-9
17,12,42,12,17,-5
17,12,43,8,29,-21
17,12,44,11,18,-7
17,12,45,23,13,10
17,12,46,12,17,-5
17,12,47,22,20,2
17,12,48,10,8,2
17,12,49,17,24,-7
17,12,50,18,24,-6
17,12,51,16,22,-6
17,12,52,20,26,-6
17,12,53,6,5,1
17,12,54,7,20,-13
17,12,55,7,12,-5
17,12,56,15,15,0
17,12,57,11,8,3
17,12,58,17,26,-9
17,12,59,4,10,-6
17,12,60,14,21,-7
17,12,61,13,28,-15
17,12,62,12,25,-13
17,12,63,24,23,1
17,12,64,11,21,-10
17,12,65,18,15,3
17,12,66,6,21,-15
17,12,67,13,18,-5
17,12,68,9,23,-14
17,12,69,17,27,-10
17,12,70,20,25,-5
17,12,71,14,16,-2
17,12,72,22,14,8
17,12,73,19,26,-7
17,12,74,7,20,-13
17,12,75,24,17,7
17,12,76,12,22,-10
17,12,77,10,20,-10
17,12,78,14,17,-3
17,12,79,18,22,-4
17,12,80,15,24,-9
17,12,81,14,26,-12
17,12,82,12,28,-16
17,12,83,9,15,-6
17,12,84,6,25,-19
17,12,85,10,9,1
17,12,86,12,21,-9
17,12,87,12,12,0
17,12,88,17,21,-4
17,12,89,21,15,6
17,12,90,10,13,-3
17,12,91,12,16,-4
17,12,92,24,13,11
17,12,93,18,22,-4
17,12,94,16,17,-1
17,12,95,15,9,6
17,12,96,13,17,-4
17,12,97,15,7,8
17,12,98,16,28,-12
17,12,99,12,20,-8
17,12,100,6,19,-13
17,12,101,8,16,-8
17,12,102,14,31,-17
17,12,103,12,26,-14
17,12,104,8,16,-8
17,12,105,8,26,-18
17,12,106,15,26,-11
17,12,107,14,15,-1
17,12,108,17,22,-5
17,12,109,11,20,-9
17,12,110,17,11,6
17,12,111,22,17,5
17,12,112,10,14,-4
17,12,113,13,12,1
17,12,114,8,16,-8
17,12,115,16,19,-3
17,12,116,9,6,3
17,12,117,22,24,-2
17,12,118,15,20,-5
17,12,119,13,23,-10
17,12,120,7,22,-15
17,12,121,7,4,3
17,12,122,24,21,3
17,12,123,14,16,-2
17,12,124,7,18,-11
17,12,125,9,8,1
17,12,126,15,20,-5
17,12,127,18,15,3
17,12,128,13,18,-5
17,12,129,11,6,5
17,12,130,10,16,-6
17,12,131,12,11,1
17,12,132,14,12,2
17,12,133,16,18,-2
17,12,134,11,14,-3
17,12,135,20,13,7
17,12,136,17,34,-17
17,12,137,13,22,-9
17,12,138,15,12,3
17,12,139,8,24,-16
17,12,140,17,20,-3
17,12,141,6,23,-17
17,12,142,9,22,-13
17,12,143,10,17,-7
17,12,144,12,26,-14
17,12,145,7,13,-6
17,12,146,5,7,-2
17,12,147,10,10,0
17,12,148,11,13,-2
17,12,149,8,14,-6
17,12,150,14,26,-12
17,12,151,13,24,-11
17,12,152,12,21,-9
17,12,153,17,13,4
17,12,154,10,15,-5
17,12,155,7,18,-11
17,12,156,8,22,-14
17,12,157,13,13,0
17,12,158,5,10,-5
17,12,159,16,9,7
17,12,160,9,10,-1
17,12,161,12,21,-9
17,12,162,15,16,-1
17,12,163,14,16,-2
17,12,164,9,17,-8
17,12,165,5,22,-17
17,12,166,10,11,-1
17,12,167,11,18,-7
17,12,168,9,10,-1
17,12,169,14,21,-7
17,12,170,8,16,-8
17,12,171,8,13,-5
17,12,172,13,21,-8
17,12,173,7,22,-15
17,12,174,4,10,-6
17,12,175,14,22,-8
17,12,176,8,6,2
17,12,177,22,27,-5
17,12,178,8,24,-16
17,12,179,4,14,-10
17,12,180,9,20,-11
17,12,181,15,26,-11
17,12,182,13,12,1
17,12,183,22,20,2
17,12,184,12,10,2
17,12,185,11,17,-6
17,12,186,11,14,-3
17,12,187,14,16,-2
17,12,188,10,12,-2
17,12,189,8,21,-13
17,12,190,2,10,-8
17,12,191,6,12,-6
17,12,192,19,7,12
17,12,193,14,13,1
17,12,194,23,13,10
17,12,195,13,9,4
17,12,196,19,7,12
17,12,197,15,13,2
17,12,198,18,15,3
17,12,199,14,26,-12
17,12,200,15,16,-1
17,12,201,18,14,4
17,12,202,14,18,-4
17,12,203,18,15,3
17,12,204,8,27,-19
17,12,205,4,4,0
17,12,206,13,13,0
17,12,207,23,32,-9
17,12,208,14,9,5
17,12,209,22,13,9
17,12,210,15,12,3
17,12,211,11,22,-11
17,12,212,7,12,-5
17,12,213,6,12,-6
17,12,214,10,16,-6
17,12,215,35,16,19
17,12,216,13,25,-12
17,12,217,14,8,6
17,12,218,17,16,1
17,12,219,5,4,1
17,12,220,13,11,2
17,12,221,23,22,1
17,12,222,10,43,-33
17,12,223,20,32,-12
17,12,224,8,7,1
17,12,225,20,29,-9
17,12,226,7,14,-7
17,12,227,4,31,-27
17,12,228,18,18,0
17,12,229,13,26,-13
17,12,230,11,14,-3
17,12,231,17,16,1
17,12,232,9,14,-5
17,12,233,8,13,-5
17,12,234,8,11,-3
17,12,235,10,11,-1
17,12,236,12,21,-9
17,12,237,17,19,-2
17,12,238,12,24,-12
17,12,239,6,23,-17
17,12,240,16,14,2
17,12,241,10,25,-15
17,12,242,1,17,-16
17,12,243,11,35,-24
17,12,244,16,9,7
17,12,245,17,37,-20
17,12,246,13,10,3
17,12,247,26,15,11
17,12,248,15,26,-11
17,12,249,21,27,-6
17,12,250,13,15,-2
17,12,251,6,26,-20
17,12,252,10,17,-7
17,12,253,17,9,8
17,12,254,16,14,2
17,12,255,8,9,-1
17,12,256,8,14,-6
17,12,257,14,15,-1
17,12,258,19,22,-3
17,12,259,12,26,-14
17,12,260,19,27,-8
17,12,261,14,30,-16
17,12,262,16,19,-3
17,12,263,11,13,-2
17,12,264,13,15,-2
17,12,265,14,19,-5
17,12,266,13,13,0
17,12,267,11,31,-20
17,12,268,8,9,-1
17,12,269,5,24,-19
17,12,270,20,25,-5
17,12,271,9,12,-3
17,12,272,18,17,1
17,12,273,14,25,-11
17,12,274,20,8,12
17,12,275,13,13,0
17,12,276,6,21,-15
17,12,277,12,18,-6
17,12,278,24,18,6
17,12,279,19,12,7
17,12,280,17,19,-2
17,12,281,22,24,-2
17,12,282,6,29,-23
17,12,283,17,23,-6
17,12,284,20,14,6
17,12,285,10,18,-8
17,12,286,22,23,-1
17,12,287,22,19,3
17,12,288,10,11,-1
17,12,289,18,21,-3
17,12,290,9,16,-7
17,12,291,13,17,-4
17,12,292,14,14,0
17,12,293,13,24,-11
17,12,294,14,19,-5
17,12,295,14,14,0
17,12,296,18,27,-9
17,12,297,23,17,6
17,12,298,16,25,-9
17,12,299,7,19,-12
17,13,0,21,9,12
17,13,1,13,19,-6
17,13,2,16,13,3
17,13,3,23,25,-2
17,13,4,5,11,-6
17,13,5,21,16,5
17,13,6,14,25,-11
17,13,7,6,26,-20
17,13,8,10,7,3
17,13,9,19,27,-8
17,13,10,25,42,-17
17,13,11,20,27,-7
17,13,12,18,17,1
17,13,13,3,11,-8
17,13,14,9,10,-1
17,13,15,16,17,-1
17,13,16,16,14,2
17,13,17,19,27,-8
17,13,18,13,20,-7
17,13,19,30,32,-2
17,13,20,17,16,1
17,13,21,11,11,0
17,13,22,10,7,3
17,13,23,6,14,-8
17,13,24,7,19,-12
17,13,25,10,15,-5
17,13,26,14,33,-19
17,13,27,18,27,-9
17,13,28,21,10,11
17,13,29,18,20,-2
17,13,30,18,16,2
17,13,31,15,30,-15
17,13,32,15,27,-12
17,13,33,9,10,-1
17,13,34,20,12,8
17,13,35,21,28,-7
17,13,36,13,16,-3
17,13,37,18,13,5
17,13,38,18,22,-4
17,13,39,12,9,3
17,13,40,16,15,1
17,13,41,16,18,-2
17,13,42,28,23,5
17,13,43,12,12,0
17,13,44,9,16,-7
17,13,45,10,16,-6
17,13,46,16,11,5
17,13,47,18,13,5
17,13,48,12,13,-1
17,13,49,20,23,-3
17,13,50,9,7,2
17,13,51,20,21,-1
17,13,52,4,6,-2
17,13,53,10,23,-13
17,13,54,15,7,8
17,13,55,13,13,0
17,13,56,19,16,3
17,13,57,9,20,-11
17,13,58,12,10,2
17,13,59,16,14,2
17,13,60,18,23,-5
17,13,61,19,16,3
17,13,62,12,31,-19
17,13,63,9,9,0
17,13,64,4,7,-3
17,13,65,17,21,-4
17,13,66,23,16,7
17,13,67,14,19,-5
17,13,68,8,15,-7
17,13,69,20,26,-6
17,13,70,14,18,-4
17,13,71,13,19,-6
17,13,72,9,17,-8
17,13,73,7,14,-7
17,13,74,8,16,-8
17,13,75,9,11,-2
17,13,76,12,17,-5
17,13,77,14,16,-2
17,13,78,6,9,-3
17,13,79,6,9,-3
17,13,80,9,10,-1
17,13,81,26,14,12
17,13,82,12,16,-4
17,13,83,8,21,-13
17,13,84,14,18,-4
17,13,85,4,13,-9
17,13,86,14,16,-2
17,13,87,11,20,-9
17,13,88,18,18,0
17,13,89,10,25,-15
17,13,90,5,24,-19
17,13,91,15,19,-4
17,13,92,18,26,-8
17,13,93,3,14,-11
17,13,94,7,12,-5
17,13,95,20,20,0
17,13,96,16,13,3
17,13,97,8,12,-4
17,13,98,32,26,6
17,13,99,15,15,0
17,13,100,15,11,4
17,13,101,13,11,2
17,13,102,13,19,-6
17,13,103,10,8,2
17,13,104,15,30,-15
17,13,105,8,21,-13
17,13,106,22,21,1
17,13,107,7,21,-14
17,13,108,10,13,-3
17,13,109,12,23,-11
17,13,110,13,12,1
17,13,111,12,32,-20
17,13,112,18,17,1
17,13,113,9,11,-2
17,13,114,17,16,1
17,13,115,10,12,-2
17,13,116,14,20,-6
17,13,117,13,10,3
17,13,118,10,11,-1
17,13,119,10,14,-4
17,13,120,11,20,-9
17,13,121,22,27,-5
17,13,122,10,27,-17
17,13,123,7,26,-19
17,13,124,14,11,3
17,13,125,10,14,-4
17,13,126,11,24,-13
17,13,127,18,16,2
17,13,128,15,6,9
17,13,129,11,12,-1
17,13,130,14,21,-7
17,13,131,8,23,-15
17,13,132,15,15,0
17,13,133,19,19,0
17,13,134,23,18,5
17,13,135,9,19,-10
17,13,136,13,16,-3
17,13,137,13,24,-11
17,13,138,20,33,-13
17,13,139,3,13,-10
17,13,140,5,15,-10
17,13,141,6,8,-2
17,13,142,5,17,-12
17,13,143,15,22,-7
17,13,144,14,13,1
17,13,145,21,19,2
17,13,146,14,12,2
17,13,147,22,16,6
17,13,148,19,17,2
17,13,149,16,24,-8
17,13,150,18,11,7
17,13,151,20,25,-5
17,13,152,11,12,-1
17,13,153,8,12,-4
17,13,154,16,12,4
17,13,155,10,15,-5
17,13,156,17,17,0
17,13,157,11,16,-5
17,13,158,5,18,-13
17,13,159,6,21,-15
17,13,160,13,16,-3
17,13,161,22,31,-9
17,13,162,24,10,14
17,13,163,17,28,-11
17,13,164,12,21,-9
17,13,165,23,17,6
17,13,166,20,23,-3
17,13,167,8,14,-6
17,13,168,4,16,-12
17,13,169,20,16,4
17,13,170,11,23,-12
17,13,171,6,12,-6
17,13,172,11,9,2
17,13,173,10,19,-9
17,13,174,6,10,-4
17,13,175,10,18,-8
17,13,176,21,24,-3
17,13,177,14,15,-1
17,13,178,17,23,-6
17,13,179,20,21,-1
17,13,180,25,14,11
17,13,181,31,21,10
17,13,182,16,11,5
17,13,183,11,11,0
17,13,184,12,10,2
17,13,185,13,9,4
17,13,186,14,24,-10
17,13,187,17,22,-5
17,13,188,20,14,6
17,13,189,5,6,-1
17,13,190,16,10,6
17,13,191,20,23,-3
17,13,192,17,26,-9
17,13,193,10,18,-8
17,13,194,6,11,-5
17,13,195,8,14,-6
17,13,196,18,21,-3
17,13,197,11,26,-15
17,13,198,7,11,-4
17,13,199,12,15,-3
17,13,200,18,23,-5
17,13,201,15,21,-6
17,13,202,8,26,-18
17,13,203,24,5,19
17,13,204,13,13,0
17,13,205,7,16,-9
17,13,206,10,26,-16
17,13,207,23,22,1
17,13,208,16,31,-15
17,13,209,11,37,-26
17,13,210,1,20,-19
17,13,211,6,11,-5
17,13,212,11,14,-3
17,13,213,11,14,-3
17,13,214,15,13,2
17,13,215,22,28,-6
17,13,216,7,24,-17
17,13,217,10,15,-5
17,13,218,20,24,-4
17,13,219,15,14,1
17,13,220,12,12,0
17,13,221,5,7,-2
17,13,222,17,23,-6
17,13,223,9,13,-4
17,13,224,24,26,-2
17,13,225,17,19,-2
17,13,226,14,20,-6
17,13,227,13,13,0
17,13,228,20,8,12
17,13,229,9,27,-18
17,13,230,23,25,-2
17,13,231,23,22,1
17,13,232,23,14,9
17,13,233,15,21,-6
17,13,234,9,15,-6
17,13,235,9,20,-11
17,13,236,16,20,-4
17,13,237,15,28,-13
17,13,238,5,17,-12
17,13,239,20,26,-6
17,13,240,18,19,-1
17,13,241,8,14,-6
17,13,242,13,19,-6
17,13,243,15,24,-9
17,13,244,10,18,-8
17,13,245,13,20,-7
17,13,246,22,25,-3
17,13,247,7,13,-6
17,13,248,7,18,-11
17,13,249,12,9,3
17,13,250,15,18,-3
17,13,251,14,28,-14
17,13,252,10,26,-16
17,13,253,11,16,-5
17,13,254,4,16,-12
17,13,255,17,8,9
17,13,256,11,12,-1
17,13,257,9,8,1
17,13,258,6,3,3
17,13,259,23,12,11
17,13,260,23,12,11
17,13,261,27,24,3
17,13,262,15,8,7
17,13,263,15,11,4
17,13,264,2,7,-5
17,13,265,14,34,-20
17,13,266,16,30,-14
17,13,267,22,20,2
17,13,268,3,18,-15
17,13,269,14,16,-2
17,13,270,19,27,-8
17,13,271,10,12,-2
17,13,272,23,24,-1
17,13,273,8,14,-6
17,13,274,12,24,-12
17,13,275,6,15,-9
17,13,276,8,18,-10
17,13,277,17,25,-8
17,13,278,12,12,0
17,13,279,16,20,-4
17,13,280,15,17,-2
17,13,281,18,15,3
17,13,282,22,27,-5
17,13,283,14,13,1
17,13,284,14,6,8
17,13,285,16,12,4
17,13,286,9,17,-8
17,13,287,12,17,-5
17,13,288,16,20,-4
17,13,289,21,23,-2
17,13,290,11,20,-9
17,13,291,20,13,7
17,13,292,10,12,-2
17,13,293,7,17,-10
17,13,294,9,10,-1
17,13,295,11,13,-2
17,13,296,21,18,3
17,13,297,15,18,-3
17,13,298,6,7,-1
17,13,299,16,21,-5
17,14,0,19,24,-5
17,14,1,17,27,-10
17,14,2,16,23,-7
17,14,3,16,18,-2
17,14,4,21,19,2
17,14,5,28,24,4
17,14,6,8,24,-16
17,14,7,9,7,2
17,14,8,15,18,-3
17,14,9,10,25,-15
17,14,10,14,20,-6
17,14,11,16,11,5
17,14,12,12,22,-10
17,14,13,24,24,0
17,14,14,8,19,-11
17,14,15,27,23,4
17,14,16,20,21,-1
17,14,17,23,27,-4
17,14,18,10,30,-20
17,14,19,5,12,-7
17,14,20,9,15,-6
17,14,21,12,29,-17
17,14,22,18,25,-7
17,14,23,21,25,-4
17,14,24,10,23,-13
17,14,25,17,24,-7
17,14,26,21,9,12
17,14,27,12,15,-3
17,14,28,11,18,-7
17,14,29,11,18,-7
17,14,30,6,9,-3
17,14,31,21,20,1
17,14,32,13,17,-4
17,14,33,19,21,-2
17,14,34,12,20,-8
17,14,35,18,14,4
17,14,36,9,8,1
17,14,37,12,12,0
17,14,38,27,20,7
17,14,39,16,14,2
17,14,40,20,14,6
17,14,41,23,24,-1
17,14,42,23,19,4
17,14,43,15,16,-1
17,14,44,11,1,10
17,14,45,8,27,-19
17,14,46,16,22,-6
17,14,47,24,17,7
17,14,48,12,15,-3
17,14,49,15,23,-8
17,14,50,13,7,6
17,14,51,13,21,-8
17,14,52,6,7,-1
17,14,53,6,15,-9
17,14,54,14,14,0
17,14,55,19,11,8
17,14,56,9,29,-20
17,14,57,9,18,-9
17,14,58,16,21,-5
17,14,59,9,15,-6
17,14,60,18,19,-1
17,14,61,22,14,8
17,14,62,14,16,-2
17,14,63,7,29,-22
17,14,64,17,21,-4
17,14,65,10,23,-13
17,14,66,18,27,-9
17,14,67,10,19,-9
17,14,68,14,12,2
17,14,69,13,23,-10
17,14,70,19,18,1
17,14,71,5,21,-16
17,14,72,9,12,-3
17,14,73,11,17,-6
17,14,74,22,23,-1
17,14,75,5,17,-12
17,14,76,17,19,-2
17,14,77,12,24,-12
17,14,78,15,21,-6
17,14,79,7,20,-13
17,14,80,14,10,4
17,14,81,14,6,8
17,14,82,18,23,-5
17,14,83,15,25,-10
17,14,84,12,32,-20
17,14,85,13,22,-9
17,14,86,13,19,-6
17,14,87,16,19,-3
17,14,88,6,17,-11
17,14,89,9,20,-11
17,14,90,12,10,2
17,14,91,14,25,-11
17,14,92,4,6,-2
17,14,93,11,12,-1
17,14,94,16,24,-8
17,14,95,9,8,1
17,14,96,18,8,10
17,14,97,10,21,-11
17,14,98,26,18,8
17,14,99,14,17,-3
17,14,100,17,22,-5
17,14,101,9,9,0
17,14,102,12,24,-12
17,14,103,12,19,-7
17,14,104,11,24,-13
17,14,105,2,7,-5
17,14,106,9,8,1
17,14,107,12,14,-2
17,14,108,7,10,-3
17,14,109,11,17,-6
17,14,110,14,20,-6
17,14,111,16,21,-5
17,14,112,22,25,-3
17,14,113,20,32,-12
17,14,114,10,25,-15
17,14,115,14,19,-5
17,14,116,15,10,5
17,14,117,11,15,-4
17,14,118,11,21,-10
17,14,119,16,23,-7
17,14,120,23,16,7
17,14,121,10,22,-12
17,14,122,6,10,-4
17,14,123,15,16,-1
17,14,124,18,19,-1
17,14,125,11,14,-3
17,14,126,15,30,-15
17,14,127,9,19,-10
17,14,128,11,22,-11
17,14,129,7,16,-9
17,14,130,6,15,-9
17,14,131,14,19,-5
17,14,132,16,9,7
17,14,133,21,22,-1
17,14,134,9,16,-7
17,14,135,16,34,-18
17,14,136,10,17,-7
17,14,137,17,13,4
17,14,138,24,10,14
17,14,139,37,18,19
17,14,140,12,11,1
17,14,141,6,10,-4
17,14,142,11,13,-2
17,14,143,14,19,-5
17,14,144,7,18,-11
17,14,145,8,18,-10
17,14,146,14,30,-16
17,14,147,18,21,-3
17,14,148,18,33,-15
17,14,149,17,12,5
17,14,150,24,10,14
17,14,151,13,0,13
17,14,152,8,11,-3
17,14,153,6,16,-10
17,14,154,14,7,7
17,14,155,10,19,-9
17,14,156,15,11,4
17,14,157,12,11,1
17,14,158,7,21,-14
17,14,159,10,16,-6
17,14,160,28,24,4
17,14,161,12,25,-13
17,14,162,8,18,-10
17,14,163,8,28,-20
17,14,164,13,10,3
17,14,165,12,16,-4
17,14,166,12,15,-3
17,14,167,17,25,-8
17,14,168,19,35,-16
17,14,169,8,14,-6
17,14,170,13,18,-5
17,14,171,17,13,4
17,14,172,15,26,-11
17,14,173,10,19,-9
17,14,174,20,14,6
17,14,175,13,19,-6
17,14,176,14,14,0
17,14,177,15,19,-4
17,14,178,12,11,1
17,14,179,6,18,-12
17,14,180,16,17,-1
17,14,181,10,16,-6
17,14,182,16,10,6
17,14,183,12,11,1
17,14,184,20,25,-5
17,14,185,17,20,-3
17,14,186,10,20,-10
17,14,187,14,23,-9
17,14,188,13,22,-9
17,14,189,10,23,-13
17,14,190,17,22,-5
17,14,191,25,29,-4
17,14,192,22,23,-1
17,14,193,23,24,-1
17,14,194,5,9,-4
17,14,195,13,16,-3
17,14,196,13,22,-9
17,14,197,10,22,-12
17,14,198,9,10,-1
17,14,199,22,15,7
17,14,200,5,9,-4
17,14,201,7,16,-9
17,14,202,18,21,-3
17,14,203,20,10,10
17,14,204,12,12,0
17,14,205,12,19,-7
17,14,206,5,19,-14
17,14,207,14,21,-7
17,14,208,29,18,11
17,14,209,26,25,1
17,14,210,4,4,0
17,14,211,12,13,-1
17,14,212,17,20,-3
17,14,213,14,37,-23
17,14,214,7,16,-9
17,14,215,10,20,-10
17,14,216,8,14,-6
17,14,217,9,16,-7
17,14,218,16,24,-8
17,14,219,19,25,-6
17,14,220,17,22,-5
17,14,221,8,9,-1
17,14,222,8,26,-18
17,14,223,10,7,3
17,14,224,21,14,7
17,14,225,17,16,1
17,14,226,19,17,2
17,14,227,8,4,4
17,14,228,13,23,-10
17,14,229,20,13,7
17,14,230,13,12,1
17,14,231,25,28,-3
17,14,232,4,33,-29
17,14,233,14,8,6
17,14,234,16,11,5
17,14,235,33,23,10
17,14,236,8,26,-18
17,14,237,10,18,-8
17,14,238,14,16,-2
17,14,239,11,21,-10
17,14,240,22,16,6
17,14,241,14,20,-6
17,14,242,14,20,-6
17,14,243,22,26,-4
17,14,244,5,19,-14
17,14,245,14,12,2
17,14,246,11,9,2
17,14,247,16,18,-2
17,14,248,12,14,-2
17,14,249,22,12,10
17,14,250,19,14,5
17,14,251,10,13,-3
17,14,252,5,18,-13
17,14,253,13,28,-15
17,14,254,26,18,8
17,14,255,24,20,4
17,14,256,9,13,-4
17,14,257,12,14,-2
17,14,258,23,19,4
17,14,259,17,16,1
17,14,260,7,9,-2
17,14,261,11,15,-4
17,14,262,9,18,-9
17,14,263,7,21,-14
17,14,264,20,16,4
17,14,265,33,31,2
17,14,266,8,13,-5
17,14,267,8,18,-10
17,14,268,8,28,-20
17,14,269,26,18,8
17,14,270,13,33,-20
17,14,271,16,19,-3
17,14,272,27,29,-2
17,14,273,26,18,8
17,14,274,12,23,-11
17,14,275,4,22,-18
17,14,276,8,14,-6
17,14,277,13,22,-9
17,14,278,25,16,9
17,14,279,7,18,-11
17,14,280,17,9,8
17,14,281,12,19,-7
17,14,282,8,19,-11
17,14,283,19,23,-4
17,14,284,11,17,-6
17,14,285,21,18,3
17,14,286,6,9,-3
17,14,287,12,8,4
17,14,288,19,15,4
17,14,289,12,20,-8
17,14,290,18,24,-6
17,14,291,20,31,-11
17,14,292,20,7,13
17,14,293,26,15,11
17,14,294,6,21,-15
17,14,295,8,8,0
17,14,296,14,17,-3
17,14,297,15,5,10
17,14,298,21,23,-2
17,14,299,13,12,1
17,15,0,3,14,-11
17,15,1,11,34,-23
17,15,2,3,20,-17
17,15,3,16,16,0
17,15,4,11,13,-2
17,15,5,17,14,3
17,15,6,10,20,-10
17,15,7,11,18,-7
17,15,8,11,8,3
17,15,9,29,23,6
17,15,10,7,18,-11
17,15,11,8,16,-8
17,15,12,13,19,-6
17,15,13,22,16,6
17,15,14,19,17,2
17,15,15,8,14,-6
17,15,16,15,15,0
17,15,17,11,24,-13
17,15,18,10,12,-2
17,15,19,7,17,-10
17,15,20,21,18,3
17,15,21,23,28,-5
17,15,22,18,24,-6
17,15,23,13,6,7
17,15,24,17,31,-14
17,15,25,23,12,11
17,15,26,15,13,2
17,15,27,6,8,-2
17,15,28,14,13,1
17,15,29,7,7,0
17,15,30,18,20,-2
17,15,31,11,12,-1
17,15,32,14,11,3
17,15,33,19,29,-10
17,15,34,4,18,-14
17,15,35,13,19,-6
17,15,36,19,19,0
17,15,37,20,22,-2
17,15,38,14,24,-10
17,15,39,19,16,3
17,15,40,20,9,11
17,15,41,18,30,-12
17,15,42,17,8,9
17,15,43,11,7,4
17,15,44,17,20,-3
17,15,45,10,33,-23
17,15,46,4,18,-14
17,15,47,17,8,9
17,15,48,17,36,-19
17,15,49,16,14,2
17,15,50,14,19,-5
17,15,51,11,40,-29
17,15,52,13,22,-9
17,15,53,17,24,-7
17,15,54,15,22,-7
17,15,55,14,23,-9
17,15,56,10,26,-16
17,15,57,19,15,4
17,15,58,24,19,5
17,15,59,14,16,-2
17,15,60,21,19,2
17,15,61,12,27,-15
17,15,62,16,6,10
17,15,63,9,21,-12
17,15,64,13,10,3
17,15,65,19,23,-4
17,15,66,5,6,-1
17,15,67,22,11,11
17,15,68,24,21,3
17,15,69,2,9,-7
17,15,70,16,21,-5
17,15,71,15,21,-6
17,15,72,6,17,-11
17,15,73,19,22,-3
17,15,74,10,21,-11
17,15,75,9,7,2
17,15,76,11,19,-8
17,15,77,27,11,16
17,15,78,9,15,-6
17,15,79,21,21,0
17,15,80,5,14,-9
17,15,81,23,26,-3
17,15,82,20,19,1
17,15,83,18,7,11
17,15,84,19,22,-3
17,15,85,12,20,-8
17,15,86,11,9,2
17,15,87,15,13,2
17,15,88,13,7,6
17,15,89,20,33,-13
17,15,90,9,12,-3
17,15,91,15,12,3
17,15,92,12,26,-14
17,15,93,17,13,4
17,15,94,17,18,-1
17,15,95,11,19,-8
17,15,96,16,24,-8
17,15,97,11,19,-8
17,15,98,10,16,-6
17,15,99,28,23,5
17,15,100,16,15,1
17,15,101,10,16,-6
17,15,102,16,24,-8
17,15,103,13,13,0
17,15,104,18,14,4
17,15,105,18,20,-2
17,15,106,24,18,6
17,15,107,7,23,-16
17,15,108,16,29,-13
17,15,109,10,21,-11
17,15,110,17,24,-7
17,15,111,9,9,0
17,15,112,14,8,6
17,15,113,19,9,10
17,15,114,16,11,5
17,15,115,3,8,-5
17,15,116,12,10,2
17,15,117,18,20,-2
17,15,118,21,13,8
17,15,119,15,8,7
17,15,120,19,14,5
17,15,121,12,10,2
17,15,122,10,35,-25
17,15,123,9,20,-11
17,15,124,5,19,-14
17,15,125,22,16,6
17,15,126,15,18,-3
17,15,127,15,21,-6
17,15,128,29,35,-6
17,15,129,21,18,3
17,15,130,6,9,-3
17,15,131,16,15,1
17,15,132,9,13,-4
17,15,133,10,10,0
17,15,134,3,16,-13
17,15,135,19,12,7
17,15,136,21,18,3
17,15,137,23,24,-1
17,15,138,19,15,4
17,15,139,13,7,6
17,15,140,10,8,2
17,15,141,14,12,2
17,15,142,4,13,-9
17,15,143,2,17,-15
17,15,144,17,16,1
17,15,145,10,20,-10
17,15,146,4,20,-16
17,15,147,10,11,-1
17,15,148,13,28,-15
17,15,149,13,9,4
17,15,150,10,12,-2
17,15,151,10,12,-2
17,15,152,13,12,1
17,15,153,6,15,-9
17,15,154,7,20,-13
17,15,155,18,38,-20
17,15,156,29,14,15
17,15,157,7,12,-5
17,15,158,13,31,-18
17,15,159,18,21,-3
17,15,160,12,14,-2
17,15,161,13,10,3
17,15,162,16,22,-6
17,15,163,14,23,-9
17,15,164,15,15,0
17,15,165,4,13,-9
17,15,166,19,19,0
17,15,167,18,17,1
17,15,168,6,20,-14
17,15,169,3,6,-3
17,15,170,7,11,-4
17,15,171,17,17,0
17,15,172,18,19,-1
17,15,173,4,8,-4
17,15,174,5,11,-6
17,15,175,22,18,4
17,15,176,19,8,11
17,15,177,19,20,-1
17,15,178,25,11,14
17,15,179,9,16,-7
17,15,180,21,19,2
17,15,181,22,9,13
17,15,182,8,12,-4
17,15,183,10,20,-10
17,15,184,6,9,-3
17,15,185,12,19,-7
17,15,186,2,9,-7
17,15,187,8,18,-10
17,15,188,9,22,-13
17,15,189,11,15,-4
17,15,190,14,28,-14
17,15,191,11,21,-10
17,15,192,16,29,-13
17,15,193,14,25,-11
17,15,194,9,17,-8
17,15,195,18,15,3
17,15,196,11,27,-16
17,15,197,17,17,0
17,15,198,12,19,-7
17,15,199,9,8,1
17,15,200,5,14,-9
17,15,201,14,11,3
17,15,202,9,9,0
17,15,203,24,16,8
17,15,204,12,10,2
17,15,205,6,9,-3
17,15,206,10,25,-15
17,15,207,8,22,-14
17,15,208,13,7,6
17,15,209,8,6,2
17,15,210,6,12,-6
17,15,211,10,8,2
17,15,212,17,10,7
17,15,213,18,16,2
17,15,214,6,8,-2
17,15,215,11,16,-5
17,15,216,12,16,-4
17,15,217,16,13,3
17,15,218,18,16,2
17,15,219,22,25,-3
17,15,220,19,16,3
17,15,221,22,25,-3
17,15,222,7,7,0
17,15,223,15,15,0
17,15,224,19,11,8
17,15,225,23,13,10
17,15,226,11,13,-2
17,15,227,6,29,-23
17,15,228,7,21,-14
17,15,229,17,15,2
17,15,230,23,27,-4
17,15,231,13,10,3
17,15,232,15,18,-3
17,15,233,19,10,9
17,15,234,16,12,4
17,15,235,12,23,-11
17,15,236,20,12,8
17,15,237,8,9,-1
17,15,238,9,13,-4
17,15,239,3,17,-14
17,15,240,9,21,-12
17,15,241,12,5,7
17,15,242,3,13,-10
17,15,243,13,22,-9
17,15,244,13,23,-10
17,15,245,22,10,12
17,15,246,17,21,-4
17,15,247,13,29,-16
17,15,248,14,21,-7
17,15,249,16,11,5
17,15,250,18,25,-7
17,15,251,8,11,-3
17,15,252,6,10,-4
17,15,253,10,16,-6
17,15,254,6,12,-6
17,15,255,13,18,-5
17,15,256,26,14,12
17,15,257,12,16,-4
17,15,258,9,13,-4
17,15,259,15,19,-4
17,15,260,5,14,-9
17,15,261,15,18,-3
17,15,262,20,14,6
17,15,263,24,15,9
17,15,264,24,17,7
17,15,265,10,20,-10
17,15,266,20,17,3
17,15,267,15,26,-11
17,15,268,20,12,8
17,15,269,10,14,-4
17,15,270,15,18,-3
17,15,271,16,18,-2
17,15,272,11,13,-2
17,15,273,7,19,-12
17,15,274,19,9,10
17,15,275,20,17,3
17,15,276,22,12,10
17,15,277,14,21,-7
17,15,278,10,15,-5
17,15,279,23,24,-1
17,15,280,24,13,11
17,15,281,16,14,2
17,15,282,13,27,-14
17,15,283,5,5,0
17,15,284,18,9,9
17,15,285,11,12,-1
17,15,286,17,19,-2
17,15,287,17,19,-2
17,15,288,25,13,12
17,15,289,17,20,-3
17,15,290,8,10,-2
17,15,291,11,18,-7
17,15,292,11,16,-5
17,15,293,19,11,8
17,15,294,13,18,-5
17,15,295,7,14,-7
17,15,296,3,9,-6
17,15,297,16,16,0
17,15,298,27,21,6
17,15,299,14,10,4
17,16,0,14,7,7
17,16,1,4,13,-9
17,16,2,9,18,-9
17,16,3,10,7,3
17,16,4,22,18,4
17,16,5,18,9,9
17,16,6,14,26,-12
17,16,7,17,18,-1
17,16,8,19,21,-2
17,16,9,22,31,-9
17,16,10,15,12,3
17,16,11,9,18,-9
17,16,12,10,17,-7
17,16,13,18,25,-7
17,16,14,17,15,2
17,16,15,22,9,13
17,16,16,17,29,-12
17,16,17,9,15,-6
17,16,18,17,21,-4
17,16,19,13,9,4
17,16,20,6,12,-6
17,16,21,18,9,9
17,16,22,11,7,4
17,16,23,31,33,-2
17,16,24,17,16,1
17,16,25,17,27,-10
17,16,26,13,15,-2
17,16,27,13,4,9
17,16,28,8,13,-5
17,16,29,12,20,-8
17,16,30,20,8,12
17,16,31,17,7,10
17,16,32,8,9,-1
17,16,33,10,16,-6
17,16,34,7,6,1
17,16,35,10,20,-10
17,16,36,10,14,-4
17,16,37,6,10,-4
17,16,38,13,26,-13
17,16,39,10,15,-5
17,16,40,5,24,-19
17,16,41,12,13,-1
17,16,42,18,19,-1
17,16,43,12,21,-9
17,16,44,10,10,0
17,16,45,11,8,3
17,16,46,12,14,-2
17,16,47,24,24,0
17,16,48,8,18,-10
17,16,49,15,9,6
17,16,50,22,22,0
17,16,51,10,8,2
17,16,52,16,19,-3
17,16,53,14,14,0
17,16,54,10,8,2
17,16,55,7,19,-12
17,16,56,15,24,-9
17,16,57,8,15,-7
17,16,58,6,6,0
17,16,59,7,23,-16
17,16,60,18,10,8
17,16,61,6,12,-6
17,16,62,8,15,-7
17,16,63,22,18,4
17,16,64,10,9,1
17,16,65,5,8,-3
17,16,66,16,31,-15
17,16,67,16,14,2
17,16,68,7,16,-9
17,16,69,18,18,0
17,16,70,28,23,5
17,16,71,21,16,5
17,16,72,16,14,2
17,16,73,16,7,9
17,16,74,15,29,-14
17,16,75,20,21,-1
17,16,76,22,15,7
17,16,77,6,13,-7
17,16,78,15,19,-4
17,16,79,6,17,-11
17,16,80,7,16,-9
17,16,81,15,11,4
17,16,82,20,12,8
17,16,83,8,18,-10
17,16,84,8,9,-1
17,16,85,21,19,2
17,16,86,8,7,1
17,16,87,8,15,-7
17,16,88,4,12,-8
17,16,89,22,23,-1
17,16,90,9,10,-1
17,16,91,14,12,2
17,16,92,7,11,-4
17,16,93,11,15,-4
17,16,94,29,19,10
17,16,95,13,4,9
17,16,96,12,19,-7
17,16,97,8,16,-8
17,16,98,11,13,-2
17,16,99,10,7,3
17,16,100,9,20,-11
17,16,101,10,7,3
17,16,102,8,10,-2
17,16,103,17,27,-10
17,16,104,14,23,-9
17,16,105,4,12,-8
17,16,106,17,22,-5
17,16,107,16,19,-3
17,16,108,18,17,1
17,16,109,11,21,-10
17,16,110,6,10,-4
17,16,111,19,13,6
17,16,112,11,22,-11
17,16,113,11,12,-1
17,16,114,14,10,4
17,16,115,9,20,-11
17,16,116,12,20,-8
17,16,117,19,11,8
17,16,118,11,19,-8
17,16,119,11,11,0
17,16,120,12,8,4
17,16,121,8,16,-8
17,16,122,13,7,6
17,16,123,16,18,-2
17,16,124,8,8,0
17,16,125,21,11,10
17,16,126,11,31,-20
17,16,127,7,19,-12
17,16,128,20,21,-1
17,16,129,12,17,-5
17,16,130,24,17,7
17,16,131,17,20,-3
17,16,132,8,12,-4
17,16,133,8,14,-6
17,16,134,13,18,-5
17,16,135,10,18,-8
17,16,136,20,17,3
17,16,137,13,16,-3
17,16,138,21,25,-4
17,16,139,19,15,4
17,16,140,20,32,-12
17,16,141,16,9,7
17,16,142,17,12,5
17,16,143,24,19,5
17,16,144,15,12,3
17,16,145,11,9,2
17,16,146,13,19,-6
17,16,147,12,11,1
17,16,148,5,12,-7
17,16,149,6,13,-7
17,16,150,19,16,3
17,16,151,25,14,11
17,16,152,19,26,-7
17,16,153,19,19,0
17,16,154,24,15,9
17,16,155,14,11,3
17,16,156,15,12,3
17,16,157,12,17,-5
17,16,158,11,15,-4
17,16,159,18,14,4
17,16,160,14,11,3
17,16,161,23,34,-11
17,16,162,14,13,1
17,16,163,19,23,-4
17,16,164,11,22,-11
17,16,165,5,13,-8
17,16,166,11,11,0
17,16,167,11,13,-2
17,16,168,16,10,6
17,16,169,11,17,-6
17,16,170,11,16,-5
17,16,171,7,21,-14
17,16,172,10,15,-5
17,16,173,10,10,0
17,16,174,10,17,-7
17,16,175,15,12,3
17,16,176,13,19,-6
17,16,177,10,23,-13
17,16,178,11,25,-14
17,16,179,6,23,-17
17,16,180,13,17,-4
17,16,181,28,32,-4
17,16,182,14,20,-6
17,16,183,11,22,-11
17,16,184,12,17,-5
17,16,185,7,11,-4
17,16,186,12,20,-8
17,16,187,11,9,2
17,16,188,14,11,3
17,16,189,14,24,-10
17,16,190,17,25,-8
17,16,191,11,9,2
17,16,192,12,13,-1
17,16,193,13,11,2
17,16,194,18,9,9
17,16,195,19,23,-4
17,16,196,6,12,-6
17,16,197,21,23,-2
17,16,198,9,18,-9
17,16,199,8,24,-16
17,16,200,3,15,-12
17,16,201,12,15,-3
17,16,202,15,10,5
17,16,203,11,15,-4
17,16,204,10,16,-6
17,16,205,7,11,-4
17,16,206,13,14,-1
17,16,207,10,15,-5
17,16,208,14,9,5
17,16,209,11,12,-1
17,16,210,8,11,-3
17,16,211,19,16,3
17,16,212,23,28,-5
17,16,213,11,13,-2
17,16,214,12,11,1
17,16,215,10,18,-8
17,16,216,7,22,-15
17,16,217,27,19,8
17,16,218,22,17,5
17,16,219,16,19,-3
17,16,220,22,8,14
17,16,221,13,15,-2
17,16,222,11,13,-2
17,16,223,23,20,3
17,16,224,16,28,-12
17,16,225,14,16,-2
17,16,226,17,15,2
17,16,227,15,19,-4
17,16,228,11,13,-2
17,16,229,10,12,-2
17,16,230,16,27,-11
17,16,231,13,18,-5
17,16,232,13,9,4
17,16,233,23,14,9
17,16,234,13,23,-10
17,16,235,15,16,-1
17,16,236,12,15,-3
17,16,237,15,9,6
17,16,238,11,14,-3
17,16,239,18,21,-3
17,16,240,30,29,1
17,16,241,9,10,-1
17,16,242,10,14,-4
17,16,243,21,18,3
17,16,244,23,15,8
17,16,245,9,9,0
17,16,246,11,8,3
17,16,247,11,14,-3
17,16,248,10,13,-3
17,16,249,8,28,-20
17,16,250,14,29,-15
17,16,251,14,19,-5
17,16,252,10,28,-18
17,16,253,19,23,-4
17,16,254,12,9,3
17,16,255,10,22,-12
17,16,256,19,16,3
17,16,257,13,13,0
17,16,258,21,20,1
17,16,259,11,14,-3
17,16,260,11,14,-3
17,16,261,6,15,-9
17,16,262,18,13,5
17,16,263,16,10,6
17,16,264,14,8,6
17,16,265,18,9,9
17,16,266,27,16,11
17,16,267,9,8,1
17,16,268,15,12,3
17,16,269,12,14,-2
17,16,270,15,12,3
17,16,271,16,4,12
17,16,272,16,5,11
17,16,273,14,16,-2
17,16,274,19,19,0
17,16,275,19,13,6
17,16,276,15,19,-4
17,16,277,10,12,-2
17,16,278,10,11,-1
17,16,279,28,22,6
17,16,280,7,13,-6
17,16,281,19,20,-1
17,16,282,19,13,6
17,16,283,8,2,6
17,16,284,18,14,4
17,16,285,11,13,-2
17,16,286,9,5,4
17,16,287,16,24,-8
17,16,288,8,11,-3
17,16,289,14,21,-7
17,16,290,19,16,3
17,16,291,6,19,-13
17,16,292,20,12,8
17,16,293,14,17,-3
17,16,294,9,15,-6
17,16,295,13,15,-2
17,16,296,15,20,-5
17,16,297,9,13,-4
17,16,298,27,14,13
17,16,299,16,14,2
17,17,0,11,18,-7
17,17,1,18,28,-10
17,17,2,11,9,2
17,17,3,15,11,4
17,17,4,9,19,-10
17,17,5,18,21,-3
17,17,6,5,10,-5
17,17,7,14,17,-3
17,17,8,25,11,14
17,17,9,13,10,3
17,17,10,15,16,-1
17,17,11,16,21,-5
17,17,12,14,30,-16
17,17,13,14,17,-3
17,17,14,11,18,-7
17,17,15,19,6,13
17,17,16,12,16,-4
17,17,17,13,28,-15
17,17,18,14,12,2
17,17,19,14,27,-13
17,17,20,6,13,-7
17,17,21,5,23,-18
17,17,22,30,28,2
17,17,23,9,14,-5
17,17,24,17,17,0
17,17,25,15,30,-15
17,17,26,9,5,4
17,17,27,10,15,-5
17,17,28,19,7,12
17,17,29,16,18,-2
17,17,30,10,16,-6
17,17,31,17,18,-1
17,17,32,13,13,0
17,17,33,19,20,-1
17,17,34,28,19,9
17,17,35,5,14,-9
17,17,36,7,13,-6
17,17,37,11,9,2
17,17,38,22,19,3
17,17,39,16,15,1
17,17,40,5,12,-7
17,17,41,13,23,-10
17,17,42,8,12,-4
17,17,43,13,15,-2
17,17,44,17,10,7
17,17,45,22,19,3
17,17,46,12,16,-4
17,17,47,17,20,-3
17,17,48,4,11,-7
17,17,49,19,17,2
17,17,50,16,15,1
17,17,51,12,16,-4
17,17,52,19,16,3
17,17,53,19,11,8
17,17,54,14,25,-11
17,17,55,15,3,12
17,17,56,6,11,-5
17,17,57,6,11,-5
17,17,58,8,9,-1
17,17,59,6,12,-6
17,17,60,6,14,-8
17,17,61,23,13,10
17,17,62,21,27,-6
17,17,63,12,18,-6
17,17,64,10,23,-13
17,17,65,5,17,-12
17,17,66,18,16,2
17,17,67,20,13,7
17,17,68,14,19,-5
17,17,69,9,7,2
17,17,70,25,14,11
17,17,71,6,8,-2
17,17,72,8,17,-9
17,17,73,21,14,7
17,17,74,16,18,-2
17,17,75,14,18,-4
17,17,76,16,21,-5
17,17,77,14,13,1
17,17,78,13,8,5
17,17,79,22,15,7
17,17,80,4,10,-6
17,17,81,19,16,3
17,17,82,14,17,-3
17,17,83,11,15,-4
17,17,84,8,13,-5
17,17,85,8,14,-6
17,17,86,26,25,1
17,17,87,20,7,13
17,17,88,16,17,-1
17,17,89,11,19,-8
17,17,90,10,12,-2
17,17,91,13,7,6
17,17,92,11,20,-9
17,17,93,25,8,17
17,17,94,14,21,-7
17,17,95,17,37,-20
17,17,96,16,24,-8
17,17,97,9,18,-9
17,17,98,13,11,2
17,17,99,11,23,-12
17,17,100,8,14,-6
17,17,101,14,11,3
17,17,102,8,23,-15
17,17,103,18,10,8
17,17,104,28,24,4
17,17,105,15,30,-15
17,17,106,15,17,-2
17,17,107,27,18,9
17,17,108,12,12,0
17,17,109,10,17,-7
17,17,110,18,8,10
17,17,111,21,20,1
17,17,112,17,31,-14
17,17,113,8,6,2
17,17,114,8,8,0
17,17,115,10,13,-3
17,17,116,15,7,8
17,17,117,5,7,-2
17,17,118,14,15,-1
17,17,119,18,17,1
17,17,120,13,20,-7
17,17,121,12,22,-10
17,17,122,13,7,6
17,17,123,11,19,-8
17,17,124,11,17,-6
17,17,125,17,15,2
17,17,126,17,22,-5
17,17,127,18,21,-3
17,17,128,15,23,-8
17,17,129,10,14,-4
17,17,130,20,11,9
17,17,131,4,19,-15
17,17,132,16,24,-8
17,17,133,17,17,0
17,17,134,18,12,6
17,17,135,15,23,-8
17,17,136,18,19,-1
17,17,137,5,21,-16
17,17,138,17,28,-11
17,17,139,10,21,-11
17,17,140,5,14,-9
17,17,141,18,24,-6
17,17,142,13,20,-7
17,17,143,17,20,-3
17,17,144,17,20,-3
17,17,145,5,13,-8
17,17,146,9,21,-12
17,17,147,8,21,-13
17,17,148,12,13,-1
17,17,149,20,8,12
17,17,150,6,15,-9
17,17,151,14,23,-9
17,17,152,17,14,3
17,17,153,22,14,8
17,17,154,15,15,0
17,17,155,12,25,-13
17,17,156,19,27,-8
17,17,157,4,4,0
17,17,158,16,28,-12
17,17,159,9,10,-1
17,17,160,5,11,-6
17,17,161,13,17,-4
17,17,162,13,17,-4
17,17,163,19,21,-2
17,17,164,15,16,-1
17,17,165,7,10,-3
17,17,166,18,20,-2
17,17,167,12,14,-2
17,17,168,18,12,6
17,17,169,28,20,8
17,17,170,20,21,-1
17,17,171,24,15,9
17,17,172,25,18,7
17,17,173,9,16,-7
17,17,174,10,19,-9
17,17,175,17,17,0
17,17,176,16,17,-1
17,17,177,8,21,-13
17,17,178,13,12,1
17,17,179,18,25,-7
17,17,180,25,24,1
17,17,181,8,6,2
17,17,182,14,18,-4
17,17,183,15,11,4
17,17,184,25,18,7
17,17,185,18,10,8
17,17,186,15,10,5
17,17,187,16,17,-1
17,17,188,12,17,-5
17,17,189,5,12,-7
17,17,190,11,10,1
17,17,191,16,18,-2
17,17,192,17,20,-3
17,17,193,12,18,-6
17,17,194,8,16,-8
17,17,195,11,4,7
17,17,196,18,23,-5
17,17,197,5,2,3
17,17,198,15,12,3
17,17,199,10,7,3
17,17,200,10,11,-1
17,17,201,12,24,-12
17,17,202,16,8,8
17,17,203,8,14,-6
17,17,204,12,11,1
17,17,205,13,25,-12
17,17,206,2,5,-3
17,17,207,10,9,1
17,17,208,24,28,-4
17,17,209,25,26,-1
17,17,210,16,15,1
17,17,211,8,10,-2
17,17,212,15,21,-6
17,17,213,13,8,5
17,17,214,17,27,-10
17,17,215,18,14,4
17,17,216,8,15,-7
17,17,217,3,10,-7
17,17,218,8,12,-4
17,17,219,18,18,0
17,17,220,23,35,-12
17,17,221,11,5,6
17,17,222,15,22,-7
17,17,223,14,7,7
17,17,224,11,10,1
17,17,225,13,16,-3
17,17,226,12,22,-10
17,17,227,10,8,2
17,17,228,6,3,3
17,17,229,22,7,15
17,17,230,11,9,2
17,17,231,10,10,0
17,17,232,4,23,-19
17,17,233,11,9,2
17,17,234,15,16,-1
17,17,235,20,23,-3
17,17,236,14,19,-5
17,17,237,14,13,1
17,17,238,17,24,-7
17,17,239,11,19,-8
17,17,240,19,20,-1
17,17,241,12,13,-1
17,17,242,13,25,-12
17,17,243,15,13,2
17,17,244,7,14,-7
17,17,245,8,19,-11
17,17,246,13,12,1
17,17,247,28,22,6
17,17,248,11,8,3
17,17,249,5,9,-4
17,17,250,15,14,1
17,17,251,12,14,-2
17,17,252,20,19,1
17,17,253,16,11,5
17,17,254,12,19,-7
17,17,255,8,13,-5
17,17,256,14,28,-14
17,17,257,12,29,-17
17,17,258,10,12,-2
17,17,259,26,20,6
17,17,260,10,9,1
17,17,261,12,16,-4
17,17,262,10,19,-9
17,17,263,9,9,0
17,17,264,10,23,-13
17,17,265,17,18,-1
17,17,266,14,17,-3
17,17,267,7,11,-4
17,17,268,22,20,2
17,17,269,11,13,-2
17,17,270,15,16,-1
17,17,271,14,9,5
17,17,272,13,17,-4
17,17,273,19,24,-5
17,17,274,17,22,-5
17,17,275,7,16,-9
17,17,276,13,18,-5
17,17,277,10,10,0
17,17,278,23,30,-7
17,17,279,13,18,-5
17,17,280,22,15,7
17,17,281,8,18,-10
17,17,282,14,20,-6
17,17,283,18,15,3
17,17,284,12,17,-5
17,17,285,23,31,-8
17,17,286,16,14,2
17,17,287,24,23,1
17,17,288,6,13,-7
17,17,289,4,20,-16
17,17,290,15,18,-3
17,17,291,13,23,-10
17,17,292,13,20,-7
17,17,293,2,15,-13
17,17,294,14,14,0
17,17,295,12,14,-2
17,17,296,13,13,0
17,17,297,21,26,-5
17,17,298,11,12,-1
17,17,299,15,10,5
17,18,0,13,10,3
17,18,1,35,24,11
17,18,2,10,19,-9
17,18,3,11,16,-5
17,18,4,4,6,-2
17,18,5,11,20,-9
17,18,6,6,12,-6
17,18,7,13,14,-1
17,18,8,15,21,-6
17,18,9,14,21,-7
17,18,10,19,20,-1
17,18,11,18,22,-4
17,18,12,14,16,-2
17,18,13,16,22,-6
17,18,14,26,34,-8
17,18,15,26,12,14
17,18,16,6,5,1
17,18,17,24,12,12
17,18,18,16,17,-1
17,18,19,12,9,3
17,18,20,10,16,-6
17,18,21,7,6,1
17,18,22,13,12,1
17,18,23,25,18,7
17,18,24,14,18,-4
17,18,25,13,11,2
17,18,26,10,15,-5
17,18,27,15,20,-5
17,18,28,12,12,0
17,18,29,7,24,-17
17,18,30,10,19,-9
17,18,31,10,19,-9
17,18,32,10,12,-2
17,18,33,15,14,1
17,18,34,23,20,3
17,18,35,14,11,3
17,18,36,27,14,13
17,18,37,26,14,12
17,18,38,21,18,3
17,18,39,19,17,2
17,18,40,13,16,-3
17,18,41,18,16,2
17,18,42,5,10,-5
17,18,43,7,5,2
17,18,44,10,16,-6
17,18,45,12,11,1
17,18,46,36,12,24
17,18,47,18,27,-9
17,18,48,12,16,-4
17,18,49,27,27,0
17,18,50,19,21,-2
17,18,51,12,18,-6
17,18,52,22,13,9
17,18,53,13,15,-2
17,18,54,7,18,-11
17,18,55,19,5,14
17,18,56,6,10,-4
17,18,57,22,15,7
17,18,58,17,17,0
17,18,59,15,17,-2
17,18,60,16,27,-11
17,18,61,9,9,0
17,18,62,25,13,12
17,18,63,20,30,-10
17,18,64,13,9,4
17,18,65,12,17,-5
17,18,66,10,12,-2
17,18,67,12,15,-3
17,18,68,18,7,11
17,18,69,19,16,3
17,18,70,10,7,3
17,18,71,7,20,-13
17,18,72,13,24,-11
17,18,73,14,22,-8
17,18,74,25,15,10
17,18,75,11,11,0
17,18,76,22,18,4
17,18,77,12,11,1
17,18,78,12,16,-4
17,18,79,13,16,-3
17,18,80,14,16,-2
17,18,81,14,13,1
17,18,82,13,15,-2
17,18,83,15,15,0
17,18,84,16,10,6
17,18,85,16,6,10
17,18,86,9,23,-14
17,18,87,22,18,4
17,18,88,18,22,-4
17,18,89,17,18,-1
17,18,90,16,9,7
17,18,91,19,12,7
17,18,92,16,24,-8
17,18,93,24,23,1
17,18,94,19,21,-2
17,18,95,17,23,-6
17,18,96,14,23,-9
17,18,97,19,20,-1
17,18,98,16,16,0
17,18,99,10,11,-1
17,18,100,15,16,-1
17,18,101,15,6,9
17,18,102,21,20,1
17,18,103,4,17,-13
17,18,104,16,8,8
17,18,105,6,10,-4
17,18,106,19,17,2
17,18,107,14,22,-8
17,18,108,16,23,-7
17,18,109,19,15,4
17,18,110,13,15,-2
17,18,111,19,17,2
17,18,112,6,8,-2
17,18,113,14,14,0
17,18,114,25,13,12
17,18,115,16,17,-1
17,18,116,16,5,11
17,18,117,13,20,-7
17,18,118,9,7,2
17,18,119,17,24,-7
17,18,120,7,10,-3
17,18,121,7,8,-1
17,18,122,22,8,14
17,18,123,10,26,-16
17,18,124,8,13,-5
17,18,125,16,16,0
17,18,126,21,18,3
17,18,127,17,17,0
17,18,128,20,24,-4
17,18,129,18,19,-1
17,18,130,13,10,3
17,18,131,11,18,-7
17,18,132,9,9,0
17,18,133,11,20,-9
17,18,134,11,11,0
17,18,135,8,15,-7
17,18,136,6,17,-11
17,18,137,12,20,-8
17,18,138,7,14,-7
17,18,139,20,15,5
17,18,140,14,13,1
17,18,141,15,10,5
17,18,142,15,26,-11
17,18,143,12,22,-10
17,18,144,20,10,10
17,18,145,13,21,-8
17,18,146,12,8,4
17,18,147,8,14,-6
17,18,148,8,17,-9
17,18,149,5,2,3
17,18,150,10,13,-3
17,18,151,8,15,-7
17,18,152,10,15,-5
17,18,153,17,29,-12
17,18,154,19,22,-3
17,18,155,9,19,-10
17,18,156,14,16,-2
17,18,157,22,33,-11
17,18,158,17,12,5
17,18,159,17,17,0
17,18,160,10,18,-8
17,18,161,37,15,22
17,18,162,16,22,-6
17,18,163,16,9,7
17,18,164,5,8,-3
17,18,165,25,13,12
17,18,166,23,19,4
17,18,167,16,12,4
17,18,168,22,13,9
17,18,169,17,6,11
17,18,170,19,15,4
17,18,171,23,20,3
17,18,172,12,20,-8
17,18,173,13,14,-1
17,18,174,11,9,2
17,18,175,7,11,-4
17,18,176,27,13,14
17,18,177,8,17,-9
17,18,178,5,30,-25
17,18,179,11,8,3
17,18,180,9,16,-7
17,18,181,25,32,-7
17,18,182,22,18,4
17,18,183,26,25,1
17,18,184,21,16,5
17,18,185,29,7,22
17,18,186,16,15,1
17,18,187,6,16,-10
17,18,188,13,13,0
17,18,189,20,10,10
17,18,190,9,7,2
17,18,191,15,31,-16
17,18,192,9,9,0
17,18,193,30,20,10
17,18,194,15,18,-3
17,18,195,7,9,-2
17,18,196,19,14,5
17,18,197,14,28,-14
17,18,198,12,19,-7
17,18,199,17,17,0
17,18,200,13,16,-3
17,18,201,12,16,-4
17,18,202,5,15,-10
17,18,203,13,13,0
17,18,204,16,14,2
17,18,205,25,18,7
17,18,206,16,15,1
17,18,207,16,11,5
17,18,208,21,26,-5
17,18,209,16,17,-1
17,18,210,13,14,-1
17,18,211,24,18,6
17,18,212,7,19,-12
17,18,213,18,10,8
17,18,214,11,19,-8
17,18,215,19,19,0
17,18,216,16,9,7
17,18,217,16,11,5
17,18,218,23,18,5
17,18,219,8,8,0
17,18,220,19,25,-6
17,18,221,9,15,-6
17,18,222,12,26,-14
17,18,223,22,23,-1
17,18,224,22,18,4
17,18,225,7,15,-8
17,18,226,16,17,-1
17,18,227,3,3,0
17,18,228,23,20,3
17,18,229,19,12,7
17,18,230,14,25,-11
17,18,231,19,17,2
17,18,232,27,10,17
17,18,233,14,14,0
17,18,234,15,19,-4
17,18,235,11,9,2
17,18,236,27,16,11
17,18,237,11,30,-19
17,18,238,11,19,-8
17,18,239,8,16,-8
17,18,240,15,29,-14
17,18,241,20,29,-9
17,18,242,18,17,1
17,18,243,15,26,-11
17,18,244,16,13,3
17,18,245,14,19,-5
17,18,246,8,14,-6
17,18,247,13,16,-3
17,18,248,16,25,-9
17,18,249,4,13,-9
17,18,250,17,18,-1
17,18,251,4,6,-2
17,18,252,20,29,-9
17,18,253,6,13,-7
17,18,254,16,13,3
17,18,255,16,10,6
17,18,256,24,24,0
17,18,257,19,30,-11
17,18,258,30,14,16
17,18,259,13,27,-14
17,18,260,3,9,-6
17,18,261,6,7,-1
17,18,262,19,14,5
17,18,263,3,6,-3
17,18,264,12,12,0
17,18,265,12,15,-3
17,18,266,15,19,-4
17,18,267,13,24,-11
17,18,268,11,7,4
17,18,269,22,23,-1
17,18,270,12,14,-2
17,18,271,26,14,12
17,18,272,4,16,-12
17,18,273,29,13,16
17,18,274,15,10,5
17,18,275,18,12,6
17,18,276,11,28,-17
17,18,277,17,14,3
17,18,278,23,20,3
17,18,279,6,34,-28
17,18,280,18,18,0
17,18,281,9,30,-21
17,18,282,16,20,-4
17,18,283,9,10,-1
17,18,284,23,22,1
17,18,285,12,10,2
17,18,286,17,16,1
17,18,287,15,26,-11
17,18,288,22,21,1
17,18,289,17,19,-2
17,18,290,17,17,0
17,18,291,10,19,-9
17,18,292,23,16,7
17,18,293,12,13,-1
17,18,294,23,18,5
17,18,295,11,9,2
17,18,296,12,10,2
17,18,297,13,17,-4
17,18,298,5,20,-15
17,18,299,23,25,-2
17,19,0,12,16,-4
17,19,1,16,17,-1
17,19,2,9,19,-10
17,19,3,8,12,-4
17,19,4,12,24,-12
17,19,5,15,11,4
17,19,6,13,12,1
17,19,7,21,8,13
17,19,8,6,18,-12
17,19,9,8,11,-3
17,19,10,14,25,-11
17,19,11,8,15,-7
17,19,12,3,12,-9
17,19,13,13,15,-2
17,19,14,9,11,-2
17,19,15,16,11,5
17,19,16,9,18,-9
17,19,17,21,11,10
17,19,18,31,27,4
17,19,19,19,14,5
17,19,20,15,17,-2
17,19,21,26,26,0
17,19,22,11,7,4
17,19,23,19,8,11
17,19,24,14,12,2
17,19,25,13,27,-14
17,19,26,14,11,3
17,19,27,15,15,0
17,19,28,6,10,-4
17,19,29,14,16,-2
17,19,30,16,18,-2
17,19,31,14,18,-4
17,19,32,13,32,-19
17,19,33,21,13,8
17,19,34,13,15,-2
17,19,35,19,15,4
17,19,36,18,21,-3
17,19,37,18,22,-4
17,19,38,6,19,-13
17,19,39,11,9,2
17,19,40,8,12,-4
17,19,41,26,18,8
17,19,42,6,4,2
17,19,43,13,6,7
17,19,44,14,12,2
17,19,45,18,15,3
17,19,46,7,10,-3
17,19,47,24,29,-5
17,19,48,20,15,5
17,19,49,17,14,3
17,19,50,13,12,1
17,19,51,21,21,0
17,19,52,9,11,-2
17,19,53,22,18,4
17,19,54,11,15,-4
17,19,55,7,7,0
17,19,56,5,13,-8
17,19,57,11,18,-7
17,19,58,12,19,-7
17,19,59,19,20,-1
17,19,60,23,17,6
17,19,61,17,26,-9
17,19,62,7,14,-7
17,19,63,22,19,3
17,19,64,10,13,-3
17,19,65,10,17,-7
17,19,66,18,11,7
17,19,67,22,30,-8
17,19,68,21,17,4
17,19,69,21,12,9
17,19,70,12,19,-7
17,19,71,13,17,-4
17,19,72,26,9,17
17,19,73,8,6,2
17,19,74,19,9,10
17,19,75,25,9,16
17,19,76,16,17,-1
17,19,77,15,16,-1
17,19,78,20,14,6
17,19,79,16,12,4
17,19,80,11,17,-6
17,19,81,12,12,0
17,19,82,8,14,-6
17,19,83,7,13,-6
17,19,84,7,14,-7
17,19,85,10,22,-12
17,19,86,16,25,-9
17,19,87,16,12,4
17,19,88,16,13,3
17,19,89,5,19,-14
17,19,90,13,15,-2
17,19,91,19,16,3
17,19,92,16,25,-9
17,19,93,12,16,-4
17,19,94,13,16,-3
17,19,95,15,10,5
17,19,96,18,10,8
17,19,97,10,17,-7
17,19,98,12,19,-7
17,19,99,13,14,-1
17,19,100,11,21,-10
17,19,101,13,18,-5
17,19,102,21,28,-7
17,19,103,8,8,0
17,19,104,15,10,5
17,19,105,17,24,-7
17,19,106,30,25,5
17,19,107,12,14,-2
17,19,108,15,13,2
17,19,109,10,10,0
17,19,110,8,19,-11
17,19,111,18,11,7
17,19,112,19,10,9
17,19,113,8,9,-1
17,19,114,6,12,-6
17,19,115,14,27,-13
17,19,116,8,12,-4
17,19,117,14,24,-10
17,19,118,15,13,2
17,19,119,18,27,-9
17,19,120,14,7,7
17,19,121,14,21,-7
17,19,122,13,25,-12
17,19,123,13,15,-2
17,19,124,10,13,-3
17,19,125,22,7,15
17,19,126,19,11,8
17,19,127,17,8,9
17,19,128,16,12,4
17,19,129,8,20,-12
17,19,130,14,3,11
17,19,131,6,8,-2
17,19,132,22,22,0
17,19,133,13,33,-20
17,19,134,10,11,-1
17,19,135,3,20,-17
17,19,136,25,10,15
17,19,137,14,13,1
17,19,138,11,30,-19
17,19,139,13,19,-6
17,19,140,19,15,4
17,19,141,12,21,-9
17,19,142,8,11,-3
17,19,143,19,14,5
17,19,144,19,17,2
17,19,145,15,13,2
17,19,146,11,21,-10
17,19,147,10,18,-8
17,19,148,14,18,-4
17,19,149,26,21,5
17,19,150,8,14,-6
17,19,151,12,16,-4
17,19,152,19,17,2
17,19,153,6,12,-6
17,19,154,11,10,1
17,19,155,12,15,-3
17,19,156,20,30,-10
17,19,157,17,13,4
17,19,158,2,10,-8
17,19,159,20,17,3
17,19,160,15,16,-1
17,19,161,18,9,9
17,19,162,15,12,3
17,19,163,5,23,-18
17,19,164,15,4,11
17,19,165,7,8,-1
17,19,166,14,19,-5
17,19,167,12,18,-6
17,19,168,13,16,-3
17,19,169,15,17,-2
17,19,170,24,26,-2
17,19,171,14,25,-11
17,19,172,12,16,-4
17,19,173,18,12,6
17,19,174,13,24,-11
17,19,175,10,20,-10
17,19,176,28,28,0
17,19,177,10,21,-11
17,19,178,18,7,11
17,19,179,22,29,-7
17,19,180,13,15,-2
17,19,181,16,18,-2
17,19,182,8,8,0
17,19,183,18,18,0
17,19,184,16,22,-6
17,19,185,25,19,6
17,19,186,15,16,-1
17,19,187,11,24,-13
17,19,188,16,17,-1
17,19,189,10,13,-3
17,19,190,15,5,10
17,19,191,16,17,-1
17,19,192,8,17,-9
17,19,193,6,14,-8
17,19,194,13,11,2
17,19,195,12,8,4
17,19,196,17,18,-1
17,19,197,20,29,-9
17,19,198,8,16,-8
17,19,199,13,20,-7
17,19,200,14,12,2
17,19,201,9,16,-7
17,19,202,14,13,1
17,19,203,14,16,-2
17,19,204,9,22,-13
17,19,205,20,21,-1
17,19,206,37,26,11
17,19,207,9,11,-2
17,19,208,2,15,-13
17,19,209,7,11,-4
17,19,210,27,18,9
17,19,211,9,4,5
17,19,212,16,6,10
17,19,213,13,19,-6
17,19,214,14,10,4
17,19,215,13,21,-8
17,19,216,7,8,-1
17,19,217,18,12,6
17,19,218,20,12,8
17,19,219,27,13,14
17,19,220,14,13,1
17,19,221,17,9,8
17,19,222,16,10,6
17,19,223,20,22,-2
17,19,224,17,19,-2
17,19,225,7,10,-3
17,19,226,23,18,5
17,19,227,17,24,-7
17,19,228,14,19,-5
17,19,229,27,29,-2
17,19,230,9,16,-7
17,19,231,20,11,9
17,19,232,12,14,-2
17,19,233,24,16,8
17,19,234,6,16,-10
17,19,235,13,28,-15
17,19,236,13,11,2
17,19,237,20,26,-6
17,19,238,15,13,2
17,19,239,13,9,4
17,19,240,9,10,-1
17,19,241,16,16,0
17,19,242,13,7,6
17,19,243,15,4,11
17,19,244,11,8,3
17,19,245,28,21,7
17,19,246,29,19,10
17,19,247,27,20,7
17,19,248,15,17,-2
17,19,249,18,17,1
17,19,250,17,20,-3
17,19,251,17,22,-5
17,19,252,25,24,1
17,19,253,20,17,3
17,19,254,14,18,-4
17,19,255,13,24,-11
17,19,256,16,22,-6
17,19,257,11,10,1
17,19,258,15,17,-2
17,19,259,11,13,-2
17,19,260,15,12,3
17,19,261,9,12,-3
17,19,262,16,25,-9
17,19,263,15,22,-7
17,19,264,13,16,-3
17,19,265,22,12,10
17,19,266,24,15,9
17,19,267,6,13,-7
17,19,268,22,20,2
17,19,269,17,15,2
17,19,270,19,12,7
17,19,271,17,12,5
17,19,272,15,22,-7
17,19,273,18,20,-2
17,19,274,15,17,-2
17,19,275,13,8,5
17,19,276,11,10,1
17,19,277,13,13,0
17,19,278,20,27,-7
17,19,279,22,22,0
17,19,280,11,19,-8
17,19,281,12,10,2
17,19,282,17,18,-1
17,19,283,9,12,-3
17,19,284,21,18,3
17,19,285,17,12,5
17,19,286,14,18,-4
17,19,287,17,20,-3
17,19,288,15,5,10
17,19,289,20,14,6
17,19,290,19,12,7
17,19,291,20,12,8
17,19,292,14,16,-2
17,19,293,36,24,12
17,19,294,16,20,-4
17,19,295,22,5,17
17,19,296,25,24,1
17,19,297,14,15,-1
17,19,298,19,5,14
17,19,299,24,21,3
17,20,0,19,11,8
17,20,1,12,8,4
17,20,2,11,11,0
17,20,3,5,5,0
17,20,4,8,4,4
17,20,5,5,12,-7
17,20,6,9,13,-4
17,20,7,26,15,11
17,20,8,6,8,-2
17,20,9,9,10,-1
17,20,10,15,28,-13
17,20,11,9,11,-2
17,20,12,7,6,1
17,20,13,34,25,9
17,20,14,12,16,-4
17,20,15,6,7,-1
17,20,16,13,15,-2
17,20,17,19,20,-1
17,20,18,17,24,-7
17,20,19,16,25,-9
17,20,20,10,11,-1
17,20,21,23,22,1
17,20,22,10,22,-12
17,20,23,17,12,5
17,20,24,12,15,-3
17,20,25,18,32,-14
17,20,26,17,18,-1
17,20,27,15,9,6
17,20,28,13,12,1
17,20,29,18,19,-1
17,20,30,15,17,-2
17,20,31,21,21,0
17,20,32,20,20,0
17,20,33,22,16,6
17,20,34,22,20,2
17,20,35,20,20,0
17,20,36,23,10,13
17,20,37,24,11,13
17,20,38,10,15,-5
17,20,39,21,24,-3
17,20,40,24,28,-4
17,20,41,16,16,0
17,20,42,12,15,-3
17,20,43,20,22,-2
17,20,44,10,6,4
17,20,45,8,12,-4
17,20,46,7,9,-2
17,20,47,12,10,2
17,20,48,5,15,-10
17,20,49,27,6,21
17,20,50,18,15,3
17,20,51,13,13,0
17,20,52,8,14,-6
17,20,53,12,3,9
17,20,54,13,15,-2
17,20,55,19,8,11
17,20,56,12,7,5
17,20,57,10,9,1
17,20,58,12,16,-4
17,20,59,19,14,5
17,20,60,14,10,4
17,20,61,9,11,-2
17,20,62,15,23,-8
17,20,63,12,13,-1
17,20,64,5,12,-7
17,20,65,8,11,-3
17,20,66,18,22,-4
17,20,67,15,22,-7
17,20,68,10,12,-2
17,20,69,13,13,0
17,20,70,8,7,1
17,20,71,13,15,-2
17,20,72,22,20,2
17,20,73,21,22,-1
17,20,74,23,24,-1
17,20,75,10,15,-5
17,20,76,12,18,-6
17,20,77,14,15,-1
17,20,78,14,10,4
17,20,79,11,15,-4
17,20,80,18,7,11
17,20,81,8,2,6
17,20,82,17,28,-11
17,20,83,12,12,0
17,20,84,9,20,-11
17,20,85,5,16,-11
17,20,86,14,15,-1
17,20,87,17,11,6
17,20,88,14,17,-3
17,20,89,5,9,-4
17,20,90,12,15,-3
17,20,91,7,10,-3
17,20,92,26,17,9
17,20,93,6,14,-8
17,20,94,10,16,-6
17,20,95,16,24,-8
17,20,96,24,27,-3
17,20,97,17,14,3
17,20,98,12,18,-6
17,20,99,10,6,4
17,20,100,9,12,-3
17,20,101,8,12,-4
17,20,102,13,15,-2
17,20,103,5,13,-8
17,20,104,15,17,-2
17,20,105,10,15,-5
17,20,106,8,10,-2
17,20,107,12,11,1
17,20,108,13,5,8
17,20,109,24,25,-1
17,20,110,17,14,3
17,20,111,29,17,12
17,20,112,24,17,7
17,20,113,15,18,-3
17,20,114,15,14,1
17,20,115,14,18,-4
17,20,116,15,10,5
17,20,117,20,24,-4
17,20,118,25,15,10
17,20,119,27,12,15
17,20,120,18,16,2
17,20,121,20,20,0
17,20,122,13,26,-13
17,20,123,8,11,-3
17,20,124,21,12,9
17,20,125,14,20,-6
17,20,126,16,9,7
17,20,127,15,11,4
17,20,128,12,27,-15
17,20,129,11,12,-1
17,20,130,24,17,7
17,20,131,14,17,-3
17,20,132,11,20,-9
17,20,133,15,13,2
17,20,134,21,19,2
17,20,135,8,15,-7
17,20,136,8,12,-4
17,20,137,16,17,-1
17,20,138,10,28,-18
17,20,139,28,16,12
17,20,140,7,18,-11
17,20,141,29,21,8
17,20,142,6,9,-3
17,20,143,13,28,-15
17,20,144,8,9,-1
17,20,145,15,14,1
17,20,146,14,11,3
17,20,147,27,24,3
17,20,148,15,17,-2
17,20,149,13,13,0
17,20,150,16,29,-13
17,20,151,14,15,-1
17,20,152,17,20,-3
17,20,153,14,12,2
17,20,154,18,16,2
17,20,155,24,18,6
17,20,156,14,13,1
17,20,157,14,15,-1
17,20,158,13,11,2
17,20,159,10,7,3
17,20,160,14,2,12
17,20,161,21,14,7
17,20,162,8,16,-8
17,20,163,13,16,-3
17,20,164,16,17,-1
17,20,165,12,14,-2
17,20,166,9,17,-8
17,20,167,13,9,4
17,20,168,22,12,10
17,20,169,20,14,6
17,20,170,13,10,3
17,20,171,29,11,18
17,20,172,16,16,0
17,20,173,13,13,0
17,20,174,8,17,-9
17,20,175,24,14,10
17,20,176,21,21,0
17,20,177,15,10,5
17,20,178,12,15,-3
17,20,179,5,12,-7
17,20,180,10,8,2
17,20,181,11,9,2
17,20,182,18,23,-5
17,20,183,6,8,-2
17,20,184,22,18,4
17,20,185,18,28,-10
17,20,186,14,17,-3
17,20,187,21,10,11
17,20,188,7,11,-4
17,20,189,20,18,2
17,20,190,11,29,-18
17,20,191,19,12,7
17,20,192,18,12,6
17,20,193,10,7,3
17,20,194,6,12,-6
17,20,195,10,25,-15
17,20,196,14,13,1
17,20,197,20,26,-6
17,20,198,12,9,3
17,20,199,12,18,-6
17,20,200,14,15,-1
17,20,201,13,15,-2
17,20,202,15,10,5
17,20,203,23,10,13
17,20,204,18,17,1
17,20,205,12,21,-9
17,20,206,25,9,16
17,20,207,11,8,3
17,20,208,27,20,7
17,20,209,9,10,-1
17,20,210,16,20,-4
17,20,211,9,11,-2
17,20,212,12,8,4
17,20,213,11,22,-11
17,20,214,20,22,-2
17,20,215,19,13,6
17,20,216,22,28,-6
17,20,217,14,12,2
17,20,218,14,22,-8
17,20,219,25,29,-4
17,20,220,12,15,-3
17,20,221,14,25,-11
17,20,222,23,14,9
17,20,223,9,10,-1
17,20,224,10,7,3
17,20,225,21,10,11
17,20,226,8,16,-8
17,20,227,7,16,-9
17,20,228,13,12,1
17,20,229,17,18,-1
17,20,230,9,10,-1
17,20,231,7,17,-10
17,20,232,7,8,-1
17,20,233,10,16,-6
17,20,234,15,11,4
17,20,235,12,15,-3
17,20,236,32,22,10
17,20,237,9,8,1
17,20,238,8,12,-4
17,20,239,13,12,1
17,20,240,21,19,2
17,20,241,16,18,-2
17,20,242,14,29,-15
17,20,243,20,19,1
17,20,244,14,17,-3
17,20,245,26,19,7
17,20,246,9,18,-9
17,20,247,11,16,-5
17,20,248,8,15,-7
17,20,249,10,16,-6
17,20,250,22,10,12
17,20,251,15,8,7
17,20,252,19,30,-11
17,20,253,21,18,3
17,20,254,15,22,-7
17,20,255,1,19,-18
17,20,256,23,11,12
17,20,257,25,17,8
17,20,258,15,27,-12
17,20,259,14,11,3
17,20,260,18,13,5
17,20,261,19,23,-4
17,20,262,18,19,-1
17,20,263,10,10,0
17,20,264,8,8,0
17,20,265,12,10,2
17,20,266,16,21,-5
17,20,267,16,18,-2
17,20,268,23,15,8
17,20,269,16,25,-9
17,20,270,24,8,16
17,20,271,14,20,-6
17,20,272,12,14,-2
17,20,273,19,9,10
17,20,274,10,21,-11
17,20,275,16,15,1
17,20,276,20,17,3
17,20,277,6,10,-4
17,20,278,18,17,1
17,20,279,7,14,-7
17,20,280,22,15,7
17,20,281,17,13,4
17,20,282,10,7,3
17,20,283,12,21,-9
17,20,284,17,14,3
17,20,285,3,14,-11
17,20,286,14,19,-5
17,20,287,20,21,-1
17,20,288,15,19,-4
17,20,289,17,8,9
17,20,290,16,15,1
17,20,291,14,13,1
17,20,292,13,14,-1
17,20,293,21,14,7
17,20,294,21,8,13
17,20,295,8,8,0
17,20,296,6,10,-4
17,20,297,13,8,5
17,20,298,12,10,2
17,20,299,16,11,5
17,21,0,14,22,-8
17,21,1,19,23,-4
17,21,2,7,15,-8
17,21,3,11,5,6
17,21,4,14,22,-8
17,21,5,13,21,-8
17,21,6,13,10,3
17,21,7,14,17,-3
17,21,8,8,15,-7
17,21,9,9,18,-9
17,21,10,12,10,2
17,21,11,29,16,13
17,21,12,9,3,6
17,21,13,8,21,-13
17,21,14,18,15,3
17,21,15,25,21,4
17,21,16,16,16,0
17,21,17,14,12,2
17,21,18,7,7,0
17,21,19,19,16,3
17,21,20,12,23,-11
17,21,21,13,12,1
17,21,22,6,12,-6
17,21,23,15,38,-23
17,21,24,30,19,11
17,21,25,22,9,13
17,21,26,5,14,-9
17,21,27,35,14,21
17,21,28,13,21,-8
17,21,29,25,22,3
17,21,30,25,6,19
17,21,31,11,19,-8
17,21,32,12,21,-9
17,21,33,15,15,0
17,21,34,15,13,2
17,21,35,21,20,1
17,21,36,3,8,-5
17,21,37,14,12,2
17,21,38,10,14,-4
17,21,39,11,12,-1
17,21,40,2,28,-26
17,21,41,19,12,7
17,21,42,6,6,0
17,21,43,23,13,10
17,21,44,17,22,-5
17,21,45,19,15,4
17,21,46,21,8,13
17,21,47,9,14,-5
17,21,48,24,24,0
17,21,49,10,15,-5
17,21,50,19,19,0
17,21,51,12,17,-5
17,21,52,7,12,-5
17,21,53,10,16,-6
17,21,54,13,25,-12
17,21,55,9,12,-3
17,21,56,12,12,0
17,21,57,13,12,1
17,21,58,23,12,11
17,21,59,11,17,-6
17,21,60,16,12,4
17,21,61,8,21,-13
17,21,62,26,16,10
17,21,63,10,7,3
17,21,64,16,6,10
17,21,65,9,20,-11
17,21,66,17,30,-13
17,21,67,24,16,8
17,21,68,17,17,0
17,21,69,6,7,-1
17,21,70,15,15,0
17,21,71,16,10,6
17,21,72,12,11,1
17,21,73,13,15,-2
17,21,74,13,7,6
17,21,75,19,19,0
17,21,76,12,23,-11
17,21,77,20,16,4
17,21,78,26,7,19
17,21,79,12,17,-5
17,21,80,21,14,7
17,21,81,14,10,4
17,21,82,18,6,12
17,21,83,12,12,0
17,21,84,12,16,-4
17,21,85,7,10,-3
17,21,86,25,6,19
17,21,87,17,14,3
17,21,88,17,11,6
17,21,89,11,22,-11
17,21,90,20,13,7
17,21,91,23,10,13
17,21,92,11,23,-12
17,21,93,12,19,-7
17,21,94,12,7,5
17,21,95,31,28,3
17,21,96,10,5,5
17,21,97,7,11,-4
17,21,98,17,7,10
17,21,99,18,23,-5
17,21,100,16,9,7
17,21,101,12,27,-15
17,21,102,17,8,9
17,21,103,9,7,2
17,21,104,21,11,10
17,21,105,17,18,-1
17,21,106,11,13,-2
17,21,107,3,8,-5
17,21,108,3,4,-1
17,21,109,14,9,5
17,21,110,18,13,5
17,21,111,14,11,3
17,21,112,23,21,2
17,21,113,13,21,-8
17,21,114,10,16,-6
17,21,115,6,11,-5
17,21,116,8,11,-3
17,21,117,5,14,-9
17,21,118,21,23,-2
17,21,119,14,13,1
17,21,120,15,14,1
17,21,121,12,14,-2
17,21,122,6,9,-3
17,21,123,16,15,1
17,21,124,3,6,-3
17,21,125,18,13,5
17,21,126,9,15,-6
17,21,127,25,14,11
17,21,128,24,15,9
17,21,129,19,11,8
17,21,130,25,28,-3
17,21,131,11,14,-3
17,21,132,20,11,9
17,21,133,11,7,4
17,21,134,20,30,-10
17,21,135,13,16,-3
17,21,136,7,14,-7
17,21,137,33,16,17
17,21,138,11,7,4
17,21,139,15,15,0
17,21,140,16,10,6
17,21,141,13,9,4
17,21,142,15,17,-2
17,21,143,29,23,6
17,21,144,9,17,-8
17,21,145,17,10,7
17,21,146,3,21,-18
17,21,147,21,8,13
17,21,148,16,13,3
17,21,149,12,15,-3
17,21,150,5,11,-6
17,21,151,14,19,-5
17,21,152,19,9,10
17,21,153,5,19,-14
17,21,154,11,19,-8
17,21,155,5,10,-5
17,21,156,21,3,18
17,21,157,12,11,1
17,21,158,13,9,4
17,21,159,10,10,0
17,21,160,15,11,4
17,21,161,13,15,-2
17,21,162,16,7,9
17,21,163,15,14,1
17,21,164,20,15,5
17,21,165,21,17,4
17,21,166,11,19,-8
17,21,167,25,29,-4
17,21,168,9,3,6
17,21,169,7,9,-2
17,21,170,7,19,-12
17,21,171,5,7,-2
17,21,172,14,19,-5
17,21,173,11,17,-6
17,21,174,17,10,7
17,21,175,12,22,-10
17,21,176,19,13,6
17,21,177,12,10,2
17,21,178,10,16,-6
17,21,179,23,16,7
17,21,180,17,10,7
17,21,181,15,10,5
17,21,182,16,17,-1
17,21,183,16,21,-5
17,21,184,9,20,-11
17,21,185,8,12,-4
17,21,186,18,8,10
17,21,187,11,8,3
17,21,188,16,11,5
17,21,189,6,6,0
17,21,190,8,16,-8
17,21,191,14,20,-6
17,21,192,20,24,-4
17,21,193,18,11,7
17,21,194,15,5,10
17,21,195,25,18,7
17,21,196,15,11,4
17,21,197,24,20,4
17,21,198,23,20,3
17,21,199,15,11,4
17,21,200,7,10,-3
17,21,201,12,25,-13
17,21,202,12,17,-5
17,21,203,24,10,14
17,21,204,8,14,-6
17,21,205,27,15,12
17,21,206,18,13,5
17,21,207,23,16,7
17,21,208,10,1,9
17,21,209,19,17,2
17,21,210,13,36,-23
17,21,211,18,16,2
17,21,212,8,14,-6
17,21,213,19,18,1
17,21,214,14,20,-6
17,21,215,11,19,-8
17,21,216,11,15,-4
17,21,217,17,7,10
17,21,218,13,4,9
17,21,219,12,16,-4
17,21,220,11,10,1
17,21,221,16,32,-16
17,21,222,19,15,4
17,21,223,16,13,3
17,21,224,17,15,2
17,21,225,12,15,-3
17,21,226,14,8,6
17,21,227,6,8,-2
17,21,228,9,13,-4
17,21,229,8,8,0
17,21,230,16,23,-7
17,21,231,17,14,3
17,21,232,24,16,8
17,21,233,18,21,-3
17,21,234,21,24,-3
17,21,235,5,9,-4
17,21,236,14,10,4
17,21,237,12,14,-2
17,21,238,9,9,0
17,21,239,10,21,-11
17,21,240,17,14,3
17,21,241,33,15,18
17,21,242,12,9,3
17,21,243,9,16,-7
17,21,244,14,14,0
17,21,245,10,14,-4
17,21,246,20,5,15
17,21,247,9,11,-2
17,21,248,15,18,-3
17,21,249,19,18,1
17,21,250,23,19,4
17,21,251,9,15,-6
17,21,252,11,5,6
17,21,253,14,13,1
17,21,254,20,27,-7
17,21,255,19,10,9
17,21,256,8,29,-21
17,21,257,8,13,-5
17,21,258,18,11,7
17,21,259,16,18,-2
17,21,260,17,20,-3
17,21,261,18,11,7
17,21,262,18,12,6
17,21,263,2,25,-23
17,21,264,15,15,0
17,21,265,12,17,-5
17,21,266,11,12,-1
17,21,267,22,18,4
17,21,268,19,16,3
17,21,269,30,20,10
17,21,270,18,10,8
17,21,271,5,11,-6
17,21,272,18,19,-1
17,21,273,23,16,7
17,21,274,15,13,2
17,21,275,13,5,8
17,21,276,20,29,-9
17,21,277,15,28,-13
17,21,278,10,14,-4
17,21,279,9,15,-6
17,21,280,9,10,-1
17,21,281,11,19,-8
17,21,282,14,21,-7
17,21,283,3,7,-4
17,21,284,14,21,-7
17,21,285,16,13,3
17,21,286,11,16,-5
17,21,287,13,26,-13
17,21,288,10,13,-3
17,21,289,16,13,3
17,21,290,22,25,-3
17,21,291,25,20,5
17,21,292,21,11,10
17,21,293,14,16,-2
17,21,294,13,18,-5
17,21,295,16,17,-1
17,21,296,15,10,5
17,21,297,15,19,-4
17,21,298,12,23,-11
17,21,299,8,11,-3
17,22,0,11,10,1
17,22,1,15,15,0
17,22,2,12,11,1
17,22,3,27,15,12
17,22,4,28,17,11
17,22,5,12,6,6
17,22,6,31,26,5
17,22,7,13,12,1
17,22,8,11,10,1
17,22,9,13,7,6
17,22,10,14,13,1
17,22,11,6,7,-1
17,22,12,16,12,4
17,22,13,20,24,-4
17,22,14,9,23,-14
17,22,15,13,14,-1
17,22,16,12,19,-7
17,22,17,23,17,6
17,22,18,17,17,0
17,22,19,11,8,3
17,22,20,13,14,-1
17,22,21,12,17,-5
17,22,22,17,16,1
17,22,23,14,19,-5
17,22,24,14,9,5
17,22,25,17,23,-6
17,22,26,17,14,3
17,22,27,31,19,12
17,22,28,13,10,3
17,22,29,21,20,1
17,22,30,23,14,9
17,22,31,16,8,8
17,22,32,14,14,0
17,22,33,17,7,10
17,22,34,12,5,7
17,22,35,4,21,-17
17,22,36,15,24,-9
17,22,37,19,17,2
17,22,38,28,8,20
17,22,39,26,30,-4
17,22,40,16,17,-1
17,22,41,11,11,0
17,22,42,11,10,1
17,22,43,12,10,2
17,22,44,25,19,6
17,22,45,16,13,3
17,22,46,24,26,-2
17,22,47,11,18,-7
17,22,48,7,15,-8
17,22,49,8,20,-12
17,22,50,4,18,-14
17,22,51,17,14,3
17,22,52,16,13,3
17,22,53,12,15,-3
17,22,54,13,19,-6
17,22,55,11,16,-5
17,22,56,8,20,-12
17,22,57,0,6,-6
17,22,58,17,15,2
17,22,59,17,16,1
17,22,60,14,5,9
17,22,61,9,13,-4
17,22,62,11,17,-6
17,22,63,17,3,14
17,22,64,18,16,2
17,22,65,10,10,0
17,22,66,18,17,1
17,22,67,21,14,7
17,22,68,12,12,0
17,22,69,28,13,15
17,22,70,18,11,7
17,22,71,25,13,12
17,22,72,13,12,1
17,22,73,15,14,1
17,22,74,16,12,4
17,22,75,19,23,-4
17,22,76,18,22,-4
17,22,77,17,37,-20
17,22,78,11,8,3
17,22,79,19,9,10
17,22,80,8,4,4
17,22,81,22,24,-2
17,22,82,7,18,-11
17,22,83,21,16,5
17,22,84,27,20,7
17,22,85,12,16,-4
17,22,86,21,14,7
17,22,87,18,4,14
17,22,88,22,20,2
17,22,89,10,12,-2
17,22,90,16,21,-5
17,22,91,13,7,6
17,22,92,14,10,4
17,22,93,22,12,10
17,22,94,11,13,-2
17,22,95,17,14,3
17,22,96,19,10,9
17,22,97,17,18,-1
17,22,98,1,11,-10
17,22,99,18,5,13
17,22,100,24,20,4
17,22,101,12,2,10
17,22,102,20,28,-8
17,22,103,12,11,1
17,22,104,6,12,-6
17,22,105,25,7,18
17,22,106,21,17,4
17,22,107,5,27,-22
17,22,108,15,9,6
17,22,109,8,16,-8
17,22,110,17,17,0
17,22,111,13,12,1
17,22,112,16,16,0
17,22,113,14,10,4
17,22,114,10,14,-4
17,22,115,18,17,1
17,22,116,25,17,8
17,22,117,21,14,7
17,22,118,10,5,5
17,22,119,11,12,-1
17,22,120,11,13,-2
17,22,121,7,3,4
17,22,122,13,18,-5
17,22,123,13,15,-2
17,22,124,14,15,-1
17,22,125,16,15,1
17,22,126,17,25,-8
17,22,127,4,28,-24
17,22,128,15,13,2
17,22,129,6,9,-3
17,22,130,12,25,-13
17,22,131,21,22,-1
17,22,132,11,12,-1
17,22,133,19,17,2
17,22,134,8,16,-8
17,22,135,20,8,12
17,22,136,23,21,2
17,22,137,15,10,5
17,22,138,16,28,-12
17,22,139,12,23,-11
17,22,140,16,16,0
17,22,141,15,26,-11
17,22,142,20,20,0
17,22,143,34,22,12
17,22,144,20,17,3
17,22,145,28,10,18
17,22,146,14,15,-1
17,22,147,5,10,-5
17,22,148,14,10,4
17,22,149,10,8,2
17,22,150,16,18,-2
17,22,151,19,12,7
17,22,152,14,29,-15
17,22,153,15,21,-6
17,22,154,3,9,-6
17,22,155,34,21,13
17,22,156,21,16,5
17,22,157,9,23,-14
17,22,158,22,12,10
17,22,159,19,17,2
17,22,160,10,9,1
17,22,161,18,15,3
17,22,162,5,12,-7
17,22,163,11,18,-7
17,22,164,18,12,6
17,22,165,10,13,-3
17,22,166,12,16,-4
17,22,167,13,13,0
17,22,168,7,5,2
17,22,169,12,10,2
17,22,170,5,10,-5
17,22,171,9,8,1
17,22,172,11,16,-5
17,22,173,20,18,2
17,22,174,19,13,6
17,22,175,17,20,-3
17,22,176,21,14,7
17,22,177,22,21,1
17,22,178,13,12,1
17,22,179,4,6,-2
17,22,180,22,19,3
17,22,181,11,19,-8
17,22,182,6,15,-9
17,22,183,24,11,13
17,22,184,17,15,2
17,22,185,15,15,0
17,22,186,17,25,-8
17,22,187,20,24,-4
17,22,188,11,13,-2
17,22,189,17,26,-9
17,22,190,7,15,-8
17,22,191,12,14,-2
17,22,192,15,25,-10
17,22,193,18,15,3
17,22,194,11,19,-8
17,22,195,17,12,5
17,22,196,18,11,7
17,22,197,29,11,18
17,22,198,22,27,-5
17,22,199,16,13,3
17,22,200,11,11,0
17,22,201,16,16,0
17,22,202,29,34,-5
17,22,203,12,6,6
17,22,204,5,6,-1
17,22,205,16,14,2
17,22,206,16,35,-19
17,22,207,16,19,-3
17,22,208,8,8,0
17,22,209,10,11,-1
17,22,210,11,20,-9
17,22,211,9,13,-4
17,22,212,14,21,-7
17,22,213,24,19,5
17,22,214,18,10,8
17,22,215,12,14,-2
17,22,216,12,4,8
17,22,217,22,21,1
17,22,218,18,25,-7
17,22,219,20,11,9
17,22,220,14,12,2
17,22,221,25,18,7
17,22,222,7,0,7
17,22,223,9,10,-1
17,22,224,8,18,-10
17,22,225,18,3,15
17,22,226,24,18,6
17,22,227,9,9,0
17,22,228,15,29,-14
17,22,229,6,13,-7
17,22,230,7,21,-14
17,22,231,24,21,3
17,22,232,8,10,-2
17,22,233,21,24,-3
17,22,234,12,13,-1
17,22,235,16,17,-1
17,22,236,13,18,-5
17,22,237,10,10,0
17,22,238,14,16,-2
17,22,239,17,21,-4
17,22,240,9,17,-8
17,22,241,18,11,7
17,22,242,15,19,-4
17,22,243,19,11,8
17,22,244,23,17,6
17,22,245,4,14,-10
17,22,246,9,2,7
17,22,247,17,19,-2
17,22,248,16,30,-14
17,22,249,7,10,-3
17,22,250,20,24,-4
17,22,251,14,21,-7
17,22,252,23,16,7
17,22,253,20,27,-7
17,22,254,16,15,1
17,22,255,13,13,0
17,22,256,7,8,-1
17,22,257,22,10,12
17,22,258,18,27,-9
17,22,259,9,13,-4
17,22,260,13,23,-10
17,22,261,19,18,1
17,22,262,4,11,-7
17,22,263,10,9,1
17,22,264,12,11,1
17,22,265,10,16,-6
17,22,266,6,22,-16
17,22,267,10,8,2
17,22,268,14,15,-1
17,22,269,13,10,3
17,22,270,19,9,10
17,22,271,12,17,-5
17,22,272,14,17,-3
17,22,273,12,5,7
17,22,274,29,28,1
17,22,275,17,12,5
17,22,276,17,21,-4
17,22,277,17,22,-5
17,22,278,22,21,1
17,22,279,13,18,-5
17,22,280,10,11,-1
17,22,281,16,18,-2
17,22,282,13,12,1
17,22,283,14,21,-7
17,22,284,18,21,-3
17,22,285,18,14,4
17,22,286,6,16,-10
17,22,287,23,15,8
17,22,288,20,20,0
17,22,289,6,7,-1
17,22,290,10,12,-2
17,22,291,14,19,-5
17,22,292,8,9,-1
17,22,293,16,14,2
17,22,294,8,1,7
17,22,295,17,16,1
17,22,296,22,14,8
17,22,297,9,13,-4
17,22,298,21,36,-15
17,22,299,6,6,0
17,23,0,31,33,-2
17,23,1,23,11,12
17,23,2,18,17,1
17,23,3,10,9,1
17,23,4,20,17,3
17,23,5,20,22,-2
17,23,6,13,8,5
17,23,7,13,7,6
17,23,8,36,26,10
17,23,9,18,12,6
17,23,10,9,6,3
17,23,11,19,17,2
17,23,12,11,10,1
17,23,13,17,20,-3
17,23,14,18,9,9
17,23,15,20,15,5
17,23,16,21,21,0
17,23,17,18,16,2
17,23,18,11,7,4
17,23,19,18,17,1
17,23,20,12,12,0
17,23,21,13,28,-15
17,23,22,21,5,16
17,23,23,12,20,-8
17,23,24,20,6,14
17,23,25,21,12,9
17,23,26,20,18,2
17,23,27,30,8,22
17,23,28,25,8,17
17,23,29,16,23,-7
17,23,30,14,19,-5
17,23,31,16,20,-4
17,23,32,6,19,-13
17,23,33,14,12,2
17,23,34,11,12,-1
17,23,35,14,13,1
17,23,36,9,6,3
17,23,37,10,11,-1
17,23,38,15,22,-7
17,23,39,17,14,3
17,23,40,13,18,-5
17,23,41,16,19,-3
17,23,42,11,1,10
17,23,43,15,8,7
17,23,44,27,28,-1
17,23,45,13,25,-12
17,23,46,13,16,-3
17,23,47,10,21,-11
17,23,48,22,12,10
17,23,49,9,7,2
17,23,50,21,10,11
17,23,51,13,11,2
17,23,52,10,12,-2
17,23,53,13,23,-10
17,23,54,14,6,8
17,23,55,14,7,7
17,23,56,18,24,-6
17,23,57,15,9,6
17,23,58,10,9,1
17,23,59,14,13,1
17,23,60,7,16,-9
17,23,61,17,10,7
17,23,62,22,22,0
17,23,63,16,29,-13
17,23,64,8,17,-9
17,23,65,17,8,9
17,23,66,8,24,-16
17,23,67,10,13,-3
17,23,68,13,9,4
17,23,69,13,11,2
17,23,70,19,13,6
17,23,71,22,10,12
17,23,72,20,15,5
17,23,73,10,11,-1
17,23,74,12,13,-1
17,23,75,13,16,-3
17,23,76,10,9,1
17,23,77,18,7,11
17,23,78,25,19,6
17,23,79,22,19,3
17,23,80,8,13,-5
17,23,81,10,8,2
17,23,82,10,23,-13
17,23,83,26,16,10
17,23,84,11,12,-1
17,23,85,9,10,-1
17,23,86,6,15,-9
17,23,87,7,7,0
17,23,88,11,10,1
17,23,89,15,14,1
17,23,90,21,21,0
17,23,91,18,24,-6
17,23,92,17,13,4
17,23,93,13,17,-4
17,23,94,20,9,11
17,23,95,18,12,6
17,23,96,17,14,3
17,23,97,13,13,0
17,23,98,16,10,6
17,23,99,17,10,7
17,23,100,15,22,-7
17,23,101,12,7,5
17,23,102,11,6,5
17,23,103,14,10,4
17,23,104,28,13,15
17,23,105,31,16,15
17,23,106,10,11,-1
17,23,107,16,10,6
17,23,108,14,12,2
17,23,109,18,15,3
17,23,110,8,5,3
17,23,111,14,10,4
17,23,112,18,8,10
17,23,113,9,18,-9
17,23,114,13,7,6
17,23,115,11,6,5
17,23,116,17,3,14
17,23,117,13,10,3
17,23,118,18,17,1
17,23,119,20,13,7
17,23,120,13,22,-9
17,23,121,11,20,-9
17,23,122,9,20,-11
17,23,123,5,7,-2
17,23,124,14,15,-1
17,23,125,21,20,1
17,23,126,19,15,4
17,23,127,21,9,12
17,23,128,6,1,5
17,23,129,17,8,9
17,23,130,15,25,-10
17,23,131,14,14,0
17,23,132,5,12,-7
17,23,133,20,16,4
17,23,134,21,13,8
17,23,135,16,15,1
17,23,136,20,9,11
17,23,137,21,16,5
17,23,138,20,16,4
17,23,139,10,12,-2
17,23,140,17,19,-2
17,23,141,23,17,6
17,23,142,15,19,-4
17,23,143,11,25,-14
17,23,144,18,14,4
17,23,145,8,12,-4
17,23,146,7,13,-6
17,23,147,10,21,-11
17,23,148,6,11,-5
17,23,149,14,20,-6
17,23,150,19,18,1
17,23,151,22,33,-11
17,23,152,15,22,-7
17,23,153,16,20,-4
17,23,154,16,16,0
17,23,155,26,10,16
17,23,156,16,22,-6
17,23,157,20,13,7
17,23,158,12,10,2
17,23,159,11,13,-2
17,23,160,20,11,9
17,23,161,15,21,-6
17,23,162,12,13,-1
17,23,163,20,20,0
17,23,164,19,15,4
17,23,165,5,10,-5
17,23,166,13,2,11
17,23,167,16,10,6
17,23,168,18,10,8
17,23,169,18,22,-4
17,23,170,17,23,-6
17,23,171,7,13,-6
17,23,172,12,5,7
17,23,173,5,15,-10
17,23,174,11,5,6
17,23,175,7,15,-8
17,23,176,8,13,-5
17,23,177,8,7,1
17,23,178,14,8,6
17,23,179,27,29,-2
17,23,180,9,28,-19
17,23,181,25,17,8
17,23,182,21,9,12
17,23,183,25,30,-5
17,23,184,15,13,2
17,23,185,2,12,-10
17,23,186,5,9,-4
17,23,187,10,9,1
17,23,188,16,20,-4
17,23,189,21,26,-5
17,23,190,21,20,1
17,23,191,19,7,12
17,23,192,21,16,5
17,23,193,13,24,-11
17,23,194,13,2,11
17,23,195,26,14,12
17,23,196,11,22,-11
17,23,197,30,12,18
17,23,198,15,14,1
17,23,199,17,10,7
17,23,200,13,14,-1
17,23,201,6,19,-13
17,23,202,8,9,-1
17,23,203,10,8,2
17,23,204,7,16,-9
17,23,205,6,11,-5
17,23,206,11,7,4
17,23,207,10,17,-7
17,23,208,12,4,8
17,23,209,13,7,6
17,23,210,10,15,-5
17,23,211,23,11,12
17,23,212,12,6,6
17,23,213,19,12,7
17,23,214,20,13,7
17,23,215,20,14,6
17,23,216,12,8,4
17,23,217,11,10,1
17,23,218,12,14,-2
17,23,219,9,16,-7
17,23,220,13,21,-8
17,23,221,10,7,3
17,23,222,9,10,-1
17,23,223,13,18,-5
17,23,224,14,11,3
17,23,225,12,16,-4
17,23,226,16,14,2
17,23,227,15,7,8
17,23,228,8,17,-9
17,23,229,11,25,-14
17,23,230,12,11,1
17,23,231,22,8,14
17,23,232,13,11,2
17,23,233,16,14,2
17,23,234,4,19,-15
17,23,235,21,12,9
17,23,236,14,5,9
17,23,237,27,4,23
17,23,238,24,24,0
17,23,239,12,9,3
17,23,240,21,30,-9
17,23,241,16,10,6
17,23,242,12,10,2
17,23,243,18,16,2
17,23,244,14,5,9
17,23,245,35,21,14
17,23,246,22,20,2
17,23,247,17,5,12
17,23,248,15,17,-2
17,23,249,8,13,-5
17,23,250,16,11,5
17,23,251,22,28,-6
17,23,252,17,19,-2
17,23,253,6,25,-19
17,23,254,27,16,11
17,23,255,24,16,8
17,23,256,11,19,-8
17,23,257,11,19,-8
17,23,258,1,11,-10
17,23,259,14,11,3
17,23,260,10,10,0
17,23,261,12,12,0
17,23,262,18,8,10
17,23,263,10,7,3
17,23,264,26,15,11
17,23,265,13,12,1
17,23,266,14,6,8
17,23,267,15,21,-6
17,23,268,31,10,21
17,23,269,12,24,-12
17,23,270,19,14,5
17,23,271,13,10,3
17,23,272,22,15,7
17,23,273,14,10,4
17,23,274,8,11,-3
17,23,275,21,28,-7
17,23,276,15,10,5
17,23,277,19,11,8
17,23,278,15,15,0
17,23,279,11,13,-2
17,23,280,21,12,9
17,23,281,9,10,-1
17,23,282,14,20,-6
17,23,283,18,19,-1
17,23,284,14,4,10
17,23,285,23,20,3
17,23,286,11,21,-10
17,23,287,7,13,-6
17,23,288,15,14,1
17,23,289,18,20,-2
17,23,290,8,14,-6
17,23,291,21,9,12
17,23,292,17,22,-5
17,23,293,20,8,12
17,23,294,26,26,0
17,23,295,20,8,12
17,23,296,7,10,-3
17,23,297,6,16,-10
17,23,298,12,12,0
17,23,299,16,10,6
17,24,0,3,7,-4
17,24,1,17,10,7
17,24,2,16,17,-1
17,24,3,17,11,6
17,24,4,12,12,0
17,24,5,13,12,1
17,24,6,15,15,0
17,24,7,16,11,5
17,24,8,12,12,0
17,24,9,2,8,-6
17,24,10,21,15,6
17,24,11,4,14,-10
17,24,12,17,14,3
17,24,13,12,4,8
17,24,14,8,16,-8
17,24,15,21,11,10
17,24,16,13,20,-7
17,24,17,18,10,8
17,24,18,18,11,7
17,24,19,19,8,11
17,24,20,20,8,12
17,24,21,19,20,-1
17,24,22,14,12,2
17,24,23,14,9,5
17,24,24,12,14,-2
17,24,25,15,9,6
17,24,26,18,24,-6
17,24,27,16,22,-6
17,24,28,17,15,2
17,24,29,23,15,8
17,24,30,20,13,7
17,24,31,9,19,-10
17,24,32,13,21,-8
17,24,33,22,7,15
17,24,34,22,25,-3
17,24,35,18,7,11
17,24,36,15,11,4
17,24,37,13,19,-6
17,24,38,10,18,-8
17,24,39,9,14,-5
17,24,40,14,19,-5
17,24,41,17,16,1
17,24,42,22,16,6
17,24,43,27,14,13
17,24,44,4,9,-5
17,24,45,20,14,6
17,24,46,32,16,16
17,24,47,18,11,7
17,24,48,26,12,14
17,24,49,24,16,8
17,24,50,16,15,1
17,24,51,13,24,-11
17,24,52,20,9,11
17,24,53,10,12,-2
17,24,54,33,19,14
17,24,55,13,12,1
17,24,56,12,5,7
17,24,57,9,8,1
17,24,58,7,13,-6
17,24,59,16,17,-1
17,24,60,14,17,-3
17,24,61,22,22,0
17,24,62,15,9,6
17,24,63,8,13,-5
17,24,64,10,10,0
17,24,65,11,12,-1
17,24,66,12,17,-5
17,24,67,18,11,7
17,24,68,7,15,-8
17,24,69,22,9,13
17,24,70,9,14,-5
17,24,71,16,12,4
17,24,72,18,10,8
17,24,73,17,10,7
17,24,74,6,6,0
17,24,75,25,14,11
17,24,76,11,13,-2
17,24,77,27,18,9
17,24,78,10,13,-3
17,24,79,14,15,-1
17,24,80,24,17,7
17,24,81,34,15,19
17,24,82,9,10,-1
17,24,83,11,5,6
17,24,84,15,15,0
17,24,85,16,7,9
17,24,86,6,11,-5
17,24,87,13,13,0
17,24,88,13,6,7
17,24,89,18,10,8
17,24,90,22,17,5
17,24,91,17,19,-2
17,24,92,17,15,2
17,24,93,20,19,1
17,24,94,15,11,4
17,24,95,24,12,12
17,24,96,7,11,-4
17,24,97,16,9,7
17,24,98,12,16,-4
17,24,99,18,8,10
17,24,100,11,9,2
17,24,101,20,24,-4
17,24,102,9,7,2
17,24,103,35,18,17
17,24,104,18,23,-5
17,24,105,17,15,2
17,24,106,20,11,9
17,24,107,15,9,6
17,24,108,10,13,-3
17,24,109,9,9,0
17,24,110,11,5,6
17,24,111,17,15,2
17,24,112,20,11,9
17,24,113,23,18,5
17,24,114,14,6,8
17,24,115,9,5,4
17,24,116,10,19,-9
17,24,117,12,15,-3
17,24,118,18,20,-2
17,24,119,18,8,10
17,24,120,7,15,-8
17,24,121,13,13,0
17,24,122,18,17,1
17,24,123,7,8,-1
17,24,124,20,12,8
17,24,125,18,11,7
17,24,126,20,12,8
17,24,127,13,12,1
17,24,128,19,17,2
17,24,129,23,12,11
17,24,130,18,14,4
17,24,131,23,19,4
17,24,132,14,19,-5
17,24,133,14,16,-2
17,24,134,24,11,13
17,24,135,14,21,-7
17,24,136,23,4,19
17,24,137,17,24,-7
17,24,138,11,9,2
17,24,139,10,11,-1
17,24,140,10,14,-4
17,24,141,17,23,-6
17,24,142,13,14,-1
17,24,143,18,8,10
17,24,144,12,8,4
17,24,145,10,9,1
17,24,146,17,18,-1
17,24,147,25,16,9
17,24,148,25,21,4
17,24,149,13,11,2
17,24,150,20,19,1
17,24,151,25,9,16
17,24,152,9,11,-2
17,24,153,8,13,-5
17,24,154,15,11,4
17,24,155,12,11,1
17,24,156,14,19,-5
17,24,157,25,14,11
17,24,158,12,12,0
17,24,159,24,19,5
17,24,160,10,10,0
17,24,161,9,3,6
17,24,162,24,16,8
17,24,163,12,32,-20
17,24,164,15,8,7
17,24,165,10,31,-21
17,24,166,11,12,-1
17,24,167,8,12,-4
17,24,168,13,11,2
17,24,169,8,10,-2
17,24,170,22,13,9
17,24,171,13,10,3
17,24,172,13,12,1
17,24,173,8,7,1
17,24,174,14,6,8
17,24,175,4,10,-6
17,24,176,5,13,-8
17,24,177,13,10,3
17,24,178,8,8,0
17,24,179,12,8,4
17,24,180,12,7,5
17,24,181,19,13,6
17,24,182,17,17,0
17,24,183,18,13,5
17,24,184,14,11,3
17,24,185,23,13,10
17,24,186,22,10,12
17,24,187,23,13,10
17,24,188,15,17,-2
17,24,189,28,23,5
17,24,190,24,9,15
17,24,191,13,2,11
17,24,192,21,15,6
17,24,193,7,10,-3
17,24,194,9,8,1
17,24,195,10,11,-1
17,24,196,14,13,1
17,24,197,18,15,3
17,24,198,14,29,-15
17,24,199,18,11,7
17,24,200,25,11,14
17,24,201,18,17,1
17,24,202,12,12,0
17,24,203,24,23,1
17,24,204,31,15,16
17,24,205,15,8,7
17,24,206,20,13,7
17,24,207,26,15,11
17,24,208,17,19,-2
17,24,209,17,8,9
17,24,210,7,8,-1
17,24,211,19,8,11
17,24,212,12,6,6
17,24,213,17,19,-2
17,24,214,13,16,-3
17,24,215,11,7,4
17,24,216,6,19,-13
17,24,217,10,26,-16
17,24,218,17,19,-2
17,24,219,10,14,-4
17,24,220,11,13,-2
17,24,221,10,11,-1
17,24,222,14,16,-2
17,24,223,17,11,6
17,24,224,9,5,4
17,24,225,16,8,8
17,24,226,6,10,-4
17,24,227,10,6,4
17,24,228,12,21,-9
17,24,229,24,19,5
17,24,230,11,19,-8
17,24,231,11,18,-7
17,24,232,16,19,-3
17,24,233,20,8,12
17,24,234,8,18,-10
17,24,235,16,18,-2
17,24,236,9,9,0
17,24,237,19,14,5
17,24,238,15,13,2
17,24,239,5,11,-6
17,24,240,17,17,0
17,24,241,19,17,2
17,24,242,14,17,-3
17,24,243,18,10,8
17,24,244,24,25,-1
17,24,245,14,13,1
17,24,246,17,8,9
17,24,247,22,14,8
17,24,248,13,6,7
17,24,249,18,13,5
17,24,250,24,21,3
17,24,251,8,18,-10
17,24,252,11,26,-15
17,24,253,12,17,-5
17,24,254,11,11,0
17,24,255,15,17,-2
17,24,256,18,11,7
17,24,257,18,17,1
17,24,258,18,12,6
17,24,259,15,18,-3
17,24,260,12,15,-3
17,24,261,15,17,-2
17,24,262,15,15,0
17,24,263,33,9,24
17,24,264,19,25,-6
17,24,265,10,6,4
17,24,266,12,13,-1
17,24,267,7,14,-7
17,24,268,9,19,-10
17,24,269,16,11,5
17,24,270,16,7,9
17,24,271,22,21,1
17,24,272,13,21,-8
17,24,273,10,12,-2
17,24,274,25,11,14
17,24,275,19,9,10
17,24,276,18,13,5
17,24,277,15,15,0
17,24,278,6,13,-7
17,24,279,25,27,-2
17,24,280,22,20,2
17,24,281,26,16,10
17,24,282,14,14,0
17,24,283,22,24,-2
17,24,284,25,20,5
17,24,285,17,6,11
17,24,286,13,8,5
17,24,287,9,11,-2
17,24,288,19,6,13
17,24,289,12,17,-5
17,24,290,16,19,-3
17,24,291,20,12,8
17,24,292,22,12,10
17,24,293,10,20,-10
17,24,294,15,7,8
17,24,295,16,11,5
17,24,296,20,14,6
17,24,297,15,18,-3
17,24,298,11,3,8
17,24,299,17,11,6
17,25,0,9,14,-5
17,25,1,7,17,-10
17,25,2,13,11,2
17,25,3,12,12,0
17,25,4,19,7,12
17,25,5,11,17,-6
17,25,6,22,14,8
17,25,7,25,27,-2
17,25,8,8,2,6
17,25,9,2,6,-4
17,25,10,14,21,-7
17,25,11,22,12,10
17,25,12,15,11,4
17,25,13,8,14,-6
17,25,14,9,17,-8
17,25,15,13,14,-1
17,25,16,23,19,4
17,25,17,6,7,-1
17,25,18,13,11,2
17,25,19,7,6,1
17,25,20,11,12,-1
17,25,21,6,6,0
17,25,22,11,7,4
17,25,23,10,14,-4
17,25,24,7,9,-2
17,25,25,16,8,8
17,25,26,17,14,3
17,25,27,14,12,2
17,25,28,12,20,-8
17,25,29,9,7,2
17,25,30,24,18,6
17,25,31,9,9,0
17,25,32,18,14,4
17,25,33,4,6,-2
17,25,34,14,9,5
17,25,35,8,7,1
17,25,36,6,9,-3
17,25,37,8,10,-2
17,25,38,9,3,6
17,25,39,21,16,5
17,25,40,9,10,-1
17,25,41,12,24,-12
17,25,42,13,11,2
17,25,43,14,15,-1
17,25,44,15,12,3
17,25,45,13,8,5
17,25,46,9,5,4
17,25,47,15,12,3
17,25,48,9,21,-12
17,25,49,28,12,16
17,25,50,14,14,0
17,25,51,7,11,-4
17,25,52,15,16,-1
17,25,53,12,18,-6
17,25,54,20,8,12
17,25,55,28,20,8
17,25,56,14,7,7
17,25,57,20,18,2
17,25,58,19,8,11
17,25,59,16,14,2
17,25,60,27,15,12
17,25,61,20,12,8
17,25,62,15,14,1
17,25,63,20,19,1
17,25,64,16,12,4
17,25,65,5,8,-3
17,25,66,17,11,6
17,25,67,16,29,-13
17,25,68,11,10,1
17,25,69,20,12,8
17,25,70,14,11,3
17,25,71,27,16,11
17,25,72,9,12,-3
17,25,73,10,12,-2
17,25,74,20,13,7
17,25,75,15,15,0
17,25,76,23,15,8
17,25,77,12,15,-3
17,25,78,8,9,-1
17,25,79,15,20,-5
17,25,80,23,26,-3
17,25,81,24,19,5
17,25,82,19,12,7
17,25,83,11,19,-8
17,25,84,6,9,-3
17,25,85,12,2,10
17,25,86,22,8,14
17,25,87,21,15,6
17,25,88,11,18,-7
17,25,89,18,21,-3
17,25,90,21,16,5
17,25,91,19,19,0
17,25,92,15,8,7
17,25,93,18,15,3
17,25,94,16,19,-3
17,25,95,25,22,3
17,25,96,13,15,-2
17,25,97,26,18,8
17,25,98,17,17,0
17,25,99,8,6,2
17,25,100,21,23,-2
17,25,101,14,9,5
17,25,102,11,10,1
17,25,103,7,15,-8
17,25,104,10,16,-6
17,25,105,16,18,-2
17,25,106,19,12,7
17,25,107,16,16,0
17,25,108,13,14,-1
17,25,109,10,20,-10
17,25,110,11,10,1
17,25,111,16,20,-4
17,25,112,14,11,3
17,25,113,14,16,-2
17,25,114,17,12,5
17,25,115,19,21,-2
17,25,116,9,8,1
17,25,117,19,20,-1
17,25,118,20,14,6
17,25,119,20,20,0
17,25,120,21,15,6
17,25,121,26,11,15
17,25,122,12,10,2
17,25,123,17,17,0
17,25,124,8,13,-5
17,25,125,13,16,-3
17,25,126,13,11,2
17,25,127,7,13,-6
17,25,128,22,17,5
17,25,129,24,13,11
17,25,130,7,0,7
17,25,131,21,15,6
17,25,132,19,12,7
17,25,133,10,16,-6
17,25,134,19,17,2
17,25,135,16,17,-1
17,25,136,16,23,-7
17,25,137,18,9,9
17,25,138,9,14,-5
17,25,139,5,6,-1
17,25,140,20,16,4
17,25,141,22,14,8
17,25,142,24,17,7
17,25,143,26,16,10
17,25,144,25,25,0
17,25,145,19,38,-19
17,25,146,22,25,-3
17,25,147,20,15,5
17,25,148,10,14,-4
17,25,149,14,7,7
17,25,150,17,23,-6
17,25,151,26,18,8
17,25,152,12,7,5
17,25,153,7,7,0
17,25,154,3,8,-5
17,25,155,17,12,5
17,25,156,13,13,0
17,25,157,15,7,8
17,25,158,22,11,11
17,25,159,16,9,7
17,25,160,1,10,-9
17,25,161,22,23,-1
17,25,162,12,11,1
17,25,163,14,19,-5
17,25,164,8,1,7
17,25,165,29,17,12
17,25,166,12,15,-3
17,25,167,22,13,9
17,25,168,15,11,4
17,25,169,22,13,9
17,25,170,20,25,-5
17,25,171,15,13,2
17,25,172,16,14,2
17,25,173,16,12,4
17,25,174,10,10,0
17,25,175,1,4,-3
17,25,176,8,12,-4
17,25,177,20,14,6
17,25,178,7,9,-2
17,25,179,26,24,2
17,25,180,21,18,3
17,25,181,13,11,2
17,25,182,11,12,-1
17,25,183,22,17,5
17,25,184,17,21,-4
17,25,185,10,9,1
17,25,186,8,8,0
17,25,187,8,20,-12
17,25,188,12,9,3
17,25,189,11,8,3
17,25,190,17,17,0
17,25,191,20,12,8
17,25,192,17,8,9
17,25,193,15,16,-1
17,25,194,12,10,2
17,25,195,17,13,4
17,25,196,24,20,4
17,25,197,9,7,2
17,25,198,12,11,1
17,25,199,12,12,0
17,25,200,12,6,6
17,25,201,15,9,6
17,25,202,11,10,1
17,25,203,32,16,16
17,25,204,10,4,6
17,25,205,9,17,-8
17,25,206,26,27,-1
17,25,207,26,10,16
17,25,208,13,11,2
17,25,209,23,23,0
17,25,210,10,6,4
17,25,211,16,6,10
17,25,212,19,17,2
17,25,213,22,17,5
17,25,214,34,18,16
17,25,215,9,17,-8
17,25,216,22,16,6
17,25,217,18,12,6
17,25,218,14,23,-9
17,25,219,12,7,5
17,25,220,21,10,11
17,25,221,14,19,-5
17,25,222,16,7,9
17,25,223,16,11,5
17,25,224,10,7,3
17,25,225,25,11,14
17,25,226,21,13,8
17,25,227,13,20,-7
17,25,228,16,14,2
17,25,229,10,10,0
17,25,230,6,18,-12
17,25,231,9,11,-2
17,25,232,25,13,12
17,25,233,14,3,11
17,25,234,30,21,9
17,25,235,17,18,-1
17,25,236,19,28,-9
17,25,237,10,16,-6
17,25,238,3,5,-2
17,25,239,18,19,-1
17,25,240,14,22,-8
17,25,241,11,7,4
17,25,242,20,11,9
17,25,243,21,24,-3
17,25,244,13,22,-9
17,25,245,16,14,2
17,25,246,9,13,-4
17,25,247,31,12,19
17,25,248,4,3,1
17,25,249,10,20,-10
17,25,250,22,8,14
17,25,251,12,19,-7
17,25,252,12,10,2
17,25,253,22,14,8
17,25,254,15,20,-5
17,25,255,11,10,1
17,25,256,17,15,2
17,25,257,27,15,12
17,25,258,13,17,-4
17,25,259,10,13,-3
17,25,260,21,17,4
17,25,261,12,13,-1
17,25,262,15,2,13
17,25,263,16,12,4
17,25,264,9,19,-10
17,25,265,17,16,1
17,25,266,14,10,4
17,25,267,14,8,6
17,25,268,10,15,-5
17,25,269,8,14,-6
17,25,270,14,13,1
17,25,271,28,10,18
17,25,272,15,21,-6
17,25,273,3,14,-11
17,25,274,16,25,-9
17,25,275,8,5,3
17,25,276,9,10,-1
17,25,277,17,14,3
17,25,278,4,7,-3
17,25,279,23,11,12
17,25,280,19,17,2
17,25,281,16,13,3
17,25,282,13,12,1
17,25,283,11,11,0
17,25,284,18,18,0
17,25,285,17,7,10
17,25,286,17,12,5
17,25,287,14,19,-5
17,25,288,25,8,17
17,25,289,23,14,9
17,25,290,14,13,1
17,25,291,18,24,-6
17,25,292,7,13,-6
17,25,293,18,12,6
17,25,294,30,16,14
17,25,295,9,5,4
17,25,296,12,10,2
17,25,297,14,13,1
17,25,298,15,7,8
17,25,299,13,8,5
17,26,0,14,17,-3
17,26,1,19,16,3
17,26,2,22,16,6
17,26,3,12,8,4
17,26,4,22,13,9
17,26,5,20,13,7
17,26,6,18,17,1
17,26,7,16,11,5
17,26,8,10,22,-12
17,26,9,19,14,5
17,26,10,11,13,-2
17,26,11,22,21,1
17,26,12,15,9,6
17,26,13,16,5,11
17,26,14,22,9,13
17,26,15,18,17,1
17,26,16,31,5,26
17,26,17,13,11,2
17,26,18,21,18,3
17,26,19,14,12,2
17,26,20,28,20,8
17,26,21,12,18,-6
17,26,22,6,22,-16
17,26,23,19,6,13
17,26,24,17,20,-3
17,26,25,22,18,4
17,26,26,11,12,-1
17,26,27,19,12,7
17,26,28,11,11,0
17,26,29,13,15,-2
17,26,30,18,22,-4
17,26,31,12,18,-6
17,26,32,11,12,-1
17,26,33,8,12,-4
17,26,34,11,8,3
17,26,35,7,18,-11
17,26,36,9,22,-13
17,26,37,11,10,1
17,26,38,10,6,4
17,26,39,12,12,0
17,26,40,15,18,-3
17,26,41,18,9,9
17,26,42,24,17,7
17,26,43,12,10,2
17,26,44,14,8,6
17,26,45,7,12,-5
17,26,46,17,10,7
17,26,47,8,10,-2
17,26,48,7,11,-4
17,26,49,23,18,5
17,26,50,9,6,3
17,26,51,12,11,1
17,26,52,19,12,7
17,26,53,10,8,2
17,26,54,11,16,-5
17,26,55,13,12,1
17,26,56,10,8,2
17,26,57,28,5,23
17,26,58,20,13,7
17,26,59,27,20,7
17,26,60,9,4,5
17,26,61,19,30,-11
17,26,62,18,17,1
17,26,63,23,15,8
17,26,64,12,9,3
17,26,65,22,25,-3
17,26,66,16,14,2
17,26,67,8,15,-7
17,26,68,15,8,7
17,26,69,4,1,3
17,26,70,12,7,5
17,26,71,10,11,-1
17,26,72,34,17,17
17,26,73,25,13,12
17,26,74,21,4,17
17,26,75,11,14,-3
17,26,76,12,19,-7
17,26,77,14,2,12
17,26,78,15,13,2
17,26,79,16,13,3
17,26,80,9,11,-2
17,26,81,12,12,0
17,26,82,20,17,3
17,26,83,10,9,1
17,26,84,18,17,1
17,26,85,10,21,-11
17,26,86,19,12,7
17,26,87,12,19,-7
17,26,88,9,11,-2
17,26,89,14,16,-2
17,26,90,15,10,5
17,26,91,15,12,3
17,26,92,8,26,-18
17,26,93,16,24,-8
17,26,94,11,10,1
17,26,95,18,5,13
17,26,96,10,16,-6
17,26,97,11,12,-1
17,26,98,12,15,-3
17,26,99,13,11,2
17,26,100,13,10,3
17,26,101,16,12,4
17,26,102,5,12,-7
17,26,103,15,16,-1
17,26,104,12,13,-1
17,26,105,14,13,1
17,26,106,18,23,-5
17,26,107,16,20,-4
17,26,108,20,15,5
17,26,109,24,16,8
17,26,110,11,11,0
17,26,111,15,13,2
17,26,112,20,18,2
17,26,113,24,15,9
17,26,114,23,8,15
17,26,115,6,4,2
17,26,116,17,20,-3
17,26,117,36,16,20
17,26,118,8,16,-8
17,26,119,28,13,15
17,26,120,18,11,7
17,26,121,11,5,6
17,26,122,22,12,10
17,26,123,13,7,6
17,26,124,8,8,0
17,26,125,15,22,-7
17,26,126,16,24,-8
17,26,127,14,13,1
17,26,128,19,7,12
17,26,129,8,7,1
17,26,130,6,8,-2
17,26,131,22,10,12
17,26,132,10,16,-6
17,26,133,12,15,-3
17,26,134,16,19,-3
17,26,135,33,15,18
17,26,136,13,17,-4
17,26,137,21,28,-7
17,26,138,16,12,4
17,26,139,10,16,-6
17,26,140,8,12,-4
17,26,141,8,14,-6
17,26,142,22,11,11
17,26,143,20,17,3
17,26,144,6,10,-4
17,26,145,22,16,6
17,26,146,18,10,8
17,26,147,20,16,4
17,26,148,22,21,1
17,26,149,12,10,2
17,26,150,7,12,-5
17,26,151,22,11,11
17,26,152,11,11,0
17,26,153,16,22,-6
17,26,154,11,14,-3
17,26,155,19,15,4
17,26,156,13,17,-4
17,26,157,12,12,0
17,26,158,11,0,11
17,26,159,17,12,5
17,26,160,35,18,17
17,26,161,22,25,-3
17,26,162,16,16,0
17,26,163,7,21,-14
17,26,164,10,11,-1
17,26,165,17,11,6
17,26,166,24,12,12
17,26,167,25,6,19
17,26,168,20,12,8
17,26,169,17,7,10
17,26,170,12,17,-5
17,26,171,17,17,0
17,26,172,11,20,-9
17,26,173,8,12,-4
17,26,174,30,11,19
17,26,175,17,20,-3
17,26,176,13,14,-1
17,26,177,8,5,3
17,26,178,20,18,2
17,26,179,13,5,8
17,26,180,16,13,3
17,26,181,9,16,-7
17,26,182,7,10,-3
17,26,183,7,4,3
17,26,184,26,13,13
17,26,185,10,14,-4
17,26,186,5,14,-9
17,26,187,15,22,-7
17,26,188,24,28,-4
17,26,189,10,11,-1
17,26,190,10,10,0
17,26,191,12,9,3
17,26,192,16,13,3
17,26,193,17,21,-4
17,26,194,24,12,12
17,26,195,25,14,11
17,26,196,10,13,-3
17,26,197,8,7,1
17,26,198,14,8,6
17,26,199,13,6,7
17,26,200,3,2,1
17,26,201,16,12,4
17,26,202,15,10,5
17,26,203,18,10,8
17,26,204,11,15,-4
17,26,205,5,9,-4
17,26,206,9,9,0
17,26,207,13,21,-8
17,26,208,5,10,-5
17,26,209,7,10,-3
17,26,210,12,19,-7
17,26,211,11,11,0
17,26,212,22,24,-2
17,26,213,22,8,14
17,26,214,8,17,-9
17,26,215,12,11,1
17,26,216,11,8,3
17,26,217,17,12,5
17,26,218,11,6,5
17,26,219,19,18,1
17,26,220,22,10,12
17,26,221,8,14,-6
17,26,222,21,8,13
17,26,223,19,16,3
17,26,224,13,1,12
17,26,225,34,18,16
17,26,226,12,2,10
17,26,227,12,11,1
17,26,228,17,17,0
17,26,229,22,22,0
17,26,230,10,14,-4
17,26,231,27,7,20
17,26,232,6,2,4
17,26,233,12,14,-2
17,26,234,18,6,12
17,26,235,15,4,11
17,26,236,15,11,4
17,26,237,24,19,5
17,26,238,7,3,4
17,26,239,8,12,-4
17,26,240,15,4,11
17,26,241,6,7,-1
17,26,242,10,5,5
17,26,243,9,6,3
17,26,244,9,6,3
17,26,245,6,11,-5
17,26,246,17,19,-2
17,26,247,4,11,-7
17,26,248,15,13,2
17,26,249,19,21,-2
17,26,250,16,13,3
17,26,251,18,12,6
17,26,252,5,10,-5
17,26,253,9,14,-5
17,26,254,17,16,1
17,26,255,18,14,4
17,26,256,7,11,-4
17,26,257,6,3,3
17,26,258,6,12,-6
17,26,259,21,7,14
17,26,260,11,15,-4
17,26,261,15,7,8
17,26,262,15,15,0
17,26,263,10,17,-7
17,26,264,22,8,14
17,26,265,10,9,1
17,26,266,16,22,-6
17,26,267,31,16,15
17,26,268,22,12,10
17,26,269,19,8,11
17,26,270,44,22,22
17,26,271,12,18,-6
17,26,272,14,7,7
17,26,273,14,16,-2
17,26,274,22,12,10
17,26,275,25,9,16
17,26,276,19,8,11
17,26,277,6,17,-11
17,26,278,20,13,7
17,26,279,14,7,7
17,26,280,15,10,5
17,26,281,13,19,-6
17,26,282,11,13,-2
17,26,283,17,23,-6
17,26,284,20,21,-1
17,26,285,27,11,16
17,26,286,12,7,5
17,26,287,14,9,5
17,26,288,14,15,-1
17,26,289,14,13,1
17,26,290,16,11,5
17,26,291,13,16,-3
17,26,292,21,14,7
17,26,293,15,15,0
17,26,294,14,15,-1
17,26,295,11,10,1
17,26,296,23,13,10
17,26,297,12,11,1
17,26,298,18,9,9
17,26,299,10,16,-6
17,27,0,23,11,12
17,27,1,22,13,9
17,27,2,24,15,9
17,27,3,17,13,4
17,27,4,7,9,-2
17,27,5,27,20,7
17,27,6,7,7,0
17,27,7,14,18,-4
17,27,8,12,18,-6
17,27,9,12,9,3
17,27,10,23,13,10
17,27,11,18,25,-7
17,27,12,15,13,2
17,27,13,23,13,10
17,27,14,16,9,7
17,27,15,8,3,5
17,27,16,14,15,-1
17,27,17,9,13,-4
17,27,18,15,35,-20
17,27,19,16,9,7
17,27,20,19,9,10
17,27,21,12,14,-2
17,27,22,28,16,12
17,27,23,9,21,-12
17,27,24,10,9,1
17,27,25,23,20,3
17,27,26,16,13,3
17,27,27,20,3,17
17,27,28,12,10,2
17,27,29,28,18,10
17,27,30,7,8,-1
17,27,31,15,19,-4
17,27,32,26,13,13
17,27,33,13,14,-1
17,27,34,15,12,3
17,27,35,1,7,-6
17,27,36,10,10,0
17,27,37,25,22,3
17,27,38,19,6,13
17,27,39,21,9,12
17,27,40,19,19,0
17,27,41,26,12,14
17,27,42,5,13,-8
17,27,43,15,18,-3
17,27,44,16,18,-2
17,27,45,7,5,2
17,27,46,18,16,2
17,27,47,11,12,-1
17,27,48,22,9,13
17,27,49,21,15,6
17,27,50,15,12,3
17,27,51,12,7,5
17,27,52,22,16,6
17,27,53,16,12,4
17,27,54,16,5,11
17,27,55,12,9,3
17,27,56,12,15,-3
17,27,57,16,9,7
17,27,58,15,22,-7
17,27,59,22,10,12
17,27,60,23,8,15
17,27,61,15,17,-2
17,27,62,13,6,7
17,27,63,11,9,2
17,27,64,13,21,-8
17,27,65,10,9,1
17,27,66,15,11,4
17,27,67,10,19,-9
17,27,68,10,8,2
17,27,69,20,12,8
17,27,70,16,14,2
17,27,71,8,5,3
17,27,72,17,11,6
17,27,73,7,5,2
17,27,74,16,9,7
17,27,75,4,13,-9
17,27,76,27,18,9
17,27,77,11,16,-5
17,27,78,11,9,2
17,27,79,9,11,-2
17,27,80,21,25,-4
17,27,81,21,17,4
17,27,82,24,20,4
17,27,83,19,18,1
17,27,84,19,10,9
17,27,85,20,10,10
17,27,86,28,17,11
17,27,87,13,17,-4
17,27,88,11,5,6
17,27,89,20,14,6
17,27,90,9,13,-4
17,27,91,5,9,-4
17,27,92,16,14,2
17,27,93,20,10,10
17,27,94,11,13,-2
17,27,95,9,21,-12
17,27,96,14,21,-7
17,27,97,20,8,12
17,27,98,15,19,-4
17,27,99,10,8,2
17,27,100,22,6,16
17,27,101,28,12,16
17,27,102,20,10,10
17,27,103,20,9,11
17,27,104,8,7,1
17,27,105,15,17,-2
17,27,106,28,15,13
17,27,107,13,7,6
17,27,108,27,22,5
17,27,109,19,21,-2
17,27,110,12,11,1
17,27,111,7,10,-3
17,27,112,16,5,11
17,27,113,7,7,0
17,27,114,12,20,-8
17,27,115,19,9,10
17,27,116,27,11,16
17,27,117,25,18,7
17,27,118,14,3,11
17,27,119,14,7,7
17,27,120,16,14,2
17,27,121,12,6,6
17,27,122,18,9,9
17,27,123,17,9,8
17,27,124,8,10,-2
17,27,125,32,34,-2
17,27,126,6,3,3
17,27,127,13,16,-3
17,27,128,19,7,12
17,27,129,12,2,10
17,27,130,8,2,6
17,27,131,31,25,6
17,27,132,17,15,2
17,27,133,18,7,11
17,27,134,12,8,4
17,27,135,22,10,12
17,27,136,21,11,10
17,27,137,16,15,1
17,27,138,2,4,-2
17,27,139,21,30,-9
17,27,140,9,14,-5
17,27,141,26,18,8
17,27,142,20,8,12
17,27,143,12,10,2
17,27,144,27,18,9
17,27,145,16,10,6
17,27,146,8,15,-7
17,27,147,26,14,12
17,27,148,9,16,-7
17,27,149,13,21,-8
17,27,150,29,11,18
17,27,151,18,9,9
17,27,152,17,16,1
17,27,153,9,18,-9
17,27,154,9,13,-4
17,27,155,8,8,0
17,27,156,13,9,4
17,27,157,16,10,6
17,27,158,11,4,7
17,27,159,7,9,-2
17,27,160,14,15,-1
17,27,161,17,20,-3
17,27,162,6,5,1
17,27,163,19,9,10
17,27,164,14,16,-2
17,27,165,12,15,-3
17,27,166,12,11,1
17,27,167,22,14,8
17,27,168,12,18,-6
17,27,169,16,8,8
17,27,170,11,13,-2
17,27,171,10,12,-2
17,27,172,5,7,-2
17,27,173,18,12,6
17,27,174,32,11,21
17,27,175,9,16,-7
17,27,176,22,11,11
17,27,177,14,11,3
17,27,178,14,21,-7
17,27,179,21,14,7
17,27,180,18,8,10
17,27,181,13,16,-3
17,27,182,16,17,-1
17,27,183,33,29,4
17,27,184,13,6,7
17,27,185,10,6,4
17,27,186,9,9,0
17,27,187,23,6,17
17,27,188,3,8,-5
17,27,189,15,3,12
17,27,190,23,22,1
17,27,191,11,19,-8
17,27,192,25,12,13
17,27,193,5,12,-7
17,27,194,16,13,3
17,27,195,17,20,-3
17,27,196,21,2,19
17,27,197,10,4,6
17,27,198,8,11,-3
17,27,199,14,12,2
17,27,200,11,13,-2
17,27,201,8,11,-3
17,27,202,10,9,1
17,27,203,11,11,0
17,27,204,15,13,2
17,27,205,34,10,24
17,27,206,21,17,4
17,27,207,10,14,-4
17,27,208,14,6,8
17,27,209,11,18,-7
17,27,210,16,10,6
17,27,211,10,0,10
17,27,212,16,12,4
17,27,213,20,13,7
17,27,214,6,6,0
17,27,215,10,9,1
17,27,216,18,23,-5
17,27,217,8,16,-8
17,27,218,12,9,3
17,27,219,14,17,-3
17,27,220,6,9,-3
17,27,221,13,11,2
17,27,222,16,9,7
17,27,223,15,11,4
17,27,224,16,7,9
17,27,225,20,21,-1
17,27,226,28,21,7
17,27,227,7,5,2
17,27,228,24,18,6
17,27,229,12,15,-3
17,27,230,15,8,7
17,27,231,17,23,-6
17,27,232,18,7,11
17,27,233,21,10,11
17,27,234,17,15,2
17,27,235,5,7,-2
17,27,236,12,13,-1
17,27,237,9,18,-9
17,27,238,14,13,1
17,27,239,17,14,3
17,27,240,22,22,0
17,27,241,23,24,-1
17,27,242,12,4,8
17,27,243,6,8,-2
17,27,244,17,17,0
17,27,245,24,13,11
17,27,246,8,9,-1
17,27,247,4,8,-4
17,27,248,17,18,-1
17,27,249,6,7,-1
17,27,250,11,11,0
17,27,251,11,8,3
17,27,252,17,11,6
17,27,253,15,9,6
17,27,254,17,11,6
17,27,255,11,8,3
17,27,256,14,8,6
17,27,257,10,12,-2
17,27,258,20,13,7
17,27,259,11,4,7
17,27,260,16,7,9
17,27,261,9,5,4
17,27,262,18,15,3
17,27,263,12,14,-2
17,27,264,23,25,-2
17,27,265,13,5,8
17,27,266,10,16,-6
17,27,267,17,9,8
17,27,268,17,6,11
17,27,269,8,12,-4
17,27,270,7,18,-11
17,27,271,11,11,0
17,27,272,11,11,0
17,27,273,14,17,-3
17,27,274,26,19,7
17,27,275,22,14,8
17,27,276,28,18,10
17,27,277,9,13,-4
17,27,278,19,10,9
17,27,279,13,12,1
17,27,280,31,9,22
17,27,281,9,9,0
17,27,282,14,12,2
17,27,283,14,15,-1
17,27,284,20,15,5
17,27,285,26,16,10
17,27,286,22,10,12
17,27,287,20,17,3
17,27,288,14,21,-7
17,27,289,27,10,17
17,27,290,39,15,24
17,27,291,9,18,-9
17,27,292,12,5,7
17,27,293,24,16,8
17,27,294,13,10,3
17,27,295,17,11,6
17,27,296,9,14,-5
17,27,297,16,10,6
17,27,298,16,12,4
17,27,299,16,8,8
17,28,0,22,19,3
17,28,1,9,11,-2
17,28,2,21,5,16
17,28,3,20,22,-2
17,28,4,20,7,13
17,28,5,12,18,-6
17,28,6,24,11,13
17,28,7,17,16,1
17,28,8,18,16,2
17,28,9,13,12,1
17,28,10,12,12,0
17,28,11,19,13,6
17,28,12,20,6,14
17,28,13,17,8,9
17,28,14,15,10,5
17,28,15,14,13,1
17,28,16,19,13,6
17,28,17,9,11,-2
17,28,18,11,10,1
17,28,19,17,12,5
17,28,20,29,16,13
17,28,21,13,12,1
17,28,22,5,5,0
17,28,23,5,6,-1
17,28,24,7,14,-7
17,28,25,21,12,9
17,28,26,19,18,1
17,28,27,14,13,1
17,28,28,29,17,12
17,28,29,11,15,-4
17,28,30,5,4,1
17,28,31,14,13,1
17,28,32,14,7,7
17,28,33,17,11,6
17,28,34,4,11,-7
17,28,35,6,5,1
17,28,36,9,14,-5
17,28,37,15,10,5
17,28,38,6,15,-9
17,28,39,19,18,1
17,28,40,13,13,0
17,28,41,9,11,-2
17,28,42,27,15,12
17,28,43,10,7,3
17,28,44,8,17,-9
17,28,45,6,9,-3
17,28,46,17,15,2
17,28,47,15,4,11
17,28,48,13,7,6
17,28,49,25,17,8
17,28,50,12,3,9
17,28,51,6,9,-3
17,28,52,14,13,1
17,28,53,13,10,3
17,28,54,8,5,3
17,28,55,15,19,-4
17,28,56,17,18,-1
17,28,57,15,13,2
17,28,58,13,11,2
17,28,59,9,8,1
17,28,60,18,12,6
17,28,61,10,3,7
17,28,62,14,29,-15
17,28,63,15,21,-6
17,28,64,11,7,4
17,28,65,12,16,-4
17,28,66,10,9,1
17,28,67,17,11,6
17,28,68,24,18,6
17,28,69,28,23,5
17,28,70,18,21,-3
17,28,71,10,5,5
17,28,72,20,18,2
17,28,73,11,11,0
17,28,74,10,14,-4
17,28,75,19,18,1
17,28,76,9,8,1
17,28,77,16,12,4
17,28,78,11,3,8
17,28,79,16,14,2
17,28,80,10,11,-1
17,28,81,13,10,3
17,28,82,12,9,3
17,28,83,9,11,-2
17,28,84,21,18,3
17,28,85,15,6,9
17,28,86,19,19,0
17,28,87,10,9,1
17,28,88,12,5,7
17,28,89,12,6,6
17,28,90,6,5,1
17,28,91,8,13,-5
17,28,92,19,17,2
17,28,93,10,11,-1
17,28,94,24,11,13
17,28,95,24,20,4
17,28,96,25,14,11
17,28,97,26,9,17
17,28,98,15,14,1
17,28,99,3,13,-10
17,28,100,20,15,5
17,28,101,27,22,5
17,28,102,17,14,3
17,28,103,30,16,14
17,28,104,9,12,-3
17,28,105,22,7,15
17,28,106,19,13,6
17,28,107,11,8,3
17,28,108,15,11,4
17,28,109,11,8,3
17,28,110,15,14,1
17,28,111,19,19,0
17,28,112,21,17,4
17,28,113,10,9,1
17,28,114,12,3,9
17,28,115,11,11,0
17,28,116,6,7,-1
17,28,117,6,13,-7
17,28,118,17,3,14
17,28,119,21,16,5
17,28,120,15,25,-10
17,28,121,22,13,9
17,28,122,6,11,-5
17,28,123,20,12,8
17,28,124,21,16,5
17,28,125,16,9,7
17,28,126,22,20,2
17,28,127,18,16,2
17,28,128,22,12,10
17,28,129,17,12,5
17,28,130,11,18,-7
17,28,131,5,13,-8
17,28,132,24,12,12
17,28,133,13,6,7
17,28,134,8,20,-12
17,28,135,19,14,5
17,28,136,15,12,3
17,28,137,23,17,6
17,28,138,15,6,9
17,28,139,11,13,-2
17,28,140,3,21,-18
17,28,141,20,18,2
17,28,142,11,6,5
17,28,143,6,8,-2
17,28,144,19,10,9
17,28,145,13,9,4
17,28,146,20,14,6
17,28,147,15,7,8
17,28,148,7,11,-4
17,28,149,18,24,-6
17,28,150,19,10,9
17,28,151,12,5,7
17,28,152,15,14,1
17,28,153,18,9,9
17,28,154,9,14,-5
17,28,155,12,6,6
17,28,156,21,17,4
17,28,157,10,10,0
17,28,158,16,5,11
17,28,159,17,16,1
17,28,160,9,4,5
17,28,161,14,16,-2
17,28,162,13,8,5
17,28,163,11,9,2
17,28,164,9,13,-4
17,28,165,8,12,-4
17,28,166,6,8,-2
17,28,167,21,13,8
17,28,168,9,13,-4
17,28,169,17,12,5
17,28,170,12,6,6
17,28,171,15,12,3
17,28,172,16,8,8
17,28,173,17,7,10
17,28,174,12,7,5
17,28,175,21,8,13
17,28,176,22,13,9
17,28,177,15,18,-3
17,28,178,15,25,-10
17,28,179,13,7,6
17,28,180,8,10,-2
17,28,181,8,16,-8
17,28,182,18,9,9
17,28,183,18,20,-2
17,28,184,11,14,-3
17,28,185,16,5,11
17,28,186,15,15,0
17,28,187,19,17,2
17,28,188,9,7,2
17,28,189,16,11,5
17,28,190,8,25,-17
17,28,191,19,3,16
17,28,192,17,7,10
17,28,193,18,9,9
17,28,194,12,18,-6
17,28,195,20,11,9
17,28,196,10,9,1
17,28,197,12,6,6
17,28,198,20,10,10
17,28,199,2,5,-3
17,28,200,16,9,7
17,28,201,35,16,19
17,28,202,21,10,11
17,28,203,5,8,-3
17,28,204,15,5,10
17,28,205,11,13,-2
17,28,206,12,21,-9
17,28,207,15,12,3
17,28,208,13,6,7
17,28,209,12,12,0
17,28,210,12,10,2
17,28,211,10,13,-3
17,28,212,19,9,10
17,28,213,33,10,23
17,28,214,17,19,-2
17,28,215,13,11,2
17,28,216,17,12,5
17,28,217,20,11,9
17,28,218,20,20,0
17,28,219,19,7,12
17,28,220,12,5,7
17,28,221,34,12,22
17,28,222,8,7,1
17,28,223,10,15,-5
17,28,224,14,20,-6
17,28,225,8,2,6
17,28,226,13,14,-1
17,28,227,19,6,13
17,28,228,20,12,8
17,28,229,17,16,1
17,28,230,13,5,8
17,28,231,8,12,-4
17,28,232,26,12,14
17,28,233,12,9,3
17,28,234,13,16,-3
17,28,235,23,6,17
17,28,236,14,11,3
17,28,237,12,11,1
17,28,238,14,10,4
17,28,239,12,7,5
17,28,240,13,11,2
17,28,241,11,16,-5
17,28,242,34,10,24
17,28,243,7,16,-9
17,28,244,6,13,-7
17,28,245,16,11,5
17,28,246,14,13,1
17,28,247,19,11,8
17,28,248,8,10,-2
17,28,249,17,10,7
17,28,250,21,6,15
17,28,251,11,20,-9
17,28,252,20,18,2
17,28,253,29,9,20
17,28,254,36,17,19
17,28,255,21,12,9
17,28,256,11,2,9
17,28,257,24,7,17
17,28,258,12,5,7
17,28,259,9,15,-6
17,28,260,21,19,2
17,28,261,16,4,12
17,28,262,19,14,5
17,28,263,22,14,8
17,28,264,7,6,1
17,28,265,9,9,0
17,28,266,10,8,2
17,28,267,18,5,13
17,28,268,6,9,-3
17,28,269,14,14,0
17,28,270,13,13,0
17,28,271,13,14,-1
17,28,272,15,7,8
17,28,273,16,13,3
17,28,274,18,17,1
17,28,275,13,12,1
17,28,276,7,8,-1
17,28,277,19,8,11
17,28,278,12,8,4
17,28,279,27,16,11
17,28,280,21,15,6
17,28,281,21,16,5
17,28,282,18,11,7
17,28,283,34,11,23
17,28,284,7,10,-3
17,28,285,8,3,5
17,28,286,5,9,-4
17,28,287,9,15,-6
17,28,288,15,9,6
17,28,289,13,17,-4
17,28,290,12,14,-2
17,28,291,9,14,-5
17,28,292,12,11,1
17,28,293,18,19,-1
17,28,294,11,12,-1
17,28,295,15,9,6
17,28,296,21,16,5
17,28,297,16,17,-1
17,28,298,22,14,8
17,28,299,22,16,6
17,29,0,13,11,2
17,29,1,10,3,7
17,29,2,15,9,6
17,29,3,14,8,6
17,29,4,21,25,-4
17,29,5,6,9,-3
17,29,6,16,13,3
17,29,7,14,14,0
17,29,8,13,10,3
17,29,9,15,11,4
17,29,10,29,21,8
17,29,11,17,11,6
17,29,12,14,8,6
17,29,13,16,7,9
17,29,14,26,17,9
17,29,15,26,6,20
17,29,16,8,12,-4
17,29,17,22,6,16
17,29,18,9,9,0
17,29,19,5,19,-14
17,29,20,8,11,-3
17,29,21,15,10,5
17,29,22,10,4,6
17,29,23,16,18,-2
17,29,24,7,12,-5
17,29,25,15,10,5
17,29,26,27,9,18
17,29,27,11,9,2
17,29,28,14,6,8
17,29,29,20,13,7
17,29,30,17,12,5
17,29,31,25,10,15
17,29,32,20,13,7
17,29,33,21,18,3
17,29,34,24,18,6
17,29,35,16,8,8
17,29,36,17,15,2
17,29,37,15,7,8
17,29,38,8,7,1
17,29,39,8,12,-4
17,29,40,30,19,11
17,29,41,12,16,-4
17,29,42,11,6,5
17,29,43,23,21,2
17,29,44,10,8,2
17,29,45,15,13,2
17,29,46,18,10,8
17,29,47,23,9,14
17,29,48,15,20,-5
17,29,49,16,15,1
17,29,50,26,5,21
17,29,51,14,10,4
17,29,52,13,2,11
17,29,53,21,11,10
17,29,54,15,16,-1
17,29,55,21,19,2
17,29,56,23,14,9
17,29,57,20,8,12
17,29,58,17,6,11
17,29,59,12,6,6
17,29,60,6,14,-8
17,29,61,3,10,-7
17,29,62,18,9,9
17,29,63,13,17,-4
17,29,64,14,10,4
17,29,65,21,16,5
17,29,66,18,18,0
17,29,67,10,6,4
17,29,68,26,9,17
17,29,69,30,5,25
17,29,70,10,12,-2
17,29,71,6,9,-3
17,29,72,22,9,13
17,29,73,14,10,4
17,29,74,7,19,-12
17,29,75,13,8,5
17,29,76,18,12,6
17,29,77,15,9,6
17,29,78,19,3,16
17,29,79,20,13,7
17,29,80,8,16,-8
17,29,81,19,17,2
17,29,82,13,7,6
17,29,83,20,18,2
17,29,84,23,16,7
17,29,85,24,9,15
17,29,86,13,15,-2
17,29,87,14,9,5
17,29,88,17,10,7
17,29,89,14,15,-1
17,29,90,5,6,-1
17,29,91,19,12,7
17,29,92,15,13,2
17,29,93,10,7,3
17,29,94,17,9,8
17,29,95,10,18,-8
17,29,96,6,3,3
17,29,97,4,14,-10
17,29,98,9,11,-2
17,29,99,13,10,3
17,29,100,4,14,-10
17,29,101,7,11,-4
17,29,102,21,25,-4
17,29,103,15,8,7
17,29,104,19,13,6
17,29,105,20,7,13
17,29,106,16,13,3
17,29,107,22,8,14
17,29,108,22,6,16
17,29,109,24,13,11
17,29,110,20,10,10
17,29,111,11,10,1
17,29,112,15,8,7
17,29,113,19,13,6
17,29,114,22,16,6
17,29,115,11,14,-3
17,29,116,11,8,3
17,29,117,18,7,11
17,29,118,19,11,8
17,29,119,5,13,-8
17,29,120,31,12,19
17,29,121,16,14,2
17,29,122,9,12,-3
17,29,123,19,20,-1
17,29,124,14,23,-9
17,29,125,18,8,10
17,29,126,11,9,2
17,29,127,12,11,1
17,29,128,16,10,6
17,29,129,20,6,14
17,29,130,26,13,13
17,29,131,16,16,0
17,29,132,24,17,7
17,29,133,9,12,-3
17,29,134,16,12,4
17,29,135,13,6,7
17,29,136,9,9,0
17,29,137,19,24,-5
17,29,138,16,9,7
17,29,139,15,14,1
17,29,140,15,11,4
17,29,141,12,24,-12
17,29,142,9,13,-4
17,29,143,18,10,8
17,29,144,12,2,10
17,29,145,15,13,2
17,29,146,10,14,-4
17,29,147,13,12,1
17,29,148,6,11,-5
17,29,149,15,9,6
17,29,150,4,10,-6
17,29,151,23,14,9
17,29,152,17,22,-5
17,29,153,11,8,3
17,29,154,4,8,-4
17,29,155,16,7,9
17,29,156,11,6,5
17,29,157,13,15,-2
17,29,158,12,6,6
17,29,159,17,13,4
17,29,160,8,5,3
17,29,161,7,7,0
17,29,162,16,8,8
17,29,163,10,10,0
17,29,164,14,11,3
17,29,165,22,12,10
17,29,166,29,18,11
17,29,167,12,7,5
17,29,168,11,3,8
17,29,169,12,19,-7
17,29,170,12,7,5
17,29,171,13,12,1
17,29,172,8,10,-2
17,29,173,22,13,9
17,29,174,14,6,8
17,29,175,29,22,7
17,29,176,17,8,9
17,29,177,15,10,5
17,29,178,14,9,5
17,29,179,11,8,3
17,29,180,23,4,19
17,29,181,7,14,-7
17,29,182,15,15,0
17,29,183,21,15,6
17,29,184,6,10,-4
17,29,185,8,6,2
17,29,186,11,10,1
17,29,187,24,12,12
17,29,188,22,14,8
17,29,189,8,16,-8
17,29,190,15,3,12
17,29,191,14,9,5
17,29,192,19,7,12
17,29,193,23,20,3
17,29,194,11,12,-1
17,29,195,18,13,5
17,29,196,9,3,6
17,29,197,16,5,11
17,29,198,11,7,4
17,29,199,7,6,1
17,29,200,14,22,-8
17,29,201,20,14,6
17,29,202,4,2,2
17,29,203,20,15,5
17,29,204,18,8,10
17,29,205,21,18,3
17,29,206,22,11,11
17,29,207,18,4,14
17,29,208,21,19,2
17,29,209,26,9,17
17,29,210,20,10,10
17,29,211,8,7,1
17,29,212,9,12,-3
17,29,213,14,6,8
17,29,214,25,13,12
17,29,215,8,6,2
17,29,216,11,5,6
17,29,217,27,14,13
17,29,218,15,12,3
17,29,219,20,15,5
17,29,220,18,16,2
17,29,221,23,15,8
17,29,222,19,5,14
17,29,223,15,12,3
17,29,224,20,19,1
17,29,225,10,4,6
17,29,226,15,6,9
17,29,227,5,12,-7
17,29,228,18,10,8
17,29,229,24,5,19
17,29,230,19,11,8
17,29,231,18,13,5
17,29,232,13,11,2
17,29,233,13,8,5
17,29,234,11,5,6
17,29,235,13,14,-1
17,29,236,13,13,0
17,29,237,17,10,7
17,29,238,12,4,8
17,29,239,20,7,13
17,29,240,18,11,7
17,29,241,7,10,-3
17,29,242,18,16,2
17,29,243,5,12,-7
17,29,244,24,8,16
17,29,245,20,12,8
17,29,246,7,14,-7
17,29,247,13,11,2
17,29,248,28,9,19
17,29,249,14,12,2
17,29,250,16,15,1
17,29,251,23,20,3
17,29,252,17,8,9
17,29,253,14,26,-12
17,29,254,12,5,7
17,29,255,16,11,5
17,29,256,14,21,-7
17,29,257,10,9,1
17,29,258,20,20,0
17,29,259,20,9,11
17,29,260,16,19,-3
17,29,261,15,8,7
17,29,262,47,17,30
17,29,263,10,10,0
17,29,264,16,16,0
17,29,265,17,12,5
17,29,266,13,5,8
17,29,267,10,13,-3
17,29,268,26,9,17
17,29,269,11,3,8
17,29,270,15,4,11
17,29,271,11,10,1
17,29,272,23,9,14
17,29,273,10,16,-6
17,29,274,30,13,17
17,29,275,18,12,6
17,29,276,15,19,-4
17,29,277,6,2,4
17,29,278,22,17,5
17,29,279,10,11,-1
17,29,280,12,5,7
17,29,281,23,16,7
17,29,282,18,16,2
17,29,283,6,7,-1
17,29,284,18,7,11
17,29,285,16,15,1
17,29,286,14,32,-18
17,29,287,23,7,16
17,29,288,17,5,12
17,29,289,16,9,7
17,29,290,11,26,-15
17,29,291,19,5,14
17,29,292,17,20,-3
17,29,293,23,14,9
17,29,294,19,13,6
17,29,295,23,19,4
17,29,296,16,8,8
17,29,297,13,13,0
17,29,298,18,11,7
17,29,299,17,4,13
17,30,0,23,13,10
17,30,1,22,22,0
17,30,2,19,13,6
17,30,3,18,10,8
17,30,4,19,10,9
17,30,5,14,8,6
17,30,6,6,7,-1
17,30,7,20,12,8
17,30,8,25,12,13
17,30,9,12,17,-5
17,30,10,12,6,6
17,30,11,19,13,6
17,30,12,22,9,13
17,30,13,16,6,10
17,30,14,16,16,0
17,30,15,23,14,9
17,30,16,14,15,-1
17,30,17,20,9,11
17,30,18,25,11,14
17,30,19,10,15,-5
17,30,20,11,11,0
17,30,21,21,16,5
17,30,22,15,13,2
17,30,23,10,9,1
17,30,24,14,17,-3
17,30,25,23,11,12
17,30,26,15,10,5
17,30,27,16,5,11
17,30,28,6,12,-6
17,30,29,25,19,6
17,30,30,15,7,8
17,30,31,14,8,6
17,30,32,25,5,20
17,30,33,8,9,-1
17,30,34,18,9,9
17,30,35,17,7,10
17,30,36,15,15,0
17,30,37,13,15,-2
17,30,38,25,17,8
17,30,39,15,9,6
17,30,40,11,9,2
17,30,41,17,15,2
17,30,42,11,12,-1
17,30,43,12,13,-1
17,30,44,5,2,3
17,30,45,10,7,3
17,30,46,11,11,0
17,30,47,17,16,1
17,30,48,14,11,3
17,30,49,25,12,13
17,30,50,10,6,4
17,30,51,28,16,12
17,30,52,31,7,24
17,30,53,15,15,0
17,30,54,25,13,12
17,30,55,8,7,1
17,30,56,11,9,2
17,30,57,14,15,-1
17,30,58,16,7,9
17,30,59,9,9,0
17,30,60,19,13,6
17,30,61,15,16,-1
17,30,62,29,9,20
17,30,63,18,8,10
17,30,64,11,3,8
17,30,65,4,10,-6
17,30,66,12,12,0
17,30,67,5,15,-10
17,30,68,25,20,5
17,30,69,14,10,4
17,30,70,11,11,0
17,30,71,16,14,2
17,30,72,26,31,-5
17,30,73,20,12,8
17,30,74,19,15,4
17,30,75,13,6,7
17,30,76,18,10,8
17,30,77,15,22,-7
17,30,78,7,6,1
17,30,79,16,10,6
17,30,80,11,20,-9
17,30,81,11,10,1
17,30,82,27,6,21
17,30,83,12,25,-13
17,30,84,15,10,5
17,30,85,14,16,-2
17,30,86,9,7,2
17,30,87,5,10,-5
17,30,88,22,11,11
17,30,89,18,14,4
17,30,90,15,14,1
17,30,91,11,3,8
17,30,92,4,3,1
17,30,93,11,10,1
17,30,94,13,10,3
17,30,95,13,7,6
17,30,96,15,16,-1
17,30,97,14,12,2
17,30,98,18,6,12
17,30,99,15,10,5
17,30,100,20,9,11
17,30,101,16,18,-2
17,30,102,12,12,0
17,30,103,21,12,9
17,30,104,28,13,15
17,30,105,7,20,-13
17,30,106,16,18,-2
17,30,107,11,9,2
17,30,108,17,29,-12
17,30,109,10,3,7
17,30,110,8,14,-6
17,30,111,7,6,1
17,30,112,14,8,6
17,30,113,10,6,4
17,30,114,11,8,3
17,30,115,19,13,6
17,30,116,10,4,6
17,30,117,15,8,7
17,30,118,10,12,-2
17,30,119,22,21,1
17,30,120,6,10,-4
17,30,121,13,6,7
17,30,122,23,18,5
17,30,123,15,11,4
17,30,124,12,3,9
17,30,125,17,15,2
17,30,126,14,12,2
17,30,127,13,15,-2
17,30,128,6,10,-4
17,30,129,11,12,-1
17,30,130,10,9,1
17,30,131,19,11,8
17,30,132,6,13,-7
17,30,133,17,18,-1
17,30,134,12,18,-6
17,30,135,16,21,-5
17,30,136,17,4,13
17,30,137,22,10,12
17,30,138,11,8,3
17,30,139,21,9,12
17,30,140,7,10,-3
17,30,141,13,25,-12
17,30,142,8,12,-4
17,30,143,24,20,4
17,30,144,12,11,1
17,30,145,19,8,11
17,30,146,9,15,-6
17,30,147,9,6,3
17,30,148,19,10,9
17,30,149,7,18,-11
17,30,150,28,18,10
17,30,151,7,13,-6
17,30,152,21,9,12
17,30,153,23,12,11
17,30,154,10,14,-4
17,30,155,18,8,10
17,30,156,22,29,-7
17,30,157,15,18,-3
17,30,158,16,17,-1
17,30,159,12,12,0
17,30,160,24,10,14
17,30,161,15,16,-1
17,30,162,10,2,8
17,30,163,15,10,5
17,30,164,5,5,0
17,30,165,11,9,2
17,30,166,18,15,3
17,30,167,10,15,-5
17,30,168,14,13,1
17,30,169,16,9,7
17,30,170,11,12,-1
17,30,171,21,6,15
17,30,172,29,9,20
17,30,173,1,11,-10
17,30,174,22,17,5
17,30,175,19,17,2
17,30,176,14,4,10
17,30,177,22,16,6
17,30,178,20,8,12
17,30,179,9,6,3
17,30,180,12,6,6
17,30,181,25,10,15
17,30,182,19,15,4
17,30,183,15,9,6
17,30,184,18,24,-6
17,30,185,14,11,3
17,30,186,14,8,6
17,30,187,17,8,9
17,30,188,15,16,-1
17,30,189,19,9,10
17,30,190,29,22,7
17,30,191,14,5,9
17,30,192,14,21,-7
17,30,193,14,9,5
17,30,194,11,11,0
17,30,195,13,16,-3
17,30,196,24,10,14
17,30,197,24,11,13
17,30,198,24,15,9
17,30,199,31,18,13
17,30,200,23,12,11
17,30,201,21,16,5
17,30,202,16,22,-6
17,30,203,13,18,-5
17,30,204,12,5,7
17,30,205,5,7,-2
17,30,206,21,9,12
17,30,207,17,21,-4
17,30,208,10,8,2
17,30,209,17,14,3
17,30,210,19,10,9
17,30,211,13,19,-6
17,30,212,17,11,6
17,30,213,11,13,-2
17,30,214,22,12,10
17,30,215,10,6,4
17,30,216,16,15,1
17,30,217,26,11,15
17,30,218,16,10,6
17,30,219,5,5,0
17,30,220,17,10,7
17,30,221,21,9,12
17,30,222,18,8,10
17,30,223,13,16,-3
17,30,224,18,18,0
17,30,225,12,4,8
17,30,226,18,15,3
17,30,227,16,7,9
17,30,228,7,6,1
17,30,229,10,10,0
17,30,230,15,18,-3
17,30,231,8,13,-5
17,30,232,18,23,-5
17,30,233,22,15,7
17,30,234,18,6,12
17,30,235,26,8,18
17,30,236,17,13,4
17,30,237,20,7,13
17,30,238,22,10,12
17,30,239,17,12,5
17,30,240,7,12,-5
17,30,241,24,9,15
17,30,242,25,4,21
17,30,243,17,11,6
17,30,244,15,21,-6
17,30,245,6,4,2
17,30,246,16,9,7
17,30,247,21,14,7
17,30,248,4,7,-3
17,30,249,13,9,4
17,30,250,15,18,-3
17,30,251,12,18,-6
17,30,252,24,4,20
17,30,253,24,21,3
17,30,254,11,13,-2
17,30,255,14,7,7
17,30,256,23,7,16
17,30,257,17,12,5
17,30,258,17,20,-3
17,30,259,14,9,5
17,30,260,16,10,6
17,30,261,16,13,3
17,30,262,11,3,8
17,30,263,6,11,-5
17,30,264,13,14,-1
17,30,265,15,17,-2
17,30,266,10,2,8
17,30,267,19,15,4
17,30,268,15,15,0
17,30,269,18,28,-10
17,30,270,9,6,3
17,30,271,13,2,11
17,30,272,23,16,7
17,30,273,17,10,7
17,30,274,23,19,4
17,30,275,12,10,2
17,30,276,20,9,11
17,30,277,11,22,-11
17,30,278,20,18,2
17,30,279,26,21,5
17,30,280,18,9,9
17,30,281,7,5,2
17,30,282,24,21,3
17,30,283,19,11,8
17,30,284,15,14,1
17,30,285,15,7,8
17,30,286,16,11,5
17,30,287,27,21,6
17,30,288,20,23,-3
17,30,289,20,9,11
17,30,290,13,12,1
17,30,291,20,24,-4
17,30,292,23,9,14
17,30,293,36,32,4
17,30,294,8,11,-3
17,30,295,17,10,7
17,30,296,12,17,-5
17,30,297,22,6,16
17,30,298,25,11,14
17,30,299,10,7,3
18,1,0,15,29,-14
18,1,1,9,26,-17
18,1,2,2,8,-6
18,1,3,7,14,-7
18,1,4,8,12,-4
18,1,5,3,15,-12
18,1,6,5,12,-7
18,1,7,9,15,-6
18,1,8,8,12,-4
18,1,9,11,18,-7
18,1,10,8,18,-10
18,1,11,12,16,-4
18,1,12,5,13,-8
18,1,13,1,12,-11
18,1,14,8,13,-5
18,1,15,5,10,-5
18,1,16,7,12,-5
18,1,17,14,7,7
18,1,18,10,16,-6
18,1,19,5,9,-4
18,1,20,7,30,-23
18,1,21,7,8,-1
18,1,22,10,24,-14
18,1,23,23,22,1
18,1,24,8,19,-11
18,1,25,8,18,-10
18,1,26,7,11,-4
18,1,27,5,9,-4
18,1,28,7,15,-8
18,1,29,9,7,2
18,1,30,9,15,-6
18,1,31,3,12,-9
18,1,32,14,34,-20
18,1,33,6,16,-10
18,1,34,13,13,0
18,1,35,4,20,-16
18,1,36,15,17,-2
18,1,37,19,15,4
18,1,38,10,17,-7
18,1,39,3,7,-4
18,1,40,8,13,-5
18,1,41,11,22,-11
18,1,42,0,14,-14
18,1,43,14,16,-2
18,1,44,4,18,-14
18,1,45,18,29,-11
18,1,46,5,10,-5
18,1,47,6,16,-10
18,1,48,5,12,-7
18,1,49,11,14,-3
18,1,50,14,10,4
18,1,51,9,8,1
18,1,52,9,10,-1
18,1,53,9,9,0
18,1,54,3,7,-4
18,1,55,8,12,-4
18,1,56,11,12,-1
18,1,57,6,14,-8
18,1,58,14,18,-4
18,1,59,10,13,-3
18,1,60,7,13,-6
18,1,61,16,28,-12
18,1,62,3,2,1
18,1,63,9,14,-5
18,1,64,7,12,-5
18,1,65,14,17,-3
18,1,66,9,28,-19
18,1,67,5,33,-28
18,1,68,2,14,-12
18,1,69,7,17,-10
18,1,70,15,29,-14
18,1,71,7,28,-21
18,1,72,11,16,-5
18,1,73,2,10,-8
18,1,74,5,10,-5
18,1,75,7,10,-3
18,1,76,15,14,1
18,1,77,15,21,-6
18,1,78,5,31,-26
18,1,79,12,14,-2
18,1,80,4,7,-3
18,1,81,3,7,-4
18,1,82,8,23,-15
18,1,83,15,32,-17
18,1,84,7,9,-2
18,1,85,11,10,1
18,1,86,8,14,-6
18,1,87,7,11,-4
18,1,88,6,7,-1
18,1,89,3,13,-10
18,1,90,5,15,-10
18,1,91,7,15,-8
18,1,92,8,20,-12
18,1,93,3,9,-6
18,1,94,9,20,-11
18,1,95,10,15,-5
18,1,96,4,12,-8
18,1,97,14,11,3
18,1,98,7,15,-8
18,1,99,4,10,-6
18,1,100,5,20,-15
18,1,101,3,10,-7
18,1,102,14,12,2
18,1,103,5,14,-9
18,1,104,2,14,-12
18,1,105,5,12,-7
18,1,106,6,17,-11
18,1,107,2,16,-14
18,1,108,6,11,-5
18,1,109,10,23,-13
18,1,110,7,12,-5
18,1,111,7,23,-16
18,1,112,9,27,-18
18,1,113,7,8,-1
18,1,114,11,8,3
18,1,115,5,14,-9
18,1,116,8,27,-19
18,1,117,2,4,-2
18,1,118,11,7,4
18,1,119,7,19,-12
18,1,120,3,19,-16
18,1,121,7,11,-4
18,1,122,2,10,-8
18,1,123,13,7,6
18,1,124,18,18,0
18,1,125,7,27,-20
18,1,126,11,24,-13
18,1,127,21,19,2
18,1,128,10,13,-3
18,1,129,4,18,-14
18,1,130,12,11,1
18,1,131,1,3,-2
18,1,132,10,30,-20
18,1,133,8,12,-4
18,1,134,6,25,-19
18,1,135,9,24,-15
18,1,136,7,20,-13
18,1,137,8,18,-10
18,1,138,12,12,0
18,1,139,7,26,-19
18,1,140,9,22,-13
18,1,141,13,23,-10
18,1,142,2,9,-7
18,1,143,4,20,-16
18,1,144,6,22,-16
18,1,145,8,11,-3
18,1,146,4,12,-8
18,1,147,17,17,0
18,1,148,5,11,-6
18,1,149,10,10,0
18,1,150,11,8,3
18,1,151,8,18,-10
18,1,152,4,11,-7
18,1,153,11,15,-4
18,1,154,14,13,1
18,1,155,4,18,-14
18,1,156,12,20,-8
18,1,157,8,14,-6
18,1,158,4,20,-16
18,1,159,7,5,2
18,1,160,5,24,-19
18,1,161,7,15,-8
18,1,162,2,11,-9
18,1,163,4,13,-9
18,1,164,5,12,-7
18,1,165,6,14,-8
18,1,166,6,12,-6
18,1,167,10,9,1
18,1,168,16,29,-13
18,1,169,9,15,-6
18,1,170,5,5,0
18,1,171,9,6,3
18,1,172,7,5,2
18,1,173,14,20,-6
18,1,174,17,19,-2
18,1,175,6,26,-20
18,1,176,3,11,-8
18,1,177,11,16,-5
18,1,178,10,23,-13
18,1,179,12,11,1
18,1,180,12,19,-7
18,1,181,6,9,-3
18,1,182,5,16,-11
18,1,183,8,16,-8
18,1,184,6,12,-6
18,1,185,5,12,-7
18,1,186,6,26,-20
18,1,187,5,3,2
18,1,188,18,16,2
18,1,189,5,21,-16
18,1,190,10,18,-8
18,1,191,6,15,-9
18,1,192,8,18,-10
18,1,193,13,15,-2
18,1,194,11,22,-11
18,1,195,3,15,-12
18,1,196,17,12,5
18,1,197,2,11,-9
18,1,198,7,17,-10
18,1,199,11,10,1
18,1,200,8,18,-10
18,1,201,14,19,-5
18,1,202,14,31,-17
18,1,203,8,16,-8
18,1,204,6,15,-9
18,1,205,9,15,-6
18,1,206,7,22,-15
18,1,207,4,8,-4
18,1,208,8,16,-8
18,1,209,7,18,-11
18,1,210,3,14,-11
18,1,211,10,33,-23
18,1,212,17,30,-13
18,1,213,5,13,-8
18,1,214,4,11,-7
18,1,215,6,17,-11
18,1,216,9,11,-2
18,1,217,3,7,-4
18,1,218,5,9,-4
18,1,219,1,11,-10
18,1,220,5,8,-3
18,1,221,7,7,0
18,1,222,11,15,-4
18,1,223,8,34,-26
18,1,224,15,9,6
18,1,225,6,15,-9
18,1,226,8,11,-3
18,1,227,10,12,-2
18,1,228,8,6,2
18,1,229,9,14,-5
18,1,230,3,13,-10
18,1,231,10,24,-14
18,1,232,9,23,-14
18,1,233,11,9,2
18,1,234,6,22,-16
18,1,235,13,23,-10
18,1,236,6,9,-3
18,1,237,10,14,-4
18,1,238,8,15,-7
18,1,239,11,16,-5
18,1,240,5,8,-3
18,1,241,13,17,-4
18,1,242,8,13,-5
18,1,243,8,17,-9
18,1,244,5,14,-9
18,1,245,11,15,-4
18,1,246,8,17,-9
18,1,247,14,11,3
18,1,248,6,15,-9
18,1,249,7,13,-6
18,1,250,5,24,-19
18,1,251,11,17,-6
18,1,252,9,14,-5
18,1,253,4,16,-12
18,1,254,5,16,-11
18,1,255,9,14,-5
18,1,256,7,9,-2
18,1,257,4,16,-12
18,1,258,4,10,-6
18,1,259,8,15,-7
18,1,260,4,7,-3
18,1,261,9,21,-12
18,1,262,4,8,-4
18,1,263,5,24,-19
18,1,264,4,18,-14
18,1,265,11,20,-9
18,1,266,13,13,0
18,1,267,6,14,-8
18,1,268,2,12,-10
18,1,269,10,11,-1
18,1,270,9,22,-13
18,1,271,15,17,-2
18,1,272,12,18,-6
18,1,273,8,2,6
18,1,274,12,12,0
18,1,275,4,21,-17
18,1,276,7,20,-13
18,1,277,21,19,2
18,1,278,6,12,-6
18,1,279,4,11,-7
18,1,280,14,15,-1
18,1,281,10,16,-6
18,1,282,5,10,-5
18,1,283,8,14,-6
18,1,284,10,11,-1
18,1,285,10,9,1
18,1,286,7,7,0
18,1,287,19,24,-5
18,1,288,13,30,-17
18,1,289,10,5,5
18,1,290,10,20,-10
18,1,291,3,22,-19
18,1,292,7,18,-11
18,1,293,5,6,-1
18,1,294,11,15,-4
18,1,295,17,22,-5
18,1,296,4,12,-8
18,1,297,14,29,-15
18,1,298,7,9,-2
18,1,299,8,12,-4
18,2,0,9,9,0
18,2,1,7,9,-2
18,2,2,14,19,-5
18,2,3,11,15,-4
18,2,4,5,8,-3
18,2,5,16,26,-10
18,2,6,2,9,-7
18,2,7,11,34,-23
18,2,8,10,13,-3
18,2,9,26,16,10
18,2,10,3,22,-19
18,2,11,4,13,-9
18,2,12,7,25,-18
18,2,13,13,9,4
18,2,14,5,22,-17
18,2,15,16,12,4
18,2,16,10,23,-13
18,2,17,2,9,-7
18,2,18,12,21,-9
18,2,19,10,15,-5
18,2,20,5,12,-7
18,2,21,4,9,-5
18,2,22,9,10,-1
18,2,23,8,16,-8
18,2,24,11,16,-5
18,2,25,7,22,-15
18,2,26,8,16,-8
18,2,27,8,37,-29
18,2,28,5,5,0
18,2,29,8,11,-3
18,2,30,12,15,-3
18,2,31,6,14,-8
18,2,32,14,11,3
18,2,33,11,9,2
18,2,34,11,25,-14
18,2,35,7,17,-10
18,2,36,4,12,-8
18,2,37,16,35,-19
18,2,38,5,16,-11
18,2,39,7,15,-8
18,2,40,9,12,-3
18,2,41,10,40,-30
18,2,42,10,25,-15
18,2,43,22,13,9
18,2,44,2,11,-9
18,2,45,12,32,-20
18,2,46,7,8,-1
18,2,47,11,19,-8
18,2,48,11,11,0
18,2,49,5,15,-10
18,2,50,11,14,-3
18,2,51,9,12,-3
18,2,52,11,14,-3
18,2,53,9,15,-6
18,2,54,7,14,-7
18,2,55,3,12,-9
18,2,56,3,20,-17
18,2,57,15,23,-8
18,2,58,7,18,-11
18,2,59,12,27,-15
18,2,60,19,26,-7
18,2,61,9,14,-5
18,2,62,12,21,-9
18,2,63,6,7,-1
18,2,64,10,24,-14
18,2,65,9,17,-8
18,2,66,1,25,-24
18,2,67,12,17,-5
18,2,68,11,17,-6
18,2,69,2,5,-3
18,2,70,7,4,3
18,2,71,13,31,-18
18,2,72,10,34,-24
18,2,73,7,10,-3
18,2,74,2,12,-10
18,2,75,10,11,-1
18,2,76,5,23,-18
18,2,77,12,25,-13
18,2,78,15,28,-13
18,2,79,2,4,-2
18,2,80,8,11,-3
18,2,81,4,20,-16
18,2,82,12,13,-1
18,2,83,3,7,-4
18,2,84,5,20,-15
18,2,85,4,13,-9
18,2,86,15,14,1
18,2,87,3,22,-19
18,2,88,9,11,-2
18,2,89,2,7,-5
18,2,90,5,4,1
18,2,91,10,29,-19
18,2,92,7,19,-12
18,2,93,9,23,-14
18,2,94,5,10,-5
18,2,95,9,30,-21
18,2,96,9,18,-9
18,2,97,9,14,-5
18,2,98,11,21,-10
18,2,99,15,17,-2
18,2,100,17,25,-8
18,2,101,13,18,-5
18,2,102,4,7,-3
18,2,103,8,22,-14
18,2,104,5,9,-4
18,2,105,8,15,-7
18,2,106,5,25,-20
18,2,107,9,12,-3
18,2,108,9,17,-8
18,2,109,2,11,-9
18,2,110,6,19,-13
18,2,111,8,21,-13
18,2,112,22,31,-9
18,2,113,6,16,-10
18,2,114,1,8,-7
18,2,115,10,22,-12
18,2,116,6,17,-11
18,2,117,2,21,-19
18,2,118,8,10,-2
18,2,119,9,27,-18
18,2,120,17,35,-18
18,2,121,8,20,-12
18,2,122,10,18,-8
18,2,123,18,21,-3
18,2,124,11,17,-6
18,2,125,8,14,-6
18,2,126,10,14,-4
18,2,127,2,10,-8
18,2,128,8,8,0
18,2,129,11,19,-8
18,2,130,14,27,-13
18,2,131,11,28,-17
18,2,132,7,7,0
18,2,133,6,21,-15
18,2,134,11,17,-6
18,2,135,11,21,-10
18,2,136,9,15,-6
18,2,137,19,16,3
18,2,138,2,31,-29
18,2,139,1,9,-8
18,2,140,10,20,-10
18,2,141,3,15,-12
18,2,142,9,16,-7
18,2,143,16,16,0
18,2,144,7,19,-12
18,2,145,4,16,-12
18,2,146,14,23,-9
18,2,147,15,11,4
18,2,148,7,14,-7
18,2,149,6,19,-13
18,2,150,6,9,-3
18,2,151,11,12,-1
18,2,152,8,6,2
18,2,153,10,11,-1
18,2,154,1,13,-12
18,2,155,12,14,-2
18,2,156,9,14,-5
18,2,157,6,16,-10
18,2,158,14,19,-5
18,2,159,5,19,-14
18,2,160,7,18,-11
18,2,161,7,15,-8
18,2,162,5,15,-10
18,2,163,8,20,-12
18,2,164,6,29,-23
18,2,165,0,7,-7
18,2,166,7,15,-8
18,2,167,4,10,-6
18,2,168,6,15,-9
18,2,169,13,11,2
18,2,170,13,23,-10
18,2,171,18,12,6
18,2,172,12,19,-7
18,2,173,7,32,-25
18,2,174,12,17,-5
18,2,175,12,16,-4
18,2,176,11,16,-5
18,2,177,2,18,-16
18,2,178,12,35,-23
18,2,179,8,16,-8
18,2,180,14,13,1
18,2,181,4,21,-17
18,2,182,16,9,7
18,2,183,11,14,-3
18,2,184,5,7,-2
18,2,185,18,21,-3
18,2,186,5,22,-17
18,2,187,9,9,0
18,2,188,15,14,1
18,2,189,9,16,-7
18,2,190,8,8,0
18,2,191,6,19,-13
18,2,192,13,22,-9
18,2,193,5,18,-13
18,2,194,18,9,9
18,2,195,3,13,-10
18,2,196,12,17,-5
18,2,197,20,17,3
18,2,198,7,20,-13
18,2,199,3,18,-15
18,2,200,15,13,2
18,2,201,17,24,-7
18,2,202,5,4,1
18,2,203,7,21,-14
18,2,204,4,17,-13
18,2,205,3,25,-22
18,2,206,12,19,-7
18,2,207,16,18,-2
18,2,208,10,20,-10
18,2,209,10,19,-9
18,2,210,1,10,-9
18,2,211,6,29,-23
18,2,212,4,24,-20
18,2,213,3,16,-13
18,2,214,7,9,-2
18,2,215,9,7,2
18,2,216,3,7,-4
18,2,217,6,20,-14
18,2,218,16,18,-2
18,2,219,7,14,-7
18,2,220,9,17,-8
18,2,221,10,14,-4
18,2,222,14,16,-2
18,2,223,4,25,-21
18,2,224,4,27,-23
18,2,225,11,11,0
18,2,226,12,24,-12
18,2,227,6,13,-7
18,2,228,4,16,-12
18,2,229,11,16,-5
18,2,230,11,19,-8
18,2,231,16,20,-4
18,2,232,16,19,-3
18,2,233,4,10,-6
18,2,234,7,37,-30
18,2,235,4,11,-7
18,2,236,5,23,-18
18,2,237,2,14,-12
18,2,238,3,7,-4
18,2,239,21,18,3
18,2,240,3,13,-10
18,2,241,9,16,-7
18,2,242,11,10,1
18,2,243,13,16,-3
18,2,244,11,24,-13
18,2,245,8,13,-5
18,2,246,5,17,-12
18,2,247,12,16,-4
18,2,248,16,17,-1
18,2,249,16,13,3
18,2,250,13,19,-6
18,2,251,1,26,-25
18,2,252,5,21,-16
18,2,253,12,26,-14
18,2,254,15,17,-2
18,2,255,10,16,-6
18,2,256,4,5,-1
18,2,257,8,18,-10
18,2,258,10,15,-5
18,2,259,12,17,-5
18,2,260,4,10,-6
18,2,261,3,7,-4
18,2,262,7,16,-9
18,2,263,2,22,-20
18,2,264,7,17,-10
18,2,265,8,15,-7
18,2,266,3,12,-9
18,2,267,12,12,0
18,2,268,5,19,-14
18,2,269,5,10,-5
18,2,270,9,5,4
18,2,271,2,7,-5
18,2,272,6,12,-6
18,2,273,8,14,-6
18,2,274,10,10,0
18,2,275,10,20,-10
18,2,276,8,21,-13
18,2,277,5,10,-5
18,2,278,9,23,-14
18,2,279,3,17,-14
18,2,280,3,8,-5
18,2,281,6,16,-10
18,2,282,11,22,-11
18,2,283,3,12,-9
18,2,284,11,13,-2
18,2,285,2,9,-7
18,2,286,8,13,-5
18,2,287,14,17,-3
18,2,288,8,18,-10
18,2,289,9,30,-21
18,2,290,10,15,-5
18,2,291,8,12,-4
18,2,292,6,10,-4
18,2,293,7,14,-7
18,2,294,6,16,-10
18,2,295,9,37,-28
18,2,296,15,16,-1
18,2,297,9,19,-10
18,2,298,8,6,2
18,2,299,13,15,-2
18,3,0,2,9,-7
18,3,1,12,15,-3
18,3,2,12,20,-8
18,3,3,9,29,-20
18,3,4,8,20,-12
18,3,5,13,19,-6
18,3,6,7,9,-2
18,3,7,18,25,-7
18,3,8,10,11,-1
18,3,9,8,19,-11
18,3,10,8,7,1
18,3,11,1,8,-7
18,3,12,9,12,-3
18,3,13,5,9,-4
18,3,14,8,8,0
18,3,15,13,22,-9
18,3,16,10,18,-8
18,3,17,9,14,-5
18,3,18,2,10,-8
18,3,19,14,21,-7
18,3,20,9,19,-10
18,3,21,15,15,0
18,3,22,7,8,-1
18,3,23,6,21,-15
18,3,24,9,21,-12
18,3,25,10,28,-18
18,3,26,7,19,-12
18,3,27,9,16,-7
18,3,28,3,18,-15
18,3,29,11,23,-12
18,3,30,10,8,2
18,3,31,5,19,-14
18,3,32,6,8,-2
18,3,33,5,11,-6
18,3,34,13,15,-2
18,3,35,6,12,-6
18,3,36,3,6,-3
18,3,37,16,10,6
18,3,38,9,34,-25
18,3,39,8,10,-2
18,3,40,15,17,-2
18,3,41,9,13,-4
18,3,42,8,7,1
18,3,43,11,8,3
18,3,44,3,15,-12
18,3,45,10,25,-15
18,3,46,12,21,-9
18,3,47,2,2,0
18,3,48,11,30,-19
18,3,49,8,13,-5
18,3,50,5,18,-13
18,3,51,9,22,-13
18,3,52,7,13,-6
18,3,53,10,18,-8
18,3,54,3,7,-4
18,3,55,6,6,0
18,3,56,8,16,-8
18,3,57,3,12,-9
18,3,58,16,25,-9
18,3,59,7,6,1
18,3,60,13,17,-4
18,3,61,12,16,-4
18,3,62,18,16,2
18,3,63,8,28,-20
18,3,64,8,12,-4
18,3,65,11,6,5
18,3,66,7,19,-12
18,3,67,7,35,-28
18,3,68,8,17,-9
18,3,69,3,3,0
18,3,70,6,19,-13
18,3,71,3,20,-17
18,3,72,17,23,-6
18,3,73,7,13,-6
18,3,74,13,25,-12
18,3,75,15,18,-3
18,3,76,14,17,-3
18,3,77,21,26,-5
18,3,78,10,9,1
18,3,79,3,9,-6
18,3,80,7,11,-4
18,3,81,2,16,-14
18,3,82,4,10,-6
18,3,83,4,20,-16
18,3,84,5,10,-5
18,3,85,13,23,-10
18,3,86,2,17,-15
18,3,87,8,11,-3
18,3,88,6,6,0
18,3,89,7,24,-17
18,3,90,9,14,-5
18,3,91,7,30,-23
18,3,92,4,23,-19
18,3,93,12,18,-6
18,3,94,18,16,2
18,3,95,10,14,-4
18,3,96,19,32,-13
18,3,97,8,13,-5
18,3,98,11,34,-23
18,3,99,4,27,-23
18,3,100,8,17,-9
18,3,101,13,22,-9
18,3,102,6,22,-16
18,3,103,15,21,-6
18,3,104,6,19,-13
18,3,105,6,14,-8
18,3,106,7,25,-18
18,3,107,11,31,-20
18,3,108,7,19,-12
18,3,109,8,27,-19
18,3,110,18,29,-11
18,3,111,13,25,-12
18,3,112,11,20,-9
18,3,113,9,21,-12
18,3,114,22,34,-12
18,3,115,12,9,3
18,3,116,14,15,-1
18,3,117,8,18,-10
18,3,118,7,10,-3
18,3,119,15,27,-12
18,3,120,17,21,-4
18,3,121,10,15,-5
18,3,122,18,17,1
18,3,123,14,14,0
18,3,124,20,32,-12
18,3,125,10,17,-7
18,3,126,8,22,-14
18,3,127,3,11,-8
18,3,128,6,8,-2
18,3,129,14,20,-6
18,3,130,7,12,-5
18,3,131,19,9,10
18,3,132,9,19,-10
18,3,133,3,10,-7
18,3,134,5,17,-12
18,3,135,4,15,-11
18,3,136,9,7,2
18,3,137,6,25,-19
18,3,138,12,12,0
18,3,139,11,16,-5
18,3,140,3,20,-17
18,3,141,5,14,-9
18,3,142,11,15,-4
18,3,143,8,31,-23
18,3,144,3,19,-16
18,3,145,7,15,-8
18,3,146,4,6,-2
18,3,147,8,14,-6
18,3,148,7,11,-4
18,3,149,6,14,-8
18,3,150,9,18,-9
18,3,151,17,14,3
18,3,152,2,17,-15
18,3,153,15,24,-9
18,3,154,11,22,-11
18,3,155,12,25,-13
18,3,156,8,15,-7
18,3,157,12,17,-5
18,3,158,7,13,-6
18,3,159,7,3,4
18,3,160,3,23,-20
18,3,161,12,32,-20
18,3,162,14,29,-15
18,3,163,8,17,-9
18,3,164,7,11,-4
18,3,165,7,11,-4
18,3,166,18,26,-8
18,3,167,7,16,-9
18,3,168,5,23,-18
18,3,169,10,19,-9
18,3,170,2,8,-6
18,3,171,13,24,-11
18,3,172,5,6,-1
18,3,173,22,25,-3
18,3,174,8,21,-13
18,3,175,6,19,-13
18,3,176,7,13,-6
18,3,177,10,10,0
18,3,178,24,13,11
18,3,179,14,16,-2
18,3,180,6,22,-16
18,3,181,5,16,-11
18,3,182,13,20,-7
18,3,183,13,20,-7
18,3,184,6,23,-17
18,3,185,6,35,-29
18,3,186,5,33,-28
18,3,187,9,23,-14
18,3,188,12,18,-6
18,3,189,8,16,-8
18,3,190,5,17,-12
18,3,191,20,31,-11
18,3,192,3,13,-10
18,3,193,7,17,-10
18,3,194,7,18,-11
18,3,195,13,22,-9
18,3,196,7,13,-6
18,3,197,8,29,-21
18,3,198,6,30,-24
18,3,199,10,17,-7
18,3,200,10,12,-2
18,3,201,6,7,-1
18,3,202,13,35,-22
18,3,203,10,7,3
18,3,204,6,10,-4
18,3,205,12,17,-5
18,3,206,16,34,-18
18,3,207,6,26,-20
18,3,208,6,18,-12
18,3,209,14,13,1
18,3,210,2,24,-22
18,3,211,8,18,-10
18,3,212,7,17,-10
18,3,213,18,26,-8
18,3,214,6,8,-2
18,3,215,5,13,-8
18,3,216,13,20,-7
18,3,217,16,15,1
18,3,218,9,12,-3
18,3,219,8,33,-25
18,3,220,13,13,0
18,3,221,10,11,-1
18,3,222,10,22,-12
18,3,223,7,23,-16
18,3,224,15,24,-9
18,3,225,19,20,-1
18,3,226,9,24,-15
18,3,227,6,21,-15
18,3,228,8,22,-14
18,3,229,6,18,-12
18,3,230,2,20,-18
18,3,231,9,12,-3
18,3,232,8,18,-10
18,3,233,8,19,-11
18,3,234,10,24,-14
18,3,235,17,21,-4
18,3,236,7,11,-4
18,3,237,13,22,-9
18,3,238,1,16,-15
18,3,239,10,19,-9
18,3,240,9,12,-3
18,3,241,9,28,-19
18,3,242,3,15,-12
18,3,243,15,17,-2
18,3,244,10,26,-16
18,3,245,8,15,-7
18,3,246,0,6,-6
18,3,247,9,13,-4
18,3,248,11,18,-7
18,3,249,8,14,-6
18,3,250,11,15,-4
18,3,251,3,13,-10
18,3,252,6,11,-5
18,3,253,9,17,-8
18,3,254,6,20,-14
18,3,255,0,17,-17
18,3,256,13,22,-9
18,3,257,9,7,2
18,3,258,12,12,0
18,3,259,7,16,-9
18,3,260,12,17,-5
18,3,261,16,21,-5
18,3,262,11,21,-10
18,3,263,11,22,-11
18,3,264,14,19,-5
18,3,265,9,35,-26
18,3,266,6,25,-19
18,3,267,8,16,-8
18,3,268,7,12,-5
18,3,269,14,15,-1
18,3,270,9,19,-10
18,3,271,12,21,-9
18,3,272,9,12,-3
18,3,273,4,17,-13
18,3,274,23,41,-18
18,3,275,9,19,-10
18,3,276,2,15,-13
18,3,277,13,14,-1
18,3,278,11,9,2
18,3,279,2,10,-8
18,3,280,1,13,-12
18,3,281,5,12,-7
18,3,282,15,26,-11
18,3,283,4,23,-19
18,3,284,8,18,-10
18,3,285,9,14,-5
18,3,286,16,9,7
18,3,287,5,11,-6
18,3,288,8,27,-19
18,3,289,17,31,-14
18,3,290,4,9,-5
18,3,291,6,9,-3
18,3,292,23,19,4
18,3,293,1,16,-15
18,3,294,3,8,-5
18,3,295,8,8,0
18,3,296,8,15,-7
18,3,297,10,18,-8
18,3,298,11,27,-16
18,3,299,7,15,-8
18,4,0,4,19,-15
18,4,1,9,14,-5
18,4,2,12,14,-2
18,4,3,4,10,-6
18,4,4,12,25,-13
18,4,5,7,13,-6
18,4,6,5,7,-2
18,4,7,10,23,-13
18,4,8,11,20,-9
18,4,9,12,23,-11
18,4,10,12,21,-9
18,4,11,7,20,-13
18,4,12,4,16,-12
18,4,13,13,14,-1
18,4,14,9,18,-9
18,4,15,13,29,-16
18,4,16,18,16,2
18,4,17,13,17,-4
18,4,18,9,10,-1
18,4,19,8,28,-20
18,4,20,7,16,-9
18,4,21,9,16,-7
18,4,22,4,20,-16
18,4,23,9,11,-2
18,4,24,12,18,-6
18,4,25,8,20,-12
18,4,26,16,23,-7
18,4,27,9,28,-19
18,4,28,7,20,-13
18,4,29,7,16,-9
18,4,30,2,16,-14
18,4,31,20,22,-2
18,4,32,10,14,-4
18,4,33,2,8,-6
18,4,34,20,23,-3
18,4,35,12,29,-17
18,4,36,12,20,-8
18,4,37,12,20,-8
18,4,38,17,16,1
18,4,39,2,17,-15
18,4,40,12,4,8
18,4,41,9,13,-4
18,4,42,10,11,-1
18,4,43,5,20,-15
18,4,44,13,23,-10
18,4,45,10,13,-3
18,4,46,7,28,-21
18,4,47,17,28,-11
18,4,48,12,14,-2
18,4,49,5,18,-13
18,4,50,7,10,-3
18,4,51,12,10,2
18,4,52,16,31,-15
18,4,53,6,20,-14
18,4,54,6,31,-25
18,4,55,8,29,-21
18,4,56,7,29,-22
18,4,57,2,10,-8
18,4,58,5,12,-7
18,4,59,2,12,-10
18,4,60,11,22,-11
18,4,61,12,29,-17
18,4,62,15,17,-2
18,4,63,10,17,-7
18,4,64,2,20,-18
18,4,65,12,14,-2
18,4,66,8,5,3
18,4,67,16,25,-9
18,4,68,10,22,-12
18,4,69,2,12,-10
18,4,70,20,20,0
18,4,71,16,11,5
18,4,72,7,20,-13
18,4,73,11,25,-14
18,4,74,12,6,6
18,4,75,9,38,-29
18,4,76,19,22,-3
18,4,77,15,17,-2
18,4,78,12,13,-1
18,4,79,11,12,-1
18,4,80,8,19,-11
18,4,81,5,18,-13
18,4,82,12,23,-11
18,4,83,17,17,0
18,4,84,8,21,-13
18,4,85,15,34,-19
18,4,86,13,24,-11
18,4,87,4,18,-14
18,4,88,8,18,-10
18,4,89,12,18,-6
18,4,90,5,25,-20
18,4,91,7,25,-18
18,4,92,6,11,-5
18,4,93,14,25,-11
18,4,94,9,17,-8
18,4,95,7,20,-13
18,4,96,16,36,-20
18,4,97,5,6,-1
18,4,98,10,18,-8
18,4,99,9,13,-4
18,4,100,9,12,-3
18,4,101,8,19,-11
18,4,102,3,18,-15
18,4,103,8,22,-14
18,4,104,11,26,-15
18,4,105,9,11,-2
18,4,106,4,5,-1
18,4,107,9,28,-19
18,4,108,8,14,-6
18,4,109,14,18,-4
18,4,110,9,22,-13
18,4,111,6,16,-10
18,4,112,9,17,-8
18,4,113,7,9,-2
18,4,114,12,21,-9
18,4,115,15,13,2
18,4,116,11,17,-6
18,4,117,7,16,-9
18,4,118,10,13,-3
18,4,119,6,12,-6
18,4,120,10,33,-23
18,4,121,6,10,-4
18,4,122,5,14,-9
18,4,123,12,12,0
18,4,124,9,18,-9
18,4,125,12,17,-5
18,4,126,18,24,-6
18,4,127,6,25,-19
18,4,128,8,25,-17
18,4,129,8,11,-3
18,4,130,9,12,-3
18,4,131,5,12,-7
18,4,132,9,18,-9
18,4,133,14,28,-14
18,4,134,4,9,-5
18,4,135,7,12,-5
18,4,136,2,9,-7
18,4,137,11,13,-2
18,4,138,5,27,-22
18,4,139,18,13,5
18,4,140,6,18,-12
18,4,141,9,39,-30
18,4,142,12,12,0
18,4,143,8,15,-7
18,4,144,17,16,1
18,4,145,10,18,-8
18,4,146,7,14,-7
18,4,147,15,18,-3
18,4,148,7,16,-9
18,4,149,8,21,-13
18,4,150,10,31,-21
18,4,151,8,10,-2
18,4,152,9,13,-4
18,4,153,7,10,-3
18,4,154,15,25,-10
18,4,155,6,17,-11
18,4,156,6,24,-18
18,4,157,4,20,-16
18,4,158,14,25,-11
18,4,159,12,13,-1
18,4,160,7,18,-11
18,4,161,11,18,-7
18,4,162,11,26,-15
18,4,163,11,10,1
18,4,164,7,10,-3
18,4,165,8,22,-14
18,4,166,12,23,-11
18,4,167,7,13,-6
18,4,168,11,17,-6
18,4,169,14,37,-23
18,4,170,9,15,-6
18,4,171,6,18,-12
18,4,172,10,19,-9
18,4,173,14,18,-4
18,4,174,8,24,-16
18,4,175,4,20,-16
18,4,176,10,13,-3
18,4,177,3,12,-9
18,4,178,9,15,-6
18,4,179,15,16,-1
18,4,180,6,29,-23
18,4,181,13,17,-4
18,4,182,6,14,-8
18,4,183,5,24,-19
18,4,184,10,30,-20
18,4,185,5,22,-17
18,4,186,10,23,-13
18,4,187,17,32,-15
18,4,188,14,13,1
18,4,189,8,23,-15
18,4,190,12,23,-11
18,4,191,7,30,-23
18,4,192,6,9,-3
18,4,193,12,37,-25
18,4,194,9,4,5
18,4,195,9,8,1
18,4,196,14,25,-11
18,4,197,7,14,-7
18,4,198,12,16,-4
18,4,199,13,26,-13
18,4,200,5,16,-11
18,4,201,9,28,-19
18,4,202,14,24,-10
18,4,203,4,17,-13
18,4,204,6,11,-5
18,4,205,7,14,-7
18,4,206,2,11,-9
18,4,207,9,13,-4
18,4,208,18,15,3
18,4,209,7,30,-23
18,4,210,6,21,-15
18,4,211,11,14,-3
18,4,212,16,21,-5
18,4,213,18,18,0
18,4,214,8,27,-19
18,4,215,3,7,-4
18,4,216,3,14,-11
18,4,217,11,21,-10
18,4,218,10,23,-13
18,4,219,15,27,-12
18,4,220,8,27,-19
18,4,221,16,17,-1
18,4,222,7,21,-14
18,4,223,14,16,-2
18,4,224,19,25,-6
18,4,225,10,22,-12
18,4,226,13,25,-12
18,4,227,11,28,-17
18,4,228,13,10,3
18,4,229,14,10,4
18,4,230,25,21,4
18,4,231,16,19,-3
18,4,232,7,16,-9
18,4,233,22,15,7
18,4,234,19,26,-7
18,4,235,11,25,-14
18,4,236,8,5,3
18,4,237,4,10,-6
18,4,238,3,14,-11
18,4,239,9,17,-8
18,4,240,13,21,-8
18,4,241,6,20,-14
18,4,242,10,24,-14
18,4,243,7,23,-16
18,4,244,17,21,-4
18,4,245,12,21,-9
18,4,246,13,18,-5
18,4,247,3,18,-15
18,4,248,10,41,-31
18,4,249,9,25,-16
18,4,250,15,29,-14
18,4,251,14,23,-9
18,4,252,6,12,-6
18,4,253,11,23,-12
18,4,254,9,14,-5
18,4,255,3,8,-5
18,4,256,7,12,-5
18,4,257,12,24,-12
18,4,258,14,24,-10
18,4,259,11,16,-5
18,4,260,9,29,-20
18,4,261,11,26,-15
18,4,262,11,11,0
18,4,263,13,28,-15
18,4,264,10,20,-10
18,4,265,12,11,1
18,4,266,9,9,0
18,4,267,12,23,-11
18,4,268,10,17,-7
18,4,269,11,27,-16
18,4,270,11,17,-6
18,4,271,9,22,-13
18,4,272,9,28,-19
18,4,273,5,8,-3
18,4,274,5,23,-18
18,4,275,12,18,-6
18,4,276,8,10,-2
18,4,277,7,29,-22
18,4,278,2,11,-9
18,4,279,7,17,-10
18,4,280,5,9,-4
18,4,281,4,17,-13
18,4,282,7,16,-9
18,4,283,16,38,-22
18,4,284,8,28,-20
18,4,285,10,9,1
18,4,286,15,18,-3
18,4,287,8,17,-9
18,4,288,10,18,-8
18,4,289,11,16,-5
18,4,290,16,18,-2
18,4,291,9,26,-17
18,4,292,15,32,-17
18,4,293,6,19,-13
18,4,294,4,14,-10
18,4,295,12,27,-15
18,4,296,7,12,-5
18,4,297,7,13,-6
18,4,298,11,16,-5
18,4,299,16,23,-7
18,5,0,4,30,-26
18,5,1,6,18,-12
18,5,2,11,7,4
18,5,3,17,18,-1
18,5,4,11,12,-1
18,5,5,11,19,-8
18,5,6,5,29,-24
18,5,7,14,22,-8
18,5,8,6,16,-10
18,5,9,5,25,-20
18,5,10,14,18,-4
18,5,11,9,25,-16
18,5,12,10,16,-6
18,5,13,11,29,-18
18,5,14,12,17,-5
18,5,15,12,25,-13
18,5,16,10,12,-2
18,5,17,16,22,-6
18,5,18,12,13,-1
18,5,19,18,24,-6
18,5,20,11,27,-16
18,5,21,10,17,-7
18,5,22,20,23,-3
18,5,23,4,19,-15
18,5,24,10,17,-7
18,5,25,9,13,-4
18,5,26,9,4,5
18,5,27,14,9,5
18,5,28,20,28,-8
18,5,29,10,17,-7
18,5,30,13,17,-4
18,5,31,18,18,0
18,5,32,18,22,-4
18,5,33,15,22,-7
18,5,34,7,20,-13
18,5,35,12,28,-16
18,5,36,17,27,-10
18,5,37,19,24,-5
18,5,38,4,12,-8
18,5,39,14,29,-15
18,5,40,9,19,-10
18,5,41,6,21,-15
18,5,42,18,22,-4
18,5,43,15,15,0
18,5,44,7,4,3
18,5,45,11,14,-3
18,5,46,16,19,-3
18,5,47,5,9,-4
18,5,48,6,22,-16
18,5,49,8,16,-8
18,5,50,10,11,-1
18,5,51,10,19,-9
18,5,52,11,11,0
18,5,53,6,19,-13
18,5,54,12,23,-11
18,5,55,3,16,-13
18,5,56,7,23,-16
18,5,57,11,21,-10
18,5,58,18,23,-5
18,5,59,7,5,2
18,5,60,16,20,-4
18,5,61,16,15,1
18,5,62,13,19,-6
18,5,63,18,21,-3
18,5,64,15,24,-9
18,5,65,16,30,-14
18,5,66,14,15,-1
18,5,67,17,21,-4
18,5,68,17,20,-3
18,5,69,7,32,-25
18,5,70,9,27,-18
18,5,71,7,13,-6
18,5,72,6,4,2
18,5,73,6,17,-11
18,5,74,19,30,-11
18,5,75,13,18,-5
18,5,76,9,26,-17
18,5,77,4,12,-8
18,5,78,13,30,-17
18,5,79,11,22,-11
18,5,80,11,16,-5
18,5,81,4,37,-33
18,5,82,16,23,-7
18,5,83,8,24,-16
18,5,84,6,32,-26
18,5,85,8,20,-12
18,5,86,9,20,-11
18,5,87,10,25,-15
18,5,88,13,21,-8
18,5,89,2,0,2
18,5,90,9,15,-6
18,5,91,10,30,-20
18,5,92,11,20,-9
18,5,93,5,5,0
18,5,94,10,13,-3
18,5,95,8,14,-6
18,5,96,17,43,-26
18,5,97,8,38,-30
18,5,98,6,14,-8
18,5,99,22,16,6
18,5,100,9,25,-16
18,5,101,8,25,-17
18,5,102,5,8,-3
18,5,103,9,16,-7
18,5,104,6,24,-18
18,5,105,11,13,-2
18,5,106,11,13,-2
18,5,107,6,22,-16
18,5,108,3,12,-9
18,5,109,12,22,-10
18,5,110,14,29,-15
18,5,111,6,13,-7
18,5,112,21,38,-17
18,5,113,9,12,-3
18,5,114,9,18,-9
18,5,115,9,21,-12
18,5,116,7,21,-14
18,5,117,9,43,-34
18,5,118,7,13,-6
18,5,119,11,38,-27
18,5,120,21,28,-7
18,5,121,9,30,-21
18,5,122,12,31,-19
18,5,123,8,26,-18
18,5,124,7,23,-16
18,5,125,12,25,-13
18,5,126,8,28,-20
18,5,127,7,28,-21
18,5,128,18,28,-10
18,5,129,12,28,-16
18,5,130,6,10,-4
18,5,131,2,9,-7
18,5,132,8,19,-11
18,5,133,8,22,-14
18,5,134,15,28,-13
18,5,135,10,15,-5
18,5,136,9,9,0
18,5,137,11,13,-2
18,5,138,12,17,-5
18,5,139,10,11,-1
18,5,140,17,22,-5
18,5,141,11,23,-12
18,5,142,11,10,1
18,5,143,1,14,-13
18,5,144,6,15,-9
18,5,145,10,27,-17
18,5,146,12,26,-14
18,5,147,19,19,0
18,5,148,6,8,-2
18,5,149,17,31,-14
18,5,150,11,30,-19
18,5,151,4,19,-15
18,5,152,3,13,-10
18,5,153,8,8,0
18,5,154,20,18,2
18,5,155,3,20,-17
18,5,156,9,10,-1
18,5,157,7,25,-18
18,5,158,15,20,-5
18,5,159,8,12,-4
18,5,160,5,25,-20
18,5,161,13,20,-7
18,5,162,18,22,-4
18,5,163,7,12,-5
18,5,164,4,23,-19
18,5,165,6,19,-13
18,5,166,14,28,-14
18,5,167,7,23,-16
18,5,168,3,21,-18
18,5,169,8,34,-26
18,5,170,5,23,-18
18,5,171,7,17,-10
18,5,172,4,17,-13
18,5,173,12,20,-8
18,5,174,14,32,-18
18,5,175,9,40,-31
18,5,176,4,17,-13
18,5,177,8,16,-8
18,5,178,17,13,4
18,5,179,7,14,-7
18,5,180,16,14,2
18,5,181,14,19,-5
18,5,182,10,12,-2
18,5,183,13,34,-21
18,5,184,7,11,-4
18,5,185,3,14,-11
18,5,186,26,20,6
18,5,187,5,13,-8
18,5,188,10,14,-4
18,5,189,9,19,-10
18,5,190,10,10,0
18,5,191,9,20,-11
18,5,192,10,29,-19
18,5,193,2,13,-11
18,5,194,4,6,-2
18,5,195,19,16,3
18,5,196,6,13,-7
18,5,197,7,21,-14
18,5,198,14,29,-15
18,5,199,7,29,-22
18,5,200,5,27,-22
18,5,201,10,14,-4
18,5,202,11,32,-21
18,5,203,12,31,-19
18,5,204,16,28,-12
18,5,205,14,31,-17
18,5,206,11,13,-2
18,5,207,8,12,-4
18,5,208,13,21,-8
18,5,209,14,22,-8
18,5,210,16,22,-6
18,5,211,21,30,-9
18,5,212,14,37,-23
18,5,213,7,15,-8
18,5,214,17,20,-3
18,5,215,10,11,-1
18,5,216,13,25,-12
18,5,217,27,22,5
18,5,218,4,14,-10
18,5,219,13,19,-6
18,5,220,19,11,8
18,5,221,7,18,-11
18,5,222,8,22,-14
18,5,223,10,5,5
18,5,224,7,24,-17
18,5,225,19,17,2
18,5,226,8,16,-8
18,5,227,9,10,-1
18,5,228,5,17,-12
18,5,229,17,17,0
18,5,230,14,12,2
18,5,231,6,25,-19
18,5,232,7,12,-5
18,5,233,12,25,-13
18,5,234,10,22,-12
18,5,235,14,23,-9
18,5,236,9,27,-18
18,5,237,6,10,-4
18,5,238,8,8,0
18,5,239,2,10,-8
18,5,240,3,15,-12
18,5,241,10,17,-7
18,5,242,2,20,-18
18,5,243,11,9,2
18,5,244,8,14,-6
18,5,245,10,27,-17
18,5,246,18,7,11
18,5,247,4,19,-15
18,5,248,6,15,-9
18,5,249,15,25,-10
18,5,250,7,26,-19
18,5,251,8,9,-1
18,5,252,12,26,-14
18,5,253,19,31,-12
18,5,254,11,16,-5
18,5,255,4,18,-14
18,5,256,15,16,-1
18,5,257,10,25,-15
18,5,258,5,11,-6
18,5,259,20,25,-5
18,5,260,8,23,-15
18,5,261,9,20,-11
18,5,262,19,23,-4
18,5,263,12,16,-4
18,5,264,11,33,-22
18,5,265,6,20,-14
18,5,266,6,13,-7
18,5,267,6,10,-4
18,5,268,10,21,-11
18,5,269,19,17,2
18,5,270,14,12,2
18,5,271,12,29,-17
18,5,272,9,20,-11
18,5,273,10,12,-2
18,5,274,17,24,-7
18,5,275,14,16,-2
18,5,276,13,24,-11
18,5,277,6,19,-13
18,5,278,9,17,-8
18,5,279,5,10,-5
18,5,280,10,16,-6
18,5,281,8,12,-4
18,5,282,14,21,-7
18,5,283,9,21,-12
18,5,284,16,18,-2
18,5,285,8,13,-5
18,5,286,7,14,-7
18,5,287,5,18,-13
18,5,288,10,23,-13
18,5,289,9,34,-25
18,5,290,12,40,-28
18,5,291,10,20,-10
18,5,292,12,22,-10
18,5,293,9,12,-3
18,5,294,5,24,-19
18,5,295,13,15,-2
18,5,296,3,15,-12
18,5,297,20,23,-3
18,5,298,14,18,-4
18,5,299,15,27,-12
18,6,0,13,25,-12
18,6,1,8,26,-18
18,6,2,4,11,-7
18,6,3,15,21,-6
18,6,4,11,22,-11
18,6,5,17,22,-5
18,6,6,5,23,-18
18,6,7,5,17,-12
18,6,8,4,18,-14
18,6,9,7,16,-9
18,6,10,9,32,-23
18,6,11,9,29,-20
18,6,12,15,16,-1
18,6,13,9,21,-12
18,6,14,17,21,-4
18,6,15,16,23,-7
18,6,16,15,32,-17
18,6,17,9,42,-33
18,6,18,4,12,-8
18,6,19,10,12,-2
18,6,20,18,13,5
18,6,21,6,27,-21
18,6,22,5,9,-4
18,6,23,6,16,-10
18,6,24,14,19,-5
18,6,25,11,11,0
18,6,26,11,27,-16
18,6,27,18,30,-12
18,6,28,12,25,-13
18,6,29,6,25,-19
18,6,30,15,39,-24
18,6,31,10,4,6
18,6,32,7,12,-5
18,6,33,20,20,0
18,6,34,7,26,-19
18,6,35,9,13,-4
18,6,36,15,27,-12
18,6,37,12,25,-13
18,6,38,13,21,-8
18,6,39,19,9,10
18,6,40,6,3,3
18,6,41,13,19,-6
18,6,42,8,23,-15
18,6,43,13,15,-2
18,6,44,10,25,-15
18,6,45,7,24,-17
18,6,46,4,6,-2
18,6,47,8,19,-11
18,6,48,9,26,-17
18,6,49,7,10,-3
18,6,50,8,16,-8
18,6,51,8,13,-5
18,6,52,7,29,-22
18,6,53,6,10,-4
18,6,54,4,9,-5
18,6,55,11,26,-15
18,6,56,8,21,-13
18,6,57,10,10,0
18,6,58,10,18,-8
18,6,59,18,39,-21
18,6,60,11,11,0
18,6,61,16,23,-7
18,6,62,11,16,-5
18,6,63,15,15,0
18,6,64,10,27,-17
18,6,65,4,29,-25
18,6,66,10,14,-4
18,6,67,10,27,-17
18,6,68,18,13,5
18,6,69,9,19,-10
18,6,70,6,21,-15
18,6,71,6,16,-10
18,6,72,11,20,-9
18,6,73,6,8,-2
18,6,74,11,12,-1
18,6,75,9,14,-5
18,6,76,5,26,-21
18,6,77,14,16,-2
18,6,78,14,24,-10
18,6,79,7,6,1
18,6,80,5,15,-10
18,6,81,7,11,-4
18,6,82,9,7,2
18,6,83,8,22,-14
18,6,84,18,21,-3
18,6,85,4,20,-16
18,6,86,8,15,-7
18,6,87,15,19,-4
18,6,88,13,16,-3
18,6,89,5,8,-3
18,6,90,10,6,4
18,6,91,5,12,-7
18,6,92,16,42,-26
18,6,93,13,26,-13
18,6,94,10,17,-7
18,6,95,8,18,-10
18,6,96,6,17,-11
18,6,97,8,13,-5
18,6,98,9,24,-15
18,6,99,6,19,-13
18,6,100,6,15,-9
18,6,101,19,21,-2
18,6,102,8,8,0
18,6,103,14,29,-15
18,6,104,7,27,-20
18,6,105,11,23,-12
18,6,106,13,20,-7
18,6,107,3,14,-11
18,6,108,7,8,-1
18,6,109,12,28,-16
18,6,110,17,15,2
18,6,111,8,14,-6
18,6,112,15,22,-7
18,6,113,17,28,-11
18,6,114,13,10,3
18,6,115,18,15,3
18,6,116,13,26,-13
18,6,117,8,11,-3
18,6,118,3,13,-10
18,6,119,7,24,-17
18,6,120,4,22,-18
18,6,121,9,19,-10
18,6,122,11,13,-2
18,6,123,13,25,-12
18,6,124,14,18,-4
18,6,125,15,16,-1
18,6,126,8,27,-19
18,6,127,10,13,-3
18,6,128,10,27,-17
18,6,129,6,12,-6
18,6,130,7,22,-15
18,6,131,10,17,-7
18,6,132,21,24,-3
18,6,133,7,14,-7
18,6,134,11,10,1
18,6,135,10,33,-23
18,6,136,17,25,-8
18,6,137,11,13,-2
18,6,138,6,21,-15
18,6,139,14,15,-1
18,6,140,22,23,-1
18,6,141,5,18,-13
18,6,142,10,23,-13
18,6,143,11,16,-5
18,6,144,18,16,2
18,6,145,15,18,-3
18,6,146,5,8,-3
18,6,147,25,17,8
18,6,148,8,7,1
18,6,149,7,22,-15
18,6,150,15,23,-8
18,6,151,27,17,10
18,6,152,13,13,0
18,6,153,4,22,-18
18,6,154,11,28,-17
18,6,155,9,13,-4
18,6,156,11,11,0
18,6,157,8,18,-10
18,6,158,4,13,-9
18,6,159,7,2,5
18,6,160,11,9,2
18,6,161,8,13,-5
18,6,162,17,21,-4
18,6,163,12,15,-3
18,6,164,17,23,-6
18,6,165,11,10,1
18,6,166,12,13,-1
18,6,167,12,20,-8
18,6,168,13,20,-7
18,6,169,14,34,-20
18,6,170,5,14,-9
18,6,171,10,6,4
18,6,172,14,6,8
18,6,173,7,31,-24
18,6,174,7,12,-5
18,6,175,5,13,-8
18,6,176,17,19,-2
18,6,177,12,22,-10
18,6,178,7,19,-12
18,6,179,7,13,-6
18,6,180,12,19,-7
18,6,181,8,24,-16
18,6,182,12,17,-5
18,6,183,1,22,-21
18,6,184,11,19,-8
18,6,185,6,6,0
18,6,186,13,24,-11
18,6,187,21,19,2
18,6,188,14,17,-3
18,6,189,10,24,-14
18,6,190,13,39,-26
18,6,191,7,7,0
18,6,192,6,8,-2
18,6,193,10,17,-7
18,6,194,11,26,-15
18,6,195,11,25,-14
18,6,196,14,16,-2
18,6,197,7,19,-12
18,6,198,15,33,-18
18,6,199,11,13,-2
18,6,200,11,18,-7
18,6,201,9,18,-9
18,6,202,16,19,-3
18,6,203,15,40,-25
18,6,204,24,17,7
18,6,205,17,27,-10
18,6,206,10,23,-13
18,6,207,17,10,7
18,6,208,5,13,-8
18,6,209,8,11,-3
18,6,210,6,23,-17
18,6,211,8,17,-9
18,6,212,8,11,-3
18,6,213,12,31,-19
18,6,214,10,11,-1
18,6,215,13,20,-7
18,6,216,14,16,-2
18,6,217,9,17,-8
18,6,218,10,12,-2
18,6,219,17,19,-2
18,6,220,8,23,-15
18,6,221,12,16,-4
18,6,222,10,10,0
18,6,223,12,13,-1
18,6,224,9,9,0
18,6,225,8,8,0
18,6,226,20,13,7
18,6,227,10,17,-7
18,6,228,11,15,-4
18,6,229,7,19,-12
18,6,230,12,10,2
18,6,231,14,15,-1
18,6,232,10,21,-11
18,6,233,11,18,-7
18,6,234,11,16,-5
18,6,235,14,15,-1
18,6,236,7,17,-10
18,6,237,10,10,0
18,6,238,7,26,-19
18,6,239,13,21,-8
18,6,240,10,12,-2
18,6,241,17,33,-16
18,6,242,5,24,-19
18,6,243,16,25,-9
18,6,244,11,16,-5
18,6,245,6,17,-11
18,6,246,10,17,-7
18,6,247,19,21,-2
18,6,248,8,14,-6
18,6,249,13,21,-8
18,6,250,18,35,-17
18,6,251,7,30,-23
18,6,252,8,20,-12
18,6,253,17,17,0
18,6,254,20,22,-2
18,6,255,7,23,-16
18,6,256,12,32,-20
18,6,257,9,20,-11
18,6,258,15,13,2
18,6,259,15,26,-11
18,6,260,11,32,-21
18,6,261,10,12,-2
18,6,262,14,15,-1
18,6,263,5,14,-9
18,6,264,21,13,8
18,6,265,7,21,-14
18,6,266,17,13,4
18,6,267,20,16,4
18,6,268,7,14,-7
18,6,269,6,12,-6
18,6,270,15,27,-12
18,6,271,13,26,-13
18,6,272,4,13,-9
18,6,273,7,24,-17
18,6,274,7,22,-15
18,6,275,18,31,-13
18,6,276,12,30,-18
18,6,277,7,21,-14
18,6,278,15,27,-12
18,6,279,2,11,-9
18,6,280,9,29,-20
18,6,281,9,22,-13
18,6,282,12,34,-22
18,6,283,3,23,-20
18,6,284,8,15,-7
18,6,285,4,11,-7
18,6,286,15,30,-15
18,6,287,9,24,-15
18,6,288,12,23,-11
18,6,289,11,12,-1
18,6,290,11,15,-4
18,6,291,13,16,-3
18,6,292,4,22,-18
18,6,293,14,16,-2
18,6,294,16,24,-8
18,6,295,12,16,-4
18,6,296,17,12,5
18,6,297,6,14,-8
18,6,298,12,10,2
18,6,299,18,36,-18
18,7,0,10,11,-1
18,7,1,20,33,-13
18,7,2,10,14,-4
18,7,3,2,8,-6
18,7,4,10,17,-7
18,7,5,10,22,-12
18,7,6,4,28,-24
18,7,7,12,15,-3
18,7,8,11,25,-14
18,7,9,11,20,-9
18,7,10,12,18,-6
18,7,11,10,17,-7
18,7,12,4,17,-13
18,7,13,21,27,-6
18,7,14,10,16,-6
18,7,15,11,33,-22
18,7,16,24,16,8
18,7,17,9,12,-3
18,7,18,5,13,-8
18,7,19,16,25,-9
18,7,20,18,18,0
18,7,21,6,19,-13
18,7,22,12,31,-19
18,7,23,15,8,7
18,7,24,8,17,-9
18,7,25,14,28,-14
18,7,26,7,13,-6
18,7,27,13,6,7
18,7,28,5,25,-20
18,7,29,12,28,-16
18,7,30,12,22,-10
18,7,31,14,27,-13
18,7,32,4,11,-7
18,7,33,17,25,-8
18,7,34,6,14,-8
18,7,35,19,30,-11
18,7,36,8,18,-10
18,7,37,6,19,-13
18,7,38,10,16,-6
18,7,39,10,20,-10
18,7,40,6,28,-22
18,7,41,13,21,-8
18,7,42,18,14,4
18,7,43,19,25,-6
18,7,44,17,7,10
18,7,45,12,8,4
18,7,46,9,16,-7
18,7,47,17,24,-7
18,7,48,6,20,-14
18,7,49,13,14,-1
18,7,50,11,6,5
18,7,51,4,11,-7
18,7,52,14,19,-5
18,7,53,11,25,-14
18,7,54,8,22,-14
18,7,55,10,41,-31
18,7,56,12,22,-10
18,7,57,7,16,-9
18,7,58,4,14,-10
18,7,59,4,12,-8
18,7,60,19,17,2
18,7,61,11,32,-21
18,7,62,13,11,2
18,7,63,17,15,2
18,7,64,16,35,-19
18,7,65,10,29,-19
18,7,66,12,20,-8
18,7,67,8,18,-10
18,7,68,16,9,7
18,7,69,18,22,-4
18,7,70,8,8,0
18,7,71,9,17,-8
18,7,72,6,7,-1
18,7,73,15,20,-5
18,7,74,16,24,-8
18,7,75,7,11,-4
18,7,76,12,12,0
18,7,77,13,22,-9
18,7,78,13,10,3
18,7,79,10,21,-11
18,7,80,5,13,-8
18,7,81,11,17,-6
18,7,82,10,22,-12
18,7,83,10,9,1
18,7,84,14,8,6
18,7,85,14,21,-7
18,7,86,7,34,-27
18,7,87,17,19,-2
18,7,88,25,29,-4
18,7,89,13,15,-2
18,7,90,15,14,1
18,7,91,14,16,-2
18,7,92,11,17,-6
18,7,93,6,13,-7
18,7,94,8,12,-4
18,7,95,16,21,-5
18,7,96,16,26,-10
18,7,97,9,29,-20
18,7,98,16,14,2
18,7,99,10,16,-6
18,7,100,16,19,-3
18,7,101,9,23,-14
18,7,102,11,28,-17
18,7,103,13,20,-7
18,7,104,17,20,-3
18,7,105,11,17,-6
18,7,106,20,16,4
18,7,107,10,5,5
18,7,108,11,23,-12
18,7,109,16,25,-9
18,7,110,5,17,-12
18,7,111,17,36,-19
18,7,112,19,23,-4
18,7,113,13,39,-26
18,7,114,4,12,-8
18,7,115,13,9,4
18,7,116,12,18,-6
18,7,117,14,10,4
18,7,118,12,23,-11
18,7,119,18,14,4
18,7,120,9,15,-6
18,7,121,14,31,-17
18,7,122,9,22,-13
18,7,123,20,21,-1
18,7,124,19,17,2
18,7,125,11,25,-14
18,7,126,13,23,-10
18,7,127,13,10,3
18,7,128,6,28,-22
18,7,129,18,16,2
18,7,130,19,19,0
18,7,131,7,17,-10
18,7,132,10,8,2
18,7,133,9,24,-15
18,7,134,9,22,-13
18,7,135,7,9,-2
18,7,136,11,12,-1
18,7,137,7,26,-19
18,7,138,10,17,-7
18,7,139,17,35,-18
18,7,140,8,21,-13
18,7,141,13,24,-11
18,7,142,5,17,-12
18,7,143,4,8,-4
18,7,144,7,26,-19
18,7,145,10,22,-12
18,7,146,15,26,-11
18,7,147,14,16,-2
18,7,148,8,22,-14
18,7,149,16,17,-1
18,7,150,18,10,8
18,7,151,9,17,-8
18,7,152,20,23,-3
18,7,153,8,27,-19
18,7,154,25,18,7
18,7,155,13,19,-6
18,7,156,11,8,3
18,7,157,5,14,-9
18,7,158,8,11,-3
18,7,159,12,28,-16
18,7,160,16,22,-6
18,7,161,19,18,1
18,7,162,10,13,-3
18,7,163,18,22,-4
18,7,164,17,19,-2
18,7,165,9,23,-14
18,7,166,13,16,-3
18,7,167,12,32,-20
18,7,168,21,38,-17
18,7,169,13,26,-13
18,7,170,11,14,-3
18,7,171,13,17,-4
18,7,172,9,26,-17
18,7,173,8,23,-15
18,7,174,17,13,4
18,7,175,5,4,1
18,7,176,10,15,-5
18,7,177,14,21,-7
18,7,178,12,17,-5
18,7,179,15,19,-4
18,7,180,9,13,-4
18,7,181,9,5,4
18,7,182,12,25,-13
18,7,183,9,15,-6
18,7,184,14,20,-6
18,7,185,6,22,-16
18,7,186,15,20,-5
18,7,187,6,13,-7
18,7,188,10,6,4
18,7,189,13,21,-8
18,7,190,19,23,-4
18,7,191,17,18,-1
18,7,192,16,26,-10
18,7,193,8,17,-9
18,7,194,16,17,-1
18,7,195,20,24,-4
18,7,196,11,13,-2
18,7,197,27,23,4
18,7,198,15,34,-19
18,7,199,10,12,-2
18,7,200,11,17,-6
18,7,201,22,28,-6
18,7,202,9,17,-8
18,7,203,21,24,-3
18,7,204,14,27,-13
18,7,205,17,22,-5
18,7,206,12,19,-7
18,7,207,10,20,-10
18,7,208,7,15,-8
18,7,209,10,19,-9
18,7,210,5,20,-15
18,7,211,13,20,-7
18,7,212,19,24,-5
18,7,213,9,21,-12
18,7,214,18,26,-8
18,7,215,13,18,-5
18,7,216,22,12,10
18,7,217,18,22,-4
18,7,218,7,21,-14
18,7,219,15,24,-9
18,7,220,14,30,-16
18,7,221,13,15,-2
18,7,222,16,17,-1
18,7,223,12,16,-4
18,7,224,5,11,-6
18,7,225,3,16,-13
18,7,226,11,16,-5
18,7,227,8,22,-14
18,7,228,10,25,-15
18,7,229,19,26,-7
18,7,230,15,17,-2
18,7,231,15,15,0
18,7,232,5,9,-4
18,7,233,9,15,-6
18,7,234,6,27,-21
18,7,235,10,27,-17
18,7,236,11,22,-11
18,7,237,15,14,1
18,7,238,6,20,-14
18,7,239,7,17,-10
18,7,240,8,15,-7
18,7,241,12,14,-2
18,7,242,14,26,-12
18,7,243,6,20,-14
18,7,244,14,14,0
18,7,245,34,16,18
18,7,246,14,12,2
18,7,247,6,21,-15
18,7,248,16,22,-6
18,7,249,13,28,-15
18,7,250,11,11,0
18,7,251,12,15,-3
18,7,252,12,9,3
18,7,253,7,10,-3
18,7,254,13,15,-2
18,7,255,9,26,-17
18,7,256,13,17,-4
18,7,257,10,21,-11
18,7,258,9,26,-17
18,7,259,16,16,0
18,7,260,11,7,4
18,7,261,18,18,0
18,7,262,16,22,-6
18,7,263,18,26,-8
18,7,264,8,22,-14
18,7,265,3,14,-11
18,7,266,13,22,-9
18,7,267,9,24,-15
18,7,268,10,21,-11
18,7,269,8,22,-14
18,7,270,12,6,6
18,7,271,13,9,4
18,7,272,7,24,-17
18,7,273,9,25,-16
18,7,274,11,28,-17
18,7,275,5,30,-25
18,7,276,9,13,-4
18,7,277,14,25,-11
18,7,278,7,17,-10
18,7,279,21,38,-17
18,7,280,13,15,-2
18,7,281,12,25,-13
18,7,282,10,19,-9
18,7,283,12,18,-6
18,7,284,10,15,-5
18,7,285,28,25,3
18,7,286,10,18,-8
18,7,287,11,26,-15
18,7,288,6,19,-13
18,7,289,9,20,-11
18,7,290,11,14,-3
18,7,291,10,17,-7
18,7,292,10,13,-3
18,7,293,18,33,-15
18,7,294,6,21,-15
18,7,295,17,22,-5
18,7,296,17,12,5
18,7,297,18,16,2
18,7,298,7,13,-6
18,7,299,9,17,-8
18,8,0,13,10,3
18,8,1,14,16,-2
18,8,2,13,18,-5
18,8,3,19,17,2
18,8,4,17,22,-5
18,8,5,11,15,-4
18,8,6,15,23,-8
18,8,7,16,19,-3
18,8,8,11,14,-3
18,8,9,4,18,-14
18,8,10,21,23,-2
18,8,11,6,17,-11
18,8,12,8,20,-12
18,8,13,7,17,-10
18,8,14,12,22,-10
18,8,15,11,20,-9
18,8,16,12,32,-20
18,8,17,10,10,0
18,8,18,18,19,-1
18,8,19,3,18,-15
18,8,20,6,23,-17
18,8,21,4,32,-28
18,8,22,6,12,-6
18,8,23,8,22,-14
18,8,24,16,22,-6
18,8,25,6,35,-29
18,8,26,5,22,-17
18,8,27,5,17,-12
18,8,28,8,13,-5
18,8,29,9,18,-9
18,8,30,18,16,2
18,8,31,10,17,-7
18,8,32,13,19,-6
18,8,33,9,35,-26
18,8,34,16,16,0
18,8,35,14,16,-2
18,8,36,12,16,-4
18,8,37,12,25,-13
18,8,38,13,31,-18
18,8,39,15,28,-13
18,8,40,16,30,-14
18,8,41,14,12,2
18,8,42,18,17,1
18,8,43,5,11,-6
18,8,44,17,18,-1
18,8,45,7,18,-11
18,8,46,3,4,-1
18,8,47,11,24,-13
18,8,48,3,14,-11
18,8,49,18,20,-2
18,8,50,10,20,-10
18,8,51,22,29,-7
18,8,52,15,16,-1
18,8,53,10,15,-5
18,8,54,14,21,-7
18,8,55,9,45,-36
18,8,56,21,21,0
18,8,57,10,21,-11
18,8,58,10,11,-1
18,8,59,12,29,-17
18,8,60,18,29,-11
18,8,61,18,17,1
18,8,62,7,16,-9
18,8,63,24,18,6
18,8,64,18,17,1
18,8,65,7,34,-27
18,8,66,15,13,2
18,8,67,9,11,-2
18,8,68,9,14,-5
18,8,69,7,17,-10
18,8,70,6,10,-4
18,8,71,17,20,-3
18,8,72,17,31,-14
18,8,73,13,22,-9
18,8,74,8,16,-8
18,8,75,25,10,15
18,8,76,18,24,-6
18,8,77,6,19,-13
18,8,78,18,27,-9
18,8,79,7,7,0
18,8,80,11,24,-13
18,8,81,12,25,-13
18,8,82,12,18,-6
18,8,83,19,23,-4
18,8,84,12,24,-12
18,8,85,9,22,-13
18,8,86,6,18,-12
18,8,87,11,16,-5
18,8,88,13,18,-5
18,8,89,10,17,-7
18,8,90,7,14,-7
18,8,91,3,15,-12
18,8,92,10,44,-34
18,8,93,15,20,-5
18,8,94,18,27,-9
18,8,95,14,14,0
18,8,96,12,18,-6
18,8,97,9,21,-12
18,8,98,6,14,-8
18,8,99,13,19,-6
18,8,100,15,36,-21
18,8,101,15,29,-14
18,8,102,14,25,-11
18,8,103,14,26,-12
18,8,104,19,20,-1
18,8,105,3,12,-9
18,8,106,17,19,-2
18,8,107,10,17,-7
18,8,108,9,16,-7
18,8,109,9,12,-3
18,8,110,5,12,-7
18,8,111,11,17,-6
18,8,112,14,33,-19
18,8,113,22,29,-7
18,8,114,15,16,-1
18,8,115,3,18,-15
18,8,116,8,17,-9
18,8,117,2,8,-6
18,8,118,10,18,-8
18,8,119,14,6,8
18,8,120,19,13,6
18,8,121,10,24,-14
18,8,122,9,12,-3
18,8,123,5,15,-10
18,8,124,8,17,-9
18,8,125,11,17,-6
18,8,126,7,25,-18
18,8,127,9,18,-9
18,8,128,11,19,-8
18,8,129,14,18,-4
18,8,130,13,24,-11
18,8,131,8,23,-15
18,8,132,14,10,4
18,8,133,13,13,0
18,8,134,4,9,-5
18,8,135,18,17,1
18,8,136,7,17,-10
18,8,137,6,14,-8
18,8,138,12,19,-7
18,8,139,19,23,-4
18,8,140,8,7,1
18,8,141,21,21,0
18,8,142,9,14,-5
18,8,143,12,18,-6
18,8,144,11,17,-6
18,8,145,10,22,-12
18,8,146,11,19,-8
18,8,147,7,12,-5
18,8,148,13,13,0
18,8,149,7,16,-9
18,8,150,13,27,-14
18,8,151,19,25,-6
18,8,152,8,23,-15
18,8,153,8,22,-14
18,8,154,10,17,-7
18,8,155,20,13,7
18,8,156,13,23,-10
18,8,157,14,43,-29
18,8,158,10,17,-7
18,8,159,9,20,-11
18,8,160,10,11,-1
18,8,161,19,20,-1
18,8,162,10,17,-7
18,8,163,6,29,-23
18,8,164,17,25,-8
18,8,165,10,11,-1
18,8,166,11,17,-6
18,8,167,14,28,-14
18,8,168,11,4,7
18,8,169,9,16,-7
18,8,170,6,22,-16
18,8,171,12,14,-2
18,8,172,7,29,-22
18,8,173,5,18,-13
18,8,174,9,15,-6
18,8,175,4,20,-16
18,8,176,13,12,1
18,8,177,6,8,-2
18,8,178,8,21,-13
18,8,179,14,10,4
18,8,180,16,11,5
18,8,181,7,9,-2
18,8,182,6,15,-9
18,8,183,4,5,-1
18,8,184,18,19,-1
18,8,185,19,22,-3
18,8,186,17,22,-5
18,8,187,16,13,3
18,8,188,20,34,-14
18,8,189,9,25,-16
18,8,190,10,18,-8
18,8,191,23,28,-5
18,8,192,17,13,4
18,8,193,14,30,-16
18,8,194,8,11,-3
18,8,195,10,25,-15
18,8,196,19,17,2
18,8,197,13,28,-15
18,8,198,16,17,-1
18,8,199,13,14,-1
18,8,200,11,22,-11
18,8,201,7,14,-7
18,8,202,11,16,-5
18,8,203,15,18,-3
18,8,204,10,10,0
18,8,205,17,35,-18
18,8,206,16,30,-14
18,8,207,17,16,1
18,8,208,4,13,-9
18,8,209,20,17,3
18,8,210,16,16,0
18,8,211,8,14,-6
18,8,212,3,24,-21
18,8,213,15,13,2
18,8,214,9,17,-8
18,8,215,15,14,1
18,8,216,10,19,-9
18,8,217,20,27,-7
18,8,218,16,30,-14
18,8,219,9,25,-16
18,8,220,12,21,-9
18,8,221,18,20,-2
18,8,222,10,17,-7
18,8,223,17,18,-1
18,8,224,12,17,-5
18,8,225,17,15,2
18,8,226,11,20,-9
18,8,227,8,8,0
18,8,228,8,7,1
18,8,229,8,8,0
18,8,230,7,21,-14
18,8,231,11,13,-2
18,8,232,14,16,-2
18,8,233,24,21,3
18,8,234,9,31,-22
18,8,235,8,25,-17
18,8,236,9,11,-2
18,8,237,8,15,-7
18,8,238,7,8,-1
18,8,239,10,17,-7
18,8,240,13,16,-3
18,8,241,10,19,-9
18,8,242,13,16,-3
18,8,243,13,24,-11
18,8,244,16,24,-8
18,8,245,11,12,-1
18,8,246,10,21,-11
18,8,247,10,12,-2
18,8,248,14,19,-5
18,8,249,8,14,-6
18,8,250,5,9,-4
18,8,251,23,12,11
18,8,252,12,13,-1
18,8,253,8,23,-15
18,8,254,13,22,-9
18,8,255,12,17,-5
18,8,256,6,9,-3
18,8,257,16,35,-19
18,8,258,16,34,-18
18,8,259,8,7,1
18,8,260,9,6,3
18,8,261,16,15,1
18,8,262,16,14,2
18,8,263,21,19,2
18,8,264,14,33,-19
18,8,265,12,17,-5
18,8,266,13,22,-9
18,8,267,10,18,-8
18,8,268,13,22,-9
18,8,269,13,20,-7
18,8,270,5,26,-21
18,8,271,4,14,-10
18,8,272,12,12,0
18,8,273,6,44,-38
18,8,274,15,15,0
18,8,275,8,18,-10
18,8,276,12,5,7
18,8,277,17,27,-10
18,8,278,7,12,-5
18,8,279,11,14,-3
18,8,280,18,14,4
18,8,281,9,24,-15
18,8,282,15,22,-7
18,8,283,13,21,-8
18,8,284,19,24,-5
18,8,285,10,18,-8
18,8,286,11,15,-4
18,8,287,14,15,-1
18,8,288,10,21,-11
18,8,289,9,15,-6
18,8,290,21,22,-1
18,8,291,8,29,-21
18,8,292,12,17,-5
18,8,293,11,29,-18
18,8,294,14,11,3
18,8,295,9,15,-6
18,8,296,4,9,-5
18,8,297,8,18,-10
18,8,298,21,19,2
18,8,299,13,19,-6
18,9,0,11,32,-21
18,9,1,8,10,-2
18,9,2,9,13,-4
18,9,3,19,15,4
18,9,4,12,23,-11
18,9,5,13,28,-15
18,9,6,17,26,-9
18,9,7,6,8,-2
18,9,8,4,18,-14
18,9,9,10,16,-6
18,9,10,13,13,0
18,9,11,10,16,-6
18,9,12,9,18,-9
18,9,13,15,31,-16
18,9,14,10,23,-13
18,9,15,7,19,-12
18,9,16,12,31,-19
18,9,17,11,28,-17
18,9,18,16,15,1
18,9,19,10,22,-12
18,9,20,11,9,2
18,9,21,1,9,-8
18,9,22,1,6,-5
18,9,23,17,27,-10
18,9,24,7,28,-21
18,9,25,8,10,-2
18,9,26,9,8,1
18,9,27,9,14,-5
18,9,28,4,13,-9
18,9,29,12,29,-17
18,9,30,10,16,-6
18,9,31,9,13,-4
18,9,32,13,14,-1
18,9,33,10,16,-6
18,9,34,9,17,-8
18,9,35,12,16,-4
18,9,36,10,15,-5
18,9,37,18,38,-20
18,9,38,8,12,-4
18,9,39,7,10,-3
18,9,40,13,8,5
18,9,41,14,15,-1
18,9,42,14,24,-10
18,9,43,4,15,-11
18,9,44,12,23,-11
18,9,45,9,16,-7
18,9,46,8,29,-21
18,9,47,12,19,-7
18,9,48,15,18,-3
18,9,49,7,24,-17
18,9,50,18,33,-15
18,9,51,12,13,-1
18,9,52,10,15,-5
18,9,53,11,13,-2
18,9,54,4,14,-10
18,9,55,7,14,-7
18,9,56,8,18,-10
18,9,57,15,17,-2
18,9,58,11,15,-4
18,9,59,15,22,-7
18,9,60,11,15,-4
18,9,61,10,26,-16
18,9,62,5,7,-2
18,9,63,20,23,-3
18,9,64,14,20,-6
18,9,65,7,12,-5
18,9,66,10,12,-2
18,9,67,6,9,-3
18,9,68,9,19,-10
18,9,69,18,15,3
18,9,70,17,23,-6
18,9,71,13,26,-13
18,9,72,13,10,3
18,9,73,4,12,-8
18,9,74,14,18,-4
18,9,75,4,17,-13
18,9,76,14,13,1
18,9,77,4,15,-11
18,9,78,18,16,2
18,9,79,17,20,-3
18,9,80,9,20,-11
18,9,81,5,15,-10
18,9,82,5,20,-15
18,9,83,12,14,-2
18,9,84,6,14,-8
18,9,85,14,22,-8
18,9,86,6,16,-10
18,9,87,16,23,-7
18,9,88,2,17,-15
18,9,89,19,20,-1
18,9,90,17,29,-12
18,9,91,8,12,-4
18,9,92,8,17,-9
18,9,93,11,20,-9
18,9,94,8,26,-18
18,9,95,11,39,-28
18,9,96,16,18,-2
18,9,97,13,22,-9
18,9,98,9,26,-17
18,9,99,12,23,-11
18,9,100,10,7,3
18,9,101,3,19,-16
18,9,102,8,15,-7
18,9,103,10,32,-22
18,9,104,14,19,-5
18,9,105,9,20,-11
18,9,106,25,8,17
18,9,107,8,2,6
18,9,108,7,20,-13
18,9,109,10,19,-9
18,9,110,3,6,-3
18,9,111,9,30,-21
18,9,112,18,19,-1
18,9,113,15,10,5
18,9,114,17,20,-3
18,9,115,12,13,-1
18,9,116,9,25,-16
18,9,117,4,13,-9
18,9,118,11,27,-16
18,9,119,17,18,-1
18,9,120,16,29,-13
18,9,121,8,23,-15
18,9,122,19,22,-3
18,9,123,12,29,-17
18,9,124,21,25,-4
18,9,125,17,26,-9
18,9,126,20,18,2
18,9,127,12,23,-11
18,9,128,18,19,-1
18,9,129,8,10,-2
18,9,130,17,29,-12
18,9,131,14,19,-5
18,9,132,13,13,0
18,9,133,13,14,-1
18,9,134,11,14,-3
18,9,135,11,19,-8
18,9,136,15,18,-3
18,9,137,5,12,-7
18,9,138,19,24,-5
18,9,139,9,11,-2
18,9,140,19,14,5
18,9,141,17,24,-7
18,9,142,12,17,-5
18,9,143,4,18,-14
18,9,144,16,22,-6
18,9,145,15,14,1
18,9,146,6,14,-8
18,9,147,22,17,5
18,9,148,7,17,-10
18,9,149,5,6,-1
18,9,150,18,19,-1
18,9,151,17,30,-13
18,9,152,6,16,-10
18,9,153,10,17,-7
18,9,154,7,20,-13
18,9,155,17,28,-11
18,9,156,8,10,-2
18,9,157,5,16,-11
18,9,158,5,14,-9
18,9,159,12,27,-15
18,9,160,18,34,-16
18,9,161,13,21,-8
18,9,162,15,24,-9
18,9,163,11,17,-6
18,9,164,14,13,1
18,9,165,16,13,3
18,9,166,24,19,5
18,9,167,18,15,3
18,9,168,16,32,-16
18,9,169,12,11,1
18,9,170,4,14,-10
18,9,171,8,9,-1
18,9,172,4,13,-9
18,9,173,13,22,-9
18,9,174,16,10,6
18,9,175,12,27,-15
18,9,176,8,5,3
18,9,177,21,25,-4
18,9,178,10,16,-6
18,9,179,8,18,-10
18,9,180,7,15,-8
18,9,181,22,26,-4
18,9,182,18,29,-11
18,9,183,13,23,-10
18,9,184,14,17,-3
18,9,185,14,18,-4
18,9,186,12,23,-11
18,9,187,7,17,-10
18,9,188,4,26,-22
18,9,189,7,13,-6
18,9,190,5,17,-12
18,9,191,10,19,-9
18,9,192,18,14,4
18,9,193,14,8,6
18,9,194,13,24,-11
18,9,195,17,18,-1
18,9,196,11,14,-3
18,9,197,15,10,5
18,9,198,24,20,4
18,9,199,22,16,6
18,9,200,8,28,-20
18,9,201,1,14,-13
18,9,202,16,22,-6
18,9,203,16,11,5
18,9,204,14,29,-15
18,9,205,10,8,2
18,9,206,8,19,-11
18,9,207,7,14,-7
18,9,208,11,14,-3
18,9,209,15,16,-1
18,9,210,11,19,-8
18,9,211,17,24,-7
18,9,212,19,15,4
18,9,213,18,20,-2
18,9,214,10,9,1
18,9,215,20,10,10
18,9,216,9,16,-7
18,9,217,23,25,-2
18,9,218,7,22,-15
18,9,219,19,21,-2
18,9,220,12,24,-12
18,9,221,19,23,-4
18,9,222,5,21,-16
18,9,223,16,17,-1
18,9,224,7,25,-18
18,9,225,15,18,-3
18,9,226,20,22,-2
18,9,227,12,24,-12
18,9,228,28,16,12
18,9,229,17,17,0
18,9,230,9,24,-15
18,9,231,8,20,-12
18,9,232,21,28,-7
18,9,233,3,18,-15
18,9,234,7,15,-8
18,9,235,3,11,-8
18,9,236,18,39,-21
18,9,237,25,10,15
18,9,238,16,28,-12
18,9,239,7,32,-25
18,9,240,15,39,-24
18,9,241,10,20,-10
18,9,242,15,24,-9
18,9,243,16,28,-12
18,9,244,5,25,-20
18,9,245,13,22,-9
18,9,246,4,16,-12
18,9,247,17,26,-9
18,9,248,13,16,-3
18,9,249,16,25,-9
18,9,250,13,19,-6
18,9,251,11,13,-2
18,9,252,13,17,-4
18,9,253,13,20,-7
18,9,254,11,15,-4
18,9,255,19,16,3
18,9,256,13,21,-8
18,9,257,17,17,0
18,9,258,10,9,1
18,9,259,15,12,3
18,9,260,20,16,4
18,9,261,6,14,-8
18,9,262,11,28,-17
18,9,263,10,18,-8
18,9,264,10,26,-16
18,9,265,9,21,-12
18,9,266,9,13,-4
18,9,267,17,28,-11
18,9,268,12,12,0
18,9,269,7,26,-19
18,9,270,11,15,-4
18,9,271,17,8,9
18,9,272,20,9,11
18,9,273,18,8,10
18,9,274,1,13,-12
18,9,275,10,10,0
18,9,276,21,28,-7
18,9,277,7,15,-8
18,9,278,12,14,-2
18,9,279,19,23,-4
18,9,280,15,30,-15
18,9,281,13,22,-9
18,9,282,13,20,-7
18,9,283,18,14,4
18,9,284,15,13,2
18,9,285,21,29,-8
18,9,286,13,20,-7
18,9,287,20,19,1
18,9,288,19,29,-10
18,9,289,11,18,-7
18,9,290,6,18,-12
18,9,291,6,16,-10
18,9,292,9,9,0
18,9,293,12,10,2
18,9,294,20,17,3
18,9,295,9,47,-38
18,9,296,9,21,-12
18,9,297,8,7,1
18,9,298,18,28,-10
18,9,299,11,9,2
18,10,0,15,16,-1
18,10,1,16,14,2
18,10,2,15,34,-19
18,10,3,15,21,-6
18,10,4,10,9,1
18,10,5,14,12,2
18,10,6,8,5,3
18,10,7,14,29,-15
18,10,8,18,26,-8
18,10,9,6,22,-16
18,10,10,3,30,-27
18,10,11,11,17,-6
18,10,12,13,11,2
18,10,13,9,10,-1
18,10,14,22,23,-1
18,10,15,18,14,4
18,10,16,8,22,-14
18,10,17,6,27,-21
18,10,18,23,29,-6
18,10,19,9,10,-1
18,10,20,16,19,-3
18,10,21,16,24,-8
18,10,22,11,24,-13
18,10,23,19,20,-1
18,10,24,15,41,-26
18,10,25,10,18,-8
18,10,26,11,10,1
18,10,27,12,21,-9
18,10,28,13,33,-20
18,10,29,18,25,-7
18,10,30,20,33,-13
18,10,31,18,15,3
18,10,32,16,13,3
18,10,33,16,30,-14
18,10,34,24,33,-9
18,10,35,12,36,-24
18,10,36,17,34,-17
18,10,37,16,11,5
18,10,38,10,19,-9
18,10,39,9,9,0
18,10,40,12,15,-3
18,10,41,12,25,-13
18,10,42,11,12,-1
18,10,43,10,11,-1
18,10,44,10,39,-29
18,10,45,14,15,-1
18,10,46,19,29,-10
18,10,47,8,19,-11
18,10,48,21,26,-5
18,10,49,13,25,-12
18,10,50,8,21,-13
18,10,51,5,15,-10
18,10,52,11,19,-8
18,10,53,21,14,7
18,10,54,11,18,-7
18,10,55,12,23,-11
18,10,56,16,34,-18
18,10,57,5,14,-9
18,10,58,14,35,-21
18,10,59,6,28,-22
18,10,60,11,22,-11
18,10,61,12,21,-9
18,10,62,4,24,-20
18,10,63,4,12,-8
18,10,64,4,11,-7
18,10,65,14,23,-9
18,10,66,5,20,-15
18,10,67,20,11,9
18,10,68,13,22,-9
18,10,69,14,16,-2
18,10,70,11,25,-14
18,10,71,4,14,-10
18,10,72,15,12,3
18,10,73,12,35,-23
18,10,74,9,16,-7
18,10,75,17,20,-3
18,10,76,4,14,-10
18,10,77,5,28,-23
18,10,78,11,14,-3
18,10,79,6,23,-17
18,10,80,7,34,-27
18,10,81,10,15,-5
18,10,82,15,17,-2
18,10,83,12,18,-6
18,10,84,7,18,-11
18,10,85,21,20,1
18,10,86,11,18,-7
18,10,87,8,10,-2
18,10,88,14,35,-21
18,10,89,20,18,2
18,10,90,9,16,-7
18,10,91,12,14,-2
18,10,92,13,24,-11
18,10,93,19,30,-11
18,10,94,9,15,-6
18,10,95,3,3,0
18,10,96,9,13,-4
18,10,97,16,17,-1
18,10,98,8,12,-4
18,10,99,8,26,-18
18,10,100,5,16,-11
18,10,101,4,18,-14
18,10,102,8,23,-15
18,10,103,9,8,1
18,10,104,22,33,-11
18,10,105,10,14,-4
18,10,106,10,26,-16
18,10,107,13,28,-15
18,10,108,21,13,8
18,10,109,10,19,-9
18,10,110,10,21,-11
18,10,111,15,17,-2
18,10,112,11,11,0
18,10,113,2,28,-26
18,10,114,17,16,1
18,10,115,3,18,-15
18,10,116,13,12,1
18,10,117,17,8,9
18,10,118,10,20,-10
18,10,119,9,12,-3
18,10,120,20,8,12
18,10,121,14,23,-9
18,10,122,3,22,-19
18,10,123,11,22,-11
18,10,124,15,22,-7
18,10,125,16,12,4
18,10,126,16,27,-11
18,10,127,15,21,-6
18,10,128,14,24,-10
18,10,129,12,18,-6
18,10,130,19,24,-5
18,10,131,17,18,-1
18,10,132,6,15,-9
18,10,133,7,8,-1
18,10,134,8,7,1
18,10,135,7,29,-22
18,10,136,6,19,-13
18,10,137,5,16,-11
18,10,138,10,24,-14
18,10,139,6,34,-28
18,10,140,16,23,-7
18,10,141,12,14,-2
18,10,142,7,8,-1
18,10,143,11,17,-6
18,10,144,5,2,3
18,10,145,18,21,-3
18,10,146,6,17,-11
18,10,147,13,10,3
18,10,148,4,4,0
18,10,149,10,24,-14
18,10,150,12,8,4
18,10,151,15,25,-10
18,10,152,18,22,-4
18,10,153,14,14,0
18,10,154,11,24,-13
18,10,155,12,20,-8
18,10,156,6,10,-4
18,10,157,0,10,-10
18,10,158,11,16,-5
18,10,159,9,14,-5
18,10,160,11,14,-3
18,10,161,14,12,2
18,10,162,16,19,-3
18,10,163,10,11,-1
18,10,164,17,27,-10
18,10,165,13,12,1
18,10,166,13,12,1
18,10,167,7,14,-7
18,10,168,10,38,-28
18,10,169,22,11,11
18,10,170,0,18,-18
18,10,171,9,10,-1
18,10,172,14,13,1
18,10,173,13,24,-11
18,10,174,16,20,-4
18,10,175,9,21,-12
18,10,176,8,22,-14
18,10,177,20,30,-10
18,10,178,14,16,-2
18,10,179,12,20,-8
18,10,180,15,21,-6
18,10,181,15,25,-10
18,10,182,9,22,-13
18,10,183,11,16,-5
18,10,184,23,9,14
18,10,185,17,15,2
18,10,186,5,14,-9
18,10,187,4,15,-11
18,10,188,9,12,-3
18,10,189,12,12,0
18,10,190,13,23,-10
18,10,191,21,11,10
18,10,192,8,34,-26
18,10,193,20,20,0
18,10,194,17,16,1
18,10,195,15,26,-11
18,10,196,12,6,6
18,10,197,13,18,-5
18,10,198,5,19,-14
18,10,199,15,22,-7
18,10,200,20,19,1
18,10,201,12,18,-6
18,10,202,13,14,-1
18,10,203,21,18,3
18,10,204,14,22,-8
18,10,205,12,13,-1
18,10,206,8,18,-10
18,10,207,23,15,8
18,10,208,9,22,-13
18,10,209,5,21,-16
18,10,210,7,12,-5
18,10,211,17,22,-5
18,10,212,14,7,7
18,10,213,11,19,-8
18,10,214,14,23,-9
18,10,215,13,15,-2
18,10,216,13,19,-6
18,10,217,11,13,-2
18,10,218,15,20,-5
18,10,219,17,9,8
18,10,220,11,21,-10
18,10,221,20,20,0
18,10,222,15,21,-6
18,10,223,6,27,-21
18,10,224,9,13,-4
18,10,225,15,18,-3
18,10,226,7,16,-9
18,10,227,16,17,-1
18,10,228,14,21,-7
18,10,229,9,13,-4
18,10,230,19,21,-2
18,10,231,20,24,-4
18,10,232,8,26,-18
18,10,233,15,19,-4
18,10,234,11,9,2
18,10,235,3,18,-15
18,10,236,16,20,-4
18,10,237,2,13,-11
18,10,238,5,30,-25
18,10,239,10,15,-5
18,10,240,14,14,0
18,10,241,13,16,-3
18,10,242,21,44,-23
18,10,243,20,11,9
18,10,244,11,24,-13
18,10,245,11,10,1
18,10,246,10,18,-8
18,10,247,11,30,-19
18,10,248,11,13,-2
18,10,249,13,23,-10
18,10,250,11,37,-26
18,10,251,16,23,-7
18,10,252,17,25,-8
18,10,253,15,25,-10
18,10,254,12,21,-9
18,10,255,12,22,-10
18,10,256,8,21,-13
18,10,257,10,16,-6
18,10,258,10,27,-17
18,10,259,16,23,-7
18,10,260,16,26,-10
18,10,261,18,15,3
18,10,262,9,20,-11
18,10,263,4,8,-4
18,10,264,18,16,2
18,10,265,7,12,-5
18,10,266,12,10,2
18,10,267,9,26,-17
18,10,268,11,30,-19
18,10,269,15,22,-7
18,10,270,12,27,-15
18,10,271,6,12,-6
18,10,272,11,28,-17
18,10,273,7,27,-20
18,10,274,18,18,0
18,10,275,11,30,-19
18,10,276,15,23,-8
18,10,277,13,9,4
18,10,278,11,12,-1
18,10,279,10,16,-6
18,10,280,14,12,2
18,10,281,7,15,-8
18,10,282,9,31,-22
18,10,283,17,13,4
18,10,284,12,24,-12
18,10,285,16,22,-6
18,10,286,15,30,-15
18,10,287,8,20,-12
18,10,288,18,32,-14
18,10,289,12,13,-1
18,10,290,13,27,-14
18,10,291,13,24,-11
18,10,292,12,8,4
18,10,293,14,30,-16
18,10,294,7,18,-11
18,10,295,3,14,-11
18,10,296,7,25,-18
18,10,297,19,16,3
18,10,298,9,6,3
18,10,299,18,8,10
18,11,0,7,30,-23
18,11,1,21,26,-5
18,11,2,26,19,7
18,11,3,9,16,-7
18,11,4,8,8,0
18,11,5,11,9,2
18,11,6,11,19,-8
18,11,7,11,17,-6
18,11,8,7,5,2
18,11,9,10,9,1
18,11,10,7,16,-9
18,11,11,15,12,3
18,11,12,16,17,-1
18,11,13,21,18,3
18,11,14,19,30,-11
18,11,15,8,12,-4
18,11,16,15,21,-6
18,11,17,11,21,-10
18,11,18,16,24,-8
18,11,19,16,8,8
18,11,20,4,23,-19
18,11,21,10,4,6
18,11,22,11,29,-18
18,11,23,10,15,-5
18,11,24,10,8,2
18,11,25,10,6,4
18,11,26,20,26,-6
18,11,27,20,16,4
18,11,28,9,9,0
18,11,29,3,13,-10
18,11,30,18,19,-1
18,11,31,14,19,-5
18,11,32,19,24,-5
18,11,33,15,26,-11
18,11,34,26,23,3
18,11,35,16,20,-4
18,11,36,16,18,-2
18,11,37,12,9,3
18,11,38,14,14,0
18,11,39,21,19,2
18,11,40,7,18,-11
18,11,41,10,11,-1
18,11,42,12,24,-12
18,11,43,11,19,-8
18,11,44,13,27,-14
18,11,45,19,36,-17
18,11,46,5,16,-11
18,11,47,10,19,-9
18,11,48,19,13,6
18,11,49,11,12,-1
18,11,50,14,16,-2
18,11,51,23,16,7
18,11,52,16,13,3
18,11,53,2,18,-16
18,11,54,24,35,-11
18,11,55,16,9,7
18,11,56,11,14,-3
18,11,57,11,7,4
18,11,58,16,31,-15
18,11,59,22,19,3
18,11,60,12,34,-22
18,11,61,15,12,3
18,11,62,24,14,10
18,11,63,19,14,5
18,11,64,12,13,-1
18,11,65,14,20,-6
18,11,66,22,13,9
18,11,67,14,19,-5
18,11,68,5,10,-5
18,11,69,13,15,-2
18,11,70,15,14,1
18,11,71,14,10,4
18,11,72,15,32,-17
18,11,73,17,11,6
18,11,74,16,12,4
18,11,75,8,23,-15
18,11,76,26,29,-3
18,11,77,15,8,7
18,11,78,8,22,-14
18,11,79,7,10,-3
18,11,80,4,15,-11
18,11,81,11,12,-1
18,11,82,9,15,-6
18,11,83,13,24,-11
18,11,84,14,19,-5
18,11,85,19,13,6
18,11,86,7,13,-6
18,11,87,10,24,-14
18,11,88,13,20,-7
18,11,89,10,33,-23
18,11,90,22,17,5
18,11,91,17,26,-9
18,11,92,9,14,-5
18,11,93,4,18,-14
18,11,94,12,23,-11
18,11,95,13,12,1
18,11,96,11,19,-8
18,11,97,9,22,-13
18,11,98,14,28,-14
18,11,99,13,26,-13
18,11,100,11,15,-4
18,11,101,12,20,-8
18,11,102,14,18,-4
18,11,103,13,25,-12
18,11,104,14,15,-1
18,11,105,16,18,-2
18,11,106,17,20,-3
18,11,107,21,16,5
18,11,108,6,10,-4
18,11,109,12,17,-5
18,11,110,9,13,-4
18,11,111,8,26,-18
18,11,112,16,12,4
18,11,113,11,24,-13
18,11,114,18,21,-3
18,11,115,7,24,-17
18,11,116,13,16,-3
18,11,117,12,23,-11
18,11,118,15,15,0
18,11,119,17,15,2
18,11,120,8,13,-5
18,11,121,19,25,-6
18,11,122,7,21,-14
18,11,123,8,12,-4
18,11,124,13,21,-8
18,11,125,12,19,-7
18,11,126,17,16,1
18,11,127,12,23,-11
18,11,128,7,12,-5
18,11,129,19,29,-10
18,11,130,19,18,1
18,11,131,14,31,-17
18,11,132,9,36,-27
18,11,133,14,20,-6
18,11,134,6,12,-6
18,11,135,10,22,-12
18,11,136,7,14,-7
18,11,137,9,28,-19
18,11,138,12,16,-4
18,11,139,5,15,-10
18,11,140,7,21,-14
18,11,141,17,15,2
18,11,142,11,16,-5
18,11,143,8,17,-9
18,11,144,20,28,-8
18,11,145,18,30,-12
18,11,146,21,26,-5
18,11,147,24,22,2
18,11,148,8,23,-15
18,11,149,22,21,1
18,11,150,21,8,13
18,11,151,9,23,-14
18,11,152,5,7,-2
18,11,153,14,12,2
18,11,154,12,20,-8
18,11,155,13,13,0
18,11,156,20,18,2
18,11,157,8,18,-10
18,11,158,11,20,-9
18,11,159,29,36,-7
18,11,160,10,17,-7
18,11,161,12,18,-6
18,11,162,16,18,-2
18,11,163,19,13,6
18,11,164,30,16,14
18,11,165,5,22,-17
18,11,166,13,16,-3
18,11,167,22,28,-6
18,11,168,9,18,-9
18,11,169,9,22,-13
18,11,170,11,20,-9
18,11,171,15,18,-3
18,11,172,24,19,5
18,11,173,20,20,0
18,11,174,10,19,-9
18,11,175,7,18,-11
18,11,176,16,16,0
18,11,177,5,32,-27
18,11,178,15,22,-7
18,11,179,15,22,-7
18,11,180,23,24,-1
18,11,181,18,14,4
18,11,182,29,31,-2
18,11,183,16,10,6
18,11,184,10,7,3
18,11,185,15,20,-5
18,11,186,14,7,7
18,11,187,18,12,6
18,11,188,6,18,-12
18,11,189,21,19,2
18,11,190,7,8,-1
18,11,191,16,11,5
18,11,192,15,28,-13
18,11,193,8,24,-16
18,11,194,23,12,11
18,11,195,5,19,-14
18,11,196,12,20,-8
18,11,197,7,18,-11
18,11,198,16,20,-4
18,11,199,10,13,-3
18,11,200,16,20,-4
18,11,201,12,23,-11
18,11,202,13,22,-9
18,11,203,16,22,-6
18,11,204,16,21,-5
18,11,205,6,14,-8
18,11,206,10,13,-3
18,11,207,2,12,-10
18,11,208,7,9,-2
18,11,209,16,15,1
18,11,210,6,11,-5
18,11,211,10,25,-15
18,11,212,16,26,-10
18,11,213,7,23,-16
18,11,214,12,15,-3
18,11,215,14,18,-4
18,11,216,19,16,3
18,11,217,4,22,-18
18,11,218,23,23,0
18,11,219,20,16,4
18,11,220,4,13,-9
18,11,221,19,9,10
18,11,222,8,23,-15
18,11,223,21,32,-11
18,11,224,8,13,-5
18,11,225,9,20,-11
18,11,226,11,18,-7
18,11,227,13,18,-5
18,11,228,15,16,-1
18,11,229,15,17,-2
18,11,230,10,7,3
18,11,231,6,19,-13
18,11,232,16,9,7
18,11,233,15,31,-16
18,11,234,9,17,-8
18,11,235,6,22,-16
18,11,236,19,23,-4
18,11,237,4,21,-17
18,11,238,12,18,-6
18,11,239,9,14,-5
18,11,240,12,19,-7
18,11,241,13,37,-24
18,11,242,13,14,-1
18,11,243,20,18,2
18,11,244,12,20,-8
18,11,245,17,26,-9
18,11,246,16,16,0
18,11,247,22,17,5
18,11,248,8,20,-12
18,11,249,12,18,-6
18,11,250,13,19,-6
18,11,251,10,8,2
18,11,252,8,21,-13
18,11,253,10,13,-3
18,11,254,7,15,-8
18,11,255,12,27,-15
18,11,256,16,17,-1
18,11,257,14,22,-8
18,11,258,15,15,0
18,11,259,14,16,-2
18,11,260,12,19,-7
18,11,261,2,11,-9
18,11,262,5,13,-8
18,11,263,5,10,-5
18,11,264,8,15,-7
18,11,265,11,23,-12
18,11,266,19,15,4
18,11,267,8,18,-10
18,11,268,19,9,10
18,11,269,13,37,-24
18,11,270,3,6,-3
18,11,271,12,28,-16
18,11,272,14,14,0
18,11,273,15,17,-2
18,11,274,11,24,-13
18,11,275,22,21,1
18,11,276,9,12,-3
18,11,277,4,11,-7
18,11,278,11,16,-5
18,11,279,12,23,-11
18,11,280,4,10,-6
18,11,281,18,25,-7
18,11,282,4,11,-7
18,11,283,4,17,-13
18,11,284,11,31,-20
18,11,285,9,14,-5
18,11,286,16,18,-2
18,11,287,12,15,-3
18,11,288,8,10,-2
18,11,289,13,16,-3
18,11,290,19,22,-3
18,11,291,12,14,-2
18,11,292,21,15,6
18,11,293,19,22,-3
18,11,294,18,24,-6
18,11,295,18,20,-2
18,11,296,12,14,-2
18,11,297,8,12,-4
18,11,298,11,9,2
18,11,299,13,19,-6
18,12,0,7,12,-5
18,12,1,17,10,7
18,12,2,9,14,-5
18,12,3,15,16,-1
18,12,4,11,23,-12
18,12,5,4,24,-20
18,12,6,21,12,9
18,12,7,14,26,-12
18,12,8,11,4,7
18,12,9,5,12,-7
18,12,10,8,9,-1
18,12,11,14,18,-4
18,12,12,25,12,13
18,12,13,13,36,-23
18,12,14,14,16,-2
18,12,15,23,21,2
18,12,16,12,10,2
18,12,17,12,19,-7
18,12,18,6,6,0
18,12,19,4,15,-11
18,12,20,15,23,-8
18,12,21,11,29,-18
18,12,22,12,18,-6
18,12,23,18,9,9
18,12,24,15,23,-8
18,12,25,11,23,-12
18,12,26,7,21,-14
18,12,27,24,21,3
18,12,28,11,18,-7
18,12,29,9,19,-10
18,12,30,15,16,-1
18,12,31,4,12,-8
18,12,32,14,23,-9
18,12,33,10,18,-8
18,12,34,11,17,-6
18,12,35,19,18,1
18,12,36,19,17,2
18,12,37,9,19,-10
18,12,38,16,17,-1
18,12,39,20,16,4
18,12,40,12,21,-9
18,12,41,7,21,-14
18,12,42,10,9,1
18,12,43,14,22,-8
18,12,44,10,17,-7
18,12,45,31,33,-2
18,12,46,10,10,0
18,12,47,4,18,-14
18,12,48,8,14,-6
18,12,49,13,24,-11
18,12,50,10,10,0
18,12,51,9,14,-5
18,12,52,21,29,-8
18,12,53,3,12,-9
18,12,54,12,17,-5
18,12,55,11,25,-14
18,12,56,9,19,-10
18,12,57,20,19,1
18,12,58,12,34,-22
18,12,59,10,16,-6
18,12,60,20,24,-4
18,12,61,18,29,-11
18,12,62,8,14,-6
18,12,63,8,21,-13
18,12,64,14,19,-5
18,12,65,12,7,5
18,12,66,7,8,-1
18,12,67,12,14,-2
18,12,68,13,13,0
18,12,69,12,11,1
18,12,70,14,13,1
18,12,71,10,26,-16
18,12,72,15,26,-11
18,12,73,18,41,-23
18,12,74,15,20,-5
18,12,75,13,24,-11
18,12,76,10,22,-12
18,12,77,10,19,-9
18,12,78,12,19,-7
18,12,79,12,20,-8
18,12,80,11,12,-1
18,12,81,4,18,-14
18,12,82,13,16,-3
18,12,83,25,24,1
18,12,84,8,16,-8
18,12,85,13,16,-3
18,12,86,20,40,-20
18,12,87,6,20,-14
18,12,88,9,15,-6
18,12,89,17,22,-5
18,12,90,17,12,5
18,12,91,9,9,0
18,12,92,17,13,4
18,12,93,14,23,-9
18,12,94,5,20,-15
18,12,95,12,12,0
18,12,96,8,15,-7
18,12,97,8,6,2
18,12,98,10,20,-10
18,12,99,16,18,-2
18,12,100,18,13,5
18,12,101,14,13,1
18,12,102,8,17,-9
18,12,103,8,16,-8
18,12,104,5,13,-8
18,12,105,13,11,2
18,12,106,20,18,2
18,12,107,9,10,-1
18,12,108,16,10,6
18,12,109,11,9,2
18,12,110,13,4,9
18,12,111,5,17,-12
18,12,112,14,21,-7
18,12,113,9,12,-3
18,12,114,4,22,-18
18,12,115,14,20,-6
18,12,116,3,5,-2
18,12,117,11,31,-20
18,12,118,2,15,-13
18,12,119,16,18,-2
18,12,120,9,19,-10
18,12,121,20,13,7
18,12,122,11,14,-3
18,12,123,18,20,-2
18,12,124,12,21,-9
18,12,125,11,19,-8
18,12,126,10,21,-11
18,12,127,15,28,-13
18,12,128,17,34,-17
18,12,129,14,12,2
18,12,130,13,22,-9
18,12,131,16,15,1
18,12,132,10,13,-3
18,12,133,8,20,-12
18,12,134,7,33,-26
18,12,135,12,8,4
18,12,136,32,13,19
18,12,137,14,21,-7
18,12,138,16,17,-1
18,12,139,12,12,0
18,12,140,5,20,-15
18,12,141,7,15,-8
18,12,142,18,22,-4
18,12,143,15,29,-14
18,12,144,14,8,6
18,12,145,5,7,-2
18,12,146,23,27,-4
18,12,147,11,26,-15
18,12,148,13,11,2
18,12,149,7,19,-12
18,12,150,8,7,1
18,12,151,6,6,0
18,12,152,11,11,0
18,12,153,9,13,-4
18,12,154,10,13,-3
18,12,155,10,18,-8
18,12,156,15,18,-3
18,12,157,13,16,-3
18,12,158,6,14,-8
18,12,159,9,20,-11
18,12,160,11,19,-8
18,12,161,14,14,0
18,12,162,5,8,-3
18,12,163,10,12,-2
18,12,164,17,10,7
18,12,165,16,24,-8
18,12,166,18,20,-2
18,12,167,10,23,-13
18,12,168,9,20,-11
18,12,169,12,29,-17
18,12,170,16,8,8
18,12,171,21,10,11
18,12,172,20,9,11
18,12,173,13,17,-4
18,12,174,18,11,7
18,12,175,23,18,5
18,12,176,13,12,1
18,12,177,18,25,-7
18,12,178,13,15,-2
18,12,179,24,12,12
18,12,180,20,21,-1
18,12,181,7,19,-12
18,12,182,13,27,-14
18,12,183,20,32,-12
18,12,184,23,26,-3
18,12,185,7,18,-11
18,12,186,19,33,-14
18,12,187,8,28,-20
18,12,188,7,15,-8
18,12,189,12,14,-2
18,12,190,12,16,-4
18,12,191,8,23,-15
18,12,192,13,24,-11
18,12,193,28,15,13
18,12,194,11,16,-5
18,12,195,13,20,-7
18,12,196,12,12,0
18,12,197,4,11,-7
18,12,198,10,17,-7
18,12,199,19,14,5
18,12,200,14,7,7
18,12,201,9,12,-3
18,12,202,7,20,-13
18,12,203,10,15,-5
18,12,204,23,22,1
18,12,205,3,18,-15
18,12,206,11,23,-12
18,12,207,9,11,-2
18,12,208,7,8,-1
18,12,209,7,23,-16
18,12,210,6,16,-10
18,12,211,21,10,11
18,12,212,14,9,5
18,12,213,12,28,-16
18,12,214,11,19,-8
18,12,215,13,9,4
18,12,216,10,11,-1
18,12,217,6,20,-14
18,12,218,8,15,-7
18,12,219,13,13,0
18,12,220,28,18,10
18,12,221,7,18,-11
18,12,222,20,10,10
18,12,223,12,18,-6
18,12,224,10,15,-5
18,12,225,7,19,-12
18,12,226,12,22,-10
18,12,227,16,28,-12
18,12,228,23,7,16
18,12,229,16,21,-5
18,12,230,4,14,-10
18,12,231,14,19,-5
18,12,232,20,14,6
18,12,233,14,19,-5
18,12,234,8,13,-5
18,12,235,7,12,-5
18,12,236,20,24,-4
18,12,237,19,28,-9
18,12,238,17,17,0
18,12,239,19,16,3
18,12,240,4,20,-16
18,12,241,13,15,-2
18,12,242,7,22,-15
18,12,243,9,21,-12
18,12,244,22,23,-1
18,12,245,16,30,-14
18,12,246,13,10,3
18,12,247,15,16,-1
18,12,248,16,9,7
18,12,249,14,22,-8
18,12,250,12,19,-7
18,12,251,11,19,-8
18,12,252,12,26,-14
18,12,253,10,17,-7
18,12,254,14,17,-3
18,12,255,30,20,10
18,12,256,17,21,-4
18,12,257,10,10,0
18,12,258,9,29,-20
18,12,259,12,17,-5
18,12,260,15,10,5
18,12,261,12,30,-18
18,12,262,17,13,4
18,12,263,7,18,-11
18,12,264,12,14,-2
18,12,265,17,13,4
18,12,266,17,5,12
18,12,267,8,20,-12
18,12,268,8,15,-7
18,12,269,9,11,-2
18,12,270,10,9,1
18,12,271,6,4,2
18,12,272,5,14,-9
18,12,273,9,12,-3
18,12,274,10,9,1
18,12,275,13,19,-6
18,12,276,9,26,-17
18,12,277,14,22,-8
18,12,278,13,10,3
18,12,279,12,17,-5
18,12,280,13,10,3
18,12,281,20,36,-16
18,12,282,9,18,-9
18,12,283,9,7,2
18,12,284,24,12,12
18,12,285,9,28,-19
18,12,286,8,21,-13
18,12,287,10,15,-5
18,12,288,13,12,1
18,12,289,17,19,-2
18,12,290,11,8,3
18,12,291,18,22,-4
18,12,292,7,5,2
18,12,293,11,16,-5
18,12,294,12,15,-3
18,12,295,5,16,-11
18,12,296,3,22,-19
18,12,297,15,17,-2
18,12,298,10,20,-10
18,12,299,17,23,-6
18,13,0,14,28,-14
18,13,1,21,34,-13
18,13,2,10,16,-6
18,13,3,14,17,-3
18,13,4,15,20,-5
18,13,5,15,12,3
18,13,6,14,18,-4
18,13,7,20,24,-4
18,13,8,14,18,-4
18,13,9,21,32,-11
18,13,10,16,8,8
18,13,11,10,6,4
18,13,12,22,16,6
18,13,13,12,12,0
18,13,14,11,12,-1
18,13,15,20,20,0
18,13,16,19,12,7
18,13,17,12,20,-8
18,13,18,19,15,4
18,13,19,13,13,0
18,13,20,14,19,-5
18,13,21,9,18,-9
18,13,22,11,16,-5
18,13,23,11,16,-5
18,13,24,18,14,4
18,13,25,12,11,1
18,13,26,13,10,3
18,13,27,25,19,6
18,13,28,25,22,3
18,13,29,17,19,-2
18,13,30,17,12,5
18,13,31,18,17,1
18,13,32,1,22,-21
18,13,33,14,14,0
18,13,34,18,13,5
18,13,35,17,20,-3
18,13,36,6,12,-6
18,13,37,7,12,-5
18,13,38,19,19,0
18,13,39,11,12,-1
18,13,40,22,17,5
18,13,41,17,19,-2
18,13,42,23,33,-10
18,13,43,11,28,-17
18,13,44,6,21,-15
18,13,45,9,7,2
18,13,46,9,14,-5
18,13,47,24,19,5
18,13,48,7,30,-23
18,13,49,12,20,-8
18,13,50,21,20,1
18,13,51,10,10,0
18,13,52,16,16,0
18,13,53,18,27,-9
18,13,54,19,24,-5
18,13,55,13,16,-3
18,13,56,10,18,-8
18,13,57,14,16,-2
18,13,58,20,4,16
18,13,59,6,13,-7
18,13,60,8,18,-10
18,13,61,11,13,-2
18,13,62,14,22,-8
18,13,63,19,26,-7
18,13,64,8,12,-4
18,13,65,9,10,-1
18,13,66,8,21,-13
18,13,67,9,19,-10
18,13,68,17,13,4
18,13,69,20,14,6
18,13,70,7,23,-16
18,13,71,18,32,-14
18,13,72,10,21,-11
18,13,73,6,13,-7
18,13,74,18,16,2
18,13,75,19,21,-2
18,13,76,6,5,1
18,13,77,8,15,-7
18,13,78,13,13,0
18,13,79,9,17,-8
18,13,80,10,30,-20
18,13,81,8,29,-21
18,13,82,15,19,-4
18,13,83,11,17,-6
18,13,84,6,14,-8
18,13,85,16,8,8
18,13,86,13,12,1
18,13,87,23,13,10
18,13,88,7,18,-11
18,13,89,15,15,0
18,13,90,12,10,2
18,13,91,12,11,1
18,13,92,11,30,-19
18,13,93,6,15,-9
18,13,94,12,25,-13
18,13,95,9,12,-3
18,13,96,12,14,-2
18,13,97,20,33,-13
18,13,98,19,22,-3
18,13,99,16,21,-5
18,13,100,12,11,1
18,13,101,13,19,-6
18,13,102,17,14,3
18,13,103,6,13,-7
18,13,104,20,31,-11
18,13,105,15,5,10
18,13,106,25,14,11
18,13,107,12,11,1
18,13,108,4,20,-16
18,13,109,17,19,-2
18,13,110,10,11,-1
18,13,111,15,9,6
18,13,112,15,10,5
18,13,113,24,24,0
18,13,114,15,15,0
18,13,115,19,24,-5
18,13,116,11,12,-1
18,13,117,9,11,-2
18,13,118,7,8,-1
18,13,119,25,17,8
18,13,120,25,28,-3
18,13,121,10,16,-6
18,13,122,19,20,-1
18,13,123,8,12,-4
18,13,124,11,15,-4
18,13,125,20,17,3
18,13,126,16,8,8
18,13,127,10,20,-10
18,13,128,11,28,-17
18,13,129,8,24,-16
18,13,130,9,23,-14
18,13,131,24,22,2
18,13,132,12,16,-4
18,13,133,16,20,-4
18,13,134,16,22,-6
18,13,135,4,20,-16
18,13,136,11,15,-4
18,13,137,10,14,-4
18,13,138,21,15,6
18,13,139,12,11,1
18,13,140,10,18,-8
18,13,141,14,23,-9
18,13,142,11,12,-1
18,13,143,14,14,0
18,13,144,6,9,-3
18,13,145,22,26,-4
18,13,146,11,21,-10
18,13,147,12,9,3
18,13,148,6,18,-12
18,13,149,9,18,-9
18,13,150,6,7,-1
18,13,151,21,23,-2
18,13,152,14,13,1
18,13,153,5,14,-9
18,13,154,8,7,1
18,13,155,18,22,-4
18,13,156,9,13,-4
18,13,157,12,13,-1
18,13,158,18,19,-1
18,13,159,7,6,1
18,13,160,18,26,-8
18,13,161,10,27,-17
18,13,162,9,12,-3
18,13,163,21,21,0
18,13,164,8,17,-9
18,13,165,12,18,-6
18,13,166,5,15,-10
18,13,167,17,9,8
18,13,168,20,14,6
18,13,169,23,24,-1
18,13,170,15,15,0
18,13,171,13,13,0
18,13,172,19,8,11
18,13,173,17,18,-1
18,13,174,8,12,-4
18,13,175,14,35,-21
18,13,176,8,14,-6
18,13,177,10,20,-10
18,13,178,10,18,-8
18,13,179,14,10,4
18,13,180,14,9,5
18,13,181,14,12,2
18,13,182,10,26,-16
18,13,183,20,20,0
18,13,184,13,21,-8
18,13,185,15,26,-11
18,13,186,15,20,-5
18,13,187,25,16,9
18,13,188,10,10,0
18,13,189,21,25,-4
18,13,190,9,21,-12
18,13,191,16,18,-2
18,13,192,13,14,-1
18,13,193,4,18,-14
18,13,194,12,9,3
18,13,195,14,9,5
18,13,196,6,14,-8
18,13,197,11,14,-3
18,13,198,22,19,3
18,13,199,12,17,-5
18,13,200,19,17,2
18,13,201,12,15,-3
18,13,202,9,16,-7
18,13,203,13,10,3
18,13,204,21,31,-10
18,13,205,9,10,-1
18,13,206,13,20,-7
18,13,207,8,15,-7
18,13,208,17,20,-3
18,13,209,6,12,-6
18,13,210,21,21,0
18,13,211,16,11,5
18,13,212,12,22,-10
18,13,213,2,23,-21
18,13,214,24,17,7
18,13,215,12,33,-21
18,13,216,11,14,-3
18,13,217,19,17,2
18,13,218,20,21,-1
18,13,219,16,31,-15
18,13,220,15,18,-3
18,13,221,8,13,-5
18,13,222,8,35,-27
18,13,223,15,24,-9
18,13,224,17,8,9
18,13,225,10,20,-10
18,13,226,13,23,-10
18,13,227,14,12,2
18,13,228,23,27,-4
18,13,229,20,23,-3
18,13,230,12,22,-10
18,13,231,8,14,-6
18,13,232,14,10,4
18,13,233,13,10,3
18,13,234,5,12,-7
18,13,235,15,19,-4
18,13,236,14,16,-2
18,13,237,14,20,-6
18,13,238,13,15,-2
18,13,239,15,24,-9
18,13,240,14,33,-19
18,13,241,12,19,-7
18,13,242,16,23,-7
18,13,243,11,10,1
18,13,244,14,7,7
18,13,245,19,20,-1
18,13,246,9,10,-1
18,13,247,11,19,-8
18,13,248,7,22,-15
18,13,249,6,14,-8
18,13,250,13,19,-6
18,13,251,13,28,-15
18,13,252,5,10,-5
18,13,253,9,19,-10
18,13,254,18,21,-3
18,13,255,6,10,-4
18,13,256,19,20,-1
18,13,257,11,8,3
18,13,258,6,19,-13
18,13,259,8,16,-8
18,13,260,7,12,-5
18,13,261,13,19,-6
18,13,262,18,26,-8
18,13,263,13,11,2
18,13,264,17,13,4
18,13,265,11,16,-5
18,13,266,6,16,-10
18,13,267,4,22,-18
18,13,268,28,11,17
18,13,269,20,14,6
18,13,270,15,11,4
18,13,271,5,19,-14
18,13,272,14,32,-18
18,13,273,5,10,-5
18,13,274,23,27,-4
18,13,275,20,13,7
18,13,276,16,6,10
18,13,277,19,16,3
18,13,278,13,16,-3
18,13,279,14,32,-18
18,13,280,13,17,-4
18,13,281,11,21,-10
18,13,282,6,10,-4
18,13,283,10,8,2
18,13,284,9,8,1
18,13,285,17,26,-9
18,13,286,16,12,4
18,13,287,6,25,-19
18,13,288,13,13,0
18,13,289,18,28,-10
18,13,290,14,19,-5
18,13,291,13,12,1
18,13,292,20,13,7
18,13,293,11,17,-6
18,13,294,20,14,6
18,13,295,21,28,-7
18,13,296,2,4,-2
18,13,297,21,13,8
18,13,298,9,6,3
18,13,299,17,18,-1
18,14,0,16,19,-3
18,14,1,7,11,-4
18,14,2,12,18,-6
18,14,3,18,16,2
18,14,4,4,12,-8
18,14,5,15,16,-1
18,14,6,17,17,0
18,14,7,16,21,-5
18,14,8,12,23,-11
18,14,9,11,15,-4
18,14,10,13,9,4
18,14,11,10,33,-23
18,14,12,6,17,-11
18,14,13,16,9,7
18,14,14,21,30,-9
18,14,15,19,29,-10
18,14,16,10,19,-9
18,14,17,13,17,-4
18,14,18,12,22,-10
18,14,19,10,20,-10
18,14,20,10,16,-6
18,14,21,10,22,-12
18,14,22,7,19,-12
18,14,23,10,11,-1
18,14,24,19,11,8
18,14,25,4,19,-15
18,14,26,4,15,-11
18,14,27,19,15,4
18,14,28,20,19,1
18,14,29,14,15,-1
18,14,30,12,13,-1
18,14,31,7,1,6
18,14,32,22,8,14
18,14,33,13,13,0
18,14,34,15,19,-4
18,14,35,13,12,1
18,14,36,14,14,0
18,14,37,4,11,-7
18,14,38,14,10,4
18,14,39,11,8,3
18,14,40,19,22,-3
18,14,41,14,18,-4
18,14,42,20,24,-4
18,14,43,14,22,-8
18,14,44,10,12,-2
18,14,45,5,14,-9
18,14,46,16,13,3
18,14,47,16,12,4
18,14,48,16,15,1
18,14,49,15,11,4
18,14,50,16,19,-3
18,14,51,11,14,-3
18,14,52,12,18,-6
18,14,53,8,16,-8
18,14,54,17,23,-6
18,14,55,16,26,-10
18,14,56,7,16,-9
18,14,57,16,37,-21
18,14,58,22,31,-9
18,14,59,12,9,3
18,14,60,10,20,-10
18,14,61,11,19,-8
18,14,62,8,16,-8
18,14,63,10,17,-7
18,14,64,12,11,1
18,14,65,15,12,3
18,14,66,14,14,0
18,14,67,16,17,-1
18,14,68,15,17,-2
18,14,69,26,21,5
18,14,70,9,7,2
18,14,71,13,22,-9
18,14,72,26,27,-1
18,14,73,20,26,-6
18,14,74,18,9,9
18,14,75,2,12,-10
18,14,76,19,12,7
18,14,77,15,18,-3
18,14,78,7,18,-11
18,14,79,13,14,-1
18,14,80,13,32,-19
18,14,81,10,29,-19
18,14,82,18,23,-5
18,14,83,27,15,12
18,14,84,9,11,-2
18,14,85,20,28,-8
18,14,86,12,15,-3
18,14,87,10,13,-3
18,14,88,16,18,-2
18,14,89,10,12,-2
18,14,90,14,34,-20
18,14,91,18,14,4
18,14,92,5,7,-2
18,14,93,14,18,-4
18,14,94,7,16,-9
18,14,95,9,17,-8
18,14,96,10,9,1
18,14,97,16,15,1
18,14,98,19,27,-8
18,14,99,15,9,6
18,14,100,24,21,3
18,14,101,6,17,-11
18,14,102,14,29,-15
18,14,103,18,13,5
18,14,104,8,12,-4
18,14,105,4,16,-12
18,14,106,23,30,-7
18,14,107,17,21,-4
18,14,108,9,11,-2
18,14,109,14,10,4
18,14,110,18,15,3
18,14,111,20,14,6
18,14,112,16,37,-21
18,14,113,13,12,1
18,14,114,12,23,-11
18,14,115,13,21,-8
18,14,116,12,19,-7
18,14,117,14,10,4
18,14,118,9,13,-4
18,14,119,14,15,-1
18,14,120,13,26,-13
18,14,121,6,19,-13
18,14,122,16,23,-7
18,14,123,7,16,-9
18,14,124,12,11,1
18,14,125,21,16,5
18,14,126,14,19,-5
18,14,127,7,10,-3
18,14,128,23,28,-5
18,14,129,9,25,-16
18,14,130,14,23,-9
18,14,131,11,12,-1
18,14,132,9,6,3
18,14,133,24,26,-2
18,14,134,28,18,10
18,14,135,23,32,-9
18,14,136,2,15,-13
18,14,137,17,15,2
18,14,138,8,16,-8
18,14,139,6,10,-4
18,14,140,9,4,5
18,14,141,12,16,-4
18,14,142,14,17,-3
18,14,143,3,8,-5
18,14,144,10,20,-10
18,14,145,11,17,-6
18,14,146,11,16,-5
18,14,147,15,21,-6
18,14,148,15,18,-3
18,14,149,11,14,-3
18,14,150,12,12,0
18,14,151,16,15,1
18,14,152,6,24,-18
18,14,153,11,24,-13
18,14,154,7,18,-11
18,14,155,9,10,-1
18,14,156,7,19,-12
18,14,157,8,20,-12
18,14,158,20,16,4
18,14,159,18,23,-5
18,14,160,23,24,-1
18,14,161,16,23,-7
18,14,162,17,23,-6
18,14,163,11,12,-1
18,14,164,19,24,-5
18,14,165,11,15,-4
18,14,166,11,1,10
18,14,167,18,21,-3
18,14,168,12,7,5
18,14,169,5,10,-5
18,14,170,12,11,1
18,14,171,18,24,-6
18,14,172,9,15,-6
18,14,173,13,16,-3
18,14,174,13,12,1
18,14,175,6,12,-6
18,14,176,18,22,-4
18,14,177,20,18,2
18,14,178,26,8,18
18,14,179,21,23,-2
18,14,180,18,15,3
18,14,181,7,17,-10
18,14,182,15,10,5
18,14,183,14,6,8
18,14,184,16,30,-14
18,14,185,12,19,-7
18,14,186,20,16,4
18,14,187,11,16,-5
18,14,188,8,20,-12
18,14,189,8,9,-1
18,14,190,12,15,-3
18,14,191,27,17,10
18,14,192,7,22,-15
18,14,193,10,20,-10
18,14,194,8,19,-11
18,14,195,2,17,-15
18,14,196,5,15,-10
18,14,197,28,22,6
18,14,198,8,9,-1
18,14,199,9,22,-13
18,14,200,17,23,-6
18,14,201,11,23,-12
18,14,202,19,28,-9
18,14,203,9,13,-4
18,14,204,17,27,-10
18,14,205,17,11,6
18,14,206,28,18,10
18,14,207,10,20,-10
18,14,208,9,21,-12
18,14,209,11,14,-3
18,14,210,7,7,0
18,14,211,13,21,-8
18,14,212,6,13,-7
18,14,213,16,18,-2
18,14,214,14,19,-5
18,14,215,14,15,-1
18,14,216,12,13,-1
18,14,217,15,18,-3
18,14,218,26,17,9
18,14,219,10,20,-10
18,14,220,8,8,0
18,14,221,7,17,-10
18,14,222,7,23,-16
18,14,223,24,23,1
18,14,224,7,15,-8
18,14,225,4,9,-5
18,14,226,6,16,-10
18,14,227,19,29,-10
18,14,228,20,16,4
18,14,229,12,25,-13
18,14,230,7,25,-18
18,14,231,9,21,-12
18,14,232,13,18,-5
18,14,233,15,7,8
18,14,234,13,18,-5
18,14,235,12,18,-6
18,14,236,13,11,2
18,14,237,20,22,-2
18,14,238,11,23,-12
18,14,239,18,10,8
18,14,240,10,14,-4
18,14,241,5,19,-14
18,14,242,8,10,-2
18,14,243,25,24,1
18,14,244,13,19,-6
18,14,245,24,24,0
18,14,246,11,10,1
18,14,247,9,16,-7
18,14,248,12,15,-3
18,14,249,15,13,2
18,14,250,17,19,-2
18,14,251,17,20,-3
18,14,252,7,18,-11
18,14,253,16,23,-7
18,14,254,14,21,-7
18,14,255,15,17,-2
18,14,256,14,16,-2
18,14,257,23,25,-2
18,14,258,17,22,-5
18,14,259,15,20,-5
18,14,260,12,15,-3
18,14,261,16,13,3
18,14,262,10,29,-19
18,14,263,8,21,-13
18,14,264,18,27,-9
18,14,265,10,14,-4
18,14,266,9,16,-7
18,14,267,15,30,-15
18,14,268,15,24,-9
18,14,269,19,17,2
18,14,270,15,17,-2
18,14,271,14,13,1
18,14,272,8,12,-4
18,14,273,9,15,-6
18,14,274,21,41,-20
18,14,275,26,24,2
18,14,276,12,14,-2
18,14,277,15,11,4
18,14,278,5,14,-9
18,14,279,13,13,0
18,14,280,11,24,-13
18,14,281,10,35,-25
18,14,282,17,29,-12
18,14,283,13,14,-1
18,14,284,13,21,-8
18,14,285,15,8,7
18,14,286,22,22,0
18,14,287,6,9,-3
18,14,288,8,18,-10
18,14,289,11,16,-5
18,14,290,11,29,-18
18,14,291,14,11,3
18,14,292,9,18,-9
18,14,293,8,22,-14
18,14,294,14,14,0
18,14,295,7,16,-9
18,14,296,9,17,-8
18,14,297,13,16,-3
18,14,298,5,8,-3
18,14,299,5,10,-5
18,15,0,14,14,0
18,15,1,13,12,1
18,15,2,31,20,11
18,15,3,15,17,-2
18,15,4,14,21,-7
18,15,5,21,20,1
18,15,6,13,15,-2
18,15,7,18,25,-7
18,15,8,7,10,-3
18,15,9,16,14,2
18,15,10,16,13,3
18,15,11,16,20,-4
18,15,12,8,13,-5
18,15,13,13,12,1
18,15,14,11,15,-4
18,15,15,13,24,-11
18,15,16,6,16,-10
18,15,17,8,16,-8
18,15,18,14,22,-8
18,15,19,18,26,-8
18,15,20,7,17,-10
18,15,21,13,20,-7
18,15,22,19,29,-10
18,15,23,19,15,4
18,15,24,16,26,-10
18,15,25,15,21,-6
18,15,26,16,11,5
18,15,27,19,10,9
18,15,28,8,13,-5
18,15,29,26,26,0
18,15,30,16,23,-7
18,15,31,20,13,7
18,15,32,13,17,-4
18,15,33,24,17,7
18,15,34,20,20,0
18,15,35,12,28,-16
18,15,36,18,28,-10
18,15,37,19,13,6
18,15,38,19,30,-11
18,15,39,13,12,1
18,15,40,14,16,-2
18,15,41,22,28,-6
18,15,42,10,30,-20
18,15,43,17,18,-1
18,15,44,13,8,5
18,15,45,22,10,12
18,15,46,17,13,4
18,15,47,4,8,-4
18,15,48,16,18,-2
18,15,49,10,17,-7
18,15,50,11,15,-4
18,15,51,10,12,-2
18,15,52,10,19,-9
18,15,53,6,11,-5
18,15,54,8,18,-10
18,15,55,7,6,1
18,15,56,9,13,-4
18,15,57,13,20,-7
18,15,58,10,11,-1
18,15,59,15,22,-7
18,15,60,11,17,-6
18,15,61,13,16,-3
18,15,62,14,13,1
18,15,63,11,10,1
18,15,64,10,9,1
18,15,65,28,23,5
18,15,66,11,8,3
18,15,67,17,18,-1
18,15,68,14,18,-4
18,15,69,10,15,-5
18,15,70,15,14,1
18,15,71,7,25,-18
18,15,72,16,21,-5
18,15,73,14,15,-1
18,15,74,7,9,-2
18,15,75,17,25,-8
18,15,76,15,11,4
18,15,77,11,12,-1
18,15,78,9,19,-10
18,15,79,5,21,-16
18,15,80,7,6,1
18,15,81,13,15,-2
18,15,82,11,15,-4
18,15,83,6,17,-11
18,15,84,18,33,-15
18,15,85,12,12,0
18,15,86,12,18,-6
18,15,87,12,13,-1
18,15,88,8,21,-13
18,15,89,5,19,-14
18,15,90,24,17,7
18,15,91,21,21,0
18,15,92,19,15,4
18,15,93,15,12,3
18,15,94,8,7,1
18,15,95,16,18,-2
18,15,96,19,30,-11
18,15,97,14,13,1
18,15,98,8,18,-10
18,15,99,22,15,7
18,15,100,18,34,-16
18,15,101,21,19,2
18,15,102,21,24,-3
18,15,103,18,19,-1
18,15,104,18,37,-19
18,15,105,16,21,-5
18,15,106,14,24,-10
18,15,107,15,14,1
18,15,108,21,26,-5
18,15,109,10,18,-8
18,15,110,8,16,-8
18,15,111,15,12,3
18,15,112,5,22,-17
18,15,113,7,17,-10
18,15,114,21,15,6
18,15,115,15,9,6
18,15,116,18,16,2
18,15,117,19,27,-8
18,15,118,10,8,2
18,15,119,16,14,2
18,15,120,11,21,-10
18,15,121,16,23,-7
18,15,122,9,19,-10
18,15,123,8,14,-6
18,15,124,13,8,5
18,15,125,13,19,-6
18,15,126,25,39,-14
18,15,127,11,15,-4
18,15,128,16,11,5
18,15,129,29,24,5
18,15,130,13,18,-5
18,15,131,20,23,-3
18,15,132,6,22,-16
18,15,133,19,13,6
18,15,134,14,15,-1
18,15,135,26,26,0
18,15,136,10,13,-3
18,15,137,11,12,-1
18,15,138,11,17,-6
18,15,139,13,18,-5
18,15,140,9,7,2
18,15,141,12,13,-1
18,15,142,1,12,-11
18,15,143,15,16,-1
18,15,144,8,26,-18
18,15,145,10,13,-3
18,15,146,12,22,-10
18,15,147,17,13,4
18,15,148,10,20,-10
18,15,149,9,26,-17
18,15,150,19,28,-9
18,15,151,24,23,1
18,15,152,20,12,8
18,15,153,12,10,2
18,15,154,6,15,-9
18,15,155,23,18,5
18,15,156,14,18,-4
18,15,157,12,15,-3
18,15,158,14,19,-5
18,15,159,13,23,-10
18,15,160,19,14,5
18,15,161,20,23,-3
18,15,162,17,14,3
18,15,163,9,6,3
18,15,164,13,6,7
18,15,165,8,14,-6
18,15,166,12,17,-5
18,15,167,11,20,-9
18,15,168,6,8,-2
18,15,169,13,20,-7
18,15,170,16,16,0
18,15,171,4,11,-7
18,15,172,12,15,-3
18,15,173,17,19,-2
18,15,174,18,12,6
18,15,175,13,20,-7
18,15,176,15,23,-8
18,15,177,24,26,-2
18,15,178,9,13,-4
18,15,179,9,21,-12
18,15,180,7,12,-5
18,15,181,16,26,-10
18,15,182,20,15,5
18,15,183,25,19,6
18,15,184,11,18,-7
18,15,185,24,24,0
18,15,186,10,8,2
18,15,187,16,11,5
18,15,188,13,12,1
18,15,189,15,19,-4
18,15,190,14,14,0
18,15,191,8,3,5
18,15,192,16,11,5
18,15,193,15,14,1
18,15,194,14,19,-5
18,15,195,8,25,-17
18,15,196,17,17,0
18,15,197,11,24,-13
18,15,198,6,16,-10
18,15,199,19,20,-1
18,15,200,9,7,2
18,15,201,14,18,-4
18,15,202,11,17,-6
18,15,203,19,13,6
18,15,204,9,13,-4
18,15,205,13,11,2
18,15,206,7,23,-16
18,15,207,9,24,-15
18,15,208,20,26,-6
18,15,209,10,8,2
18,15,210,17,24,-7
18,15,211,11,21,-10
18,15,212,9,15,-6
18,15,213,16,17,-1
18,15,214,9,20,-11
18,15,215,8,11,-3
18,15,216,13,10,3
18,15,217,25,20,5
18,15,218,11,12,-1
18,15,219,14,24,-10
18,15,220,12,11,1
18,15,221,10,4,6
18,15,222,11,9,2
18,15,223,11,30,-19
18,15,224,18,25,-7
18,15,225,12,11,1
18,15,226,19,20,-1
18,15,227,19,12,7
18,15,228,10,25,-15
18,15,229,12,9,3
18,15,230,23,38,-15
18,15,231,12,22,-10
18,15,232,12,18,-6
18,15,233,10,28,-18
18,15,234,24,16,8
18,15,235,6,11,-5
18,15,236,10,15,-5
18,15,237,14,7,7
18,15,238,23,18,5
18,15,239,8,17,-9
18,15,240,8,10,-2
18,15,241,10,3,7
18,15,242,9,14,-5
18,15,243,10,28,-18
18,15,244,11,10,1
18,15,245,11,19,-8
18,15,246,17,17,0
18,15,247,24,15,9
18,15,248,14,29,-15
18,15,249,14,11,3
18,15,250,13,35,-22
18,15,251,23,26,-3
18,15,252,7,13,-6
18,15,253,15,19,-4
18,15,254,5,19,-14
18,15,255,12,12,0
18,15,256,11,8,3
18,15,257,18,10,8
18,15,258,11,5,6
18,15,259,11,23,-12
18,15,260,19,8,11
18,15,261,12,27,-15
18,15,262,17,16,1
18,15,263,12,11,1
18,15,264,17,21,-4
18,15,265,10,23,-13
18,15,266,15,12,3
18,15,267,19,17,2
18,15,268,16,14,2
18,15,269,10,13,-3
18,15,270,8,19,-11
18,15,271,28,18,10
18,15,272,12,5,7
18,15,273,11,10,1
18,15,274,20,12,8
18,15,275,11,14,-3
18,15,276,17,27,-10
18,15,277,15,14,1
18,15,278,16,10,6
18,15,279,5,17,-12
18,15,280,22,20,2
18,15,281,14,11,3
18,15,282,20,26,-6
18,15,283,13,28,-15
18,15,284,20,20,0
18,15,285,8,10,-2
18,15,286,12,22,-10
18,15,287,18,18,0
18,15,288,13,30,-17
18,15,289,13,16,-3
18,15,290,6,15,-9
18,15,291,10,9,1
18,15,292,9,14,-5
18,15,293,22,23,-1
18,15,294,19,22,-3
18,15,295,19,27,-8
18,15,296,19,14,5
18,15,297,29,28,1
18,15,298,16,12,4
18,15,299,18,18,0
18,16,0,14,22,-8
18,16,1,11,17,-6
18,16,2,21,22,-1
18,16,3,12,19,-7
18,16,4,15,16,-1
18,16,5,14,11,3
18,16,6,15,11,4
18,16,7,13,11,2
18,16,8,17,18,-1
18,16,9,12,13,-1
18,16,10,21,18,3
18,16,11,21,26,-5
18,16,12,11,10,1
18,16,13,12,20,-8
18,16,14,7,12,-5
18,16,15,11,13,-2
18,16,16,10,11,-1
18,16,17,23,19,4
18,16,18,14,17,-3
18,16,19,13,23,-10
18,16,20,26,23,3
18,16,21,12,23,-11
18,16,22,15,16,-1
18,16,23,8,17,-9
18,16,24,8,14,-6
18,16,25,9,13,-4
18,16,26,9,20,-11
18,16,27,10,8,2
18,16,28,23,17,6
18,16,29,21,29,-8
18,16,30,12,16,-4
18,16,31,26,17,9
18,16,32,17,7,10
18,16,33,11,20,-9
18,16,34,6,8,-2
18,16,35,9,13,-4
18,16,36,7,15,-8
18,16,37,5,8,-3
18,16,38,25,8,17
18,16,39,14,17,-3
18,16,40,15,15,0
18,16,41,15,15,0
18,16,42,12,18,-6
18,16,43,12,23,-11
18,16,44,3,12,-9
18,16,45,19,23,-4
18,16,46,13,25,-12
18,16,47,6,4,2
18,16,48,18,14,4
18,16,49,18,13,5
18,16,50,22,16,6
18,16,51,4,9,-5
18,16,52,6,15,-9
18,16,53,9,5,4
18,16,54,13,17,-4
18,16,55,15,27,-12
18,16,56,16,10,6
18,16,57,14,6,8
18,16,58,15,12,3
18,16,59,13,11,2
18,16,60,9,18,-9
18,16,61,8,15,-7
18,16,62,8,4,4
18,16,63,12,18,-6
18,16,64,22,13,9
18,16,65,19,15,4
18,16,66,11,9,2
18,16,67,13,24,-11
18,16,68,12,9,3
18,16,69,8,12,-4
18,16,70,16,17,-1
18,16,71,16,16,0
18,16,72,7,6,1
18,16,73,14,14,0
18,16,74,24,14,10
18,16,75,17,14,3
18,16,76,22,22,0
18,16,77,8,18,-10
18,16,78,20,23,-3
18,16,79,10,9,1
18,16,80,21,16,5
18,16,81,22,22,0
18,16,82,12,3,9
18,16,83,9,3,6
18,16,84,23,26,-3
18,16,85,17,8,9
18,16,86,9,20,-11
18,16,87,6,5,1
18,16,88,9,13,-4
18,16,89,7,16,-9
18,16,90,11,12,-1
18,16,91,19,26,-7
18,16,92,12,31,-19
18,16,93,20,18,2
18,16,94,19,21,-2
18,16,95,6,5,1
18,16,96,18,15,3
18,16,97,13,28,-15
18,16,98,17,21,-4
18,16,99,12,14,-2
18,16,100,28,14,14
18,16,101,16,12,4
18,16,102,15,9,6
18,16,103,11,22,-11
18,16,104,24,18,6
18,16,105,3,23,-20
18,16,106,4,5,-1
18,16,107,13,20,-7
18,16,108,17,21,-4
18,16,109,7,13,-6
18,16,110,22,8,14
18,16,111,19,36,-17
18,16,112,14,23,-9
18,16,113,16,23,-7
18,16,114,17,16,1
18,16,115,13,17,-4
18,16,116,10,17,-7
18,16,117,13,18,-5
18,16,118,19,29,-10
18,16,119,8,10,-2
18,16,120,18,15,3
18,16,121,22,26,-4
18,16,122,9,22,-13
18,16,123,17,26,-9
18,16,124,29,19,10
18,16,125,7,12,-5
18,16,126,10,30,-20
18,16,127,12,19,-7
18,16,128,5,10,-5
18,16,129,18,15,3
18,16,130,21,18,3
18,16,131,4,24,-20
18,16,132,12,17,-5
18,16,133,16,19,-3
18,16,134,13,16,-3
18,16,135,22,31,-9
18,16,136,10,18,-8
18,16,137,16,13,3
18,16,138,10,13,-3
18,16,139,19,22,-3
18,16,140,13,22,-9
18,16,141,13,21,-8
18,16,142,20,31,-11
18,16,143,10,13,-3
18,16,144,2,16,-14
18,16,145,15,14,1
18,16,146,6,12,-6
18,16,147,25,22,3
18,16,148,3,27,-24
18,16,149,11,11,0
18,16,150,19,18,1
18,16,151,18,23,-5
18,16,152,18,17,1
18,16,153,13,16,-3
18,16,154,17,16,1
18,16,155,7,11,-4
18,16,156,15,16,-1
18,16,157,18,20,-2
18,16,158,22,11,11
18,16,159,19,18,1
18,16,160,3,13,-10
18,16,161,5,19,-14
18,16,162,8,12,-4
18,16,163,23,14,9
18,16,164,12,8,4
18,16,165,14,6,8
18,16,166,18,17,1
18,16,167,9,8,1
18,16,168,16,18,-2
18,16,169,9,26,-17
18,16,170,16,19,-3
18,16,171,20,18,2
18,16,172,18,16,2
18,16,173,23,13,10
18,16,174,8,17,-9
18,16,175,10,17,-7
18,16,176,11,12,-1
18,16,177,11,18,-7
18,16,178,18,18,0
18,16,179,13,17,-4
18,16,180,12,9,3
18,16,181,8,20,-12
18,16,182,14,20,-6
18,16,183,22,9,13
18,16,184,22,22,0
18,16,185,14,9,5
18,16,186,20,26,-6
18,16,187,22,10,12
18,16,188,6,30,-24
18,16,189,25,27,-2
18,16,190,13,16,-3
18,16,191,17,14,3
18,16,192,21,6,15
18,16,193,13,8,5
18,16,194,8,11,-3
18,16,195,8,10,-2
18,16,196,15,6,9
18,16,197,17,10,7
18,16,198,15,6,9
18,16,199,19,16,3
18,16,200,21,14,7
18,16,201,9,12,-3
18,16,202,14,11,3
18,16,203,13,16,-3
18,16,204,11,16,-5
18,16,205,15,16,-1
18,16,206,16,15,1
18,16,207,14,9,5
18,16,208,14,9,5
18,16,209,9,15,-6
18,16,210,8,10,-2
18,16,211,21,19,2
18,16,212,13,25,-12
18,16,213,8,4,4
18,16,214,11,9,2
18,16,215,9,26,-17
18,16,216,7,4,3
18,16,217,18,15,3
18,16,218,14,18,-4
18,16,219,9,5,4
18,16,220,7,5,2
18,16,221,15,13,2
18,16,222,11,19,-8
18,16,223,9,19,-10
18,16,224,16,19,-3
18,16,225,14,7,7
18,16,226,18,15,3
18,16,227,20,16,4
18,16,228,10,9,1
18,16,229,3,18,-15
18,16,230,17,19,-2
18,16,231,9,8,1
18,16,232,21,6,15
18,16,233,20,20,0
18,16,234,19,17,2
18,16,235,6,13,-7
18,16,236,7,14,-7
18,16,237,12,12,0
18,16,238,8,5,3
18,16,239,13,20,-7
18,16,240,10,12,-2
18,16,241,25,23,2
18,16,242,10,15,-5
18,16,243,14,24,-10
18,16,244,16,11,5
18,16,245,14,11,3
18,16,246,18,11,7
18,16,247,10,17,-7
18,16,248,16,10,6
18,16,249,10,19,-9
18,16,250,16,13,3
18,16,251,19,9,10
18,16,252,17,16,1
18,16,253,17,15,2
18,16,254,15,8,7
18,16,255,17,19,-2
18,16,256,11,14,-3
18,16,257,9,17,-8
18,16,258,16,29,-13
18,16,259,18,18,0
18,16,260,19,10,9
18,16,261,24,13,11
18,16,262,20,8,12
18,16,263,6,13,-7
18,16,264,12,16,-4
18,16,265,20,19,1
18,16,266,17,17,0
18,16,267,18,20,-2
18,16,268,10,13,-3
18,16,269,8,7,1
18,16,270,18,14,4
18,16,271,15,18,-3
18,16,272,8,17,-9
18,16,273,9,14,-5
18,16,274,14,20,-6
18,16,275,21,16,5
18,16,276,9,19,-10
18,16,277,29,21,8
18,16,278,23,15,8
18,16,279,14,11,3
18,16,280,11,18,-7
18,16,281,10,8,2
18,16,282,16,22,-6
18,16,283,23,24,-1
18,16,284,9,21,-12
18,16,285,15,12,3
18,16,286,25,27,-2
18,16,287,20,13,7
18,16,288,23,36,-13
18,16,289,20,18,2
18,16,290,12,16,-4
18,16,291,4,26,-22
18,16,292,14,16,-2
18,16,293,22,19,3
18,16,294,7,23,-16
18,16,295,8,18,-10
18,16,296,12,10,2
18,16,297,20,13,7
18,16,298,14,16,-2
18,16,299,9,16,-7
18,17,0,13,27,-14
18,17,1,16,9,7
18,17,2,30,9,21
18,17,3,17,15,2
18,17,4,20,11,9
18,17,5,6,18,-12
18,17,6,20,18,2
18,17,7,13,13,0
18,17,8,7,14,-7
18,17,9,18,13,5
18,17,10,10,14,-4
18,17,11,18,15,3
18,17,12,23,10,13
18,17,13,9,7,2
18,17,14,18,18,0
18,17,15,21,10,11
18,17,16,13,30,-17
18,17,17,13,15,-2
18,17,18,9,14,-5
18,17,19,17,9,8
18,17,20,23,12,11
18,17,21,13,18,-5
18,17,22,22,20,2
18,17,23,12,16,-4
18,17,24,17,15,2
18,17,25,11,11,0
18,17,26,7,22,-15
18,17,27,4,15,-11
18,17,28,20,12,8
18,17,29,12,19,-7
18,17,30,17,16,1
18,17,31,18,16,2
18,17,32,20,20,0
18,17,33,12,15,-3
18,17,34,7,11,-4
18,17,35,5,13,-8
18,17,36,13,5,8
18,17,37,7,12,-5
18,17,38,22,23,-1
18,17,39,11,16,-5
18,17,40,19,17,2
18,17,41,26,17,9
18,17,42,13,10,3
18,17,43,9,32,-23
18,17,44,14,23,-9
18,17,45,13,22,-9
18,17,46,21,9,12
18,17,47,5,13,-8
18,17,48,20,29,-9
18,17,49,17,19,-2
18,17,50,13,10,3
18,17,51,12,9,3
18,17,52,18,32,-14
18,17,53,25,32,-7
18,17,54,17,16,1
18,17,55,12,13,-1
18,17,56,20,15,5
18,17,57,4,8,-4
18,17,58,16,27,-11
18,17,59,3,10,-7
18,17,60,9,17,-8
18,17,61,6,11,-5
18,17,62,19,14,5
18,17,63,16,17,-1
18,17,64,7,8,-1
18,17,65,14,16,-2
18,17,66,16,17,-1
18,17,67,12,16,-4
18,17,68,27,34,-7
18,17,69,4,13,-9
18,17,70,11,22,-11
18,17,71,8,5,3
18,17,72,14,8,6
18,17,73,14,30,-16
18,17,74,21,11,10
18,17,75,6,21,-15
18,17,76,12,21,-9
18,17,77,9,11,-2
18,17,78,12,16,-4
18,17,79,17,17,0
18,17,80,8,21,-13
18,17,81,24,8,16
18,17,82,17,18,-1
18,17,83,24,18,6
18,17,84,11,20,-9
18,17,85,15,16,-1
18,17,86,5,13,-8
18,17,87,11,10,1
18,17,88,21,24,-3
18,17,89,19,7,12
18,17,90,10,28,-18
18,17,91,6,17,-11
18,17,92,21,34,-13
18,17,93,15,31,-16
18,17,94,23,25,-2
18,17,95,8,7,1
18,17,96,24,21,3
18,17,97,17,19,-2
18,17,98,12,24,-12
18,17,99,14,17,-3
18,17,100,3,12,-9
18,17,101,11,12,-1
18,17,102,9,17,-8
18,17,103,28,18,10
18,17,104,25,14,11
18,17,105,15,26,-11
18,17,106,4,28,-24
18,17,107,26,20,6
18,17,108,9,29,-20
18,17,109,20,21,-1
18,17,110,22,18,4
18,17,111,16,17,-1
18,17,112,6,11,-5
18,17,113,15,19,-4
18,17,114,11,3,8
18,17,115,9,15,-6
18,17,116,15,19,-4
18,17,117,7,14,-7
18,17,118,13,9,4
18,17,119,13,25,-12
18,17,120,9,7,2
18,17,121,17,13,4
18,17,122,12,22,-10
18,17,123,20,18,2
18,17,124,18,14,4
18,17,125,13,40,-27
18,17,126,6,20,-14
18,17,127,15,27,-12
18,17,128,13,19,-6
18,17,129,14,5,9
18,17,130,9,15,-6
18,17,131,17,13,4
18,17,132,15,14,1
18,17,133,13,13,0
18,17,134,11,17,-6
18,17,135,11,13,-2
18,17,136,9,21,-12
18,17,137,12,6,6
18,17,138,7,15,-8
18,17,139,8,18,-10
18,17,140,5,7,-2
18,17,141,10,9,1
18,17,142,23,19,4
18,17,143,16,27,-11
18,17,144,16,12,4
18,17,145,16,21,-5
18,17,146,13,17,-4
18,17,147,11,13,-2
18,17,148,9,22,-13
18,17,149,16,33,-17
18,17,150,3,13,-10
18,17,151,19,10,9
18,17,152,12,15,-3
18,17,153,17,14,3
18,17,154,13,19,-6
18,17,155,24,23,1
18,17,156,8,16,-8
18,17,157,12,8,4
18,17,158,14,11,3
18,17,159,15,21,-6
18,17,160,21,14,7
18,17,161,13,19,-6
18,17,162,18,19,-1
18,17,163,14,13,1
18,17,164,8,9,-1
18,17,165,14,21,-7
18,17,166,17,20,-3
18,17,167,17,23,-6
18,17,168,16,15,1
18,17,169,9,15,-6
18,17,170,12,17,-5
18,17,171,18,11,7
18,17,172,16,22,-6
18,17,173,33,27,6
18,17,174,26,13,13
18,17,175,16,6,10
18,17,176,7,15,-8
18,17,177,15,10,5
18,17,178,16,25,-9
18,17,179,12,17,-5
18,17,180,27,24,3
18,17,181,15,10,5
18,17,182,20,23,-3
18,17,183,16,27,-11
18,17,184,6,5,1
18,17,185,11,13,-2
18,17,186,12,16,-4
18,17,187,16,11,5
18,17,188,14,10,4
18,17,189,10,9,1
18,17,190,14,8,6
18,17,191,23,16,7
18,17,192,5,5,0
18,17,193,14,34,-20
18,17,194,18,20,-2
18,17,195,14,12,2
18,17,196,4,16,-12
18,17,197,7,7,0
18,17,198,6,17,-11
18,17,199,9,10,-1
18,17,200,15,13,2
18,17,201,11,12,-1
18,17,202,13,14,-1
18,17,203,13,14,-1
18,17,204,11,16,-5
18,17,205,30,25,5
18,17,206,17,18,-1
18,17,207,18,29,-11
18,17,208,6,12,-6
18,17,209,15,15,0
18,17,210,20,16,4
18,17,211,12,14,-2
18,17,212,19,27,-8
18,17,213,13,17,-4
18,17,214,20,14,6
18,17,215,10,16,-6
18,17,216,10,18,-8
18,17,217,14,25,-11
18,17,218,20,18,2
18,17,219,19,11,8
18,17,220,17,19,-2
18,17,221,8,22,-14
18,17,222,14,13,1
18,17,223,16,9,7
18,17,224,4,14,-10
18,17,225,9,8,1
18,17,226,13,20,-7
18,17,227,8,9,-1
18,17,228,11,12,-1
18,17,229,14,20,-6
18,17,230,18,12,6
18,17,231,17,22,-5
18,17,232,18,19,-1
18,17,233,7,18,-11
18,17,234,13,24,-11
18,17,235,17,25,-8
18,17,236,20,13,7
18,17,237,18,17,1
18,17,238,13,17,-4
18,17,239,21,24,-3
18,17,240,15,15,0
18,17,241,10,12,-2
18,17,242,6,10,-4
18,17,243,17,12,5
18,17,244,11,15,-4
18,17,245,11,20,-9
18,17,246,10,10,0
18,17,247,13,21,-8
18,17,248,14,20,-6
18,17,249,17,19,-2
18,17,250,11,16,-5
18,17,251,9,19,-10
18,17,252,18,17,1
18,17,253,15,15,0
18,17,254,8,19,-11
18,17,255,22,5,17
18,17,256,12,10,2
18,17,257,8,20,-12
18,17,258,17,18,-1
18,17,259,9,14,-5
18,17,260,13,23,-10
18,17,261,11,19,-8
18,17,262,6,15,-9
18,17,263,13,7,6
18,17,264,7,12,-5
18,17,265,16,16,0
18,17,266,6,14,-8
18,17,267,23,25,-2
18,17,268,15,21,-6
18,17,269,20,22,-2
18,17,270,20,14,6
18,17,271,2,15,-13
18,17,272,13,15,-2
18,17,273,16,23,-7
18,17,274,29,18,11
18,17,275,14,9,5
18,17,276,10,14,-4
18,17,277,12,0,12
18,17,278,21,16,5
18,17,279,16,22,-6
18,17,280,12,20,-8
18,17,281,16,19,-3
18,17,282,14,16,-2
18,17,283,9,29,-20
18,17,284,10,5,5
18,17,285,8,7,1
18,17,286,15,21,-6
18,17,287,12,13,-1
18,17,288,13,26,-13
18,17,289,11,24,-13
18,17,290,12,15,-3
18,17,291,14,17,-3
18,17,292,13,15,-2
18,17,293,14,22,-8
18,17,294,10,15,-5
18,17,295,20,22,-2
18,17,296,11,8,3
18,17,297,18,15,3
18,17,298,12,13,-1
18,17,299,10,6,4
18,18,0,16,15,1
18,18,1,10,19,-9
18,18,2,18,14,4
18,18,3,22,13,9
18,18,4,8,29,-21
18,18,5,20,18,2
18,18,6,14,9,5
18,18,7,9,17,-8
18,18,8,15,23,-8
18,18,9,19,15,4
18,18,10,16,11,5
18,18,11,8,16,-8
18,18,12,16,18,-2
18,18,13,5,5,0
18,18,14,12,12,0
18,18,15,12,10,2
18,18,16,22,10,12
18,18,17,16,14,2
18,18,18,11,31,-20
18,18,19,13,11,2
18,18,20,9,18,-9
18,18,21,8,16,-8
18,18,22,7,14,-7
18,18,23,14,26,-12
18,18,24,22,25,-3
18,18,25,12,17,-5
18,18,26,9,13,-4
18,18,27,10,15,-5
18,18,28,5,7,-2
18,18,29,7,19,-12
18,18,30,27,9,18
18,18,31,13,13,0
18,18,32,14,24,-10
18,18,33,13,6,7
18,18,34,4,17,-13
18,18,35,6,11,-5
18,18,36,17,10,7
18,18,37,2,9,-7
18,18,38,13,8,5
18,18,39,9,21,-12
18,18,40,13,16,-3
18,18,41,6,14,-8
18,18,42,18,14,4
18,18,43,20,13,7
18,18,44,5,15,-10
18,18,45,7,10,-3
18,18,46,27,11,16
18,18,47,13,15,-2
18,18,48,4,11,-7
18,18,49,23,30,-7
18,18,50,7,14,-7
18,18,51,9,21,-12
18,18,52,4,10,-6
18,18,53,13,17,-4
18,18,54,18,22,-4
18,18,55,19,8,11
18,18,56,13,23,-10
18,18,57,7,12,-5
18,18,58,13,23,-10
18,18,59,13,15,-2
18,18,60,6,7,-1
18,18,61,14,29,-15
18,18,62,15,20,-5
18,18,63,8,9,-1
18,18,64,9,12,-3
18,18,65,15,15,0
18,18,66,8,18,-10
18,18,67,6,25,-19
18,18,68,13,11,2
18,18,69,17,8,9
18,18,70,2,8,-6
18,18,71,10,42,-32
18,18,72,7,14,-7
18,18,73,19,7,12
18,18,74,9,15,-6
18,18,75,16,9,7
18,18,76,14,15,-1
18,18,77,19,20,-1
18,18,78,8,19,-11
18,18,79,10,25,-15
18,18,80,16,14,2
18,18,81,15,16,-1
18,18,82,15,14,1
18,18,83,14,12,2
18,18,84,16,17,-1
18,18,85,15,26,-11
18,18,86,10,3,7
18,18,87,8,11,-3
18,18,88,12,10,2
18,18,89,15,5,10
18,18,90,10,4,6
18,18,91,2,15,-13
18,18,92,17,8,9
18,18,93,21,19,2
18,18,94,16,13,3
18,18,95,17,20,-3
18,18,96,16,23,-7
18,18,97,17,22,-5
18,18,98,13,24,-11
18,18,99,15,12,3
18,18,100,24,24,0
18,18,101,11,25,-14
18,18,102,15,13,2
18,18,103,13,5,8
18,18,104,23,9,14
18,18,105,15,14,1
18,18,106,5,13,-8
18,18,107,12,13,-1
18,18,108,8,9,-1
18,18,109,10,25,-15
18,18,110,8,4,4
18,18,111,6,4,2
18,18,112,9,20,-11
18,18,113,9,15,-6
18,18,114,3,10,-7
18,18,115,6,16,-10
18,18,116,16,13,3
18,18,117,16,6,10
18,18,118,14,5,9
18,18,119,13,15,-2
18,18,120,12,15,-3
18,18,121,15,21,-6
18,18,122,17,19,-2
18,18,123,10,15,-5
18,18,124,14,8,6
18,18,125,20,10,10
18,18,126,13,30,-17
18,18,127,12,7,5
18,18,128,10,14,-4
18,18,129,13,20,-7
18,18,130,10,15,-5
18,18,131,17,9,8
18,18,132,13,12,1
18,18,133,15,20,-5
18,18,134,9,10,-1
18,18,135,8,16,-8
18,18,136,11,18,-7
18,18,137,9,10,-1
18,18,138,6,13,-7
18,18,139,25,28,-3
18,18,140,13,8,5
18,18,141,12,18,-6
18,18,142,13,23,-10
18,18,143,14,22,-8
18,18,144,20,25,-5
18,18,145,4,14,-10
18,18,146,5,13,-8
18,18,147,14,15,-1
18,18,148,16,14,2
18,18,149,10,13,-3
18,18,150,17,15,2
18,18,151,16,20,-4
18,18,152,10,10,0
18,18,153,8,9,-1
18,18,154,11,20,-9
18,18,155,4,18,-14
18,18,156,10,9,1
18,18,157,9,22,-13
18,18,158,4,17,-13
18,18,159,5,8,-3
18,18,160,11,15,-4
18,18,161,17,20,-3
18,18,162,9,15,-6
18,18,163,14,16,-2
18,18,164,17,26,-9
18,18,165,11,15,-4
18,18,166,16,15,1
18,18,167,8,11,-3
18,18,168,23,20,3
18,18,169,12,18,-6
18,18,170,11,19,-8
18,18,171,11,16,-5
18,18,172,18,19,-1
18,18,173,8,12,-4
18,18,174,21,7,14
18,18,175,6,16,-10
18,18,176,29,40,-11
18,18,177,12,14,-2
18,18,178,9,8,1
18,18,179,17,17,0
18,18,180,12,14,-2
18,18,181,17,12,5
18,18,182,5,10,-5
18,18,183,12,8,4
18,18,184,18,24,-6
18,18,185,17,8,9
18,18,186,10,14,-4
18,18,187,7,36,-29
18,18,188,18,27,-9
18,18,189,18,15,3
18,18,190,18,22,-4
18,18,191,10,26,-16
18,18,192,8,6,2
18,18,193,13,15,-2
18,18,194,7,20,-13
18,18,195,13,29,-16
18,18,196,4,5,-1
18,18,197,9,19,-10
18,18,198,12,21,-9
18,18,199,14,3,11
18,18,200,9,7,2
18,18,201,4,6,-2
18,18,202,14,14,0
18,18,203,16,27,-11
18,18,204,9,6,3
18,18,205,10,14,-4
18,18,206,11,13,-2
18,18,207,14,17,-3
18,18,208,12,17,-5
18,18,209,12,17,-5
18,18,210,23,13,10
18,18,211,25,11,14
18,18,212,13,17,-4
18,18,213,14,19,-5
18,18,214,13,6,7
18,18,215,30,23,7
18,18,216,14,16,-2
18,18,217,9,13,-4
18,18,218,10,16,-6
18,18,219,11,12,-1
18,18,220,18,16,2
18,18,221,13,14,-1
18,18,222,3,11,-8
18,18,223,20,20,0
18,18,224,13,14,-1
18,18,225,19,20,-1
18,18,226,11,29,-18
18,18,227,14,19,-5
18,18,228,12,17,-5
18,18,229,18,18,0
18,18,230,20,6,14
18,18,231,4,13,-9
18,18,232,12,12,0
18,18,233,11,15,-4
18,18,234,16,23,-7
18,18,235,5,5,0
18,18,236,12,17,-5
18,18,237,11,10,1
18,18,238,29,19,10
18,18,239,9,18,-9
18,18,240,32,23,9
18,18,241,19,9,10
18,18,242,10,13,-3
18,18,243,7,7,0
18,18,244,12,7,5
18,18,245,18,8,10
18,18,246,15,8,7
18,18,247,11,14,-3
18,18,248,18,26,-8
18,18,249,13,14,-1
18,18,250,6,20,-14
18,18,251,26,21,5
18,18,252,16,15,1
18,18,253,11,11,0
18,18,254,12,22,-10
18,18,255,17,14,3
18,18,256,6,19,-13
18,18,257,25,12,13
18,18,258,24,29,-5
18,18,259,13,22,-9
18,18,260,15,18,-3
18,18,261,10,14,-4
18,18,262,15,20,-5
18,18,263,11,17,-6
18,18,264,8,15,-7
18,18,265,17,10,7
18,18,266,13,7,6
18,18,267,9,11,-2
18,18,268,6,23,-17
18,18,269,13,21,-8
18,18,270,11,12,-1
18,18,271,12,15,-3
18,18,272,6,8,-2
18,18,273,5,11,-6
18,18,274,15,9,6
18,18,275,17,9,8
18,18,276,5,12,-7
18,18,277,13,8,5
18,18,278,11,7,4
18,18,279,25,14,11
18,18,280,18,3,15
18,18,281,9,17,-8
18,18,282,13,10,3
18,18,283,14,15,-1
18,18,284,18,15,3
18,18,285,24,22,2
18,18,286,8,25,-17
18,18,287,14,18,-4
18,18,288,11,12,-1
18,18,289,16,17,-1
18,18,290,12,8,4
18,18,291,14,19,-5
18,18,292,18,20,-2
18,18,293,18,22,-4
18,18,294,10,27,-17
18,18,295,15,13,2
18,18,296,16,10,6
18,18,297,20,17,3
18,18,298,12,8,4
18,18,299,14,12,2
18,19,0,15,15,0
18,19,1,13,16,-3
18,19,2,7,17,-10
18,19,3,5,10,-5
18,19,4,27,12,15
18,19,5,15,14,1
18,19,6,12,26,-14
18,19,7,9,19,-10
18,19,8,17,26,-9
18,19,9,16,20,-4
18,19,10,23,22,1
18,19,11,17,17,0
18,19,12,12,14,-2
18,19,13,16,16,0
18,19,14,14,30,-16
18,19,15,4,15,-11
18,19,16,7,6,1
18,19,17,19,19,0
18,19,18,13,25,-12
18,19,19,14,6,8
18,19,20,12,13,-1
18,19,21,16,10,6
18,19,22,22,22,0
18,19,23,14,11,3
18,19,24,21,9,12
18,19,25,9,14,-5
18,19,26,8,9,-1
18,19,27,13,24,-11
18,19,28,9,23,-14
18,19,29,17,23,-6
18,19,30,11,15,-4
18,19,31,11,23,-12
18,19,32,5,15,-10
18,19,33,17,21,-4
18,19,34,14,14,0
18,19,35,5,15,-10
18,19,36,7,3,4
18,19,37,18,11,7
18,19,38,9,22,-13
18,19,39,20,10,10
18,19,40,18,15,3
18,19,41,18,19,-1
18,19,42,16,15,1
18,19,43,15,15,0
18,19,44,7,11,-4
18,19,45,6,7,-1
18,19,46,18,16,2
18,19,47,19,16,3
18,19,48,10,6,4
18,19,49,20,20,0
18,19,50,9,25,-16
18,19,51,10,9,1
18,19,52,13,17,-4
18,19,53,3,11,-8
18,19,54,9,24,-15
18,19,55,14,22,-8
18,19,56,12,12,0
18,19,57,22,29,-7
18,19,58,23,13,10
18,19,59,22,25,-3
18,19,60,15,13,2
18,19,61,9,14,-5
18,19,62,8,20,-12
18,19,63,8,16,-8
18,19,64,16,11,5
18,19,65,13,8,5
18,19,66,3,5,-2
18,19,67,4,15,-11
18,19,68,17,15,2
18,19,69,16,18,-2
18,19,70,13,4,9
18,19,71,26,20,6
18,19,72,19,13,6
18,19,73,12,9,3
18,19,74,7,9,-2
18,19,75,21,42,-21
18,19,76,12,11,1
18,19,77,10,12,-2
18,19,78,16,17,-1
18,19,79,19,13,6
18,19,80,8,6,2
18,19,81,11,15,-4
18,19,82,17,23,-6
18,19,83,14,17,-3
18,19,84,9,9,0
18,19,85,13,15,-2
18,19,86,25,10,15
18,19,87,18,22,-4
18,19,88,11,13,-2
18,19,89,6,10,-4
18,19,90,6,16,-10
18,19,91,9,13,-4
18,19,92,12,20,-8
18,19,93,10,19,-9
18,19,94,9,9,0
18,19,95,18,24,-6
18,19,96,15,19,-4
18,19,97,18,11,7
18,19,98,10,15,-5
18,19,99,18,16,2
18,19,100,16,12,4
18,19,101,22,26,-4
18,19,102,12,23,-11
18,19,103,20,19,1
18,19,104,13,9,4
18,19,105,18,21,-3
18,19,106,9,7,2
18,19,107,21,6,15
18,19,108,8,17,-9
18,19,109,22,16,6
18,19,110,13,20,-7
18,19,111,15,16,-1
18,19,112,5,11,-6
18,19,113,15,24,-9
18,19,114,24,13,11
18,19,115,13,17,-4
18,19,116,34,19,15
18,19,117,16,22,-6
18,19,118,20,27,-7
18,19,119,19,15,4
18,19,120,11,25,-14
18,19,121,15,17,-2
18,19,122,8,3,5
18,19,123,11,20,-9
18,19,124,14,23,-9
18,19,125,16,22,-6
18,19,126,19,20,-1
18,19,127,5,30,-25
18,19,128,19,15,4
18,19,129,30,9,21
18,19,130,30,20,10
18,19,131,7,5,2
18,19,132,18,17,1
18,19,133,17,17,0
18,19,134,17,23,-6
18,19,135,7,6,1
18,19,136,20,14,6
18,19,137,7,20,-13
18,19,138,14,8,6
18,19,139,9,18,-9
18,19,140,4,15,-11
18,19,141,20,16,4
18,19,142,29,11,18
18,19,143,10,20,-10
18,19,144,12,4,8
18,19,145,17,35,-18
18,19,146,18,14,4
18,19,147,30,26,4
18,19,148,13,15,-2
18,19,149,10,16,-6
18,19,150,18,13,5
18,19,151,5,10,-5
18,19,152,14,20,-6
18,19,153,16,15,1
18,19,154,15,12,3
18,19,155,16,22,-6
18,19,156,10,13,-3
18,19,157,25,20,5
18,19,158,7,14,-7
18,19,159,12,16,-4
18,19,160,10,10,0
18,19,161,26,15,11
18,19,162,19,13,6
18,19,163,22,21,1
18,19,164,12,20,-8
18,19,165,20,17,3
18,19,166,11,20,-9
18,19,167,21,21,0
18,19,168,13,8,5
18,19,169,14,5,9
18,19,170,8,9,-1
18,19,171,22,23,-1
18,19,172,9,11,-2
18,19,173,15,17,-2
18,19,174,14,21,-7
18,19,175,18,18,0
18,19,176,19,16,3
18,19,177,10,26,-16
18,19,178,7,20,-13
18,19,179,5,18,-13
18,19,180,23,13,10
18,19,181,11,22,-11
18,19,182,12,9,3
18,19,183,8,26,-18
18,19,184,27,11,16
18,19,185,8,19,-11
18,19,186,20,17,3
18,19,187,20,10,10
18,19,188,19,23,-4
18,19,189,16,12,4
18,19,190,14,12,2
18,19,191,9,17,-8
18,19,192,14,16,-2
18,19,193,13,16,-3
18,19,194,17,11,6
18,19,195,12,12,0
18,19,196,6,9,-3
18,19,197,9,3,6
18,19,198,14,22,-8
18,19,199,7,12,-5
18,19,200,11,17,-6
18,19,201,14,19,-5
18,19,202,18,13,5
18,19,203,14,13,1
18,19,204,13,13,0
18,19,205,14,30,-16
18,19,206,20,18,2
18,19,207,12,11,1
18,19,208,16,18,-2
18,19,209,14,7,7
18,19,210,14,11,3
18,19,211,21,13,8
18,19,212,13,9,4
18,19,213,12,7,5
18,19,214,15,7,8
18,19,215,11,16,-5
18,19,216,10,13,-3
18,19,217,16,19,-3
18,19,218,14,10,4
18,19,219,20,25,-5
18,19,220,13,10,3
18,19,221,12,13,-1
18,19,222,8,12,-4
18,19,223,17,15,2
18,19,224,23,30,-7
18,19,225,17,17,0
18,19,226,19,16,3
18,19,227,21,15,6
18,19,228,9,22,-13
18,19,229,18,24,-6
18,19,230,25,9,16
18,19,231,20,10,10
18,19,232,9,12,-3
18,19,233,13,37,-24
18,19,234,9,14,-5
18,19,235,31,11,20
18,19,236,15,18,-3
18,19,237,8,24,-16
18,19,238,17,15,2
18,19,239,20,17,3
18,19,240,10,15,-5
18,19,241,16,10,6
18,19,242,20,21,-1
18,19,243,12,15,-3
18,19,244,14,10,4
18,19,245,19,17,2
18,19,246,17,17,0
18,19,247,15,14,1
18,19,248,13,17,-4
18,19,249,12,16,-4
18,19,250,13,15,-2
18,19,251,8,18,-10
18,19,252,15,11,4
18,19,253,6,14,-8
18,19,254,8,8,0
18,19,255,15,18,-3
18,19,256,18,17,1
18,19,257,25,13,12
18,19,258,12,7,5
18,19,259,6,12,-6
18,19,260,25,18,7
18,19,261,21,8,13
18,19,262,15,11,4
18,19,263,16,14,2
18,19,264,23,10,13
18,19,265,18,19,-1
18,19,266,9,16,-7
18,19,267,10,21,-11
18,19,268,19,24,-5
18,19,269,32,31,1
18,19,270,12,15,-3
18,19,271,9,21,-12
18,19,272,12,11,1
18,19,273,14,15,-1
18,19,274,16,9,7
18,19,275,9,22,-13
18,19,276,11,19,-8
18,19,277,11,8,3
18,19,278,19,10,9
18,19,279,22,10,12
18,19,280,11,16,-5
18,19,281,14,16,-2
18,19,282,13,15,-2
18,19,283,11,13,-2
18,19,284,5,11,-6
18,19,285,21,20,1
18,19,286,7,12,-5
18,19,287,14,16,-2
18,19,288,6,16,-10
18,19,289,24,17,7
18,19,290,10,13,-3
18,19,291,15,12,3
18,19,292,13,19,-6
18,19,293,13,7,6
18,19,294,8,28,-20
18,19,295,7,17,-10
18,19,296,12,19,-7
18,19,297,11,14,-3
18,19,298,16,17,-1
18,19,299,16,19,-3
18,20,0,19,21,-2
18,20,1,16,8,8
18,20,2,14,12,2
18,20,3,14,13,1
18,20,4,6,20,-14
18,20,5,19,12,7
18,20,6,11,16,-5
18,20,7,16,5,11
18,20,8,9,30,-21
18,20,9,7,18,-11
18,20,10,25,22,3
18,20,11,7,7,0
18,20,12,6,11,-5
18,20,13,10,17,-7
18,20,14,15,13,2
18,20,15,23,23,0
18,20,16,21,17,4
18,20,17,21,14,7
18,20,18,19,9,10
18,20,19,12,11,1
18,20,20,28,22,6
18,20,21,4,8,-4
18,20,22,22,11,11
18,20,23,8,10,-2
18,20,24,16,11,5
18,20,25,10,22,-12
18,20,26,12,10,2
18,20,27,18,23,-5
18,20,28,14,18,-4
18,20,29,8,12,-4
18,20,30,13,21,-8
18,20,31,11,14,-3
18,20,32,20,22,-2
18,20,33,8,14,-6
18,20,34,6,14,-8
18,20,35,20,22,-2
18,20,36,10,10,0
18,20,37,12,24,-12
18,20,38,17,17,0
18,20,39,13,9,4
18,20,40,10,9,1
18,20,41,10,15,-5
18,20,42,25,26,-1
18,20,43,18,12,6
18,20,44,33,19,14
18,20,45,22,21,1
18,20,46,20,2,18
18,20,47,8,10,-2
18,20,48,14,24,-10
18,20,49,14,12,2
18,20,50,14,11,3
18,20,51,10,16,-6
18,20,52,11,11,0
18,20,53,13,11,2
18,20,54,12,17,-5
18,20,55,9,20,-11
18,20,56,27,17,10
18,20,57,12,5,7
18,20,58,14,26,-12
18,20,59,5,19,-14
18,20,60,25,16,9
18,20,61,6,18,-12
18,20,62,10,16,-6
18,20,63,25,15,10
18,20,64,8,7,1
18,20,65,13,16,-3
18,20,66,8,9,-1
18,20,67,11,20,-9
18,20,68,16,8,8
18,20,69,11,11,0
18,20,70,18,16,2
18,20,71,13,14,-1
18,20,72,17,13,4
18,20,73,4,17,-13
18,20,74,15,25,-10
18,20,75,14,20,-6
18,20,76,34,26,8
18,20,77,4,14,-10
18,20,78,30,17,13
18,20,79,22,14,8
18,20,80,11,14,-3
18,20,81,13,17,-4
18,20,82,19,27,-8
18,20,83,21,16,5
18,20,84,12,25,-13
18,20,85,1,13,-12
18,20,86,21,19,2
18,20,87,16,10,6
18,20,88,14,12,2
18,20,89,7,8,-1
18,20,90,7,11,-4
18,20,91,17,17,0
18,20,92,13,10,3
18,20,93,9,11,-2
18,20,94,9,12,-3
18,20,95,25,15,10
18,20,96,14,24,-10
18,20,97,22,10,12
18,20,98,17,18,-1
18,20,99,14,16,-2
18,20,100,12,20,-8
18,20,101,17,17,0
18,20,102,21,15,6
18,20,103,16,16,0
18,20,104,16,16,0
18,20,105,12,15,-3
18,20,106,12,8,4
18,20,107,24,20,4
18,20,108,16,18,-2
18,20,109,18,10,8
18,20,110,16,14,2
18,20,111,11,9,2
18,20,112,12,17,-5
18,20,113,19,20,-1
18,20,114,17,10,7
18,20,115,10,15,-5
18,20,116,12,14,-2
18,20,117,10,17,-7
18,20,118,7,8,-1
18,20,119,10,15,-5
18,20,120,9,19,-10
18,20,121,4,9,-5
18,20,122,5,9,-4
18,20,123,13,19,-6
18,20,124,9,15,-6
18,20,125,13,14,-1
18,20,126,8,5,3
18,20,127,12,14,-2
18,20,128,9,8,1
18,20,129,4,11,-7
18,20,130,13,13,0
18,20,131,10,22,-12
18,20,132,14,6,8
18,20,133,18,15,3
18,20,134,17,9,8
18,20,135,9,15,-6
18,20,136,10,12,-2
18,20,137,10,22,-12
18,20,138,10,12,-2
18,20,139,7,19,-12
18,20,140,13,13,0
18,20,141,9,10,-1
18,20,142,22,7,15
18,20,143,8,9,-1
18,20,144,21,15,6
18,20,145,31,13,18
18,20,146,19,17,2
18,20,147,13,13,0
18,20,148,30,11,19
18,20,149,3,14,-11
18,20,150,10,21,-11
18,20,151,11,14,-3
18,20,152,15,15,0
18,20,153,7,16,-9
18,20,154,15,19,-4
18,20,155,18,16,2
18,20,156,15,22,-7
18,20,157,12,8,4
18,20,158,15,16,-1
18,20,159,14,24,-10
18,20,160,11,14,-3
18,20,161,18,11,7
18,20,162,10,8,2
18,20,163,16,13,3
18,20,164,9,33,-24
18,20,165,9,8,1
18,20,166,20,19,1
18,20,167,21,30,-9
18,20,168,16,24,-8
18,20,169,17,14,3
18,20,170,15,7,8
18,20,171,15,10,5
18,20,172,9,7,2
18,20,173,10,11,-1
18,20,174,16,16,0
18,20,175,16,14,2
18,20,176,27,27,0
18,20,177,20,22,-2
18,20,178,21,22,-1
18,20,179,8,16,-8
18,20,180,12,19,-7
18,20,181,17,8,9
18,20,182,8,16,-8
18,20,183,22,13,9
18,20,184,17,12,5
18,20,185,16,23,-7
18,20,186,15,14,1
18,20,187,14,10,4
18,20,188,15,14,1
18,20,189,15,13,2
18,20,190,15,4,11
18,20,191,24,19,5
18,20,192,8,18,-10
18,20,193,16,14,2
18,20,194,18,12,6
18,20,195,11,9,2
18,20,196,5,19,-14
18,20,197,10,18,-8
18,20,198,10,8,2
18,20,199,6,11,-5
18,20,200,12,22,-10
18,20,201,9,8,1
18,20,202,11,16,-5
18,20,203,14,9,5
18,20,204,10,12,-2
18,20,205,22,10,12
18,20,206,16,14,2
18,20,207,11,20,-9
18,20,208,10,10,0
18,20,209,13,16,-3
18,20,210,17,22,-5
18,20,211,16,6,10
18,20,212,15,16,-1
18,20,213,15,20,-5
18,20,214,23,17,6
18,20,215,16,10,6
18,20,216,16,21,-5
18,20,217,13,19,-6
18,20,218,14,6,8
18,20,219,17,14,3
18,20,220,11,12,-1
18,20,221,8,18,-10
18,20,222,7,11,-4
18,20,223,14,9,5
18,20,224,9,2,7
18,20,225,24,13,11
18,20,226,11,10,1
18,20,227,29,18,11
18,20,228,18,24,-6
18,20,229,17,16,1
18,20,230,10,21,-11
18,20,231,17,17,0
18,20,232,10,13,-3
18,20,233,21,9,12
18,20,234,21,16,5
18,20,235,11,12,-1
18,20,236,16,16,0
18,20,237,9,12,-3
18,20,238,15,23,-8
18,20,239,3,11,-8
18,20,240,18,24,-6
18,20,241,17,18,-1
18,20,242,7,16,-9
18,20,243,26,10,16
18,20,244,14,14,0
18,20,245,10,14,-4
18,20,246,17,29,-12
18,20,247,28,12,16
18,20,248,11,20,-9
18,20,249,21,26,-5
18,20,250,7,13,-6
18,20,251,12,10,2
18,20,252,15,16,-1
18,20,253,19,12,7
18,20,254,11,27,-16
18,20,255,17,20,-3
18,20,256,15,22,-7
18,20,257,5,11,-6
18,20,258,14,17,-3
18,20,259,18,7,11
18,20,260,20,27,-7
18,20,261,8,18,-10
18,20,262,12,4,8
18,20,263,26,26,0
18,20,264,15,12,3
18,20,265,8,24,-16
18,20,266,20,10,10
18,20,267,23,21,2
18,20,268,21,20,1
18,20,269,12,23,-11
18,20,270,12,10,2
18,20,271,17,7,10
18,20,272,18,18,0
18,20,273,14,19,-5
18,20,274,12,19,-7
18,20,275,8,13,-5
18,20,276,12,9,3
18,20,277,9,15,-6
18,20,278,7,13,-6
18,20,279,11,23,-12
18,20,280,6,12,-6
18,20,281,12,16,-4
18,20,282,20,27,-7
18,20,283,24,18,6
18,20,284,12,21,-9
18,20,285,16,11,5
18,20,286,20,17,3
18,20,287,20,22,-2
18,20,288,9,15,-6
18,20,289,27,19,8
18,20,290,12,10,2
18,20,291,24,25,-1
18,20,292,19,3,16
18,20,293,4,10,-6
18,20,294,14,8,6
18,20,295,21,19,2
18,20,296,14,14,0
18,20,297,24,16,8
18,20,298,14,13,1
18,20,299,14,24,-10
18,21,0,27,18,9
18,21,1,21,16,5
18,21,2,11,12,-1
18,21,3,13,11,2
18,21,4,14,22,-8
18,21,5,18,7,11
18,21,6,18,8,10
18,21,7,24,10,14
18,21,8,12,9,3
18,21,9,15,21,-6
18,21,10,25,9,16
18,21,11,13,11,2
18,21,12,18,18,0
18,21,13,24,24,0
18,21,14,19,5,14
18,21,15,14,23,-9
18,21,16,10,18,-8
18,21,17,16,33,-17
18,21,18,12,28,-16
18,21,19,21,28,-7
18,21,20,15,19,-4
18,21,21,12,10,2
18,21,22,13,12,1
18,21,23,6,11,-5
18,21,24,11,8,3
18,21,25,7,14,-7
18,21,26,9,12,-3
18,21,27,5,10,-5
18,21,28,12,30,-18
18,21,29,5,10,-5
18,21,30,14,19,-5
18,21,31,10,18,-8
18,21,32,19,26,-7
18,21,33,19,20,-1
18,21,34,11,20,-9
18,21,35,18,16,2
18,21,36,12,8,4
18,21,37,4,8,-4
18,21,38,15,10,5
18,21,39,11,12,-1
18,21,40,22,29,-7
18,21,41,7,6,1
18,21,42,18,8,10
18,21,43,9,11,-2
18,21,44,13,9,4
18,21,45,16,11,5
18,21,46,20,27,-7
18,21,47,26,20,6
18,21,48,15,14,1
18,21,49,15,14,1
18,21,50,8,14,-6
18,21,51,15,14,1
18,21,52,7,9,-2
18,21,53,12,1,11
18,21,54,11,19,-8
18,21,55,22,17,5
18,21,56,14,14,0
18,21,57,4,14,-10
18,21,58,16,11,5
18,21,59,4,12,-8
18,21,60,6,8,-2
18,21,61,10,27,-17
18,21,62,17,22,-5
18,21,63,17,17,0
18,21,64,12,20,-8
18,21,65,8,10,-2
18,21,66,4,17,-13
18,21,67,11,13,-2
18,21,68,13,9,4
18,21,69,11,8,3
18,21,70,21,19,2
18,21,71,26,13,13
18,21,72,16,22,-6
18,21,73,18,15,3
18,21,74,8,15,-7
18,21,75,16,9,7
18,21,76,11,5,6
18,21,77,10,19,-9
18,21,78,11,18,-7
18,21,79,15,12,3
18,21,80,17,19,-2
18,21,81,5,12,-7
18,21,82,14,12,2
18,21,83,11,8,3
18,21,84,20,20,0
18,21,85,13,25,-12
18,21,86,6,16,-10
18,21,87,11,15,-4
18,21,88,17,9,8
18,21,89,17,16,1
18,21,90,7,14,-7
18,21,91,18,8,10
18,21,92,11,13,-2
18,21,93,8,10,-2
18,21,94,23,35,-12
18,21,95,12,10,2
18,21,96,24,19,5
18,21,97,15,14,1
18,21,98,18,8,10
18,21,99,18,11,7
18,21,100,20,32,-12
18,21,101,22,23,-1
18,21,102,7,19,-12
18,21,103,17,16,1
18,21,104,12,13,-1
18,21,105,18,16,2
18,21,106,13,19,-6
18,21,107,13,13,0
18,21,108,19,26,-7
18,21,109,18,23,-5
18,21,110,9,19,-10
18,21,111,16,10,6
18,21,112,10,10,0
18,21,113,17,11,6
18,21,114,13,17,-4
18,21,115,10,20,-10
18,21,116,27,19,8
18,21,117,24,11,13
18,21,118,8,7,1
18,21,119,19,15,4
18,21,120,14,22,-8
18,21,121,23,19,4
18,21,122,4,15,-11
18,21,123,6,16,-10
18,21,124,21,21,0
18,21,125,18,15,3
18,21,126,18,9,9
18,21,127,12,8,4
18,21,128,9,10,-1
18,21,129,7,15,-8
18,21,130,19,23,-4
18,21,131,18,28,-10
18,21,132,4,10,-6
18,21,133,10,20,-10
18,21,134,9,19,-10
18,21,135,16,27,-11
18,21,136,20,13,7
18,21,137,13,23,-10
18,21,138,28,24,4
18,21,139,21,9,12
18,21,140,24,8,16
18,21,141,13,9,4
18,21,142,17,6,11
18,21,143,19,15,4
18,21,144,16,14,2
18,21,145,4,8,-4
18,21,146,17,13,4
18,21,147,17,25,-8
18,21,148,19,13,6
18,21,149,12,6,6
18,21,150,16,3,13
18,21,151,19,13,6
18,21,152,23,21,2
18,21,153,11,8,3
18,21,154,16,21,-5
18,21,155,32,16,16
18,21,156,23,20,3
18,21,157,13,12,1
18,21,158,18,13,5
18,21,159,6,8,-2
18,21,160,17,12,5
18,21,161,15,21,-6
18,21,162,24,24,0
18,21,163,15,23,-8
18,21,164,11,10,1
18,21,165,24,13,11
18,21,166,5,23,-18
18,21,167,3,10,-7
18,21,168,27,21,6
18,21,169,12,10,2
18,21,170,17,20,-3
18,21,171,22,15,7
18,21,172,11,8,3
18,21,173,15,17,-2
18,21,174,6,20,-14
18,21,175,20,20,0
18,21,176,17,10,7
18,21,177,13,19,-6
18,21,178,11,16,-5
18,21,179,11,16,-5
18,21,180,13,15,-2
18,21,181,5,12,-7
18,21,182,23,30,-7
18,21,183,10,12,-2
18,21,184,11,8,3
18,21,185,18,19,-1
18,21,186,17,23,-6
18,21,187,15,7,8
18,21,188,7,19,-12
18,21,189,17,22,-5
18,21,190,12,26,-14
18,21,191,15,11,4
18,21,192,15,14,1
18,21,193,7,6,1
18,21,194,19,38,-19
18,21,195,12,39,-27
18,21,196,5,7,-2
18,21,197,21,17,4
18,21,198,22,17,5
18,21,199,9,17,-8
18,21,200,10,9,1
18,21,201,17,18,-1
18,21,202,4,13,-9
18,21,203,15,9,6
18,21,204,18,19,-1
18,21,205,10,22,-12
18,21,206,9,9,0
18,21,207,13,23,-10
18,21,208,11,7,4
18,21,209,9,15,-6
18,21,210,23,13,10
18,21,211,9,22,-13
18,21,212,11,15,-4
18,21,213,18,13,5
18,21,214,14,11,3
18,21,215,23,18,5
18,21,216,11,7,4
18,21,217,8,3,5
18,21,218,23,27,-4
18,21,219,28,14,14
18,21,220,13,13,0
18,21,221,7,6,1
18,21,222,12,9,3
18,21,223,12,7,5
18,21,224,17,16,1
18,21,225,12,11,1
18,21,226,24,20,4
18,21,227,15,10,5
18,21,228,15,27,-12
18,21,229,17,15,2
18,21,230,10,13,-3
18,21,231,15,18,-3
18,21,232,10,18,-8
18,21,233,15,6,9
18,21,234,26,18,8
18,21,235,18,13,5
18,21,236,9,13,-4
18,21,237,10,17,-7
18,21,238,20,20,0
18,21,239,24,12,12
18,21,240,16,18,-2
18,21,241,24,11,13
18,21,242,27,7,20
18,21,243,11,9,2
18,21,244,11,10,1
18,21,245,23,7,16
18,21,246,11,19,-8
18,21,247,16,15,1
18,21,248,11,26,-15
18,21,249,24,11,13
18,21,250,21,25,-4
18,21,251,7,14,-7
18,21,252,15,18,-3
18,21,253,18,14,4
18,21,254,6,17,-11
18,21,255,15,17,-2
18,21,256,17,20,-3
18,21,257,8,26,-18
18,21,258,7,27,-20
18,21,259,6,27,-21
18,21,260,9,20,-11
18,21,261,11,13,-2
18,21,262,15,14,1
18,21,263,16,14,2
18,21,264,14,11,3
18,21,265,10,12,-2
18,21,266,16,19,-3
18,21,267,11,29,-18
18,21,268,17,26,-9
18,21,269,26,26,0
18,21,270,28,23,5
18,21,271,18,25,-7
18,21,272,16,15,1
18,21,273,15,12,3
18,21,274,22,12,10
18,21,275,25,17,8
18,21,276,19,13,6
18,21,277,19,21,-2
18,21,278,24,13,11
18,21,279,9,12,-3
18,21,280,23,17,6
18,21,281,14,9,5
18,21,282,11,6,5
18,21,283,14,9,5
18,21,284,21,17,4
18,21,285,12,12,0
18,21,286,20,24,-4
18,21,287,11,18,-7
18,21,288,19,8,11
18,21,289,20,11,9
18,21,290,16,13,3
18,21,291,20,12,8
18,21,292,7,14,-7
18,21,293,15,13,2
18,21,294,9,11,-2
18,21,295,13,19,-6
18,21,296,23,19,4
18,21,297,13,18,-5
18,21,298,6,5,1
18,21,299,13,19,-6
18,22,0,11,8,3
18,22,1,13,18,-5
18,22,2,15,23,-8
18,22,3,10,10,0
18,22,4,6,8,-2
18,22,5,12,17,-5
18,22,6,8,3,5
18,22,7,3,10,-7
18,22,8,15,12,3
18,22,9,11,23,-12
18,22,10,26,23,3
18,22,11,20,22,-2
18,22,12,23,23,0
18,22,13,17,21,-4
18,22,14,13,7,6
18,22,15,24,12,12
18,22,16,16,14,2
18,22,17,17,8,9
18,22,18,23,15,8
18,22,19,16,8,8
18,22,20,19,8,11
18,22,21,18,32,-14
18,22,22,15,11,4
18,22,23,8,21,-13
18,22,24,6,4,2
18,22,25,9,18,-9
18,22,26,5,17,-12
18,22,27,19,17,2
18,22,28,19,17,2
18,22,29,12,17,-5
18,22,30,21,13,8
18,22,31,14,19,-5
18,22,32,28,20,8
18,22,33,5,6,-1
18,22,34,15,17,-2
18,22,35,17,12,5
18,22,36,8,13,-5
18,22,37,16,13,3
18,22,38,5,11,-6
18,22,39,16,8,8
18,22,40,8,16,-8
18,22,41,16,12,4
18,22,42,15,13,2
18,22,43,18,16,2
18,22,44,19,26,-7
18,22,45,8,6,2
18,22,46,14,11,3
18,22,47,8,13,-5
18,22,48,12,8,4
18,22,49,8,5,3
18,22,50,17,11,6
18,22,51,16,13,3
18,22,52,12,21,-9
18,22,53,9,17,-8
18,22,54,15,20,-5
18,22,55,17,9,8
18,22,56,7,8,-1
18,22,57,18,20,-2
18,22,58,21,16,5
18,22,59,8,15,-7
18,22,60,0,20,-20
18,22,61,21,6,15
18,22,62,12,16,-4
18,22,63,15,14,1
18,22,64,9,13,-4
18,22,65,7,8,-1
18,22,66,13,38,-25
18,22,67,8,13,-5
18,22,68,15,11,4
18,22,69,13,20,-7
18,22,70,12,21,-9
18,22,71,15,13,2
18,22,72,14,30,-16
18,22,73,8,16,-8
18,22,74,7,19,-12
18,22,75,12,17,-5
18,22,76,19,28,-9
18,22,77,15,16,-1
18,22,78,6,9,-3
18,22,79,26,21,5
18,22,80,7,7,0
18,22,81,13,14,-1
18,22,82,14,8,6
18,22,83,18,27,-9
18,22,84,30,17,13
18,22,85,22,17,5
18,22,86,10,14,-4
18,22,87,8,10,-2
18,22,88,17,18,-1
18,22,89,16,13,3
18,22,90,12,16,-4
18,22,91,9,13,-4
18,22,92,6,21,-15
18,22,93,14,10,4
18,22,94,18,19,-1
18,22,95,18,19,-1
18,22,96,20,10,10
18,22,97,6,13,-7
18,22,98,18,18,0
18,22,99,21,13,8
18,22,100,16,23,-7
18,22,101,14,16,-2
18,22,102,27,26,1
18,22,103,11,12,-1
18,22,104,10,11,-1
18,22,105,17,16,1
18,22,106,11,21,-10
18,22,107,8,4,4
18,22,108,10,12,-2
18,22,109,11,22,-11
18,22,110,12,18,-6
18,22,111,15,31,-16
18,22,112,15,13,2
18,22,113,17,23,-6
18,22,114,9,12,-3
18,22,115,11,13,-2
18,22,116,8,20,-12
18,22,117,10,12,-2
18,22,118,12,11,1
18,22,119,9,9,0
18,22,120,27,22,5
18,22,121,12,16,-4
18,22,122,5,3,2
18,22,123,11,13,-2
18,22,124,20,16,4
18,22,125,18,18,0
18,22,126,20,10,10
18,22,127,10,14,-4
18,22,128,12,13,-1
18,22,129,14,14,0
18,22,130,8,11,-3
18,22,131,19,11,8
18,22,132,10,4,6
18,22,133,7,4,3
18,22,134,15,10,5
18,22,135,6,24,-18
18,22,136,21,14,7
18,22,137,12,12,0
18,22,138,9,13,-4
18,22,139,17,15,2
18,22,140,8,19,-11
18,22,141,15,13,2
18,22,142,23,18,5
18,22,143,17,24,-7
18,22,144,10,17,-7
18,22,145,18,8,10
18,22,146,25,12,13
18,22,147,16,16,0
18,22,148,14,28,-14
18,22,149,16,15,1
18,22,150,11,12,-1
18,22,151,18,18,0
18,22,152,20,15,5
18,22,153,17,13,4
18,22,154,14,14,0
18,22,155,29,24,5
18,22,156,27,14,13
18,22,157,18,21,-3
18,22,158,11,20,-9
18,22,159,16,21,-5
18,22,160,16,11,5
18,22,161,13,7,6
18,22,162,6,20,-14
18,22,163,11,13,-2
18,22,164,21,20,1
18,22,165,22,20,2
18,22,166,5,11,-6
18,22,167,6,10,-4
18,22,168,19,9,10
18,22,169,18,28,-10
18,22,170,11,12,-1
18,22,171,9,8,1
18,22,172,12,10,2
18,22,173,18,17,1
18,22,174,26,13,13
18,22,175,13,21,-8
18,22,176,24,29,-5
18,22,177,11,13,-2
18,22,178,11,5,6
18,22,179,21,18,3
18,22,180,15,22,-7
18,22,181,16,14,2
18,22,182,6,12,-6
18,22,183,8,11,-3
18,22,184,17,14,3
18,22,185,9,18,-9
18,22,186,13,14,-1
18,22,187,3,4,-1
18,22,188,14,12,2
18,22,189,16,16,0
18,22,190,20,14,6
18,22,191,14,19,-5
18,22,192,12,11,1
18,22,193,13,8,5
18,22,194,25,14,11
18,22,195,10,9,1
18,22,196,7,12,-5
18,22,197,16,10,6
18,22,198,12,19,-7
18,22,199,11,24,-13
18,22,200,25,15,10
18,22,201,6,12,-6
18,22,202,14,9,5
18,22,203,28,25,3
18,22,204,15,15,0
18,22,205,23,15,8
18,22,206,18,15,3
18,22,207,15,39,-24
18,22,208,9,19,-10
18,22,209,14,37,-23
18,22,210,27,18,9
18,22,211,16,18,-2
18,22,212,8,20,-12
18,22,213,20,17,3
18,22,214,14,17,-3
18,22,215,16,20,-4
18,22,216,3,18,-15
18,22,217,16,7,9
18,22,218,28,13,15
18,22,219,15,10,5
18,22,220,7,12,-5
18,22,221,13,10,3
18,22,222,9,11,-2
18,22,223,12,12,0
18,22,224,27,12,15
18,22,225,19,24,-5
18,22,226,24,22,2
18,22,227,20,16,4
18,22,228,16,6,10
18,22,229,14,10,4
18,22,230,12,10,2
18,22,231,12,14,-2
18,22,232,14,12,2
18,22,233,17,19,-2
18,22,234,17,17,0
18,22,235,19,11,8
18,22,236,14,3,11
18,22,237,4,5,-1
18,22,238,5,8,-3
18,22,239,20,22,-2
18,22,240,15,6,9
18,22,241,17,22,-5
18,22,242,20,10,10
18,22,243,5,7,-2
18,22,244,16,12,4
18,22,245,15,11,4
18,22,246,17,20,-3
18,22,247,8,17,-9
18,22,248,10,7,3
18,22,249,36,21,15
18,22,250,9,13,-4
18,22,251,28,20,8
18,22,252,10,17,-7
18,22,253,20,13,7
18,22,254,16,20,-4
18,22,255,14,19,-5
18,22,256,24,13,11
18,22,257,9,8,1
18,22,258,13,7,6
18,22,259,19,18,1
18,22,260,15,24,-9
18,22,261,9,10,-1
18,22,262,17,7,10
18,22,263,19,23,-4
18,22,264,8,7,1
18,22,265,17,9,8
18,22,266,24,19,5
18,22,267,18,16,2
18,22,268,18,18,0
18,22,269,17,14,3
18,22,270,10,20,-10
18,22,271,25,11,14
18,22,272,12,20,-8
18,22,273,18,22,-4
18,22,274,8,9,-1
18,22,275,24,13,11
18,22,276,13,11,2
18,22,277,14,8,6
18,22,278,18,33,-15
18,22,279,11,13,-2
18,22,280,22,25,-3
18,22,281,11,21,-10
18,22,282,30,15,15
18,22,283,16,17,-1
18,22,284,23,14,9
18,22,285,19,15,4
18,22,286,8,8,0
18,22,287,4,15,-11
18,22,288,6,20,-14
18,22,289,9,18,-9
18,22,290,9,16,-7
18,22,291,22,19,3
18,22,292,17,19,-2
18,22,293,13,15,-2
18,22,294,7,20,-13
18,22,295,5,5,0
18,22,296,21,16,5
18,22,297,26,10,16
18,22,298,11,15,-4
18,22,299,23,14,9
18,23,0,12,18,-6
18,23,1,28,19,9
18,23,2,16,16,0
18,23,3,6,18,-12
18,23,4,14,5,9
18,23,5,6,9,-3
18,23,6,5,9,-4
18,23,7,10,8,2
18,23,8,12,12,0
18,23,9,12,24,-12
18,23,10,13,17,-4
18,23,11,17,16,1
18,23,12,15,29,-14
18,23,13,8,6,2
18,23,14,34,22,12
18,23,15,7,9,-2
18,23,16,24,21,3
18,23,17,17,18,-1
18,23,18,20,9,11
18,23,19,21,17,4
18,23,20,13,5,8
18,23,21,8,15,-7
18,23,22,23,22,1
18,23,23,13,6,7
18,23,24,6,6,0
18,23,25,17,9,8
18,23,26,16,18,-2
18,23,27,15,12,3
18,23,28,20,29,-9
18,23,29,4,20,-16
18,23,30,10,5,5
18,23,31,20,6,14
18,23,32,27,15,12
18,23,33,7,8,-1
18,23,34,26,17,9
18,23,35,20,18,2
18,23,36,22,17,5
18,23,37,20,19,1
18,23,38,8,14,-6
18,23,39,17,16,1
18,23,40,19,15,4
18,23,41,5,8,-3
18,23,42,18,17,1
18,23,43,24,12,12
18,23,44,13,20,-7
18,23,45,17,16,1
18,23,46,24,26,-2
18,23,47,8,9,-1
18,23,48,20,15,5
18,23,49,19,12,7
18,23,50,31,12,19
18,23,51,14,17,-3
18,23,52,20,12,8
18,23,53,13,17,-4
18,23,54,16,17,-1
18,23,55,22,31,-9
18,23,56,26,23,3
18,23,57,10,17,-7
18,23,58,18,22,-4
18,23,59,16,13,3
18,23,60,18,19,-1
18,23,61,11,11,0
18,23,62,12,6,6
18,23,63,4,15,-11
18,23,64,15,11,4
18,23,65,11,12,-1
18,23,66,6,5,1
18,23,67,24,15,9
18,23,68,18,17,1
18,23,69,24,19,5
18,23,70,13,9,4
18,23,71,13,15,-2
18,23,72,21,14,7
18,23,73,5,2,3
18,23,74,22,7,15
18,23,75,10,10,0
18,23,76,15,20,-5
18,23,77,25,12,13
18,23,78,11,3,8
18,23,79,13,22,-9
18,23,80,27,26,1
18,23,81,8,18,-10
18,23,82,9,16,-7
18,23,83,13,8,5
18,23,84,20,17,3
18,23,85,21,19,2
18,23,86,8,12,-4
18,23,87,23,14,9
18,23,88,5,23,-18
18,23,89,20,13,7
18,23,90,19,14,5
18,23,91,10,16,-6
18,23,92,14,14,0
18,23,93,8,17,-9
18,23,94,6,6,0
18,23,95,13,15,-2
18,23,96,18,11,7
18,23,97,15,22,-7
18,23,98,21,10,11
18,23,99,14,11,3
18,23,100,23,23,0
18,23,101,8,15,-7
18,23,102,16,8,8
18,23,103,10,16,-6
18,23,104,19,15,4
18,23,105,15,32,-17
18,23,106,6,8,-2
18,23,107,5,9,-4
18,23,108,16,20,-4
18,23,109,9,11,-2
18,23,110,17,9,8
18,23,111,13,18,-5
18,23,112,41,19,22
18,23,113,17,11,6
18,23,114,17,5,12
18,23,115,8,17,-9
18,23,116,10,5,5
18,23,117,14,15,-1
18,23,118,13,17,-4
18,23,119,7,17,-10
18,23,120,13,29,-16
18,23,121,10,13,-3
18,23,122,22,26,-4
18,23,123,24,15,9
18,23,124,19,15,4
18,23,125,32,24,8
18,23,126,20,17,3
18,23,127,22,29,-7
18,23,128,14,24,-10
18,23,129,29,20,9
18,23,130,14,8,6
18,23,131,11,11,0
18,23,132,13,16,-3
18,23,133,9,15,-6
18,23,134,7,7,0
18,23,135,17,19,-2
18,23,136,18,20,-2
18,23,137,19,5,14
18,23,138,11,9,2
18,23,139,11,20,-9
18,23,140,22,8,14
18,23,141,16,11,5
18,23,142,8,7,1
18,23,143,11,9,2
18,23,144,9,10,-1
18,23,145,21,14,7
18,23,146,22,27,-5
18,23,147,9,9,0
18,23,148,23,22,1
18,23,149,24,13,11
18,23,150,13,15,-2
18,23,151,6,13,-7
18,23,152,22,13,9
18,23,153,17,15,2
18,23,154,22,18,4
18,23,155,11,8,3
18,23,156,12,9,3
18,23,157,7,20,-13
18,23,158,8,10,-2
18,23,159,19,17,2
18,23,160,21,15,6
18,23,161,16,19,-3
18,23,162,13,9,4
18,23,163,16,8,8
18,23,164,17,7,10
18,23,165,17,10,7
18,23,166,26,18,8
18,23,167,12,23,-11
18,23,168,11,9,2
18,23,169,14,18,-4
18,23,170,26,11,15
18,23,171,16,19,-3
18,23,172,14,6,8
18,23,173,23,16,7
18,23,174,14,8,6
18,23,175,17,9,8
18,23,176,9,11,-2
18,23,177,13,6,7
18,23,178,14,21,-7
18,23,179,17,16,1
18,23,180,20,12,8
18,23,181,19,4,15
18,23,182,16,18,-2
18,23,183,11,10,1
18,23,184,9,20,-11
18,23,185,17,13,4
18,23,186,8,18,-10
18,23,187,25,11,14
18,23,188,11,14,-3
18,23,189,12,6,6
18,23,190,19,12,7
18,23,191,19,25,-6
18,23,192,13,12,1
18,23,193,10,4,6
18,23,194,26,20,6
18,23,195,23,6,17
18,23,196,21,25,-4
18,23,197,16,6,10
18,23,198,12,13,-1
18,23,199,7,9,-2
18,23,200,11,16,-5
18,23,201,17,19,-2
18,23,202,24,21,3
18,23,203,29,36,-7
18,23,204,17,3,14
18,23,205,20,14,6
18,23,206,23,12,11
18,23,207,13,17,-4
18,23,208,6,19,-13
18,23,209,13,9,4
18,23,210,12,15,-3
18,23,211,7,17,-10
18,23,212,13,22,-9
18,23,213,0,6,-6
18,23,214,27,19,8
18,23,215,7,9,-2
18,23,216,15,23,-8
18,23,217,12,6,6
18,23,218,15,14,1
18,23,219,11,15,-4
18,23,220,9,9,0
18,23,221,15,17,-2
18,23,222,8,24,-16
18,23,223,14,16,-2
18,23,224,16,15,1
18,23,225,18,10,8
18,23,226,15,11,4
18,23,227,14,20,-6
18,23,228,18,9,9
18,23,229,5,14,-9
18,23,230,10,8,2
18,23,231,8,19,-11
18,23,232,23,14,9
18,23,233,18,12,6
18,23,234,14,23,-9
18,23,235,8,21,-13
18,23,236,9,6,3
18,23,237,17,8,9
18,23,238,13,6,7
18,23,239,22,11,11
18,23,240,20,15,5
18,23,241,8,6,2
18,23,242,6,24,-18
18,23,243,15,11,4
18,23,244,15,14,1
18,23,245,17,10,7
18,23,246,24,15,9
18,23,247,14,17,-3
18,23,248,25,20,5
18,23,249,23,14,9
18,23,250,11,11,0
18,23,251,19,20,-1
18,23,252,18,12,6
18,23,253,20,14,6
18,23,254,11,22,-11
18,23,255,8,10,-2
18,23,256,13,12,1
18,23,257,14,19,-5
18,23,258,11,22,-11
18,23,259,8,10,-2
18,23,260,19,12,7
18,23,261,18,13,5
18,23,262,10,13,-3
18,23,263,12,8,4
18,23,264,18,14,4
18,23,265,18,7,11
18,23,266,15,12,3
18,23,267,13,8,5
18,23,268,17,8,9
18,23,269,17,11,6
18,23,270,22,26,-4
18,23,271,20,14,6
18,23,272,12,18,-6
18,23,273,25,14,11
18,23,274,5,5,0
18,23,275,5,10,-5
18,23,276,17,27,-10
18,23,277,14,7,7
18,23,278,12,9,3
18,23,279,10,5,5
18,23,280,19,12,7
18,23,281,18,16,2
18,23,282,8,9,-1
18,23,283,23,15,8
18,23,284,14,17,-3
18,23,285,17,23,-6
18,23,286,16,15,1
18,23,287,17,14,3
18,23,288,8,13,-5
18,23,289,17,16,1
18,23,290,14,9,5
18,23,291,17,12,5
18,23,292,16,7,9
18,23,293,16,15,1
18,23,294,20,18,2
18,23,295,22,4,18
18,23,296,16,18,-2
18,23,297,22,10,12
18,23,298,15,11,4
18,23,299,15,10,5
18,24,0,17,8,9
18,24,1,18,18,0
18,24,2,6,18,-12
18,24,3,22,17,5
18,24,4,7,7,0
18,24,5,10,9,1
18,24,6,16,18,-2
18,24,7,11,9,2
18,24,8,16,13,3
18,24,9,5,8,-3
18,24,10,17,11,6
18,24,11,20,24,-4
18,24,12,6,12,-6
18,24,13,33,23,10
18,24,14,15,12,3
18,24,15,23,13,10
18,24,16,9,9,0
18,24,17,22,16,6
18,24,18,6,14,-8
18,24,19,10,14,-4
18,24,20,14,10,4
18,24,21,13,12,1
18,24,22,19,14,5
18,24,23,21,14,7
18,24,24,12,7,5
18,24,25,21,20,1
18,24,26,12,8,4
18,24,27,9,25,-16
18,24,28,11,12,-1
18,24,29,16,10,6
18,24,30,18,17,1
18,24,31,8,19,-11
18,24,32,9,12,-3
18,24,33,15,11,4
18,24,34,11,16,-5
18,24,35,17,8,9
18,24,36,19,13,6
18,24,37,21,26,-5
18,24,38,14,25,-11
18,24,39,16,23,-7
18,24,40,23,23,0
18,24,41,9,10,-1
18,24,42,27,7,20
18,24,43,25,22,3
18,24,44,17,17,0
18,24,45,24,22,2
18,24,46,4,14,-10
18,24,47,12,10,2
18,24,48,14,12,2
18,24,49,17,7,10
18,24,50,19,15,4
18,24,51,15,15,0
18,24,52,11,16,-5
18,24,53,15,15,0
18,24,54,13,6,7
18,24,55,10,14,-4
18,24,56,9,7,2
18,24,57,9,17,-8
18,24,58,13,24,-11
18,24,59,25,15,10
18,24,60,10,4,6
18,24,61,13,18,-5
18,24,62,14,9,5
18,24,63,9,17,-8
18,24,64,12,15,-3
18,24,65,31,6,25
18,24,66,7,21,-14
18,24,67,15,7,8
18,24,68,19,20,-1
18,24,69,6,3,3
18,24,70,8,11,-3
18,24,71,11,14,-3
18,24,72,8,28,-20
18,24,73,16,16,0
18,24,74,24,14,10
18,24,75,11,24,-13
18,24,76,15,8,7
18,24,77,13,13,0
18,24,78,18,20,-2
18,24,79,5,14,-9
18,24,80,10,5,5
18,24,81,14,14,0
18,24,82,7,6,1
18,24,83,10,17,-7
18,24,84,13,12,1
18,24,85,10,12,-2
18,24,86,13,8,5
18,24,87,8,17,-9
18,24,88,10,32,-22
18,24,89,10,11,-1
18,24,90,24,22,2
18,24,91,19,14,5
18,24,92,9,12,-3
18,24,93,13,13,0
18,24,94,11,8,3
18,24,95,23,16,7
18,24,96,23,14,9
18,24,97,5,13,-8
18,24,98,8,14,-6
18,24,99,20,12,8
18,24,100,27,16,11
18,24,101,14,12,2
18,24,102,11,19,-8
18,24,103,12,15,-3
18,24,104,28,15,13
18,24,105,19,10,9
18,24,106,11,16,-5
18,24,107,10,20,-10
18,24,108,14,11,3
18,24,109,14,11,3
18,24,110,18,18,0
18,24,111,21,24,-3
18,24,112,18,6,12
18,24,113,16,5,11
18,24,114,17,2,15
18,24,115,24,14,10
18,24,116,16,19,-3
18,24,117,21,14,7
18,24,118,18,10,8
18,24,119,22,10,12
18,24,120,9,6,3
18,24,121,14,18,-4
18,24,122,25,14,11
18,24,123,25,18,7
18,24,124,10,9,1
18,24,125,14,15,-1
18,24,126,20,17,3
18,24,127,17,6,11
18,24,128,18,15,3
18,24,129,23,4,19
18,24,130,8,8,0
18,24,131,9,25,-16
18,24,132,20,15,5
18,24,133,4,10,-6
18,24,134,14,14,0
18,24,135,13,8,5
18,24,136,10,10,0
18,24,137,7,19,-12
18,24,138,11,17,-6
18,24,139,15,4,11
18,24,140,16,27,-11
18,24,141,11,17,-6
18,24,142,15,11,4
18,24,143,13,9,4
18,24,144,12,20,-8
18,24,145,18,19,-1
18,24,146,28,17,11
18,24,147,18,5,13
18,24,148,13,11,2
18,24,149,10,9,1
18,24,150,17,13,4
18,24,151,12,12,0
18,24,152,20,9,11
18,24,153,23,23,0
18,24,154,13,19,-6
18,24,155,11,16,-5
18,24,156,12,14,-2
18,24,157,21,19,2
18,24,158,16,2,14
18,24,159,10,8,2
18,24,160,14,14,0
18,24,161,12,10,2
18,24,162,33,8,25
18,24,163,18,11,7
18,24,164,15,11,4
18,24,165,15,22,-7
18,24,166,21,9,12
18,24,167,15,10,5
18,24,168,20,29,-9
18,24,169,25,14,11
18,24,170,25,12,13
18,24,171,22,12,10
18,24,172,10,13,-3
18,24,173,5,16,-11
18,24,174,28,16,12
18,24,175,15,8,7
18,24,176,1,6,-5
18,24,177,1,6,-5
18,24,178,11,4,7
18,24,179,20,11,9
18,24,180,14,15,-1
18,24,181,13,24,-11
18,24,182,19,13,6
18,24,183,16,15,1
18,24,184,11,22,-11
18,24,185,18,19,-1
18,24,186,16,20,-4
18,24,187,1,7,-6
18,24,188,8,18,-10
18,24,189,22,16,6
18,24,190,10,13,-3
18,24,191,21,10,11
18,24,192,21,11,10
18,24,193,7,13,-6
18,24,194,21,16,5
18,24,195,4,4,0
18,24,196,17,22,-5
18,24,197,11,10,1
18,24,198,17,14,3
18,24,199,14,12,2
18,24,200,7,4,3
18,24,201,28,12,16
18,24,202,16,12,4
18,24,203,10,10,0
18,24,204,25,17,8
18,24,205,10,13,-3
18,24,206,11,6,5
18,24,207,23,9,14
18,24,208,11,19,-8
18,24,209,12,14,-2
18,24,210,9,10,-1
18,24,211,24,9,15
18,24,212,22,20,2
18,24,213,16,18,-2
18,24,214,18,8,10
18,24,215,9,13,-4
18,24,216,19,7,12
18,24,217,13,16,-3
18,24,218,30,8,22
18,24,219,22,17,5
18,24,220,8,9,-1
18,24,221,12,13,-1
18,24,222,15,14,1
18,24,223,23,17,6
18,24,224,16,17,-1
18,24,225,6,12,-6
18,24,226,9,18,-9
18,24,227,16,17,-1
18,24,228,15,11,4
18,24,229,17,13,4
18,24,230,15,13,2
18,24,231,21,24,-3
18,24,232,3,9,-6
18,24,233,25,18,7
18,24,234,11,10,1
18,24,235,11,14,-3
18,24,236,17,7,10
18,24,237,21,17,4
18,24,238,18,9,9
18,24,239,35,14,21
18,24,240,13,22,-9
18,24,241,13,7,6
18,24,242,17,10,7
18,24,243,15,27,-12
18,24,244,9,27,-18
18,24,245,5,3,2
18,24,246,13,12,1
18,24,247,12,20,-8
18,24,248,17,6,11
18,24,249,12,13,-1
18,24,250,20,25,-5
18,24,251,6,7,-1
18,24,252,12,17,-5
18,24,253,12,20,-8
18,24,254,9,7,2
18,24,255,19,10,9
18,24,256,18,11,7
18,24,257,18,18,0
18,24,258,15,9,6
18,24,259,20,22,-2
18,24,260,5,22,-17
18,24,261,22,9,13
18,24,262,13,10,3
18,24,263,16,9,7
18,24,264,9,14,-5
18,24,265,15,9,6
18,24,266,9,15,-6
18,24,267,15,12,3
18,24,268,19,20,-1
18,24,269,15,16,-1
18,24,270,19,11,8
18,24,271,24,17,7
18,24,272,16,6,10
18,24,273,18,21,-3
18,24,274,33,12,21
18,24,275,10,17,-7
18,24,276,8,9,-1
18,24,277,27,16,11
18,24,278,8,3,5
18,24,279,5,10,-5
18,24,280,16,8,8
18,24,281,15,17,-2
18,24,282,14,15,-1
18,24,283,13,15,-2
18,24,284,15,13,2
18,24,285,12,20,-8
18,24,286,9,11,-2
18,24,287,13,8,5
18,24,288,8,12,-4
18,24,289,27,14,13
18,24,290,9,9,0
18,24,291,11,15,-4
18,24,292,18,12,6
18,24,293,10,17,-7
18,24,294,16,19,-3
18,24,295,18,18,0
18,24,296,9,13,-4
18,24,297,4,13,-9
18,24,298,6,7,-1
18,24,299,24,21,3
18,25,0,16,15,1
18,25,1,18,9,9
18,25,2,18,14,4
18,25,3,19,13,6
18,25,4,16,31,-15
18,25,5,18,15,3
18,25,6,11,11,0
18,25,7,5,16,-11
18,25,8,15,16,-1
18,25,9,10,9,1
18,25,10,12,16,-4
18,25,11,16,8,8
18,25,12,26,10,16
18,25,13,26,20,6
18,25,14,14,15,-1
18,25,15,10,14,-4
18,25,16,20,25,-5
18,25,17,9,13,-4
18,25,18,19,21,-2
18,25,19,10,19,-9
18,25,20,20,21,-1
18,25,21,18,5,13
18,25,22,16,18,-2
18,25,23,15,16,-1
18,25,24,9,5,4
18,25,25,13,19,-6
18,25,26,15,15,0
18,25,27,18,9,9
18,25,28,11,9,2
18,25,29,7,7,0
18,25,30,23,20,3
18,25,31,23,20,3
18,25,32,12,11,1
18,25,33,16,14,2
18,25,34,26,17,9
18,25,35,12,12,0
18,25,36,13,10,3
18,25,37,15,10,5
18,25,38,16,10,6
18,25,39,19,19,0
18,25,40,10,7,3
18,25,41,11,8,3
18,25,42,26,23,3
18,25,43,7,8,-1
18,25,44,10,16,-6
18,25,45,19,7,12
18,25,46,15,8,7
18,25,47,21,15,6
18,25,48,21,19,2
18,25,49,12,23,-11
18,25,50,17,19,-2
18,25,51,13,18,-5
18,25,52,7,7,0
18,25,53,9,7,2
18,25,54,11,8,3
18,25,55,9,21,-12
18,25,56,13,10,3
18,25,57,21,24,-3
18,25,58,12,8,4
18,25,59,8,11,-3
18,25,60,19,18,1
18,25,61,16,14,2
18,25,62,16,24,-8
18,25,63,23,18,5
18,25,64,14,16,-2
18,25,65,15,9,6
18,25,66,12,6,6
18,25,67,15,14,1
18,25,68,20,9,11
18,25,69,10,5,5
18,25,70,29,17,12
18,25,71,25,16,9
18,25,72,7,13,-6
18,25,73,15,7,8
18,25,74,12,21,-9
18,25,75,19,29,-10
18,25,76,17,13,4
18,25,77,23,13,10
18,25,78,19,19,0
18,25,79,19,24,-5
18,25,80,15,4,11
18,25,81,23,25,-2
18,25,82,13,13,0
18,25,83,12,19,-7
18,25,84,11,26,-15
18,25,85,15,6,9
18,25,86,16,24,-8
18,25,87,20,14,6
18,25,88,14,15,-1
18,25,89,12,19,-7
18,25,90,20,19,1
18,25,91,17,9,8
18,25,92,21,12,9
18,25,93,3,2,1
18,25,94,9,25,-16
18,25,95,16,15,1
18,25,96,14,24,-10
18,25,97,6,3,3
18,25,98,14,23,-9
18,25,99,12,6,6
18,25,100,13,23,-10
18,25,101,10,15,-5
18,25,102,17,20,-3
18,25,103,28,13,15
18,25,104,20,24,-4
18,25,105,15,11,4
18,25,106,14,11,3
18,25,107,18,17,1
18,25,108,21,11,10
18,25,109,9,12,-3
18,25,110,10,13,-3
18,25,111,8,9,-1
18,25,112,9,11,-2
18,25,113,15,14,1
18,25,114,20,9,11
18,25,115,18,6,12
18,25,116,13,14,-1
18,25,117,20,4,16
18,25,118,27,8,19
18,25,119,13,10,3
18,25,120,14,14,0
18,25,121,15,17,-2
18,25,122,17,3,14
18,25,123,13,11,2
18,25,124,22,21,1
18,25,125,16,20,-4
18,25,126,12,12,0
18,25,127,8,7,1
18,25,128,11,13,-2
18,25,129,12,7,5
18,25,130,22,15,7
18,25,131,10,12,-2
18,25,132,16,9,7
18,25,133,22,18,4
18,25,134,13,11,2
18,25,135,15,9,6
18,25,136,12,12,0
18,25,137,12,10,2
18,25,138,16,17,-1
18,25,139,19,11,8
18,25,140,28,22,6
18,25,141,10,18,-8
18,25,142,9,7,2
18,25,143,9,19,-10
18,25,144,20,7,13
18,25,145,23,9,14
18,25,146,20,19,1
18,25,147,13,14,-1
18,25,148,34,12,22
18,25,149,9,19,-10
18,25,150,14,10,4
18,25,151,16,7,9
18,25,152,24,33,-9
18,25,153,8,17,-9
18,25,154,23,20,3
18,25,155,24,12,12
18,25,156,12,1,11
18,25,157,16,12,4
18,25,158,11,9,2
18,25,159,10,11,-1
18,25,160,22,3,19
18,25,161,21,18,3
18,25,162,18,23,-5
18,25,163,9,11,-2
18,25,164,12,13,-1
18,25,165,16,16,0
18,25,166,29,18,11
18,25,167,16,19,-3
18,25,168,17,15,2
18,25,169,8,16,-8
18,25,170,10,9,1
18,25,171,11,15,-4
18,25,172,20,11,9
18,25,173,12,9,3
18,25,174,20,14,6
18,25,175,17,20,-3
18,25,176,15,4,11
18,25,177,8,26,-18
18,25,178,25,13,12
18,25,179,19,16,3
18,25,180,19,14,5
18,25,181,10,6,4
18,25,182,17,6,11
18,25,183,9,12,-3
18,25,184,10,9,1
18,25,185,16,7,9
18,25,186,15,17,-2
18,25,187,10,5,5
18,25,188,12,4,8
18,25,189,17,4,13
18,25,190,14,12,2
18,25,191,21,11,10
18,25,192,12,12,0
18,25,193,13,8,5
18,25,194,7,6,1
18,25,195,11,11,0
18,25,196,11,13,-2
18,25,197,13,12,1
18,25,198,20,16,4
18,25,199,16,14,2
18,25,200,18,18,0
18,25,201,11,16,-5
18,25,202,14,7,7
18,25,203,15,11,4
18,25,204,19,12,7
18,25,205,17,8,9
18,25,206,10,14,-4
18,25,207,9,16,-7
18,25,208,27,10,17
18,25,209,12,19,-7
18,25,210,17,23,-6
18,25,211,9,13,-4
18,25,212,22,22,0
18,25,213,7,7,0
18,25,214,9,4,5
18,25,215,12,20,-8
18,25,216,14,19,-5
18,25,217,16,8,8
18,25,218,13,10,3
18,25,219,25,12,13
18,25,220,27,20,7
18,25,221,8,7,1
18,25,222,15,14,1
18,25,223,10,11,-1
18,25,224,11,8,3
18,25,225,22,15,7
18,25,226,10,16,-6
18,25,227,6,11,-5
18,25,228,7,14,-7
18,25,229,9,9,0
18,25,230,17,14,3
18,25,231,10,12,-2
18,25,232,20,24,-4
18,25,233,13,16,-3
18,25,234,7,5,2
18,25,235,10,4,6
18,25,236,13,16,-3
18,25,237,18,20,-2
18,25,238,17,12,5
18,25,239,8,10,-2
18,25,240,28,17,11
18,25,241,10,10,0
18,25,242,10,16,-6
18,25,243,9,7,2
18,25,244,15,25,-10
18,25,245,7,12,-5
18,25,246,14,29,-15
18,25,247,13,11,2
18,25,248,8,14,-6
18,25,249,7,10,-3
18,25,250,17,11,6
18,25,251,16,25,-9
18,25,252,12,27,-15
18,25,253,13,26,-13
18,25,254,25,13,12
18,25,255,15,13,2
18,25,256,22,11,11
18,25,257,13,18,-5
18,25,258,20,12,8
18,25,259,17,16,1
18,25,260,11,9,2
18,25,261,12,14,-2
18,25,262,14,11,3
18,25,263,16,9,7
18,25,264,14,9,5
18,25,265,19,7,12
18,25,266,10,10,0
18,25,267,22,12,10
18,25,268,4,5,-1
18,25,269,22,16,6
18,25,270,8,8,0
18,25,271,23,12,11
18,25,272,9,14,-5
18,25,273,16,14,2
18,25,274,22,17,5
18,25,275,10,10,0
18,25,276,20,27,-7
18,25,277,12,13,-1
18,25,278,20,15,5
18,25,279,16,17,-1
18,25,280,10,13,-3
18,25,281,19,16,3
18,25,282,21,17,4
18,25,283,20,18,2
18,25,284,23,19,4
18,25,285,21,16,5
18,25,286,20,25,-5
18,25,287,14,12,2
18,25,288,26,7,19
18,25,289,15,18,-3
18,25,290,8,15,-7
18,25,291,14,23,-9
18,25,292,21,9,12
18,25,293,4,7,-3
18,25,294,11,5,6
18,25,295,15,15,0
18,25,296,15,6,9
18,25,297,11,16,-5
18,25,298,18,26,-8
18,25,299,11,17,-6
18,26,0,20,20,0
18,26,1,27,25,2
18,26,2,13,18,-5
18,26,3,13,19,-6
18,26,4,22,13,9
18,26,5,13,13,0
18,26,6,6,7,-1
18,26,7,6,17,-11
18,26,8,7,12,-5
18,26,9,24,18,6
18,26,10,10,18,-8
18,26,11,16,18,-2
18,26,12,13,4,9
18,26,13,20,11,9
18,26,14,19,13,6
18,26,15,14,22,-8
18,26,16,13,11,2
18,26,17,15,12,3
18,26,18,17,15,2
18,26,19,25,26,-1
18,26,20,15,13,2
18,26,21,12,8,4
18,26,22,10,18,-8
18,26,23,20,15,5
18,26,24,13,14,-1
18,26,25,14,21,-7
18,26,26,27,11,16
18,26,27,13,21,-8
18,26,28,10,15,-5
18,26,29,16,5,11
18,26,30,13,15,-2
18,26,31,21,21,0
18,26,32,23,24,-1
18,26,33,15,10,5
18,26,34,18,15,3
18,26,35,12,16,-4
18,26,36,15,14,1
18,26,37,25,10,15
18,26,38,15,8,7
18,26,39,18,18,0
18,26,40,19,18,1
18,26,41,12,12,0
18,26,42,15,20,-5
18,26,43,27,7,20
18,26,44,11,16,-5
18,26,45,22,10,12
18,26,46,18,13,5
18,26,47,23,22,1
18,26,48,17,13,4
18,26,49,19,11,8
18,26,50,12,10,2
18,26,51,15,10,5
18,26,52,24,18,6
18,26,53,33,18,15
18,26,54,9,8,1
18,26,55,14,16,-2
18,26,56,8,7,1
18,26,57,20,12,8
18,26,58,19,3,16
18,26,59,20,11,9
18,26,60,20,14,6
18,26,61,16,28,-12
18,26,62,16,6,10
18,26,63,11,14,-3
18,26,64,25,9,16
18,26,65,11,17,-6
18,26,66,32,19,13
18,26,67,12,8,4
18,26,68,23,11,12
18,26,69,23,8,15
18,26,70,14,14,0
18,26,71,10,13,-3
18,26,72,26,26,0
18,26,73,14,7,7
18,26,74,18,21,-3
18,26,75,14,18,-4
18,26,76,19,11,8
18,26,77,23,18,5
18,26,78,19,11,8
18,26,79,12,11,1
18,26,80,22,13,9
18,26,81,8,15,-7
18,26,82,15,7,8
18,26,83,17,12,5
18,26,84,17,12,5
18,26,85,13,12,1
18,26,86,18,10,8
18,26,87,23,16,7
18,26,88,16,13,3
18,26,89,15,15,0
18,26,90,15,16,-1
18,26,91,9,7,2
18,26,92,17,15,2
18,26,93,23,9,14
18,26,94,17,11,6
18,26,95,6,9,-3
18,26,96,18,17,1
18,26,97,24,17,7
18,26,98,25,12,13
18,26,99,17,14,3
18,26,100,12,6,6
18,26,101,12,9,3
18,26,102,15,12,3
18,26,103,8,9,-1
18,26,104,27,26,1
18,26,105,16,18,-2
18,26,106,16,11,5
18,26,107,1,7,-6
18,26,108,15,11,4
18,26,109,13,18,-5
18,26,110,12,10,2
18,26,111,8,9,-1
18,26,112,20,5,15
18,26,113,13,12,1
18,26,114,14,16,-2
18,26,115,13,12,1
18,26,116,9,16,-7
18,26,117,15,13,2
18,26,118,12,26,-14
18,26,119,19,17,2
18,26,120,7,12,-5
18,26,121,19,14,5
18,26,122,17,18,-1
18,26,123,13,12,1
18,26,124,10,11,-1
18,26,125,10,12,-2
18,26,126,11,13,-2
18,26,127,10,12,-2
18,26,128,12,15,-3
18,26,129,15,19,-4
18,26,130,20,13,7
18,26,131,16,11,5
18,26,132,14,13,1
18,26,133,17,10,7
18,26,134,16,14,2
18,26,135,15,23,-8
18,26,136,13,14,-1
18,26,137,14,13,1
18,26,138,19,13,6
18,26,139,9,13,-4
18,26,140,22,14,8
18,26,141,14,6,8
18,26,142,17,14,3
18,26,143,17,15,2
18,26,144,21,5,16
18,26,145,10,17,-7
18,26,146,19,22,-3
18,26,147,23,14,9
18,26,148,21,7,14
18,26,149,6,11,-5
18,26,150,18,8,10
18,26,151,25,9,16
18,26,152,8,14,-6
18,26,153,9,6,3
18,26,154,19,15,4
18,26,155,17,9,8
18,26,156,14,8,6
18,26,157,15,15,0
18,26,158,17,23,-6
18,26,159,12,9,3
18,26,160,10,7,3
18,26,161,11,13,-2
18,26,162,17,20,-3
18,26,163,16,17,-1
18,26,164,11,18,-7
18,26,165,21,12,9
18,26,166,6,7,-1
18,26,167,10,9,1
18,26,168,17,8,9
18,26,169,10,7,3
18,26,170,15,9,6
18,26,171,10,4,6
18,26,172,13,24,-11
18,26,173,10,12,-2
18,26,174,17,8,9
18,26,175,17,19,-2
18,26,176,14,18,-4
18,26,177,13,14,-1
18,26,178,10,17,-7
18,26,179,11,13,-2
18,26,180,10,1,9
18,26,181,12,14,-2
18,26,182,14,17,-3
18,26,183,18,19,-1
18,26,184,11,10,1
18,26,185,10,12,-2
18,26,186,15,10,5
18,26,187,13,14,-1
18,26,188,1,5,-4
18,26,189,25,20,5
18,26,190,18,10,8
18,26,191,14,8,6
18,26,192,12,12,0
18,26,193,15,17,-2
18,26,194,30,23,7
18,26,195,17,9,8
18,26,196,14,18,-4
18,26,197,18,7,11
18,26,198,4,4,0
18,26,199,14,18,-4
18,26,200,23,18,5
18,26,201,15,12,3
18,26,202,10,4,6
18,26,203,14,11,3
18,26,204,18,12,6
18,26,205,15,22,-7
18,26,206,9,15,-6
18,26,207,19,12,7
18,26,208,17,10,7
18,26,209,12,18,-6
18,26,210,16,19,-3
18,26,211,9,3,6
18,26,212,25,18,7
18,26,213,16,3,13
18,26,214,13,11,2
18,26,215,8,9,-1
18,26,216,13,14,-1
18,26,217,13,9,4
18,26,218,17,16,1
18,26,219,12,17,-5
18,26,220,14,14,0
18,26,221,13,18,-5
18,26,222,15,13,2
18,26,223,10,12,-2
18,26,224,13,13,0
18,26,225,19,25,-6
18,26,226,18,14,4
18,26,227,16,16,0
18,26,228,6,12,-6
18,26,229,20,16,4
18,26,230,20,13,7
18,26,231,18,18,0
18,26,232,6,6,0
18,26,233,20,16,4
18,26,234,10,10,0
18,26,235,22,12,10
18,26,236,18,22,-4
18,26,237,18,15,3
18,26,238,15,11,4
18,26,239,13,11,2
18,26,240,26,21,5
18,26,241,12,8,4
18,26,242,12,9,3
18,26,243,17,7,10
18,26,244,18,19,-1
18,26,245,13,8,5
18,26,246,15,14,1
18,26,247,24,9,15
18,26,248,18,7,11
18,26,249,18,18,0
18,26,250,14,4,10
18,26,251,17,12,5
18,26,252,21,22,-1
18,26,253,10,15,-5
18,26,254,18,11,7
18,26,255,20,13,7
18,26,256,12,13,-1
18,26,257,24,25,-1
18,26,258,17,7,10
18,26,259,12,12,0
18,26,260,19,12,7
18,26,261,6,9,-3
18,26,262,7,2,5
18,26,263,17,6,11
18,26,264,7,17,-10
18,26,265,10,13,-3
18,26,266,19,15,4
18,26,267,8,21,-13
18,26,268,14,17,-3
18,26,269,14,17,-3
18,26,270,19,11,8
18,26,271,4,11,-7
18,26,272,15,14,1
18,26,273,16,10,6
18,26,274,10,5,5
18,26,275,17,7,10
18,26,276,22,17,5
18,26,277,26,20,6
18,26,278,4,3,1
18,26,279,19,14,5
18,26,280,14,10,4
18,26,281,26,11,15
18,26,282,14,9,5
18,26,283,19,8,11
18,26,284,13,13,0
18,26,285,8,11,-3
18,26,286,19,4,15
18,26,287,8,12,-4
18,26,288,8,16,-8
18,26,289,16,6,10
18,26,290,24,6,18
18,26,291,18,20,-2
18,26,292,18,8,10
18,26,293,8,9,-1
18,26,294,3,9,-6
18,26,295,6,6,0
18,26,296,15,22,-7
18,26,297,19,7,12
18,26,298,11,8,3
18,26,299,15,15,0
18,27,0,29,15,14
18,27,1,23,20,3
18,27,2,17,17,0
18,27,3,29,13,16
18,27,4,19,21,-2
18,27,5,18,12,6
18,27,6,16,8,8
18,27,7,16,12,4
18,27,8,11,12,-1
18,27,9,13,10,3
18,27,10,7,5,2
18,27,11,21,10,11
18,27,12,20,18,2
18,27,13,18,5,13
18,27,14,27,8,19
18,27,15,8,8,0
18,27,16,11,18,-7
18,27,17,20,12,8
18,27,18,22,4,18
18,27,19,8,17,-9
18,27,20,12,17,-5
18,27,21,13,17,-4
18,27,22,28,9,19
18,27,23,27,11,16
18,27,24,24,23,1
18,27,25,29,21,8
18,27,26,12,17,-5
18,27,27,8,7,1
18,27,28,7,18,-11
18,27,29,14,21,-7
18,27,30,19,19,0
18,27,31,12,19,-7
18,27,32,11,9,2
18,27,33,19,15,4
18,27,34,15,14,1
18,27,35,1,11,-10
18,27,36,4,13,-9
18,27,37,9,8,1
18,27,38,12,18,-6
18,27,39,9,12,-3
18,27,40,2,9,-7
18,27,41,17,13,4
18,27,42,20,5,15
18,27,43,12,10,2
18,27,44,21,8,13
18,27,45,9,8,1
18,27,46,7,6,1
18,27,47,25,14,11
18,27,48,13,8,5
18,27,49,8,13,-5
18,27,50,16,11,5
18,27,51,23,16,7
18,27,52,3,12,-9
18,27,53,15,26,-11
18,27,54,12,10,2
18,27,55,15,4,11
18,27,56,17,15,2
18,27,57,20,20,0
18,27,58,15,12,3
18,27,59,14,22,-8
18,27,60,21,17,4
18,27,61,13,3,10
18,27,62,10,12,-2
18,27,63,24,15,9
18,27,64,25,10,15
18,27,65,14,12,2
18,27,66,21,11,10
18,27,67,18,20,-2
18,27,68,15,17,-2
18,27,69,16,10,6
18,27,70,28,7,21
18,27,71,20,16,4
18,27,72,11,14,-3
18,27,73,14,13,1
18,27,74,17,12,5
18,27,75,14,8,6
18,27,76,8,4,4
18,27,77,12,15,-3
18,27,78,7,14,-7
18,27,79,4,9,-5
18,27,80,22,11,11
18,27,81,10,6,4
18,27,82,13,11,2
18,27,83,15,20,-5
18,27,84,10,12,-2
18,27,85,21,19,2
18,27,86,15,10,5
18,27,87,20,14,6
18,27,88,10,15,-5
18,27,89,17,17,0
18,27,90,18,17,1
18,27,91,15,10,5
18,27,92,5,7,-2
18,27,93,15,18,-3
18,27,94,8,18,-10
18,27,95,15,10,5
18,27,96,12,15,-3
18,27,97,17,16,1
18,27,98,9,14,-5
18,27,99,5,7,-2
18,27,100,17,23,-6
18,27,101,11,17,-6
18,27,102,25,18,7
18,27,103,11,17,-6
18,27,104,17,7,10
18,27,105,6,8,-2
18,27,106,17,14,3
18,27,107,15,15,0
18,27,108,12,3,9
18,27,109,6,10,-4
18,27,110,6,10,-4
18,27,111,9,8,1
18,27,112,18,9,9
18,27,113,22,15,7
18,27,114,11,9,2
18,27,115,15,20,-5
18,27,116,6,6,0
18,27,117,8,12,-4
18,27,118,24,21,3
18,27,119,8,17,-9
18,27,120,7,6,1
18,27,121,11,0,11
18,27,122,17,10,7
18,27,123,13,11,2
18,27,124,19,10,9
18,27,125,13,14,-1
18,27,126,6,13,-7
18,27,127,20,14,6
18,27,128,16,14,2
18,27,129,9,11,-2
18,27,130,19,11,8
18,27,131,17,15,2
18,27,132,11,18,-7
18,27,133,13,21,-8
18,27,134,10,23,-13
18,27,135,11,15,-4
18,27,136,27,9,18
18,27,137,12,26,-14
18,27,138,7,14,-7
18,27,139,17,14,3
18,27,140,22,11,11
18,27,141,20,11,9
18,27,142,12,7,5
18,27,143,6,10,-4
18,27,144,19,8,11
18,27,145,19,19,0
18,27,146,9,15,-6
18,27,147,8,6,2
18,27,148,14,4,10
18,27,149,17,19,-2
18,27,150,26,3,23
18,27,151,15,19,-4
18,27,152,15,7,8
18,27,153,20,18,2
18,27,154,22,17,5
18,27,155,13,15,-2
18,27,156,18,17,1
18,27,157,16,14,2
18,27,158,29,16,13
18,27,159,6,8,-2
18,27,160,7,9,-2
18,27,161,18,8,10
18,27,162,18,4,14
18,27,163,17,13,4
18,27,164,7,7,0
18,27,165,10,18,-8
18,27,166,36,25,11
18,27,167,17,16,1
18,27,168,21,18,3
18,27,169,11,11,0
18,27,170,12,20,-8
18,27,171,17,11,6
18,27,172,8,10,-2
18,27,173,6,14,-8
18,27,174,17,19,-2
18,27,175,17,16,1
18,27,176,15,12,3
18,27,177,21,12,9
18,27,178,25,19,6
18,27,179,8,11,-3
18,27,180,16,15,1
18,27,181,7,7,0
18,27,182,26,28,-2
18,27,183,24,17,7
18,27,184,9,5,4
18,27,185,12,8,4
18,27,186,25,16,9
18,27,187,24,22,2
18,27,188,10,10,0
18,27,189,16,6,10
18,27,190,17,17,0
18,27,191,6,3,3
18,27,192,15,21,-6
18,27,193,13,14,-1
18,27,194,18,8,10
18,27,195,24,11,13
18,27,196,22,17,5
18,27,197,28,20,8
18,27,198,9,11,-2
18,27,199,11,14,-3
18,27,200,5,7,-2
18,27,201,12,7,5
18,27,202,14,11,3
18,27,203,20,17,3
18,27,204,10,7,3
18,27,205,15,7,8
18,27,206,24,16,8
18,27,207,9,17,-8
18,27,208,27,10,17
18,27,209,22,21,1
18,27,210,25,19,6
18,27,211,17,16,1
18,27,212,16,14,2
18,27,213,10,15,-5
18,27,214,16,8,8
18,27,215,12,17,-5
18,27,216,7,7,0
18,27,217,29,20,9
18,27,218,21,23,-2
18,27,219,15,14,1
18,27,220,13,13,0
18,27,221,25,18,7
18,27,222,15,12,3
18,27,223,22,14,8
18,27,224,14,4,10
18,27,225,15,6,9
18,27,226,21,23,-2
18,27,227,17,14,3
18,27,228,15,15,0
18,27,229,21,6,15
18,27,230,4,15,-11
18,27,231,17,21,-4
18,27,232,11,12,-1
18,27,233,30,22,8
18,27,234,12,8,4
18,27,235,14,17,-3
18,27,236,7,2,5
18,27,237,8,17,-9
18,27,238,17,9,8
18,27,239,19,18,1
18,27,240,8,11,-3
18,27,241,16,9,7
18,27,242,10,16,-6
18,27,243,18,9,9
18,27,244,18,5,13
18,27,245,9,9,0
18,27,246,27,18,9
18,27,247,15,17,-2
18,27,248,18,25,-7
18,27,249,20,17,3
18,27,250,16,8,8
18,27,251,20,16,4
18,27,252,8,14,-6
18,27,253,16,7,9
18,27,254,11,6,5
18,27,255,21,5,16
18,27,256,24,6,18
18,27,257,20,14,6
18,27,258,11,14,-3
18,27,259,18,9,9
18,27,260,7,5,2
18,27,261,11,32,-21
18,27,262,5,5,0
18,27,263,10,22,-12
18,27,264,13,10,3
18,27,265,19,12,7
18,27,266,6,9,-3
18,27,267,7,8,-1
18,27,268,15,11,4
18,27,269,11,15,-4
18,27,270,21,14,7
18,27,271,20,15,5
18,27,272,25,19,6
18,27,273,22,10,12
18,27,274,25,15,10
18,27,275,11,12,-1
18,27,276,13,27,-14
18,27,277,16,7,9
18,27,278,11,12,-1
18,27,279,6,10,-4
18,27,280,21,15,6
18,27,281,21,14,7
18,27,282,29,11,18
18,27,283,24,11,13
18,27,284,16,11,5
18,27,285,5,12,-7
18,27,286,15,10,5
18,27,287,22,15,7
18,27,288,19,12,7
18,27,289,24,26,-2
18,27,290,14,12,2
18,27,291,8,6,2
18,27,292,14,9,5
18,27,293,7,9,-2
18,27,294,10,15,-5
18,27,295,15,22,-7
18,27,296,21,5,16
18,27,297,11,17,-6
18,27,298,12,8,4
18,27,299,19,16,3
18,28,0,16,7,9
18,28,1,26,15,11
18,28,2,12,17,-5
18,28,3,13,10,3
18,28,4,7,11,-4
18,28,5,17,12,5
18,28,6,31,17,14
18,28,7,14,19,-5
18,28,8,11,6,5
18,28,9,22,22,0
18,28,10,15,16,-1
18,28,11,14,6,8
18,28,12,9,11,-2
18,28,13,14,9,5
18,28,14,20,9,11
18,28,15,27,17,10
18,28,16,19,13,6
18,28,17,8,13,-5
18,28,18,13,11,2
18,28,19,7,10,-3
18,28,20,9,13,-4
18,28,21,11,11,0
18,28,22,18,11,7
18,28,23,18,24,-6
18,28,24,19,3,16
18,28,25,13,11,2
18,28,26,14,9,5
18,28,27,17,18,-1
18,28,28,9,4,5
18,28,29,14,19,-5
18,28,30,15,12,3
18,28,31,18,20,-2
18,28,32,15,15,0
18,28,33,18,11,7
18,28,34,13,8,5
18,28,35,19,29,-10
18,28,36,3,7,-4
18,28,37,13,8,5
18,28,38,22,18,4
18,28,39,19,13,6
18,28,40,23,21,2
18,28,41,9,9,0
18,28,42,10,9,1
18,28,43,21,15,6
18,28,44,18,17,1
18,28,45,15,16,-1
18,28,46,27,15,12
18,28,47,8,13,-5
18,28,48,12,9,3
18,28,49,15,14,1
18,28,50,20,14,6
18,28,51,25,14,11
18,28,52,21,20,1
18,28,53,12,20,-8
18,28,54,11,24,-13
18,28,55,3,10,-7
18,28,56,13,7,6
18,28,57,11,10,1
18,28,58,14,12,2
18,28,59,15,19,-4
18,28,60,18,9,9
18,28,61,14,14,0
18,28,62,25,14,11
18,28,63,29,22,7
18,28,64,15,13,2
18,28,65,19,12,7
18,28,66,8,6,2
18,28,67,16,10,6
18,28,68,22,27,-5
18,28,69,9,3,6
18,28,70,31,18,13
18,28,71,29,15,14
18,28,72,23,19,4
18,28,73,21,14,7
18,28,74,14,11,3
18,28,75,18,24,-6
18,28,76,27,17,10
18,28,77,17,16,1
18,28,78,7,14,-7
18,28,79,11,16,-5
18,28,80,9,9,0
18,28,81,23,12,11
18,28,82,24,13,11
18,28,83,5,8,-3
18,28,84,14,17,-3
18,28,85,15,13,2
18,28,86,18,19,-1
18,28,87,20,17,3
18,28,88,21,19,2
18,28,89,27,16,11
18,28,90,16,3,13
18,28,91,18,22,-4
18,28,92,6,5,1
18,28,93,19,11,8
18,28,94,21,13,8
18,28,95,33,13,20
18,28,96,15,14,1
18,28,97,15,7,8
18,28,98,16,6,10
18,28,99,15,11,4
18,28,100,26,10,16
18,28,101,15,13,2
18,28,102,6,11,-5
18,28,103,11,13,-2
18,28,104,13,11,2
18,28,105,13,15,-2
18,28,106,8,12,-4
18,28,107,18,9,9
18,28,108,15,21,-6
18,28,109,15,11,4
18,28,110,19,28,-9
18,28,111,22,15,7
18,28,112,15,3,12
18,28,113,12,19,-7
18,28,114,23,26,-3
18,28,115,7,9,-2
18,28,116,24,11,13
18,28,117,10,17,-7
18,28,118,13,11,2
18,28,119,31,14,17
18,28,120,20,28,-8
18,28,121,12,15,-3
18,28,122,25,10,15
18,28,123,14,22,-8
18,28,124,6,12,-6
18,28,125,9,12,-3
18,28,126,8,10,-2
18,28,127,17,9,8
18,28,128,7,13,-6
18,28,129,13,8,5
18,28,130,17,17,0
18,28,131,16,10,6
18,28,132,15,15,0
18,28,133,13,11,2
18,28,134,14,17,-3
18,28,135,23,19,4
18,28,136,11,13,-2
18,28,137,10,17,-7
18,28,138,15,11,4
18,28,139,14,14,0
18,28,140,14,18,-4
18,28,141,24,12,12
18,28,142,24,8,16
18,28,143,8,12,-4
18,28,144,9,9,0
18,28,145,12,20,-8
18,28,146,25,17,8
18,28,147,11,10,1
18,28,148,21,11,10
18,28,149,6,4,2
18,28,150,19,10,9
18,28,151,13,23,-10
18,28,152,11,14,-3
18,28,153,23,20,3
18,28,154,19,11,8
18,28,155,22,14,8
18,28,156,30,18,12
18,28,157,15,5,10
18,28,158,8,3,5
18,28,159,14,14,0
18,28,160,7,15,-8
18,28,161,6,8,-2
18,28,162,14,16,-2
18,28,163,20,12,8
18,28,164,17,6,11
18,28,165,14,13,1
18,28,166,14,13,1
18,28,167,17,18,-1
18,28,168,11,8,3
18,28,169,19,17,2
18,28,170,20,16,4
18,28,171,29,22,7
18,28,172,22,11,11
18,28,173,24,29,-5
18,28,174,11,10,1
18,28,175,14,9,5
18,28,176,28,13,15
18,28,177,15,17,-2
18,28,178,17,6,11
18,28,179,19,11,8
18,28,180,4,9,-5
18,28,181,18,17,1
18,28,182,15,10,5
18,28,183,10,9,1
18,28,184,6,13,-7
18,28,185,24,9,15
18,28,186,9,8,1
18,28,187,18,19,-1
18,28,188,18,8,10
18,28,189,33,10,23
18,28,190,16,21,-5
18,28,191,9,14,-5
18,28,192,8,16,-8
18,28,193,15,11,4
18,28,194,10,21,-11
18,28,195,29,11,18
18,28,196,13,6,7
18,28,197,12,11,1
18,28,198,13,13,0
18,28,199,6,2,4
18,28,200,18,13,5
18,28,201,14,14,0
18,28,202,22,14,8
18,28,203,16,6,10
18,28,204,28,17,11
18,28,205,23,16,7
18,28,206,12,6,6
18,28,207,12,6,6
18,28,208,12,10,2
18,28,209,23,11,12
18,28,210,13,11,2
18,28,211,9,2,7
18,28,212,8,12,-4
18,28,213,13,12,1
18,28,214,25,28,-3
18,28,215,12,13,-1
18,28,216,15,11,4
18,28,217,21,5,16
18,28,218,22,10,12
18,28,219,14,17,-3
18,28,220,8,6,2
18,28,221,7,13,-6
18,28,222,7,0,7
18,28,223,13,6,7
18,28,224,10,5,5
18,28,225,11,15,-4
18,28,226,9,8,1
18,28,227,20,10,10
18,28,228,14,9,5
18,28,229,15,12,3
18,28,230,10,8,2
18,28,231,9,2,7
18,28,232,19,19,0
18,28,233,10,10,0
18,28,234,9,14,-5
18,28,235,9,8,1
18,28,236,23,13,10
18,28,237,18,9,9
18,28,238,10,13,-3
18,28,239,15,13,2
18,28,240,18,14,4
18,28,241,10,9,1
18,28,242,13,14,-1
18,28,243,24,8,16
18,28,244,8,5,3
18,28,245,33,28,5
18,28,246,11,17,-6
18,28,247,19,22,-3
18,28,248,20,17,3
18,28,249,8,6,2
18,28,250,12,12,0
18,28,251,12,5,7
18,28,252,11,19,-8
18,28,253,12,17,-5
18,28,254,23,13,10
18,28,255,18,11,7
18,28,256,10,15,-5
18,28,257,18,10,8
18,28,258,13,18,-5
18,28,259,22,11,11
18,28,260,6,17,-11
18,28,261,19,14,5
18,28,262,17,17,0
18,28,263,9,12,-3
18,28,264,20,16,4
18,28,265,18,11,7
18,28,266,17,15,2
18,28,267,11,5,6
18,28,268,11,6,5
18,28,269,19,9,10
18,28,270,20,8,12
18,28,271,15,11,4
18,28,272,19,9,10
18,28,273,11,6,5
18,28,274,14,14,0
18,28,275,10,8,2
18,28,276,17,16,1
18,28,277,27,9,18
18,28,278,21,17,4
18,28,279,15,11,4
18,28,280,18,14,4
18,28,281,15,8,7
18,28,282,7,10,-3
18,28,283,13,6,7
18,28,284,14,16,-2
18,28,285,9,7,2
18,28,286,11,10,1
18,28,287,8,12,-4
18,28,288,18,9,9
18,28,289,14,23,-9
18,28,290,19,16,3
18,28,291,19,8,11
18,28,292,27,14,13
18,28,293,17,20,-3
18,28,294,16,15,1
18,28,295,13,13,0
18,28,296,14,14,0
18,28,297,10,22,-12
18,28,298,11,16,-5
18,28,299,16,18,-2
18,29,0,17,15,2
18,29,1,13,7,6
18,29,2,18,8,10
18,29,3,26,6,20
18,29,4,7,5,2
18,29,5,23,13,10
18,29,6,20,7,13
18,29,7,15,16,-1
18,29,8,13,7,6
18,29,9,22,10,12
18,29,10,22,17,5
18,29,11,8,10,-2
18,29,12,11,13,-2
18,29,13,17,15,2
18,29,14,17,12,5
18,29,15,7,9,-2
18,29,16,19,12,7
18,29,17,19,6,13
18,29,18,10,6,4
18,29,19,16,9,7
18,29,20,12,32,-20
18,29,21,14,9,5
18,29,22,14,8,6
18,29,23,16,14,2
18,29,24,13,13,0
18,29,25,7,8,-1
18,29,26,31,14,17
18,29,27,15,8,7
18,29,28,19,10,9
18,29,29,9,6,3
18,29,30,18,25,-7
18,29,31,16,10,6
18,29,32,8,9,-1
18,29,33,6,13,-7
18,29,34,17,23,-6
18,29,35,27,20,7
18,29,36,31,19,12
18,29,37,12,18,-6
18,29,38,17,9,8
18,29,39,11,7,4
18,29,40,16,13,3
18,29,41,8,11,-3
18,29,42,10,11,-1
18,29,43,9,25,-16
18,29,44,13,15,-2
18,29,45,19,13,6
18,29,46,12,26,-14
18,29,47,25,17,8
18,29,48,19,12,7
18,29,49,11,14,-3
18,29,50,15,29,-14
18,29,51,7,12,-5
18,29,52,16,20,-4
18,29,53,9,12,-3
18,29,54,11,20,-9
18,29,55,10,7,3
18,29,56,15,21,-6
18,29,57,28,12,16
18,29,58,22,10,12
18,29,59,16,7,9
18,29,60,9,17,-8
18,29,61,17,17,0
18,29,62,20,4,16
18,29,63,21,9,12
18,29,64,8,6,2
18,29,65,22,5,17
18,29,66,6,7,-1
18,29,67,9,18,-9
18,29,68,16,17,-1
18,29,69,11,14,-3
18,29,70,21,15,6
18,29,71,17,2,15
18,29,72,6,13,-7
18,29,73,7,7,0
18,29,74,19,15,4
18,29,75,12,10,2
18,29,76,29,22,7
18,29,77,19,12,7
18,29,78,10,9,1
18,29,79,6,12,-6
18,29,80,18,6,12
18,29,81,11,22,-11
18,29,82,26,10,16
18,29,83,23,13,10
18,29,84,18,13,5
18,29,85,14,10,4
18,29,86,11,11,0
18,29,87,17,15,2
18,29,88,25,8,17
18,29,89,12,20,-8
18,29,90,15,16,-1
18,29,91,17,12,5
18,29,92,16,16,0
18,29,93,12,13,-1
18,29,94,12,10,2
18,29,95,15,16,-1
18,29,96,16,14,2
18,29,97,12,11,1
18,29,98,15,3,12
18,29,99,28,15,13
18,29,100,17,12,5
18,29,101,18,5,13
18,29,102,10,13,-3
18,29,103,4,12,-8
18,29,104,11,4,7
18,29,105,29,17,12
18,29,106,22,19,3
18,29,107,16,15,1
18,29,108,18,16,2
18,29,109,23,5,18
18,29,110,10,10,0
18,29,111,11,15,-4
18,29,112,14,4,10
18,29,113,6,17,-11
18,29,114,23,23,0
18,29,115,10,9,1
18,29,116,17,11,6
18,29,117,11,10,1
18,29,118,13,12,1
18,29,119,23,12,11
18,29,120,6,16,-10
18,29,121,22,4,18
18,29,122,11,10,1
18,29,123,23,18,5
18,29,124,18,20,-2
18,29,125,16,17,-1
18,29,126,22,22,0
18,29,127,16,9,7
18,29,128,22,17,5
18,29,129,25,16,9
18,29,130,21,10,11
18,29,131,14,18,-4
18,29,132,15,17,-2
18,29,133,22,13,9
18,29,134,18,14,4
18,29,135,14,12,2
18,29,136,25,12,13
18,29,137,9,7,2
18,29,138,16,11,5
18,29,139,15,16,-1
18,29,140,15,8,7
18,29,141,15,23,-8
18,29,142,22,11,11
18,29,143,19,16,3
18,29,144,16,10,6
18,29,145,4,10,-6
18,29,146,15,12,3
18,29,147,13,14,-1
18,29,148,21,16,5
18,29,149,12,10,2
18,29,150,6,9,-3
18,29,151,21,21,0
18,29,152,25,11,14
18,29,153,15,15,0
18,29,154,22,11,11
18,29,155,17,14,3
18,29,156,13,12,1
18,29,157,15,11,4
18,29,158,24,15,9
18,29,159,24,8,16
18,29,160,17,16,1
18,29,161,21,6,15
18,29,162,8,7,1
18,29,163,18,12,6
18,29,164,16,9,7
18,29,165,12,4,8
18,29,166,21,11,10
18,29,167,14,9,5
18,29,168,21,18,3
18,29,169,24,7,17
18,29,170,5,5,0
18,29,171,15,23,-8
18,29,172,13,10,3
18,29,173,15,13,2
18,29,174,16,23,-7
18,29,175,11,12,-1
18,29,176,16,17,-1
18,29,177,13,12,1
18,29,178,10,16,-6
18,29,179,21,27,-6
18,29,180,10,14,-4
18,29,181,15,10,5
18,29,182,9,14,-5
18,29,183,15,4,11
18,29,184,14,9,5
18,29,185,27,21,6
18,29,186,17,21,-4
18,29,187,20,20,0
18,29,188,17,25,-8
18,29,189,22,9,13
18,29,190,9,10,-1
18,29,191,10,6,4
18,29,192,19,12,7
18,29,193,15,26,-11
18,29,194,13,29,-16
18,29,195,15,10,5
18,29,196,12,4,8
18,29,197,14,12,2
18,29,198,13,15,-2
18,29,199,20,23,-3
18,29,200,10,12,-2
18,29,201,13,14,-1
18,29,202,19,9,10
18,29,203,10,3,7
18,29,204,15,18,-3
18,29,205,16,13,3
18,29,206,3,9,-6
18,29,207,20,6,14
18,29,208,21,13,8
18,29,209,21,17,4
18,29,210,16,7,9
18,29,211,7,11,-4
18,29,212,16,7,9
18,29,213,21,5,16
18,29,214,13,17,-4
18,29,215,15,12,3
18,29,216,8,6,2
18,29,217,13,9,4
18,29,218,9,7,2
18,29,219,24,10,14
18,29,220,13,2,11
18,29,221,15,6,9
18,29,222,23,9,14
18,29,223,7,23,-16
18,29,224,8,4,4
18,29,225,10,4,6
18,29,226,10,7,3
18,29,227,17,16,1
18,29,228,6,10,-4
18,29,229,25,9,16
18,29,230,3,9,-6
18,29,231,11,12,-1
18,29,232,15,5,10
18,29,233,22,15,7
18,29,234,18,8,10
18,29,235,15,28,-13
18,29,236,30,11,19
18,29,237,10,16,-6
18,29,238,20,16,4
18,29,239,14,14,0
18,29,240,4,6,-2
18,29,241,8,10,-2
18,29,242,10,5,5
18,29,243,23,10,13
18,29,244,32,23,9
18,29,245,27,12,15
18,29,246,7,18,-11
18,29,247,2,2,0
18,29,248,7,16,-9
18,29,249,14,6,8
18,29,250,26,10,16
18,29,251,4,8,-4
18,29,252,13,5,8
18,29,253,19,7,12
18,29,254,20,13,7
18,29,255,15,14,1
18,29,256,8,6,2
18,29,257,12,16,-4
18,29,258,15,11,4
18,29,259,16,23,-7
18,29,260,15,7,8
18,29,261,8,13,-5
18,29,262,18,12,6
18,29,263,10,5,5
18,29,264,5,4,1
18,29,265,24,18,6
18,29,266,13,6,7
18,29,267,24,15,9
18,29,268,18,12,6
18,29,269,21,13,8
18,29,270,7,7,0
18,29,271,20,22,-2
18,29,272,22,15,7
18,29,273,7,8,-1
18,29,274,19,11,8
18,29,275,22,21,1
18,29,276,15,8,7
18,29,277,5,6,-1
18,29,278,22,12,10
18,29,279,26,11,15
18,29,280,16,7,9
18,29,281,15,13,2
18,29,282,34,13,21
18,29,283,14,14,0
18,29,284,20,15,5
18,29,285,14,3,11
18,29,286,16,10,6
18,29,287,17,2,15
18,29,288,8,4,4
18,29,289,7,11,-4
18,29,290,7,9,-2
18,29,291,24,9,15
18,29,292,15,18,-3
18,29,293,5,6,-1
18,29,294,19,16,3
18,29,295,17,18,-1
18,29,296,14,6,8
18,29,297,4,14,-10
18,29,298,20,9,11
18,29,299,25,12,13
18,30,0,12,10,2
18,30,1,9,13,-4
18,30,2,9,10,-1
18,30,3,11,22,-11
18,30,4,8,7,1
18,30,5,16,16,0
18,30,6,21,12,9
18,30,7,17,15,2
18,30,8,26,22,4
18,30,9,13,10,3
18,30,10,19,14,5
18,30,11,15,14,1
18,30,12,22,23,-1
18,30,13,24,5,19
18,30,14,20,13,7
18,30,15,11,8,3
18,30,16,14,13,1
18,30,17,10,8,2
18,30,18,11,9,2
18,30,19,12,16,-4
18,30,20,10,15,-5
18,30,21,8,7,1
18,30,22,15,10,5
18,30,23,17,15,2
18,30,24,7,7,0
18,30,25,14,12,2
18,30,26,14,10,4
18,30,27,14,10,4
18,30,28,15,5,10
18,30,29,17,16,1
18,30,30,6,16,-10
18,30,31,11,16,-5
18,30,32,11,3,8
18,30,33,13,7,6
18,30,34,29,11,18
18,30,35,16,9,7
18,30,36,16,15,1
18,30,37,18,14,4
18,30,38,28,14,14
18,30,39,21,25,-4
18,30,40,15,17,-2
18,30,41,13,17,-4
18,30,42,15,11,4
18,30,43,14,17,-3
18,30,44,8,4,4
18,30,45,16,14,2
18,30,46,32,17,15
18,30,47,10,17,-7
18,30,48,11,12,-1
18,30,49,20,22,-2
18,30,50,18,13,5
18,30,51,13,16,-3
18,30,52,36,18,18
18,30,53,18,8,10
18,30,54,14,7,7
18,30,55,10,9,1
18,30,56,19,11,8
18,30,57,16,8,8
18,30,58,14,14,0
18,30,59,19,20,-1
18,30,60,10,5,5
18,30,61,12,9,3
18,30,62,9,7,2
18,30,63,15,6,9
18,30,64,9,22,-13
18,30,65,17,11,6
18,30,66,7,13,-6
18,30,67,17,10,7
18,30,68,24,10,14
18,30,69,18,11,7
18,30,70,13,10,3
18,30,71,17,12,5
18,30,72,8,12,-4
18,30,73,17,10,7
18,30,74,25,16,9
18,30,75,19,16,3
18,30,76,13,16,-3
18,30,77,22,14,8
18,30,78,18,20,-2
18,30,79,17,3,14
18,30,80,18,8,10
18,30,81,13,7,6
18,30,82,28,8,20
18,30,83,10,2,8
18,30,84,18,10,8
18,30,85,18,20,-2
18,30,86,19,15,4
18,30,87,19,13,6
18,30,88,9,8,1
18,30,89,5,3,2
18,30,90,20,18,2
18,30,91,9,20,-11
18,30,92,18,11,7
18,30,93,11,19,-8
18,30,94,15,10,5
18,30,95,15,11,4
18,30,96,14,9,5
18,30,97,13,12,1
18,30,98,10,7,3
18,30,99,16,24,-8
18,30,100,25,9,16
18,30,101,4,5,-1
18,30,102,12,8,4
18,30,103,23,7,16
18,30,104,13,18,-5
18,30,105,16,11,5
18,30,106,6,7,-1
18,30,107,17,10,7
18,30,108,24,13,11
18,30,109,3,11,-8
18,30,110,22,16,6
18,30,111,10,16,-6
18,30,112,15,20,-5
18,30,113,10,6,4
18,30,114,8,10,-2
18,30,115,11,7,4
18,30,116,20,15,5
18,30,117,10,12,-2
18,30,118,17,9,8
18,30,119,15,17,-2
18,30,120,15,11,4
18,30,121,22,16,6
18,30,122,27,7,20
18,30,123,13,9,4
18,30,124,8,10,-2
18,30,125,12,4,8
18,30,126,10,14,-4
18,30,127,7,15,-8
18,30,128,11,14,-3
18,30,129,16,23,-7
18,30,130,19,18,1
18,30,131,11,10,1
18,30,132,23,19,4
18,30,133,32,17,15
18,30,134,6,6,0
18,30,135,23,5,18
18,30,136,8,10,-2
18,30,137,26,16,10
18,30,138,18,7,11
18,30,139,17,15,2
18,30,140,6,10,-4
18,30,141,24,12,12
18,30,142,13,13,0
18,30,143,16,6,10
18,30,144,16,12,4
18,30,145,20,13,7
18,30,146,9,10,-1
18,30,147,18,10,8
18,30,148,28,7,21
18,30,149,8,7,1
18,30,150,11,23,-12
18,30,151,8,18,-10
18,30,152,27,12,15
18,30,153,10,7,3
18,30,154,17,17,0
18,30,155,13,14,-1
18,30,156,3,12,-9
18,30,157,14,12,2
18,30,158,9,11,-2
18,30,159,15,16,-1
18,30,160,5,6,-1
18,30,161,21,17,4
18,30,162,18,12,6
18,30,163,15,19,-4
18,30,164,17,18,-1
18,30,165,16,7,9
18,30,166,12,11,1
18,30,167,23,6,17
18,30,168,29,19,10
18,30,169,18,11,7
18,30,170,8,7,1
18,30,171,11,11,0
18,30,172,9,4,5
18,30,173,19,13,6
18,30,174,29,17,12
18,30,175,12,15,-3
18,30,176,12,15,-3
18,30,177,18,13,5
18,30,178,13,14,-1
18,30,179,17,16,1
18,30,180,15,19,-4
18,30,181,14,14,0
18,30,182,17,12,5
18,30,183,16,11,5
18,30,184,20,7,13
18,30,185,16,13,3
18,30,186,9,5,4
18,30,187,13,7,6
18,30,188,13,10,3
18,30,189,16,13,3
18,30,190,6,14,-8
18,30,191,9,8,1
18,30,192,9,10,-1
18,30,193,14,7,7
18,30,194,26,15,11
18,30,195,19,17,2
18,30,196,8,6,2
18,30,197,7,12,-5
18,30,198,14,12,2
18,30,199,20,8,12
18,30,200,20,15,5
18,30,201,16,16,0
18,30,202,14,19,-5
18,30,203,19,4,15
18,30,204,17,11,6
18,30,205,15,12,3
18,30,206,23,15,8
18,30,207,7,12,-5
18,30,208,21,14,7
18,30,209,11,5,6
18,30,210,9,14,-5
18,30,211,9,15,-6
18,30,212,4,4,0
18,30,213,16,9,7
18,30,214,13,6,7
18,30,215,18,9,9
18,30,216,11,14,-3
18,30,217,20,16,4
18,30,218,31,20,11
18,30,219,26,20,6
18,30,220,21,25,-4
18,30,221,21,11,10
18,30,222,19,11,8
18,30,223,24,13,11
18,30,224,11,11,0
18,30,225,25,11,14
18,30,226,19,21,-2
18,30,227,12,17,-5
18,30,228,15,9,6
18,30,229,15,9,6
18,30,230,10,10,0
18,30,231,10,13,-3
18,30,232,23,19,4
18,30,233,11,5,6
18,30,234,18,15,3
18,30,235,9,20,-11
18,30,236,17,20,-3
18,30,237,13,11,2
18,30,238,27,11,16
18,30,239,23,14,9
18,30,240,14,17,-3
18,30,241,9,8,1
18,30,242,9,2,7
18,30,243,7,11,-4
18,30,244,13,8,5
18,30,245,14,6,8
18,30,246,19,9,10
18,30,247,11,14,-3
18,30,248,16,17,-1
18,30,249,15,11,4
18,30,250,7,9,-2
18,30,251,22,16,6
18,30,252,15,10,5
18,30,253,14,10,4
18,30,254,9,17,-8
18,30,255,16,7,9
18,30,256,14,8,6
18,30,257,16,5,11
18,30,258,16,15,1
18,30,259,15,11,4
18,30,260,5,5,0
18,30,261,9,11,-2
18,30,262,25,7,18
18,30,263,18,7,11
18,30,264,14,13,1
18,30,265,18,8,10
18,30,266,24,11,13
18,30,267,18,9,9
18,30,268,12,15,-3
18,30,269,14,6,8
18,30,270,14,8,6
18,30,271,11,7,4
18,30,272,6,12,-6
18,30,273,30,9,21
18,30,274,10,7,3
18,30,275,18,11,7
18,30,276,14,9,5
18,30,277,10,11,-1
18,30,278,12,15,-3
18,30,279,16,18,-2
18,30,280,11,12,-1
18,30,281,8,10,-2
18,30,282,15,8,7
18,30,283,5,11,-6
18,30,284,21,10,11
18,30,285,11,20,-9
18,30,286,27,11,16
18,30,287,25,18,7
18,30,288,20,14,6
18,30,289,23,15,8
18,30,290,23,9,14
18,30,291,6,8,-2
18,30,292,13,15,-2
18,30,293,18,11,7
18,30,294,26,8,18
18,30,295,24,15,9
18,30,296,23,13,10
18,30,297,11,17,-6
18,30,298,1,10,-9
18,30,299,16,13,3
19,1,0,4,6,-2
19,1,1,3,6,-3
19,1,2,12,21,-9
19,1,3,0,9,-9
19,1,4,5,22,-17
19,1,5,8,3,5
19,1,6,11,22,-11
19,1,7,15,26,-11
19,1,8,10,12,-2
19,1,9,7,8,-1
19,1,10,6,8,-2
19,1,11,5,21,-16
19,1,12,14,19,-5
19,1,13,5,14,-9
19,1,14,9,11,-2
19,1,15,10,14,-4
19,1,16,15,39,-24
19,1,17,7,20,-13
19,1,18,15,22,-7
19,1,19,5,24,-19
19,1,20,2,15,-13
19,1,21,8,10,-2
19,1,22,7,11,-4
19,1,23,7,12,-5
19,1,24,11,32,-21
19,1,25,10,8,2
19,1,26,14,20,-6
19,1,27,13,10,3
19,1,28,5,18,-13
19,1,29,12,16,-4
19,1,30,9,15,-6
19,1,31,5,17,-12
19,1,32,14,5,9
19,1,33,7,22,-15
19,1,34,5,11,-6
19,1,35,5,5,0
19,1,36,4,14,-10
19,1,37,6,4,2
19,1,38,9,8,1
19,1,39,11,12,-1
19,1,40,16,18,-2
19,1,41,11,15,-4
19,1,42,13,21,-8
19,1,43,12,16,-4
19,1,44,1,12,-11
19,1,45,7,7,0
19,1,46,11,19,-8
19,1,47,4,14,-10
19,1,48,3,17,-14
19,1,49,5,17,-12
19,1,50,8,19,-11
19,1,51,12,7,5
19,1,52,5,21,-16
19,1,53,0,10,-10
19,1,54,7,7,0
19,1,55,5,10,-5
19,1,56,7,13,-6
19,1,57,12,25,-13
19,1,58,6,15,-9
19,1,59,4,5,-1
19,1,60,7,12,-5
19,1,61,7,18,-11
19,1,62,18,22,-4
19,1,63,18,14,4
19,1,64,11,9,2
19,1,65,5,14,-9
19,1,66,11,28,-17
19,1,67,8,17,-9
19,1,68,3,7,-4
19,1,69,5,18,-13
19,1,70,3,14,-11
19,1,71,14,17,-3
19,1,72,10,19,-9
19,1,73,14,16,-2
19,1,74,7,9,-2
19,1,75,8,14,-6
19,1,76,21,22,-1
19,1,77,7,24,-17
19,1,78,11,11,0
19,1,79,7,6,1
19,1,80,3,25,-22
19,1,81,9,7,2
19,1,82,3,3,0
19,1,83,3,22,-19
19,1,84,4,13,-9
19,1,85,8,7,1
19,1,86,6,15,-9
19,1,87,13,18,-5
19,1,88,9,14,-5
19,1,89,10,14,-4
19,1,90,4,19,-15
19,1,91,7,18,-11
19,1,92,5,5,0
19,1,93,14,28,-14
19,1,94,7,8,-1
19,1,95,9,21,-12
19,1,96,3,16,-13
19,1,97,2,2,0
19,1,98,13,21,-8
19,1,99,9,13,-4
19,1,100,5,10,-5
19,1,101,5,20,-15
19,1,102,2,8,-6
19,1,103,7,24,-17
19,1,104,8,6,2
19,1,105,9,15,-6
19,1,106,3,15,-12
19,1,107,18,19,-1
19,1,108,9,29,-20
19,1,109,7,17,-10
19,1,110,4,6,-2
19,1,111,4,13,-9
19,1,112,10,14,-4
19,1,113,10,15,-5
19,1,114,13,26,-13
19,1,115,5,16,-11
19,1,116,9,15,-6
19,1,117,9,16,-7
19,1,118,9,21,-12
19,1,119,8,13,-5
19,1,120,13,26,-13
19,1,121,5,10,-5
19,1,122,5,16,-11
19,1,123,6,4,2
19,1,124,5,14,-9
19,1,125,16,28,-12
19,1,126,6,15,-9
19,1,127,2,7,-5
19,1,128,10,18,-8
19,1,129,11,18,-7
19,1,130,16,8,8
19,1,131,3,15,-12
19,1,132,2,16,-14
19,1,133,7,24,-17
19,1,134,4,15,-11
19,1,135,5,7,-2
19,1,136,10,17,-7
19,1,137,10,7,3
19,1,138,3,27,-24
19,1,139,6,11,-5
19,1,140,3,14,-11
19,1,141,6,18,-12
19,1,142,9,17,-8
19,1,143,2,9,-7
19,1,144,7,10,-3
19,1,145,11,24,-13
19,1,146,11,20,-9
19,1,147,8,9,-1
19,1,148,1,16,-15
19,1,149,9,23,-14
19,1,150,11,11,0
19,1,151,7,7,0
19,1,152,3,13,-10
19,1,153,4,8,-4
19,1,154,6,15,-9
19,1,155,12,28,-16
19,1,156,22,27,-5
19,1,157,10,21,-11
19,1,158,6,18,-12
19,1,159,5,31,-26
19,1,160,10,28,-18
19,1,161,6,14,-8
19,1,162,7,18,-11
19,1,163,6,20,-14
19,1,164,8,16,-8
19,1,165,6,9,-3
19,1,166,7,9,-2
19,1,167,15,13,2
19,1,168,19,11,8
19,1,169,5,18,-13
19,1,170,4,12,-8
19,1,171,7,12,-5
19,1,172,9,13,-4
19,1,173,9,20,-11
19,1,174,7,13,-6
19,1,175,17,19,-2
19,1,176,3,10,-7
19,1,177,3,5,-2
19,1,178,2,12,-10
19,1,179,6,11,-5
19,1,180,10,20,-10
19,1,181,10,17,-7
19,1,182,12,11,1
19,1,183,14,21,-7
19,1,184,16,24,-8
19,1,185,3,9,-6
19,1,186,10,17,-7
19,1,187,6,25,-19
19,1,188,4,10,-6
19,1,189,9,8,1
19,1,190,1,9,-8
19,1,191,4,14,-10
19,1,192,15,16,-1
19,1,193,13,16,-3
19,1,194,1,19,-18
19,1,195,7,18,-11
19,1,196,13,10,3
19,1,197,6,8,-2
19,1,198,11,15,-4
19,1,199,6,18,-12
19,1,200,6,25,-19
19,1,201,3,8,-5
19,1,202,4,19,-15
19,1,203,7,9,-2
19,1,204,7,16,-9
19,1,205,11,15,-4
19,1,206,15,20,-5
19,1,207,6,13,-7
19,1,208,7,17,-10
19,1,209,8,26,-18
19,1,210,3,8,-5
19,1,211,11,18,-7
19,1,212,9,24,-15
19,1,213,8,7,1
19,1,214,9,16,-7
19,1,215,9,19,-10
19,1,216,12,6,6
19,1,217,16,10,6
19,1,218,8,20,-12
19,1,219,10,18,-8
19,1,220,2,4,-2
19,1,221,5,4,1
19,1,222,9,14,-5
19,1,223,12,12,0
19,1,224,14,19,-5
19,1,225,10,26,-16
19,1,226,7,20,-13
19,1,227,9,15,-6
19,1,228,8,9,-1
19,1,229,9,14,-5
19,1,230,11,10,1
19,1,231,19,13,6
19,1,232,6,12,-6
19,1,233,12,10,2
19,1,234,9,16,-7
19,1,235,5,13,-8
19,1,236,6,12,-6
19,1,237,9,8,1
19,1,238,13,16,-3
19,1,239,15,23,-8
19,1,240,11,20,-9
19,1,241,13,14,-1
19,1,242,11,6,5
19,1,243,6,9,-3
19,1,244,10,16,-6
19,1,245,7,16,-9
19,1,246,11,13,-2
19,1,247,10,14,-4
19,1,248,14,25,-11
19,1,249,8,22,-14
19,1,250,15,9,6
19,1,251,4,9,-5
19,1,252,4,5,-1
19,1,253,4,19,-15
19,1,254,2,8,-6
19,1,255,0,12,-12
19,1,256,15,27,-12
19,1,257,4,17,-13
19,1,258,7,15,-8
19,1,259,5,8,-3
19,1,260,9,8,1
19,1,261,9,7,2
19,1,262,14,18,-4
19,1,263,5,12,-7
19,1,264,13,7,6
19,1,265,10,26,-16
19,1,266,8,7,1
19,1,267,10,15,-5
19,1,268,14,1,13
19,1,269,6,17,-11
19,1,270,13,26,-13
19,1,271,5,16,-11
19,1,272,10,29,-19
19,1,273,14,18,-4
19,1,274,10,18,-8
19,1,275,12,21,-9
19,1,276,9,11,-2
19,1,277,13,22,-9
19,1,278,13,13,0
19,1,279,10,8,2
19,1,280,7,10,-3
19,1,281,6,29,-23
19,1,282,17,22,-5
19,1,283,14,15,-1
19,1,284,10,18,-8
19,1,285,14,20,-6
19,1,286,12,26,-14
19,1,287,11,17,-6
19,1,288,7,20,-13
19,1,289,6,15,-9
19,1,290,13,19,-6
19,1,291,7,26,-19
19,1,292,5,7,-2
19,1,293,6,13,-7
19,1,294,3,13,-10
19,1,295,7,19,-12
19,1,296,16,25,-9
19,1,297,1,11,-10
19,1,298,8,19,-11
19,1,299,8,6,2
19,2,0,9,10,-1
19,2,1,7,21,-14
19,2,2,13,17,-4
19,2,3,7,13,-6
19,2,4,9,15,-6
19,2,5,9,15,-6
19,2,6,9,13,-4
19,2,7,8,21,-13
19,2,8,2,12,-10
19,2,9,11,6,5
19,2,10,7,8,-1
19,2,11,11,19,-8
19,2,12,3,17,-14
19,2,13,7,5,2
19,2,14,5,12,-7
19,2,15,13,24,-11
19,2,16,4,9,-5
19,2,17,13,18,-5
19,2,18,9,15,-6
19,2,19,7,25,-18
19,2,20,6,19,-13
19,2,21,11,25,-14
19,2,22,9,11,-2
19,2,23,7,13,-6
19,2,24,4,10,-6
19,2,25,13,22,-9
19,2,26,11,17,-6
19,2,27,18,20,-2
19,2,28,11,15,-4
19,2,29,8,24,-16
19,2,30,5,19,-14
19,2,31,13,15,-2
19,2,32,14,15,-1
19,2,33,14,20,-6
19,2,34,17,22,-5
19,2,35,9,27,-18
19,2,36,11,27,-16
19,2,37,7,16,-9
19,2,38,17,9,8
19,2,39,11,17,-6
19,2,40,8,22,-14
19,2,41,18,22,-4
19,2,42,4,27,-23
19,2,43,8,11,-3
19,2,44,11,11,0
19,2,45,4,15,-11
19,2,46,2,10,-8
19,2,47,11,30,-19
19,2,48,10,19,-9
19,2,49,4,22,-18
19,2,50,10,13,-3
19,2,51,13,15,-2
19,2,52,8,41,-33
19,2,53,16,20,-4
19,2,54,11,18,-7
19,2,55,10,17,-7
19,2,56,11,16,-5
19,2,57,5,13,-8
19,2,58,9,17,-8
19,2,59,5,18,-13
19,2,60,9,18,-9
19,2,61,7,4,3
19,2,62,12,32,-20
19,2,63,5,11,-6
19,2,64,7,17,-10
19,2,65,6,34,-28
19,2,66,10,22,-12
19,2,67,9,17,-8
19,2,68,4,12,-8
19,2,69,12,11,1
19,2,70,18,15,3
19,2,71,7,20,-13
19,2,72,5,6,-1
19,2,73,4,13,-9
19,2,74,5,20,-15
19,2,75,10,28,-18
19,2,76,11,14,-3
19,2,77,16,25,-9
19,2,78,3,21,-18
19,2,79,9,10,-1
19,2,80,10,30,-20
19,2,81,11,8,3
19,2,82,5,32,-27
19,2,83,13,14,-1
19,2,84,8,9,-1
19,2,85,9,7,2
19,2,86,11,26,-15
19,2,87,17,16,1
19,2,88,9,12,-3
19,2,89,12,22,-10
19,2,90,4,5,-1
19,2,91,9,11,-2
19,2,92,4,9,-5
19,2,93,3,25,-22
19,2,94,5,10,-5
19,2,95,8,25,-17
19,2,96,20,21,-1
19,2,97,7,18,-11
19,2,98,8,24,-16
19,2,99,3,14,-11
19,2,100,3,9,-6
19,2,101,17,21,-4
19,2,102,8,15,-7
19,2,103,6,6,0
19,2,104,5,14,-9
19,2,105,13,9,4
19,2,106,18,23,-5
19,2,107,9,5,4
19,2,108,10,16,-6
19,2,109,4,20,-16
19,2,110,20,16,4
19,2,111,5,10,-5
19,2,112,14,24,-10
19,2,113,13,19,-6
19,2,114,12,9,3
19,2,115,18,10,8
19,2,116,17,19,-2
19,2,117,2,11,-9
19,2,118,14,23,-9
19,2,119,4,11,-7
19,2,120,13,14,-1
19,2,121,4,20,-16
19,2,122,4,15,-11
19,2,123,10,30,-20
19,2,124,6,14,-8
19,2,125,12,19,-7
19,2,126,2,20,-18
19,2,127,3,23,-20
19,2,128,7,17,-10
19,2,129,7,21,-14
19,2,130,2,12,-10
19,2,131,11,12,-1
19,2,132,11,21,-10
19,2,133,2,16,-14
19,2,134,7,9,-2
19,2,135,3,17,-14
19,2,136,12,23,-11
19,2,137,12,11,1
19,2,138,1,10,-9
19,2,139,14,22,-8
19,2,140,4,7,-3
19,2,141,12,18,-6
19,2,142,13,17,-4
19,2,143,4,26,-22
19,2,144,16,23,-7
19,2,145,16,10,6
19,2,146,8,11,-3
19,2,147,8,27,-19
19,2,148,5,8,-3
19,2,149,11,23,-12
19,2,150,15,19,-4
19,2,151,8,17,-9
19,2,152,10,24,-14
19,2,153,6,23,-17
19,2,154,9,16,-7
19,2,155,7,17,-10
19,2,156,5,14,-9
19,2,157,14,20,-6
19,2,158,7,12,-5
19,2,159,10,18,-8
19,2,160,14,14,0
19,2,161,13,20,-7
19,2,162,12,14,-2
19,2,163,14,27,-13
19,2,164,17,17,0
19,2,165,3,18,-15
19,2,166,4,14,-10
19,2,167,5,8,-3
19,2,168,4,11,-7
19,2,169,9,17,-8
19,2,170,20,19,1
19,2,171,4,14,-10
19,2,172,9,6,3
19,2,173,16,14,2
19,2,174,11,23,-12
19,2,175,15,16,-1
19,2,176,10,9,1
19,2,177,12,18,-6
19,2,178,13,17,-4
19,2,179,9,19,-10
19,2,180,15,18,-3
19,2,181,11,18,-7
19,2,182,6,14,-8
19,2,183,4,18,-14
19,2,184,19,22,-3
19,2,185,5,16,-11
19,2,186,6,27,-21
19,2,187,13,6,7
19,2,188,20,11,9
19,2,189,11,13,-2
19,2,190,5,12,-7
19,2,191,14,18,-4
19,2,192,11,15,-4
19,2,193,7,11,-4
19,2,194,8,24,-16
19,2,195,5,24,-19
19,2,196,12,11,1
19,2,197,9,19,-10
19,2,198,6,13,-7
19,2,199,4,18,-14
19,2,200,12,23,-11
19,2,201,8,18,-10
19,2,202,4,23,-19
19,2,203,17,18,-1
19,2,204,2,10,-8
19,2,205,3,14,-11
19,2,206,8,10,-2
19,2,207,12,15,-3
19,2,208,12,16,-4
19,2,209,8,11,-3
19,2,210,8,5,3
19,2,211,2,16,-14
19,2,212,8,10,-2
19,2,213,8,11,-3
19,2,214,3,15,-12
19,2,215,3,18,-15
19,2,216,7,13,-6
19,2,217,17,20,-3
19,2,218,3,13,-10
19,2,219,12,25,-13
19,2,220,17,25,-8
19,2,221,4,25,-21
19,2,222,12,10,2
19,2,223,8,21,-13
19,2,224,8,14,-6
19,2,225,5,14,-9
19,2,226,7,16,-9
19,2,227,12,9,3
19,2,228,8,22,-14
19,2,229,8,17,-9
19,2,230,12,13,-1
19,2,231,8,19,-11
19,2,232,5,31,-26
19,2,233,4,14,-10
19,2,234,4,12,-8
19,2,235,6,17,-11
19,2,236,11,22,-11
19,2,237,7,16,-9
19,2,238,10,26,-16
19,2,239,9,18,-9
19,2,240,6,5,1
19,2,241,7,24,-17
19,2,242,10,21,-11
19,2,243,7,24,-17
19,2,244,15,19,-4
19,2,245,13,16,-3
19,2,246,5,25,-20
19,2,247,18,14,4
19,2,248,5,12,-7
19,2,249,7,23,-16
19,2,250,5,12,-7
19,2,251,7,14,-7
19,2,252,7,25,-18
19,2,253,3,13,-10
19,2,254,14,8,6
19,2,255,9,20,-11
19,2,256,21,22,-1
19,2,257,17,21,-4
19,2,258,5,15,-10
19,2,259,3,24,-21
19,2,260,15,17,-2
19,2,261,7,26,-19
19,2,262,12,23,-11
19,2,263,12,13,-1
19,2,264,9,14,-5
19,2,265,14,22,-8
19,2,266,8,10,-2
19,2,267,16,23,-7
19,2,268,11,18,-7
19,2,269,8,18,-10
19,2,270,5,5,0
19,2,271,14,27,-13
19,2,272,10,27,-17
19,2,273,5,8,-3
19,2,274,9,8,1
19,2,275,20,24,-4
19,2,276,17,22,-5
19,2,277,7,14,-7
19,2,278,6,24,-18
19,2,279,6,21,-15
19,2,280,14,28,-14
19,2,281,9,20,-11
19,2,282,8,10,-2
19,2,283,18,6,12
19,2,284,9,15,-6
19,2,285,8,10,-2
19,2,286,7,10,-3
19,2,287,11,16,-5
19,2,288,9,17,-8
19,2,289,10,12,-2
19,2,290,10,19,-9
19,2,291,4,24,-20
19,2,292,12,13,-1
19,2,293,12,15,-3
19,2,294,8,21,-13
19,2,295,1,6,-5
19,2,296,10,17,-7
19,2,297,14,24,-10
19,2,298,2,5,-3
19,2,299,2,8,-6
19,3,0,12,28,-16
19,3,1,8,20,-12
19,3,2,4,10,-6
19,3,3,12,16,-4
19,3,4,22,23,-1
19,3,5,12,10,2
19,3,6,7,22,-15
19,3,7,14,19,-5
19,3,8,10,22,-12
19,3,9,3,6,-3
19,3,10,5,21,-16
19,3,11,23,10,13
19,3,12,9,18,-9
19,3,13,12,17,-5
19,3,14,5,14,-9
19,3,15,10,14,-4
19,3,16,4,6,-2
19,3,17,8,28,-20
19,3,18,8,16,-8
19,3,19,3,24,-21
19,3,20,9,21,-12
19,3,21,18,22,-4
19,3,22,11,24,-13
19,3,23,10,27,-17
19,3,24,13,16,-3
19,3,25,5,16,-11
19,3,26,2,9,-7
19,3,27,8,24,-16
19,3,28,12,32,-20
19,3,29,8,18,-10
19,3,30,8,14,-6
19,3,31,10,15,-5
19,3,32,15,22,-7
19,3,33,15,35,-20
19,3,34,7,21,-14
19,3,35,4,18,-14
19,3,36,11,20,-9
19,3,37,6,9,-3
19,3,38,8,39,-31
19,3,39,15,12,3
19,3,40,9,11,-2
19,3,41,8,25,-17
19,3,42,16,29,-13
19,3,43,8,27,-19
19,3,44,10,12,-2
19,3,45,9,12,-3
19,3,46,7,17,-10
19,3,47,9,18,-9
19,3,48,18,22,-4
19,3,49,6,21,-15
19,3,50,9,16,-7
19,3,51,12,27,-15
19,3,52,4,24,-20
19,3,53,6,12,-6
19,3,54,15,20,-5
19,3,55,22,18,4
19,3,56,15,21,-6
19,3,57,9,29,-20
19,3,58,13,26,-13
19,3,59,14,7,7
19,3,60,7,10,-3
19,3,61,14,23,-9
19,3,62,12,16,-4
19,3,63,23,11,12
19,3,64,12,20,-8
19,3,65,10,18,-8
19,3,66,6,14,-8
19,3,67,12,26,-14
19,3,68,13,14,-1
19,3,69,7,6,1
19,3,70,11,24,-13
19,3,71,9,8,1
19,3,72,11,11,0
19,3,73,9,23,-14
19,3,74,5,17,-12
19,3,75,18,14,4
19,3,76,5,15,-10
19,3,77,8,19,-11
19,3,78,7,14,-7
19,3,79,8,21,-13
19,3,80,6,25,-19
19,3,81,4,25,-21
19,3,82,4,13,-9
19,3,83,6,4,2
19,3,84,11,39,-28
19,3,85,5,18,-13
19,3,86,11,19,-8
19,3,87,9,20,-11
19,3,88,3,10,-7
19,3,89,15,29,-14
19,3,90,6,9,-3
19,3,91,16,26,-10
19,3,92,10,13,-3
19,3,93,1,13,-12
19,3,94,14,32,-18
19,3,95,5,28,-23
19,3,96,1,11,-10
19,3,97,4,9,-5
19,3,98,9,20,-11
19,3,99,2,13,-11
19,3,100,14,22,-8
19,3,101,6,12,-6
19,3,102,8,16,-8
19,3,103,6,33,-27
19,3,104,8,14,-6
19,3,105,12,12,0
19,3,106,4,4,0
19,3,107,11,16,-5
19,3,108,20,25,-5
19,3,109,12,10,2
19,3,110,4,18,-14
19,3,111,11,28,-17
19,3,112,14,17,-3
19,3,113,13,24,-11
19,3,114,6,9,-3
19,3,115,8,11,-3
19,3,116,14,30,-16
19,3,117,8,15,-7
19,3,118,16,26,-10
19,3,119,10,18,-8
19,3,120,5,13,-8
19,3,121,11,28,-17
19,3,122,5,17,-12
19,3,123,15,6,9
19,3,124,11,12,-1
19,3,125,10,18,-8
19,3,126,7,30,-23
19,3,127,11,10,1
19,3,128,11,27,-16
19,3,129,6,12,-6
19,3,130,4,10,-6
19,3,131,10,14,-4
19,3,132,6,17,-11
19,3,133,8,12,-4
19,3,134,5,24,-19
19,3,135,7,20,-13
19,3,136,19,13,6
19,3,137,9,23,-14
19,3,138,5,17,-12
19,3,139,7,25,-18
19,3,140,10,33,-23
19,3,141,12,25,-13
19,3,142,7,19,-12
19,3,143,13,22,-9
19,3,144,14,26,-12
19,3,145,15,3,12
19,3,146,2,11,-9
19,3,147,7,14,-7
19,3,148,5,14,-9
19,3,149,2,9,-7
19,3,150,11,15,-4
19,3,151,14,18,-4
19,3,152,20,20,0
19,3,153,9,13,-4
19,3,154,9,24,-15
19,3,155,13,19,-6
19,3,156,5,24,-19
19,3,157,14,33,-19
19,3,158,13,27,-14
19,3,159,7,15,-8
19,3,160,10,10,0
19,3,161,6,6,0
19,3,162,7,12,-5
19,3,163,10,26,-16
19,3,164,14,19,-5
19,3,165,6,20,-14
19,3,166,11,15,-4
19,3,167,10,13,-3
19,3,168,7,15,-8
19,3,169,5,12,-7
19,3,170,5,14,-9
19,3,171,8,13,-5
19,3,172,9,17,-8
19,3,173,18,28,-10
19,3,174,12,28,-16
19,3,175,8,22,-14
19,3,176,15,24,-9
19,3,177,8,15,-7
19,3,178,10,25,-15
19,3,179,12,23,-11
19,3,180,3,32,-29
19,3,181,13,22,-9
19,3,182,15,23,-8
19,3,183,4,32,-28
19,3,184,14,26,-12
19,3,185,4,15,-11
19,3,186,18,20,-2
19,3,187,9,11,-2
19,3,188,16,27,-11
19,3,189,4,12,-8
19,3,190,12,22,-10
19,3,191,13,25,-12
19,3,192,13,23,-10
19,3,193,13,10,3
19,3,194,4,5,-1
19,3,195,15,24,-9
19,3,196,8,23,-15
19,3,197,7,15,-8
19,3,198,4,12,-8
19,3,199,15,16,-1
19,3,200,11,7,4
19,3,201,7,18,-11
19,3,202,6,15,-9
19,3,203,11,17,-6
19,3,204,0,9,-9
19,3,205,7,32,-25
19,3,206,13,7,6
19,3,207,11,8,3
19,3,208,4,19,-15
19,3,209,17,26,-9
19,3,210,8,17,-9
19,3,211,2,8,-6
19,3,212,10,7,3
19,3,213,8,30,-22
19,3,214,14,29,-15
19,3,215,8,20,-12
19,3,216,7,17,-10
19,3,217,9,16,-7
19,3,218,10,19,-9
19,3,219,5,19,-14
19,3,220,5,28,-23
19,3,221,4,16,-12
19,3,222,6,7,-1
19,3,223,4,13,-9
19,3,224,4,16,-12
19,3,225,12,19,-7
19,3,226,7,15,-8
19,3,227,17,21,-4
19,3,228,7,20,-13
19,3,229,9,24,-15
19,3,230,9,17,-8
19,3,231,14,18,-4
19,3,232,8,17,-9
19,3,233,6,6,0
19,3,234,3,8,-5
19,3,235,10,16,-6
19,3,236,16,23,-7
19,3,237,3,20,-17
19,3,238,4,13,-9
19,3,239,8,25,-17
19,3,240,7,12,-5
19,3,241,25,24,1
19,3,242,11,14,-3
19,3,243,17,18,-1
19,3,244,23,17,6
19,3,245,11,16,-5
19,3,246,14,24,-10
19,3,247,5,21,-16
19,3,248,10,25,-15
19,3,249,7,19,-12
19,3,250,11,23,-12
19,3,251,13,16,-3
19,3,252,19,21,-2
19,3,253,11,21,-10
19,3,254,8,13,-5
19,3,255,8,10,-2
19,3,256,18,18,0
19,3,257,7,14,-7
19,3,258,6,15,-9
19,3,259,8,19,-11
19,3,260,6,24,-18
19,3,261,7,21,-14
19,3,262,1,17,-16
19,3,263,8,12,-4
19,3,264,8,24,-16
19,3,265,23,33,-10
19,3,266,14,17,-3
19,3,267,14,34,-20
19,3,268,5,13,-8
19,3,269,3,29,-26
19,3,270,13,19,-6
19,3,271,17,21,-4
19,3,272,8,13,-5
19,3,273,13,5,8
19,3,274,12,10,2
19,3,275,7,18,-11
19,3,276,11,21,-10
19,3,277,8,27,-19
19,3,278,13,18,-5
19,3,279,8,28,-20
19,3,280,19,24,-5
19,3,281,11,20,-9
19,3,282,4,10,-6
19,3,283,4,19,-15
19,3,284,22,13,9
19,3,285,15,14,1
19,3,286,1,29,-28
19,3,287,7,12,-5
19,3,288,3,14,-11
19,3,289,8,7,1
19,3,290,7,14,-7
19,3,291,8,19,-11
19,3,292,5,10,-5
19,3,293,7,6,1
19,3,294,5,13,-8
19,3,295,3,21,-18
19,3,296,15,40,-25
19,3,297,12,9,3
19,3,298,5,11,-6
19,3,299,17,18,-1
19,4,0,8,24,-16
19,4,1,5,17,-12
19,4,2,10,15,-5
19,4,3,11,18,-7
19,4,4,4,19,-15
19,4,5,12,20,-8
19,4,6,23,29,-6
19,4,7,13,21,-8
19,4,8,15,27,-12
19,4,9,7,10,-3
19,4,10,14,10,4
19,4,11,4,13,-9
19,4,12,8,12,-4
19,4,13,15,29,-14
19,4,14,13,30,-17
19,4,15,7,10,-3
19,4,16,11,15,-4
19,4,17,12,21,-9
19,4,18,16,12,4
19,4,19,6,33,-27
19,4,20,4,15,-11
19,4,21,15,14,1
19,4,22,10,21,-11
19,4,23,6,17,-11
19,4,24,10,26,-16
19,4,25,12,21,-9
19,4,26,7,15,-8
19,4,27,12,22,-10
19,4,28,8,14,-6
19,4,29,11,17,-6
19,4,30,18,29,-11
19,4,31,15,23,-8
19,4,32,12,17,-5
19,4,33,11,19,-8
19,4,34,10,15,-5
19,4,35,11,28,-17
19,4,36,5,9,-4
19,4,37,11,12,-1
19,4,38,7,11,-4
19,4,39,12,12,0
19,4,40,7,12,-5
19,4,41,18,37,-19
19,4,42,9,14,-5
19,4,43,8,21,-13
19,4,44,10,18,-8
19,4,45,5,21,-16
19,4,46,7,15,-8
19,4,47,21,26,-5
19,4,48,9,14,-5
19,4,49,13,27,-14
19,4,50,14,28,-14
19,4,51,18,18,0
19,4,52,12,37,-25
19,4,53,3,22,-19
19,4,54,8,17,-9
19,4,55,7,36,-29
19,4,56,7,15,-8
19,4,57,6,20,-14
19,4,58,13,17,-4
19,4,59,12,11,1
19,4,60,8,21,-13
19,4,61,6,23,-17
19,4,62,7,13,-6
19,4,63,16,17,-1
19,4,64,13,20,-7
19,4,65,13,19,-6
19,4,66,14,19,-5
19,4,67,23,23,0
19,4,68,17,20,-3
19,4,69,16,17,-1
19,4,70,15,28,-13
19,4,71,9,23,-14
19,4,72,11,16,-5
19,4,73,18,18,0
19,4,74,9,18,-9
19,4,75,7,34,-27
19,4,76,8,14,-6
19,4,77,12,20,-8
19,4,78,7,16,-9
19,4,79,9,14,-5
19,4,80,6,35,-29
19,4,81,15,24,-9
19,4,82,13,4,9
19,4,83,6,11,-5
19,4,84,11,14,-3
19,4,85,20,14,6
19,4,86,4,16,-12
19,4,87,13,20,-7
19,4,88,17,18,-1
19,4,89,5,15,-10
19,4,90,11,19,-8
19,4,91,14,24,-10
19,4,92,10,13,-3
19,4,93,20,23,-3
19,4,94,19,34,-15
19,4,95,8,18,-10
19,4,96,9,23,-14
19,4,97,11,14,-3
19,4,98,13,7,6
19,4,99,10,14,-4
19,4,100,13,12,1
19,4,101,13,24,-11
19,4,102,22,23,-1
19,4,103,6,11,-5
19,4,104,16,26,-10
19,4,105,9,32,-23
19,4,106,9,15,-6
19,4,107,11,21,-10
19,4,108,13,17,-4
19,4,109,6,10,-4
19,4,110,11,12,-1
19,4,111,5,20,-15
19,4,112,3,7,-4
19,4,113,10,16,-6
19,4,114,4,16,-12
19,4,115,18,17,1
19,4,116,17,17,0
19,4,117,20,18,2
19,4,118,21,11,10
19,4,119,17,19,-2
19,4,120,3,30,-27
19,4,121,16,25,-9
19,4,122,5,15,-10
19,4,123,2,16,-14
19,4,124,8,19,-11
19,4,125,22,23,-1
19,4,126,15,21,-6
19,4,127,31,31,0
19,4,128,9,15,-6
19,4,129,6,29,-23
19,4,130,6,11,-5
19,4,131,4,8,-4
19,4,132,9,24,-15
19,4,133,20,12,8
19,4,134,15,23,-8
19,4,135,10,14,-4
19,4,136,14,13,1
19,4,137,8,26,-18
19,4,138,8,18,-10
19,4,139,25,14,11
19,4,140,9,15,-6
19,4,141,11,19,-8
19,4,142,11,22,-11
19,4,143,12,24,-12
19,4,144,10,32,-22
19,4,145,11,14,-3
19,4,146,12,17,-5
19,4,147,4,10,-6
19,4,148,11,21,-10
19,4,149,2,17,-15
19,4,150,14,15,-1
19,4,151,9,4,5
19,4,152,13,22,-9
19,4,153,14,20,-6
19,4,154,16,28,-12
19,4,155,10,12,-2
19,4,156,14,21,-7
19,4,157,10,14,-4
19,4,158,10,13,-3
19,4,159,13,20,-7
19,4,160,15,21,-6
19,4,161,8,35,-27
19,4,162,15,24,-9
19,4,163,19,22,-3
19,4,164,17,10,7
19,4,165,14,12,2
19,4,166,4,19,-15
19,4,167,17,19,-2
19,4,168,18,27,-9
19,4,169,0,19,-19
19,4,170,2,15,-13
19,4,171,4,31,-27
19,4,172,5,11,-6
19,4,173,10,31,-21
19,4,174,7,16,-9
19,4,175,15,15,0
19,4,176,6,23,-17
19,4,177,4,14,-10
19,4,178,11,20,-9
19,4,179,11,16,-5
19,4,180,22,24,-2
19,4,181,25,16,9
19,4,182,4,24,-20
19,4,183,11,28,-17
19,4,184,7,31,-24
19,4,185,11,23,-12
19,4,186,14,26,-12
19,4,187,13,18,-5
19,4,188,13,21,-8
19,4,189,13,22,-9
19,4,190,7,18,-11
19,4,191,10,18,-8
19,4,192,8,29,-21
19,4,193,8,22,-14
19,4,194,15,20,-5
19,4,195,19,26,-7
19,4,196,18,23,-5
19,4,197,12,25,-13
19,4,198,7,24,-17
19,4,199,19,35,-16
19,4,200,17,15,2
19,4,201,6,14,-8
19,4,202,8,18,-10
19,4,203,9,12,-3
19,4,204,11,37,-26
19,4,205,8,23,-15
19,4,206,11,20,-9
19,4,207,12,18,-6
19,4,208,13,18,-5
19,4,209,3,15,-12
19,4,210,7,23,-16
19,4,211,1,7,-6
19,4,212,9,11,-2
19,4,213,16,13,3
19,4,214,9,17,-8
19,4,215,10,11,-1
19,4,216,9,15,-6
19,4,217,7,18,-11
19,4,218,9,24,-15
19,4,219,9,14,-5
19,4,220,8,21,-13
19,4,221,5,19,-14
19,4,222,16,20,-4
19,4,223,9,20,-11
19,4,224,8,24,-16
19,4,225,16,10,6
19,4,226,10,19,-9
19,4,227,7,15,-8
19,4,228,9,21,-12
19,4,229,8,23,-15
19,4,230,10,18,-8
19,4,231,20,21,-1
19,4,232,13,30,-17
19,4,233,12,21,-9
19,4,234,8,11,-3
19,4,235,4,9,-5
19,4,236,6,18,-12
19,4,237,13,39,-26
19,4,238,9,24,-15
19,4,239,11,12,-1
19,4,240,11,28,-17
19,4,241,10,29,-19
19,4,242,13,16,-3
19,4,243,22,24,-2
19,4,244,2,20,-18
19,4,245,9,22,-13
19,4,246,11,33,-22
19,4,247,11,20,-9
19,4,248,21,16,5
19,4,249,7,14,-7
19,4,250,14,15,-1
19,4,251,12,28,-16
19,4,252,9,12,-3
19,4,253,16,29,-13
19,4,254,17,16,1
19,4,255,8,11,-3
19,4,256,8,32,-24
19,4,257,13,14,-1
19,4,258,12,11,1
19,4,259,5,15,-10
19,4,260,6,17,-11
19,4,261,19,20,-1
19,4,262,16,17,-1
19,4,263,6,20,-14
19,4,264,16,21,-5
19,4,265,18,17,1
19,4,266,6,17,-11
19,4,267,12,19,-7
19,4,268,3,3,0
19,4,269,9,15,-6
19,4,270,21,23,-2
19,4,271,7,17,-10
19,4,272,14,20,-6
19,4,273,11,39,-28
19,4,274,14,23,-9
19,4,275,9,12,-3
19,4,276,20,34,-14
19,4,277,12,23,-11
19,4,278,13,28,-15
19,4,279,11,17,-6
19,4,280,12,19,-7
19,4,281,25,17,8
19,4,282,11,16,-5
19,4,283,6,14,-8
19,4,284,10,12,-2
19,4,285,10,18,-8
19,4,286,14,29,-15
19,4,287,21,36,-15
19,4,288,16,18,-2
19,4,289,4,16,-12
19,4,290,13,25,-12
19,4,291,16,22,-6
19,4,292,17,20,-3
19,4,293,14,24,-10
19,4,294,5,24,-19
19,4,295,1,11,-10
19,4,296,22,33,-11
19,4,297,7,15,-8
19,4,298,10,17,-7
19,4,299,6,8,-2
19,5,0,14,27,-13
19,5,1,7,22,-15
19,5,2,11,32,-21
19,5,3,8,14,-6
19,5,4,19,12,7
19,5,5,15,14,1
19,5,6,9,18,-9
19,5,7,12,22,-10
19,5,8,22,20,2
19,5,9,7,10,-3
19,5,10,21,12,9
19,5,11,5,17,-12
19,5,12,7,11,-4
19,5,13,18,28,-10
19,5,14,6,16,-10
19,5,15,20,22,-2
19,5,16,14,14,0
19,5,17,9,12,-3
19,5,18,4,13,-9
19,5,19,9,26,-17
19,5,20,15,18,-3
19,5,21,9,11,-2
19,5,22,3,14,-11
19,5,23,12,24,-12
19,5,24,5,16,-11
19,5,25,10,16,-6
19,5,26,16,26,-10
19,5,27,11,34,-23
19,5,28,16,24,-8
19,5,29,9,16,-7
19,5,30,5,17,-12
19,5,31,7,19,-12
19,5,32,7,11,-4
19,5,33,6,14,-8
19,5,34,5,4,1
19,5,35,16,14,2
19,5,36,15,23,-8
19,5,37,10,21,-11
19,5,38,8,9,-1
19,5,39,19,16,3
19,5,40,8,18,-10
19,5,41,11,10,1
19,5,42,11,33,-22
19,5,43,14,18,-4
19,5,44,15,35,-20
19,5,45,10,23,-13
19,5,46,18,25,-7
19,5,47,7,10,-3
19,5,48,9,3,6
19,5,49,15,24,-9
19,5,50,8,12,-4
19,5,51,16,18,-2
19,5,52,15,20,-5
19,5,53,14,18,-4
19,5,54,5,7,-2
19,5,55,9,10,-1
19,5,56,12,19,-7
19,5,57,12,14,-2
19,5,58,10,14,-4
19,5,59,12,14,-2
19,5,60,15,16,-1
19,5,61,14,28,-14
19,5,62,15,24,-9
19,5,63,12,12,0
19,5,64,11,12,-1
19,5,65,13,23,-10
19,5,66,9,18,-9
19,5,67,23,43,-20
19,5,68,9,22,-13
19,5,69,9,17,-8
19,5,70,10,18,-8
19,5,71,10,27,-17
19,5,72,7,8,-1
19,5,73,3,19,-16
19,5,74,8,7,1
19,5,75,12,26,-14
19,5,76,8,16,-8
19,5,77,16,20,-4
19,5,78,8,20,-12
19,5,79,10,25,-15
19,5,80,14,27,-13
19,5,81,9,26,-17
19,5,82,9,9,0
19,5,83,9,19,-10
19,5,84,6,18,-12
19,5,85,9,23,-14
19,5,86,12,16,-4
19,5,87,4,15,-11
19,5,88,10,24,-14
19,5,89,7,21,-14
19,5,90,10,25,-15
19,5,91,10,17,-7
19,5,92,9,14,-5
19,5,93,12,21,-9
19,5,94,9,12,-3
19,5,95,17,23,-6
19,5,96,6,22,-16
19,5,97,16,29,-13
19,5,98,13,33,-20
19,5,99,22,25,-3
19,5,100,18,14,4
19,5,101,6,19,-13
19,5,102,11,16,-5
19,5,103,10,25,-15
19,5,104,16,22,-6
19,5,105,21,24,-3
19,5,106,13,10,3
19,5,107,9,5,4
19,5,108,4,15,-11
19,5,109,10,24,-14
19,5,110,8,14,-6
19,5,111,9,16,-7
19,5,112,19,13,6
19,5,113,9,18,-9
19,5,114,4,13,-9
19,5,115,17,11,6
19,5,116,3,18,-15
19,5,117,14,14,0
19,5,118,14,19,-5
19,5,119,7,13,-6
19,5,120,9,13,-4
19,5,121,14,22,-8
19,5,122,17,16,1
19,5,123,9,19,-10
19,5,124,6,28,-22
19,5,125,8,14,-6
19,5,126,12,11,1
19,5,127,11,20,-9
19,5,128,10,21,-11
19,5,129,7,20,-13
19,5,130,11,29,-18
19,5,131,7,9,-2
19,5,132,20,12,8
19,5,133,1,22,-21
19,5,134,11,29,-18
19,5,135,11,31,-20
19,5,136,5,12,-7
19,5,137,16,16,0
19,5,138,21,22,-1
19,5,139,6,12,-6
19,5,140,12,27,-15
19,5,141,9,8,1
19,5,142,5,4,1
19,5,143,14,9,5
19,5,144,9,20,-11
19,5,145,17,16,1
19,5,146,11,27,-16
19,5,147,11,14,-3
19,5,148,10,13,-3
19,5,149,6,6,0
19,5,150,10,24,-14
19,5,151,17,27,-10
19,5,152,7,12,-5
19,5,153,12,20,-8
19,5,154,6,17,-11
19,5,155,10,23,-13
19,5,156,14,29,-15
19,5,157,7,21,-14
19,5,158,7,12,-5
19,5,159,10,18,-8
19,5,160,7,11,-4
19,5,161,3,17,-14
19,5,162,2,12,-10
19,5,163,7,29,-22
19,5,164,5,12,-7
19,5,165,13,20,-7
19,5,166,20,18,2
19,5,167,11,14,-3
19,5,168,5,21,-16
19,5,169,10,28,-18
19,5,170,10,19,-9
19,5,171,8,14,-6
19,5,172,12,17,-5
19,5,173,8,5,3
19,5,174,7,17,-10
19,5,175,13,19,-6
19,5,176,13,15,-2
19,5,177,11,13,-2
19,5,178,10,17,-7
19,5,179,7,18,-11
19,5,180,5,19,-14
19,5,181,6,17,-11
19,5,182,5,23,-18
19,5,183,7,19,-12
19,5,184,10,27,-17
19,5,185,3,13,-10
19,5,186,9,17,-8
19,5,187,8,24,-16
19,5,188,10,27,-17
19,5,189,11,15,-4
19,5,190,6,9,-3
19,5,191,13,31,-18
19,5,192,9,17,-8
19,5,193,11,18,-7
19,5,194,8,19,-11
19,5,195,6,21,-15
19,5,196,11,13,-2
19,5,197,12,15,-3
19,5,198,10,15,-5
19,5,199,19,10,9
19,5,200,11,28,-17
19,5,201,12,23,-11
19,5,202,10,12,-2
19,5,203,7,18,-11
19,5,204,11,20,-9
19,5,205,7,37,-30
19,5,206,10,15,-5
19,5,207,20,26,-6
19,5,208,8,15,-7
19,5,209,12,21,-9
19,5,210,14,19,-5
19,5,211,6,25,-19
19,5,212,5,28,-23
19,5,213,15,19,-4
19,5,214,7,8,-1
19,5,215,9,20,-11
19,5,216,21,30,-9
19,5,217,8,18,-10
19,5,218,16,18,-2
19,5,219,18,15,3
19,5,220,16,14,2
19,5,221,16,26,-10
19,5,222,8,19,-11
19,5,223,7,16,-9
19,5,224,12,17,-5
19,5,225,16,33,-17
19,5,226,6,12,-6
19,5,227,11,24,-13
19,5,228,17,22,-5
19,5,229,2,6,-4
19,5,230,14,17,-3
19,5,231,8,16,-8
19,5,232,13,18,-5
19,5,233,10,31,-21
19,5,234,13,14,-1
19,5,235,20,15,5
19,5,236,28,28,0
19,5,237,6,19,-13
19,5,238,8,14,-6
19,5,239,17,16,1
19,5,240,10,2,8
19,5,241,15,17,-2
19,5,242,24,22,2
19,5,243,8,11,-3
19,5,244,6,21,-15
19,5,245,13,25,-12
19,5,246,10,22,-12
19,5,247,12,28,-16
19,5,248,2,10,-8
19,5,249,8,30,-22
19,5,250,13,16,-3
19,5,251,13,19,-6
19,5,252,15,25,-10
19,5,253,5,9,-4
19,5,254,10,13,-3
19,5,255,3,14,-11
19,5,256,9,20,-11
19,5,257,20,34,-14
19,5,258,11,16,-5
19,5,259,6,5,1
19,5,260,18,25,-7
19,5,261,36,25,11
19,5,262,22,15,7
19,5,263,9,10,-1
19,5,264,17,24,-7
19,5,265,13,30,-17
19,5,266,12,19,-7
19,5,267,11,8,3
19,5,268,5,22,-17
19,5,269,9,20,-11
19,5,270,6,21,-15
19,5,271,11,13,-2
19,5,272,10,5,5
19,5,273,17,15,2
19,5,274,5,16,-11
19,5,275,5,20,-15
19,5,276,10,41,-31
19,5,277,7,28,-21
19,5,278,19,24,-5
19,5,279,13,25,-12
19,5,280,13,20,-7
19,5,281,11,33,-22
19,5,282,8,21,-13
19,5,283,6,31,-25
19,5,284,9,15,-6
19,5,285,20,28,-8
19,5,286,8,13,-5
19,5,287,22,22,0
19,5,288,2,14,-12
19,5,289,10,33,-23
19,5,290,13,24,-11
19,5,291,9,12,-3
19,5,292,2,9,-7
19,5,293,9,25,-16
19,5,294,10,31,-21
19,5,295,9,13,-4
19,5,296,14,30,-16
19,5,297,11,18,-7
19,5,298,16,9,7
19,5,299,14,20,-6
19,6,0,7,28,-21
19,6,1,8,18,-10
19,6,2,15,18,-3
19,6,3,19,23,-4
19,6,4,17,29,-12
19,6,5,6,14,-8
19,6,6,13,22,-9
19,6,7,5,6,-1
19,6,8,6,8,-2
19,6,9,12,21,-9
19,6,10,10,18,-8
19,6,11,14,10,4
19,6,12,11,28,-17
19,6,13,7,23,-16
19,6,14,7,15,-8
19,6,15,13,19,-6
19,6,16,7,16,-9
19,6,17,3,11,-8
19,6,18,12,33,-21
19,6,19,12,46,-34
19,6,20,18,21,-3
19,6,21,6,10,-4
19,6,22,13,17,-4
19,6,23,14,14,0
19,6,24,22,23,-1
19,6,25,10,19,-9
19,6,26,9,18,-9
19,6,27,12,14,-2
19,6,28,14,18,-4
19,6,29,12,20,-8
19,6,30,3,15,-12
19,6,31,14,9,5
19,6,32,11,26,-15
19,6,33,9,9,0
19,6,34,13,12,1
19,6,35,6,10,-4
19,6,36,11,22,-11
19,6,37,13,17,-4
19,6,38,10,20,-10
19,6,39,6,8,-2
19,6,40,9,16,-7
19,6,41,5,27,-22
19,6,42,9,17,-8
19,6,43,2,26,-24
19,6,44,7,10,-3
19,6,45,13,12,1
19,6,46,16,26,-10
19,6,47,9,12,-3
19,6,48,17,13,4
19,6,49,9,16,-7
19,6,50,19,35,-16
19,6,51,7,21,-14
19,6,52,7,11,-4
19,6,53,16,31,-15
19,6,54,12,18,-6
19,6,55,6,24,-18
19,6,56,17,37,-20
19,6,57,14,21,-7
19,6,58,10,22,-12
19,6,59,13,7,6
19,6,60,16,33,-17
19,6,61,23,18,5
19,6,62,9,19,-10
19,6,63,13,13,0
19,6,64,9,19,-10
19,6,65,19,18,1
19,6,66,19,20,-1
19,6,67,8,10,-2
19,6,68,7,12,-5
19,6,69,9,19,-10
19,6,70,16,18,-2
19,6,71,3,18,-15
19,6,72,4,9,-5
19,6,73,8,18,-10
19,6,74,19,22,-3
19,6,75,20,17,3
19,6,76,3,25,-22
19,6,77,2,22,-20
19,6,78,6,13,-7
19,6,79,7,17,-10
19,6,80,18,18,0
19,6,81,12,30,-18
19,6,82,7,23,-16
19,6,83,9,8,1
19,6,84,5,20,-15
19,6,85,9,27,-18
19,6,86,14,23,-9
19,6,87,14,6,8
19,6,88,13,27,-14
19,6,89,5,15,-10
19,6,90,11,14,-3
19,6,91,7,28,-21
19,6,92,26,23,3
19,6,93,9,23,-14
19,6,94,10,19,-9
19,6,95,9,24,-15
19,6,96,14,25,-11
19,6,97,16,23,-7
19,6,98,20,20,0
19,6,99,10,14,-4
19,6,100,11,20,-9
19,6,101,6,11,-5
19,6,102,19,25,-6
19,6,103,12,26,-14
19,6,104,18,19,-1
19,6,105,9,6,3
19,6,106,6,19,-13
19,6,107,20,24,-4
19,6,108,25,32,-7
19,6,109,22,21,1
19,6,110,10,10,0
19,6,111,10,17,-7
19,6,112,10,11,-1
19,6,113,5,10,-5
19,6,114,5,14,-9
19,6,115,10,22,-12
19,6,116,9,7,2
19,6,117,13,21,-8
19,6,118,10,15,-5
19,6,119,7,25,-18
19,6,120,8,13,-5
19,6,121,9,43,-34
19,6,122,11,20,-9
19,6,123,15,25,-10
19,6,124,13,18,-5
19,6,125,11,18,-7
19,6,126,8,15,-7
19,6,127,18,19,-1
19,6,128,8,18,-10
19,6,129,15,17,-2
19,6,130,16,22,-6
19,6,131,11,17,-6
19,6,132,11,11,0
19,6,133,4,13,-9
19,6,134,8,12,-4
19,6,135,16,14,2
19,6,136,19,21,-2
19,6,137,8,16,-8
19,6,138,12,16,-4
19,6,139,18,15,3
19,6,140,6,22,-16
19,6,141,15,16,-1
19,6,142,8,23,-15
19,6,143,2,17,-15
19,6,144,11,21,-10
19,6,145,18,12,6
19,6,146,9,19,-10
19,6,147,9,9,0
19,6,148,11,15,-4
19,6,149,11,20,-9
19,6,150,7,19,-12
19,6,151,16,18,-2
19,6,152,9,13,-4
19,6,153,5,13,-8
19,6,154,13,12,1
19,6,155,9,14,-5
19,6,156,6,19,-13
19,6,157,4,12,-8
19,6,158,9,22,-13
19,6,159,12,23,-11
19,6,160,14,8,6
19,6,161,24,30,-6
19,6,162,14,27,-13
19,6,163,3,25,-22
19,6,164,6,16,-10
19,6,165,10,14,-4
19,6,166,11,26,-15
19,6,167,8,15,-7
19,6,168,21,17,4
19,6,169,15,32,-17
19,6,170,19,27,-8
19,6,171,6,4,2
19,6,172,16,20,-4
19,6,173,9,38,-29
19,6,174,10,18,-8
19,6,175,11,21,-10
19,6,176,13,18,-5
19,6,177,17,33,-16
19,6,178,9,44,-35
19,6,179,5,22,-17
19,6,180,9,15,-6
19,6,181,10,28,-18
19,6,182,11,19,-8
19,6,183,21,20,1
19,6,184,13,27,-14
19,6,185,15,13,2
19,6,186,8,26,-18
19,6,187,20,27,-7
19,6,188,5,21,-16
19,6,189,7,24,-17
19,6,190,7,22,-15
19,6,191,8,11,-3
19,6,192,11,14,-3
19,6,193,2,3,-1
19,6,194,11,30,-19
19,6,195,10,20,-10
19,6,196,20,25,-5
19,6,197,7,10,-3
19,6,198,8,11,-3
19,6,199,14,23,-9
19,6,200,9,10,-1
19,6,201,12,42,-30
19,6,202,15,27,-12
19,6,203,24,30,-6
19,6,204,13,31,-18
19,6,205,11,20,-9
19,6,206,12,17,-5
19,6,207,1,14,-13
19,6,208,15,27,-12
19,6,209,11,33,-22
19,6,210,7,19,-12
19,6,211,7,20,-13
19,6,212,15,22,-7
19,6,213,8,15,-7
19,6,214,10,20,-10
19,6,215,15,29,-14
19,6,216,13,22,-9
19,6,217,13,11,2
19,6,218,9,20,-11
19,6,219,4,17,-13
19,6,220,12,7,5
19,6,221,1,17,-16
19,6,222,7,25,-18
19,6,223,12,20,-8
19,6,224,12,12,0
19,6,225,6,13,-7
19,6,226,3,15,-12
19,6,227,18,24,-6
19,6,228,5,16,-11
19,6,229,13,20,-7
19,6,230,8,24,-16
19,6,231,18,20,-2
19,6,232,20,27,-7
19,6,233,8,13,-5
19,6,234,8,20,-12
19,6,235,14,20,-6
19,6,236,12,24,-12
19,6,237,19,31,-12
19,6,238,5,12,-7
19,6,239,8,20,-12
19,6,240,13,13,0
19,6,241,23,30,-7
19,6,242,11,12,-1
19,6,243,14,14,0
19,6,244,6,14,-8
19,6,245,9,26,-17
19,6,246,13,24,-11
19,6,247,13,27,-14
19,6,248,4,16,-12
19,6,249,17,27,-10
19,6,250,13,14,-1
19,6,251,11,24,-13
19,6,252,8,10,-2
19,6,253,10,12,-2
19,6,254,14,40,-26
19,6,255,22,29,-7
19,6,256,13,23,-10
19,6,257,11,14,-3
19,6,258,11,32,-21
19,6,259,15,9,6
19,6,260,17,14,3
19,6,261,23,26,-3
19,6,262,9,39,-30
19,6,263,14,24,-10
19,6,264,7,18,-11
19,6,265,10,20,-10
19,6,266,12,22,-10
19,6,267,6,18,-12
19,6,268,6,13,-7
19,6,269,18,26,-8
19,6,270,8,9,-1
19,6,271,20,32,-12
19,6,272,14,18,-4
19,6,273,16,24,-8
19,6,274,21,14,7
19,6,275,16,20,-4
19,6,276,8,22,-14
19,6,277,7,13,-6
19,6,278,8,27,-19
19,6,279,8,9,-1
19,6,280,11,18,-7
19,6,281,12,14,-2
19,6,282,15,21,-6
19,6,283,5,10,-5
19,6,284,17,16,1
19,6,285,11,14,-3
19,6,286,15,14,1
19,6,287,14,12,2
19,6,288,11,11,0
19,6,289,15,21,-6
19,6,290,18,32,-14
19,6,291,5,20,-15
19,6,292,19,28,-9
19,6,293,16,27,-11
19,6,294,11,26,-15
19,6,295,7,14,-7
19,6,296,20,23,-3
19,6,297,23,52,-29
19,6,298,14,24,-10
19,6,299,22,26,-4
19,7,0,8,20,-12
19,7,1,15,19,-4
19,7,2,4,10,-6
19,7,3,9,11,-2
19,7,4,15,25,-10
19,7,5,11,15,-4
19,7,6,17,22,-5
19,7,7,10,10,0
19,7,8,18,18,0
19,7,9,6,14,-8
19,7,10,10,15,-5
19,7,11,11,21,-10
19,7,12,17,27,-10
19,7,13,10,31,-21
19,7,14,7,9,-2
19,7,15,15,17,-2
19,7,16,13,24,-11
19,7,17,20,8,12
19,7,18,11,21,-10
19,7,19,6,29,-23
19,7,20,17,13,4
19,7,21,4,11,-7
19,7,22,10,11,-1
19,7,23,17,22,-5
19,7,24,7,27,-20
19,7,25,8,20,-12
19,7,26,17,10,7
19,7,27,28,14,14
19,7,28,7,5,2
19,7,29,17,25,-8
19,7,30,16,19,-3
19,7,31,14,14,0
19,7,32,8,23,-15
19,7,33,10,20,-10
19,7,34,16,22,-6
19,7,35,6,17,-11
19,7,36,9,12,-3
19,7,37,15,24,-9
19,7,38,19,16,3
19,7,39,13,19,-6
19,7,40,14,25,-11
19,7,41,9,20,-11
19,7,42,20,19,1
19,7,43,6,8,-2
19,7,44,14,31,-17
19,7,45,18,17,1
19,7,46,13,18,-5
19,7,47,6,18,-12
19,7,48,4,7,-3
19,7,49,9,23,-14
19,7,50,5,7,-2
19,7,51,12,27,-15
19,7,52,8,18,-10
19,7,53,6,12,-6
19,7,54,8,15,-7
19,7,55,3,23,-20
19,7,56,16,20,-4
19,7,57,6,25,-19
19,7,58,14,19,-5
19,7,59,9,11,-2
19,7,60,24,14,10
19,7,61,17,20,-3
19,7,62,5,11,-6
19,7,63,9,21,-12
19,7,64,10,15,-5
19,7,65,15,25,-10
19,7,66,5,14,-9
19,7,67,20,22,-2
19,7,68,16,26,-10
19,7,69,18,26,-8
19,7,70,11,34,-23
19,7,71,7,15,-8
19,7,72,3,24,-21
19,7,73,7,23,-16
19,7,74,12,23,-11
19,7,75,14,30,-16
19,7,76,9,18,-9
19,7,77,8,15,-7
19,7,78,21,26,-5
19,7,79,20,27,-7
19,7,80,10,19,-9
19,7,81,7,10,-3
19,7,82,5,20,-15
19,7,83,14,13,1
19,7,84,5,18,-13
19,7,85,15,33,-18
19,7,86,22,26,-4
19,7,87,23,45,-22
19,7,88,18,19,-1
19,7,89,5,5,0
19,7,90,12,17,-5
19,7,91,11,15,-4
19,7,92,9,10,-1
19,7,93,4,10,-6
19,7,94,21,16,5
19,7,95,10,17,-7
19,7,96,8,21,-13
19,7,97,13,25,-12
19,7,98,5,10,-5
19,7,99,14,13,1
19,7,100,12,9,3
19,7,101,15,24,-9
19,7,102,14,10,4
19,7,103,14,12,2
19,7,104,13,20,-7
19,7,105,17,21,-4
19,7,106,15,26,-11
19,7,107,11,9,2
19,7,108,4,24,-20
19,7,109,23,28,-5
19,7,110,13,18,-5
19,7,111,9,8,1
19,7,112,22,21,1
19,7,113,8,30,-22
19,7,114,11,31,-20
19,7,115,11,11,0
19,7,116,22,25,-3
19,7,117,12,17,-5
19,7,118,5,14,-9
19,7,119,6,15,-9
19,7,120,13,16,-3
19,7,121,9,16,-7
19,7,122,13,27,-14
19,7,123,7,23,-16
19,7,124,16,21,-5
19,7,125,15,19,-4
19,7,126,11,13,-2
19,7,127,19,34,-15
19,7,128,22,27,-5
19,7,129,5,8,-3
19,7,130,3,9,-6
19,7,131,19,16,3
19,7,132,14,21,-7
19,7,133,12,19,-7
19,7,134,7,19,-12
19,7,135,5,10,-5
19,7,136,5,22,-17
19,7,137,14,28,-14
19,7,138,13,12,1
19,7,139,8,13,-5
19,7,140,20,24,-4
19,7,141,10,9,1
19,7,142,18,24,-6
19,7,143,7,16,-9
19,7,144,11,18,-7
19,7,145,5,13,-8
19,7,146,13,18,-5
19,7,147,22,22,0
19,7,148,11,24,-13
19,7,149,12,28,-16
19,7,150,9,26,-17
19,7,151,13,16,-3
19,7,152,19,25,-6
19,7,153,3,16,-13
19,7,154,6,20,-14
19,7,155,4,10,-6
19,7,156,12,27,-15
19,7,157,22,26,-4
19,7,158,14,23,-9
19,7,159,15,14,1
19,7,160,12,24,-12
19,7,161,9,12,-3
19,7,162,16,19,-3
19,7,163,15,16,-1
19,7,164,14,19,-5
19,7,165,13,24,-11
19,7,166,9,13,-4
19,7,167,2,7,-5
19,7,168,10,22,-12
19,7,169,11,34,-23
19,7,170,16,23,-7
19,7,171,15,28,-13
19,7,172,15,22,-7
19,7,173,2,20,-18
19,7,174,12,15,-3
19,7,175,11,22,-11
19,7,176,16,16,0
19,7,177,13,19,-6
19,7,178,16,22,-6
19,7,179,5,15,-10
19,7,180,7,11,-4
19,7,181,5,20,-15
19,7,182,18,24,-6
19,7,183,10,30,-20
19,7,184,11,9,2
19,7,185,17,22,-5
19,7,186,13,21,-8
19,7,187,14,26,-12
19,7,188,14,26,-12
19,7,189,6,28,-22
19,7,190,11,15,-4
19,7,191,5,10,-5
19,7,192,19,27,-8
19,7,193,7,12,-5
19,7,194,8,19,-11
19,7,195,20,14,6
19,7,196,14,8,6
19,7,197,32,20,12
19,7,198,11,19,-8
19,7,199,13,19,-6
19,7,200,12,18,-6
19,7,201,13,31,-18
19,7,202,8,19,-11
19,7,203,9,19,-10
19,7,204,8,14,-6
19,7,205,6,10,-4
19,7,206,8,19,-11
19,7,207,13,9,4
19,7,208,12,12,0
19,7,209,19,18,1
19,7,210,16,19,-3
19,7,211,27,23,4
19,7,212,16,23,-7
19,7,213,13,13,0
19,7,214,6,8,-2
19,7,215,1,14,-13
19,7,216,5,24,-19
19,7,217,15,29,-14
19,7,218,12,19,-7
19,7,219,5,21,-16
19,7,220,23,27,-4
19,7,221,16,26,-10
19,7,222,5,19,-14
19,7,223,17,24,-7
19,7,224,6,19,-13
19,7,225,3,22,-19
19,7,226,12,14,-2
19,7,227,11,16,-5
19,7,228,5,7,-2
19,7,229,12,27,-15
19,7,230,13,26,-13
19,7,231,19,25,-6
19,7,232,12,18,-6
19,7,233,15,12,3
19,7,234,16,20,-4
19,7,235,14,23,-9
19,7,236,13,26,-13
19,7,237,23,25,-2
19,7,238,7,18,-11
19,7,239,17,26,-9
19,7,240,16,11,5
19,7,241,8,16,-8
19,7,242,9,18,-9
19,7,243,14,10,4
19,7,244,7,19,-12
19,7,245,9,21,-12
19,7,246,16,28,-12
19,7,247,16,15,1
19,7,248,5,9,-4
19,7,249,7,15,-8
19,7,250,10,15,-5
19,7,251,9,16,-7
19,7,252,24,49,-25
19,7,253,12,15,-3
19,7,254,8,16,-8
19,7,255,21,27,-6
19,7,256,17,22,-5
19,7,257,5,21,-16
19,7,258,14,20,-6
19,7,259,25,25,0
19,7,260,22,15,7
19,7,261,6,16,-10
19,7,262,8,18,-10
19,7,263,9,8,1
19,7,264,8,17,-9
19,7,265,8,12,-4
19,7,266,10,13,-3
19,7,267,5,17,-12
19,7,268,17,28,-11
19,7,269,10,17,-7
19,7,270,12,35,-23
19,7,271,16,19,-3
19,7,272,21,10,11
19,7,273,9,14,-5
19,7,274,21,12,9
19,7,275,8,15,-7
19,7,276,31,10,21
19,7,277,8,10,-2
19,7,278,20,26,-6
19,7,279,15,31,-16
19,7,280,11,22,-11
19,7,281,16,15,1
19,7,282,2,10,-8
19,7,283,15,18,-3
19,7,284,17,16,1
19,7,285,22,13,9
19,7,286,31,29,2
19,7,287,16,12,4
19,7,288,7,11,-4
19,7,289,9,28,-19
19,7,290,10,10,0
19,7,291,11,23,-12
19,7,292,9,10,-1
19,7,293,9,22,-13
19,7,294,4,22,-18
19,7,295,14,15,-1
19,7,296,21,25,-4
19,7,297,9,9,0
19,7,298,9,17,-8
19,7,299,12,28,-16
19,8,0,13,26,-13
19,8,1,4,14,-10
19,8,2,11,16,-5
19,8,3,11,25,-14
19,8,4,29,26,3
19,8,5,5,19,-14
19,8,6,8,14,-6
19,8,7,13,10,3
19,8,8,10,11,-1
19,8,9,4,24,-20
19,8,10,10,24,-14
19,8,11,16,18,-2
19,8,12,14,15,-1
19,8,13,14,12,2
19,8,14,8,23,-15
19,8,15,11,9,2
19,8,16,16,13,3
19,8,17,14,37,-23
19,8,18,16,20,-4
19,8,19,7,17,-10
19,8,20,11,17,-6
19,8,21,6,27,-21
19,8,22,12,17,-5
19,8,23,6,10,-4
19,8,24,17,24,-7
19,8,25,21,23,-2
19,8,26,16,18,-2
19,8,27,13,24,-11
19,8,28,7,14,-7
19,8,29,16,15,1
19,8,30,9,18,-9
19,8,31,12,15,-3
19,8,32,16,41,-25
19,8,33,11,18,-7
19,8,34,3,22,-19
19,8,35,16,14,2
19,8,36,19,22,-3
19,8,37,6,10,-4
19,8,38,9,19,-10
19,8,39,19,18,1
19,8,40,16,29,-13
19,8,41,12,32,-20
19,8,42,16,26,-10
19,8,43,4,16,-12
19,8,44,11,16,-5
19,8,45,10,7,3
19,8,46,11,16,-5
19,8,47,7,11,-4
19,8,48,10,28,-18
19,8,49,14,20,-6
19,8,50,15,22,-7
19,8,51,6,17,-11
19,8,52,14,12,2
19,8,53,15,24,-9
19,8,54,12,13,-1
19,8,55,15,7,8
19,8,56,17,14,3
19,8,57,11,26,-15
19,8,58,32,16,16
19,8,59,7,14,-7
19,8,60,10,25,-15
19,8,61,2,7,-5
19,8,62,30,30,0
19,8,63,13,29,-16
19,8,64,18,33,-15
19,8,65,11,23,-12
19,8,66,10,16,-6
19,8,67,8,14,-6
19,8,68,21,27,-6
19,8,69,11,22,-11
19,8,70,11,16,-5
19,8,71,10,12,-2
19,8,72,10,11,-1
19,8,73,6,26,-20
19,8,74,16,33,-17
19,8,75,13,14,-1
19,8,76,15,7,8
19,8,77,7,17,-10
19,8,78,12,25,-13
19,8,79,13,25,-12
19,8,80,9,20,-11
19,8,81,18,28,-10
19,8,82,8,15,-7
19,8,83,19,16,3
19,8,84,12,13,-1
19,8,85,17,23,-6
19,8,86,13,22,-9
19,8,87,12,17,-5
19,8,88,20,23,-3
19,8,89,19,16,3
19,8,90,13,22,-9
19,8,91,6,11,-5
19,8,92,13,43,-30
19,8,93,11,15,-4
19,8,94,14,22,-8
19,8,95,6,5,1
19,8,96,11,26,-15
19,8,97,13,19,-6
19,8,98,15,18,-3
19,8,99,6,30,-24
19,8,100,19,12,7
19,8,101,22,21,1
19,8,102,4,9,-5
19,8,103,9,16,-7
19,8,104,6,14,-8
19,8,105,8,20,-12
19,8,106,11,20,-9
19,8,107,24,28,-4
19,8,108,12,24,-12
19,8,109,7,42,-35
19,8,110,11,19,-8
19,8,111,11,24,-13
19,8,112,5,10,-5
19,8,113,19,18,1
19,8,114,11,15,-4
19,8,115,17,34,-17
19,8,116,13,14,-1
19,8,117,11,17,-6
19,8,118,7,20,-13
19,8,119,25,21,4
19,8,120,12,6,6
19,8,121,24,20,4
19,8,122,11,7,4
19,8,123,7,34,-27
19,8,124,15,26,-11
19,8,125,15,17,-2
19,8,126,16,29,-13
19,8,127,3,16,-13
19,8,128,10,18,-8
19,8,129,12,34,-22
19,8,130,13,18,-5
19,8,131,12,9,3
19,8,132,20,28,-8
19,8,133,11,20,-9
19,8,134,19,13,6
19,8,135,7,23,-16
19,8,136,11,28,-17
19,8,137,18,36,-18
19,8,138,12,21,-9
19,8,139,9,16,-7
19,8,140,10,11,-1
19,8,141,8,19,-11
19,8,142,11,17,-6
19,8,143,7,12,-5
19,8,144,15,38,-23
19,8,145,12,17,-5
19,8,146,6,22,-16
19,8,147,9,32,-23
19,8,148,15,19,-4
19,8,149,12,16,-4
19,8,150,20,26,-6
19,8,151,6,12,-6
19,8,152,18,19,-1
19,8,153,11,27,-16
19,8,154,8,23,-15
19,8,155,7,11,-4
19,8,156,10,12,-2
19,8,157,6,10,-4
19,8,158,10,13,-3
19,8,159,12,23,-11
19,8,160,15,29,-14
19,8,161,21,17,4
19,8,162,9,13,-4
19,8,163,30,26,4
19,8,164,18,45,-27
19,8,165,14,14,0
19,8,166,10,8,2
19,8,167,15,29,-14
19,8,168,8,22,-14
19,8,169,13,32,-19
19,8,170,18,25,-7
19,8,171,13,21,-8
19,8,172,19,25,-6
19,8,173,11,17,-6
19,8,174,2,24,-22
19,8,175,8,12,-4
19,8,176,14,12,2
19,8,177,14,20,-6
19,8,178,4,28,-24
19,8,179,9,13,-4
19,8,180,16,18,-2
19,8,181,16,24,-8
19,8,182,23,20,3
19,8,183,15,12,3
19,8,184,13,24,-11
19,8,185,25,21,4
19,8,186,21,28,-7
19,8,187,4,29,-25
19,8,188,16,42,-26
19,8,189,21,12,9
19,8,190,13,21,-8
19,8,191,24,23,1
19,8,192,12,23,-11
19,8,193,5,15,-10
19,8,194,25,20,5
19,8,195,7,14,-7
19,8,196,9,8,1
19,8,197,7,21,-14
19,8,198,3,15,-12
19,8,199,7,23,-16
19,8,200,11,8,3
19,8,201,15,21,-6
19,8,202,12,13,-1
19,8,203,6,23,-17
19,8,204,13,28,-15
19,8,205,14,18,-4
19,8,206,12,21,-9
19,8,207,18,29,-11
19,8,208,14,33,-19
19,8,209,18,23,-5
19,8,210,18,19,-1
19,8,211,10,20,-10
19,8,212,9,17,-8
19,8,213,10,23,-13
19,8,214,11,12,-1
19,8,215,10,16,-6
19,8,216,19,20,-1
19,8,217,9,27,-18
19,8,218,4,16,-12
19,8,219,7,17,-10
19,8,220,11,23,-12
19,8,221,17,28,-11
19,8,222,19,32,-13
19,8,223,12,15,-3
19,8,224,11,16,-5
19,8,225,5,12,-7
19,8,226,23,29,-6
19,8,227,6,10,-4
19,8,228,14,19,-5
19,8,229,15,12,3
19,8,230,19,35,-16
19,8,231,12,9,3
19,8,232,15,18,-3
19,8,233,7,16,-9
19,8,234,19,44,-25
19,8,235,8,8,0
19,8,236,7,33,-26
19,8,237,11,23,-12
19,8,238,8,28,-20
19,8,239,9,15,-6
19,8,240,15,24,-9
19,8,241,25,18,7
19,8,242,1,13,-12
19,8,243,11,15,-4
19,8,244,17,15,2
19,8,245,17,25,-8
19,8,246,12,6,6
19,8,247,17,29,-12
19,8,248,22,20,2
19,8,249,7,24,-17
19,8,250,9,26,-17
19,8,251,15,13,2
19,8,252,4,13,-9
19,8,253,9,24,-15
19,8,254,10,15,-5
19,8,255,16,19,-3
19,8,256,14,18,-4
19,8,257,23,17,6
19,8,258,9,13,-4
19,8,259,19,27,-8
19,8,260,10,15,-5
19,8,261,20,24,-4
19,8,262,14,26,-12
19,8,263,13,21,-8
19,8,264,16,20,-4
19,8,265,10,21,-11
19,8,266,10,24,-14
19,8,267,15,24,-9
19,8,268,8,23,-15
19,8,269,13,18,-5
19,8,270,5,25,-20
19,8,271,13,18,-5
19,8,272,14,15,-1
19,8,273,14,27,-13
19,8,274,20,20,0
19,8,275,10,21,-11
19,8,276,13,26,-13
19,8,277,12,7,5
19,8,278,13,22,-9
19,8,279,11,17,-6
19,8,280,8,15,-7
19,8,281,25,24,1
19,8,282,13,19,-6
19,8,283,13,22,-9
19,8,284,3,20,-17
19,8,285,6,17,-11
19,8,286,18,23,-5
19,8,287,10,23,-13
19,8,288,15,19,-4
19,8,289,16,23,-7
19,8,290,13,22,-9
19,8,291,27,25,2
19,8,292,19,18,1
19,8,293,7,27,-20
19,8,294,11,25,-14
19,8,295,10,21,-11
19,8,296,22,22,0
19,8,297,10,23,-13
19,8,298,6,12,-6
19,8,299,7,18,-11
19,9,0,18,26,-8
19,9,1,8,26,-18
19,9,2,8,10,-2
19,9,3,8,11,-3
19,9,4,11,25,-14
19,9,5,14,21,-7
19,9,6,23,17,6
19,9,7,21,35,-14
19,9,8,15,15,0
19,9,9,3,5,-2
19,9,10,7,21,-14
19,9,11,12,18,-6
19,9,12,9,20,-11
19,9,13,13,25,-12
19,9,14,8,21,-13
19,9,15,20,16,4
19,9,16,17,24,-7
19,9,17,12,11,1
19,9,18,7,36,-29
19,9,19,10,29,-19
19,9,20,15,12,3
19,9,21,14,13,1
19,9,22,3,17,-14
19,9,23,5,27,-22
19,9,24,20,19,1
19,9,25,7,18,-11
19,9,26,9,33,-24
19,9,27,13,18,-5
19,9,28,14,19,-5
19,9,29,13,6,7
19,9,30,10,14,-4
19,9,31,6,14,-8
19,9,32,15,12,3
19,9,33,20,22,-2
19,9,34,4,16,-12
19,9,35,16,19,-3
19,9,36,16,21,-5
19,9,37,6,13,-7
19,9,38,4,22,-18
19,9,39,18,13,5
19,9,40,5,10,-5
19,9,41,12,32,-20
19,9,42,17,15,2
19,9,43,6,16,-10
19,9,44,13,19,-6
19,9,45,5,29,-24
19,9,46,16,22,-6
19,9,47,14,28,-14
19,9,48,10,15,-5
19,9,49,9,22,-13
19,9,50,7,14,-7
19,9,51,12,20,-8
19,9,52,7,21,-14
19,9,53,18,8,10
19,9,54,4,8,-4
19,9,55,9,19,-10
19,9,56,5,12,-7
19,9,57,12,7,5
19,9,58,7,19,-12
19,9,59,11,17,-6
19,9,60,14,14,0
19,9,61,16,26,-10
19,9,62,16,22,-6
19,9,63,14,24,-10
19,9,64,12,20,-8
19,9,65,17,28,-11
19,9,66,13,21,-8
19,9,67,10,17,-7
19,9,68,20,16,4
19,9,69,18,27,-9
19,9,70,9,3,6
19,9,71,8,25,-17
19,9,72,16,28,-12
19,9,73,23,11,12
19,9,74,17,29,-12
19,9,75,21,18,3
19,9,76,24,17,7
19,9,77,26,29,-3
19,9,78,7,15,-8
19,9,79,15,10,5
19,9,80,14,26,-12
19,9,81,12,12,0
19,9,82,9,26,-17
19,9,83,15,25,-10
19,9,84,10,17,-7
19,9,85,7,20,-13
19,9,86,17,14,3
19,9,87,5,15,-10
19,9,88,9,29,-20
19,9,89,19,22,-3
19,9,90,9,14,-5
19,9,91,11,14,-3
19,9,92,10,28,-18
19,9,93,12,14,-2
19,9,94,13,15,-2
19,9,95,13,13,0
19,9,96,5,19,-14
19,9,97,14,18,-4
19,9,98,13,17,-4
19,9,99,6,11,-5
19,9,100,8,24,-16
19,9,101,7,10,-3
19,9,102,10,21,-11
19,9,103,12,18,-6
19,9,104,10,29,-19
19,9,105,27,24,3
19,9,106,20,11,9
19,9,107,9,24,-15
19,9,108,15,19,-4
19,9,109,8,24,-16
19,9,110,22,20,2
19,9,111,7,24,-17
19,9,112,6,21,-15
19,9,113,12,16,-4
19,9,114,13,26,-13
19,9,115,17,14,3
19,9,116,15,16,-1
19,9,117,14,24,-10
19,9,118,12,31,-19
19,9,119,14,14,0
19,9,120,14,30,-16
19,9,121,11,21,-10
19,9,122,18,21,-3
19,9,123,7,16,-9
19,9,124,6,32,-26
19,9,125,13,21,-8
19,9,126,26,33,-7
19,9,127,13,25,-12
19,9,128,17,21,-4
19,9,129,5,22,-17
19,9,130,17,20,-3
19,9,131,8,16,-8
19,9,132,9,12,-3
19,9,133,9,8,1
19,9,134,12,18,-6
19,9,135,11,21,-10
19,9,136,7,15,-8
19,9,137,13,13,0
19,9,138,13,15,-2
19,9,139,13,25,-12
19,9,140,12,16,-4
19,9,141,13,21,-8
19,9,142,7,12,-5
19,9,143,14,7,7
19,9,144,22,30,-8
19,9,145,9,21,-12
19,9,146,11,17,-6
19,9,147,10,12,-2
19,9,148,16,32,-16
19,9,149,4,25,-21
19,9,150,9,17,-8
19,9,151,17,27,-10
19,9,152,8,28,-20
19,9,153,9,13,-4
19,9,154,11,24,-13
19,9,155,4,21,-17
19,9,156,16,21,-5
19,9,157,4,12,-8
19,9,158,18,24,-6
19,9,159,7,5,2
19,9,160,8,15,-7
19,9,161,4,11,-7
19,9,162,16,15,1
19,9,163,23,21,2
19,9,164,20,14,6
19,9,165,19,21,-2
19,9,166,14,35,-21
19,9,167,7,17,-10
19,9,168,4,32,-28
19,9,169,13,27,-14
19,9,170,10,30,-20
19,9,171,5,20,-15
19,9,172,9,34,-25
19,9,173,12,22,-10
19,9,174,9,17,-8
19,9,175,1,8,-7
19,9,176,9,15,-6
19,9,177,13,14,-1
19,9,178,8,24,-16
19,9,179,7,20,-13
19,9,180,8,9,-1
19,9,181,18,27,-9
19,9,182,16,20,-4
19,9,183,16,36,-20
19,9,184,7,9,-2
19,9,185,11,20,-9
19,9,186,13,7,6
19,9,187,13,13,0
19,9,188,4,7,-3
19,9,189,13,15,-2
19,9,190,12,18,-6
19,9,191,3,14,-11
19,9,192,12,27,-15
19,9,193,7,11,-4
19,9,194,10,12,-2
19,9,195,8,24,-16
19,9,196,19,14,5
19,9,197,21,24,-3
19,9,198,12,29,-17
19,9,199,8,15,-7
19,9,200,9,22,-13
19,9,201,12,14,-2
19,9,202,6,14,-8
19,9,203,10,23,-13
19,9,204,5,18,-13
19,9,205,10,21,-11
19,9,206,11,17,-6
19,9,207,12,14,-2
19,9,208,30,21,9
19,9,209,11,15,-4
19,9,210,9,11,-2
19,9,211,7,5,2
19,9,212,8,18,-10
19,9,213,7,15,-8
19,9,214,11,12,-1
19,9,215,12,10,2
19,9,216,10,23,-13
19,9,217,8,6,2
19,9,218,10,22,-12
19,9,219,12,17,-5
19,9,220,15,20,-5
19,9,221,18,29,-11
19,9,222,23,17,6
19,9,223,16,38,-22
19,9,224,10,11,-1
19,9,225,8,13,-5
19,9,226,5,15,-10
19,9,227,11,31,-20
19,9,228,10,28,-18
19,9,229,4,16,-12
19,9,230,12,15,-3
19,9,231,13,22,-9
19,9,232,9,21,-12
19,9,233,8,14,-6
19,9,234,17,20,-3
19,9,235,14,11,3
19,9,236,10,19,-9
19,9,237,16,29,-13
19,9,238,15,10,5
19,9,239,19,12,7
19,9,240,17,10,7
19,9,241,5,30,-25
19,9,242,6,16,-10
19,9,243,13,12,1
19,9,244,8,18,-10
19,9,245,16,22,-6
19,9,246,13,15,-2
19,9,247,18,13,5
19,9,248,11,18,-7
19,9,249,10,19,-9
19,9,250,7,14,-7
19,9,251,9,15,-6
19,9,252,14,16,-2
19,9,253,22,30,-8
19,9,254,13,20,-7
19,9,255,18,25,-7
19,9,256,5,13,-8
19,9,257,8,19,-11
19,9,258,9,15,-6
19,9,259,14,14,0
19,9,260,10,19,-9
19,9,261,5,29,-24
19,9,262,1,3,-2
19,9,263,14,29,-15
19,9,264,15,10,5
19,9,265,6,23,-17
19,9,266,12,23,-11
19,9,267,8,8,0
19,9,268,11,9,2
19,9,269,12,19,-7
19,9,270,14,16,-2
19,9,271,8,25,-17
19,9,272,9,18,-9
19,9,273,17,30,-13
19,9,274,7,27,-20
19,9,275,9,24,-15
19,9,276,9,10,-1
19,9,277,23,21,2
19,9,278,8,28,-20
19,9,279,9,21,-12
19,9,280,10,12,-2
19,9,281,27,15,12
19,9,282,12,13,-1
19,9,283,6,8,-2
19,9,284,19,14,5
19,9,285,14,15,-1
19,9,286,18,27,-9
19,9,287,8,7,1
19,9,288,8,18,-10
19,9,289,13,17,-4
19,9,290,13,28,-15
19,9,291,8,18,-10
19,9,292,11,30,-19
19,9,293,7,17,-10
19,9,294,17,16,1
19,9,295,7,10,-3
19,9,296,13,18,-5
19,9,297,19,13,6
19,9,298,7,10,-3
19,9,299,11,21,-10
19,10,0,6,8,-2
19,10,1,23,6,17
19,10,2,19,28,-9
19,10,3,12,21,-9
19,10,4,12,34,-22
19,10,5,13,21,-8
19,10,6,15,16,-1
19,10,7,17,17,0
19,10,8,9,15,-6
19,10,9,5,7,-2
19,10,10,19,16,3
19,10,11,20,12,8
19,10,12,22,24,-2
19,10,13,13,32,-19
19,10,14,19,23,-4
19,10,15,21,22,-1
19,10,16,18,11,7
19,10,17,14,14,0
19,10,18,14,19,-5
19,10,19,11,32,-21
19,10,20,9,13,-4
19,10,21,6,16,-10
19,10,22,6,19,-13
19,10,23,25,18,7
19,10,24,7,3,4
19,10,25,15,14,1
19,10,26,15,20,-5
19,10,27,5,10,-5
19,10,28,21,11,10
19,10,29,5,16,-11
19,10,30,2,16,-14
19,10,31,8,23,-15
19,10,32,9,17,-8
19,10,33,17,17,0
19,10,34,7,16,-9
19,10,35,8,25,-17
19,10,36,17,22,-5
19,10,37,4,12,-8
19,10,38,7,20,-13
19,10,39,7,21,-14
19,10,40,6,23,-17
19,10,41,18,21,-3
19,10,42,18,24,-6
19,10,43,14,16,-2
19,10,44,12,35,-23
19,10,45,18,16,2
19,10,46,14,21,-7
19,10,47,13,15,-2
19,10,48,20,16,4
19,10,49,20,11,9
19,10,50,12,22,-10
19,10,51,17,10,7
19,10,52,12,18,-6
19,10,53,16,18,-2
19,10,54,14,22,-8
19,10,55,9,14,-5
19,10,56,12,19,-7
19,10,57,20,27,-7
19,10,58,7,9,-2
19,10,59,21,18,3
19,10,60,21,33,-12
19,10,61,16,19,-3
19,10,62,22,18,4
19,10,63,10,22,-12
19,10,64,7,15,-8
19,10,65,17,31,-14
19,10,66,11,26,-15
19,10,67,14,27,-13
19,10,68,17,10,7
19,10,69,15,6,9
19,10,70,6,13,-7
19,10,71,5,9,-4
19,10,72,15,29,-14
19,10,73,3,14,-11
19,10,74,7,18,-11
19,10,75,1,13,-12
19,10,76,14,27,-13
19,10,77,14,19,-5
19,10,78,10,9,1
19,10,79,9,16,-7
19,10,80,10,14,-4
19,10,81,13,32,-19
19,10,82,10,25,-15
19,10,83,10,7,3
19,10,84,20,30,-10
19,10,85,16,16,0
19,10,86,17,13,4
19,10,87,10,8,2
19,10,88,5,15,-10
19,10,89,31,14,17
19,10,90,19,19,0
19,10,91,5,15,-10
19,10,92,11,32,-21
19,10,93,14,12,2
19,10,94,12,13,-1
19,10,95,18,7,11
19,10,96,13,20,-7
19,10,97,16,15,1
19,10,98,5,14,-9
19,10,99,19,15,4
19,10,100,10,26,-16
19,10,101,18,17,1
19,10,102,7,12,-5
19,10,103,15,26,-11
19,10,104,11,13,-2
19,10,105,12,16,-4
19,10,106,17,27,-10
19,10,107,26,17,9
19,10,108,21,24,-3
19,10,109,16,20,-4
19,10,110,6,17,-11
19,10,111,7,20,-13
19,10,112,24,25,-1
19,10,113,15,13,2
19,10,114,23,22,1
19,10,115,11,10,1
19,10,116,7,14,-7
19,10,117,13,25,-12
19,10,118,20,20,0
19,10,119,10,35,-25
19,10,120,18,37,-19
19,10,121,7,15,-8
19,10,122,10,11,-1
19,10,123,8,13,-5
19,10,124,14,9,5
19,10,125,18,14,4
19,10,126,21,34,-13
19,10,127,20,27,-7
19,10,128,18,14,4
19,10,129,12,28,-16
19,10,130,11,14,-3
19,10,131,13,23,-10
19,10,132,17,32,-15
19,10,133,7,28,-21
19,10,134,16,25,-9
19,10,135,6,30,-24
19,10,136,7,19,-12
19,10,137,7,26,-19
19,10,138,20,29,-9
19,10,139,15,22,-7
19,10,140,8,31,-23
19,10,141,10,13,-3
19,10,142,14,16,-2
19,10,143,10,15,-5
19,10,144,20,35,-15
19,10,145,6,10,-4
19,10,146,11,16,-5
19,10,147,12,13,-1
19,10,148,8,8,0
19,10,149,8,20,-12
19,10,150,13,14,-1
19,10,151,11,12,-1
19,10,152,13,20,-7
19,10,153,13,14,-1
19,10,154,7,7,0
19,10,155,5,15,-10
19,10,156,26,32,-6
19,10,157,7,29,-22
19,10,158,16,13,3
19,10,159,17,12,5
19,10,160,8,12,-4
19,10,161,17,20,-3
19,10,162,18,16,2
19,10,163,21,19,2
19,10,164,21,20,1
19,10,165,0,13,-13
19,10,166,7,18,-11
19,10,167,12,6,6
19,10,168,28,26,2
19,10,169,14,16,-2
19,10,170,14,24,-10
19,10,171,12,18,-6
19,10,172,10,12,-2
19,10,173,21,15,6
19,10,174,20,31,-11
19,10,175,12,23,-11
19,10,176,14,21,-7
19,10,177,7,23,-16
19,10,178,9,23,-14
19,10,179,12,14,-2
19,10,180,7,14,-7
19,10,181,9,13,-4
19,10,182,21,21,0
19,10,183,8,21,-13
19,10,184,25,38,-13
19,10,185,8,17,-9
19,10,186,12,27,-15
19,10,187,10,10,0
19,10,188,28,26,2
19,10,189,19,18,1
19,10,190,32,22,10
19,10,191,17,9,8
19,10,192,9,13,-4
19,10,193,10,16,-6
19,10,194,22,19,3
19,10,195,8,12,-4
19,10,196,23,23,0
19,10,197,10,23,-13
19,10,198,14,7,7
19,10,199,29,16,13
19,10,200,28,20,8
19,10,201,9,11,-2
19,10,202,8,28,-20
19,10,203,14,21,-7
19,10,204,6,17,-11
19,10,205,25,37,-12
19,10,206,1,17,-16
19,10,207,13,23,-10
19,10,208,15,19,-4
19,10,209,11,17,-6
19,10,210,7,26,-19
19,10,211,10,13,-3
19,10,212,22,13,9
19,10,213,12,15,-3
19,10,214,12,12,0
19,10,215,10,8,2
19,10,216,6,13,-7
19,10,217,18,25,-7
19,10,218,19,20,-1
19,10,219,13,12,1
19,10,220,17,16,1
19,10,221,16,17,-1
19,10,222,5,19,-14
19,10,223,10,25,-15
19,10,224,5,8,-3
19,10,225,18,21,-3
19,10,226,19,37,-18
19,10,227,20,32,-12
19,10,228,13,19,-6
19,10,229,5,17,-12
19,10,230,15,9,6
19,10,231,15,23,-8
19,10,232,30,30,0
19,10,233,12,30,-18
19,10,234,3,23,-20
19,10,235,10,15,-5
19,10,236,16,22,-6
19,10,237,8,12,-4
19,10,238,6,13,-7
19,10,239,18,19,-1
19,10,240,28,25,3
19,10,241,13,7,6
19,10,242,14,19,-5
19,10,243,18,22,-4
19,10,244,10,25,-15
19,10,245,5,13,-8
19,10,246,22,23,-1
19,10,247,6,16,-10
19,10,248,12,32,-20
19,10,249,9,11,-2
19,10,250,9,15,-6
19,10,251,9,16,-7
19,10,252,20,31,-11
19,10,253,10,33,-23
19,10,254,5,29,-24
19,10,255,14,20,-6
19,10,256,14,23,-9
19,10,257,15,14,1
19,10,258,10,12,-2
19,10,259,11,12,-1
19,10,260,9,26,-17
19,10,261,12,11,1
19,10,262,17,20,-3
19,10,263,10,17,-7
19,10,264,18,14,4
19,10,265,6,12,-6
19,10,266,10,25,-15
19,10,267,5,17,-12
19,10,268,5,31,-26
19,10,269,21,19,2
19,10,270,8,19,-11
19,10,271,4,12,-8
19,10,272,13,13,0
19,10,273,22,30,-8
19,10,274,15,20,-5
19,10,275,21,12,9
19,10,276,17,14,3
19,10,277,21,16,5
19,10,278,5,19,-14
19,10,279,15,17,-2
19,10,280,21,13,8
19,10,281,10,30,-20
19,10,282,22,14,8
19,10,283,15,20,-5
19,10,284,7,15,-8
19,10,285,18,11,7
19,10,286,19,18,1
19,10,287,10,23,-13
19,10,288,18,21,-3
19,10,289,5,22,-17
19,10,290,10,23,-13
19,10,291,19,21,-2
19,10,292,13,17,-4
19,10,293,15,22,-7
19,10,294,11,28,-17
19,10,295,11,10,1
19,10,296,16,16,0
19,10,297,7,14,-7
19,10,298,15,18,-3
19,10,299,7,16,-9
19,11,0,18,20,-2
19,11,1,1,5,-4
19,11,2,15,17,-2
19,11,3,19,7,12
19,11,4,9,26,-17
19,11,5,19,29,-10
19,11,6,9,22,-13
19,11,7,8,16,-8
19,11,8,21,17,4
19,11,9,20,35,-15
19,11,10,1,14,-13
19,11,11,13,9,4
19,11,12,7,18,-11
19,11,13,12,33,-21
19,11,14,9,15,-6
19,11,15,11,22,-11
19,11,16,4,16,-12
19,11,17,8,21,-13
19,11,18,10,11,-1
19,11,19,12,28,-16
19,11,20,12,30,-18
19,11,21,16,23,-7
19,11,22,6,14,-8
19,11,23,9,13,-4
19,11,24,11,11,0
19,11,25,19,19,0
19,11,26,27,33,-6
19,11,27,9,17,-8
19,11,28,24,10,14
19,11,29,10,20,-10
19,11,30,16,26,-10
19,11,31,11,26,-15
19,11,32,10,4,6
19,11,33,8,17,-9
19,11,34,7,19,-12
19,11,35,13,9,4
19,11,36,10,22,-12
19,11,37,9,19,-10
19,11,38,10,17,-7
19,11,39,29,16,13
19,11,40,2,30,-28
19,11,41,13,21,-8
19,11,42,10,17,-7
19,11,43,14,15,-1
19,11,44,17,23,-6
19,11,45,16,17,-1
19,11,46,6,27,-21
19,11,47,10,18,-8
19,11,48,11,8,3
19,11,49,3,11,-8
19,11,50,14,15,-1
19,11,51,13,14,-1
19,11,52,11,13,-2
19,11,53,14,21,-7
19,11,54,10,21,-11
19,11,55,7,16,-9
19,11,56,11,24,-13
19,11,57,10,23,-13
19,11,58,7,16,-9
19,11,59,4,13,-9
19,11,60,11,22,-11
19,11,61,11,15,-4
19,11,62,13,17,-4
19,11,63,18,20,-2
19,11,64,4,9,-5
19,11,65,12,18,-6
19,11,66,14,23,-9
19,11,67,6,21,-15
19,11,68,14,13,1
19,11,69,5,9,-4
19,11,70,9,10,-1
19,11,71,9,23,-14
19,11,72,20,17,3
19,11,73,8,17,-9
19,11,74,7,7,0
19,11,75,16,15,1
19,11,76,8,12,-4
19,11,77,15,20,-5
19,11,78,10,18,-8
19,11,79,10,14,-4
19,11,80,12,17,-5
19,11,81,15,24,-9
19,11,82,16,19,-3
19,11,83,12,24,-12
19,11,84,16,13,3
19,11,85,23,32,-9
19,11,86,5,21,-16
19,11,87,5,14,-9
19,11,88,18,24,-6
19,11,89,16,26,-10
19,11,90,8,7,1
19,11,91,16,14,2
19,11,92,14,20,-6
19,11,93,9,9,0
19,11,94,8,13,-5
19,11,95,13,23,-10
19,11,96,15,22,-7
19,11,97,6,10,-4
19,11,98,7,21,-14
19,11,99,12,6,6
19,11,100,10,19,-9
19,11,101,9,20,-11
19,11,102,11,17,-6
19,11,103,8,8,0
19,11,104,18,16,2
19,11,105,9,17,-8
19,11,106,12,18,-6
19,11,107,11,14,-3
19,11,108,6,20,-14
19,11,109,8,21,-13
19,11,110,5,8,-3
19,11,111,13,31,-18
19,11,112,11,18,-7
19,11,113,20,14,6
19,11,114,17,21,-4
19,11,115,22,24,-2
19,11,116,16,9,7
19,11,117,13,19,-6
19,11,118,14,20,-6
19,11,119,12,26,-14
19,11,120,12,20,-8
19,11,121,13,9,4
19,11,122,25,25,0
19,11,123,15,9,6
19,11,124,19,20,-1
19,11,125,9,26,-17
19,11,126,9,23,-14
19,11,127,20,13,7
19,11,128,8,11,-3
19,11,129,22,20,2
19,11,130,14,14,0
19,11,131,19,30,-11
19,11,132,10,19,-9
19,11,133,25,24,1
19,11,134,7,6,1
19,11,135,4,11,-7
19,11,136,12,19,-7
19,11,137,16,32,-16
19,11,138,16,19,-3
19,11,139,18,20,-2
19,11,140,14,15,-1
19,11,141,10,27,-17
19,11,142,9,18,-9
19,11,143,19,24,-5
19,11,144,11,12,-1
19,11,145,13,15,-2
19,11,146,15,17,-2
19,11,147,6,11,-5
19,11,148,10,14,-4
19,11,149,9,26,-17
19,11,150,8,27,-19
19,11,151,22,30,-8
19,11,152,7,12,-5
19,11,153,11,19,-8
19,11,154,7,17,-10
19,11,155,16,20,-4
19,11,156,7,25,-18
19,11,157,5,20,-15
19,11,158,8,15,-7
19,11,159,17,25,-8
19,11,160,14,18,-4
19,11,161,13,26,-13
19,11,162,11,12,-1
19,11,163,6,7,-1
19,11,164,11,30,-19
19,11,165,10,12,-2
19,11,166,15,21,-6
19,11,167,19,24,-5
19,11,168,23,22,1
19,11,169,16,21,-5
19,11,170,10,10,0
19,11,171,11,25,-14
19,11,172,9,6,3
19,11,173,8,17,-9
19,11,174,24,17,7
19,11,175,16,24,-8
19,11,176,16,28,-12
19,11,177,8,11,-3
19,11,178,7,12,-5
19,11,179,15,20,-5
19,11,180,23,8,15
19,11,181,15,21,-6
19,11,182,13,25,-12
19,11,183,7,16,-9
19,11,184,14,13,1
19,11,185,26,18,8
19,11,186,10,21,-11
19,11,187,20,13,7
19,11,188,10,27,-17
19,11,189,10,14,-4
19,11,190,12,19,-7
19,11,191,29,19,10
19,11,192,14,21,-7
19,11,193,7,9,-2
19,11,194,18,9,9
19,11,195,6,22,-16
19,11,196,13,19,-6
19,11,197,11,20,-9
19,11,198,17,13,4
19,11,199,10,12,-2
19,11,200,14,27,-13
19,11,201,12,11,1
19,11,202,3,10,-7
19,11,203,11,27,-16
19,11,204,15,12,3
19,11,205,6,16,-10
19,11,206,7,15,-8
19,11,207,5,27,-22
19,11,208,8,25,-17
19,11,209,13,25,-12
19,11,210,19,28,-9
19,11,211,8,8,0
19,11,212,13,34,-21
19,11,213,9,21,-12
19,11,214,16,26,-10
19,11,215,11,23,-12
19,11,216,11,9,2
19,11,217,11,20,-9
19,11,218,5,22,-17
19,11,219,16,11,5
19,11,220,5,3,2
19,11,221,24,20,4
19,11,222,9,21,-12
19,11,223,7,22,-15
19,11,224,20,15,5
19,11,225,3,8,-5
19,11,226,18,18,0
19,11,227,8,12,-4
19,11,228,21,30,-9
19,11,229,8,16,-8
19,11,230,15,20,-5
19,11,231,17,24,-7
19,11,232,10,7,3
19,11,233,9,18,-9
19,11,234,9,13,-4
19,11,235,4,5,-1
19,11,236,10,16,-6
19,11,237,14,13,1
19,11,238,13,17,-4
19,11,239,13,13,0
19,11,240,30,14,16
19,11,241,16,28,-12
19,11,242,11,14,-3
19,11,243,14,22,-8
19,11,244,11,22,-11
19,11,245,18,15,3
19,11,246,7,14,-7
19,11,247,12,20,-8
19,11,248,12,20,-8
19,11,249,24,15,9
19,11,250,13,10,3
19,11,251,15,28,-13
19,11,252,13,11,2
19,11,253,12,18,-6
19,11,254,15,20,-5
19,11,255,14,25,-11
19,11,256,11,12,-1
19,11,257,10,23,-13
19,11,258,17,14,3
19,11,259,27,31,-4
19,11,260,18,27,-9
19,11,261,13,16,-3
19,11,262,10,20,-10
19,11,263,3,6,-3
19,11,264,14,34,-20
19,11,265,11,18,-7
19,11,266,21,26,-5
19,11,267,16,22,-6
19,11,268,9,23,-14
19,11,269,12,13,-1
19,11,270,6,19,-13
19,11,271,7,15,-8
19,11,272,4,15,-11
19,11,273,6,13,-7
19,11,274,18,24,-6
19,11,275,7,20,-13
19,11,276,15,14,1
19,11,277,4,13,-9
19,11,278,14,24,-10
19,11,279,15,24,-9
19,11,280,17,15,2
19,11,281,9,19,-10
19,11,282,5,21,-16
19,11,283,16,20,-4
19,11,284,9,26,-17
19,11,285,15,21,-6
19,11,286,17,23,-6
19,11,287,19,24,-5
19,11,288,9,18,-9
19,11,289,8,12,-4
19,11,290,5,13,-8
19,11,291,21,16,5
19,11,292,9,30,-21
19,11,293,14,14,0
19,11,294,14,17,-3
19,11,295,12,18,-6
19,11,296,10,15,-5
19,11,297,17,14,3
19,11,298,15,20,-5
19,11,299,11,12,-1
19,12,0,10,23,-13
19,12,1,9,16,-7
19,12,2,11,15,-4
19,12,3,12,16,-4
19,12,4,14,21,-7
19,12,5,19,16,3
19,12,6,21,34,-13
19,12,7,23,13,10
19,12,8,29,25,4
19,12,9,4,30,-26
19,12,10,5,14,-9
19,12,11,15,22,-7
19,12,12,13,16,-3
19,12,13,12,20,-8
19,12,14,13,27,-14
19,12,15,7,10,-3
19,12,16,15,22,-7
19,12,17,20,15,5
19,12,18,9,17,-8
19,12,19,16,20,-4
19,12,20,19,17,2
19,12,21,21,16,5
19,12,22,7,14,-7
19,12,23,12,6,6
19,12,24,20,22,-2
19,12,25,11,13,-2
19,12,26,14,19,-5
19,12,27,18,21,-3
19,12,28,14,27,-13
19,12,29,12,17,-5
19,12,30,18,18,0
19,12,31,17,18,-1
19,12,32,16,22,-6
19,12,33,24,28,-4
19,12,34,7,23,-16
19,12,35,19,29,-10
19,12,36,18,17,1
19,12,37,30,22,8
19,12,38,18,15,3
19,12,39,12,12,0
19,12,40,6,11,-5
19,12,41,15,11,4
19,12,42,10,11,-1
19,12,43,3,20,-17
19,12,44,8,19,-11
19,12,45,16,30,-14
19,12,46,6,13,-7
19,12,47,6,17,-11
19,12,48,13,27,-14
19,12,49,8,22,-14
19,12,50,16,33,-17
19,12,51,15,21,-6
19,12,52,7,21,-14
19,12,53,13,16,-3
19,12,54,14,25,-11
19,12,55,10,21,-11
19,12,56,11,20,-9
19,12,57,8,18,-10
19,12,58,9,11,-2
19,12,59,8,13,-5
19,12,60,5,2,3
19,12,61,11,32,-21
19,12,62,8,15,-7
19,12,63,13,9,4
19,12,64,13,34,-21
19,12,65,6,25,-19
19,12,66,14,11,3
19,12,67,17,12,5
19,12,68,17,9,8
19,12,69,13,20,-7
19,12,70,19,19,0
19,12,71,14,26,-12
19,12,72,11,25,-14
19,12,73,4,14,-10
19,12,74,17,18,-1
19,12,75,1,11,-10
19,12,76,8,21,-13
19,12,77,14,17,-3
19,12,78,13,14,-1
19,12,79,19,23,-4
19,12,80,14,26,-12
19,12,81,7,17,-10
19,12,82,20,28,-8
19,12,83,18,24,-6
19,12,84,13,19,-6
19,12,85,22,28,-6
19,12,86,8,10,-2
19,12,87,9,10,-1
19,12,88,7,12,-5
19,12,89,12,20,-8
19,12,90,16,33,-17
19,12,91,15,21,-6
19,12,92,22,14,8
19,12,93,7,12,-5
19,12,94,17,19,-2
19,12,95,5,25,-20
19,12,96,7,16,-9
19,12,97,12,11,1
19,12,98,17,10,7
19,12,99,12,20,-8
19,12,100,17,21,-4
19,12,101,11,17,-6
19,12,102,20,21,-1
19,12,103,16,14,2
19,12,104,9,13,-4
19,12,105,14,14,0
19,12,106,7,15,-8
19,12,107,13,18,-5
19,12,108,8,17,-9
19,12,109,16,23,-7
19,12,110,11,12,-1
19,12,111,12,14,-2
19,12,112,22,15,7
19,12,113,19,27,-8
19,12,114,11,12,-1
19,12,115,14,21,-7
19,12,116,21,19,2
19,12,117,6,13,-7
19,12,118,11,18,-7
19,12,119,12,5,7
19,12,120,15,26,-11
19,12,121,14,6,8
19,12,122,18,13,5
19,12,123,12,13,-1
19,12,124,10,18,-8
19,12,125,11,12,-1
19,12,126,8,15,-7
19,12,127,17,14,3
19,12,128,11,30,-19
19,12,129,15,17,-2
19,12,130,11,11,0
19,12,131,9,19,-10
19,12,132,11,21,-10
19,12,133,9,9,0
19,12,134,15,8,7
19,12,135,21,12,9
19,12,136,13,22,-9
19,12,137,8,24,-16
19,12,138,13,24,-11
19,12,139,8,11,-3
19,12,140,10,10,0
19,12,141,12,19,-7
19,12,142,10,10,0
19,12,143,8,14,-6
19,12,144,11,18,-7
19,12,145,7,14,-7
19,12,146,17,23,-6
19,12,147,10,13,-3
19,12,148,23,29,-6
19,12,149,12,19,-7
19,12,150,12,6,6
19,12,151,17,25,-8
19,12,152,24,22,2
19,12,153,20,26,-6
19,12,154,12,21,-9
19,12,155,17,14,3
19,12,156,7,5,2
19,12,157,17,17,0
19,12,158,6,30,-24
19,12,159,16,9,7
19,12,160,6,21,-15
19,12,161,12,22,-10
19,12,162,7,7,0
19,12,163,10,18,-8
19,12,164,8,20,-12
19,12,165,3,10,-7
19,12,166,12,17,-5
19,12,167,10,12,-2
19,12,168,14,10,4
19,12,169,18,12,6
19,12,170,2,18,-16
19,12,171,17,15,2
19,12,172,12,22,-10
19,12,173,26,30,-4
19,12,174,14,15,-1
19,12,175,13,21,-8
19,12,176,19,13,6
19,12,177,16,19,-3
19,12,178,22,23,-1
19,12,179,13,7,6
19,12,180,8,12,-4
19,12,181,13,18,-5
19,12,182,16,20,-4
19,12,183,12,15,-3
19,12,184,23,15,8
19,12,185,8,14,-6
19,12,186,17,18,-1
19,12,187,12,11,1
19,12,188,20,28,-8
19,12,189,9,8,1
19,12,190,14,11,3
19,12,191,9,11,-2
19,12,192,14,17,-3
19,12,193,4,16,-12
19,12,194,8,13,-5
19,12,195,19,23,-4
19,12,196,14,22,-8
19,12,197,20,14,6
19,12,198,11,22,-11
19,12,199,20,20,0
19,12,200,13,7,6
19,12,201,21,17,4
19,12,202,9,26,-17
19,12,203,12,25,-13
19,12,204,5,15,-10
19,12,205,22,19,3
19,12,206,7,10,-3
19,12,207,14,12,2
19,12,208,9,10,-1
19,12,209,33,23,10
19,12,210,19,21,-2
19,12,211,11,16,-5
19,12,212,5,9,-4
19,12,213,17,17,0
19,12,214,19,11,8
19,12,215,22,21,1
19,12,216,14,8,6
19,12,217,13,13,0
19,12,218,20,13,7
19,12,219,10,20,-10
19,12,220,13,10,3
19,12,221,19,26,-7
19,12,222,16,26,-10
19,12,223,17,40,-23
19,12,224,21,24,-3
19,12,225,5,15,-10
19,12,226,13,27,-14
19,12,227,19,17,2
19,12,228,6,12,-6
19,12,229,9,19,-10
19,12,230,13,11,2
19,12,231,20,15,5
19,12,232,8,8,0
19,12,233,4,11,-7
19,12,234,10,11,-1
19,12,235,17,20,-3
19,12,236,7,9,-2
19,12,237,22,20,2
19,12,238,18,8,10
19,12,239,19,16,3
19,12,240,22,24,-2
19,12,241,14,3,11
19,12,242,10,4,6
19,12,243,1,17,-16
19,12,244,14,9,5
19,12,245,12,15,-3
19,12,246,8,9,-1
19,12,247,19,17,2
19,12,248,17,24,-7
19,12,249,16,17,-1
19,12,250,17,16,1
19,12,251,10,10,0
19,12,252,18,16,2
19,12,253,11,14,-3
19,12,254,13,22,-9
19,12,255,18,26,-8
19,12,256,4,7,-3
19,12,257,14,5,9
19,12,258,9,16,-7
19,12,259,28,24,4
19,12,260,16,20,-4
19,12,261,15,11,4
19,12,262,23,19,4
19,12,263,17,13,4
19,12,264,13,19,-6
19,12,265,5,6,-1
19,12,266,3,8,-5
19,12,267,15,32,-17
19,12,268,6,13,-7
19,12,269,11,16,-5
19,12,270,19,14,5
19,12,271,19,32,-13
19,12,272,12,23,-11
19,12,273,17,23,-6
19,12,274,12,21,-9
19,12,275,5,11,-6
19,12,276,9,17,-8
19,12,277,13,21,-8
19,12,278,11,18,-7
19,12,279,14,21,-7
19,12,280,17,10,7
19,12,281,6,6,0
19,12,282,16,26,-10
19,12,283,13,11,2
19,12,284,18,9,9
19,12,285,15,25,-10
19,12,286,7,17,-10
19,12,287,10,13,-3
19,12,288,21,29,-8
19,12,289,10,20,-10
19,12,290,12,15,-3
19,12,291,13,10,3
19,12,292,18,22,-4
19,12,293,12,14,-2
19,12,294,4,21,-17
19,12,295,16,14,2
19,12,296,17,10,7
19,12,297,19,25,-6
19,12,298,4,23,-19
19,12,299,21,18,3
19,13,0,15,27,-12
19,13,1,11,15,-4
19,13,2,19,16,3
19,13,3,15,28,-13
19,13,4,9,23,-14
19,13,5,11,13,-2
19,13,6,8,9,-1
19,13,7,12,20,-8
19,13,8,19,21,-2
19,13,9,25,15,10
19,13,10,18,15,3
19,13,11,6,13,-7
19,13,12,14,19,-5
19,13,13,8,20,-12
19,13,14,12,23,-11
19,13,15,12,13,-1
19,13,16,7,13,-6
19,13,17,11,20,-9
19,13,18,28,12,16
19,13,19,9,15,-6
19,13,20,14,16,-2
19,13,21,5,5,0
19,13,22,15,17,-2
19,13,23,6,14,-8
19,13,24,10,16,-6
19,13,25,21,25,-4
19,13,26,20,15,5
19,13,27,19,39,-20
19,13,28,8,9,-1
19,13,29,24,22,2
19,13,30,10,13,-3
19,13,31,10,14,-4
19,13,32,13,11,2
19,13,33,18,17,1
19,13,34,7,9,-2
19,13,35,10,10,0
19,13,36,14,19,-5
19,13,37,18,19,-1
19,13,38,16,13,3
19,13,39,16,18,-2
19,13,40,2,20,-18
19,13,41,20,34,-14
19,13,42,5,9,-4
19,13,43,16,36,-20
19,13,44,19,16,3
19,13,45,10,16,-6
19,13,46,10,20,-10
19,13,47,16,21,-5
19,13,48,24,30,-6
19,13,49,6,7,-1
19,13,50,15,19,-4
19,13,51,14,22,-8
19,13,52,5,14,-9
19,13,53,5,21,-16
19,13,54,9,13,-4
19,13,55,13,12,1
19,13,56,26,22,4
19,13,57,11,8,3
19,13,58,10,15,-5
19,13,59,15,24,-9
19,13,60,12,17,-5
19,13,61,19,20,-1
19,13,62,16,16,0
19,13,63,16,12,4
19,13,64,14,17,-3
19,13,65,9,16,-7
19,13,66,6,23,-17
19,13,67,10,14,-4
19,13,68,10,17,-7
19,13,69,13,20,-7
19,13,70,7,14,-7
19,13,71,25,23,2
19,13,72,18,27,-9
19,13,73,15,16,-1
19,13,74,22,16,6
19,13,75,10,20,-10
19,13,76,14,21,-7
19,13,77,17,13,4
19,13,78,14,11,3
19,13,79,14,32,-18
19,13,80,13,8,5
19,13,81,9,12,-3
19,13,82,10,19,-9
19,13,83,11,5,6
19,13,84,14,15,-1
19,13,85,14,18,-4
19,13,86,4,4,0
19,13,87,8,13,-5
19,13,88,18,22,-4
19,13,89,18,23,-5
19,13,90,18,20,-2
19,13,91,10,24,-14
19,13,92,11,19,-8
19,13,93,15,32,-17
19,13,94,18,11,7
19,13,95,22,21,1
19,13,96,17,18,-1
19,13,97,8,19,-11
19,13,98,19,21,-2
19,13,99,15,24,-9
19,13,100,18,34,-16
19,13,101,14,20,-6
19,13,102,11,28,-17
19,13,103,5,7,-2
19,13,104,7,16,-9
19,13,105,8,10,-2
19,13,106,17,10,7
19,13,107,13,13,0
19,13,108,14,12,2
19,13,109,10,32,-22
19,13,110,11,27,-16
19,13,111,12,14,-2
19,13,112,17,8,9
19,13,113,11,15,-4
19,13,114,10,26,-16
19,13,115,17,23,-6
19,13,116,8,29,-21
19,13,117,12,14,-2
19,13,118,11,6,5
19,13,119,13,12,1
19,13,120,18,12,6
19,13,121,23,27,-4
19,13,122,9,25,-16
19,13,123,12,7,5
19,13,124,17,20,-3
19,13,125,6,16,-10
19,13,126,22,27,-5
19,13,127,7,6,1
19,13,128,10,14,-4
19,13,129,16,16,0
19,13,130,9,23,-14
19,13,131,19,28,-9
19,13,132,12,22,-10
19,13,133,17,18,-1
19,13,134,12,3,9
19,13,135,6,18,-12
19,13,136,8,12,-4
19,13,137,7,13,-6
19,13,138,11,23,-12
19,13,139,13,37,-24
19,13,140,23,8,15
19,13,141,6,13,-7
19,13,142,22,19,3
19,13,143,9,21,-12
19,13,144,13,14,-1
19,13,145,18,19,-1
19,13,146,16,23,-7
19,13,147,7,8,-1
19,13,148,18,16,2
19,13,149,11,7,4
19,13,150,13,19,-6
19,13,151,25,26,-1
19,13,152,9,18,-9
19,13,153,11,22,-11
19,13,154,13,19,-6
19,13,155,18,18,0
19,13,156,11,33,-22
19,13,157,16,13,3
19,13,158,9,8,1
19,13,159,17,20,-3
19,13,160,10,19,-9
19,13,161,10,17,-7
19,13,162,14,29,-15
19,13,163,8,23,-15
19,13,164,9,10,-1
19,13,165,17,10,7
19,13,166,6,21,-15
19,13,167,16,15,1
19,13,168,13,14,-1
19,13,169,12,22,-10
19,13,170,17,19,-2
19,13,171,19,17,2
19,13,172,9,15,-6
19,13,173,14,19,-5
19,13,174,13,18,-5
19,13,175,22,23,-1
19,13,176,20,19,1
19,13,177,13,15,-2
19,13,178,18,8,10
19,13,179,14,23,-9
19,13,180,17,20,-3
19,13,181,11,20,-9
19,13,182,9,17,-8
19,13,183,8,17,-9
19,13,184,9,14,-5
19,13,185,16,18,-2
19,13,186,10,19,-9
19,13,187,14,22,-8
19,13,188,16,16,0
19,13,189,7,11,-4
19,13,190,5,11,-6
19,13,191,6,6,0
19,13,192,7,5,2
19,13,193,15,26,-11
19,13,194,20,11,9
19,13,195,6,18,-12
19,13,196,3,10,-7
19,13,197,11,7,4
19,13,198,10,18,-8
19,13,199,10,22,-12
19,13,200,6,11,-5
19,13,201,9,13,-4
19,13,202,14,31,-17
19,13,203,13,18,-5
19,13,204,10,5,5
19,13,205,8,12,-4
19,13,206,21,14,7
19,13,207,15,11,4
19,13,208,15,18,-3
19,13,209,18,23,-5
19,13,210,12,15,-3
19,13,211,14,20,-6
19,13,212,21,16,5
19,13,213,13,8,5
19,13,214,15,34,-19
19,13,215,8,20,-12
19,13,216,5,16,-11
19,13,217,27,16,11
19,13,218,10,11,-1
19,13,219,13,10,3
19,13,220,11,11,0
19,13,221,10,22,-12
19,13,222,17,18,-1
19,13,223,24,21,3
19,13,224,4,21,-17
19,13,225,15,15,0
19,13,226,17,16,1
19,13,227,10,18,-8
19,13,228,20,30,-10
19,13,229,23,22,1
19,13,230,20,24,-4
19,13,231,18,7,11
19,13,232,9,14,-5
19,13,233,13,27,-14
19,13,234,9,11,-2
19,13,235,15,26,-11
19,13,236,8,18,-10
19,13,237,7,19,-12
19,13,238,18,28,-10
19,13,239,10,26,-16
19,13,240,17,17,0
19,13,241,9,32,-23
19,13,242,10,16,-6
19,13,243,13,27,-14
19,13,244,3,19,-16
19,13,245,13,13,0
19,13,246,10,22,-12
19,13,247,12,13,-1
19,13,248,15,15,0
19,13,249,12,20,-8
19,13,250,21,39,-18
19,13,251,14,17,-3
19,13,252,10,14,-4
19,13,253,11,11,0
19,13,254,4,19,-15
19,13,255,12,19,-7
19,13,256,19,31,-12
19,13,257,24,32,-8
19,13,258,5,14,-9
19,13,259,4,16,-12
19,13,260,17,24,-7
19,13,261,10,22,-12
19,13,262,8,18,-10
19,13,263,12,22,-10
19,13,264,16,23,-7
19,13,265,6,10,-4
19,13,266,15,11,4
19,13,267,12,15,-3
19,13,268,16,12,4
19,13,269,19,22,-3
19,13,270,10,18,-8
19,13,271,13,33,-20
19,13,272,22,22,0
19,13,273,10,12,-2
19,13,274,11,24,-13
19,13,275,25,26,-1
19,13,276,15,11,4
19,13,277,23,18,5
19,13,278,25,17,8
19,13,279,12,23,-11
19,13,280,11,24,-13
19,13,281,9,24,-15
19,13,282,18,19,-1
19,13,283,18,19,-1
19,13,284,5,6,-1
19,13,285,18,16,2
19,13,286,11,12,-1
19,13,287,16,19,-3
19,13,288,6,17,-11
19,13,289,18,9,9
19,13,290,6,14,-8
19,13,291,17,14,3
19,13,292,14,18,-4
19,13,293,16,20,-4
19,13,294,6,8,-2
19,13,295,4,24,-20
19,13,296,10,19,-9
19,13,297,26,21,5
19,13,298,13,25,-12
19,13,299,8,17,-9
19,14,0,17,36,-19
19,14,1,8,9,-1
19,14,2,22,21,1
19,14,3,25,13,12
19,14,4,3,10,-7
19,14,5,11,18,-7
19,14,6,16,9,7
19,14,7,15,18,-3
19,14,8,20,18,2
19,14,9,12,19,-7
19,14,10,9,13,-4
19,14,11,12,11,1
19,14,12,16,29,-13
19,14,13,12,21,-9
19,14,14,18,17,1
19,14,15,8,21,-13
19,14,16,7,14,-7
19,14,17,26,32,-6
19,14,18,20,14,6
19,14,19,4,17,-13
19,14,20,25,13,12
19,14,21,8,7,1
19,14,22,30,22,8
19,14,23,9,13,-4
19,14,24,23,12,11
19,14,25,13,19,-6
19,14,26,3,15,-12
19,14,27,10,36,-26
19,14,28,13,20,-7
19,14,29,9,19,-10
19,14,30,14,20,-6
19,14,31,7,11,-4
19,14,32,10,20,-10
19,14,33,36,10,26
19,14,34,9,17,-8
19,14,35,11,8,3
19,14,36,11,19,-8
19,14,37,12,20,-8
19,14,38,14,31,-17
19,14,39,17,17,0
19,14,40,11,14,-3
19,14,41,6,13,-7
19,14,42,14,9,5
19,14,43,13,12,1
19,14,44,18,26,-8
19,14,45,11,13,-2
19,14,46,8,28,-20
19,14,47,22,22,0
19,14,48,20,20,0
19,14,49,14,12,2
19,14,50,13,14,-1
19,14,51,11,16,-5
19,14,52,14,16,-2
19,14,53,6,19,-13
19,14,54,12,21,-9
19,14,55,18,12,6
19,14,56,25,23,2
19,14,57,22,10,12
19,14,58,7,11,-4
19,14,59,17,14,3
19,14,60,22,25,-3
19,14,61,8,16,-8
19,14,62,5,10,-5
19,14,63,20,29,-9
19,14,64,12,35,-23
19,14,65,12,18,-6
19,14,66,20,10,10
19,14,67,20,26,-6
19,14,68,22,31,-9
19,14,69,14,18,-4
19,14,70,13,20,-7
19,14,71,13,17,-4
19,14,72,4,19,-15
19,14,73,29,29,0
19,14,74,22,14,8
19,14,75,17,27,-10
19,14,76,12,9,3
19,14,77,13,26,-13
19,14,78,17,18,-1
19,14,79,4,14,-10
19,14,80,19,18,1
19,14,81,5,12,-7
19,14,82,12,9,3
19,14,83,9,28,-19
19,14,84,15,14,1
19,14,85,8,13,-5
19,14,86,19,14,5
19,14,87,15,13,2
19,14,88,10,17,-7
19,14,89,14,24,-10
19,14,90,10,12,-2
19,14,91,10,13,-3
19,14,92,23,9,14
19,14,93,13,17,-4
19,14,94,8,4,4
19,14,95,6,10,-4
19,14,96,9,23,-14
19,14,97,7,16,-9
19,14,98,14,21,-7
19,14,99,10,15,-5
19,14,100,16,13,3
19,14,101,6,7,-1
19,14,102,16,22,-6
19,14,103,10,17,-7
19,14,104,16,31,-15
19,14,105,6,10,-4
19,14,106,8,6,2
19,14,107,6,14,-8
19,14,108,11,12,-1
19,14,109,5,18,-13
19,14,110,15,16,-1
19,14,111,16,22,-6
19,14,112,11,17,-6
19,14,113,9,10,-1
19,14,114,11,14,-3
19,14,115,11,10,1
19,14,116,20,28,-8
19,14,117,16,18,-2
19,14,118,5,15,-10
19,14,119,16,17,-1
19,14,120,8,14,-6
19,14,121,16,16,0
19,14,122,14,17,-3
19,14,123,18,13,5
19,14,124,25,31,-6
19,14,125,24,18,6
19,14,126,15,13,2
19,14,127,9,17,-8
19,14,128,17,20,-3
19,14,129,7,6,1
19,14,130,14,8,6
19,14,131,12,23,-11
19,14,132,10,11,-1
19,14,133,19,14,5
19,14,134,14,21,-7
19,14,135,39,21,18
19,14,136,20,19,1
19,14,137,9,19,-10
19,14,138,11,7,4
19,14,139,14,9,5
19,14,140,18,31,-13
19,14,141,9,28,-19
19,14,142,15,22,-7
19,14,143,17,20,-3
19,14,144,8,12,-4
19,14,145,4,12,-8
19,14,146,3,14,-11
19,14,147,12,21,-9
19,14,148,15,14,1
19,14,149,9,18,-9
19,14,150,9,14,-5
19,14,151,27,14,13
19,14,152,9,13,-4
19,14,153,13,30,-17
19,14,154,6,32,-26
19,14,155,20,11,9
19,14,156,14,9,5
19,14,157,19,20,-1
19,14,158,9,9,0
19,14,159,15,19,-4
19,14,160,2,21,-19
19,14,161,7,18,-11
19,14,162,21,15,6
19,14,163,12,11,1
19,14,164,3,11,-8
19,14,165,12,8,4
19,14,166,3,7,-4
19,14,167,17,15,2
19,14,168,15,23,-8
19,14,169,12,22,-10
19,14,170,18,20,-2
19,14,171,25,29,-4
19,14,172,16,14,2
19,14,173,21,18,3
19,14,174,7,6,1
19,14,175,7,19,-12
19,14,176,10,11,-1
19,14,177,20,20,0
19,14,178,22,11,11
19,14,179,9,15,-6
19,14,180,25,6,19
19,14,181,17,19,-2
19,14,182,17,18,-1
19,14,183,9,3,6
19,14,184,10,6,4
19,14,185,16,27,-11
19,14,186,14,9,5
19,14,187,10,16,-6
19,14,188,30,18,12
19,14,189,22,12,10
19,14,190,3,18,-15
19,14,191,18,11,7
19,14,192,9,16,-7
19,14,193,1,13,-12
19,14,194,18,20,-2
19,14,195,24,19,5
19,14,196,8,20,-12
19,14,197,19,14,5
19,14,198,12,24,-12
19,14,199,8,12,-4
19,14,200,12,6,6
19,14,201,16,19,-3
19,14,202,7,20,-13
19,14,203,21,13,8
19,14,204,13,9,4
19,14,205,13,22,-9
19,14,206,17,16,1
19,14,207,11,19,-8
19,14,208,17,25,-8
19,14,209,22,32,-10
19,14,210,8,11,-3
19,14,211,10,11,-1
19,14,212,19,31,-12
19,14,213,12,14,-2
19,14,214,18,7,11
19,14,215,21,15,6
19,14,216,19,18,1
19,14,217,11,12,-1
19,14,218,16,30,-14
19,14,219,11,21,-10
19,14,220,8,4,4
19,14,221,11,10,1
19,14,222,9,17,-8
19,14,223,19,20,-1
19,14,224,15,18,-3
19,14,225,22,16,6
19,14,226,14,23,-9
19,14,227,16,8,8
19,14,228,7,20,-13
19,14,229,23,35,-12
19,14,230,10,17,-7
19,14,231,24,9,15
19,14,232,25,25,0
19,14,233,17,27,-10
19,14,234,8,18,-10
19,14,235,15,23,-8
19,14,236,9,13,-4
19,14,237,9,16,-7
19,14,238,21,26,-5
19,14,239,15,26,-11
19,14,240,15,23,-8
19,14,241,19,28,-9
19,14,242,19,21,-2
19,14,243,6,11,-5
19,14,244,11,17,-6
19,14,245,24,19,5
19,14,246,14,16,-2
19,14,247,27,21,6
19,14,248,16,24,-8
19,14,249,11,18,-7
19,14,250,15,15,0
19,14,251,12,23,-11
19,14,252,5,13,-8
19,14,253,12,20,-8
19,14,254,16,15,1
19,14,255,16,27,-11
19,14,256,19,15,4
19,14,257,16,9,7
19,14,258,16,21,-5
19,14,259,23,23,0
19,14,260,13,19,-6
19,14,261,20,16,4
19,14,262,12,19,-7
19,14,263,13,22,-9
19,14,264,11,15,-4
19,14,265,8,22,-14
19,14,266,12,21,-9
19,14,267,11,17,-6
19,14,268,16,21,-5
19,14,269,21,24,-3
19,14,270,16,19,-3
19,14,271,9,25,-16
19,14,272,8,9,-1
19,14,273,14,16,-2
19,14,274,11,14,-3
19,14,275,20,27,-7
19,14,276,10,20,-10
19,14,277,11,14,-3
19,14,278,14,22,-8
19,14,279,8,12,-4
19,14,280,13,10,3
19,14,281,6,12,-6
19,14,282,11,8,3
19,14,283,18,15,3
19,14,284,8,18,-10
19,14,285,14,7,7
19,14,286,18,24,-6
19,14,287,27,24,3
19,14,288,16,18,-2
19,14,289,20,13,7
19,14,290,23,27,-4
19,14,291,19,31,-12
19,14,292,23,23,0
19,14,293,16,29,-13
19,14,294,13,14,-1
19,14,295,16,17,-1
19,14,296,11,11,0
19,14,297,18,25,-7
19,14,298,9,16,-7
19,14,299,5,7,-2
19,15,0,16,20,-4
19,15,1,5,12,-7
19,15,2,13,9,4
19,15,3,20,27,-7
19,15,4,18,15,3
19,15,5,24,18,6
19,15,6,24,10,14
19,15,7,15,7,8
19,15,8,8,8,0
19,15,9,7,9,-2
19,15,10,10,15,-5
19,15,11,17,19,-2
19,15,12,7,14,-7
19,15,13,17,26,-9
19,15,14,22,18,4
19,15,15,14,13,1
19,15,16,15,24,-9
19,15,17,19,22,-3
19,15,18,18,16,2
19,15,19,18,21,-3
19,15,20,24,17,7
19,15,21,13,14,-1
19,15,22,11,17,-6
19,15,23,17,17,0
19,15,24,5,8,-3
19,15,25,12,23,-11
19,15,26,14,8,6
19,15,27,20,18,2
19,15,28,25,19,6
19,15,29,9,19,-10
19,15,30,23,18,5
19,15,31,3,8,-5
19,15,32,14,17,-3
19,15,33,11,6,5
19,15,34,28,20,8
19,15,35,9,11,-2
19,15,36,12,24,-12
19,15,37,6,14,-8
19,15,38,8,22,-14
19,15,39,8,5,3
19,15,40,18,21,-3
19,15,41,13,15,-2
19,15,42,9,8,1
19,15,43,4,13,-9
19,15,44,10,10,0
19,15,45,18,15,3
19,15,46,15,19,-4
19,15,47,13,21,-8
19,15,48,21,18,3
19,15,49,12,11,1
19,15,50,15,7,8
19,15,51,12,16,-4
19,15,52,5,13,-8
19,15,53,18,19,-1
19,15,54,12,14,-2
19,15,55,7,5,2
19,15,56,8,14,-6
19,15,57,7,14,-7
19,15,58,7,14,-7
19,15,59,31,21,10
19,15,60,13,16,-3
19,15,61,20,16,4
19,15,62,5,12,-7
19,15,63,7,11,-4
19,15,64,7,15,-8
19,15,65,14,15,-1
19,15,66,16,14,2
19,15,67,20,26,-6
19,15,68,12,19,-7
19,15,69,19,28,-9
19,15,70,11,22,-11
19,15,71,7,28,-21
19,15,72,20,31,-11
19,15,73,23,14,9
19,15,74,13,29,-16
19,15,75,6,7,-1
19,15,76,13,4,9
19,15,77,15,16,-1
19,15,78,17,12,5
19,15,79,9,11,-2
19,15,80,23,17,6
19,15,81,21,30,-9
19,15,82,7,10,-3
19,15,83,20,23,-3
19,15,84,26,27,-1
19,15,85,8,7,1
19,15,86,17,13,4
19,15,87,17,23,-6
19,15,88,19,22,-3
19,15,89,25,22,3
19,15,90,16,9,7
19,15,91,17,16,1
19,15,92,5,13,-8
19,15,93,9,16,-7
19,15,94,19,20,-1
19,15,95,18,24,-6
19,15,96,18,9,9
19,15,97,12,21,-9
19,15,98,14,15,-1
19,15,99,9,12,-3
19,15,100,7,16,-9
19,15,101,3,16,-13
19,15,102,11,15,-4
19,15,103,22,24,-2
19,15,104,4,7,-3
19,15,105,7,16,-9
19,15,106,8,19,-11
19,15,107,26,17,9
19,15,108,5,9,-4
19,15,109,17,13,4
19,15,110,13,18,-5
19,15,111,10,13,-3
19,15,112,8,14,-6
19,15,113,14,23,-9
19,15,114,10,13,-3
19,15,115,9,6,3
19,15,116,18,29,-11
19,15,117,17,20,-3
19,15,118,10,13,-3
19,15,119,28,27,1
19,15,120,13,19,-6
19,15,121,17,20,-3
19,15,122,12,32,-20
19,15,123,25,34,-9
19,15,124,19,13,6
19,15,125,11,20,-9
19,15,126,13,24,-11
19,15,127,22,21,1
19,15,128,13,8,5
19,15,129,21,22,-1
19,15,130,11,14,-3
19,15,131,12,12,0
19,15,132,12,27,-15
19,15,133,18,22,-4
19,15,134,18,32,-14
19,15,135,9,14,-5
19,15,136,5,9,-4
19,15,137,13,15,-2
19,15,138,15,13,2
19,15,139,13,14,-1
19,15,140,9,17,-8
19,15,141,11,18,-7
19,15,142,20,24,-4
19,15,143,6,14,-8
19,15,144,11,14,-3
19,15,145,16,14,2
19,15,146,6,10,-4
19,15,147,11,17,-6
19,15,148,24,25,-1
19,15,149,22,19,3
19,15,150,25,13,12
19,15,151,9,7,2
19,15,152,34,18,16
19,15,153,17,18,-1
19,15,154,17,18,-1
19,15,155,17,19,-2
19,15,156,16,14,2
19,15,157,16,17,-1
19,15,158,17,21,-4
19,15,159,14,20,-6
19,15,160,17,26,-9
19,15,161,5,25,-20
19,15,162,7,12,-5
19,15,163,19,14,5
19,15,164,12,22,-10
19,15,165,14,11,3
19,15,166,24,48,-24
19,15,167,13,15,-2
19,15,168,24,8,16
19,15,169,16,13,3
19,15,170,30,27,3
19,15,171,18,34,-16
19,15,172,11,29,-18
19,15,173,10,15,-5
19,15,174,12,18,-6
19,15,175,4,17,-13
19,15,176,14,22,-8
19,15,177,15,19,-4
19,15,178,12,12,0
19,15,179,11,20,-9
19,15,180,8,11,-3
19,15,181,7,9,-2
19,15,182,13,22,-9
19,15,183,12,24,-12
19,15,184,27,15,12
19,15,185,20,27,-7
19,15,186,25,26,-1
19,15,187,5,12,-7
19,15,188,12,13,-1
19,15,189,17,25,-8
19,15,190,14,15,-1
19,15,191,8,19,-11
19,15,192,9,22,-13
19,15,193,14,11,3
19,15,194,6,18,-12
19,15,195,20,21,-1
19,15,196,12,14,-2
19,15,197,13,17,-4
19,15,198,10,9,1
19,15,199,9,18,-9
19,15,200,22,13,9
19,15,201,12,13,-1
19,15,202,16,17,-1
19,15,203,11,18,-7
19,15,204,12,25,-13
19,15,205,19,14,5
19,15,206,12,19,-7
19,15,207,12,17,-5
19,15,208,26,8,18
19,15,209,19,30,-11
19,15,210,7,13,-6
19,15,211,9,20,-11
19,15,212,8,9,-1
19,15,213,4,18,-14
19,15,214,23,8,15
19,15,215,7,17,-10
19,15,216,17,13,4
19,15,217,8,8,0
19,15,218,18,9,9
19,15,219,17,26,-9
19,15,220,10,10,0
19,15,221,15,12,3
19,15,222,11,14,-3
19,15,223,20,27,-7
19,15,224,9,16,-7
19,15,225,9,15,-6
19,15,226,12,5,7
19,15,227,16,27,-11
19,15,228,18,24,-6
19,15,229,10,6,4
19,15,230,9,23,-14
19,15,231,9,13,-4
19,15,232,12,6,6
19,15,233,8,7,1
19,15,234,9,27,-18
19,15,235,15,7,8
19,15,236,22,25,-3
19,15,237,14,12,2
19,15,238,12,18,-6
19,15,239,18,6,12
19,15,240,17,21,-4
19,15,241,13,13,0
19,15,242,22,30,-8
19,15,243,6,21,-15
19,15,244,26,42,-16
19,15,245,15,21,-6
19,15,246,17,21,-4
19,15,247,11,19,-8
19,15,248,7,11,-4
19,15,249,23,19,4
19,15,250,9,13,-4
19,15,251,5,6,-1
19,15,252,27,14,13
19,15,253,16,21,-5
19,15,254,16,25,-9
19,15,255,9,20,-11
19,15,256,21,19,2
19,15,257,8,11,-3
19,15,258,15,20,-5
19,15,259,11,19,-8
19,15,260,13,24,-11
19,15,261,21,14,7
19,15,262,20,28,-8
19,15,263,13,19,-6
19,15,264,12,20,-8
19,15,265,27,15,12
19,15,266,7,6,1
19,15,267,8,3,5
19,15,268,17,16,1
19,15,269,13,18,-5
19,15,270,11,18,-7
19,15,271,11,15,-4
19,15,272,18,11,7
19,15,273,24,13,11
19,15,274,15,19,-4
19,15,275,16,13,3
19,15,276,2,15,-13
19,15,277,17,14,3
19,15,278,8,16,-8
19,15,279,21,25,-4
19,15,280,10,7,3
19,15,281,7,27,-20
19,15,282,14,22,-8
19,15,283,16,19,-3
19,15,284,35,12,23
19,15,285,10,17,-7
19,15,286,15,15,0
19,15,287,14,23,-9
19,15,288,14,14,0
19,15,289,20,19,1
19,15,290,7,13,-6
19,15,291,15,16,-1
19,15,292,14,17,-3
19,15,293,27,10,17
19,15,294,29,16,13
19,15,295,6,21,-15
19,15,296,10,14,-4
19,15,297,26,8,18
19,15,298,19,26,-7
19,15,299,17,23,-6
19,16,0,10,19,-9
19,16,1,11,16,-5
19,16,2,13,9,4
19,16,3,17,8,9
19,16,4,9,18,-9
19,16,5,9,21,-12
19,16,6,16,24,-8
19,16,7,12,11,1
19,16,8,12,14,-2
19,16,9,14,18,-4
19,16,10,13,10,3
19,16,11,11,23,-12
19,16,12,10,12,-2
19,16,13,18,18,0
19,16,14,15,11,4
19,16,15,13,11,2
19,16,16,22,13,9
19,16,17,8,19,-11
19,16,18,23,12,11
19,16,19,19,20,-1
19,16,20,28,24,4
19,16,21,7,12,-5
19,16,22,8,9,-1
19,16,23,21,23,-2
19,16,24,4,16,-12
19,16,25,8,15,-7
19,16,26,19,19,0
19,16,27,19,18,1
19,16,28,7,8,-1
19,16,29,16,20,-4
19,16,30,20,16,4
19,16,31,18,20,-2
19,16,32,20,20,0
19,16,33,24,27,-3
19,16,34,13,12,1
19,16,35,14,12,2
19,16,36,17,14,3
19,16,37,21,21,0
19,16,38,11,12,-1
19,16,39,23,22,1
19,16,40,21,16,5
19,16,41,17,6,11
19,16,42,10,22,-12
19,16,43,14,25,-11
19,16,44,14,19,-5
19,16,45,17,15,2
19,16,46,8,15,-7
19,16,47,15,16,-1
19,16,48,13,9,4
19,16,49,12,21,-9
19,16,50,8,16,-8
19,16,51,14,8,6
19,16,52,10,11,-1
19,16,53,12,15,-3
19,16,54,13,12,1
19,16,55,12,14,-2
19,16,56,22,29,-7
19,16,57,15,25,-10
19,16,58,15,20,-5
19,16,59,12,11,1
19,16,60,14,10,4
19,16,61,20,12,8
19,16,62,13,29,-16
19,16,63,14,16,-2
19,16,64,19,9,10
19,16,65,10,8,2
19,16,66,16,12,4
19,16,67,10,21,-11
19,16,68,3,11,-8
19,16,69,8,14,-6
19,16,70,17,17,0
19,16,71,21,12,9
19,16,72,20,29,-9
19,16,73,14,24,-10
19,16,74,6,19,-13
19,16,75,21,8,13
19,16,76,17,27,-10
19,16,77,5,10,-5
19,16,78,16,6,10
19,16,79,13,14,-1
19,16,80,14,9,5
19,16,81,16,17,-1
19,16,82,26,26,0
19,16,83,17,27,-10
19,16,84,10,15,-5
19,16,85,15,26,-11
19,16,86,17,16,1
19,16,87,19,21,-2
19,16,88,17,24,-7
19,16,89,19,23,-4
19,16,90,12,10,2
19,16,91,10,5,5
19,16,92,21,17,4
19,16,93,11,25,-14
19,16,94,11,21,-10
19,16,95,7,16,-9
19,16,96,17,13,4
19,16,97,11,18,-7
19,16,98,23,27,-4
19,16,99,17,16,1
19,16,100,7,7,0
19,16,101,15,16,-1
19,16,102,13,13,0
19,16,103,26,21,5
19,16,104,20,19,1
19,16,105,31,23,8
19,16,106,10,12,-2
19,16,107,4,17,-13
19,16,108,13,18,-5
19,16,109,10,15,-5
19,16,110,17,21,-4
19,16,111,13,26,-13
19,16,112,11,9,2
19,16,113,17,11,6
19,16,114,7,10,-3
19,16,115,15,22,-7
19,16,116,16,15,1
19,16,117,6,14,-8
19,16,118,12,9,3
19,16,119,19,16,3
19,16,120,4,17,-13
19,16,121,9,18,-9
19,16,122,16,12,4
19,16,123,8,11,-3
19,16,124,21,21,0
19,16,125,5,9,-4
19,16,126,14,8,6
19,16,127,23,28,-5
19,16,128,7,20,-13
19,16,129,18,17,1
19,16,130,13,21,-8
19,16,131,12,21,-9
19,16,132,17,24,-7
19,16,133,17,9,8
19,16,134,25,13,12
19,16,135,11,15,-4
19,16,136,15,17,-2
19,16,137,12,21,-9
19,16,138,7,17,-10
19,16,139,3,7,-4
19,16,140,12,20,-8
19,16,141,17,2,15
19,16,142,10,7,3
19,16,143,17,23,-6
19,16,144,14,18,-4
19,16,145,19,14,5
19,16,146,13,26,-13
19,16,147,14,19,-5
19,16,148,20,10,10
19,16,149,17,14,3
19,16,150,8,5,3
19,16,151,24,11,13
19,16,152,27,29,-2
19,16,153,17,15,2
19,16,154,19,22,-3
19,16,155,9,16,-7
19,16,156,16,19,-3
19,16,157,14,7,7
19,16,158,17,13,4
19,16,159,12,18,-6
19,16,160,11,12,-1
19,16,161,7,13,-6
19,16,162,9,14,-5
19,16,163,6,13,-7
19,16,164,6,9,-3
19,16,165,20,25,-5
19,16,166,25,25,0
19,16,167,13,20,-7
19,16,168,11,16,-5
19,16,169,19,14,5
19,16,170,18,23,-5
19,16,171,10,2,8
19,16,172,12,8,4
19,16,173,20,20,0
19,16,174,14,18,-4
19,16,175,43,23,20
19,16,176,21,11,10
19,16,177,10,23,-13
19,16,178,22,9,13
19,16,179,11,13,-2
19,16,180,10,19,-9
19,16,181,14,18,-4
19,16,182,16,27,-11
19,16,183,16,24,-8
19,16,184,12,14,-2
19,16,185,16,13,3
19,16,186,10,13,-3
19,16,187,24,28,-4
19,16,188,9,11,-2
19,16,189,10,19,-9
19,16,190,18,16,2
19,16,191,20,13,7
19,16,192,20,20,0
19,16,193,9,4,5
19,16,194,18,21,-3
19,16,195,19,17,2
19,16,196,11,18,-7
19,16,197,17,15,2
19,16,198,11,20,-9
19,16,199,9,10,-1
19,16,200,17,19,-2
19,16,201,9,14,-5
19,16,202,20,21,-1
19,16,203,12,6,6
19,16,204,9,13,-4
19,16,205,10,10,0
19,16,206,18,16,2
19,16,207,19,12,7
19,16,208,15,6,9
19,16,209,17,19,-2
19,16,210,16,25,-9
19,16,211,20,16,4
19,16,212,24,20,4
19,16,213,8,2,6
19,16,214,18,9,9
19,16,215,15,27,-12
19,16,216,11,16,-5
19,16,217,18,12,6
19,16,218,28,8,20
19,16,219,20,21,-1
19,16,220,14,17,-3
19,16,221,19,33,-14
19,16,222,13,13,0
19,16,223,7,19,-12
19,16,224,13,13,0
19,16,225,11,27,-16
19,16,226,19,13,6
19,16,227,21,27,-6
19,16,228,15,22,-7
19,16,229,12,19,-7
19,16,230,18,28,-10
19,16,231,11,20,-9
19,16,232,14,22,-8
19,16,233,27,24,3
19,16,234,13,17,-4
19,16,235,14,27,-13
19,16,236,11,6,5
19,16,237,13,12,1
19,16,238,24,12,12
19,16,239,14,19,-5
19,16,240,10,21,-11
19,16,241,11,20,-9
19,16,242,10,13,-3
19,16,243,10,16,-6
19,16,244,14,10,4
19,16,245,14,14,0
19,16,246,12,16,-4
19,16,247,14,17,-3
19,16,248,19,20,-1
19,16,249,9,11,-2
19,16,250,7,17,-10
19,16,251,14,11,3
19,16,252,3,8,-5
19,16,253,23,32,-9
19,16,254,28,22,6
19,16,255,12,17,-5
19,16,256,16,10,6
19,16,257,7,17,-10
19,16,258,18,17,1
19,16,259,15,10,5
19,16,260,9,17,-8
19,16,261,8,9,-1
19,16,262,7,12,-5
19,16,263,27,20,7
19,16,264,8,14,-6
19,16,265,12,22,-10
19,16,266,7,11,-4
19,16,267,8,34,-26
19,16,268,14,26,-12
19,16,269,20,18,2
19,16,270,8,7,1
19,16,271,14,37,-23
19,16,272,7,21,-14
19,16,273,16,17,-1
19,16,274,25,12,13
19,16,275,26,17,9
19,16,276,18,10,8
19,16,277,8,13,-5
19,16,278,20,23,-3
19,16,279,3,12,-9
19,16,280,21,10,11
19,16,281,20,18,2
19,16,282,18,19,-1
19,16,283,16,17,-1
19,16,284,14,11,3
19,16,285,3,19,-16
19,16,286,29,31,-2
19,16,287,17,13,4
19,16,288,11,39,-28
19,16,289,16,14,2
19,16,290,8,12,-4
19,16,291,9,20,-11
19,16,292,6,11,-5
19,16,293,18,25,-7
19,16,294,15,17,-2
19,16,295,11,11,0
19,16,296,14,21,-7
19,16,297,14,21,-7
19,16,298,13,16,-3
19,16,299,3,17,-14
19,17,0,17,24,-7
19,17,1,9,13,-4
19,17,2,12,20,-8
19,17,3,14,29,-15
19,17,4,9,18,-9
19,17,5,14,17,-3
19,17,6,13,11,2
19,17,7,18,27,-9
19,17,8,23,22,1
19,17,9,12,13,-1
19,17,10,12,20,-8
19,17,11,8,8,0
19,17,12,16,32,-16
19,17,13,7,6,1
19,17,14,8,8,0
19,17,15,9,16,-7
19,17,16,7,26,-19
19,17,17,30,20,10
19,17,18,25,18,7
19,17,19,15,18,-3
19,17,20,4,11,-7
19,17,21,20,30,-10
19,17,22,14,10,4
19,17,23,7,24,-17
19,17,24,8,21,-13
19,17,25,17,17,0
19,17,26,14,15,-1
19,17,27,26,27,-1
19,17,28,12,23,-11
19,17,29,7,11,-4
19,17,30,11,11,0
19,17,31,16,12,4
19,17,32,7,15,-8
19,17,33,13,13,0
19,17,34,12,9,3
19,17,35,15,15,0
19,17,36,7,11,-4
19,17,37,6,16,-10
19,17,38,10,18,-8
19,17,39,15,18,-3
19,17,40,4,8,-4
19,17,41,14,7,7
19,17,42,8,17,-9
19,17,43,18,17,1
19,17,44,22,22,0
19,17,45,8,13,-5
19,17,46,12,19,-7
19,17,47,26,20,6
19,17,48,17,15,2
19,17,49,16,19,-3
19,17,50,8,18,-10
19,17,51,5,5,0
19,17,52,17,17,0
19,17,53,10,5,5
19,17,54,19,15,4
19,17,55,17,17,0
19,17,56,19,24,-5
19,17,57,18,17,1
19,17,58,19,6,13
19,17,59,17,14,3
19,17,60,19,19,0
19,17,61,15,10,5
19,17,62,14,9,5
19,17,63,17,13,4
19,17,64,16,18,-2
19,17,65,18,12,6
19,17,66,8,12,-4
19,17,67,16,14,2
19,17,68,16,19,-3
19,17,69,16,31,-15
19,17,70,23,19,4
19,17,71,12,15,-3
19,17,72,19,12,7
19,17,73,5,13,-8
19,17,74,20,12,8
19,17,75,11,8,3
19,17,76,13,17,-4
19,17,77,9,19,-10
19,17,78,11,14,-3
19,17,79,28,31,-3
19,17,80,16,14,2
19,17,81,10,14,-4
19,17,82,23,32,-9
19,17,83,18,13,5
19,17,84,13,18,-5
19,17,85,11,17,-6
19,17,86,14,25,-11
19,17,87,5,15,-10
19,17,88,9,13,-4
19,17,89,14,11,3
19,17,90,19,4,15
19,17,91,18,36,-18
19,17,92,17,20,-3
19,17,93,10,8,2
19,17,94,18,17,1
19,17,95,6,8,-2
19,17,96,14,15,-1
19,17,97,13,11,2
19,17,98,11,23,-12
19,17,99,10,16,-6
19,17,100,13,8,5
19,17,101,13,13,0
19,17,102,16,18,-2
19,17,103,21,15,6
19,17,104,14,28,-14
19,17,105,14,28,-14
19,17,106,18,23,-5
19,17,107,15,14,1
19,17,108,8,2,6
19,17,109,18,18,0
19,17,110,14,13,1
19,17,111,15,21,-6
19,17,112,17,15,2
19,17,113,14,16,-2
19,17,114,23,24,-1
19,17,115,6,8,-2
19,17,116,9,18,-9
19,17,117,6,20,-14
19,17,118,13,12,1
19,17,119,9,12,-3
19,17,120,16,19,-3
19,17,121,13,21,-8
19,17,122,17,19,-2
19,17,123,9,20,-11
19,17,124,14,2,12
19,17,125,13,18,-5
19,17,126,15,17,-2
19,17,127,10,16,-6
19,17,128,7,8,-1
19,17,129,10,11,-1
19,17,130,18,5,13
19,17,131,11,9,2
19,17,132,7,22,-15
19,17,133,5,17,-12
19,17,134,13,20,-7
19,17,135,14,10,4
19,17,136,26,24,2
19,17,137,19,13,6
19,17,138,15,10,5
19,17,139,10,7,3
19,17,140,10,17,-7
19,17,141,18,26,-8
19,17,142,22,14,8
19,17,143,11,13,-2
19,17,144,11,23,-12
19,17,145,7,6,1
19,17,146,17,18,-1
19,17,147,12,11,1
19,17,148,9,5,4
19,17,149,8,16,-8
19,17,150,11,4,7
19,17,151,10,14,-4
19,17,152,31,14,17
19,17,153,21,16,5
19,17,154,10,7,3
19,17,155,19,15,4
19,17,156,18,10,8
19,17,157,12,16,-4
19,17,158,15,18,-3
19,17,159,15,17,-2
19,17,160,18,24,-6
19,17,161,12,15,-3
19,17,162,7,9,-2
19,17,163,12,12,0
19,17,164,21,30,-9
19,17,165,14,18,-4
19,17,166,11,12,-1
19,17,167,13,14,-1
19,17,168,23,19,4
19,17,169,18,19,-1
19,17,170,17,20,-3
19,17,171,20,6,14
19,17,172,18,24,-6
19,17,173,14,7,7
19,17,174,2,11,-9
19,17,175,18,21,-3
19,17,176,13,17,-4
19,17,177,23,24,-1
19,17,178,11,5,6
19,17,179,11,19,-8
19,17,180,10,25,-15
19,17,181,16,17,-1
19,17,182,19,27,-8
19,17,183,13,4,9
19,17,184,20,19,1
19,17,185,20,22,-2
19,17,186,17,22,-5
19,17,187,10,26,-16
19,17,188,12,8,4
19,17,189,20,7,13
19,17,190,30,22,8
19,17,191,12,18,-6
19,17,192,19,20,-1
19,17,193,9,10,-1
19,17,194,11,8,3
19,17,195,26,16,10
19,17,196,14,13,1
19,17,197,24,20,4
19,17,198,10,12,-2
19,17,199,15,25,-10
19,17,200,12,11,1
19,17,201,17,20,-3
19,17,202,17,9,8
19,17,203,20,12,8
19,17,204,14,21,-7
19,17,205,11,16,-5
19,17,206,19,12,7
19,17,207,12,7,5
19,17,208,15,27,-12
19,17,209,27,16,11
19,17,210,11,11,0
19,17,211,13,15,-2
19,17,212,21,25,-4
19,17,213,21,26,-5
19,17,214,26,16,10
19,17,215,22,17,5
19,17,216,5,5,0
19,17,217,21,6,15
19,17,218,12,11,1
19,17,219,17,16,1
19,17,220,22,13,9
19,17,221,8,10,-2
19,17,222,18,26,-8
19,17,223,18,13,5
19,17,224,23,27,-4
19,17,225,11,20,-9
19,17,226,12,9,3
19,17,227,17,8,9
19,17,228,25,15,10
19,17,229,5,7,-2
19,17,230,8,15,-7
19,17,231,16,13,3
19,17,232,20,16,4
19,17,233,12,14,-2
19,17,234,6,9,-3
19,17,235,11,14,-3
19,17,236,28,20,8
19,17,237,15,35,-20
19,17,238,3,10,-7
19,17,239,13,14,-1
19,17,240,11,15,-4
19,17,241,19,17,2
19,17,242,15,11,4
19,17,243,12,22,-10
19,17,244,17,14,3
19,17,245,15,19,-4
19,17,246,10,17,-7
19,17,247,13,29,-16
19,17,248,12,16,-4
19,17,249,28,26,2
19,17,250,34,23,11
19,17,251,12,18,-6
19,17,252,9,15,-6
19,17,253,22,22,0
19,17,254,5,13,-8
19,17,255,15,8,7
19,17,256,15,13,2
19,17,257,15,26,-11
19,17,258,12,12,0
19,17,259,15,19,-4
19,17,260,15,16,-1
19,17,261,17,14,3
19,17,262,15,15,0
19,17,263,19,12,7
19,17,264,17,23,-6
19,17,265,16,10,6
19,17,266,14,21,-7
19,17,267,11,10,1
19,17,268,25,9,16
19,17,269,13,17,-4
19,17,270,13,19,-6
19,17,271,14,22,-8
19,17,272,10,20,-10
19,17,273,12,13,-1
19,17,274,15,30,-15
19,17,275,18,16,2
19,17,276,13,16,-3
19,17,277,8,6,2
19,17,278,31,24,7
19,17,279,19,8,11
19,17,280,19,13,6
19,17,281,19,17,2
19,17,282,23,24,-1
19,17,283,18,24,-6
19,17,284,17,25,-8
19,17,285,31,19,12
19,17,286,17,13,4
19,17,287,24,22,2
19,17,288,13,8,5
19,17,289,16,12,4
19,17,290,18,28,-10
19,17,291,16,14,2
19,17,292,17,28,-11
19,17,293,15,23,-8
19,17,294,22,16,6
19,17,295,16,25,-9
19,17,296,11,13,-2
19,17,297,25,16,9
19,17,298,16,31,-15
19,17,299,14,21,-7
19,18,0,14,15,-1
19,18,1,8,14,-6
19,18,2,25,17,8
19,18,3,16,3,13
19,18,4,19,27,-8
19,18,5,12,21,-9
19,18,6,11,21,-10
19,18,7,14,8,6
19,18,8,15,13,2
19,18,9,15,16,-1
19,18,10,8,18,-10
19,18,11,17,17,0
19,18,12,32,12,20
19,18,13,16,16,0
19,18,14,12,11,1
19,18,15,15,14,1
19,18,16,17,14,3
19,18,17,30,27,3
19,18,18,11,23,-12
19,18,19,14,20,-6
19,18,20,21,18,3
19,18,21,5,16,-11
19,18,22,5,17,-12
19,18,23,10,19,-9
19,18,24,33,18,15
19,18,25,18,10,8
19,18,26,23,15,8
19,18,27,13,17,-4
19,18,28,25,12,13
19,18,29,37,11,26
19,18,30,15,20,-5
19,18,31,22,21,1
19,18,32,10,7,3
19,18,33,7,13,-6
19,18,34,10,23,-13
19,18,35,11,15,-4
19,18,36,7,11,-4
19,18,37,27,13,14
19,18,38,6,23,-17
19,18,39,17,13,4
19,18,40,21,12,9
19,18,41,13,10,3
19,18,42,14,21,-7
19,18,43,0,9,-9
19,18,44,10,21,-11
19,18,45,13,15,-2
19,18,46,13,18,-5
19,18,47,11,9,2
19,18,48,17,15,2
19,18,49,10,19,-9
19,18,50,14,12,2
19,18,51,16,15,1
19,18,52,10,8,2
19,18,53,14,14,0
19,18,54,8,23,-15
19,18,55,6,11,-5
19,18,56,21,13,8
19,18,57,17,16,1
19,18,58,6,3,3
19,18,59,12,16,-4
19,18,60,16,20,-4
19,18,61,12,12,0
19,18,62,7,23,-16
19,18,63,8,9,-1
19,18,64,8,16,-8
19,18,65,11,8,3
19,18,66,8,14,-6
19,18,67,15,13,2
19,18,68,17,9,8
19,18,69,16,17,-1
19,18,70,12,22,-10
19,18,71,17,15,2
19,18,72,20,21,-1
19,18,73,11,17,-6
19,18,74,9,29,-20
19,18,75,19,8,11
19,18,76,33,17,16
19,18,77,11,16,-5
19,18,78,22,25,-3
19,18,79,20,24,-4
19,18,80,12,6,6
19,18,81,12,12,0
19,18,82,16,35,-19
19,18,83,14,19,-5
19,18,84,30,23,7
19,18,85,5,14,-9
19,18,86,17,15,2
19,18,87,14,19,-5
19,18,88,10,11,-1
19,18,89,14,11,3
19,18,90,6,11,-5
19,18,91,21,14,7
19,18,92,8,24,-16
19,18,93,10,24,-14
19,18,94,15,19,-4
19,18,95,15,11,4
19,18,96,15,17,-2
19,18,97,10,11,-1
19,18,98,11,25,-14
19,18,99,5,14,-9
19,18,100,14,11,3
19,18,101,9,18,-9
19,18,102,10,11,-1
19,18,103,19,29,-10
19,18,104,17,10,7
19,18,105,24,16,8
19,18,106,8,14,-6
19,18,107,10,21,-11
19,18,108,13,15,-2
19,18,109,9,11,-2
19,18,110,21,24,-3
19,18,111,17,11,6
19,18,112,10,16,-6
19,18,113,7,16,-9
19,18,114,12,16,-4
19,18,115,17,23,-6
19,18,116,13,22,-9
19,18,117,14,11,3
19,18,118,22,20,2
19,18,119,22,22,0
19,18,120,22,10,12
19,18,121,9,10,-1
19,18,122,15,19,-4
19,18,123,11,23,-12
19,18,124,14,18,-4
19,18,125,15,18,-3
19,18,126,15,17,-2
19,18,127,7,11,-4
19,18,128,16,17,-1
19,18,129,13,12,1
19,18,130,8,10,-2
19,18,131,16,21,-5
19,18,132,16,15,1
19,18,133,12,24,-12
19,18,134,14,14,0
19,18,135,19,11,8
19,18,136,15,28,-13
19,18,137,16,26,-10
19,18,138,15,15,0
19,18,139,16,5,11
19,18,140,12,16,-4
19,18,141,22,10,12
19,18,142,14,14,0
19,18,143,10,14,-4
19,18,144,19,16,3
19,18,145,20,13,7
19,18,146,20,24,-4
19,18,147,19,18,1
19,18,148,23,19,4
19,18,149,18,16,2
19,18,150,17,24,-7
19,18,151,21,19,2
19,18,152,8,9,-1
19,18,153,6,11,-5
19,18,154,17,22,-5
19,18,155,20,13,7
19,18,156,16,15,1
19,18,157,14,9,5
19,18,158,17,23,-6
19,18,159,11,15,-4
19,18,160,16,2,14
19,18,161,19,21,-2
19,18,162,17,23,-6
19,18,163,32,14,18
19,18,164,11,7,4
19,18,165,13,9,4
19,18,166,9,13,-4
19,18,167,19,19,0
19,18,168,17,24,-7
19,18,169,4,17,-13
19,18,170,21,19,2
19,18,171,8,12,-4
19,18,172,28,19,9
19,18,173,18,17,1
19,18,174,23,8,15
19,18,175,20,19,1
19,18,176,6,7,-1
19,18,177,13,9,4
19,18,178,8,12,-4
19,18,179,11,18,-7
19,18,180,17,22,-5
19,18,181,16,17,-1
19,18,182,16,7,9
19,18,183,4,13,-9
19,18,184,27,6,21
19,18,185,10,13,-3
19,18,186,19,30,-11
19,18,187,24,15,9
19,18,188,11,25,-14
19,18,189,14,12,2
19,18,190,17,25,-8
19,18,191,17,15,2
19,18,192,31,6,25
19,18,193,27,18,9
19,18,194,18,8,10
19,18,195,21,16,5
19,18,196,17,25,-8
19,18,197,5,14,-9
19,18,198,18,12,6
19,18,199,25,10,15
19,18,200,18,3,15
19,18,201,26,17,9
19,18,202,27,16,11
19,18,203,9,11,-2
19,18,204,11,9,2
19,18,205,16,19,-3
19,18,206,9,16,-7
19,18,207,15,15,0
19,18,208,33,25,8
19,18,209,8,8,0
19,18,210,7,9,-2
19,18,211,8,9,-1
19,18,212,7,6,1
19,18,213,11,14,-3
19,18,214,9,8,1
19,18,215,31,11,20
19,18,216,12,35,-23
19,18,217,16,10,6
19,18,218,7,11,-4
19,18,219,15,11,4
19,18,220,7,19,-12
19,18,221,13,21,-8
19,18,222,14,19,-5
19,18,223,14,15,-1
19,18,224,12,9,3
19,18,225,22,14,8
19,18,226,14,12,2
19,18,227,13,9,4
19,18,228,7,12,-5
19,18,229,16,18,-2
19,18,230,16,21,-5
19,18,231,8,12,-4
19,18,232,16,17,-1
19,18,233,23,18,5
19,18,234,17,14,3
19,18,235,11,18,-7
19,18,236,12,15,-3
19,18,237,9,19,-10
19,18,238,13,18,-5
19,18,239,21,7,14
19,18,240,11,14,-3
19,18,241,16,15,1
19,18,242,18,18,0
19,18,243,15,14,1
19,18,244,9,9,0
19,18,245,7,10,-3
19,18,246,14,12,2
19,18,247,9,5,4
19,18,248,10,15,-5
19,18,249,12,20,-8
19,18,250,20,10,10
19,18,251,17,10,7
19,18,252,25,5,20
19,18,253,14,11,3
19,18,254,8,21,-13
19,18,255,6,17,-11
19,18,256,29,12,17
19,18,257,21,16,5
19,18,258,9,24,-15
19,18,259,8,6,2
19,18,260,18,25,-7
19,18,261,15,10,5
19,18,262,9,12,-3
19,18,263,16,18,-2
19,18,264,11,17,-6
19,18,265,17,32,-15
19,18,266,23,9,14
19,18,267,12,15,-3
19,18,268,11,20,-9
19,18,269,9,17,-8
19,18,270,15,21,-6
19,18,271,5,2,3
19,18,272,2,10,-8
19,18,273,13,9,4
19,18,274,15,18,-3
19,18,275,14,10,4
19,18,276,12,6,6
19,18,277,12,15,-3
19,18,278,14,18,-4
19,18,279,16,6,10
19,18,280,19,17,2
19,18,281,12,13,-1
19,18,282,12,12,0
19,18,283,18,9,9
19,18,284,10,19,-9
19,18,285,21,24,-3
19,18,286,20,27,-7
19,18,287,15,15,0
19,18,288,14,23,-9
19,18,289,17,13,4
19,18,290,23,24,-1
19,18,291,11,13,-2
19,18,292,16,15,1
19,18,293,12,12,0
19,18,294,16,7,9
19,18,295,22,16,6
19,18,296,12,14,-2
19,18,297,14,10,4
19,18,298,24,8,16
19,18,299,14,22,-8
19,19,0,18,31,-13
19,19,1,17,25,-8
19,19,2,21,36,-15
19,19,3,9,21,-12
19,19,4,19,13,6
19,19,5,9,11,-2
19,19,6,10,13,-3
19,19,7,14,9,5
19,19,8,15,36,-21
19,19,9,17,14,3
19,19,10,9,24,-15
19,19,11,9,20,-11
19,19,12,15,23,-8
19,19,13,22,28,-6
19,19,14,18,24,-6
19,19,15,11,9,2
19,19,16,18,13,5
19,19,17,11,21,-10
19,19,18,10,17,-7
19,19,19,10,16,-6
19,19,20,12,21,-9
19,19,21,15,16,-1
19,19,22,12,18,-6
19,19,23,12,14,-2
19,19,24,17,17,0
19,19,25,14,18,-4
19,19,26,15,16,-1
19,19,27,15,18,-3
19,19,28,7,16,-9
19,19,29,1,11,-10
19,19,30,9,28,-19
19,19,31,3,18,-15
19,19,32,16,11,5
19,19,33,7,9,-2
19,19,34,13,15,-2
19,19,35,6,10,-4
19,19,36,24,21,3
19,19,37,6,22,-16
19,19,38,11,11,0
19,19,39,13,37,-24
19,19,40,11,9,2
19,19,41,23,21,2
19,19,42,15,8,7
19,19,43,18,10,8
19,19,44,23,18,5
19,19,45,19,17,2
19,19,46,16,13,3
19,19,47,19,11,8
19,19,48,24,26,-2
19,19,49,16,9,7
19,19,50,18,15,3
19,19,51,17,29,-12
19,19,52,13,16,-3
19,19,53,16,11,5
19,19,54,11,14,-3
19,19,55,11,7,4
19,19,56,19,18,1
19,19,57,11,16,-5
19,19,58,6,17,-11
19,19,59,9,7,2
19,19,60,24,18,6
19,19,61,10,8,2
19,19,62,11,27,-16
19,19,63,12,17,-5
19,19,64,8,12,-4
19,19,65,15,28,-13
19,19,66,13,23,-10
19,19,67,17,23,-6
19,19,68,15,6,9
19,19,69,20,16,4
19,19,70,20,18,2
19,19,71,7,25,-18
19,19,72,10,19,-9
19,19,73,8,15,-7
19,19,74,20,25,-5
19,19,75,4,15,-11
19,19,76,16,10,6
19,19,77,17,13,4
19,19,78,13,19,-6
19,19,79,15,7,8
19,19,80,15,9,6
19,19,81,18,19,-1
19,19,82,26,22,4
19,19,83,19,9,10
19,19,84,29,31,-2
19,19,85,16,14,2
19,19,86,8,10,-2
19,19,87,13,21,-8
19,19,88,21,15,6
19,19,89,16,18,-2
19,19,90,13,11,2
19,19,91,16,20,-4
19,19,92,24,17,7
19,19,93,7,17,-10
19,19,94,15,11,4
19,19,95,15,11,4
19,19,96,10,4,6
19,19,97,5,9,-4
19,19,98,10,15,-5
19,19,99,10,15,-5
19,19,100,14,17,-3
19,19,101,7,10,-3
19,19,102,15,16,-1
19,19,103,25,19,6
19,19,104,3,10,-7
19,19,105,9,17,-8
19,19,106,11,20,-9
19,19,107,17,13,4
19,19,108,28,23,5
19,19,109,20,28,-8
19,19,110,20,18,2
19,19,111,9,15,-6
19,19,112,21,28,-7
19,19,113,7,9,-2
19,19,114,14,29,-15
19,19,115,20,17,3
19,19,116,8,19,-11
19,19,117,15,12,3
19,19,118,23,25,-2
19,19,119,14,17,-3
19,19,120,18,16,2
19,19,121,13,23,-10
19,19,122,13,11,2
19,19,123,26,15,11
19,19,124,14,6,8
19,19,125,29,6,23
19,19,126,4,11,-7
19,19,127,9,20,-11
19,19,128,17,16,1
19,19,129,16,28,-12
19,19,130,8,9,-1
19,19,131,9,20,-11
19,19,132,7,25,-18
19,19,133,12,34,-22
19,19,134,12,15,-3
19,19,135,11,20,-9
19,19,136,23,16,7
19,19,137,11,7,4
19,19,138,17,14,3
19,19,139,20,13,7
19,19,140,21,17,4
19,19,141,17,13,4
19,19,142,16,11,5
19,19,143,7,19,-12
19,19,144,5,7,-2
19,19,145,19,22,-3
19,19,146,12,14,-2
19,19,147,12,19,-7
19,19,148,13,14,-1
19,19,149,22,32,-10
19,19,150,17,8,9
19,19,151,20,18,2
19,19,152,22,20,2
19,19,153,9,16,-7
19,19,154,5,10,-5
19,19,155,12,15,-3
19,19,156,15,12,3
19,19,157,4,9,-5
19,19,158,11,28,-17
19,19,159,19,7,12
19,19,160,4,18,-14
19,19,161,18,11,7
19,19,162,18,20,-2
19,19,163,10,7,3
19,19,164,12,16,-4
19,19,165,17,12,5
19,19,166,12,17,-5
19,19,167,11,20,-9
19,19,168,32,33,-1
19,19,169,26,18,8
19,19,170,17,10,7
19,19,171,19,23,-4
19,19,172,21,9,12
19,19,173,10,13,-3
19,19,174,30,20,10
19,19,175,15,21,-6
19,19,176,20,14,6
19,19,177,12,16,-4
19,19,178,7,16,-9
19,19,179,13,15,-2
19,19,180,16,4,12
19,19,181,14,21,-7
19,19,182,12,7,5
19,19,183,34,23,11
19,19,184,14,22,-8
19,19,185,4,17,-13
19,19,186,11,9,2
19,19,187,13,16,-3
19,19,188,20,5,15
19,19,189,15,36,-21
19,19,190,17,21,-4
19,19,191,21,23,-2
19,19,192,20,13,7
19,19,193,17,36,-19
19,19,194,13,9,4
19,19,195,16,39,-23
19,19,196,10,19,-9
19,19,197,16,33,-17
19,19,198,9,17,-8
19,19,199,19,10,9
19,19,200,13,10,3
19,19,201,15,18,-3
19,19,202,3,7,-4
19,19,203,19,13,6
19,19,204,8,13,-5
19,19,205,11,9,2
19,19,206,9,21,-12
19,19,207,17,11,6
19,19,208,13,8,5
19,19,209,28,25,3
19,19,210,4,8,-4
19,19,211,12,10,2
19,19,212,13,18,-5
19,19,213,14,32,-18
19,19,214,14,18,-4
19,19,215,7,18,-11
19,19,216,14,19,-5
19,19,217,8,14,-6
19,19,218,5,15,-10
19,19,219,20,15,5
19,19,220,6,16,-10
19,19,221,9,24,-15
19,19,222,20,22,-2
19,19,223,17,13,4
19,19,224,7,23,-16
19,19,225,9,20,-11
19,19,226,9,25,-16
19,19,227,15,17,-2
19,19,228,15,13,2
19,19,229,9,11,-2
19,19,230,9,13,-4
19,19,231,2,7,-5
19,19,232,13,20,-7
19,19,233,21,21,0
19,19,234,8,26,-18
19,19,235,17,23,-6
19,19,236,18,26,-8
19,19,237,7,13,-6
19,19,238,11,10,1
19,19,239,13,17,-4
19,19,240,14,11,3
19,19,241,7,16,-9
19,19,242,16,12,4
19,19,243,17,16,1
19,19,244,26,18,8
19,19,245,20,11,9
19,19,246,13,25,-12
19,19,247,5,14,-9
19,19,248,17,23,-6
19,19,249,10,27,-17
19,19,250,6,20,-14
19,19,251,17,14,3
19,19,252,8,18,-10
19,19,253,13,10,3
19,19,254,27,18,9
19,19,255,9,9,0
19,19,256,22,13,9
19,19,257,4,11,-7
19,19,258,20,17,3
19,19,259,10,22,-12
19,19,260,25,18,7
19,19,261,20,21,-1
19,19,262,10,10,0
19,19,263,14,19,-5
19,19,264,24,11,13
19,19,265,16,15,1
19,19,266,23,12,11
19,19,267,25,19,6
19,19,268,11,17,-6
19,19,269,5,10,-5
19,19,270,17,4,13
19,19,271,8,12,-4
19,19,272,15,16,-1
19,19,273,24,24,0
19,19,274,9,5,4
19,19,275,23,12,11
19,19,276,14,16,-2
19,19,277,5,13,-8
19,19,278,4,17,-13
19,19,279,4,4,0
19,19,280,16,16,0
19,19,281,7,22,-15
19,19,282,6,9,-3
19,19,283,8,19,-11
19,19,284,5,20,-15
19,19,285,10,8,2
19,19,286,16,14,2
19,19,287,6,13,-7
19,19,288,10,19,-9
19,19,289,21,15,6
19,19,290,12,22,-10
19,19,291,4,15,-11
19,19,292,9,13,-4
19,19,293,25,18,7
19,19,294,14,18,-4
19,19,295,10,12,-2
19,19,296,12,9,3
19,19,297,1,16,-15
19,19,298,7,9,-2
19,19,299,9,10,-1
19,20,0,18,20,-2
19,20,1,9,8,1
19,20,2,18,23,-5
19,20,3,9,15,-6
19,20,4,11,13,-2
19,20,5,19,23,-4
19,20,6,15,16,-1
19,20,7,8,23,-15
19,20,8,12,18,-6
19,20,9,10,8,2
19,20,10,3,4,-1
19,20,11,15,12,3
19,20,12,10,15,-5
19,20,13,15,13,2
19,20,14,9,9,0
19,20,15,10,3,7
19,20,16,22,25,-3
19,20,17,21,16,5
19,20,18,6,8,-2
19,20,19,8,9,-1
19,20,20,6,18,-12
19,20,21,13,22,-9
19,20,22,4,10,-6
19,20,23,13,11,2
19,20,24,13,7,6
19,20,25,17,23,-6
19,20,26,13,10,3
19,20,27,21,15,6
19,20,28,11,16,-5
19,20,29,16,8,8
19,20,30,10,17,-7
19,20,31,18,22,-4
19,20,32,9,9,0
19,20,33,4,7,-3
19,20,34,23,18,5
19,20,35,21,22,-1
19,20,36,16,10,6
19,20,37,19,14,5
19,20,38,13,23,-10
19,20,39,11,9,2
19,20,40,9,22,-13
19,20,41,16,22,-6
19,20,42,21,12,9
19,20,43,24,26,-2
19,20,44,14,8,6
19,20,45,18,31,-13
19,20,46,19,30,-11
19,20,47,10,13,-3
19,20,48,16,18,-2
19,20,49,11,11,0
19,20,50,17,15,2
19,20,51,24,29,-5
19,20,52,20,11,9
19,20,53,13,19,-6
19,20,54,6,15,-9
19,20,55,4,8,-4
19,20,56,4,6,-2
19,20,57,16,21,-5
19,20,58,13,12,1
19,20,59,16,17,-1
19,20,60,28,17,11
19,20,61,16,25,-9
19,20,62,23,26,-3
19,20,63,26,24,2
19,20,64,5,21,-16
19,20,65,17,15,2
19,20,66,13,10,3
19,20,67,28,18,10
19,20,68,21,10,11
19,20,69,20,28,-8
19,20,70,11,5,6
19,20,71,20,13,7
19,20,72,16,15,1
19,20,73,13,20,-7
19,20,74,7,21,-14
19,20,75,23,25,-2
19,20,76,11,19,-8
19,20,77,19,26,-7
19,20,78,22,25,-3
19,20,79,13,15,-2
19,20,80,7,9,-2
19,20,81,13,12,1
19,20,82,19,13,6
19,20,83,11,13,-2
19,20,84,8,11,-3
19,20,85,18,30,-12
19,20,86,18,21,-3
19,20,87,20,14,6
19,20,88,12,22,-10
19,20,89,18,16,2
19,20,90,11,14,-3
19,20,91,11,10,1
19,20,92,14,11,3
19,20,93,16,11,5
19,20,94,11,17,-6
19,20,95,20,17,3
19,20,96,19,16,3
19,20,97,10,10,0
19,20,98,10,7,3
19,20,99,10,7,3
19,20,100,24,18,6
19,20,101,14,10,4
19,20,102,11,11,0
19,20,103,16,10,6
19,20,104,38,16,22
19,20,105,24,15,9
19,20,106,18,15,3
19,20,107,13,5,8
19,20,108,10,18,-8
19,20,109,18,9,9
19,20,110,9,18,-9
19,20,111,7,8,-1
19,20,112,26,17,9
19,20,113,11,14,-3
19,20,114,13,15,-2
19,20,115,24,6,18
19,20,116,13,12,1
19,20,117,19,23,-4
19,20,118,8,11,-3
19,20,119,19,14,5
19,20,120,28,22,6
19,20,121,28,25,3
19,20,122,13,18,-5
19,20,123,12,20,-8
19,20,124,11,15,-4
19,20,125,29,19,10
19,20,126,13,15,-2
19,20,127,12,15,-3
19,20,128,8,11,-3
19,20,129,9,10,-1
19,20,130,14,12,2
19,20,131,8,15,-7
19,20,132,10,16,-6
19,20,133,26,15,11
19,20,134,12,11,1
19,20,135,23,14,9
19,20,136,11,11,0
19,20,137,2,10,-8
19,20,138,13,14,-1
19,20,139,11,17,-6
19,20,140,12,10,2
19,20,141,14,14,0
19,20,142,20,15,5
19,20,143,16,9,7
19,20,144,16,14,2
19,20,145,11,10,1
19,20,146,21,22,-1
19,20,147,9,13,-4
19,20,148,22,17,5
19,20,149,16,9,7
19,20,150,11,16,-5
19,20,151,23,34,-11
19,20,152,10,15,-5
19,20,153,12,16,-4
19,20,154,13,24,-11
19,20,155,10,22,-12
19,20,156,22,20,2
19,20,157,8,10,-2
19,20,158,21,12,9
19,20,159,23,28,-5
19,20,160,8,10,-2
19,20,161,25,20,5
19,20,162,14,14,0
19,20,163,17,21,-4
19,20,164,8,12,-4
19,20,165,17,15,2
19,20,166,13,15,-2
19,20,167,13,9,4
19,20,168,16,11,5
19,20,169,11,16,-5
19,20,170,8,10,-2
19,20,171,7,17,-10
19,20,172,10,12,-2
19,20,173,5,10,-5
19,20,174,13,23,-10
19,20,175,16,27,-11
19,20,176,10,11,-1
19,20,177,12,14,-2
19,20,178,14,31,-17
19,20,179,6,7,-1
19,20,180,11,13,-2
19,20,181,7,7,0
19,20,182,15,16,-1
19,20,183,15,13,2
19,20,184,14,10,4
19,20,185,20,22,-2
19,20,186,9,18,-9
19,20,187,26,11,15
19,20,188,17,19,-2
19,20,189,24,16,8
19,20,190,16,13,3
19,20,191,16,12,4
19,20,192,15,19,-4
19,20,193,13,9,4
19,20,194,11,19,-8
19,20,195,20,14,6
19,20,196,12,9,3
19,20,197,21,19,2
19,20,198,18,22,-4
19,20,199,10,12,-2
19,20,200,18,18,0
19,20,201,15,11,4
19,20,202,5,5,0
19,20,203,20,22,-2
19,20,204,10,8,2
19,20,205,26,9,17
19,20,206,25,17,8
19,20,207,19,21,-2
19,20,208,5,19,-14
19,20,209,12,12,0
19,20,210,22,21,1
19,20,211,15,11,4
19,20,212,14,14,0
19,20,213,3,2,1
19,20,214,13,27,-14
19,20,215,13,7,6
19,20,216,20,8,12
19,20,217,6,13,-7
19,20,218,7,9,-2
19,20,219,9,11,-2
19,20,220,20,19,1
19,20,221,7,11,-4
19,20,222,15,11,4
19,20,223,10,5,5
19,20,224,14,17,-3
19,20,225,22,18,4
19,20,226,14,10,4
19,20,227,16,15,1
19,20,228,13,15,-2
19,20,229,10,18,-8
19,20,230,11,8,3
19,20,231,13,32,-19
19,20,232,23,20,3
19,20,233,25,15,10
19,20,234,11,7,4
19,20,235,12,12,0
19,20,236,16,23,-7
19,20,237,14,18,-4
19,20,238,14,20,-6
19,20,239,9,11,-2
19,20,240,8,19,-11
19,20,241,12,16,-4
19,20,242,15,13,2
19,20,243,4,9,-5
19,20,244,7,10,-3
19,20,245,10,11,-1
19,20,246,7,9,-2
19,20,247,25,31,-6
19,20,248,21,6,15
19,20,249,16,20,-4
19,20,250,8,12,-4
19,20,251,13,12,1
19,20,252,5,11,-6
19,20,253,22,19,3
19,20,254,14,24,-10
19,20,255,9,7,2
19,20,256,20,10,10
19,20,257,7,19,-12
19,20,258,16,25,-9
19,20,259,16,19,-3
19,20,260,27,20,7
19,20,261,10,15,-5
19,20,262,11,9,2
19,20,263,9,14,-5
19,20,264,17,21,-4
19,20,265,18,19,-1
19,20,266,11,24,-13
19,20,267,8,8,0
19,20,268,19,17,2
19,20,269,12,26,-14
19,20,270,19,24,-5
19,20,271,12,20,-8
19,20,272,17,12,5
19,20,273,6,16,-10
19,20,274,16,8,8
19,20,275,18,26,-8
19,20,276,19,14,5
19,20,277,15,18,-3
19,20,278,14,21,-7
19,20,279,9,11,-2
19,20,280,12,6,6
19,20,281,18,9,9
19,20,282,7,20,-13
19,20,283,10,26,-16
19,20,284,18,30,-12
19,20,285,27,11,16
19,20,286,11,21,-10
19,20,287,13,14,-1
19,20,288,19,27,-8
19,20,289,16,12,4
19,20,290,16,22,-6
19,20,291,11,20,-9
19,20,292,15,8,7
19,20,293,21,13,8
19,20,294,20,12,8
19,20,295,12,5,7
19,20,296,22,24,-2
19,20,297,21,24,-3
19,20,298,18,9,9
19,20,299,16,14,2
19,21,0,15,10,5
19,21,1,27,23,4
19,21,2,24,17,7
19,21,3,18,17,1
19,21,4,15,8,7
19,21,5,13,11,2
19,21,6,25,13,12
19,21,7,15,12,3
19,21,8,23,24,-1
19,21,9,26,11,15
19,21,10,10,14,-4
19,21,11,11,18,-7
19,21,12,12,9,3
19,21,13,13,19,-6
19,21,14,16,11,5
19,21,15,5,14,-9
19,21,16,13,20,-7
19,21,17,31,18,13
19,21,18,36,30,6
19,21,19,12,18,-6
19,21,20,15,15,0
19,21,21,25,15,10
19,21,22,18,13,5
19,21,23,16,14,2
19,21,24,15,14,1
19,21,25,12,14,-2
19,21,26,13,10,3
19,21,27,8,9,-1
19,21,28,25,17,8
19,21,29,13,15,-2
19,21,30,10,6,4
19,21,31,14,23,-9
19,21,32,14,18,-4
19,21,33,12,12,0
19,21,34,17,32,-15
19,21,35,7,9,-2
19,21,36,17,21,-4
19,21,37,15,25,-10
19,21,38,14,8,6
19,21,39,9,7,2
19,21,40,13,8,5
19,21,41,8,14,-6
19,21,42,9,13,-4
19,21,43,25,20,5
19,21,44,19,16,3
19,21,45,18,13,5
19,21,46,20,9,11
19,21,47,19,14,5
19,21,48,22,17,5
19,21,49,14,9,5
19,21,50,13,15,-2
19,21,51,10,19,-9
19,21,52,20,13,7
19,21,53,20,14,6
19,21,54,16,36,-20
19,21,55,13,21,-8
19,21,56,13,30,-17
19,21,57,19,14,5
19,21,58,14,8,6
19,21,59,18,17,1
19,21,60,17,10,7
19,21,61,10,20,-10
19,21,62,17,11,6
19,21,63,10,26,-16
19,21,64,16,16,0
19,21,65,22,10,12
19,21,66,24,11,13
19,21,67,4,6,-2
19,21,68,10,3,7
19,21,69,13,18,-5
19,21,70,18,21,-3
19,21,71,12,17,-5
19,21,72,4,30,-26
19,21,73,20,17,3
19,21,74,12,13,-1
19,21,75,14,13,1
19,21,76,14,37,-23
19,21,77,13,14,-1
19,21,78,12,10,2
19,21,79,16,9,7
19,21,80,22,16,6
19,21,81,24,10,14
19,21,82,16,11,5
19,21,83,7,8,-1
19,21,84,11,12,-1
19,21,85,24,21,3
19,21,86,22,14,8
19,21,87,28,10,18
19,21,88,21,14,7
19,21,89,27,3,24
19,21,90,15,13,2
19,21,91,11,15,-4
19,21,92,6,10,-4
19,21,93,11,23,-12
19,21,94,10,20,-10
19,21,95,12,10,2
19,21,96,5,22,-17
19,21,97,21,13,8
19,21,98,12,16,-4
19,21,99,27,9,18
19,21,100,14,16,-2
19,21,101,6,10,-4
19,21,102,19,18,1
19,21,103,23,17,6
19,21,104,3,17,-14
19,21,105,14,14,0
19,21,106,27,15,12
19,21,107,18,11,7
19,21,108,11,17,-6
19,21,109,14,8,6
19,21,110,1,8,-7
19,21,111,17,8,9
19,21,112,12,5,7
19,21,113,4,8,-4
19,21,114,16,19,-3
19,21,115,19,10,9
19,21,116,21,9,12
19,21,117,10,12,-2
19,21,118,8,13,-5
19,21,119,19,19,0
19,21,120,14,5,9
19,21,121,15,7,8
19,21,122,21,21,0
19,21,123,13,12,1
19,21,124,11,20,-9
19,21,125,11,12,-1
19,21,126,15,8,7
19,21,127,12,11,1
19,21,128,19,23,-4
19,21,129,10,6,4
19,21,130,9,12,-3
19,21,131,14,15,-1
19,21,132,11,14,-3
19,21,133,5,18,-13
19,21,134,24,16,8
19,21,135,9,3,6
19,21,136,15,12,3
19,21,137,14,12,2
19,21,138,19,12,7
19,21,139,15,7,8
19,21,140,15,10,5
19,21,141,13,11,2
19,21,142,10,13,-3
19,21,143,22,18,4
19,21,144,14,21,-7
19,21,145,10,3,7
19,21,146,25,22,3
19,21,147,23,17,6
19,21,148,9,8,1
19,21,149,18,15,3
19,21,150,18,32,-14
19,21,151,5,16,-11
19,21,152,15,11,4
19,21,153,12,22,-10
19,21,154,11,13,-2
19,21,155,13,17,-4
19,21,156,13,15,-2
19,21,157,16,23,-7
19,21,158,22,14,8
19,21,159,21,9,12
19,21,160,21,14,7
19,21,161,23,26,-3
19,21,162,10,15,-5
19,21,163,15,13,2
19,21,164,29,10,19
19,21,165,17,23,-6
19,21,166,30,17,13
19,21,167,8,21,-13
19,21,168,8,15,-7
19,21,169,10,19,-9
19,21,170,4,6,-2
19,21,171,18,17,1
19,21,172,15,23,-8
19,21,173,7,17,-10
19,21,174,15,9,6
19,21,175,15,19,-4
19,21,176,34,23,11
19,21,177,26,13,13
19,21,178,24,13,11
19,21,179,4,17,-13
19,21,180,16,17,-1
19,21,181,14,24,-10
19,21,182,15,16,-1
19,21,183,18,13,5
19,21,184,18,14,4
19,21,185,18,24,-6
19,21,186,4,14,-10
19,21,187,18,31,-13
19,21,188,8,8,0
19,21,189,11,19,-8
19,21,190,5,6,-1
19,21,191,24,10,14
19,21,192,7,9,-2
19,21,193,8,7,1
19,21,194,16,15,1
19,21,195,10,12,-2
19,21,196,9,15,-6
19,21,197,18,12,6
19,21,198,13,19,-6
19,21,199,18,10,8
19,21,200,27,25,2
19,21,201,19,21,-2
19,21,202,6,9,-3
19,21,203,16,8,8
19,21,204,15,11,4
19,21,205,18,19,-1
19,21,206,3,11,-8
19,21,207,20,25,-5
19,21,208,5,19,-14
19,21,209,22,7,15
19,21,210,7,24,-17
19,21,211,2,6,-4
19,21,212,11,11,0
19,21,213,12,2,10
19,21,214,22,23,-1
19,21,215,21,14,7
19,21,216,18,22,-4
19,21,217,13,12,1
19,21,218,11,16,-5
19,21,219,17,5,12
19,21,220,20,22,-2
19,21,221,19,18,1
19,21,222,14,11,3
19,21,223,15,12,3
19,21,224,33,11,22
19,21,225,16,20,-4
19,21,226,12,9,3
19,21,227,11,7,4
19,21,228,13,28,-15
19,21,229,13,15,-2
19,21,230,23,20,3
19,21,231,22,19,3
19,21,232,21,8,13
19,21,233,11,8,3
19,21,234,16,14,2
19,21,235,8,5,3
19,21,236,10,18,-8
19,21,237,6,14,-8
19,21,238,9,11,-2
19,21,239,8,20,-12
19,21,240,16,17,-1
19,21,241,12,9,3
19,21,242,19,15,4
19,21,243,14,13,1
19,21,244,18,23,-5
19,21,245,2,25,-23
19,21,246,14,22,-8
19,21,247,4,19,-15
19,21,248,13,11,2
19,21,249,14,16,-2
19,21,250,23,15,8
19,21,251,31,16,15
19,21,252,18,16,2
19,21,253,8,10,-2
19,21,254,22,10,12
19,21,255,10,14,-4
19,21,256,18,15,3
19,21,257,20,20,0
19,21,258,19,17,2
19,21,259,19,11,8
19,21,260,11,10,1
19,21,261,16,24,-8
19,21,262,20,20,0
19,21,263,24,18,6
19,21,264,12,13,-1
19,21,265,17,20,-3
19,21,266,16,15,1
19,21,267,18,16,2
19,21,268,17,25,-8
19,21,269,16,10,6
19,21,270,12,18,-6
19,21,271,25,36,-11
19,21,272,16,14,2
19,21,273,23,12,11
19,21,274,15,16,-1
19,21,275,15,12,3
19,21,276,18,15,3
19,21,277,27,27,0
19,21,278,20,29,-9
19,21,279,16,6,10
19,21,280,15,12,3
19,21,281,22,19,3
19,21,282,18,16,2
19,21,283,9,11,-2
19,21,284,17,22,-5
19,21,285,4,13,-9
19,21,286,8,9,-1
19,21,287,15,18,-3
19,21,288,13,13,0
19,21,289,16,23,-7
19,21,290,28,18,10
19,21,291,13,23,-10
19,21,292,6,10,-4
19,21,293,11,18,-7
19,21,294,11,14,-3
19,21,295,17,24,-7
19,21,296,18,19,-1
19,21,297,17,15,2
19,21,298,25,15,10
19,21,299,18,3,15
19,22,0,9,14,-5
19,22,1,18,16,2
19,22,2,17,21,-4
19,22,3,17,12,5
19,22,4,21,14,7
19,22,5,16,12,4
19,22,6,17,12,5
19,22,7,26,18,8
19,22,8,10,14,-4
19,22,9,23,4,19
19,22,10,20,11,9
19,22,11,18,17,1
19,22,12,8,5,3
19,22,13,9,12,-3
19,22,14,14,16,-2
19,22,15,16,24,-8
19,22,16,8,19,-11
19,22,17,12,11,1
19,22,18,21,21,0
19,22,19,14,17,-3
19,22,20,11,15,-4
19,22,21,12,15,-3
19,22,22,15,8,7
19,22,23,14,18,-4
19,22,24,9,18,-9
19,22,25,14,11,3
19,22,26,19,14,5
19,22,27,8,20,-12
19,22,28,15,22,-7
19,22,29,13,9,4
19,22,30,10,8,2
19,22,31,17,19,-2
19,22,32,10,5,5
19,22,33,15,20,-5
19,22,34,29,17,12
19,22,35,17,14,3
19,22,36,26,10,16
19,22,37,3,10,-7
19,22,38,19,4,15
19,22,39,21,11,10
19,22,40,17,26,-9
19,22,41,14,9,5
19,22,42,17,16,1
19,22,43,11,18,-7
19,22,44,19,27,-8
19,22,45,18,21,-3
19,22,46,12,17,-5
19,22,47,40,10,30
19,22,48,14,11,3
19,22,49,8,10,-2
19,22,50,9,21,-12
19,22,51,9,14,-5
19,22,52,15,16,-1
19,22,53,13,7,6
19,22,54,19,10,9
19,22,55,8,35,-27
19,22,56,7,9,-2
19,22,57,21,23,-2
19,22,58,13,18,-5
19,22,59,18,15,3
19,22,60,24,20,4
19,22,61,17,12,5
19,22,62,20,9,11
19,22,63,14,32,-18
19,22,64,7,17,-10
19,22,65,22,16,6
19,22,66,12,31,-19
19,22,67,5,11,-6
19,22,68,18,15,3
19,22,69,25,21,4
19,22,70,19,11,8
19,22,71,12,20,-8
19,22,72,9,12,-3
19,22,73,16,14,2
19,22,74,11,17,-6
19,22,75,24,22,2
19,22,76,12,16,-4
19,22,77,19,17,2
19,22,78,12,14,-2
19,22,79,18,6,12
19,22,80,5,14,-9
19,22,81,18,22,-4
19,22,82,14,10,4
19,22,83,17,22,-5
19,22,84,9,13,-4
19,22,85,10,15,-5
19,22,86,17,10,7
19,22,87,8,7,1
19,22,88,22,11,11
19,22,89,20,29,-9
19,22,90,13,14,-1
19,22,91,8,10,-2
19,22,92,11,9,2
19,22,93,28,11,17
19,22,94,9,7,2
19,22,95,18,9,9
19,22,96,12,13,-1
19,22,97,9,3,6
19,22,98,13,13,0
19,22,99,9,15,-6
19,22,100,14,12,2
19,22,101,12,22,-10
19,22,102,23,18,5
19,22,103,22,15,7
19,22,104,23,22,1
19,22,105,5,11,-6
19,22,106,12,13,-1
19,22,107,22,12,10
19,22,108,17,9,8
19,22,109,11,15,-4
19,22,110,12,9,3
19,22,111,15,17,-2
19,22,112,15,17,-2
19,22,113,10,8,2
19,22,114,14,6,8
19,22,115,14,23,-9
19,22,116,4,18,-14
19,22,117,12,11,1
19,22,118,7,10,-3
19,22,119,13,21,-8
19,22,120,15,7,8
19,22,121,11,6,5
19,22,122,24,14,10
19,22,123,12,6,6
19,22,124,23,14,9
19,22,125,17,6,11
19,22,126,13,12,1
19,22,127,13,22,-9
19,22,128,10,11,-1
19,22,129,21,23,-2
19,22,130,20,19,1
19,22,131,15,19,-4
19,22,132,11,23,-12
19,22,133,25,24,1
19,22,134,15,25,-10
19,22,135,19,17,2
19,22,136,16,14,2
19,22,137,8,14,-6
19,22,138,8,12,-4
19,22,139,18,19,-1
19,22,140,15,11,4
19,22,141,14,13,1
19,22,142,10,16,-6
19,22,143,18,11,7
19,22,144,19,26,-7
19,22,145,21,20,1
19,22,146,5,13,-8
19,22,147,9,5,4
19,22,148,14,15,-1
19,22,149,14,14,0
19,22,150,11,20,-9
19,22,151,10,14,-4
19,22,152,4,12,-8
19,22,153,24,6,18
19,22,154,22,6,16
19,22,155,16,15,1
19,22,156,15,18,-3
19,22,157,24,24,0
19,22,158,12,7,5
19,22,159,18,16,2
19,22,160,14,11,3
19,22,161,16,10,6
19,22,162,19,17,2
19,22,163,19,21,-2
19,22,164,23,16,7
19,22,165,6,6,0
19,22,166,18,28,-10
19,22,167,17,12,5
19,22,168,23,13,10
19,22,169,8,13,-5
19,22,170,28,7,21
19,22,171,10,10,0
19,22,172,24,9,15
19,22,173,13,17,-4
19,22,174,18,10,8
19,22,175,19,25,-6
19,22,176,22,29,-7
19,22,177,19,13,6
19,22,178,12,11,1
19,22,179,17,15,2
19,22,180,10,17,-7
19,22,181,12,18,-6
19,22,182,19,21,-2
19,22,183,19,16,3
19,22,184,12,19,-7
19,22,185,18,8,10
19,22,186,25,11,14
19,22,187,34,15,19
19,22,188,13,7,6
19,22,189,8,9,-1
19,22,190,13,9,4
19,22,191,22,12,10
19,22,192,14,22,-8
19,22,193,21,22,-1
19,22,194,19,28,-9
19,22,195,14,18,-4
19,22,196,13,14,-1
19,22,197,19,15,4
19,22,198,7,6,1
19,22,199,11,16,-5
19,22,200,23,29,-6
19,22,201,13,14,-1
19,22,202,7,6,1
19,22,203,11,17,-6
19,22,204,14,18,-4
19,22,205,18,13,5
19,22,206,9,15,-6
19,22,207,16,14,2
19,22,208,14,10,4
19,22,209,14,19,-5
19,22,210,26,22,4
19,22,211,15,11,4
19,22,212,13,13,0
19,22,213,11,17,-6
19,22,214,12,28,-16
19,22,215,13,8,5
19,22,216,21,10,11
19,22,217,10,9,1
19,22,218,19,21,-2
19,22,219,16,22,-6
19,22,220,28,8,20
19,22,221,5,22,-17
19,22,222,8,6,2
19,22,223,12,21,-9
19,22,224,9,24,-15
19,22,225,6,11,-5
19,22,226,15,20,-5
19,22,227,14,12,2
19,22,228,27,8,19
19,22,229,22,17,5
19,22,230,20,15,5
19,22,231,12,18,-6
19,22,232,24,19,5
19,22,233,13,12,1
19,22,234,16,27,-11
19,22,235,16,19,-3
19,22,236,12,11,1
19,22,237,10,6,4
19,22,238,14,13,1
19,22,239,31,19,12
19,22,240,16,15,1
19,22,241,20,13,7
19,22,242,18,16,2
19,22,243,14,26,-12
19,22,244,8,11,-3
19,22,245,15,10,5
19,22,246,31,7,24
19,22,247,10,27,-17
19,22,248,20,18,2
19,22,249,17,17,0
19,22,250,8,11,-3
19,22,251,8,23,-15
19,22,252,5,9,-4
19,22,253,14,21,-7
19,22,254,18,11,7
19,22,255,6,12,-6
19,22,256,9,11,-2
19,22,257,7,16,-9
19,22,258,16,7,9
19,22,259,12,22,-10
19,22,260,20,14,6
19,22,261,10,9,1
19,22,262,14,17,-3
19,22,263,2,8,-6
19,22,264,18,12,6
19,22,265,15,38,-23
19,22,266,10,17,-7
19,22,267,19,19,0
19,22,268,10,8,2
19,22,269,13,11,2
19,22,270,13,15,-2
19,22,271,13,19,-6
19,22,272,3,8,-5
19,22,273,2,14,-12
19,22,274,18,27,-9
19,22,275,18,18,0
19,22,276,4,14,-10
19,22,277,12,14,-2
19,22,278,14,6,8
19,22,279,12,17,-5
19,22,280,12,13,-1
19,22,281,9,16,-7
19,22,282,17,10,7
19,22,283,11,5,6
19,22,284,8,10,-2
19,22,285,14,10,4
19,22,286,19,21,-2
19,22,287,13,13,0
19,22,288,23,14,9
19,22,289,16,14,2
19,22,290,7,16,-9
19,22,291,20,11,9
19,22,292,11,24,-13
19,22,293,10,11,-1
19,22,294,21,13,8
19,22,295,12,13,-1
19,22,296,6,17,-11
19,22,297,17,14,3
19,22,298,12,11,1
19,22,299,16,13,3
19,23,0,20,14,6
19,23,1,12,15,-3
19,23,2,11,12,-1
19,23,3,21,24,-3
19,23,4,11,13,-2
19,23,5,18,18,0
19,23,6,8,12,-4
19,23,7,6,15,-9
19,23,8,18,10,8
19,23,9,17,13,4
19,23,10,27,15,12
19,23,11,25,21,4
19,23,12,10,15,-5
19,23,13,12,13,-1
19,23,14,15,19,-4
19,23,15,25,14,11
19,23,16,5,10,-5
19,23,17,20,16,4
19,23,18,16,15,1
19,23,19,17,10,7
19,23,20,13,11,2
19,23,21,10,11,-1
19,23,22,14,21,-7
19,23,23,20,27,-7
19,23,24,18,11,7
19,23,25,21,23,-2
19,23,26,13,7,6
19,23,27,9,9,0
19,23,28,7,13,-6
19,23,29,13,17,-4
19,23,30,11,9,2
19,23,31,20,8,12
19,23,32,6,14,-8
19,23,33,16,10,6
19,23,34,17,15,2
19,23,35,22,22,0
19,23,36,12,11,1
19,23,37,7,9,-2
19,23,38,15,15,0
19,23,39,30,16,14
19,23,40,18,14,4
19,23,41,15,6,9
19,23,42,28,13,15
19,23,43,16,9,7
19,23,44,15,10,5
19,23,45,13,12,1
19,23,46,19,10,9
19,23,47,12,17,-5
19,23,48,14,5,9
19,23,49,24,13,11
19,23,50,21,16,5
19,23,51,11,8,3
19,23,52,19,13,6
19,23,53,20,17,3
19,23,54,16,8,8
19,23,55,23,20,3
19,23,56,28,14,14
19,23,57,12,7,5
19,23,58,13,10,3
19,23,59,8,20,-12
19,23,60,16,8,8
19,23,61,11,14,-3
19,23,62,12,12,0
19,23,63,14,16,-2
19,23,64,11,12,-1
19,23,65,20,10,10
19,23,66,22,9,13
19,23,67,20,10,10
19,23,68,19,10,9
19,23,69,10,18,-8
19,23,70,10,3,7
19,23,71,18,14,4
19,23,72,11,13,-2
19,23,73,13,8,5
19,23,74,4,10,-6
19,23,75,10,14,-4
19,23,76,30,12,18
19,23,77,8,7,1
19,23,78,8,21,-13
19,23,79,21,15,6
19,23,80,17,21,-4
19,23,81,15,10,5
19,23,82,9,18,-9
19,23,83,12,8,4
19,23,84,7,8,-1
19,23,85,13,18,-5
19,23,86,15,9,6
19,23,87,14,18,-4
19,23,88,24,11,13
19,23,89,2,16,-14
19,23,90,22,19,3
19,23,91,8,12,-4
19,23,92,8,9,-1
19,23,93,19,12,7
19,23,94,8,13,-5
19,23,95,17,7,10
19,23,96,12,13,-1
19,23,97,10,15,-5
19,23,98,11,14,-3
19,23,99,21,19,2
19,23,100,23,17,6
19,23,101,23,14,9
19,23,102,18,12,6
19,23,103,16,30,-14
19,23,104,21,14,7
19,23,105,6,7,-1
19,23,106,17,12,5
19,23,107,14,18,-4
19,23,108,16,10,6
19,23,109,16,8,8
19,23,110,14,28,-14
19,23,111,14,6,8
19,23,112,22,16,6
19,23,113,27,14,13
19,23,114,18,20,-2
19,23,115,11,2,9
19,23,116,20,14,6
19,23,117,14,20,-6
19,23,118,19,15,4
19,23,119,18,14,4
19,23,120,11,15,-4
19,23,121,25,22,3
19,23,122,12,12,0
19,23,123,20,12,8
19,23,124,11,23,-12
19,23,125,17,9,8
19,23,126,24,23,1
19,23,127,17,15,2
19,23,128,25,19,6
19,23,129,16,11,5
19,23,130,8,13,-5
19,23,131,20,18,2
19,23,132,14,15,-1
19,23,133,12,12,0
19,23,134,21,20,1
19,23,135,15,18,-3
19,23,136,4,1,3
19,23,137,9,20,-11
19,23,138,7,12,-5
19,23,139,19,19,0
19,23,140,18,11,7
19,23,141,21,15,6
19,23,142,18,18,0
19,23,143,14,11,3
19,23,144,17,13,4
19,23,145,15,7,8
19,23,146,7,1,6
19,23,147,11,14,-3
19,23,148,20,8,12
19,23,149,9,14,-5
19,23,150,13,18,-5
19,23,151,19,25,-6
19,23,152,13,14,-1
19,23,153,19,15,4
19,23,154,14,16,-2
19,23,155,8,6,2
19,23,156,15,24,-9
19,23,157,14,16,-2
19,23,158,9,8,1
19,23,159,19,18,1
19,23,160,14,21,-7
19,23,161,14,15,-1
19,23,162,24,22,2
19,23,163,16,14,2
19,23,164,12,13,-1
19,23,165,26,17,9
19,23,166,14,12,2
19,23,167,6,9,-3
19,23,168,13,14,-1
19,23,169,19,13,6
19,23,170,14,16,-2
19,23,171,19,8,11
19,23,172,17,22,-5
19,23,173,8,10,-2
19,23,174,15,16,-1
19,23,175,20,6,14
19,23,176,11,17,-6
19,23,177,23,17,6
19,23,178,6,24,-18
19,23,179,18,9,9
19,23,180,11,11,0
19,23,181,8,3,5
19,23,182,14,18,-4
19,23,183,10,9,1
19,23,184,16,16,0
19,23,185,13,15,-2
19,23,186,5,25,-20
19,23,187,26,16,10
19,23,188,18,14,4
19,23,189,14,28,-14
19,23,190,13,16,-3
19,23,191,15,12,3
19,23,192,17,18,-1
19,23,193,14,11,3
19,23,194,14,15,-1
19,23,195,18,13,5
19,23,196,16,8,8
19,23,197,22,22,0
19,23,198,20,26,-6
19,23,199,19,20,-1
19,23,200,17,7,10
19,23,201,9,14,-5
19,23,202,20,29,-9
19,23,203,10,8,2
19,23,204,27,27,0
19,23,205,14,19,-5
19,23,206,29,31,-2
19,23,207,18,17,1
19,23,208,22,11,11
19,23,209,13,14,-1
19,23,210,11,13,-2
19,23,211,16,14,2
19,23,212,20,15,5
19,23,213,11,11,0
19,23,214,21,14,7
19,23,215,23,12,11
19,23,216,10,13,-3
19,23,217,8,12,-4
19,23,218,10,13,-3
19,23,219,6,20,-14
19,23,220,15,15,0
19,23,221,21,19,2
19,23,222,21,22,-1
19,23,223,12,13,-1
19,23,224,19,22,-3
19,23,225,8,17,-9
19,23,226,17,11,6
19,23,227,7,8,-1
19,23,228,14,16,-2
19,23,229,11,5,6
19,23,230,10,10,0
19,23,231,22,9,13
19,23,232,15,13,2
19,23,233,13,21,-8
19,23,234,18,11,7
19,23,235,13,14,-1
19,23,236,13,25,-12
19,23,237,10,19,-9
19,23,238,12,19,-7
19,23,239,13,19,-6
19,23,240,18,23,-5
19,23,241,22,19,3
19,23,242,13,20,-7
19,23,243,18,10,8
19,23,244,11,14,-3
19,23,245,20,20,0
19,23,246,17,7,10
19,23,247,12,16,-4
19,23,248,6,21,-15
19,23,249,10,9,1
19,23,250,23,16,7
19,23,251,5,10,-5
19,23,252,11,13,-2
19,23,253,16,23,-7
19,23,254,10,6,4
19,23,255,8,12,-4
19,23,256,21,15,6
19,23,257,17,19,-2
19,23,258,21,17,4
19,23,259,17,10,7
19,23,260,11,8,3
19,23,261,14,16,-2
19,23,262,20,22,-2
19,23,263,5,10,-5
19,23,264,16,33,-17
19,23,265,10,14,-4
19,23,266,12,10,2
19,23,267,16,7,9
19,23,268,11,12,-1
19,23,269,8,13,-5
19,23,270,7,5,2
19,23,271,8,10,-2
19,23,272,23,28,-5
19,23,273,14,11,3
19,23,274,11,9,2
19,23,275,6,13,-7
19,23,276,15,18,-3
19,23,277,11,20,-9
19,23,278,14,26,-12
19,23,279,21,14,7
19,23,280,19,26,-7
19,23,281,26,26,0
19,23,282,14,9,5
19,23,283,22,21,1
19,23,284,15,11,4
19,23,285,17,19,-2
19,23,286,18,13,5
19,23,287,12,14,-2
19,23,288,11,11,0
19,23,289,13,10,3
19,23,290,7,9,-2
19,23,291,6,14,-8
19,23,292,17,13,4
19,23,293,8,8,0
19,23,294,15,18,-3
19,23,295,9,11,-2
19,23,296,13,6,7
19,23,297,22,10,12
19,23,298,14,9,5
19,23,299,22,6,16
19,24,0,24,13,11
19,24,1,16,7,9
19,24,2,16,11,5
19,24,3,5,10,-5
19,24,4,10,1,9
19,24,5,11,16,-5
19,24,6,12,11,1
19,24,7,21,15,6
19,24,8,13,11,2
19,24,9,26,21,5
19,24,10,19,15,4
19,24,11,18,6,12
19,24,12,18,11,7
19,24,13,12,6,6
19,24,14,2,9,-7
19,24,15,9,9,0
19,24,16,7,6,1
19,24,17,20,12,8
19,24,18,18,19,-1
19,24,19,6,16,-10
19,24,20,15,14,1
19,24,21,26,19,7
19,24,22,12,18,-6
19,24,23,20,15,5
19,24,24,15,3,12
19,24,25,14,9,5
19,24,26,15,12,3
19,24,27,12,11,1
19,24,28,25,14,11
19,24,29,15,17,-2
19,24,30,20,9,11
19,24,31,12,2,10
19,24,32,11,6,5
19,24,33,7,18,-11
19,24,34,15,15,0
19,24,35,16,14,2
19,24,36,3,12,-9
19,24,37,14,24,-10
19,24,38,8,13,-5
19,24,39,15,6,9
19,24,40,14,13,1
19,24,41,21,10,11
19,24,42,16,6,10
19,24,43,18,17,1
19,24,44,20,14,6
19,24,45,8,14,-6
19,24,46,13,16,-3
19,24,47,22,5,17
19,24,48,13,14,-1
19,24,49,16,10,6
19,24,50,13,5,8
19,24,51,3,6,-3
19,24,52,23,10,13
19,24,53,12,12,0
19,24,54,20,15,5
19,24,55,12,11,1
19,24,56,26,9,17
19,24,57,12,12,0
19,24,58,20,17,3
19,24,59,16,11,5
19,24,60,24,23,1
19,24,61,16,19,-3
19,24,62,18,15,3
19,24,63,19,11,8
19,24,64,13,4,9
19,24,65,14,12,2
19,24,66,11,12,-1
19,24,67,17,13,4
19,24,68,24,16,8
19,24,69,9,16,-7
19,24,70,17,12,5
19,24,71,18,13,5
19,24,72,23,9,14
19,24,73,11,22,-11
19,24,74,25,28,-3
19,24,75,8,3,5
19,24,76,16,21,-5
19,24,77,12,14,-2
19,24,78,17,22,-5
19,24,79,12,7,5
19,24,80,14,21,-7
19,24,81,11,15,-4
19,24,82,19,16,3
19,24,83,9,15,-6
19,24,84,22,21,1
19,24,85,10,3,7
19,24,86,22,14,8
19,24,87,18,12,6
19,24,88,20,18,2
19,24,89,27,17,10
19,24,90,27,21,6
19,24,91,19,8,11
19,24,92,14,17,-3
19,24,93,16,3,13
19,24,94,24,23,1
19,24,95,23,21,2
19,24,96,25,24,1
19,24,97,26,19,7
19,24,98,12,9,3
19,24,99,17,14,3
19,24,100,9,7,2
19,24,101,18,20,-2
19,24,102,8,15,-7
19,24,103,6,18,-12
19,24,104,11,11,0
19,24,105,21,9,12
19,24,106,11,11,0
19,24,107,16,30,-14
19,24,108,14,10,4
19,24,109,12,15,-3
19,24,110,12,7,5
19,24,111,18,16,2
19,24,112,13,8,5
19,24,113,11,25,-14
19,24,114,16,12,4
19,24,115,7,3,4
19,24,116,9,13,-4
19,24,117,16,15,1
19,24,118,27,14,13
19,24,119,20,19,1
19,24,120,11,24,-13
19,24,121,18,21,-3
19,24,122,27,12,15
19,24,123,15,12,3
19,24,124,15,30,-15
19,24,125,13,16,-3
19,24,126,12,11,1
19,24,127,17,20,-3
19,24,128,8,24,-16
19,24,129,20,16,4
19,24,130,20,18,2
19,24,131,16,14,2
19,24,132,9,20,-11
19,24,133,19,13,6
19,24,134,15,5,10
19,24,135,7,7,0
19,24,136,18,13,5
19,24,137,12,12,0
19,24,138,11,11,0
19,24,139,19,18,1
19,24,140,19,18,1
19,24,141,19,15,4
19,24,142,13,15,-2
19,24,143,17,5,12
19,24,144,16,19,-3
19,24,145,14,15,-1
19,24,146,13,7,6
19,24,147,13,10,3
19,24,148,24,23,1
19,24,149,11,11,0
19,24,150,21,20,1
19,24,151,13,12,1
19,24,152,17,14,3
19,24,153,15,9,6
19,24,154,18,12,6
19,24,155,9,17,-8
19,24,156,15,8,7
19,24,157,16,14,2
19,24,158,15,16,-1
19,24,159,5,11,-6
19,24,160,11,11,0
19,24,161,16,11,5
19,24,162,12,15,-3
19,24,163,12,21,-9
19,24,164,18,9,9
19,24,165,17,26,-9
19,24,166,9,14,-5
19,24,167,16,2,14
19,24,168,17,12,5
19,24,169,22,15,7
19,24,170,9,7,2
19,24,171,19,14,5
19,24,172,18,7,11
19,24,173,11,10,1
19,24,174,18,12,6
19,24,175,20,15,5
19,24,176,12,22,-10
19,24,177,12,7,5
19,24,178,6,6,0
19,24,179,18,22,-4
19,24,180,14,11,3
19,24,181,22,14,8
19,24,182,16,11,5
19,24,183,25,29,-4
19,24,184,15,14,1
19,24,185,11,14,-3
19,24,186,18,17,1
19,24,187,13,14,-1
19,24,188,13,12,1
19,24,189,14,13,1
19,24,190,16,12,4
19,24,191,25,20,5
19,24,192,17,9,8
19,24,193,6,12,-6
19,24,194,19,13,6
19,24,195,17,9,8
19,24,196,13,26,-13
19,24,197,21,17,4
19,24,198,18,7,11
19,24,199,11,15,-4
19,24,200,28,14,14
19,24,201,9,16,-7
19,24,202,18,19,-1
19,24,203,18,19,-1
19,24,204,16,21,-5
19,24,205,15,9,6
19,24,206,14,4,10
19,24,207,31,34,-3
19,24,208,24,17,7
19,24,209,13,10,3
19,24,210,6,21,-15
19,24,211,11,13,-2
19,24,212,6,22,-16
19,24,213,12,7,5
19,24,214,11,5,6
19,24,215,12,13,-1
19,24,216,10,13,-3
19,24,217,17,12,5
19,24,218,11,27,-16
19,24,219,9,24,-15
19,24,220,22,15,7
19,24,221,7,4,3
19,24,222,14,17,-3
19,24,223,13,16,-3
19,24,224,15,6,9
19,24,225,12,10,2
19,24,226,23,17,6
19,24,227,16,13,3
19,24,228,9,9,0
19,24,229,23,9,14
19,24,230,18,23,-5
19,24,231,21,9,12
19,24,232,17,14,3
19,24,233,14,18,-4
19,24,234,22,8,14
19,24,235,10,8,2
19,24,236,11,18,-7
19,24,237,23,11,12
19,24,238,11,6,5
19,24,239,11,16,-5
19,24,240,17,11,6
19,24,241,8,16,-8
19,24,242,20,17,3
19,24,243,12,13,-1
19,24,244,5,17,-12
19,24,245,7,7,0
19,24,246,12,8,4
19,24,247,16,15,1
19,24,248,26,13,13
19,24,249,19,18,1
19,24,250,12,9,3
19,24,251,19,12,7
19,24,252,13,13,0
19,24,253,19,11,8
19,24,254,20,14,6
19,24,255,23,12,11
19,24,256,14,15,-1
19,24,257,11,9,2
19,24,258,17,20,-3
19,24,259,15,16,-1
19,24,260,16,7,9
19,24,261,9,20,-11
19,24,262,16,11,5
19,24,263,14,11,3
19,24,264,22,9,13
19,24,265,29,18,11
19,24,266,22,15,7
19,24,267,14,9,5
19,24,268,26,14,12
19,24,269,17,13,4
19,24,270,14,13,1
19,24,271,15,13,2
19,24,272,29,15,14
19,24,273,9,15,-6
19,24,274,32,31,1
19,24,275,18,7,11
19,24,276,4,10,-6
19,24,277,11,12,-1
19,24,278,15,18,-3
19,24,279,20,18,2
19,24,280,12,15,-3
19,24,281,7,13,-6
19,24,282,23,11,12
19,24,283,18,16,2
19,24,284,20,15,5
19,24,285,14,12,2
19,24,286,29,22,7
19,24,287,9,16,-7
19,24,288,9,16,-7
19,24,289,12,9,3
19,24,290,14,15,-1
19,24,291,14,19,-5
19,24,292,16,7,9
19,24,293,9,9,0
19,24,294,24,21,3
19,24,295,12,19,-7
19,24,296,16,7,9
19,24,297,20,9,11
19,24,298,14,23,-9
19,24,299,19,9,10
19,25,0,14,5,9
19,25,1,13,12,1
19,25,2,8,10,-2
19,25,3,11,16,-5
19,25,4,14,10,4
19,25,5,15,20,-5
19,25,6,8,12,-4
19,25,7,9,6,3
19,25,8,14,8,6
19,25,9,21,14,7
19,25,10,17,12,5
19,25,11,19,23,-4
19,25,12,20,10,10
19,25,13,13,20,-7
19,25,14,12,19,-7
19,25,15,24,20,4
19,25,16,15,11,4
19,25,17,6,11,-5
19,25,18,11,19,-8
19,25,19,10,6,4
19,25,20,9,12,-3
19,25,21,19,9,10
19,25,22,15,12,3
19,25,23,6,7,-1
19,25,24,14,13,1
19,25,25,10,18,-8
19,25,26,10,21,-11
19,25,27,24,15,9
19,25,28,24,17,7
19,25,29,14,7,7
19,25,30,13,15,-2
19,25,31,13,6,7
19,25,32,13,20,-7
19,25,33,15,18,-3
19,25,34,4,9,-5
19,25,35,13,12,1
19,25,36,11,13,-2
19,25,37,12,8,4
19,25,38,13,10,3
19,25,39,10,11,-1
19,25,40,22,21,1
19,25,41,12,19,-7
19,25,42,19,14,5
19,25,43,18,9,9
19,25,44,24,17,7
19,25,45,24,11,13
19,25,46,11,14,-3
19,25,47,28,16,12
19,25,48,24,23,1
19,25,49,24,21,3
19,25,50,15,10,5
19,25,51,8,17,-9
19,25,52,18,17,1
19,25,53,15,33,-18
19,25,54,17,15,2
19,25,55,9,18,-9
19,25,56,12,15,-3
19,25,57,8,10,-2
19,25,58,12,17,-5
19,25,59,13,14,-1
19,25,60,32,19,13
19,25,61,11,11,0
19,25,62,10,18,-8
19,25,63,12,13,-1
19,25,64,19,15,4
19,25,65,19,5,14
19,25,66,16,12,4
19,25,67,22,11,11
19,25,68,29,16,13
19,25,69,21,10,11
19,25,70,19,12,7
19,25,71,19,4,15
19,25,72,15,23,-8
19,25,73,11,20,-9
19,25,74,14,10,4
19,25,75,36,18,18
19,25,76,18,12,6
19,25,77,16,11,5
19,25,78,12,15,-3
19,25,79,11,23,-12
19,25,80,18,13,5
19,25,81,18,13,5
19,25,82,19,14,5
19,25,83,14,15,-1
19,25,84,7,16,-9
19,25,85,15,12,3
19,25,86,8,12,-4
19,25,87,31,45,-14
19,25,88,25,11,14
19,25,89,12,15,-3
19,25,90,27,14,13
19,25,91,12,19,-7
19,25,92,23,10,13
19,25,93,28,16,12
19,25,94,12,14,-2
19,25,95,25,18,7
19,25,96,18,8,10
19,25,97,21,22,-1
19,25,98,19,16,3
19,25,99,18,11,7
19,25,100,11,5,6
19,25,101,18,11,7
19,25,102,18,11,7
19,25,103,16,13,3
19,25,104,29,11,18
19,25,105,17,21,-4
19,25,106,10,11,-1
19,25,107,22,20,2
19,25,108,13,17,-4
19,25,109,12,10,2
19,25,110,16,17,-1
19,25,111,16,16,0
19,25,112,12,13,-1
19,25,113,14,6,8
19,25,114,11,21,-10
19,25,115,16,9,7
19,25,116,5,10,-5
19,25,117,29,14,15
19,25,118,7,5,2
19,25,119,12,9,3
19,25,120,12,6,6
19,25,121,20,19,1
19,25,122,14,18,-4
19,25,123,9,5,4
19,25,124,14,13,1
19,25,125,21,8,13
19,25,126,18,22,-4
19,25,127,6,20,-14
19,25,128,13,19,-6
19,25,129,9,14,-5
19,25,130,22,21,1
19,25,131,7,15,-8
19,25,132,7,8,-1
19,25,133,13,12,1
19,25,134,13,8,5
19,25,135,15,11,4
19,25,136,10,11,-1
19,25,137,5,12,-7
19,25,138,17,6,11
19,25,139,21,21,0
19,25,140,11,15,-4
19,25,141,19,15,4
19,25,142,20,12,8
19,25,143,16,8,8
19,25,144,22,6,16
19,25,145,14,15,-1
19,25,146,8,14,-6
19,25,147,22,14,8
19,25,148,17,15,2
19,25,149,23,15,8
19,25,150,14,21,-7
19,25,151,27,6,21
19,25,152,26,25,1
19,25,153,12,22,-10
19,25,154,16,11,5
19,25,155,19,14,5
19,25,156,15,21,-6
19,25,157,9,21,-12
19,25,158,19,6,13
19,25,159,11,8,3
19,25,160,8,15,-7
19,25,161,10,14,-4
19,25,162,15,12,3
19,25,163,17,15,2
19,25,164,15,3,12
19,25,165,12,15,-3
19,25,166,18,16,2
19,25,167,17,13,4
19,25,168,19,19,0
19,25,169,18,13,5
19,25,170,12,16,-4
19,25,171,13,19,-6
19,25,172,9,9,0
19,25,173,21,23,-2
19,25,174,18,11,7
19,25,175,8,19,-11
19,25,176,4,13,-9
19,25,177,21,18,3
19,25,178,15,27,-12
19,25,179,8,8,0
19,25,180,17,17,0
19,25,181,15,15,0
19,25,182,18,23,-5
19,25,183,14,9,5
19,25,184,9,6,3
19,25,185,15,12,3
19,25,186,22,18,4
19,25,187,10,5,5
19,25,188,7,8,-1
19,25,189,14,13,1
19,25,190,13,15,-2
19,25,191,11,11,0
19,25,192,27,19,8
19,25,193,10,5,5
19,25,194,18,15,3
19,25,195,16,13,3
19,25,196,6,1,5
19,25,197,11,14,-3
19,25,198,22,17,5
19,25,199,14,19,-5
19,25,200,14,17,-3
19,25,201,19,12,7
19,25,202,10,8,2
19,25,203,7,17,-10
19,25,204,32,15,17
19,25,205,23,26,-3
19,25,206,24,27,-3
19,25,207,20,17,3
19,25,208,12,6,6
19,25,209,13,12,1
19,25,210,18,21,-3
19,25,211,12,13,-1
19,25,212,11,12,-1
19,25,213,25,27,-2
19,25,214,8,16,-8
19,25,215,11,9,2
19,25,216,19,16,3
19,25,217,22,19,3
19,25,218,17,11,6
19,25,219,9,16,-7
19,25,220,19,6,13
19,25,221,12,13,-1
19,25,222,21,20,1
19,25,223,18,12,6
19,25,224,10,18,-8
19,25,225,45,17,28
19,25,226,16,15,1
19,25,227,14,11,3
19,25,228,20,14,6
19,25,229,13,11,2
19,25,230,23,13,10
19,25,231,12,23,-11
19,25,232,22,14,8
19,25,233,16,15,1
19,25,234,12,20,-8
19,25,235,7,15,-8
19,25,236,23,20,3
19,25,237,9,13,-4
19,25,238,30,13,17
19,25,239,29,19,10
19,25,240,23,7,16
19,25,241,20,18,2
19,25,242,22,14,8
19,25,243,22,17,5
19,25,244,13,17,-4
19,25,245,8,10,-2
19,25,246,16,14,2
19,25,247,16,7,9
19,25,248,16,5,11
19,25,249,18,16,2
19,25,250,22,9,13
19,25,251,21,22,-1
19,25,252,17,20,-3
19,25,253,13,8,5
19,25,254,24,17,7
19,25,255,22,13,9
19,25,256,17,18,-1
19,25,257,20,14,6
19,25,258,16,10,6
19,25,259,10,9,1
19,25,260,10,9,1
19,25,261,21,19,2
19,25,262,15,8,7
19,25,263,11,10,1
19,25,264,13,11,2
19,25,265,17,17,0
19,25,266,14,18,-4
19,25,267,11,11,0
19,25,268,21,7,14
19,25,269,11,17,-6
19,25,270,26,17,9
19,25,271,15,17,-2
19,25,272,16,14,2
19,25,273,19,14,5
19,25,274,24,21,3
19,25,275,19,10,9
19,25,276,14,22,-8
19,25,277,13,6,7
19,25,278,23,14,9
19,25,279,9,13,-4
19,25,280,13,10,3
19,25,281,20,11,9
19,25,282,17,5,12
19,25,283,6,13,-7
19,25,284,20,9,11
19,25,285,9,16,-7
19,25,286,7,13,-6
19,25,287,10,6,4
19,25,288,23,20,3
19,25,289,27,22,5
19,25,290,17,21,-4
19,25,291,19,14,5
19,25,292,17,26,-9
19,25,293,16,22,-6
19,25,294,11,8,3
19,25,295,25,26,-1
19,25,296,11,17,-6
19,25,297,11,11,0
19,25,298,18,15,3
19,25,299,13,13,0
19,26,0,8,16,-8
19,26,1,18,16,2
19,26,2,23,11,12
19,26,3,18,22,-4
19,26,4,21,10,11
19,26,5,13,8,5
19,26,6,30,28,2
19,26,7,11,3,8
19,26,8,24,18,6
19,26,9,16,19,-3
19,26,10,12,6,6
19,26,11,20,18,2
19,26,12,10,3,7
19,26,13,16,20,-4
19,26,14,11,5,6
19,26,15,13,14,-1
19,26,16,14,18,-4
19,26,17,17,2,15
19,26,18,15,26,-11
19,26,19,6,12,-6
19,26,20,19,11,8
19,26,21,15,11,4
19,26,22,18,23,-5
19,26,23,25,14,11
19,26,24,19,9,10
19,26,25,10,7,3
19,26,26,26,29,-3
19,26,27,7,9,-2
19,26,28,4,11,-7
19,26,29,9,6,3
19,26,30,14,11,3
19,26,31,24,14,10
19,26,32,16,11,5
19,26,33,17,10,7
19,26,34,11,9,2
19,26,35,13,12,1
19,26,36,10,8,2
19,26,37,7,9,-2
19,26,38,22,9,13
19,26,39,15,11,4
19,26,40,18,11,7
19,26,41,13,10,3
19,26,42,18,15,3
19,26,43,4,15,-11
19,26,44,18,13,5
19,26,45,5,20,-15
19,26,46,20,15,5
19,26,47,22,15,7
19,26,48,21,14,7
19,26,49,9,7,2
19,26,50,33,16,17
19,26,51,13,15,-2
19,26,52,23,16,7
19,26,53,9,9,0
19,26,54,21,12,9
19,26,55,5,14,-9
19,26,56,5,11,-6
19,26,57,13,22,-9
19,26,58,20,10,10
19,26,59,8,3,5
19,26,60,11,17,-6
19,26,61,12,13,-1
19,26,62,30,20,10
19,26,63,21,23,-2
19,26,64,21,14,7
19,26,65,15,15,0
19,26,66,17,13,4
19,26,67,14,15,-1
19,26,68,8,15,-7
19,26,69,11,3,8
19,26,70,20,16,4
19,26,71,16,15,1
19,26,72,13,14,-1
19,26,73,15,21,-6
19,26,74,27,6,21
19,26,75,11,6,5
19,26,76,17,18,-1
19,26,77,20,18,2
19,26,78,12,19,-7
19,26,79,22,33,-11
19,26,80,9,15,-6
19,26,81,17,21,-4
19,26,82,13,10,3
19,26,83,21,11,10
19,26,84,8,11,-3
19,26,85,22,17,5
19,26,86,13,19,-6
19,26,87,6,10,-4
19,26,88,12,15,-3
19,26,89,11,8,3
19,26,90,16,18,-2
19,26,91,21,27,-6
19,26,92,18,9,9
19,26,93,12,18,-6
19,26,94,20,10,10
19,26,95,22,14,8
19,26,96,14,10,4
19,26,97,23,11,12
19,26,98,26,22,4
19,26,99,11,4,7
19,26,100,9,14,-5
19,26,101,19,15,4
19,26,102,15,7,8
19,26,103,18,11,7
19,26,104,17,13,4
19,26,105,11,6,5
19,26,106,11,19,-8
19,26,107,20,22,-2
19,26,108,11,7,4
19,26,109,18,20,-2
19,26,110,5,10,-5
19,26,111,21,27,-6
19,26,112,11,6,5
19,26,113,8,12,-4
19,26,114,9,13,-4
19,26,115,14,11,3
19,26,116,15,9,6
19,26,117,15,10,5
19,26,118,17,20,-3
19,26,119,5,12,-7
19,26,120,20,13,7
19,26,121,24,26,-2
19,26,122,13,23,-10
19,26,123,19,35,-16
19,26,124,16,24,-8
19,26,125,28,25,3
19,26,126,15,5,10
19,26,127,24,14,10
19,26,128,12,10,2
19,26,129,5,6,-1
19,26,130,17,14,3
19,26,131,15,20,-5
19,26,132,15,14,1
19,26,133,18,19,-1
19,26,134,6,10,-4
19,26,135,20,13,7
19,26,136,14,19,-5
19,26,137,13,5,8
19,26,138,9,16,-7
19,26,139,17,4,13
19,26,140,7,10,-3
19,26,141,14,14,0
19,26,142,25,11,14
19,26,143,14,18,-4
19,26,144,10,12,-2
19,26,145,20,31,-11
19,26,146,5,7,-2
19,26,147,8,20,-12
19,26,148,11,13,-2
19,26,149,8,4,4
19,26,150,11,9,2
19,26,151,8,7,1
19,26,152,25,8,17
19,26,153,10,24,-14
19,26,154,18,24,-6
19,26,155,7,22,-15
19,26,156,12,8,4
19,26,157,19,15,4
19,26,158,11,19,-8
19,26,159,32,25,7
19,26,160,12,13,-1
19,26,161,12,20,-8
19,26,162,10,9,1
19,26,163,16,24,-8
19,26,164,15,11,4
19,26,165,11,12,-1
19,26,166,5,21,-16
19,26,167,14,16,-2
19,26,168,16,16,0
19,26,169,12,13,-1
19,26,170,14,12,2
19,26,171,12,13,-1
19,26,172,14,12,2
19,26,173,8,4,4
19,26,174,19,5,14
19,26,175,12,12,0
19,26,176,7,10,-3
19,26,177,16,15,1
19,26,178,8,10,-2
19,26,179,18,6,12
19,26,180,18,11,7
19,26,181,15,12,3
19,26,182,10,4,6
19,26,183,10,17,-7
19,26,184,9,9,0
19,26,185,22,9,13
19,26,186,21,20,1
19,26,187,19,8,11
19,26,188,32,21,11
19,26,189,16,20,-4
19,26,190,8,7,1
19,26,191,21,21,0
19,26,192,9,12,-3
19,26,193,18,6,12
19,26,194,20,10,10
19,26,195,26,18,8
19,26,196,9,12,-3
19,26,197,16,20,-4
19,26,198,16,10,6
19,26,199,17,8,9
19,26,200,24,15,9
19,26,201,8,9,-1
19,26,202,18,17,1
19,26,203,17,14,3
19,26,204,8,7,1
19,26,205,6,10,-4
19,26,206,15,17,-2
19,26,207,19,10,9
19,26,208,17,9,8
19,26,209,12,12,0
19,26,210,14,14,0
19,26,211,18,15,3
19,26,212,16,12,4
19,26,213,19,16,3
19,26,214,5,11,-6
19,26,215,16,15,1
19,26,216,20,12,8
19,26,217,18,15,3
19,26,218,11,8,3
19,26,219,18,12,6
19,26,220,9,9,0
19,26,221,11,17,-6
19,26,222,15,13,2
19,26,223,23,13,10
19,26,224,31,23,8
19,26,225,13,14,-1
19,26,226,17,7,10
19,26,227,15,9,6
19,26,228,13,15,-2
19,26,229,11,9,2
19,26,230,17,18,-1
19,26,231,9,12,-3
19,26,232,11,10,1
19,26,233,27,11,16
19,26,234,11,4,7
19,26,235,12,8,4
19,26,236,23,34,-11
19,26,237,12,17,-5
19,26,238,17,21,-4
19,26,239,14,15,-1
19,26,240,24,21,3
19,26,241,15,12,3
19,26,242,18,11,7
19,26,243,8,10,-2
19,26,244,12,14,-2
19,26,245,8,10,-2
19,26,246,8,3,5
19,26,247,15,11,4
19,26,248,13,23,-10
19,26,249,9,9,0
19,26,250,21,9,12
19,26,251,25,23,2
19,26,252,3,4,-1
19,26,253,11,10,1
19,26,254,8,5,3
19,26,255,17,13,4
19,26,256,9,13,-4
19,26,257,11,7,4
19,26,258,13,7,6
19,26,259,11,13,-2
19,26,260,23,8,15
19,26,261,25,9,16
19,26,262,15,16,-1
19,26,263,30,16,14
19,26,264,7,11,-4
19,26,265,20,15,5
19,26,266,15,13,2
19,26,267,27,11,16
19,26,268,19,12,7
19,26,269,27,12,15
19,26,270,18,26,-8
19,26,271,26,19,7
19,26,272,13,19,-6
19,26,273,23,11,12
19,26,274,11,10,1
19,26,275,15,18,-3
19,26,276,18,7,11
19,26,277,22,12,10
19,26,278,13,10,3
19,26,279,25,13,12
19,26,280,17,10,7
19,26,281,13,18,-5
19,26,282,11,6,5
19,26,283,8,7,1
19,26,284,24,21,3
19,26,285,13,12,1
19,26,286,25,34,-9
19,26,287,16,7,9
19,26,288,13,13,0
19,26,289,17,14,3
19,26,290,11,18,-7
19,26,291,22,7,15
19,26,292,12,16,-4
19,26,293,26,11,15
19,26,294,17,14,3
19,26,295,11,12,-1
19,26,296,15,19,-4
19,26,297,12,22,-10
19,26,298,9,9,0
19,26,299,6,14,-8
19,27,0,16,24,-8
19,27,1,13,8,5
19,27,2,11,12,-1
19,27,3,12,8,4
19,27,4,24,19,5
19,27,5,16,12,4
19,27,6,9,21,-12
19,27,7,19,11,8
19,27,8,27,10,17
19,27,9,9,15,-6
19,27,10,17,14,3
19,27,11,23,19,4
19,27,12,9,8,1
19,27,13,9,15,-6
19,27,14,20,20,0
19,27,15,6,8,-2
19,27,16,19,12,7
19,27,17,11,12,-1
19,27,18,22,15,7
19,27,19,19,11,8
19,27,20,17,15,2
19,27,21,15,22,-7
19,27,22,7,20,-13
19,27,23,14,18,-4
19,27,24,18,12,6
19,27,25,10,16,-6
19,27,26,25,17,8
19,27,27,21,25,-4
19,27,28,17,10,7
19,27,29,29,24,5
19,27,30,14,5,9
19,27,31,17,14,3
19,27,32,21,16,5
19,27,33,24,14,10
19,27,34,24,17,7
19,27,35,21,5,16
19,27,36,15,3,12
19,27,37,19,13,6
19,27,38,9,9,0
19,27,39,10,15,-5
19,27,40,6,17,-11
19,27,41,14,10,4
19,27,42,17,16,1
19,27,43,21,10,11
19,27,44,7,21,-14
19,27,45,13,17,-4
19,27,46,19,29,-10
19,27,47,6,2,4
19,27,48,19,9,10
19,27,49,12,8,4
19,27,50,20,17,3
19,27,51,10,11,-1
19,27,52,7,12,-5
19,27,53,30,9,21
19,27,54,8,7,1
19,27,55,16,11,5
19,27,56,8,15,-7
19,27,57,16,22,-6
19,27,58,14,24,-10
19,27,59,26,26,0
19,27,60,13,15,-2
19,27,61,8,14,-6
19,27,62,9,12,-3
19,27,63,15,11,4
19,27,64,5,5,0
19,27,65,18,20,-2
19,27,66,17,4,13
19,27,67,18,16,2
19,27,68,23,20,3
19,27,69,6,8,-2
19,27,70,8,2,6
19,27,71,11,12,-1
19,27,72,18,22,-4
19,27,73,15,6,9
19,27,74,22,20,2
19,27,75,14,11,3
19,27,76,16,10,6
19,27,77,8,2,6
19,27,78,10,12,-2
19,27,79,11,6,5
19,27,80,15,11,4
19,27,81,16,10,6
19,27,82,20,17,3
19,27,83,6,13,-7
19,27,84,20,12,8
19,27,85,7,9,-2
19,27,86,10,3,7
19,27,87,22,18,4
19,27,88,16,21,-5
19,27,89,17,16,1
19,27,90,16,15,1
19,27,91,11,5,6
19,27,92,20,13,7
19,27,93,17,25,-8
19,27,94,11,11,0
19,27,95,24,11,13
19,27,96,8,4,4
19,27,97,11,11,0
19,27,98,10,24,-14
19,27,99,9,14,-5
19,27,100,19,21,-2
19,27,101,22,16,6
19,27,102,19,33,-14
19,27,103,17,23,-6
19,27,104,17,9,8
19,27,105,13,12,1
19,27,106,24,14,10
19,27,107,8,20,-12
19,27,108,17,11,6
19,27,109,21,16,5
19,27,110,4,8,-4
19,27,111,26,18,8
19,27,112,14,12,2
19,27,113,19,19,0
19,27,114,13,11,2
19,27,115,14,10,4
19,27,116,13,7,6
19,27,117,12,13,-1
19,27,118,25,12,13
19,27,119,19,11,8
19,27,120,8,3,5
19,27,121,6,14,-8
19,27,122,15,17,-2
19,27,123,18,10,8
19,27,124,12,6,6
19,27,125,3,5,-2
19,27,126,15,21,-6
19,27,127,24,15,9
19,27,128,18,14,4
19,27,129,16,8,8
19,27,130,16,7,9
19,27,131,9,10,-1
19,27,132,24,14,10
19,27,133,14,13,1
19,27,134,10,10,0
19,27,135,14,9,5
19,27,136,16,15,1
19,27,137,9,19,-10
19,27,138,18,16,2
19,27,139,27,11,16
19,27,140,14,29,-15
19,27,141,22,21,1
19,27,142,12,11,1
19,27,143,23,8,15
19,27,144,29,10,19
19,27,145,8,8,0
19,27,146,11,11,0
19,27,147,34,26,8
19,27,148,30,9,21
19,27,149,9,8,1
19,27,150,6,10,-4
19,27,151,16,13,3
19,27,152,11,13,-2
19,27,153,22,16,6
19,27,154,20,18,2
19,27,155,20,12,8
19,27,156,14,6,8
19,27,157,9,5,4
19,27,158,9,20,-11
19,27,159,16,6,10
19,27,160,12,19,-7
19,27,161,20,21,-1
19,27,162,15,9,6
19,27,163,11,15,-4
19,27,164,15,22,-7
19,27,165,11,15,-4
19,27,166,6,18,-12
19,27,167,19,12,7
19,27,168,19,8,11
19,27,169,15,18,-3
19,27,170,19,16,3
19,27,171,13,10,3
19,27,172,13,12,1
19,27,173,21,24,-3
19,27,174,18,22,-4
19,27,175,16,14,2
19,27,176,22,14,8
19,27,177,24,7,17
19,27,178,9,15,-6
19,27,179,12,12,0
19,27,180,8,14,-6
19,27,181,25,10,15
19,27,182,12,13,-1
19,27,183,15,11,4
19,27,184,14,8,6
19,27,185,17,11,6
19,27,186,19,13,6
19,27,187,26,14,12
19,27,188,14,6,8
19,27,189,9,12,-3
19,27,190,23,10,13
19,27,191,9,2,7
19,27,192,22,11,11
19,27,193,12,10,2
19,27,194,11,11,0
19,27,195,15,16,-1
19,27,196,6,4,2
19,27,197,23,12,11
19,27,198,19,18,1
19,27,199,26,16,10
19,27,200,12,8,4
19,27,201,11,7,4
19,27,202,38,23,15
19,27,203,16,3,13
19,27,204,14,20,-6
19,27,205,16,8,8
19,27,206,23,7,16
19,27,207,12,17,-5
19,27,208,3,7,-4
19,27,209,26,11,15
19,27,210,24,16,8
19,27,211,22,11,11
19,27,212,25,23,2
19,27,213,16,8,8
19,27,214,13,5,8
19,27,215,25,11,14
19,27,216,14,7,7
19,27,217,10,22,-12
19,27,218,21,19,2
19,27,219,22,6,16
19,27,220,10,12,-2
19,27,221,17,10,7
19,27,222,14,11,3
19,27,223,28,31,-3
19,27,224,14,9,5
19,27,225,17,18,-1
19,27,226,19,20,-1
19,27,227,28,13,15
19,27,228,16,12,4
19,27,229,11,3,8
19,27,230,17,29,-12
19,27,231,11,4,7
19,27,232,15,10,5
19,27,233,3,13,-10
19,27,234,21,20,1
19,27,235,18,11,7
19,27,236,18,12,6
19,27,237,8,3,5
19,27,238,15,18,-3
19,27,239,20,17,3
19,27,240,22,9,13
19,27,241,12,11,1
19,27,242,28,15,13
19,27,243,20,11,9
19,27,244,9,14,-5
19,27,245,11,9,2
19,27,246,22,9,13
19,27,247,13,5,8
19,27,248,29,16,13
19,27,249,10,15,-5
19,27,250,26,20,6
19,27,251,22,19,3
19,27,252,11,12,-1
19,27,253,22,17,5
19,27,254,22,12,10
19,27,255,8,19,-11
19,27,256,8,18,-10
19,27,257,20,10,10
19,27,258,30,13,17
19,27,259,14,13,1
19,27,260,6,10,-4
19,27,261,28,4,24
19,27,262,18,16,2
19,27,263,12,2,10
19,27,264,14,10,4
19,27,265,15,16,-1
19,27,266,23,7,16
19,27,267,27,16,11
19,27,268,18,5,13
19,27,269,14,12,2
19,27,270,22,18,4
19,27,271,4,4,0
19,27,272,22,7,15
19,27,273,22,11,11
19,27,274,24,13,11
19,27,275,5,16,-11
19,27,276,8,5,3
19,27,277,16,21,-5
19,27,278,10,4,6
19,27,279,15,17,-2
19,27,280,8,9,-1
19,27,281,12,18,-6
19,27,282,27,3,24
19,27,283,19,9,10
19,27,284,6,17,-11
19,27,285,16,10,6
19,27,286,16,16,0
19,27,287,7,13,-6
19,27,288,17,9,8
19,27,289,8,8,0
19,27,290,10,15,-5
19,27,291,10,12,-2
19,27,292,9,10,-1
19,27,293,11,9,2
19,27,294,3,7,-4
19,27,295,3,15,-12
19,27,296,15,9,6
19,27,297,26,11,15
19,27,298,6,8,-2
19,27,299,16,13,3
19,28,0,4,19,-15
19,28,1,10,16,-6
19,28,2,7,20,-13
19,28,3,18,8,10
19,28,4,17,10,7
19,28,5,3,14,-11
19,28,6,19,12,7
19,28,7,10,6,4
19,28,8,23,29,-6
19,28,9,14,4,10
19,28,10,24,13,11
19,28,11,26,22,4
19,28,12,14,13,1
19,28,13,12,12,0
19,28,14,13,11,2
19,28,15,9,9,0
19,28,16,13,12,1
19,28,17,18,22,-4
19,28,18,16,11,5
19,28,19,19,11,8
19,28,20,19,12,7
19,28,21,22,14,8
19,28,22,16,13,3
19,28,23,17,13,4
19,28,24,28,17,11
19,28,25,13,11,2
19,28,26,10,13,-3
19,28,27,10,15,-5
19,28,28,7,19,-12
19,28,29,21,13,8
19,28,30,16,15,1
19,28,31,23,7,16
19,28,32,16,20,-4
19,28,33,12,14,-2
19,28,34,8,4,4
19,28,35,13,7,6
19,28,36,10,15,-5
19,28,37,14,14,0
19,28,38,10,5,5
19,28,39,21,13,8
19,28,40,18,6,12
19,28,41,21,18,3
19,28,42,8,11,-3
19,28,43,10,20,-10
19,28,44,13,18,-5
19,28,45,22,4,18
19,28,46,28,9,19
19,28,47,15,14,1
19,28,48,4,10,-6
19,28,49,17,14,3
19,28,50,8,20,-12
19,28,51,18,18,0
19,28,52,14,8,6
19,28,53,25,10,15
19,28,54,19,9,10
19,28,55,9,10,-1
19,28,56,11,15,-4
19,28,57,17,12,5
19,28,58,19,15,4
19,28,59,25,18,7
19,28,60,11,7,4
19,28,61,24,10,14
19,28,62,18,20,-2
19,28,63,6,7,-1
19,28,64,9,8,1
19,28,65,17,16,1
19,28,66,29,17,12
19,28,67,37,15,22
19,28,68,23,8,15
19,28,69,22,9,13
19,28,70,15,17,-2
19,28,71,24,14,10
19,28,72,20,18,2
19,28,73,18,18,0
19,28,74,13,7,6
19,28,75,4,5,-1
19,28,76,22,9,13
19,28,77,14,8,6
19,28,78,6,7,-1
19,28,79,15,9,6
19,28,80,9,6,3
19,28,81,17,2,15
19,28,82,20,16,4
19,28,83,14,9,5
19,28,84,15,2,13
19,28,85,14,12,2
19,28,86,12,13,-1
19,28,87,23,14,9
19,28,88,12,8,4
19,28,89,24,11,13
19,28,90,11,13,-2
19,28,91,12,10,2
19,28,92,5,22,-17
19,28,93,17,11,6
19,28,94,14,20,-6
19,28,95,11,6,5
19,28,96,16,11,5
19,28,97,9,20,-11
19,28,98,32,12,20
19,28,99,15,18,-3
19,28,100,19,15,4
19,28,101,6,9,-3
19,28,102,13,10,3
19,28,103,11,9,2
19,28,104,20,15,5
19,28,105,14,23,-9
19,28,106,16,13,3
19,28,107,17,3,14
19,28,108,20,14,6
19,28,109,9,3,6
19,28,110,16,16,0
19,28,111,9,11,-2
19,28,112,16,17,-1
19,28,113,10,8,2
19,28,114,16,10,6
19,28,115,11,22,-11
19,28,116,13,12,1
19,28,117,12,17,-5
19,28,118,23,24,-1
19,28,119,15,13,2
19,28,120,10,8,2
19,28,121,15,13,2
19,28,122,10,13,-3
19,28,123,26,7,19
19,28,124,11,5,6
19,28,125,12,16,-4
19,28,126,20,14,6
19,28,127,16,7,9
19,28,128,18,9,9
19,28,129,22,14,8
19,28,130,23,15,8
19,28,131,20,19,1
19,28,132,21,14,7
19,28,133,36,8,28
19,28,134,6,16,-10
19,28,135,16,12,4
19,28,136,10,5,5
19,28,137,13,10,3
19,28,138,28,18,10
19,28,139,14,10,4
19,28,140,14,15,-1
19,28,141,10,11,-1
19,28,142,18,12,6
19,28,143,13,15,-2
19,28,144,19,11,8
19,28,145,13,8,5
19,28,146,15,18,-3
19,28,147,10,22,-12
19,28,148,21,12,9
19,28,149,23,13,10
19,28,150,14,8,6
19,28,151,17,13,4
19,28,152,23,13,10
19,28,153,13,18,-5
19,28,154,13,11,2
19,28,155,14,10,4
19,28,156,20,6,14
19,28,157,18,12,6
19,28,158,17,13,4
19,28,159,19,15,4
19,28,160,15,16,-1
19,28,161,23,18,5
19,28,162,13,14,-1
19,28,163,19,15,4
19,28,164,10,7,3
19,28,165,6,6,0
19,28,166,11,16,-5
19,28,167,9,10,-1
19,28,168,17,9,8
19,28,169,9,4,5
19,28,170,10,16,-6
19,28,171,20,20,0
19,28,172,12,14,-2
19,28,173,11,9,2
19,28,174,23,12,11
19,28,175,16,15,1
19,28,176,12,13,-1
19,28,177,21,18,3
19,28,178,20,24,-4
19,28,179,21,22,-1
19,28,180,24,9,15
19,28,181,17,6,11
19,28,182,7,15,-8
19,28,183,14,16,-2
19,28,184,20,19,1
19,28,185,17,10,7
19,28,186,13,16,-3
19,28,187,25,18,7
19,28,188,9,8,1
19,28,189,16,20,-4
19,28,190,14,18,-4
19,28,191,11,13,-2
19,28,192,10,13,-3
19,28,193,25,13,12
19,28,194,12,9,3
19,28,195,23,23,0
19,28,196,10,16,-6
19,28,197,12,11,1
19,28,198,13,5,8
19,28,199,17,21,-4
19,28,200,18,12,6
19,28,201,14,10,4
19,28,202,16,13,3
19,28,203,10,19,-9
19,28,204,28,14,14
19,28,205,15,6,9
19,28,206,17,9,8
19,28,207,21,11,10
19,28,208,9,14,-5
19,28,209,39,21,18
19,28,210,14,13,1
19,28,211,12,21,-9
19,28,212,15,6,9
19,28,213,28,22,6
19,28,214,5,7,-2
19,28,215,14,13,1
19,28,216,5,9,-4
19,28,217,15,5,10
19,28,218,14,21,-7
19,28,219,8,6,2
19,28,220,11,14,-3
19,28,221,10,17,-7
19,28,222,30,24,6
19,28,223,25,16,9
19,28,224,11,11,0
19,28,225,9,9,0
19,28,226,14,12,2
19,28,227,13,13,0
19,28,228,13,3,10
19,28,229,8,11,-3
19,28,230,25,16,9
19,28,231,13,6,7
19,28,232,11,9,2
19,28,233,21,11,10
19,28,234,17,9,8
19,28,235,20,14,6
19,28,236,18,10,8
19,28,237,6,11,-5
19,28,238,16,9,7
19,28,239,19,28,-9
19,28,240,11,17,-6
19,28,241,7,10,-3
19,28,242,15,16,-1
19,28,243,14,15,-1
19,28,244,8,10,-2
19,28,245,18,21,-3
19,28,246,8,10,-2
19,28,247,8,5,3
19,28,248,4,17,-13
19,28,249,22,18,4
19,28,250,12,19,-7
19,28,251,20,14,6
19,28,252,15,6,9
19,28,253,9,13,-4
19,28,254,16,20,-4
19,28,255,13,14,-1
19,28,256,14,13,1
19,28,257,18,20,-2
19,28,258,19,13,6
19,28,259,14,20,-6
19,28,260,12,5,7
19,28,261,11,8,3
19,28,262,17,21,-4
19,28,263,25,11,14
19,28,264,5,10,-5
19,28,265,6,9,-3
19,28,266,14,9,5
19,28,267,8,9,-1
19,28,268,7,5,2
19,28,269,21,14,7
19,28,270,13,12,1
19,28,271,16,15,1
19,28,272,18,11,7
19,28,273,15,9,6
19,28,274,9,10,-1
19,28,275,5,7,-2
19,28,276,16,9,7
19,28,277,22,9,13
19,28,278,17,9,8
19,28,279,28,3,25
19,28,280,26,12,14
19,28,281,19,18,1
19,28,282,11,15,-4
19,28,283,26,14,12
19,28,284,11,17,-6
19,28,285,7,1,6
19,28,286,13,11,2
19,28,287,14,15,-1
19,28,288,27,24,3
19,28,289,17,8,9
19,28,290,11,12,-1
19,28,291,13,14,-1
19,28,292,6,6,0
19,28,293,12,11,1
19,28,294,14,16,-2
19,28,295,17,13,4
19,28,296,17,15,2
19,28,297,17,22,-5
19,28,298,12,4,8
19,28,299,18,7,11
19,29,0,13,18,-5
19,29,1,11,14,-3
19,29,2,7,11,-4
19,29,3,14,19,-5
19,29,4,18,6,12
19,29,5,10,5,5
19,29,6,13,8,5
19,29,7,20,19,1
19,29,8,11,9,2
19,29,9,14,8,6
19,29,10,26,22,4
19,29,11,8,8,0
19,29,12,10,10,0
19,29,13,13,17,-4
19,29,14,27,12,15
19,29,15,14,21,-7
19,29,16,13,27,-14
19,29,17,13,5,8
19,29,18,18,16,2
19,29,19,16,4,12
19,29,20,20,23,-3
19,29,21,9,1,8
19,29,22,11,8,3
19,29,23,24,13,11
19,29,24,19,15,4
19,29,25,34,13,21
19,29,26,17,26,-9
19,29,27,10,12,-2
19,29,28,19,18,1
19,29,29,21,9,12
19,29,30,21,13,8
19,29,31,10,16,-6
19,29,32,8,7,1
19,29,33,6,12,-6
19,29,34,9,11,-2
19,29,35,10,13,-3
19,29,36,20,16,4
19,29,37,19,9,10
19,29,38,26,16,10
19,29,39,20,17,3
19,29,40,13,12,1
19,29,41,18,6,12
19,29,42,8,3,5
19,29,43,28,9,19
19,29,44,14,13,1
19,29,45,17,5,12
19,29,46,16,16,0
19,29,47,18,23,-5
19,29,48,15,7,8
19,29,49,14,14,0
19,29,50,6,3,3
19,29,51,9,2,7
19,29,52,7,11,-4
19,29,53,20,11,9
19,29,54,13,7,6
19,29,55,8,10,-2
19,29,56,14,8,6
19,29,57,7,8,-1
19,29,58,22,17,5
19,29,59,12,13,-1
19,29,60,26,14,12
19,29,61,13,9,4
19,29,62,10,14,-4
19,29,63,15,26,-11
19,29,64,15,15,0
19,29,65,16,11,5
19,29,66,23,13,10
19,29,67,16,8,8
19,29,68,17,12,5
19,29,69,14,11,3
19,29,70,15,12,3
19,29,71,21,16,5
19,29,72,25,8,17
19,29,73,12,13,-1
19,29,74,21,12,9
19,29,75,24,27,-3
19,29,76,19,17,2
19,29,77,18,15,3
19,29,78,14,13,1
19,29,79,11,7,4
19,29,80,9,10,-1
19,29,81,5,11,-6
19,29,82,18,12,6
19,29,83,1,15,-14
19,29,84,6,8,-2
19,29,85,20,17,3
19,29,86,12,5,7
19,29,87,12,8,4
19,29,88,9,11,-2
19,29,89,21,17,4
19,29,90,20,9,11
19,29,91,10,17,-7
19,29,92,9,17,-8
19,29,93,12,12,0
19,29,94,13,5,8
19,29,95,19,14,5
19,29,96,5,12,-7
19,29,97,28,18,10
19,29,98,8,10,-2
19,29,99,13,13,0
19,29,100,7,10,-3
19,29,101,15,16,-1
19,29,102,29,13,16
19,29,103,15,10,5
19,29,104,21,20,1
19,29,105,7,13,-6
19,29,106,19,17,2
19,29,107,18,8,10
19,29,108,27,23,4
19,29,109,9,14,-5
19,29,110,17,12,5
19,29,111,16,7,9
19,29,112,19,18,1
19,29,113,12,15,-3
19,29,114,16,11,5
19,29,115,17,6,11
19,29,116,21,9,12
19,29,117,13,16,-3
19,29,118,12,13,-1
19,29,119,16,7,9
19,29,120,14,12,2
19,29,121,15,16,-1
19,29,122,15,14,1
19,29,123,13,10,3
19,29,124,26,14,12
19,29,125,13,18,-5
19,29,126,12,11,1
19,29,127,20,11,9
19,29,128,10,11,-1
19,29,129,12,16,-4
19,29,130,18,12,6
19,29,131,22,18,4
19,29,132,17,21,-4
19,29,133,16,13,3
19,29,134,9,7,2
19,29,135,16,17,-1
19,29,136,11,12,-1
19,29,137,10,6,4
19,29,138,14,8,6
19,29,139,15,11,4
19,29,140,7,12,-5
19,29,141,14,9,5
19,29,142,11,13,-2
19,29,143,26,5,21
19,29,144,14,21,-7
19,29,145,25,10,15
19,29,146,15,10,5
19,29,147,13,12,1
19,29,148,20,14,6
19,29,149,15,15,0
19,29,150,6,7,-1
19,29,151,21,22,-1
19,29,152,7,3,4
19,29,153,10,14,-4
19,29,154,17,10,7
19,29,155,16,18,-2
19,29,156,24,13,11
19,29,157,21,17,4
19,29,158,15,12,3
19,29,159,13,20,-7
19,29,160,15,4,11
19,29,161,17,15,2
19,29,162,18,15,3
19,29,163,17,18,-1
19,29,164,10,14,-4
19,29,165,10,15,-5
19,29,166,25,11,14
19,29,167,16,13,3
19,29,168,21,9,12
19,29,169,8,5,3
19,29,170,12,3,9
19,29,171,15,16,-1
19,29,172,21,9,12
19,29,173,19,16,3
19,29,174,16,9,7
19,29,175,16,15,1
19,29,176,11,15,-4
19,29,177,15,20,-5
19,29,178,14,6,8
19,29,179,16,14,2
19,29,180,4,13,-9
19,29,181,10,16,-6
19,29,182,13,7,6
19,29,183,27,19,8
19,29,184,17,21,-4
19,29,185,8,10,-2
19,29,186,17,20,-3
19,29,187,10,8,2
19,29,188,25,17,8
19,29,189,16,6,10
19,29,190,20,20,0
19,29,191,8,13,-5
19,29,192,4,15,-11
19,29,193,12,11,1
19,29,194,25,12,13
19,29,195,21,6,15
19,29,196,20,11,9
19,29,197,16,25,-9
19,29,198,9,17,-8
19,29,199,12,5,7
19,29,200,9,11,-2
19,29,201,33,12,21
19,29,202,11,15,-4
19,29,203,8,11,-3
19,29,204,22,13,9
19,29,205,7,9,-2
19,29,206,27,15,12
19,29,207,12,2,10
19,29,208,17,17,0
19,29,209,5,9,-4
19,29,210,16,30,-14
19,29,211,14,4,10
19,29,212,19,13,6
19,29,213,20,9,11
19,29,214,5,13,-8
19,29,215,13,12,1
19,29,216,10,16,-6
19,29,217,6,16,-10
19,29,218,16,8,8
19,29,219,14,18,-4
19,29,220,12,15,-3
19,29,221,8,12,-4
19,29,222,19,6,13
19,29,223,9,6,3
19,29,224,7,9,-2
19,29,225,14,7,7
19,29,226,11,8,3
19,29,227,16,19,-3
19,29,228,15,9,6
19,29,229,21,21,0
19,29,230,14,11,3
19,29,231,16,6,10
19,29,232,17,13,4
19,29,233,20,5,15
19,29,234,17,13,4
19,29,235,15,7,8
19,29,236,22,11,11
19,29,237,10,7,3
19,29,238,15,14,1
19,29,239,23,6,17
19,29,240,13,11,2
19,29,241,16,8,8
19,29,242,27,18,9
19,29,243,18,18,0
19,29,244,18,9,9
19,29,245,11,15,-4
19,29,246,9,10,-1
19,29,247,13,14,-1
19,29,248,10,5,5
19,29,249,18,14,4
19,29,250,20,9,11
19,29,251,29,12,17
19,29,252,16,15,1
19,29,253,18,16,2
19,29,254,11,12,-1
19,29,255,21,11,10
19,29,256,17,9,8
19,29,257,29,14,15
19,29,258,12,12,0
19,29,259,18,15,3
19,29,260,12,11,1
19,29,261,20,13,7
19,29,262,16,13,3
19,29,263,11,10,1
19,29,264,10,14,-4
19,29,265,16,12,4
19,29,266,21,21,0
19,29,267,15,24,-9
19,29,268,19,9,10
19,29,269,25,12,13
19,29,270,29,24,5
19,29,271,13,18,-5
19,29,272,12,22,-10
19,29,273,16,15,1
19,29,274,17,23,-6
19,29,275,15,15,0
19,29,276,16,13,3
19,29,277,22,13,9
19,29,278,15,8,7
19,29,279,3,4,-1
19,29,280,32,14,18
19,29,281,14,22,-8
19,29,282,10,6,4
19,29,283,14,18,-4
19,29,284,17,14,3
19,29,285,15,7,8
19,29,286,8,8,0
19,29,287,11,11,0
19,29,288,16,3,13
19,29,289,13,8,5
19,29,290,25,10,15
19,29,291,14,20,-6
19,29,292,9,8,1
19,29,293,8,7,1
19,29,294,16,19,-3
19,29,295,15,18,-3
19,29,296,15,12,3
19,29,297,12,12,0
19,29,298,21,9,12
19,29,299,15,10,5
19,30,0,21,15,6
19,30,1,9,18,-9
19,30,2,11,19,-8
19,30,3,21,6,15
19,30,4,16,7,9
19,30,5,21,5,16
19,30,6,12,15,-3
19,30,7,26,18,8
19,30,8,16,9,7
19,30,9,11,14,-3
19,30,10,7,15,-8
19,30,11,16,4,12
19,30,12,18,9,9
19,30,13,15,4,11
19,30,14,24,13,11
19,30,15,10,7,3
19,30,16,19,7,12
19,30,17,20,9,11
19,30,18,18,10,8
19,30,19,16,20,-4
19,30,20,16,22,-6
19,30,21,21,16,5
19,30,22,14,9,5
19,30,23,25,11,14
19,30,24,10,17,-7
19,30,25,22,20,2
19,30,26,9,7,2
19,30,27,12,13,-1
19,30,28,18,13,5
19,30,29,14,7,7
19,30,30,11,9,2
19,30,31,18,16,2
19,30,32,18,18,0
19,30,33,18,8,10
19,30,34,8,9,-1
19,30,35,17,12,5
19,30,36,18,8,10
19,30,37,9,23,-14
19,30,38,37,16,21
19,30,39,15,10,5
19,30,40,18,18,0
19,30,41,22,16,6
19,30,42,18,8,10
19,30,43,24,24,0
19,30,44,18,14,4
19,30,45,22,11,11
19,30,46,19,14,5
19,30,47,17,17,0
19,30,48,5,4,1
19,30,49,9,9,0
19,30,50,14,13,1
19,30,51,24,13,11
19,30,52,15,13,2
19,30,53,6,13,-7
19,30,54,16,7,9
19,30,55,6,14,-8
19,30,56,10,8,2
19,30,57,17,7,10
19,30,58,14,8,6
19,30,59,12,7,5
19,30,60,18,17,1
19,30,61,26,6,20
19,30,62,1,12,-11
19,30,63,11,10,1
19,30,64,8,8,0
19,30,65,19,16,3
19,30,66,5,16,-11
19,30,67,16,18,-2
19,30,68,11,10,1
19,30,69,28,34,-6
19,30,70,23,8,15
19,30,71,18,11,7
19,30,72,10,7,3
19,30,73,27,14,13
19,30,74,13,6,7
19,30,75,28,8,20
19,30,76,9,6,3
19,30,77,12,2,10
19,30,78,24,16,8
19,30,79,16,21,-5
19,30,80,3,7,-4
19,30,81,10,7,3
19,30,82,17,9,8
19,30,83,15,12,3
19,30,84,12,4,8
19,30,85,13,10,3
19,30,86,22,9,13
19,30,87,10,15,-5
19,30,88,12,8,4
19,30,89,11,2,9
19,30,90,11,10,1
19,30,91,9,11,-2
19,30,92,20,7,13
19,30,93,21,12,9
19,30,94,5,16,-11
19,30,95,21,17,4
19,30,96,18,14,4
19,30,97,11,10,1
19,30,98,20,15,5
19,30,99,17,6,11
19,30,100,11,11,0
19,30,101,13,6,7
19,30,102,9,8,1
19,30,103,32,21,11
19,30,104,11,11,0
19,30,105,15,7,8
19,30,106,12,12,0
19,30,107,22,17,5
19,30,108,20,5,15
19,30,109,16,19,-3
19,30,110,20,9,11
19,30,111,18,14,4
19,30,112,14,15,-1
19,30,113,12,2,10
19,30,114,11,17,-6
19,30,115,15,20,-5
19,30,116,13,14,-1
19,30,117,16,13,3
19,30,118,24,26,-2
19,30,119,19,16,3
19,30,120,14,6,8
19,30,121,13,17,-4
19,30,122,26,24,2
19,30,123,16,19,-3
19,30,124,9,14,-5
19,30,125,5,5,0
19,30,126,21,12,9
19,30,127,24,22,2
19,30,128,22,9,13
19,30,129,17,4,13
19,30,130,19,10,9
19,30,131,17,14,3
19,30,132,10,9,1
19,30,133,28,20,8
19,30,134,20,12,8
19,30,135,15,10,5
19,30,136,13,4,9
19,30,137,15,4,11
19,30,138,16,21,-5
19,30,139,13,6,7
19,30,140,14,18,-4
19,30,141,13,16,-3
19,30,142,22,20,2
19,30,143,18,11,7
19,30,144,14,18,-4
19,30,145,29,20,9
19,30,146,12,22,-10
19,30,147,15,6,9
19,30,148,23,19,4
19,30,149,13,14,-1
19,30,150,15,6,9
19,30,151,30,17,13
19,30,152,3,4,-1
19,30,153,21,21,0
19,30,154,8,6,2
19,30,155,11,19,-8
19,30,156,13,5,8
19,30,157,18,13,5
19,30,158,6,10,-4
19,30,159,11,14,-3
19,30,160,25,6,19
19,30,161,6,8,-2
19,30,162,19,16,3
19,30,163,26,10,16
19,30,164,13,21,-8
19,30,165,21,13,8
19,30,166,14,10,4
19,30,167,18,5,13
19,30,168,28,22,6
19,30,169,22,14,8
19,30,170,7,14,-7
19,30,171,20,9,11
19,30,172,16,16,0
19,30,173,10,11,-1
19,30,174,14,20,-6
19,30,175,27,14,13
19,30,176,10,3,7
19,30,177,10,21,-11
19,30,178,18,15,3
19,30,179,14,10,4
19,30,180,16,10,6
19,30,181,7,13,-6
19,30,182,13,19,-6
19,30,183,17,12,5
19,30,184,13,10,3
19,30,185,11,13,-2
19,30,186,11,11,0
19,30,187,22,10,12
19,30,188,19,14,5
19,30,189,22,24,-2
19,30,190,12,20,-8
19,30,191,8,4,4
19,30,192,16,9,7
19,30,193,16,10,6
19,30,194,12,13,-1
19,30,195,24,18,6
19,30,196,10,9,1
19,30,197,17,15,2
19,30,198,26,23,3
19,30,199,6,7,-1
19,30,200,16,11,5
19,30,201,6,5,1
19,30,202,13,11,2
19,30,203,18,3,15
19,30,204,17,20,-3
19,30,205,10,12,-2
19,30,206,8,4,4
19,30,207,16,29,-13
19,30,208,9,8,1
19,30,209,7,5,2
19,30,210,14,16,-2
19,30,211,16,13,3
19,30,212,13,7,6
19,30,213,16,8,8
19,30,214,25,19,6
19,30,215,20,16,4
19,30,216,27,9,18
19,30,217,17,14,3
19,30,218,19,8,11
19,30,219,16,6,10
19,30,220,12,8,4
19,30,221,23,24,-1
19,30,222,18,11,7
19,30,223,20,16,4
19,30,224,14,3,11
19,30,225,2,9,-7
19,30,226,30,17,13
19,30,227,16,22,-6
19,30,228,23,14,9
19,30,229,12,10,2
19,30,230,12,14,-2
19,30,231,7,9,-2
19,30,232,9,13,-4
19,30,233,23,6,17
19,30,234,17,8,9
19,30,235,18,10,8
19,30,236,25,14,11
19,30,237,18,20,-2
19,30,238,19,8,11
19,30,239,15,12,3
19,30,240,12,9,3
19,30,241,12,19,-7
19,30,242,6,9,-3
19,30,243,14,19,-5
19,30,244,21,20,1
19,30,245,6,4,2
19,30,246,13,7,6
19,30,247,15,8,7
19,30,248,15,13,2
19,30,249,16,20,-4
19,30,250,6,9,-3
19,30,251,35,21,14
19,30,252,16,6,10
19,30,253,15,8,7
19,30,254,13,6,7
19,30,255,24,6,18
19,30,256,22,21,1
19,30,257,16,13,3
19,30,258,13,17,-4
19,30,259,13,17,-4
19,30,260,17,9,8
19,30,261,10,5,5
19,30,262,10,5,5
19,30,263,19,8,11
19,30,264,8,8,0
19,30,265,15,12,3
19,30,266,13,19,-6
19,30,267,19,16,3
19,30,268,14,15,-1
19,30,269,16,5,11
19,30,270,15,13,2
19,30,271,23,13,10
19,30,272,11,15,-4
19,30,273,16,9,7
19,30,274,18,11,7
19,30,275,21,13,8
19,30,276,17,4,13
19,30,277,20,6,14
19,30,278,9,10,-1
19,30,279,18,12,6
19,30,280,22,12,10
19,30,281,12,14,-2
19,30,282,11,12,-1
19,30,283,22,23,-1
19,30,284,14,9,5
19,30,285,8,7,1
19,30,286,13,3,10
19,30,287,26,14,12
19,30,288,20,10,10
19,30,289,10,21,-11
19,30,290,10,19,-9
19,30,291,33,14,19
19,30,292,7,14,-7
19,30,293,11,9,2
19,30,294,28,18,10
19,30,295,15,10,5
19,30,296,21,16,5
19,30,297,13,6,7
19,30,298,12,5,7
19,30,299,10,4,6
20,1,0,9,5,4
20,1,1,8,17,-9
20,1,2,7,11,-4
20,1,3,6,16,-10
20,1,4,9,21,-12
20,1,5,16,19,-3
20,1,6,22,8,14
20,1,7,3,16,-13
20,1,8,8,7,1
20,1,9,20,18,2
20,1,10,11,18,-7
20,1,11,8,5,3
20,1,12,8,24,-16
20,1,13,9,12,-3
20,1,14,15,18,-3
20,1,15,9,15,-6
20,1,16,11,9,2
20,1,17,16,21,-5
20,1,18,17,27,-10
20,1,19,1,11,-10
20,1,20,4,15,-11
20,1,21,9,26,-17
20,1,22,10,26,-16
20,1,23,9,16,-7
20,1,24,13,16,-3
20,1,25,9,20,-11
20,1,26,3,20,-17
20,1,27,10,8,2
20,1,28,4,13,-9
20,1,29,6,15,-9
20,1,30,6,12,-6
20,1,31,9,19,-10
20,1,32,5,12,-7
20,1,33,8,13,-5
20,1,34,3,9,-6
20,1,35,11,12,-1
20,1,36,7,12,-5
20,1,37,10,8,2
20,1,38,9,19,-10
20,1,39,8,5,3
20,1,40,13,31,-18
20,1,41,15,15,0
20,1,42,9,18,-9
20,1,43,7,14,-7
20,1,44,6,12,-6
20,1,45,16,15,1
20,1,46,7,23,-16
20,1,47,11,20,-9
20,1,48,7,15,-8
20,1,49,10,24,-14
20,1,50,6,18,-12
20,1,51,7,15,-8
20,1,52,15,13,2
20,1,53,16,16,0
20,1,54,8,14,-6
20,1,55,6,10,-4
20,1,56,8,12,-4
20,1,57,10,22,-12
20,1,58,8,5,3
20,1,59,6,17,-11
20,1,60,9,21,-12
20,1,61,8,8,0
20,1,62,6,11,-5
20,1,63,4,3,1
20,1,64,5,8,-3
20,1,65,9,16,-7
20,1,66,6,18,-12
20,1,67,22,19,3
20,1,68,3,13,-10
20,1,69,11,21,-10
20,1,70,7,11,-4
20,1,71,5,20,-15
20,1,72,11,18,-7
20,1,73,7,13,-6
20,1,74,14,23,-9
20,1,75,10,13,-3
20,1,76,7,17,-10
20,1,77,5,14,-9
20,1,78,1,22,-21
20,1,79,11,27,-16
20,1,80,11,18,-7
20,1,81,10,30,-20
20,1,82,5,21,-16
20,1,83,8,22,-14
20,1,84,24,19,5
20,1,85,9,22,-13
20,1,86,9,10,-1
20,1,87,1,4,-3
20,1,88,9,14,-5
20,1,89,5,4,1
20,1,90,5,14,-9
20,1,91,15,14,1
20,1,92,6,27,-21
20,1,93,4,14,-10
20,1,94,20,31,-11
20,1,95,7,17,-10
20,1,96,10,10,0
20,1,97,2,1,1
20,1,98,11,24,-13
20,1,99,5,10,-5
20,1,100,10,10,0
20,1,101,11,17,-6
20,1,102,3,15,-12
20,1,103,6,13,-7
20,1,104,18,25,-7
20,1,105,13,13,0
20,1,106,6,15,-9
20,1,107,5,8,-3
20,1,108,6,12,-6
20,1,109,9,22,-13
20,1,110,13,22,-9
20,1,111,3,18,-15
20,1,112,9,28,-19
20,1,113,5,27,-22
20,1,114,5,18,-13
20,1,115,11,6,5
20,1,116,10,22,-12
20,1,117,3,20,-17
20,1,118,14,13,1
20,1,119,5,22,-17
20,1,120,11,15,-4
20,1,121,8,28,-20
20,1,122,6,13,-7
20,1,123,15,21,-6
20,1,124,5,40,-35
20,1,125,11,8,3
20,1,126,8,14,-6
20,1,127,7,26,-19
20,1,128,17,24,-7
20,1,129,13,9,4
20,1,130,9,12,-3
20,1,131,13,7,6
20,1,132,14,16,-2
20,1,133,11,22,-11
20,1,134,7,18,-11
20,1,135,9,17,-8
20,1,136,17,20,-3
20,1,137,8,11,-3
20,1,138,10,22,-12
20,1,139,4,12,-8
20,1,140,8,11,-3
20,1,141,16,14,2
20,1,142,7,15,-8
20,1,143,5,20,-15
20,1,144,8,17,-9
20,1,145,4,12,-8
20,1,146,9,22,-13
20,1,147,5,23,-18
20,1,148,21,22,-1
20,1,149,3,9,-6
20,1,150,10,15,-5
20,1,151,12,27,-15
20,1,152,16,18,-2
20,1,153,9,12,-3
20,1,154,17,16,1
20,1,155,4,29,-25
20,1,156,21,35,-14
20,1,157,0,10,-10
20,1,158,11,10,1
20,1,159,11,11,0
20,1,160,8,19,-11
20,1,161,8,22,-14
20,1,162,10,17,-7
20,1,163,12,13,-1
20,1,164,5,19,-14
20,1,165,8,31,-23
20,1,166,10,22,-12
20,1,167,6,15,-9
20,1,168,6,26,-20
20,1,169,6,11,-5
20,1,170,10,18,-8
20,1,171,10,20,-10
20,1,172,9,26,-17
20,1,173,8,5,3
20,1,174,11,20,-9
20,1,175,12,17,-5
20,1,176,13,14,-1
20,1,177,12,20,-8
20,1,178,10,20,-10
20,1,179,7,16,-9
20,1,180,5,34,-29
20,1,181,6,8,-2
20,1,182,4,18,-14
20,1,183,6,25,-19
20,1,184,4,19,-15
20,1,185,3,6,-3
20,1,186,14,23,-9
20,1,187,11,18,-7
20,1,188,6,12,-6
20,1,189,4,22,-18
20,1,190,4,11,-7
20,1,191,14,23,-9
20,1,192,8,20,-12
20,1,193,2,9,-7
20,1,194,1,3,-2
20,1,195,11,11,0
20,1,196,10,21,-11
20,1,197,6,22,-16
20,1,198,4,17,-13
20,1,199,7,10,-3
20,1,200,3,17,-14
20,1,201,15,28,-13
20,1,202,9,12,-3
20,1,203,7,10,-3
20,1,204,13,19,-6
20,1,205,10,21,-11
20,1,206,7,12,-5
20,1,207,4,27,-23
20,1,208,4,13,-9
20,1,209,19,15,4
20,1,210,5,26,-21
20,1,211,8,13,-5
20,1,212,11,12,-1
20,1,213,9,11,-2
20,1,214,6,12,-6
20,1,215,10,18,-8
20,1,216,4,21,-17
20,1,217,12,29,-17
20,1,218,15,12,3
20,1,219,8,13,-5
20,1,220,4,12,-8
20,1,221,8,10,-2
20,1,222,2,21,-19
20,1,223,11,16,-5
20,1,224,13,16,-3
20,1,225,6,9,-3
20,1,226,9,15,-6
20,1,227,12,19,-7
20,1,228,10,9,1
20,1,229,14,10,4
20,1,230,12,22,-10
20,1,231,9,15,-6
20,1,232,7,15,-8
20,1,233,11,10,1
20,1,234,13,29,-16
20,1,235,20,15,5
20,1,236,7,27,-20
20,1,237,9,12,-3
20,1,238,6,11,-5
20,1,239,11,6,5
20,1,240,10,6,4
20,1,241,0,13,-13
20,1,242,5,11,-6
20,1,243,3,10,-7
20,1,244,6,10,-4
20,1,245,8,23,-15
20,1,246,2,11,-9
20,1,247,11,17,-6
20,1,248,6,14,-8
20,1,249,3,19,-16
20,1,250,7,7,0
20,1,251,11,10,1
20,1,252,10,18,-8
20,1,253,15,24,-9
20,1,254,14,16,-2
20,1,255,9,9,0
20,1,256,3,15,-12
20,1,257,4,21,-17
20,1,258,3,17,-14
20,1,259,8,14,-6
20,1,260,14,30,-16
20,1,261,8,32,-24
20,1,262,12,18,-6
20,1,263,25,17,8
20,1,264,11,11,0
20,1,265,2,20,-18
20,1,266,11,29,-18
20,1,267,10,10,0
20,1,268,17,20,-3
20,1,269,6,22,-16
20,1,270,7,6,1
20,1,271,11,26,-15
20,1,272,17,21,-4
20,1,273,6,25,-19
20,1,274,8,28,-20
20,1,275,3,13,-10
20,1,276,3,6,-3
20,1,277,4,13,-9
20,1,278,8,14,-6
20,1,279,10,13,-3
20,1,280,10,10,0
20,1,281,11,11,0
20,1,282,7,13,-6
20,1,283,7,12,-5
20,1,284,7,11,-4
20,1,285,6,23,-17
20,1,286,4,16,-12
20,1,287,24,12,12
20,1,288,14,31,-17
20,1,289,3,3,0
20,1,290,2,7,-5
20,1,291,8,18,-10
20,1,292,10,17,-7
20,1,293,5,16,-11
20,1,294,14,20,-6
20,1,295,10,8,2
20,1,296,15,17,-2
20,1,297,3,8,-5
20,1,298,5,12,-7
20,1,299,7,16,-9
20,2,0,2,12,-10
20,2,1,8,25,-17
20,2,2,1,11,-10
20,2,3,4,10,-6
20,2,4,9,18,-9
20,2,5,15,23,-8
20,2,6,9,14,-5
20,2,7,3,7,-4
20,2,8,1,5,-4
20,2,9,12,20,-8
20,2,10,6,21,-15
20,2,11,12,13,-1
20,2,12,20,8,12
20,2,13,15,35,-20
20,2,14,7,14,-7
20,2,15,17,28,-11
20,2,16,13,14,-1
20,2,17,4,12,-8
20,2,18,10,9,1
20,2,19,10,12,-2
20,2,20,5,19,-14
20,2,21,0,10,-10
20,2,22,12,19,-7
20,2,23,7,10,-3
20,2,24,7,14,-7
20,2,25,5,11,-6
20,2,26,5,11,-6
20,2,27,13,19,-6
20,2,28,21,22,-1
20,2,29,10,5,5
20,2,30,8,10,-2
20,2,31,1,17,-16
20,2,32,10,12,-2
20,2,33,4,15,-11
20,2,34,13,18,-5
20,2,35,7,16,-9
20,2,36,9,15,-6
20,2,37,3,26,-23
20,2,38,7,6,1
20,2,39,7,25,-18
20,2,40,7,18,-11
20,2,41,17,17,0
20,2,42,18,11,7
20,2,43,3,25,-22
20,2,44,6,14,-8
20,2,45,9,15,-6
20,2,46,11,26,-15
20,2,47,5,6,-1
20,2,48,9,13,-4
20,2,49,10,28,-18
20,2,50,12,14,-2
20,2,51,6,16,-10
20,2,52,5,13,-8
20,2,53,10,25,-15
20,2,54,1,13,-12
20,2,55,17,17,0
20,2,56,11,17,-6
20,2,57,7,22,-15
20,2,58,7,12,-5
20,2,59,8,30,-22
20,2,60,8,29,-21
20,2,61,6,16,-10
20,2,62,20,14,6
20,2,63,17,33,-16
20,2,64,14,19,-5
20,2,65,5,8,-3
20,2,66,14,34,-20
20,2,67,10,27,-17
20,2,68,11,13,-2
20,2,69,12,14,-2
20,2,70,8,22,-14
20,2,71,6,23,-17
20,2,72,14,18,-4
20,2,73,3,13,-10
20,2,74,3,20,-17
20,2,75,18,21,-3
20,2,76,5,18,-13
20,2,77,10,21,-11
20,2,78,4,8,-4
20,2,79,8,12,-4
20,2,80,5,12,-7
20,2,81,4,12,-8
20,2,82,11,18,-7
20,2,83,5,19,-14
20,2,84,9,17,-8
20,2,85,4,17,-13
20,2,86,5,3,2
20,2,87,10,15,-5
20,2,88,6,8,-2
20,2,89,2,14,-12
20,2,90,15,16,-1
20,2,91,9,14,-5
20,2,92,3,24,-21
20,2,93,6,14,-8
20,2,94,7,4,3
20,2,95,6,15,-9
20,2,96,11,13,-2
20,2,97,9,13,-4
20,2,98,22,30,-8
20,2,99,5,16,-11
20,2,100,10,17,-7
20,2,101,3,25,-22
20,2,102,8,6,2
20,2,103,11,13,-2
20,2,104,8,17,-9
20,2,105,11,21,-10
20,2,106,8,15,-7
20,2,107,10,9,1
20,2,108,12,14,-2
20,2,109,7,12,-5
20,2,110,11,8,3
20,2,111,12,14,-2
20,2,112,12,24,-12
20,2,113,7,30,-23
20,2,114,12,14,-2
20,2,115,11,25,-14
20,2,116,9,13,-4
20,2,117,5,13,-8
20,2,118,9,12,-3
20,2,119,8,24,-16
20,2,120,4,10,-6
20,2,121,5,7,-2
20,2,122,10,40,-30
20,2,123,6,32,-26
20,2,124,4,16,-12
20,2,125,14,16,-2
20,2,126,15,25,-10
20,2,127,8,33,-25
20,2,128,13,11,2
20,2,129,11,9,2
20,2,130,2,21,-19
20,2,131,7,23,-16
20,2,132,12,24,-12
20,2,133,3,19,-16
20,2,134,4,15,-11
20,2,135,1,17,-16
20,2,136,21,26,-5
20,2,137,15,24,-9
20,2,138,9,27,-18
20,2,139,5,22,-17
20,2,140,8,23,-15
20,2,141,7,19,-12
20,2,142,25,18,7
20,2,143,5,20,-15
20,2,144,11,22,-11
20,2,145,4,13,-9
20,2,146,9,12,-3
20,2,147,5,20,-15
20,2,148,20,25,-5
20,2,149,8,16,-8
20,2,150,18,27,-9
20,2,151,3,20,-17
20,2,152,12,8,4
20,2,153,10,13,-3
20,2,154,17,23,-6
20,2,155,22,13,9
20,2,156,7,16,-9
20,2,157,10,15,-5
20,2,158,4,17,-13
20,2,159,5,9,-4
20,2,160,15,35,-20
20,2,161,9,11,-2
20,2,162,10,16,-6
20,2,163,7,20,-13
20,2,164,6,6,0
20,2,165,14,18,-4
20,2,166,6,13,-7
20,2,167,9,23,-14
20,2,168,4,13,-9
20,2,169,11,14,-3
20,2,170,5,16,-11
20,2,171,8,11,-3
20,2,172,5,17,-12
20,2,173,11,16,-5
20,2,174,16,21,-5
20,2,175,10,17,-7
20,2,176,5,8,-3
20,2,177,6,15,-9
20,2,178,15,13,2
20,2,179,10,30,-20
20,2,180,4,16,-12
20,2,181,6,16,-10
20,2,182,11,17,-6
20,2,183,6,14,-8
20,2,184,10,19,-9
20,2,185,9,18,-9
20,2,186,1,1,0
20,2,187,12,22,-10
20,2,188,13,25,-12
20,2,189,12,13,-1
20,2,190,5,25,-20
20,2,191,9,23,-14
20,2,192,19,20,-1
20,2,193,3,12,-9
20,2,194,6,15,-9
20,2,195,7,9,-2
20,2,196,8,15,-7
20,2,197,12,34,-22
20,2,198,1,14,-13
20,2,199,12,18,-6
20,2,200,6,19,-13
20,2,201,9,21,-12
20,2,202,12,26,-14
20,2,203,11,32,-21
20,2,204,14,12,2
20,2,205,12,21,-9
20,2,206,5,9,-4
20,2,207,22,13,9
20,2,208,9,10,-1
20,2,209,12,23,-11
20,2,210,3,18,-15
20,2,211,10,5,5
20,2,212,2,14,-12
20,2,213,9,28,-19
20,2,214,9,8,1
20,2,215,5,10,-5
20,2,216,10,20,-10
20,2,217,20,31,-11
20,2,218,13,23,-10
20,2,219,16,18,-2
20,2,220,7,14,-7
20,2,221,15,25,-10
20,2,222,6,17,-11
20,2,223,12,14,-2
20,2,224,13,33,-20
20,2,225,14,24,-10
20,2,226,7,12,-5
20,2,227,14,27,-13
20,2,228,7,21,-14
20,2,229,6,12,-6
20,2,230,8,12,-4
20,2,231,10,13,-3
20,2,232,5,13,-8
20,2,233,12,16,-4
20,2,234,17,27,-10
20,2,235,15,12,3
20,2,236,14,13,1
20,2,237,9,10,-1
20,2,238,6,14,-8
20,2,239,4,12,-8
20,2,240,3,19,-16
20,2,241,2,13,-11
20,2,242,12,17,-5
20,2,243,3,17,-14
20,2,244,4,26,-22
20,2,245,14,18,-4
20,2,246,2,9,-7
20,2,247,11,22,-11
20,2,248,15,19,-4
20,2,249,13,30,-17
20,2,250,7,17,-10
20,2,251,15,21,-6
20,2,252,16,26,-10
20,2,253,9,42,-33
20,2,254,9,12,-3
20,2,255,11,21,-10
20,2,256,7,7,0
20,2,257,18,18,0
20,2,258,10,17,-7
20,2,259,11,18,-7
20,2,260,15,10,5
20,2,261,12,5,7
20,2,262,13,19,-6
20,2,263,20,27,-7
20,2,264,2,12,-10
20,2,265,12,19,-7
20,2,266,8,17,-9
20,2,267,12,17,-5
20,2,268,6,23,-17
20,2,269,8,26,-18
20,2,270,10,33,-23
20,2,271,6,13,-7
20,2,272,2,8,-6
20,2,273,6,6,0
20,2,274,5,11,-6
20,2,275,5,11,-6
20,2,276,6,30,-24
20,2,277,9,13,-4
20,2,278,11,19,-8
20,2,279,7,19,-12
20,2,280,6,8,-2
20,2,281,7,3,4
20,2,282,15,29,-14
20,2,283,7,22,-15
20,2,284,8,4,4
20,2,285,12,33,-21
20,2,286,7,18,-11
20,2,287,6,8,-2
20,2,288,9,21,-12
20,2,289,6,15,-9
20,2,290,2,13,-11
20,2,291,8,16,-8
20,2,292,13,29,-16
20,2,293,8,21,-13
20,2,294,5,23,-18
20,2,295,5,21,-16
20,2,296,6,17,-11
20,2,297,4,9,-5
20,2,298,8,20,-12
20,2,299,8,22,-14
20,3,0,9,14,-5
20,3,1,3,4,-1
20,3,2,11,19,-8
20,3,3,14,19,-5
20,3,4,4,14,-10
20,3,5,10,18,-8
20,3,6,6,22,-16
20,3,7,12,19,-7
20,3,8,6,26,-20
20,3,9,10,15,-5
20,3,10,13,15,-2
20,3,11,19,19,0
20,3,12,16,28,-12
20,3,13,14,12,2
20,3,14,18,24,-6
20,3,15,8,19,-11
20,3,16,3,22,-19
20,3,17,13,25,-12
20,3,18,17,19,-2
20,3,19,6,20,-14
20,3,20,10,17,-7
20,3,21,14,16,-2
20,3,22,5,20,-15
20,3,23,9,17,-8
20,3,24,13,24,-11
20,3,25,14,24,-10
20,3,26,8,17,-9
20,3,27,6,14,-8
20,3,28,12,34,-22
20,3,29,9,15,-6
20,3,30,5,16,-11
20,3,31,13,12,1
20,3,32,4,18,-14
20,3,33,15,15,0
20,3,34,7,18,-11
20,3,35,8,27,-19
20,3,36,8,25,-17
20,3,37,11,13,-2
20,3,38,7,15,-8
20,3,39,6,13,-7
20,3,40,8,31,-23
20,3,41,9,20,-11
20,3,42,7,20,-13
20,3,43,9,9,0
20,3,44,12,25,-13
20,3,45,7,26,-19
20,3,46,8,21,-13
20,3,47,12,28,-16
20,3,48,9,14,-5
20,3,49,16,11,5
20,3,50,3,16,-13
20,3,51,6,8,-2
20,3,52,10,33,-23
20,3,53,9,13,-4
20,3,54,13,17,-4
20,3,55,5,17,-12
20,3,56,1,11,-10
20,3,57,11,30,-19
20,3,58,9,14,-5
20,3,59,7,16,-9
20,3,60,8,8,0
20,3,61,6,18,-12
20,3,62,7,2,5
20,3,63,11,39,-28
20,3,64,8,13,-5
20,3,65,5,21,-16
20,3,66,9,36,-27
20,3,67,8,12,-4
20,3,68,8,22,-14
20,3,69,9,20,-11
20,3,70,18,26,-8
20,3,71,4,26,-22
20,3,72,6,14,-8
20,3,73,0,5,-5
20,3,74,1,9,-8
20,3,75,12,23,-11
20,3,76,9,25,-16
20,3,77,12,15,-3
20,3,78,17,22,-5
20,3,79,5,18,-13
20,3,80,7,28,-21
20,3,81,3,20,-17
20,3,82,11,8,3
20,3,83,6,19,-13
20,3,84,17,21,-4
20,3,85,5,16,-11
20,3,86,10,16,-6
20,3,87,9,16,-7
20,3,88,5,14,-9
20,3,89,11,14,-3
20,3,90,4,11,-7
20,3,91,14,15,-1
20,3,92,8,6,2
20,3,93,8,21,-13
20,3,94,8,13,-5
20,3,95,9,17,-8
20,3,96,10,19,-9
20,3,97,13,18,-5
20,3,98,6,12,-6
20,3,99,9,9,0
20,3,100,4,8,-4
20,3,101,0,13,-13
20,3,102,12,16,-4
20,3,103,10,19,-9
20,3,104,5,21,-16
20,3,105,9,15,-6
20,3,106,11,15,-4
20,3,107,8,23,-15
20,3,108,10,27,-17
20,3,109,8,14,-6
20,3,110,14,16,-2
20,3,111,5,5,0
20,3,112,6,2,4
20,3,113,1,16,-15
20,3,114,9,22,-13
20,3,115,12,20,-8
20,3,116,8,19,-11
20,3,117,6,23,-17
20,3,118,10,16,-6
20,3,119,15,12,3
20,3,120,4,24,-20
20,3,121,10,26,-16
20,3,122,18,19,-1
20,3,123,7,19,-12
20,3,124,2,6,-4
20,3,125,16,24,-8
20,3,126,11,17,-6
20,3,127,5,30,-25
20,3,128,6,21,-15
20,3,129,6,9,-3
20,3,130,9,19,-10
20,3,131,5,25,-20
20,3,132,10,18,-8
20,3,133,13,13,0
20,3,134,6,21,-15
20,3,135,3,24,-21
20,3,136,7,14,-7
20,3,137,8,13,-5
20,3,138,19,33,-14
20,3,139,8,15,-7
20,3,140,8,20,-12
20,3,141,14,22,-8
20,3,142,9,12,-3
20,3,143,12,23,-11
20,3,144,11,17,-6
20,3,145,9,22,-13
20,3,146,6,16,-10
20,3,147,6,27,-21
20,3,148,7,12,-5
20,3,149,6,9,-3
20,3,150,13,17,-4
20,3,151,9,11,-2
20,3,152,9,13,-4
20,3,153,12,13,-1
20,3,154,10,19,-9
20,3,155,7,16,-9
20,3,156,9,10,-1
20,3,157,6,9,-3
20,3,158,5,23,-18
20,3,159,13,26,-13
20,3,160,8,26,-18
20,3,161,9,32,-23
20,3,162,10,24,-14
20,3,163,16,30,-14
20,3,164,9,13,-4
20,3,165,8,12,-4
20,3,166,14,7,7
20,3,167,8,20,-12
20,3,168,11,20,-9
20,3,169,16,29,-13
20,3,170,5,15,-10
20,3,171,5,13,-8
20,3,172,7,20,-13
20,3,173,6,12,-6
20,3,174,9,14,-5
20,3,175,10,13,-3
20,3,176,6,27,-21
20,3,177,17,28,-11
20,3,178,11,27,-16
20,3,179,14,35,-21
20,3,180,14,17,-3
20,3,181,10,23,-13
20,3,182,6,18,-12
20,3,183,18,21,-3
20,3,184,10,13,-3
20,3,185,12,28,-16
20,3,186,19,20,-1
20,3,187,11,12,-1
20,3,188,11,15,-4
20,3,189,6,25,-19
20,3,190,5,11,-6
20,3,191,11,27,-16
20,3,192,7,23,-16
20,3,193,12,21,-9
20,3,194,12,25,-13
20,3,195,13,26,-13
20,3,196,18,19,-1
20,3,197,7,15,-8
20,3,198,10,17,-7
20,3,199,17,21,-4
20,3,200,10,10,0
20,3,201,13,25,-12
20,3,202,13,20,-7
20,3,203,5,26,-21
20,3,204,6,14,-8
20,3,205,18,15,3
20,3,206,7,20,-13
20,3,207,12,18,-6
20,3,208,7,16,-9
20,3,209,13,21,-8
20,3,210,6,9,-3
20,3,211,8,22,-14
20,3,212,7,18,-11
20,3,213,10,14,-4
20,3,214,5,27,-22
20,3,215,6,24,-18
20,3,216,14,20,-6
20,3,217,10,22,-12
20,3,218,7,21,-14
20,3,219,9,23,-14
20,3,220,5,6,-1
20,3,221,8,28,-20
20,3,222,4,14,-10
20,3,223,10,24,-14
20,3,224,6,13,-7
20,3,225,6,13,-7
20,3,226,9,21,-12
20,3,227,6,16,-10
20,3,228,13,20,-7
20,3,229,4,14,-10
20,3,230,2,15,-13
20,3,231,8,30,-22
20,3,232,12,22,-10
20,3,233,14,32,-18
20,3,234,22,38,-16
20,3,235,8,20,-12
20,3,236,10,11,-1
20,3,237,9,24,-15
20,3,238,8,13,-5
20,3,239,11,11,0
20,3,240,15,21,-6
20,3,241,9,16,-7
20,3,242,15,14,1
20,3,243,23,43,-20
20,3,244,7,13,-6
20,3,245,9,14,-5
20,3,246,15,24,-9
20,3,247,14,7,7
20,3,248,7,10,-3
20,3,249,10,18,-8
20,3,250,11,31,-20
20,3,251,8,27,-19
20,3,252,17,19,-2
20,3,253,10,24,-14
20,3,254,8,9,-1
20,3,255,4,15,-11
20,3,256,13,25,-12
20,3,257,6,18,-12
20,3,258,10,21,-11
20,3,259,9,15,-6
20,3,260,16,18,-2
20,3,261,3,11,-8
20,3,262,10,23,-13
20,3,263,7,16,-9
20,3,264,12,21,-9
20,3,265,5,14,-9
20,3,266,9,13,-4
20,3,267,3,20,-17
20,3,268,11,16,-5
20,3,269,3,15,-12
20,3,270,10,16,-6
20,3,271,14,18,-4
20,3,272,18,21,-3
20,3,273,9,22,-13
20,3,274,8,16,-8
20,3,275,6,15,-9
20,3,276,9,21,-12
20,3,277,8,11,-3
20,3,278,3,22,-19
20,3,279,10,22,-12
20,3,280,12,18,-6
20,3,281,11,5,6
20,3,282,6,17,-11
20,3,283,11,14,-3
20,3,284,6,20,-14
20,3,285,10,16,-6
20,3,286,12,37,-25
20,3,287,8,17,-9
20,3,288,6,23,-17
20,3,289,3,8,-5
20,3,290,12,33,-21
20,3,291,7,15,-8
20,3,292,8,14,-6
20,3,293,11,13,-2
20,3,294,9,17,-8
20,3,295,16,25,-9
20,3,296,6,32,-26
20,3,297,12,25,-13
20,3,298,6,28,-22
20,3,299,8,10,-2
20,4,0,14,19,-5
20,4,1,11,9,2
20,4,2,11,22,-11
20,4,3,17,33,-16
20,4,4,13,23,-10
20,4,5,4,14,-10
20,4,6,11,33,-22
20,4,7,11,15,-4
20,4,8,5,11,-6
20,4,9,7,16,-9
20,4,10,6,31,-25
20,4,11,5,17,-12
20,4,12,8,13,-5
20,4,13,10,25,-15
20,4,14,3,13,-10
20,4,15,8,13,-5
20,4,16,10,9,1
20,4,17,13,17,-4
20,4,18,21,21,0
20,4,19,13,16,-3
20,4,20,7,24,-17
20,4,21,6,13,-7
20,4,22,12,16,-4
20,4,23,10,23,-13
20,4,24,8,17,-9
20,4,25,20,29,-9
20,4,26,11,22,-11
20,4,27,11,20,-9
20,4,28,10,9,1
20,4,29,9,19,-10
20,4,30,12,12,0
20,4,31,11,18,-7
20,4,32,13,22,-9
20,4,33,7,21,-14
20,4,34,5,26,-21
20,4,35,21,30,-9
20,4,36,15,18,-3
20,4,37,5,8,-3
20,4,38,14,37,-23
20,4,39,15,15,0
20,4,40,12,17,-5
20,4,41,9,13,-4
20,4,42,7,16,-9
20,4,43,5,10,-5
20,4,44,9,17,-8
20,4,45,14,20,-6
20,4,46,5,15,-10
20,4,47,10,14,-4
20,4,48,1,10,-9
20,4,49,14,20,-6
20,4,50,3,12,-9
20,4,51,16,19,-3
20,4,52,10,25,-15
20,4,53,5,18,-13
20,4,54,8,34,-26
20,4,55,11,19,-8
20,4,56,5,20,-15
20,4,57,8,22,-14
20,4,58,15,28,-13
20,4,59,3,14,-11
20,4,60,6,24,-18
20,4,61,4,20,-16
20,4,62,11,20,-9
20,4,63,10,7,3
20,4,64,12,21,-9
20,4,65,11,23,-12
20,4,66,8,15,-7
20,4,67,22,16,6
20,4,68,21,20,1
20,4,69,8,6,2
20,4,70,10,18,-8
20,4,71,17,27,-10
20,4,72,7,11,-4
20,4,73,18,17,1
20,4,74,5,21,-16
20,4,75,9,11,-2
20,4,76,7,18,-11
20,4,77,10,20,-10
20,4,78,13,24,-11
20,4,79,11,20,-9
20,4,80,8,44,-36
20,4,81,7,15,-8
20,4,82,15,27,-12
20,4,83,9,13,-4
20,4,84,4,11,-7
20,4,85,2,12,-10
20,4,86,8,9,-1
20,4,87,9,16,-7
20,4,88,1,17,-16
20,4,89,12,24,-12
20,4,90,10,20,-10
20,4,91,10,36,-26
20,4,92,15,20,-5
20,4,93,18,25,-7
20,4,94,2,7,-5
20,4,95,8,18,-10
20,4,96,12,26,-14
20,4,97,9,28,-19
20,4,98,6,13,-7
20,4,99,17,23,-6
20,4,100,11,13,-2
20,4,101,13,19,-6
20,4,102,12,17,-5
20,4,103,14,10,4
20,4,104,8,22,-14
20,4,105,11,37,-26
20,4,106,14,12,2
20,4,107,2,18,-16
20,4,108,12,31,-19
20,4,109,12,20,-8
20,4,110,12,27,-15
20,4,111,6,7,-1
20,4,112,13,18,-5
20,4,113,10,22,-12
20,4,114,6,10,-4
20,4,115,7,22,-15
20,4,116,5,13,-8
20,4,117,20,15,5
20,4,118,14,22,-8
20,4,119,4,38,-34
20,4,120,13,20,-7
20,4,121,7,5,2
20,4,122,7,10,-3
20,4,123,10,15,-5
20,4,124,9,24,-15
20,4,125,8,32,-24
20,4,126,10,17,-7
20,4,127,9,31,-22
20,4,128,11,9,2
20,4,129,10,17,-7
20,4,130,9,35,-26
20,4,131,7,12,-5
20,4,132,16,13,3
20,4,133,8,15,-7
20,4,134,14,17,-3
20,4,135,9,22,-13
20,4,136,8,20,-12
20,4,137,19,24,-5
20,4,138,5,18,-13
20,4,139,7,22,-15
20,4,140,3,19,-16
20,4,141,9,36,-27
20,4,142,5,16,-11
20,4,143,9,11,-2
20,4,144,10,23,-13
20,4,145,11,20,-9
20,4,146,6,22,-16
20,4,147,11,22,-11
20,4,148,4,16,-12
20,4,149,20,26,-6
20,4,150,7,19,-12
20,4,151,10,22,-12
20,4,152,4,27,-23
20,4,153,11,11,0
20,4,154,7,17,-10
20,4,155,5,6,-1
20,4,156,7,28,-21
20,4,157,8,25,-17
20,4,158,8,14,-6
20,4,159,16,15,1
20,4,160,14,19,-5
20,4,161,9,33,-24
20,4,162,25,32,-7
20,4,163,8,11,-3
20,4,164,15,12,3
20,4,165,10,17,-7
20,4,166,8,12,-4
20,4,167,11,14,-3
20,4,168,16,21,-5
20,4,169,16,24,-8
20,4,170,11,16,-5
20,4,171,7,16,-9
20,4,172,4,10,-6
20,4,173,15,27,-12
20,4,174,4,12,-8
20,4,175,14,25,-11
20,4,176,11,19,-8
20,4,177,6,23,-17
20,4,178,2,7,-5
20,4,179,6,20,-14
20,4,180,11,21,-10
20,4,181,19,20,-1
20,4,182,15,24,-9
20,4,183,7,14,-7
20,4,184,16,24,-8
20,4,185,9,24,-15
20,4,186,11,32,-21
20,4,187,11,21,-10
20,4,188,13,32,-19
20,4,189,9,11,-2
20,4,190,14,23,-9
20,4,191,13,15,-2
20,4,192,9,19,-10
20,4,193,13,25,-12
20,4,194,12,22,-10
20,4,195,6,11,-5
20,4,196,11,20,-9
20,4,197,7,21,-14
20,4,198,11,18,-7
20,4,199,3,13,-10
20,4,200,18,25,-7
20,4,201,11,15,-4
20,4,202,14,11,3
20,4,203,12,21,-9
20,4,204,12,30,-18
20,4,205,1,6,-5
20,4,206,3,7,-4
20,4,207,6,9,-3
20,4,208,8,22,-14
20,4,209,29,13,16
20,4,210,9,8,1
20,4,211,4,18,-14
20,4,212,20,25,-5
20,4,213,9,14,-5
20,4,214,12,7,5
20,4,215,13,21,-8
20,4,216,7,6,1
20,4,217,7,12,-5
20,4,218,8,26,-18
20,4,219,5,10,-5
20,4,220,2,14,-12
20,4,221,13,22,-9
20,4,222,3,27,-24
20,4,223,6,16,-10
20,4,224,5,15,-10
20,4,225,12,23,-11
20,4,226,5,20,-15
20,4,227,19,18,1
20,4,228,7,26,-19
20,4,229,4,22,-18
20,4,230,15,28,-13
20,4,231,2,15,-13
20,4,232,12,25,-13
20,4,233,11,19,-8
20,4,234,8,17,-9
20,4,235,6,16,-10
20,4,236,10,20,-10
20,4,237,11,22,-11
20,4,238,9,13,-4
20,4,239,11,17,-6
20,4,240,8,21,-13
20,4,241,15,13,2
20,4,242,11,17,-6
20,4,243,9,13,-4
20,4,244,5,10,-5
20,4,245,3,14,-11
20,4,246,6,10,-4
20,4,247,15,13,2
20,4,248,10,21,-11
20,4,249,17,20,-3
20,4,250,11,19,-8
20,4,251,10,32,-22
20,4,252,9,21,-12
20,4,253,5,12,-7
20,4,254,13,24,-11
20,4,255,10,9,1
20,4,256,8,14,-6
20,4,257,12,13,-1
20,4,258,9,15,-6
20,4,259,15,19,-4
20,4,260,15,16,-1
20,4,261,14,17,-3
20,4,262,7,28,-21
20,4,263,8,7,1
20,4,264,14,11,3
20,4,265,21,19,2
20,4,266,6,11,-5
20,4,267,11,9,2
20,4,268,14,27,-13
20,4,269,6,7,-1
20,4,270,22,36,-14
20,4,271,10,17,-7
20,4,272,7,21,-14
20,4,273,12,12,0
20,4,274,3,12,-9
20,4,275,11,12,-1
20,4,276,6,23,-17
20,4,277,20,28,-8
20,4,278,13,27,-14
20,4,279,12,17,-5
20,4,280,9,17,-8
20,4,281,8,14,-6
20,4,282,16,16,0
20,4,283,4,26,-22
20,4,284,10,16,-6
20,4,285,10,13,-3
20,4,286,6,23,-17
20,4,287,5,13,-8
20,4,288,8,10,-2
20,4,289,7,17,-10
20,4,290,6,21,-15
20,4,291,15,16,-1
20,4,292,16,23,-7
20,4,293,16,30,-14
20,4,294,10,21,-11
20,4,295,6,16,-10
20,4,296,6,21,-15
20,4,297,23,33,-10
20,4,298,9,24,-15
20,4,299,11,16,-5
20,5,0,9,21,-12
20,5,1,6,20,-14
20,5,2,7,25,-18
20,5,3,12,41,-29
20,5,4,10,24,-14
20,5,5,8,17,-9
20,5,6,11,14,-3
20,5,7,9,15,-6
20,5,8,9,18,-9
20,5,9,10,28,-18
20,5,10,19,28,-9
20,5,11,11,18,-7
20,5,12,25,31,-6
20,5,13,14,37,-23
20,5,14,14,17,-3
20,5,15,13,21,-8
20,5,16,20,12,8
20,5,17,21,27,-6
20,5,18,11,18,-7
20,5,19,10,13,-3
20,5,20,15,14,1
20,5,21,3,9,-6
20,5,22,13,22,-9
20,5,23,17,16,1
20,5,24,9,26,-17
20,5,25,9,19,-10
20,5,26,8,13,-5
20,5,27,6,15,-9
20,5,28,9,12,-3
20,5,29,11,14,-3
20,5,30,8,16,-8
20,5,31,16,27,-11
20,5,32,8,17,-9
20,5,33,7,18,-11
20,5,34,8,24,-16
20,5,35,18,28,-10
20,5,36,11,11,0
20,5,37,7,12,-5
20,5,38,12,14,-2
20,5,39,5,12,-7
20,5,40,15,19,-4
20,5,41,10,16,-6
20,5,42,0,19,-19
20,5,43,18,21,-3
20,5,44,12,18,-6
20,5,45,7,22,-15
20,5,46,6,27,-21
20,5,47,14,25,-11
20,5,48,9,16,-7
20,5,49,4,14,-10
20,5,50,6,12,-6
20,5,51,13,23,-10
20,5,52,23,32,-9
20,5,53,8,11,-3
20,5,54,12,6,6
20,5,55,11,29,-18
20,5,56,5,25,-20
20,5,57,19,32,-13
20,5,58,17,23,-6
20,5,59,5,30,-25
20,5,60,28,30,-2
20,5,61,11,13,-2
20,5,62,17,31,-14
20,5,63,9,11,-2
20,5,64,12,29,-17
20,5,65,12,31,-19
20,5,66,13,38,-25
20,5,67,7,26,-19
20,5,68,15,18,-3
20,5,69,12,12,0
20,5,70,12,20,-8
20,5,71,10,29,-19
20,5,72,17,7,10
20,5,73,16,20,-4
20,5,74,16,16,0
20,5,75,7,25,-18
20,5,76,7,23,-16
20,5,77,6,20,-14
20,5,78,4,22,-18
20,5,79,15,15,0
20,5,80,20,9,11
20,5,81,3,13,-10
20,5,82,8,31,-23
20,5,83,14,20,-6
20,5,84,7,26,-19
20,5,85,14,16,-2
20,5,86,8,11,-3
20,5,87,5,11,-6
20,5,88,8,27,-19
20,5,89,13,14,-1
20,5,90,4,21,-17
20,5,91,14,28,-14
20,5,92,21,28,-7
20,5,93,8,15,-7
20,5,94,17,18,-1
20,5,95,14,10,4
20,5,96,7,27,-20
20,5,97,13,24,-11
20,5,98,7,17,-10
20,5,99,6,8,-2
20,5,100,10,19,-9
20,5,101,6,8,-2
20,5,102,13,26,-13
20,5,103,15,15,0
20,5,104,9,23,-14
20,5,105,20,26,-6
20,5,106,7,14,-7
20,5,107,12,26,-14
20,5,108,10,31,-21
20,5,109,6,21,-15
20,5,110,3,14,-11
20,5,111,3,10,-7
20,5,112,8,18,-10
20,5,113,12,23,-11
20,5,114,14,19,-5
20,5,115,12,11,1
20,5,116,13,12,1
20,5,117,14,35,-21
20,5,118,11,16,-5
20,5,119,11,32,-21
20,5,120,13,34,-21
20,5,121,6,20,-14
20,5,122,13,37,-24
20,5,123,8,20,-12
20,5,124,17,28,-11
20,5,125,9,11,-2
20,5,126,11,20,-9
20,5,127,17,39,-22
20,5,128,12,23,-11
20,5,129,12,27,-15
20,5,130,7,18,-11
20,5,131,25,25,0
20,5,132,29,29,0
20,5,133,6,17,-11
20,5,134,12,14,-2
20,5,135,12,28,-16
20,5,136,17,17,0
20,5,137,6,17,-11
20,5,138,10,30,-20
20,5,139,19,19,0
20,5,140,11,21,-10
20,5,141,8,24,-16
20,5,142,7,30,-23
20,5,143,9,19,-10
20,5,144,6,17,-11
20,5,145,11,16,-5
20,5,146,15,20,-5
20,5,147,8,45,-37
20,5,148,10,31,-21
20,5,149,11,34,-23
20,5,150,6,17,-11
20,5,151,14,19,-5
20,5,152,8,26,-18
20,5,153,14,34,-20
20,5,154,13,37,-24
20,5,155,8,11,-3
20,5,156,14,12,2
20,5,157,9,19,-10
20,5,158,21,27,-6
20,5,159,11,23,-12
20,5,160,17,25,-8
20,5,161,18,24,-6
20,5,162,12,26,-14
20,5,163,2,17,-15
20,5,164,6,18,-12
20,5,165,8,20,-12
20,5,166,29,30,-1
20,5,167,14,33,-19
20,5,168,14,17,-3
20,5,169,4,18,-14
20,5,170,7,17,-10
20,5,171,10,17,-7
20,5,172,7,11,-4
20,5,173,6,11,-5
20,5,174,9,5,4
20,5,175,11,31,-20
20,5,176,17,19,-2
20,5,177,11,14,-3
20,5,178,12,38,-26
20,5,179,6,22,-16
20,5,180,4,18,-14
20,5,181,8,15,-7
20,5,182,9,21,-12
20,5,183,2,26,-24
20,5,184,10,9,1
20,5,185,10,21,-11
20,5,186,11,24,-13
20,5,187,14,24,-10
20,5,188,15,13,2
20,5,189,12,11,1
20,5,190,10,22,-12
20,5,191,5,20,-15
20,5,192,12,27,-15
20,5,193,9,18,-9
20,5,194,16,29,-13
20,5,195,15,30,-15
20,5,196,6,15,-9
20,5,197,13,20,-7
20,5,198,9,11,-2
20,5,199,4,14,-10
20,5,200,8,23,-15
20,5,201,12,13,-1
20,5,202,11,19,-8
20,5,203,12,25,-13
20,5,204,7,17,-10
20,5,205,9,16,-7
20,5,206,8,31,-23
20,5,207,8,13,-5
20,5,208,6,21,-15
20,5,209,17,7,10
20,5,210,9,28,-19
20,5,211,0,6,-6
20,5,212,18,21,-3
20,5,213,19,35,-16
20,5,214,8,19,-11
20,5,215,10,19,-9
20,5,216,16,34,-18
20,5,217,21,18,3
20,5,218,9,15,-6
20,5,219,18,23,-5
20,5,220,4,14,-10
20,5,221,5,21,-16
20,5,222,6,20,-14
20,5,223,14,28,-14
20,5,224,5,14,-9
20,5,225,9,14,-5
20,5,226,4,10,-6
20,5,227,13,19,-6
20,5,228,13,23,-10
20,5,229,12,17,-5
20,5,230,16,16,0
20,5,231,5,23,-18
20,5,232,5,15,-10
20,5,233,9,13,-4
20,5,234,15,24,-9
20,5,235,14,24,-10
20,5,236,6,15,-9
20,5,237,19,19,0
20,5,238,5,21,-16
20,5,239,12,15,-3
20,5,240,23,22,1
20,5,241,13,25,-12
20,5,242,0,13,-13
20,5,243,7,16,-9
20,5,244,20,9,11
20,5,245,8,18,-10
20,5,246,10,22,-12
20,5,247,13,14,-1
20,5,248,6,19,-13
20,5,249,20,31,-11
20,5,250,9,21,-12
20,5,251,4,17,-13
20,5,252,13,19,-6
20,5,253,18,22,-4
20,5,254,9,24,-15
20,5,255,7,10,-3
20,5,256,9,33,-24
20,5,257,7,8,-1
20,5,258,10,20,-10
20,5,259,2,3,-1
20,5,260,7,26,-19
20,5,261,20,30,-10
20,5,262,9,27,-18
20,5,263,5,26,-21
20,5,264,7,24,-17
20,5,265,12,13,-1
20,5,266,11,25,-14
20,5,267,18,28,-10
20,5,268,4,9,-5
20,5,269,6,21,-15
20,5,270,10,18,-8
20,5,271,5,17,-12
20,5,272,6,7,-1
20,5,273,9,12,-3
20,5,274,17,23,-6
20,5,275,9,25,-16
20,5,276,5,17,-12
20,5,277,14,19,-5
20,5,278,10,14,-4
20,5,279,13,48,-35
20,5,280,15,26,-11
20,5,281,13,16,-3
20,5,282,18,24,-6
20,5,283,10,14,-4
20,5,284,10,28,-18
20,5,285,7,12,-5
20,5,286,5,9,-4
20,5,287,7,12,-5
20,5,288,11,10,1
20,5,289,12,31,-19
20,5,290,6,22,-16
20,5,291,16,27,-11
20,5,292,7,18,-11
20,5,293,3,23,-20
20,5,294,10,32,-22
20,5,295,3,21,-18
20,5,296,13,25,-12
20,5,297,18,21,-3
20,5,298,11,14,-3
20,5,299,10,17,-7
20,6,0,8,22,-14
20,6,1,21,13,8
20,6,2,16,23,-7
20,6,3,8,22,-14
20,6,4,15,19,-4
20,6,5,16,23,-7
20,6,6,17,24,-7
20,6,7,5,10,-5
20,6,8,16,31,-15
20,6,9,10,11,-1
20,6,10,6,25,-19
20,6,11,4,13,-9
20,6,12,1,19,-18
20,6,13,7,23,-16
20,6,14,19,24,-5
20,6,15,14,23,-9
20,6,16,13,25,-12
20,6,17,15,18,-3
20,6,18,15,15,0
20,6,19,10,13,-3
20,6,20,13,37,-24
20,6,21,14,25,-11
20,6,22,15,21,-6
20,6,23,7,30,-23
20,6,24,6,26,-20
20,6,25,14,26,-12
20,6,26,12,13,-1
20,6,27,12,32,-20
20,6,28,10,18,-8
20,6,29,15,20,-5
20,6,30,17,21,-4
20,6,31,12,22,-10
20,6,32,5,26,-21
20,6,33,11,5,6
20,6,34,9,15,-6
20,6,35,11,21,-10
20,6,36,17,19,-2
20,6,37,15,26,-11
20,6,38,9,26,-17
20,6,39,12,17,-5
20,6,40,12,25,-13
20,6,41,9,24,-15
20,6,42,8,17,-9
20,6,43,9,11,-2
20,6,44,10,26,-16
20,6,45,5,6,-1
20,6,46,19,25,-6
20,6,47,9,10,-1
20,6,48,4,10,-6
20,6,49,8,20,-12
20,6,50,28,25,3
20,6,51,21,22,-1
20,6,52,9,22,-13
20,6,53,15,18,-3
20,6,54,16,16,0
20,6,55,13,24,-11
20,6,56,13,20,-7
20,6,57,13,21,-8
20,6,58,12,22,-10
20,6,59,7,25,-18
20,6,60,9,17,-8
20,6,61,6,8,-2
20,6,62,14,25,-11
20,6,63,11,18,-7
20,6,64,8,12,-4
20,6,65,11,28,-17
20,6,66,14,23,-9
20,6,67,12,11,1
20,6,68,8,37,-29
20,6,69,17,23,-6
20,6,70,14,8,6
20,6,71,6,19,-13
20,6,72,10,17,-7
20,6,73,19,24,-5
20,6,74,10,12,-2
20,6,75,13,25,-12
20,6,76,4,17,-13
20,6,77,10,13,-3
20,6,78,22,41,-19
20,6,79,5,26,-21
20,6,80,17,23,-6
20,6,81,12,23,-11
20,6,82,9,17,-8
20,6,83,12,19,-7
20,6,84,4,21,-17
20,6,85,15,18,-3
20,6,86,5,15,-10
20,6,87,15,22,-7
20,6,88,9,28,-19
20,6,89,8,21,-13
20,6,90,19,17,2
20,6,91,15,21,-6
20,6,92,4,20,-16
20,6,93,14,14,0
20,6,94,10,33,-23
20,6,95,13,19,-6
20,6,96,8,19,-11
20,6,97,21,29,-8
20,6,98,10,13,-3
20,6,99,21,17,4
20,6,100,6,21,-15
20,6,101,13,15,-2
20,6,102,14,9,5
20,6,103,13,9,4
20,6,104,11,20,-9
20,6,105,10,17,-7
20,6,106,15,26,-11
20,6,107,13,13,0
20,6,108,12,21,-9
20,6,109,21,15,6
20,6,110,14,31,-17
20,6,111,16,21,-5
20,6,112,6,14,-8
20,6,113,12,23,-11
20,6,114,10,16,-6
20,6,115,6,27,-21
20,6,116,16,23,-7
20,6,117,8,11,-3
20,6,118,14,23,-9
20,6,119,9,38,-29
20,6,120,4,31,-27
20,6,121,25,27,-2
20,6,122,14,15,-1
20,6,123,7,20,-13
20,6,124,8,18,-10
20,6,125,13,27,-14
20,6,126,7,14,-7
20,6,127,15,28,-13
20,6,128,8,18,-10
20,6,129,11,18,-7
20,6,130,8,9,-1
20,6,131,12,20,-8
20,6,132,3,12,-9
20,6,133,10,22,-12
20,6,134,8,20,-12
20,6,135,3,8,-5
20,6,136,14,22,-8
20,6,137,9,23,-14
20,6,138,17,15,2
20,6,139,8,22,-14
20,6,140,7,10,-3
20,6,141,10,17,-7
20,6,142,12,13,-1
20,6,143,13,14,-1
20,6,144,9,15,-6
20,6,145,11,7,4
20,6,146,26,29,-3
20,6,147,22,22,0
20,6,148,6,15,-9
20,6,149,11,20,-9
20,6,150,14,17,-3
20,6,151,11,19,-8
20,6,152,20,29,-9
20,6,153,17,24,-7
20,6,154,7,23,-16
20,6,155,8,18,-10
20,6,156,7,15,-8
20,6,157,17,22,-5
20,6,158,21,25,-4
20,6,159,13,13,0
20,6,160,16,18,-2
20,6,161,10,23,-13
20,6,162,9,16,-7
20,6,163,5,23,-18
20,6,164,8,20,-12
20,6,165,21,18,3
20,6,166,19,11,8
20,6,167,3,16,-13
20,6,168,10,40,-30
20,6,169,15,20,-5
20,6,170,23,38,-15
20,6,171,12,22,-10
20,6,172,10,18,-8
20,6,173,13,23,-10
20,6,174,9,15,-6
20,6,175,10,13,-3
20,6,176,6,21,-15
20,6,177,8,22,-14
20,6,178,14,17,-3
20,6,179,21,29,-8
20,6,180,19,22,-3
20,6,181,19,11,8
20,6,182,8,20,-12
20,6,183,2,11,-9
20,6,184,7,26,-19
20,6,185,10,27,-17
20,6,186,13,23,-10
20,6,187,4,14,-10
20,6,188,13,23,-10
20,6,189,15,15,0
20,6,190,12,26,-14
20,6,191,6,25,-19
20,6,192,16,21,-5
20,6,193,12,21,-9
20,6,194,9,12,-3
20,6,195,19,26,-7
20,6,196,1,9,-8
20,6,197,10,30,-20
20,6,198,4,22,-18
20,6,199,5,25,-20
20,6,200,10,19,-9
20,6,201,10,27,-17
20,6,202,16,15,1
20,6,203,5,10,-5
20,6,204,3,26,-23
20,6,205,5,17,-12
20,6,206,4,24,-20
20,6,207,12,36,-24
20,6,208,8,20,-12
20,6,209,15,24,-9
20,6,210,5,18,-13
20,6,211,11,15,-4
20,6,212,11,8,3
20,6,213,11,13,-2
20,6,214,6,25,-19
20,6,215,9,10,-1
20,6,216,10,25,-15
20,6,217,7,12,-5
20,6,218,10,11,-1
20,6,219,25,45,-20
20,6,220,21,36,-15
20,6,221,13,21,-8
20,6,222,6,27,-21
20,6,223,9,17,-8
20,6,224,13,29,-16
20,6,225,19,15,4
20,6,226,18,21,-3
20,6,227,9,22,-13
20,6,228,14,24,-10
20,6,229,11,18,-7
20,6,230,24,16,8
20,6,231,6,20,-14
20,6,232,10,13,-3
20,6,233,15,28,-13
20,6,234,13,16,-3
20,6,235,10,20,-10
20,6,236,5,20,-15
20,6,237,10,28,-18
20,6,238,13,9,4
20,6,239,11,18,-7
20,6,240,11,25,-14
20,6,241,15,15,0
20,6,242,9,15,-6
20,6,243,5,12,-7
20,6,244,10,31,-21
20,6,245,8,11,-3
20,6,246,10,13,-3
20,6,247,18,30,-12
20,6,248,10,6,4
20,6,249,19,16,3
20,6,250,10,18,-8
20,6,251,12,25,-13
20,6,252,12,16,-4
20,6,253,14,25,-11
20,6,254,4,16,-12
20,6,255,8,15,-7
20,6,256,11,19,-8
20,6,257,10,24,-14
20,6,258,7,17,-10
20,6,259,10,16,-6
20,6,260,7,11,-4
20,6,261,16,15,1
20,6,262,7,32,-25
20,6,263,4,28,-24
20,6,264,3,20,-17
20,6,265,7,15,-8
20,6,266,15,27,-12
20,6,267,18,15,3
20,6,268,8,18,-10
20,6,269,10,7,3
20,6,270,7,17,-10
20,6,271,15,32,-17
20,6,272,15,17,-2
20,6,273,7,8,-1
20,6,274,15,23,-8
20,6,275,6,18,-12
20,6,276,11,11,0
20,6,277,14,13,1
20,6,278,13,25,-12
20,6,279,16,18,-2
20,6,280,14,18,-4
20,6,281,8,22,-14
20,6,282,28,16,12
20,6,283,9,32,-23
20,6,284,8,7,1
20,6,285,11,14,-3
20,6,286,16,30,-14
20,6,287,17,25,-8
20,6,288,18,15,3
20,6,289,4,16,-12
20,6,290,13,16,-3
20,6,291,14,22,-8
20,6,292,19,20,-1
20,6,293,6,18,-12
20,6,294,4,25,-21
20,6,295,10,17,-7
20,6,296,13,12,1
20,6,297,9,16,-7
20,6,298,15,26,-11
20,6,299,9,24,-15
20,7,0,5,10,-5
20,7,1,6,15,-9
20,7,2,14,25,-11
20,7,3,14,10,4
20,7,4,33,29,4
20,7,5,12,37,-25
20,7,6,25,32,-7
20,7,7,14,20,-6
20,7,8,9,25,-16
20,7,9,11,17,-6
20,7,10,3,14,-11
20,7,11,11,9,2
20,7,12,20,24,-4
20,7,13,13,9,4
20,7,14,9,18,-9
20,7,15,13,25,-12
20,7,16,14,17,-3
20,7,17,20,16,4
20,7,18,10,5,5
20,7,19,20,34,-14
20,7,20,15,20,-5
20,7,21,24,36,-12
20,7,22,23,19,4
20,7,23,14,21,-7
20,7,24,8,22,-14
20,7,25,5,22,-17
20,7,26,12,15,-3
20,7,27,12,25,-13
20,7,28,7,14,-7
20,7,29,7,17,-10
20,7,30,14,24,-10
20,7,31,11,9,2
20,7,32,18,13,5
20,7,33,8,23,-15
20,7,34,17,22,-5
20,7,35,11,18,-7
20,7,36,14,27,-13
20,7,37,16,18,-2
20,7,38,11,15,-4
20,7,39,14,17,-3
20,7,40,11,29,-18
20,7,41,4,15,-11
20,7,42,9,10,-1
20,7,43,6,17,-11
20,7,44,16,20,-4
20,7,45,8,14,-6
20,7,46,9,25,-16
20,7,47,7,18,-11
20,7,48,16,30,-14
20,7,49,12,18,-6
20,7,50,31,17,14
20,7,51,14,10,4
20,7,52,12,12,0
20,7,53,0,5,-5
20,7,54,11,23,-12
20,7,55,12,17,-5
20,7,56,11,20,-9
20,7,57,16,9,7
20,7,58,15,12,3
20,7,59,9,16,-7
20,7,60,18,14,4
20,7,61,18,33,-15
20,7,62,17,33,-16
20,7,63,9,29,-20
20,7,64,25,16,9
20,7,65,9,10,-1
20,7,66,15,9,6
20,7,67,3,7,-4
20,7,68,12,31,-19
20,7,69,10,32,-22
20,7,70,17,23,-6
20,7,71,11,35,-24
20,7,72,13,7,6
20,7,73,9,37,-28
20,7,74,8,10,-2
20,7,75,12,29,-17
20,7,76,9,37,-28
20,7,77,11,12,-1
20,7,78,22,22,0
20,7,79,22,30,-8
20,7,80,8,30,-22
20,7,81,10,22,-12
20,7,82,9,24,-15
20,7,83,12,26,-14
20,7,84,13,23,-10
20,7,85,11,8,3
20,7,86,7,29,-22
20,7,87,4,24,-20
20,7,88,5,24,-19
20,7,89,12,25,-13
20,7,90,1,11,-10
20,7,91,10,20,-10
20,7,92,16,23,-7
20,7,93,12,18,-6
20,7,94,19,20,-1
20,7,95,15,15,0
20,7,96,10,6,4
20,7,97,10,18,-8
20,7,98,15,32,-17
20,7,99,17,36,-19
20,7,100,19,32,-13
20,7,101,20,21,-1
20,7,102,14,18,-4
20,7,103,14,17,-3
20,7,104,17,30,-13
20,7,105,6,5,1
20,7,106,17,21,-4
20,7,107,5,8,-3
20,7,108,10,16,-6
20,7,109,8,19,-11
20,7,110,13,18,-5
20,7,111,7,5,2
20,7,112,19,26,-7
20,7,113,13,11,2
20,7,114,17,27,-10
20,7,115,18,25,-7
20,7,116,11,12,-1
20,7,117,8,18,-10
20,7,118,7,11,-4
20,7,119,18,26,-8
20,7,120,10,24,-14
20,7,121,16,16,0
20,7,122,13,34,-21
20,7,123,17,20,-3
20,7,124,7,18,-11
20,7,125,6,3,3
20,7,126,11,14,-3
20,7,127,15,16,-1
20,7,128,5,19,-14
20,7,129,11,28,-17
20,7,130,12,19,-7
20,7,131,17,29,-12
20,7,132,24,39,-15
20,7,133,18,23,-5
20,7,134,5,14,-9
20,7,135,11,21,-10
20,7,136,6,26,-20
20,7,137,8,29,-21
20,7,138,22,28,-6
20,7,139,7,15,-8
20,7,140,10,10,0
20,7,141,11,23,-12
20,7,142,6,20,-14
20,7,143,15,26,-11
20,7,144,19,16,3
20,7,145,9,16,-7
20,7,146,14,14,0
20,7,147,24,15,9
20,7,148,15,30,-15
20,7,149,17,32,-15
20,7,150,16,26,-10
20,7,151,13,24,-11
20,7,152,13,8,5
20,7,153,16,27,-11
20,7,154,14,25,-11
20,7,155,29,14,15
20,7,156,11,31,-20
20,7,157,10,15,-5
20,7,158,17,17,0
20,7,159,7,19,-12
20,7,160,7,12,-5
20,7,161,15,14,1
20,7,162,18,36,-18
20,7,163,14,16,-2
20,7,164,14,23,-9
20,7,165,8,20,-12
20,7,166,4,11,-7
20,7,167,19,22,-3
20,7,168,13,16,-3
20,7,169,11,15,-4
20,7,170,14,39,-25
20,7,171,10,12,-2
20,7,172,13,19,-6
20,7,173,3,23,-20
20,7,174,9,5,4
20,7,175,7,13,-6
20,7,176,8,12,-4
20,7,177,15,32,-17
20,7,178,20,17,3
20,7,179,8,20,-12
20,7,180,14,33,-19
20,7,181,4,28,-24
20,7,182,6,14,-8
20,7,183,8,15,-7
20,7,184,6,22,-16
20,7,185,10,19,-9
20,7,186,14,30,-16
20,7,187,9,28,-19
20,7,188,5,23,-18
20,7,189,6,22,-16
20,7,190,9,29,-20
20,7,191,16,35,-19
20,7,192,17,9,8
20,7,193,8,3,5
20,7,194,16,15,1
20,7,195,6,18,-12
20,7,196,14,17,-3
20,7,197,14,27,-13
20,7,198,3,17,-14
20,7,199,15,20,-5
20,7,200,14,28,-14
20,7,201,20,21,-1
20,7,202,15,28,-13
20,7,203,14,25,-11
20,7,204,9,21,-12
20,7,205,19,23,-4
20,7,206,8,13,-5
20,7,207,17,25,-8
20,7,208,17,24,-7
20,7,209,9,11,-2
20,7,210,13,29,-16
20,7,211,9,12,-3
20,7,212,10,7,3
20,7,213,10,26,-16
20,7,214,12,30,-18
20,7,215,11,21,-10
20,7,216,9,24,-15
20,7,217,5,18,-13
20,7,218,18,26,-8
20,7,219,12,30,-18
20,7,220,11,21,-10
20,7,221,14,13,1
20,7,222,7,25,-18
20,7,223,25,42,-17
20,7,224,11,20,-9
20,7,225,15,13,2
20,7,226,18,15,3
20,7,227,26,24,2
20,7,228,14,15,-1
20,7,229,11,18,-7
20,7,230,11,24,-13
20,7,231,15,19,-4
20,7,232,19,14,5
20,7,233,7,15,-8
20,7,234,9,10,-1
20,7,235,6,7,-1
20,7,236,23,20,3
20,7,237,18,29,-11
20,7,238,27,18,9
20,7,239,14,24,-10
20,7,240,10,16,-6
20,7,241,8,10,-2
20,7,242,3,14,-11
20,7,243,20,38,-18
20,7,244,15,14,1
20,7,245,10,17,-7
20,7,246,11,16,-5
20,7,247,18,37,-19
20,7,248,13,20,-7
20,7,249,8,9,-1
20,7,250,12,11,1
20,7,251,10,17,-7
20,7,252,28,27,1
20,7,253,13,31,-18
20,7,254,15,33,-18
20,7,255,4,14,-10
20,7,256,12,27,-15
20,7,257,11,17,-6
20,7,258,8,8,0
20,7,259,17,9,8
20,7,260,8,25,-17
20,7,261,15,28,-13
20,7,262,6,16,-10
20,7,263,3,8,-5
20,7,264,10,23,-13
20,7,265,10,22,-12
20,7,266,10,27,-17
20,7,267,11,16,-5
20,7,268,10,27,-17
20,7,269,16,38,-22
20,7,270,10,15,-5
20,7,271,7,11,-4
20,7,272,16,14,2
20,7,273,18,26,-8
20,7,274,15,30,-15
20,7,275,13,23,-10
20,7,276,9,17,-8
20,7,277,1,13,-12
20,7,278,12,15,-3
20,7,279,7,12,-5
20,7,280,12,25,-13
20,7,281,11,19,-8
20,7,282,10,10,0
20,7,283,9,16,-7
20,7,284,9,19,-10
20,7,285,19,34,-15
20,7,286,16,20,-4
20,7,287,14,11,3
20,7,288,14,18,-4
20,7,289,16,23,-7
20,7,290,11,21,-10
20,7,291,10,16,-6
20,7,292,9,19,-10
20,7,293,13,17,-4
20,7,294,10,25,-15
20,7,295,11,18,-7
20,7,296,21,29,-8
20,7,297,11,23,-12
20,7,298,19,15,4
20,7,299,11,14,-3
20,8,0,10,14,-4
20,8,1,15,21,-6
20,8,2,13,8,5
20,8,3,13,20,-7
20,8,4,7,11,-4
20,8,5,4,22,-18
20,8,6,7,28,-21
20,8,7,10,11,-1
20,8,8,11,14,-3
20,8,9,5,14,-9
20,8,10,10,20,-10
20,8,11,6,15,-9
20,8,12,8,12,-4
20,8,13,10,26,-16
20,8,14,11,40,-29
20,8,15,7,6,1
20,8,16,6,16,-10
20,8,17,15,8,7
20,8,18,12,16,-4
20,8,19,6,18,-12
20,8,20,11,17,-6
20,8,21,4,21,-17
20,8,22,20,14,6
20,8,23,11,15,-4
20,8,24,27,23,4
20,8,25,8,22,-14
20,8,26,10,20,-10
20,8,27,12,11,1
20,8,28,14,24,-10
20,8,29,18,22,-4
20,8,30,12,39,-27
20,8,31,6,17,-11
20,8,32,6,9,-3
20,8,33,8,13,-5
20,8,34,12,14,-2
20,8,35,26,21,5
20,8,36,14,11,3
20,8,37,10,10,0
20,8,38,13,25,-12
20,8,39,6,9,-3
20,8,40,7,20,-13
20,8,41,9,27,-18
20,8,42,18,30,-12
20,8,43,2,14,-12
20,8,44,0,13,-13
20,8,45,11,7,4
20,8,46,10,22,-12
20,8,47,8,7,1
20,8,48,19,18,1
20,8,49,19,36,-17
20,8,50,19,21,-2
20,8,51,16,21,-5
20,8,52,8,15,-7
20,8,53,10,19,-9
20,8,54,11,15,-4
20,8,55,8,22,-14
20,8,56,13,13,0
20,8,57,9,24,-15
20,8,58,11,16,-5
20,8,59,13,22,-9
20,8,60,9,26,-17
20,8,61,18,25,-7
20,8,62,5,16,-11
20,8,63,8,10,-2
20,8,64,19,17,2
20,8,65,11,9,2
20,8,66,5,10,-5
20,8,67,15,14,1
20,8,68,4,26,-22
20,8,69,11,20,-9
20,8,70,28,27,1
20,8,71,7,23,-16
20,8,72,14,17,-3
20,8,73,8,16,-8
20,8,74,9,20,-11
20,8,75,9,13,-4
20,8,76,7,17,-10
20,8,77,12,35,-23
20,8,78,12,16,-4
20,8,79,7,19,-12
20,8,80,13,21,-8
20,8,81,9,24,-15
20,8,82,8,20,-12
20,8,83,20,17,3
20,8,84,18,18,0
20,8,85,13,16,-3
20,8,86,6,20,-14
20,8,87,6,31,-25
20,8,88,13,21,-8
20,8,89,6,19,-13
20,8,90,3,9,-6
20,8,91,10,24,-14
20,8,92,8,8,0
20,8,93,15,11,4
20,8,94,9,39,-30
20,8,95,12,17,-5
20,8,96,15,17,-2
20,8,97,16,20,-4
20,8,98,10,22,-12
20,8,99,12,27,-15
20,8,100,14,11,3
20,8,101,9,14,-5
20,8,102,11,30,-19
20,8,103,3,14,-11
20,8,104,10,22,-12
20,8,105,4,4,0
20,8,106,12,21,-9
20,8,107,13,21,-8
20,8,108,28,21,7
20,8,109,5,17,-12
20,8,110,6,10,-4
20,8,111,15,24,-9
20,8,112,8,15,-7
20,8,113,26,22,4
20,8,114,18,21,-3
20,8,115,8,23,-15
20,8,116,8,16,-8
20,8,117,3,19,-16
20,8,118,11,17,-6
20,8,119,16,22,-6
20,8,120,7,21,-14
20,8,121,8,18,-10
20,8,122,12,30,-18
20,8,123,15,25,-10
20,8,124,11,8,3
20,8,125,8,23,-15
20,8,126,14,21,-7
20,8,127,11,16,-5
20,8,128,14,18,-4
20,8,129,9,16,-7
20,8,130,13,15,-2
20,8,131,18,26,-8
20,8,132,8,16,-8
20,8,133,8,17,-9
20,8,134,10,23,-13
20,8,135,11,17,-6
20,8,136,11,25,-14
20,8,137,6,12,-6
20,8,138,18,19,-1
20,8,139,15,29,-14
20,8,140,8,14,-6
20,8,141,17,19,-2
20,8,142,4,13,-9
20,8,143,11,12,-1
20,8,144,4,14,-10
20,8,145,9,22,-13
20,8,146,12,21,-9
20,8,147,14,31,-17
20,8,148,7,11,-4
20,8,149,19,21,-2
20,8,150,6,16,-10
20,8,151,3,20,-17
20,8,152,19,10,9
20,8,153,16,19,-3
20,8,154,4,6,-2
20,8,155,14,21,-7
20,8,156,16,27,-11
20,8,157,8,21,-13
20,8,158,12,22,-10
20,8,159,11,24,-13
20,8,160,11,15,-4
20,8,161,8,8,0
20,8,162,15,15,0
20,8,163,13,13,0
20,8,164,12,26,-14
20,8,165,5,10,-5
20,8,166,18,20,-2
20,8,167,13,20,-7
20,8,168,8,19,-11
20,8,169,2,9,-7
20,8,170,8,19,-11
20,8,171,7,17,-10
20,8,172,20,27,-7
20,8,173,18,31,-13
20,8,174,8,17,-9
20,8,175,17,22,-5
20,8,176,9,9,0
20,8,177,12,25,-13
20,8,178,9,27,-18
20,8,179,7,15,-8
20,8,180,21,11,10
20,8,181,6,16,-10
20,8,182,6,10,-4
20,8,183,5,10,-5
20,8,184,14,15,-1
20,8,185,9,15,-6
20,8,186,6,16,-10
20,8,187,11,22,-11
20,8,188,7,40,-33
20,8,189,14,11,3
20,8,190,12,11,1
20,8,191,11,27,-16
20,8,192,11,19,-8
20,8,193,19,22,-3
20,8,194,17,20,-3
20,8,195,11,21,-10
20,8,196,8,13,-5
20,8,197,10,17,-7
20,8,198,10,21,-11
20,8,199,6,12,-6
20,8,200,15,7,8
20,8,201,21,22,-1
20,8,202,3,9,-6
20,8,203,7,5,2
20,8,204,11,17,-6
20,8,205,22,16,6
20,8,206,9,16,-7
20,8,207,19,29,-10
20,8,208,16,25,-9
20,8,209,7,16,-9
20,8,210,12,24,-12
20,8,211,16,7,9
20,8,212,19,31,-12
20,8,213,18,31,-13
20,8,214,15,25,-10
20,8,215,10,23,-13
20,8,216,17,18,-1
20,8,217,8,13,-5
20,8,218,12,25,-13
20,8,219,11,31,-20
20,8,220,9,18,-9
20,8,221,3,4,-1
20,8,222,8,14,-6
20,8,223,7,18,-11
20,8,224,11,13,-2
20,8,225,16,23,-7
20,8,226,5,18,-13
20,8,227,4,11,-7
20,8,228,15,20,-5
20,8,229,19,12,7
20,8,230,13,12,1
20,8,231,7,23,-16
20,8,232,21,23,-2
20,8,233,8,28,-20
20,8,234,17,18,-1
20,8,235,12,15,-3
20,8,236,11,21,-10
20,8,237,11,12,-1
20,8,238,21,30,-9
20,8,239,20,29,-9
20,8,240,10,9,1
20,8,241,5,17,-12
20,8,242,12,21,-9
20,8,243,13,17,-4
20,8,244,13,19,-6
20,8,245,17,30,-13
20,8,246,4,19,-15
20,8,247,7,15,-8
20,8,248,10,18,-8
20,8,249,8,10,-2
20,8,250,8,26,-18
20,8,251,19,20,-1
20,8,252,23,30,-7
20,8,253,21,21,0
20,8,254,13,15,-2
20,8,255,11,12,-1
20,8,256,22,19,3
20,8,257,9,16,-7
20,8,258,15,21,-6
20,8,259,5,12,-7
20,8,260,18,14,4
20,8,261,15,25,-10
20,8,262,6,14,-8
20,8,263,6,19,-13
20,8,264,4,16,-12
20,8,265,15,23,-8
20,8,266,12,18,-6
20,8,267,12,25,-13
20,8,268,6,9,-3
20,8,269,20,23,-3
20,8,270,5,22,-17
20,8,271,19,24,-5
20,8,272,3,25,-22
20,8,273,15,24,-9
20,8,274,16,25,-9
20,8,275,17,21,-4
20,8,276,16,27,-11
20,8,277,17,15,2
20,8,278,14,27,-13
20,8,279,10,15,-5
20,8,280,8,8,0
20,8,281,6,17,-11
20,8,282,4,17,-13
20,8,283,23,28,-5
20,8,284,5,12,-7
20,8,285,19,23,-4
20,8,286,6,16,-10
20,8,287,8,28,-20
20,8,288,10,21,-11
20,8,289,11,13,-2
20,8,290,18,11,7
20,8,291,15,13,2
20,8,292,14,19,-5
20,8,293,10,25,-15
20,8,294,18,19,-1
20,8,295,24,30,-6
20,8,296,9,25,-16
20,8,297,11,29,-18
20,8,298,8,15,-7
20,8,299,7,15,-8
20,9,0,9,16,-7
20,9,1,15,28,-13
20,9,2,4,6,-2
20,9,3,11,24,-13
20,9,4,11,12,-1
20,9,5,9,35,-26
20,9,6,8,13,-5
20,9,7,9,12,-3
20,9,8,11,16,-5
20,9,9,12,13,-1
20,9,10,13,24,-11
20,9,11,1,14,-13
20,9,12,8,21,-13
20,9,13,8,13,-5
20,9,14,6,20,-14
20,9,15,6,10,-4
20,9,16,18,19,-1
20,9,17,8,16,-8
20,9,18,13,26,-13
20,9,19,9,16,-7
20,9,20,13,6,7
20,9,21,8,18,-10
20,9,22,15,15,0
20,9,23,12,21,-9
20,9,24,14,30,-16
20,9,25,11,19,-8
20,9,26,8,21,-13
20,9,27,18,11,7
20,9,28,11,15,-4
20,9,29,15,21,-6
20,9,30,8,15,-7
20,9,31,9,18,-9
20,9,32,23,17,6
20,9,33,4,23,-19
20,9,34,6,11,-5
20,9,35,16,19,-3
20,9,36,6,10,-4
20,9,37,10,20,-10
20,9,38,11,14,-3
20,9,39,20,18,2
20,9,40,19,29,-10
20,9,41,20,34,-14
20,9,42,6,11,-5
20,9,43,10,9,1
20,9,44,16,29,-13
20,9,45,12,15,-3
20,9,46,10,22,-12
20,9,47,10,15,-5
20,9,48,10,13,-3
20,9,49,6,24,-18
20,9,50,23,28,-5
20,9,51,10,15,-5
20,9,52,4,16,-12
20,9,53,13,16,-3
20,9,54,15,20,-5
20,9,55,13,27,-14
20,9,56,8,29,-21
20,9,57,17,17,0
20,9,58,5,11,-6
20,9,59,6,19,-13
20,9,60,7,17,-10
20,9,61,12,16,-4
20,9,62,11,11,0
20,9,63,11,14,-3
20,9,64,11,18,-7
20,9,65,13,19,-6
20,9,66,14,33,-19
20,9,67,17,24,-7
20,9,68,18,19,-1
20,9,69,19,17,2
20,9,70,5,20,-15
20,9,71,9,10,-1
20,9,72,21,14,7
20,9,73,14,20,-6
20,9,74,12,15,-3
20,9,75,15,23,-8
20,9,76,11,13,-2
20,9,77,11,20,-9
20,9,78,12,6,6
20,9,79,9,24,-15
20,9,80,16,21,-5
20,9,81,10,14,-4
20,9,82,14,18,-4
20,9,83,13,19,-6
20,9,84,7,23,-16
20,9,85,5,17,-12
20,9,86,14,15,-1
20,9,87,10,27,-17
20,9,88,11,22,-11
20,9,89,12,24,-12
20,9,90,24,26,-2
20,9,91,12,19,-7
20,9,92,12,24,-12
20,9,93,8,19,-11
20,9,94,21,22,-1
20,9,95,9,12,-3
20,9,96,20,30,-10
20,9,97,2,25,-23
20,9,98,5,15,-10
20,9,99,19,25,-6
20,9,100,9,14,-5
20,9,101,10,10,0
20,9,102,16,13,3
20,9,103,7,14,-7
20,9,104,16,35,-19
20,9,105,15,17,-2
20,9,106,9,12,-3
20,9,107,8,20,-12
20,9,108,8,21,-13
20,9,109,15,22,-7
20,9,110,7,27,-20
20,9,111,4,14,-10
20,9,112,20,24,-4
20,9,113,17,15,2
20,9,114,11,27,-16
20,9,115,7,15,-8
20,9,116,10,31,-21
20,9,117,13,20,-7
20,9,118,17,23,-6
20,9,119,8,13,-5
20,9,120,18,21,-3
20,9,121,14,12,2
20,9,122,16,20,-4
20,9,123,16,25,-9
20,9,124,5,17,-12
20,9,125,10,18,-8
20,9,126,18,19,-1
20,9,127,8,18,-10
20,9,128,9,14,-5
20,9,129,15,21,-6
20,9,130,12,28,-16
20,9,131,6,27,-21
20,9,132,12,16,-4
20,9,133,10,16,-6
20,9,134,15,16,-1
20,9,135,8,12,-4
20,9,136,10,10,0
20,9,137,17,29,-12
20,9,138,7,20,-13
20,9,139,13,19,-6
20,9,140,16,24,-8
20,9,141,15,13,2
20,9,142,17,27,-10
20,9,143,9,10,-1
20,9,144,14,14,0
20,9,145,10,28,-18
20,9,146,6,9,-3
20,9,147,19,31,-12
20,9,148,8,13,-5
20,9,149,6,12,-6
20,9,150,16,15,1
20,9,151,8,13,-5
20,9,152,16,25,-9
20,9,153,6,18,-12
20,9,154,16,26,-10
20,9,155,12,25,-13
20,9,156,21,33,-12
20,9,157,16,8,8
20,9,158,16,29,-13
20,9,159,14,29,-15
20,9,160,13,19,-6
20,9,161,14,17,-3
20,9,162,15,35,-20
20,9,163,1,4,-3
20,9,164,17,21,-4
20,9,165,12,6,6
20,9,166,7,18,-11
20,9,167,13,16,-3
20,9,168,8,17,-9
20,9,169,20,16,4
20,9,170,14,15,-1
20,9,171,11,24,-13
20,9,172,15,13,2
20,9,173,16,27,-11
20,9,174,3,19,-16
20,9,175,13,15,-2
20,9,176,8,10,-2
20,9,177,4,15,-11
20,9,178,5,16,-11
20,9,179,6,15,-9
20,9,180,31,20,11
20,9,181,10,14,-4
20,9,182,15,22,-7
20,9,183,15,13,2
20,9,184,10,25,-15
20,9,185,5,9,-4
20,9,186,12,23,-11
20,9,187,7,25,-18
20,9,188,8,22,-14
20,9,189,11,43,-32
20,9,190,2,12,-10
20,9,191,12,21,-9
20,9,192,17,31,-14
20,9,193,7,13,-6
20,9,194,17,20,-3
20,9,195,8,8,0
20,9,196,15,14,1
20,9,197,11,10,1
20,9,198,10,17,-7
20,9,199,15,8,7
20,9,200,6,9,-3
20,9,201,11,15,-4
20,9,202,4,13,-9
20,9,203,10,9,1
20,9,204,8,6,2
20,9,205,14,19,-5
20,9,206,15,15,0
20,9,207,9,11,-2
20,9,208,2,11,-9
20,9,209,15,28,-13
20,9,210,15,12,3
20,9,211,12,25,-13
20,9,212,9,21,-12
20,9,213,15,15,0
20,9,214,15,26,-11
20,9,215,19,35,-16
20,9,216,17,22,-5
20,9,217,12,17,-5
20,9,218,10,9,1
20,9,219,12,9,3
20,9,220,11,14,-3
20,9,221,16,23,-7
20,9,222,10,15,-5
20,9,223,7,12,-5
20,9,224,9,18,-9
20,9,225,13,16,-3
20,9,226,12,22,-10
20,9,227,11,22,-11
20,9,228,9,30,-21
20,9,229,10,25,-15
20,9,230,2,26,-24
20,9,231,5,14,-9
20,9,232,9,10,-1
20,9,233,23,22,1
20,9,234,24,26,-2
20,9,235,13,23,-10
20,9,236,12,18,-6
20,9,237,12,10,2
20,9,238,13,8,5
20,9,239,15,28,-13
20,9,240,7,13,-6
20,9,241,12,11,1
20,9,242,23,23,0
20,9,243,15,14,1
20,9,244,8,9,-1
20,9,245,9,24,-15
20,9,246,13,16,-3
20,9,247,8,13,-5
20,9,248,29,23,6
20,9,249,4,18,-14
20,9,250,12,18,-6
20,9,251,12,17,-5
20,9,252,13,17,-4
20,9,253,8,26,-18
20,9,254,23,17,6
20,9,255,14,20,-6
20,9,256,23,26,-3
20,9,257,25,30,-5
20,9,258,10,18,-8
20,9,259,17,23,-6
20,9,260,16,7,9
20,9,261,7,19,-12
20,9,262,18,36,-18
20,9,263,29,23,6
20,9,264,9,20,-11
20,9,265,5,16,-11
20,9,266,4,25,-21
20,9,267,20,23,-3
20,9,268,10,18,-8
20,9,269,17,16,1
20,9,270,13,31,-18
20,9,271,13,30,-17
20,9,272,8,20,-12
20,9,273,7,17,-10
20,9,274,8,18,-10
20,9,275,11,16,-5
20,9,276,6,15,-9
20,9,277,13,16,-3
20,9,278,11,17,-6
20,9,279,7,18,-11
20,9,280,11,14,-3
20,9,281,9,20,-11
20,9,282,8,10,-2
20,9,283,11,22,-11
20,9,284,10,9,1
20,9,285,10,17,-7
20,9,286,18,18,0
20,9,287,17,7,10
20,9,288,11,13,-2
20,9,289,13,19,-6
20,9,290,20,14,6
20,9,291,16,16,0
20,9,292,5,12,-7
20,9,293,10,16,-6
20,9,294,18,19,-1
20,9,295,18,30,-12
20,9,296,14,19,-5
20,9,297,8,24,-16
20,9,298,7,13,-6
20,9,299,19,25,-6
20,10,0,6,18,-12
20,10,1,16,17,-1
20,10,2,10,21,-11
20,10,3,15,21,-6
20,10,4,4,4,0
20,10,5,9,24,-15
20,10,6,15,18,-3
20,10,7,7,12,-5
20,10,8,5,19,-14
20,10,9,12,17,-5
20,10,10,11,13,-2
20,10,11,12,28,-16
20,10,12,7,19,-12
20,10,13,15,18,-3
20,10,14,12,8,4
20,10,15,7,17,-10
20,10,16,10,31,-21
20,10,17,13,22,-9
20,10,18,7,17,-10
20,10,19,11,15,-4
20,10,20,13,20,-7
20,10,21,4,16,-12
20,10,22,25,18,7
20,10,23,10,16,-6
20,10,24,11,16,-5
20,10,25,9,14,-5
20,10,26,20,14,6
20,10,27,9,12,-3
20,10,28,7,16,-9
20,10,29,16,13,3
20,10,30,18,24,-6
20,10,31,17,22,-5
20,10,32,15,10,5
20,10,33,19,14,5
20,10,34,10,24,-14
20,10,35,14,22,-8
20,10,36,12,11,1
20,10,37,18,19,-1
20,10,38,10,16,-6
20,10,39,10,14,-4
20,10,40,20,21,-1
20,10,41,9,20,-11
20,10,42,5,21,-16
20,10,43,10,12,-2
20,10,44,16,17,-1
20,10,45,14,15,-1
20,10,46,8,14,-6
20,10,47,11,20,-9
20,10,48,8,12,-4
20,10,49,8,21,-13
20,10,50,16,22,-6
20,10,51,18,22,-4
20,10,52,11,24,-13
20,10,53,22,10,12
20,10,54,4,9,-5
20,10,55,25,25,0
20,10,56,14,7,7
20,10,57,5,23,-18
20,10,58,19,17,2
20,10,59,17,16,1
20,10,60,11,29,-18
20,10,61,12,10,2
20,10,62,15,24,-9
20,10,63,12,15,-3
20,10,64,2,12,-10
20,10,65,11,15,-4
20,10,66,17,19,-2
20,10,67,23,16,7
20,10,68,6,22,-16
20,10,69,7,18,-11
20,10,70,8,29,-21
20,10,71,15,14,1
20,10,72,8,16,-8
20,10,73,26,29,-3
20,10,74,13,13,0
20,10,75,12,30,-18
20,10,76,8,16,-8
20,10,77,6,14,-8
20,10,78,21,25,-4
20,10,79,21,32,-11
20,10,80,14,24,-10
20,10,81,13,24,-11
20,10,82,17,30,-13
20,10,83,7,27,-20
20,10,84,14,38,-24
20,10,85,7,18,-11
20,10,86,11,13,-2
20,10,87,12,12,0
20,10,88,3,27,-24
20,10,89,16,11,5
20,10,90,19,23,-4
20,10,91,19,24,-5
20,10,92,16,20,-4
20,10,93,13,21,-8
20,10,94,8,21,-13
20,10,95,7,9,-2
20,10,96,12,19,-7
20,10,97,7,13,-6
20,10,98,9,23,-14
20,10,99,19,29,-10
20,10,100,11,11,0
20,10,101,16,23,-7
20,10,102,24,21,3
20,10,103,6,21,-15
20,10,104,13,15,-2
20,10,105,12,16,-4
20,10,106,5,16,-11
20,10,107,7,29,-22
20,10,108,2,9,-7
20,10,109,11,6,5
20,10,110,11,11,0
20,10,111,13,24,-11
20,10,112,9,21,-12
20,10,113,11,23,-12
20,10,114,14,16,-2
20,10,115,11,13,-2
20,10,116,6,36,-30
20,10,117,11,21,-10
20,10,118,4,10,-6
20,10,119,15,18,-3
20,10,120,5,18,-13
20,10,121,17,16,1
20,10,122,12,16,-4
20,10,123,8,13,-5
20,10,124,20,20,0
20,10,125,17,24,-7
20,10,126,7,14,-7
20,10,127,2,8,-6
20,10,128,6,29,-23
20,10,129,17,15,2
20,10,130,14,23,-9
20,10,131,20,25,-5
20,10,132,18,14,4
20,10,133,15,17,-2
20,10,134,16,8,8
20,10,135,8,16,-8
20,10,136,3,33,-30
20,10,137,7,15,-8
20,10,138,24,21,3
20,10,139,13,11,2
20,10,140,17,20,-3
20,10,141,10,19,-9
20,10,142,17,39,-22
20,10,143,12,15,-3
20,10,144,15,37,-22
20,10,145,8,24,-16
20,10,146,10,13,-3
20,10,147,25,21,4
20,10,148,14,13,1
20,10,149,7,12,-5
20,10,150,14,25,-11
20,10,151,14,22,-8
20,10,152,17,14,3
20,10,153,15,8,7
20,10,154,10,24,-14
20,10,155,14,17,-3
20,10,156,10,15,-5
20,10,157,12,10,2
20,10,158,15,26,-11
20,10,159,18,22,-4
20,10,160,12,20,-8
20,10,161,8,20,-12
20,10,162,14,6,8
20,10,163,16,16,0
20,10,164,20,26,-6
20,10,165,7,12,-5
20,10,166,14,18,-4
20,10,167,11,9,2
20,10,168,16,21,-5
20,10,169,6,10,-4
20,10,170,31,28,3
20,10,171,8,23,-15
20,10,172,13,29,-16
20,10,173,14,28,-14
20,10,174,12,15,-3
20,10,175,18,24,-6
20,10,176,10,19,-9
20,10,177,7,12,-5
20,10,178,8,18,-10
20,10,179,15,18,-3
20,10,180,14,18,-4
20,10,181,6,12,-6
20,10,182,15,32,-17
20,10,183,9,20,-11
20,10,184,8,14,-6
20,10,185,2,12,-10
20,10,186,18,26,-8
20,10,187,4,14,-10
20,10,188,11,29,-18
20,10,189,20,31,-11
20,10,190,7,32,-25
20,10,191,8,11,-3
20,10,192,17,21,-4
20,10,193,13,18,-5
20,10,194,8,9,-1
20,10,195,6,19,-13
20,10,196,5,5,0
20,10,197,13,19,-6
20,10,198,21,26,-5
20,10,199,15,10,5
20,10,200,6,20,-14
20,10,201,13,32,-19
20,10,202,18,23,-5
20,10,203,3,10,-7
20,10,204,15,15,0
20,10,205,5,13,-8
20,10,206,16,32,-16
20,10,207,16,18,-2
20,10,208,14,35,-21
20,10,209,10,6,4
20,10,210,16,15,1
20,10,211,15,13,2
20,10,212,9,15,-6
20,10,213,11,30,-19
20,10,214,8,18,-10
20,10,215,18,27,-9
20,10,216,12,27,-15
20,10,217,11,14,-3
20,10,218,18,10,8
20,10,219,6,26,-20
20,10,220,7,19,-12
20,10,221,2,24,-22
20,10,222,18,20,-2
20,10,223,9,5,4
20,10,224,14,24,-10
20,10,225,13,16,-3
20,10,226,25,22,3
20,10,227,7,16,-9
20,10,228,14,14,0
20,10,229,10,14,-4
20,10,230,8,29,-21
20,10,231,27,15,12
20,10,232,14,13,1
20,10,233,7,7,0
20,10,234,18,18,0
20,10,235,11,19,-8
20,10,236,8,21,-13
20,10,237,6,7,-1
20,10,238,16,34,-18
20,10,239,18,21,-3
20,10,240,13,20,-7
20,10,241,9,17,-8
20,10,242,7,23,-16
20,10,243,23,8,15
20,10,244,19,35,-16
20,10,245,9,25,-16
20,10,246,13,16,-3
20,10,247,11,21,-10
20,10,248,7,22,-15
20,10,249,18,27,-9
20,10,250,28,30,-2
20,10,251,7,15,-8
20,10,252,2,26,-24
20,10,253,5,13,-8
20,10,254,15,34,-19
20,10,255,21,19,2
20,10,256,9,14,-5
20,10,257,9,19,-10
20,10,258,14,23,-9
20,10,259,2,18,-16
20,10,260,14,19,-5
20,10,261,14,18,-4
20,10,262,11,23,-12
20,10,263,7,20,-13
20,10,264,16,25,-9
20,10,265,7,30,-23
20,10,266,11,22,-11
20,10,267,18,9,9
20,10,268,21,18,3
20,10,269,3,22,-19
20,10,270,3,19,-16
20,10,271,11,14,-3
20,10,272,7,10,-3
20,10,273,17,17,0
20,10,274,18,25,-7
20,10,275,16,22,-6
20,10,276,5,26,-21
20,10,277,19,26,-7
20,10,278,8,22,-14
20,10,279,8,24,-16
20,10,280,5,22,-17
20,10,281,12,32,-20
20,10,282,10,20,-10
20,10,283,7,11,-4
20,10,284,4,14,-10
20,10,285,15,18,-3
20,10,286,3,21,-18
20,10,287,15,15,0
20,10,288,8,21,-13
20,10,289,9,8,1
20,10,290,3,12,-9
20,10,291,10,26,-16
20,10,292,8,12,-4
20,10,293,7,24,-17
20,10,294,9,18,-9
20,10,295,13,34,-21
20,10,296,11,16,-5
20,10,297,9,28,-19
20,10,298,6,26,-20
20,10,299,10,20,-10
20,11,0,16,26,-10
20,11,1,16,16,0
20,11,2,11,34,-23
20,11,3,10,16,-6
20,11,4,15,18,-3
20,11,5,12,26,-14
20,11,6,18,31,-13
20,11,7,13,24,-11
20,11,8,11,15,-4
20,11,9,25,15,10
20,11,10,14,24,-10
20,11,11,14,21,-7
20,11,12,10,15,-5
20,11,13,12,4,8
20,11,14,8,16,-8
20,11,15,29,26,3
20,11,16,14,17,-3
20,11,17,9,18,-9
20,11,18,14,16,-2
20,11,19,9,20,-11
20,11,20,11,15,-4
20,11,21,16,24,-8
20,11,22,10,21,-11
20,11,23,20,23,-3
20,11,24,14,25,-11
20,11,25,4,19,-15
20,11,26,25,28,-3
20,11,27,16,17,-1
20,11,28,11,13,-2
20,11,29,14,24,-10
20,11,30,11,19,-8
20,11,31,10,17,-7
20,11,32,23,18,5
20,11,33,8,16,-8
20,11,34,8,22,-14
20,11,35,24,33,-9
20,11,36,11,16,-5
20,11,37,8,19,-11
20,11,38,9,16,-7
20,11,39,20,11,9
20,11,40,11,20,-9
20,11,41,19,20,-1
20,11,42,27,16,11
20,11,43,10,26,-16
20,11,44,7,17,-10
20,11,45,23,14,9
20,11,46,9,19,-10
20,11,47,12,17,-5
20,11,48,18,33,-15
20,11,49,10,22,-12
20,11,50,5,14,-9
20,11,51,15,27,-12
20,11,52,12,6,6
20,11,53,15,14,1
20,11,54,1,4,-3
20,11,55,4,23,-19
20,11,56,12,15,-3
20,11,57,12,27,-15
20,11,58,9,18,-9
20,11,59,28,15,13
20,11,60,8,11,-3
20,11,61,11,21,-10
20,11,62,18,10,8
20,11,63,23,23,0
20,11,64,16,17,-1
20,11,65,17,22,-5
20,11,66,11,10,1
20,11,67,12,20,-8
20,11,68,2,17,-15
20,11,69,5,20,-15
20,11,70,16,25,-9
20,11,71,9,23,-14
20,11,72,10,9,1
20,11,73,3,20,-17
20,11,74,9,18,-9
20,11,75,9,12,-3
20,11,76,12,21,-9
20,11,77,13,22,-9
20,11,78,13,8,5
20,11,79,21,18,3
20,11,80,10,19,-9
20,11,81,10,22,-12
20,11,82,5,23,-18
20,11,83,10,17,-7
20,11,84,22,15,7
20,11,85,11,14,-3
20,11,86,16,13,3
20,11,87,12,18,-6
20,11,88,7,11,-4
20,11,89,16,20,-4
20,11,90,14,9,5
20,11,91,17,22,-5
20,11,92,11,29,-18
20,11,93,10,15,-5
20,11,94,8,13,-5
20,11,95,9,21,-12
20,11,96,6,9,-3
20,11,97,14,24,-10
20,11,98,21,8,13
20,11,99,9,23,-14
20,11,100,16,16,0
20,11,101,28,31,-3
20,11,102,14,26,-12
20,11,103,6,12,-6
20,11,104,15,29,-14
20,11,105,8,26,-18
20,11,106,5,19,-14
20,11,107,14,25,-11
20,11,108,9,15,-6
20,11,109,18,24,-6
20,11,110,18,8,10
20,11,111,13,8,5
20,11,112,20,20,0
20,11,113,14,20,-6
20,11,114,10,17,-7
20,11,115,18,11,7
20,11,116,11,18,-7
20,11,117,5,16,-11
20,11,118,6,6,0
20,11,119,28,23,5
20,11,120,13,17,-4
20,11,121,10,8,2
20,11,122,9,16,-7
20,11,123,11,15,-4
20,11,124,9,12,-3
20,11,125,15,28,-13
20,11,126,5,11,-6
20,11,127,13,16,-3
20,11,128,16,26,-10
20,11,129,14,19,-5
20,11,130,18,14,4
20,11,131,16,25,-9
20,11,132,4,12,-8
20,11,133,7,12,-5
20,11,134,14,20,-6
20,11,135,18,23,-5
20,11,136,14,16,-2
20,11,137,14,21,-7
20,11,138,16,11,5
20,11,139,11,18,-7
20,11,140,18,18,0
20,11,141,5,16,-11
20,11,142,7,14,-7
20,11,143,14,13,1
20,11,144,15,24,-9
20,11,145,12,10,2
20,11,146,33,25,8
20,11,147,2,17,-15
20,11,148,7,22,-15
20,11,149,18,23,-5
20,11,150,23,14,9
20,11,151,15,25,-10
20,11,152,14,19,-5
20,11,153,18,17,1
20,11,154,11,31,-20
20,11,155,9,23,-14
20,11,156,19,29,-10
20,11,157,18,15,3
20,11,158,7,15,-8
20,11,159,13,8,5
20,11,160,14,16,-2
20,11,161,19,31,-12
20,11,162,14,20,-6
20,11,163,11,21,-10
20,11,164,10,33,-23
20,11,165,18,28,-10
20,11,166,9,20,-11
20,11,167,8,15,-7
20,11,168,15,19,-4
20,11,169,18,15,3
20,11,170,7,16,-9
20,11,171,13,22,-9
20,11,172,10,24,-14
20,11,173,17,11,6
20,11,174,6,20,-14
20,11,175,11,11,0
20,11,176,19,19,0
20,11,177,22,24,-2
20,11,178,16,17,-1
20,11,179,9,9,0
20,11,180,19,28,-9
20,11,181,14,18,-4
20,11,182,23,17,6
20,11,183,15,16,-1
20,11,184,14,16,-2
20,11,185,8,33,-25
20,11,186,14,22,-8
20,11,187,10,11,-1
20,11,188,11,9,2
20,11,189,17,21,-4
20,11,190,4,7,-3
20,11,191,11,22,-11
20,11,192,14,20,-6
20,11,193,7,28,-21
20,11,194,19,24,-5
20,11,195,17,19,-2
20,11,196,10,14,-4
20,11,197,12,35,-23
20,11,198,9,20,-11
20,11,199,9,20,-11
20,11,200,4,7,-3
20,11,201,9,7,2
20,11,202,13,26,-13
20,11,203,6,26,-20
20,11,204,14,10,4
20,11,205,13,11,2
20,11,206,12,23,-11
20,11,207,10,22,-12
20,11,208,12,11,1
20,11,209,6,20,-14
20,11,210,16,20,-4
20,11,211,10,16,-6
20,11,212,3,13,-10
20,11,213,9,14,-5
20,11,214,14,17,-3
20,11,215,7,23,-16
20,11,216,11,17,-6
20,11,217,8,14,-6
20,11,218,19,17,2
20,11,219,16,35,-19
20,11,220,7,14,-7
20,11,221,11,23,-12
20,11,222,14,26,-12
20,11,223,8,12,-4
20,11,224,23,27,-4
20,11,225,17,15,2
20,11,226,4,16,-12
20,11,227,19,27,-8
20,11,228,17,25,-8
20,11,229,8,21,-13
20,11,230,3,23,-20
20,11,231,35,21,14
20,11,232,8,10,-2
20,11,233,14,15,-1
20,11,234,12,19,-7
20,11,235,7,13,-6
20,11,236,11,16,-5
20,11,237,10,17,-7
20,11,238,11,22,-11
20,11,239,15,28,-13
20,11,240,13,16,-3
20,11,241,16,17,-1
20,11,242,16,21,-5
20,11,243,13,28,-15
20,11,244,7,20,-13
20,11,245,2,9,-7
20,11,246,12,19,-7
20,11,247,15,20,-5
20,11,248,14,17,-3
20,11,249,19,22,-3
20,11,250,17,6,11
20,11,251,7,16,-9
20,11,252,15,14,1
20,11,253,11,11,0
20,11,254,6,12,-6
20,11,255,17,14,3
20,11,256,6,11,-5
20,11,257,13,16,-3
20,11,258,7,20,-13
20,11,259,8,14,-6
20,11,260,13,16,-3
20,11,261,11,12,-1
20,11,262,7,16,-9
20,11,263,23,27,-4
20,11,264,13,18,-5
20,11,265,13,15,-2
20,11,266,9,17,-8
20,11,267,12,22,-10
20,11,268,5,13,-8
20,11,269,16,10,6
20,11,270,10,25,-15
20,11,271,11,13,-2
20,11,272,14,28,-14
20,11,273,11,17,-6
20,11,274,15,23,-8
20,11,275,4,25,-21
20,11,276,1,11,-10
20,11,277,14,18,-4
20,11,278,13,26,-13
20,11,279,10,12,-2
20,11,280,19,23,-4
20,11,281,10,16,-6
20,11,282,5,23,-18
20,11,283,14,28,-14
20,11,284,10,29,-19
20,11,285,27,19,8
20,11,286,12,30,-18
20,11,287,24,29,-5
20,11,288,21,14,7
20,11,289,15,30,-15
20,11,290,8,19,-11
20,11,291,13,24,-11
20,11,292,5,15,-10
20,11,293,8,18,-10
20,11,294,11,13,-2
20,11,295,18,41,-23
20,11,296,16,18,-2
20,11,297,14,22,-8
20,11,298,7,17,-10
20,11,299,22,29,-7
20,12,0,20,15,5
20,12,1,13,12,1
20,12,2,15,21,-6
20,12,3,11,26,-15
20,12,4,9,21,-12
20,12,5,9,22,-13
20,12,6,13,25,-12
20,12,7,12,16,-4
20,12,8,13,15,-2
20,12,9,13,28,-15
20,12,10,15,17,-2
20,12,11,15,8,7
20,12,12,9,11,-2
20,12,13,8,12,-4
20,12,14,6,13,-7
20,12,15,10,23,-13
20,12,16,6,17,-11
20,12,17,10,9,1
20,12,18,13,12,1
20,12,19,14,20,-6
20,12,20,14,10,4
20,12,21,17,19,-2
20,12,22,13,26,-13
20,12,23,13,16,-3
20,12,24,7,8,-1
20,12,25,11,16,-5
20,12,26,13,27,-14
20,12,27,4,13,-9
20,12,28,12,13,-1
20,12,29,11,17,-6
20,12,30,13,30,-17
20,12,31,5,8,-3
20,12,32,25,20,5
20,12,33,13,12,1
20,12,34,16,19,-3
20,12,35,7,22,-15
20,12,36,15,19,-4
20,12,37,15,30,-15
20,12,38,28,14,14
20,12,39,15,22,-7
20,12,40,13,16,-3
20,12,41,10,21,-11
20,12,42,18,8,10
20,12,43,15,23,-8
20,12,44,2,19,-17
20,12,45,24,17,7
20,12,46,26,19,7
20,12,47,12,16,-4
20,12,48,11,17,-6
20,12,49,18,20,-2
20,12,50,16,24,-8
20,12,51,20,30,-10
20,12,52,19,14,5
20,12,53,25,30,-5
20,12,54,18,13,5
20,12,55,8,8,0
20,12,56,14,13,1
20,12,57,9,16,-7
20,12,58,12,20,-8
20,12,59,10,12,-2
20,12,60,9,18,-9
20,12,61,9,16,-7
20,12,62,14,41,-27
20,12,63,8,27,-19
20,12,64,13,20,-7
20,12,65,4,23,-19
20,12,66,5,11,-6
20,12,67,7,16,-9
20,12,68,3,10,-7
20,12,69,21,15,6
20,12,70,20,29,-9
20,12,71,15,23,-8
20,12,72,14,19,-5
20,12,73,13,27,-14
20,12,74,13,2,11
20,12,75,2,4,-2
20,12,76,17,9,8
20,12,77,8,18,-10
20,12,78,10,19,-9
20,12,79,18,12,6
20,12,80,11,23,-12
20,12,81,6,11,-5
20,12,82,9,24,-15
20,12,83,11,19,-8
20,12,84,9,14,-5
20,12,85,17,9,8
20,12,86,6,21,-15
20,12,87,13,15,-2
20,12,88,34,27,7
20,12,89,17,25,-8
20,12,90,19,30,-11
20,12,91,7,18,-11
20,12,92,5,10,-5
20,12,93,6,23,-17
20,12,94,20,13,7
20,12,95,14,10,4
20,12,96,6,19,-13
20,12,97,19,28,-9
20,12,98,12,13,-1
20,12,99,10,17,-7
20,12,100,14,29,-15
20,12,101,4,15,-11
20,12,102,19,31,-12
20,12,103,22,15,7
20,12,104,6,15,-9
20,12,105,8,20,-12
20,12,106,13,12,1
20,12,107,14,7,7
20,12,108,15,12,3
20,12,109,10,22,-12
20,12,110,11,16,-5
20,12,111,17,27,-10
20,12,112,21,11,10
20,12,113,18,24,-6
20,12,114,19,18,1
20,12,115,11,11,0
20,12,116,10,19,-9
20,12,117,15,22,-7
20,12,118,11,13,-2
20,12,119,19,7,12
20,12,120,4,15,-11
20,12,121,12,24,-12
20,12,122,12,22,-10
20,12,123,15,24,-9
20,12,124,10,11,-1
20,12,125,3,18,-15
20,12,126,8,3,5
20,12,127,9,12,-3
20,12,128,7,4,3
20,12,129,16,15,1
20,12,130,10,22,-12
20,12,131,16,23,-7
20,12,132,20,8,12
20,12,133,5,18,-13
20,12,134,17,22,-5
20,12,135,14,25,-11
20,12,136,7,28,-21
20,12,137,18,21,-3
20,12,138,24,35,-11
20,12,139,9,11,-2
20,12,140,12,19,-7
20,12,141,24,44,-20
20,12,142,9,31,-22
20,12,143,14,6,8
20,12,144,11,15,-4
20,12,145,9,13,-4
20,12,146,22,16,6
20,12,147,10,13,-3
20,12,148,12,22,-10
20,12,149,11,20,-9
20,12,150,17,18,-1
20,12,151,20,16,4
20,12,152,4,10,-6
20,12,153,15,23,-8
20,12,154,15,18,-3
20,12,155,30,19,11
20,12,156,19,10,9
20,12,157,18,23,-5
20,12,158,17,18,-1
20,12,159,11,17,-6
20,12,160,7,35,-28
20,12,161,15,21,-6
20,12,162,9,13,-4
20,12,163,12,18,-6
20,12,164,12,22,-10
20,12,165,17,20,-3
20,12,166,13,17,-4
20,12,167,10,25,-15
20,12,168,10,8,2
20,12,169,14,10,4
20,12,170,11,25,-14
20,12,171,9,12,-3
20,12,172,8,18,-10
20,12,173,12,13,-1
20,12,174,11,19,-8
20,12,175,15,10,5
20,12,176,21,12,9
20,12,177,18,15,3
20,12,178,8,16,-8
20,12,179,11,17,-6
20,12,180,12,22,-10
20,12,181,18,20,-2
20,12,182,15,10,5
20,12,183,16,20,-4
20,12,184,8,17,-9
20,12,185,20,14,6
20,12,186,21,22,-1
20,12,187,18,38,-20
20,12,188,7,19,-12
20,12,189,20,29,-9
20,12,190,9,19,-10
20,12,191,6,8,-2
20,12,192,9,12,-3
20,12,193,7,12,-5
20,12,194,8,19,-11
20,12,195,15,13,2
20,12,196,18,17,1
20,12,197,8,11,-3
20,12,198,22,20,2
20,12,199,5,9,-4
20,12,200,12,18,-6
20,12,201,14,11,3
20,12,202,12,16,-4
20,12,203,11,16,-5
20,12,204,18,12,6
20,12,205,14,16,-2
20,12,206,30,35,-5
20,12,207,8,17,-9
20,12,208,15,18,-3
20,12,209,15,12,3
20,12,210,11,24,-13
20,12,211,17,37,-20
20,12,212,21,21,0
20,12,213,11,18,-7
20,12,214,14,23,-9
20,12,215,14,21,-7
20,12,216,14,10,4
20,12,217,6,16,-10
20,12,218,15,23,-8
20,12,219,3,18,-15
20,12,220,16,21,-5
20,12,221,4,14,-10
20,12,222,9,21,-12
20,12,223,20,29,-9
20,12,224,14,12,2
20,12,225,10,15,-5
20,12,226,20,28,-8
20,12,227,16,23,-7
20,12,228,13,12,1
20,12,229,11,17,-6
20,12,230,7,34,-27
20,12,231,17,15,2
20,12,232,20,30,-10
20,12,233,8,8,0
20,12,234,6,11,-5
20,12,235,24,26,-2
20,12,236,11,23,-12
20,12,237,21,16,5
20,12,238,7,17,-10
20,12,239,15,21,-6
20,12,240,15,25,-10
20,12,241,17,17,0
20,12,242,10,22,-12
20,12,243,14,24,-10
20,12,244,23,10,13
20,12,245,22,18,4
20,12,246,24,29,-5
20,12,247,20,19,1
20,12,248,5,12,-7
20,12,249,8,23,-15
20,12,250,12,23,-11
20,12,251,18,17,1
20,12,252,11,19,-8
20,12,253,8,24,-16
20,12,254,7,14,-7
20,12,255,11,23,-12
20,12,256,5,14,-9
20,12,257,13,11,2
20,12,258,13,23,-10
20,12,259,10,14,-4
20,12,260,12,32,-20
20,12,261,24,16,8
20,12,262,11,30,-19
20,12,263,5,13,-8
20,12,264,21,28,-7
20,12,265,18,16,2
20,12,266,19,39,-20
20,12,267,15,12,3
20,12,268,18,15,3
20,12,269,13,24,-11
20,12,270,16,23,-7
20,12,271,12,29,-17
20,12,272,10,25,-15
20,12,273,6,19,-13
20,12,274,27,12,15
20,12,275,13,25,-12
20,12,276,18,14,4
20,12,277,12,17,-5
20,12,278,12,14,-2
20,12,279,10,15,-5
20,12,280,8,20,-12
20,12,281,11,14,-3
20,12,282,14,26,-12
20,12,283,9,10,-1
20,12,284,7,14,-7
20,12,285,8,17,-9
20,12,286,20,25,-5
20,12,287,7,14,-7
20,12,288,18,19,-1
20,12,289,14,17,-3
20,12,290,5,14,-9
20,12,291,6,20,-14
20,12,292,21,22,-1
20,12,293,8,20,-12
20,12,294,21,19,2
20,12,295,9,24,-15
20,12,296,12,23,-11
20,12,297,19,25,-6
20,12,298,9,21,-12
20,12,299,11,21,-10
20,13,0,8,10,-2
20,13,1,10,11,-1
20,13,2,9,21,-12
20,13,3,13,9,4
20,13,4,9,14,-5
20,13,5,18,29,-11
20,13,6,7,27,-20
20,13,7,13,14,-1
20,13,8,12,25,-13
20,13,9,12,18,-6
20,13,10,12,20,-8
20,13,11,13,14,-1
20,13,12,6,9,-3
20,13,13,15,14,1
20,13,14,7,23,-16
20,13,15,14,18,-4
20,13,16,13,15,-2
20,13,17,23,15,8
20,13,18,24,17,7
20,13,19,27,8,19
20,13,20,17,21,-4
20,13,21,8,27,-19
20,13,22,11,16,-5
20,13,23,15,19,-4
20,13,24,10,13,-3
20,13,25,14,16,-2
20,13,26,14,28,-14
20,13,27,13,27,-14
20,13,28,7,20,-13
20,13,29,13,21,-8
20,13,30,8,14,-6
20,13,31,8,20,-12
20,13,32,8,23,-15
20,13,33,15,13,2
20,13,34,4,10,-6
20,13,35,15,19,-4
20,13,36,10,17,-7
20,13,37,2,8,-6
20,13,38,25,23,2
20,13,39,7,25,-18
20,13,40,18,17,1
20,13,41,6,11,-5
20,13,42,21,27,-6
20,13,43,12,26,-14
20,13,44,11,14,-3
20,13,45,4,4,0
20,13,46,11,25,-14
20,13,47,20,9,11
20,13,48,17,27,-10
20,13,49,15,24,-9
20,13,50,10,30,-20
20,13,51,5,6,-1
20,13,52,12,23,-11
20,13,53,15,25,-10
20,13,54,12,15,-3
20,13,55,16,23,-7
20,13,56,11,23,-12
20,13,57,19,18,1
20,13,58,6,14,-8
20,13,59,13,33,-20
20,13,60,7,26,-19
20,13,61,7,12,-5
20,13,62,14,26,-12
20,13,63,14,11,3
20,13,64,11,19,-8
20,13,65,10,20,-10
20,13,66,15,15,0
20,13,67,17,22,-5
20,13,68,17,28,-11
20,13,69,16,25,-9
20,13,70,22,15,7
20,13,71,25,26,-1
20,13,72,3,6,-3
20,13,73,20,16,4
20,13,74,7,21,-14
20,13,75,10,12,-2
20,13,76,12,34,-22
20,13,77,33,18,15
20,13,78,19,30,-11
20,13,79,22,20,2
20,13,80,12,21,-9
20,13,81,7,22,-15
20,13,82,19,24,-5
20,13,83,16,17,-1
20,13,84,15,14,1
20,13,85,15,15,0
20,13,86,4,7,-3
20,13,87,7,14,-7
20,13,88,7,20,-13
20,13,89,21,15,6
20,13,90,16,6,10
20,13,91,6,19,-13
20,13,92,11,28,-17
20,13,93,7,19,-12
20,13,94,15,17,-2
20,13,95,14,19,-5
20,13,96,8,17,-9
20,13,97,13,12,1
20,13,98,9,14,-5
20,13,99,11,20,-9
20,13,100,11,17,-6
20,13,101,10,6,4
20,13,102,12,19,-7
20,13,103,10,16,-6
20,13,104,9,17,-8
20,13,105,24,30,-6
20,13,106,20,30,-10
20,13,107,16,15,1
20,13,108,7,26,-19
20,13,109,10,15,-5
20,13,110,17,23,-6
20,13,111,16,19,-3
20,13,112,15,23,-8
20,13,113,9,23,-14
20,13,114,11,20,-9
20,13,115,12,19,-7
20,13,116,8,9,-1
20,13,117,20,26,-6
20,13,118,8,22,-14
20,13,119,19,12,7
20,13,120,21,23,-2
20,13,121,13,26,-13
20,13,122,10,21,-11
20,13,123,18,19,-1
20,13,124,4,14,-10
20,13,125,11,13,-2
20,13,126,17,38,-21
20,13,127,14,26,-12
20,13,128,12,15,-3
20,13,129,24,23,1
20,13,130,9,14,-5
20,13,131,14,7,7
20,13,132,19,27,-8
20,13,133,18,16,2
20,13,134,11,14,-3
20,13,135,13,17,-4
20,13,136,11,23,-12
20,13,137,8,29,-21
20,13,138,13,13,0
20,13,139,9,14,-5
20,13,140,22,24,-2
20,13,141,3,10,-7
20,13,142,18,17,1
20,13,143,26,12,14
20,13,144,15,16,-1
20,13,145,20,16,4
20,13,146,17,12,5
20,13,147,13,16,-3
20,13,148,6,15,-9
20,13,149,15,15,0
20,13,150,13,11,2
20,13,151,13,14,-1
20,13,152,16,26,-10
20,13,153,16,15,1
20,13,154,15,24,-9
20,13,155,15,36,-21
20,13,156,30,16,14
20,13,157,19,11,8
20,13,158,11,16,-5
20,13,159,9,19,-10
20,13,160,9,13,-4
20,13,161,5,17,-12
20,13,162,13,14,-1
20,13,163,23,16,7
20,13,164,17,24,-7
20,13,165,22,17,5
20,13,166,15,10,5
20,13,167,16,29,-13
20,13,168,7,22,-15
20,13,169,8,17,-9
20,13,170,14,18,-4
20,13,171,30,27,3
20,13,172,20,21,-1
20,13,173,15,24,-9
20,13,174,12,16,-4
20,13,175,15,11,4
20,13,176,12,10,2
20,13,177,20,29,-9
20,13,178,20,20,0
20,13,179,10,15,-5
20,13,180,10,16,-6
20,13,181,9,20,-11
20,13,182,5,17,-12
20,13,183,22,21,1
20,13,184,10,36,-26
20,13,185,15,31,-16
20,13,186,3,14,-11
20,13,187,18,16,2
20,13,188,14,37,-23
20,13,189,22,18,4
20,13,190,12,23,-11
20,13,191,8,16,-8
20,13,192,8,15,-7
20,13,193,17,22,-5
20,13,194,15,21,-6
20,13,195,16,13,3
20,13,196,11,9,2
20,13,197,15,19,-4
20,13,198,23,16,7
20,13,199,14,21,-7
20,13,200,3,17,-14
20,13,201,7,11,-4
20,13,202,10,21,-11
20,13,203,22,17,5
20,13,204,8,16,-8
20,13,205,14,20,-6
20,13,206,21,12,9
20,13,207,8,14,-6
20,13,208,7,15,-8
20,13,209,10,19,-9
20,13,210,13,23,-10
20,13,211,17,17,0
20,13,212,13,17,-4
20,13,213,15,21,-6
20,13,214,10,15,-5
20,13,215,16,10,6
20,13,216,11,21,-10
20,13,217,10,18,-8
20,13,218,8,21,-13
20,13,219,23,30,-7
20,13,220,8,10,-2
20,13,221,7,15,-8
20,13,222,4,7,-3
20,13,223,9,22,-13
20,13,224,17,17,0
20,13,225,14,17,-3
20,13,226,21,22,-1
20,13,227,20,18,2
20,13,228,9,21,-12
20,13,229,11,20,-9
20,13,230,15,23,-8
20,13,231,20,32,-12
20,13,232,17,19,-2
20,13,233,18,19,-1
20,13,234,14,16,-2
20,13,235,12,12,0
20,13,236,16,26,-10
20,13,237,9,10,-1
20,13,238,14,16,-2
20,13,239,6,7,-1
20,13,240,14,24,-10
20,13,241,17,15,2
20,13,242,13,23,-10
20,13,243,21,22,-1
20,13,244,22,20,2
20,13,245,19,12,7
20,13,246,16,27,-11
20,13,247,12,33,-21
20,13,248,16,11,5
20,13,249,9,5,4
20,13,250,5,12,-7
20,13,251,14,31,-17
20,13,252,13,15,-2
20,13,253,12,18,-6
20,13,254,13,18,-5
20,13,255,14,10,4
20,13,256,18,21,-3
20,13,257,9,14,-5
20,13,258,14,9,5
20,13,259,9,20,-11
20,13,260,19,11,8
20,13,261,3,17,-14
20,13,262,12,22,-10
20,13,263,2,17,-15
20,13,264,5,18,-13
20,13,265,17,25,-8
20,13,266,17,10,7
20,13,267,11,18,-7
20,13,268,12,25,-13
20,13,269,26,22,4
20,13,270,16,27,-11
20,13,271,9,22,-13
20,13,272,16,22,-6
20,13,273,10,26,-16
20,13,274,7,26,-19
20,13,275,7,18,-11
20,13,276,18,11,7
20,13,277,17,18,-1
20,13,278,11,12,-1
20,13,279,11,16,-5
20,13,280,11,16,-5
20,13,281,18,20,-2
20,13,282,16,9,7
20,13,283,11,14,-3
20,13,284,18,46,-28
20,13,285,18,24,-6
20,13,286,22,30,-8
20,13,287,6,18,-12
20,13,288,12,24,-12
20,13,289,15,14,1
20,13,290,15,13,2
20,13,291,12,21,-9
20,13,292,8,21,-13
20,13,293,18,27,-9
20,13,294,4,21,-17
20,13,295,24,30,-6
20,13,296,7,11,-4
20,13,297,19,37,-18
20,13,298,9,25,-16
20,13,299,26,25,1
20,14,0,6,23,-17
20,14,1,12,17,-5
20,14,2,15,23,-8
20,14,3,26,20,6
20,14,4,7,12,-5
20,14,5,9,22,-13
20,14,6,12,9,3
20,14,7,14,23,-9
20,14,8,16,22,-6
20,14,9,15,23,-8
20,14,10,7,14,-7
20,14,11,22,22,0
20,14,12,8,26,-18
20,14,13,10,14,-4
20,14,14,22,22,0
20,14,15,8,20,-12
20,14,16,10,6,4
20,14,17,1,23,-22
20,14,18,10,14,-4
20,14,19,13,13,0
20,14,20,11,13,-2
20,14,21,7,16,-9
20,14,22,7,12,-5
20,14,23,7,24,-17
20,14,24,9,19,-10
20,14,25,18,29,-11
20,14,26,15,20,-5
20,14,27,12,19,-7
20,14,28,14,18,-4
20,14,29,9,14,-5
20,14,30,8,18,-10
20,14,31,23,12,11
20,14,32,18,28,-10
20,14,33,7,16,-9
20,14,34,15,18,-3
20,14,35,10,20,-10
20,14,36,13,14,-1
20,14,37,13,14,-1
20,14,38,9,27,-18
20,14,39,18,17,1
20,14,40,11,17,-6
20,14,41,13,14,-1
20,14,42,36,31,5
20,14,43,6,18,-12
20,14,44,16,18,-2
20,14,45,20,18,2
20,14,46,21,13,8
20,14,47,20,27,-7
20,14,48,21,18,3
20,14,49,14,24,-10
20,14,50,13,27,-14
20,14,51,6,18,-12
20,14,52,10,15,-5
20,14,53,13,18,-5
20,14,54,7,8,-1
20,14,55,24,22,2
20,14,56,14,26,-12
20,14,57,9,12,-3
20,14,58,14,10,4
20,14,59,13,27,-14
20,14,60,17,15,2
20,14,61,7,12,-5
20,14,62,8,26,-18
20,14,63,7,11,-4
20,14,64,14,16,-2
20,14,65,11,23,-12
20,14,66,19,20,-1
20,14,67,5,10,-5
20,14,68,10,20,-10
20,14,69,10,9,1
20,14,70,5,9,-4
20,14,71,6,5,1
20,14,72,15,29,-14
20,14,73,17,15,2
20,14,74,10,15,-5
20,14,75,10,12,-2
20,14,76,18,23,-5
20,14,77,13,12,1
20,14,78,15,19,-4
20,14,79,8,19,-11
20,14,80,10,24,-14
20,14,81,13,23,-10
20,14,82,3,18,-15
20,14,83,29,17,12
20,14,84,23,19,4
20,14,85,14,17,-3
20,14,86,14,19,-5
20,14,87,13,12,1
20,14,88,20,19,1
20,14,89,7,21,-14
20,14,90,13,10,3
20,14,91,22,21,1
20,14,92,17,23,-6
20,14,93,24,12,12
20,14,94,15,13,2
20,14,95,5,12,-7
20,14,96,16,22,-6
20,14,97,9,20,-11
20,14,98,15,21,-6
20,14,99,6,9,-3
20,14,100,17,13,4
20,14,101,13,21,-8
20,14,102,12,11,1
20,14,103,20,23,-3
20,14,104,11,21,-10
20,14,105,9,6,3
20,14,106,20,30,-10
20,14,107,21,20,1
20,14,108,15,13,2
20,14,109,23,20,3
20,14,110,7,26,-19
20,14,111,10,15,-5
20,14,112,10,6,4
20,14,113,10,13,-3
20,14,114,5,10,-5
20,14,115,10,19,-9
20,14,116,13,15,-2
20,14,117,7,9,-2
20,14,118,12,23,-11
20,14,119,17,21,-4
20,14,120,4,15,-11
20,14,121,23,25,-2
20,14,122,10,17,-7
20,14,123,14,24,-10
20,14,124,14,24,-10
20,14,125,13,16,-3
20,14,126,7,12,-5
20,14,127,14,23,-9
20,14,128,10,13,-3
20,14,129,19,19,0
20,14,130,30,21,9
20,14,131,3,10,-7
20,14,132,9,9,0
20,14,133,16,16,0
20,14,134,19,21,-2
20,14,135,15,11,4
20,14,136,6,23,-17
20,14,137,21,25,-4
20,14,138,4,33,-29
20,14,139,9,20,-11
20,14,140,5,14,-9
20,14,141,14,24,-10
20,14,142,20,11,9
20,14,143,14,18,-4
20,14,144,14,13,1
20,14,145,20,17,3
20,14,146,8,29,-21
20,14,147,9,16,-7
20,14,148,21,18,3
20,14,149,6,25,-19
20,14,150,13,13,0
20,14,151,17,23,-6
20,14,152,16,32,-16
20,14,153,15,19,-4
20,14,154,26,14,12
20,14,155,21,17,4
20,14,156,24,18,6
20,14,157,22,11,11
20,14,158,7,12,-5
20,14,159,8,28,-20
20,14,160,13,19,-6
20,14,161,5,19,-14
20,14,162,11,35,-24
20,14,163,19,31,-12
20,14,164,11,8,3
20,14,165,20,20,0
20,14,166,20,9,11
20,14,167,9,22,-13
20,14,168,12,28,-16
20,14,169,14,23,-9
20,14,170,12,18,-6
20,14,171,5,19,-14
20,14,172,7,14,-7
20,14,173,27,16,11
20,14,174,9,18,-9
20,14,175,4,27,-23
20,14,176,12,29,-17
20,14,177,17,15,2
20,14,178,15,8,7
20,14,179,14,5,9
20,14,180,5,20,-15
20,14,181,8,7,1
20,14,182,12,17,-5
20,14,183,11,13,-2
20,14,184,12,22,-10
20,14,185,16,16,0
20,14,186,12,17,-5
20,14,187,3,15,-12
20,14,188,17,15,2
20,14,189,15,13,2
20,14,190,12,8,4
20,14,191,15,16,-1
20,14,192,20,20,0
20,14,193,13,9,4
20,14,194,10,19,-9
20,14,195,8,16,-8
20,14,196,13,26,-13
20,14,197,10,15,-5
20,14,198,12,14,-2
20,14,199,21,18,3
20,14,200,26,20,6
20,14,201,17,15,2
20,14,202,8,19,-11
20,14,203,13,19,-6
20,14,204,18,28,-10
20,14,205,16,15,1
20,14,206,10,20,-10
20,14,207,8,12,-4
20,14,208,10,7,3
20,14,209,3,15,-12
20,14,210,9,8,1
20,14,211,14,10,4
20,14,212,11,16,-5
20,14,213,19,15,4
20,14,214,14,4,10
20,14,215,14,26,-12
20,14,216,16,20,-4
20,14,217,13,15,-2
20,14,218,11,7,4
20,14,219,13,13,0
20,14,220,12,18,-6
20,14,221,10,14,-4
20,14,222,15,20,-5
20,14,223,21,25,-4
20,14,224,16,9,7
20,14,225,29,16,13
20,14,226,5,23,-18
20,14,227,11,26,-15
20,14,228,13,26,-13
20,14,229,15,17,-2
20,14,230,19,24,-5
20,14,231,10,30,-20
20,14,232,8,4,4
20,14,233,12,12,0
20,14,234,8,10,-2
20,14,235,20,10,10
20,14,236,11,6,5
20,14,237,12,24,-12
20,14,238,18,33,-15
20,14,239,13,15,-2
20,14,240,14,9,5
20,14,241,20,16,4
20,14,242,15,25,-10
20,14,243,9,13,-4
20,14,244,8,17,-9
20,14,245,12,28,-16
20,14,246,10,19,-9
20,14,247,8,6,2
20,14,248,16,13,3
20,14,249,11,16,-5
20,14,250,15,17,-2
20,14,251,12,19,-7
20,14,252,8,13,-5
20,14,253,9,17,-8
20,14,254,12,18,-6
20,14,255,11,16,-5
20,14,256,27,14,13
20,14,257,8,9,-1
20,14,258,11,15,-4
20,14,259,18,18,0
20,14,260,7,18,-11
20,14,261,12,23,-11
20,14,262,14,21,-7
20,14,263,16,39,-23
20,14,264,3,21,-18
20,14,265,13,28,-15
20,14,266,19,32,-13
20,14,267,9,17,-8
20,14,268,17,21,-4
20,14,269,18,15,3
20,14,270,9,30,-21
20,14,271,18,19,-1
20,14,272,13,20,-7
20,14,273,10,20,-10
20,14,274,17,18,-1
20,14,275,25,15,10
20,14,276,7,22,-15
20,14,277,5,18,-13
20,14,278,15,11,4
20,14,279,8,27,-19
20,14,280,4,19,-15
20,14,281,20,31,-11
20,14,282,16,10,6
20,14,283,20,21,-1
20,14,284,13,18,-5
20,14,285,23,26,-3
20,14,286,18,19,-1
20,14,287,23,11,12
20,14,288,13,23,-10
20,14,289,11,14,-3
20,14,290,12,17,-5
20,14,291,18,15,3
20,14,292,14,14,0
20,14,293,8,11,-3
20,14,294,16,13,3
20,14,295,17,27,-10
20,14,296,11,10,1
20,14,297,20,17,3
20,14,298,23,6,17
20,14,299,16,22,-6
20,15,0,14,17,-3
20,15,1,22,27,-5
20,15,2,8,6,2
20,15,3,23,14,9
20,15,4,4,7,-3
20,15,5,13,17,-4
20,15,6,8,22,-14
20,15,7,10,7,3
20,15,8,9,9,0
20,15,9,7,24,-17
20,15,10,7,8,-1
20,15,11,11,12,-1
20,15,12,18,16,2
20,15,13,18,16,2
20,15,14,15,19,-4
20,15,15,11,16,-5
20,15,16,13,21,-8
20,15,17,11,16,-5
20,15,18,9,22,-13
20,15,19,19,19,0
20,15,20,23,16,7
20,15,21,3,13,-10
20,15,22,20,15,5
20,15,23,8,5,3
20,15,24,6,9,-3
20,15,25,19,14,5
20,15,26,10,10,0
20,15,27,22,21,1
20,15,28,26,16,10
20,15,29,10,17,-7
20,15,30,11,20,-9
20,15,31,21,16,5
20,15,32,19,11,8
20,15,33,14,21,-7
20,15,34,23,12,11
20,15,35,20,9,11
20,15,36,10,20,-10
20,15,37,16,18,-2
20,15,38,13,13,0
20,15,39,8,9,-1
20,15,40,6,12,-6
20,15,41,21,17,4
20,15,42,14,26,-12
20,15,43,5,21,-16
20,15,44,16,19,-3
20,15,45,18,14,4
20,15,46,10,16,-6
20,15,47,16,10,6
20,15,48,28,38,-10
20,15,49,12,8,4
20,15,50,10,23,-13
20,15,51,12,19,-7
20,15,52,21,14,7
20,15,53,13,19,-6
20,15,54,21,28,-7
20,15,55,12,21,-9
20,15,56,10,15,-5
20,15,57,13,19,-6
20,15,58,13,5,8
20,15,59,10,27,-17
20,15,60,21,17,4
20,15,61,10,15,-5
20,15,62,17,20,-3
20,15,63,12,15,-3
20,15,64,17,22,-5
20,15,65,9,13,-4
20,15,66,17,20,-3
20,15,67,19,25,-6
20,15,68,8,13,-5
20,15,69,15,13,2
20,15,70,17,22,-5
20,15,71,27,31,-4
20,15,72,14,8,6
20,15,73,15,20,-5
20,15,74,4,4,0
20,15,75,15,7,8
20,15,76,14,30,-16
20,15,77,28,32,-4
20,15,78,11,17,-6
20,15,79,24,19,5
20,15,80,12,20,-8
20,15,81,19,21,-2
20,15,82,15,8,7
20,15,83,7,28,-21
20,15,84,26,10,16
20,15,85,14,8,6
20,15,86,12,23,-11
20,15,87,12,16,-4
20,15,88,14,9,5
20,15,89,7,12,-5
20,15,90,13,18,-5
20,15,91,13,22,-9
20,15,92,14,26,-12
20,15,93,19,27,-8
20,15,94,13,18,-5
20,15,95,17,16,1
20,15,96,14,18,-4
20,15,97,14,14,0
20,15,98,11,9,2
20,15,99,5,20,-15
20,15,100,13,20,-7
20,15,101,7,19,-12
20,15,102,22,13,9
20,15,103,22,17,5
20,15,104,19,23,-4
20,15,105,12,22,-10
20,15,106,9,20,-11
20,15,107,8,12,-4
20,15,108,10,14,-4
20,15,109,13,23,-10
20,15,110,18,32,-14
20,15,111,15,21,-6
20,15,112,21,14,7
20,15,113,6,15,-9
20,15,114,28,24,4
20,15,115,10,22,-12
20,15,116,12,14,-2
20,15,117,10,16,-6
20,15,118,17,18,-1
20,15,119,18,20,-2
20,15,120,21,11,10
20,15,121,7,12,-5
20,15,122,4,17,-13
20,15,123,7,20,-13
20,15,124,19,13,6
20,15,125,23,26,-3
20,15,126,8,13,-5
20,15,127,20,12,8
20,15,128,15,22,-7
20,15,129,8,20,-12
20,15,130,19,19,0
20,15,131,13,17,-4
20,15,132,7,21,-14
20,15,133,15,7,8
20,15,134,13,25,-12
20,15,135,7,12,-5
20,15,136,25,25,0
20,15,137,13,23,-10
20,15,138,14,13,1
20,15,139,20,22,-2
20,15,140,22,21,1
20,15,141,15,19,-4
20,15,142,18,25,-7
20,15,143,15,19,-4
20,15,144,9,20,-11
20,15,145,26,18,8
20,15,146,14,20,-6
20,15,147,15,20,-5
20,15,148,29,21,8
20,15,149,17,12,5
20,15,150,14,15,-1
20,15,151,8,24,-16
20,15,152,11,16,-5
20,15,153,15,13,2
20,15,154,9,11,-2
20,15,155,3,14,-11
20,15,156,15,16,-1
20,15,157,12,20,-8
20,15,158,13,11,2
20,15,159,6,11,-5
20,15,160,19,11,8
20,15,161,3,20,-17
20,15,162,13,12,1
20,15,163,7,11,-4
20,15,164,12,25,-13
20,15,165,20,38,-18
20,15,166,7,15,-8
20,15,167,5,16,-11
20,15,168,8,19,-11
20,15,169,10,11,-1
20,15,170,18,12,6
20,15,171,12,18,-6
20,15,172,18,16,2
20,15,173,16,16,0
20,15,174,11,10,1
20,15,175,21,13,8
20,15,176,7,18,-11
20,15,177,17,7,10
20,15,178,11,24,-13
20,15,179,14,15,-1
20,15,180,12,13,-1
20,15,181,17,9,8
20,15,182,9,8,1
20,15,183,14,17,-3
20,15,184,13,19,-6
20,15,185,6,14,-8
20,15,186,13,30,-17
20,15,187,14,21,-7
20,15,188,12,9,3
20,15,189,15,13,2
20,15,190,7,16,-9
20,15,191,9,39,-30
20,15,192,18,24,-6
20,15,193,6,24,-18
20,15,194,10,13,-3
20,15,195,6,20,-14
20,15,196,15,25,-10
20,15,197,12,14,-2
20,15,198,17,15,2
20,15,199,5,11,-6
20,15,200,14,6,8
20,15,201,10,7,3
20,15,202,6,17,-11
20,15,203,15,31,-16
20,15,204,15,19,-4
20,15,205,13,14,-1
20,15,206,14,21,-7
20,15,207,11,26,-15
20,15,208,12,18,-6
20,15,209,14,26,-12
20,15,210,24,32,-8
20,15,211,8,10,-2
20,15,212,11,8,3
20,15,213,17,19,-2
20,15,214,8,7,1
20,15,215,18,20,-2
20,15,216,9,20,-11
20,15,217,21,30,-9
20,15,218,9,16,-7
20,15,219,16,24,-8
20,15,220,16,26,-10
20,15,221,25,16,9
20,15,222,19,11,8
20,15,223,22,19,3
20,15,224,13,17,-4
20,15,225,10,7,3
20,15,226,11,10,1
20,15,227,18,20,-2
20,15,228,12,18,-6
20,15,229,22,18,4
20,15,230,18,11,7
20,15,231,19,18,1
20,15,232,12,21,-9
20,15,233,11,10,1
20,15,234,25,9,16
20,15,235,15,22,-7
20,15,236,9,23,-14
20,15,237,12,11,1
20,15,238,10,12,-2
20,15,239,7,4,3
20,15,240,18,27,-9
20,15,241,14,11,3
20,15,242,21,12,9
20,15,243,23,30,-7
20,15,244,23,29,-6
20,15,245,21,16,5
20,15,246,13,16,-3
20,15,247,17,16,1
20,15,248,12,27,-15
20,15,249,15,27,-12
20,15,250,15,12,3
20,15,251,12,4,8
20,15,252,11,27,-16
20,15,253,15,30,-15
20,15,254,8,10,-2
20,15,255,12,18,-6
20,15,256,13,24,-11
20,15,257,20,29,-9
20,15,258,17,28,-11
20,15,259,15,18,-3
20,15,260,14,7,7
20,15,261,10,10,0
20,15,262,6,22,-16
20,15,263,11,13,-2
20,15,264,7,11,-4
20,15,265,8,8,0
20,15,266,10,15,-5
20,15,267,11,11,0
20,15,268,22,18,4
20,15,269,7,7,0
20,15,270,18,19,-1
20,15,271,5,18,-13
20,15,272,10,27,-17
20,15,273,16,23,-7
20,15,274,22,31,-9
20,15,275,20,11,9
20,15,276,15,12,3
20,15,277,10,13,-3
20,15,278,13,24,-11
20,15,279,3,17,-14
20,15,280,7,31,-24
20,15,281,7,18,-11
20,15,282,14,17,-3
20,15,283,22,18,4
20,15,284,20,9,11
20,15,285,19,18,1
20,15,286,9,12,-3
20,15,287,7,14,-7
20,15,288,17,29,-12
20,15,289,35,19,16
20,15,290,9,24,-15
20,15,291,13,21,-8
20,15,292,9,15,-6
20,15,293,15,14,1
20,15,294,12,22,-10
20,15,295,17,31,-14
20,15,296,12,12,0
20,15,297,11,7,4
20,15,298,17,5,12
20,15,299,13,13,0
20,16,0,4,2,2
20,16,1,10,16,-6
20,16,2,12,11,1
20,16,3,20,22,-2
20,16,4,14,16,-2
20,16,5,20,12,8
20,16,6,12,6,6
20,16,7,18,28,-10
20,16,8,18,27,-9
20,16,9,9,15,-6
20,16,10,19,18,1
20,16,11,20,19,1
20,16,12,10,20,-10
20,16,13,9,9,0
20,16,14,21,14,7
20,16,15,4,15,-11
20,16,16,15,18,-3
20,16,17,19,17,2
20,16,18,12,8,4
20,16,19,3,22,-19
20,16,20,15,30,-15
20,16,21,13,13,0
20,16,22,11,13,-2
20,16,23,22,9,13
20,16,24,12,15,-3
20,16,25,10,10,0
20,16,26,7,20,-13
20,16,27,18,15,3
20,16,28,16,19,-3
20,16,29,11,21,-10
20,16,30,13,25,-12
20,16,31,27,16,11
20,16,32,13,6,7
20,16,33,13,18,-5
20,16,34,16,37,-21
20,16,35,15,23,-8
20,16,36,12,9,3
20,16,37,30,16,14
20,16,38,17,33,-16
20,16,39,18,11,7
20,16,40,11,24,-13
20,16,41,24,10,14
20,16,42,16,20,-4
20,16,43,16,21,-5
20,16,44,31,23,8
20,16,45,11,24,-13
20,16,46,4,23,-19
20,16,47,17,11,6
20,16,48,7,14,-7
20,16,49,15,14,1
20,16,50,16,19,-3
20,16,51,17,26,-9
20,16,52,25,19,6
20,16,53,21,17,4
20,16,54,13,29,-16
20,16,55,8,6,2
20,16,56,9,12,-3
20,16,57,9,21,-12
20,16,58,18,19,-1
20,16,59,4,11,-7
20,16,60,19,25,-6
20,16,61,7,22,-15
20,16,62,3,12,-9
20,16,63,13,14,-1
20,16,64,15,10,5
20,16,65,14,13,1
20,16,66,26,9,17
20,16,67,5,10,-5
20,16,68,7,16,-9
20,16,69,12,26,-14
20,16,70,13,12,1
20,16,71,14,20,-6
20,16,72,12,12,0
20,16,73,13,14,-1
20,16,74,19,8,11
20,16,75,13,14,-1
20,16,76,13,19,-6
20,16,77,22,18,4
20,16,78,15,7,8
20,16,79,22,15,7
20,16,80,11,9,2
20,16,81,8,25,-17
20,16,82,29,25,4
20,16,83,8,15,-7
20,16,84,10,7,3
20,16,85,21,25,-4
20,16,86,13,13,0
20,16,87,19,13,6
20,16,88,15,14,1
20,16,89,5,10,-5
20,16,90,6,11,-5
20,16,91,16,10,6
20,16,92,23,21,2
20,16,93,11,15,-4
20,16,94,9,18,-9
20,16,95,2,18,-16
20,16,96,36,14,22
20,16,97,11,19,-8
20,16,98,8,15,-7
20,16,99,15,15,0
20,16,100,26,13,13
20,16,101,11,11,0
20,16,102,16,16,0
20,16,103,16,18,-2
20,16,104,19,15,4
20,16,105,6,12,-6
20,16,106,5,14,-9
20,16,107,9,8,1
20,16,108,14,12,2
20,16,109,12,27,-15
20,16,110,15,17,-2
20,16,111,12,21,-9
20,16,112,13,12,1
20,16,113,16,12,4
20,16,114,12,26,-14
20,16,115,8,5,3
20,16,116,7,13,-6
20,16,117,12,9,3
20,16,118,15,15,0
20,16,119,15,34,-19
20,16,120,17,17,0
20,16,121,12,16,-4
20,16,122,13,13,0
20,16,123,16,25,-9
20,16,124,27,21,6
20,16,125,13,18,-5
20,16,126,16,20,-4
20,16,127,12,30,-18
20,16,128,11,18,-7
20,16,129,15,13,2
20,16,130,9,18,-9
20,16,131,14,28,-14
20,16,132,22,22,0
20,16,133,34,27,7
20,16,134,15,10,5
20,16,135,19,24,-5
20,16,136,5,9,-4
20,16,137,24,22,2
20,16,138,23,18,5
20,16,139,15,16,-1
20,16,140,15,24,-9
20,16,141,15,20,-5
20,16,142,11,23,-12
20,16,143,21,19,2
20,16,144,19,11,8
20,16,145,24,26,-2
20,16,146,15,20,-5
20,16,147,21,17,4
20,16,148,22,24,-2
20,16,149,15,14,1
20,16,150,9,27,-18
20,16,151,23,20,3
20,16,152,18,15,3
20,16,153,10,20,-10
20,16,154,18,23,-5
20,16,155,8,11,-3
20,16,156,10,14,-4
20,16,157,18,23,-5
20,16,158,17,13,4
20,16,159,22,31,-9
20,16,160,11,15,-4
20,16,161,12,6,6
20,16,162,13,8,5
20,16,163,7,17,-10
20,16,164,19,14,5
20,16,165,22,12,10
20,16,166,17,19,-2
20,16,167,23,9,14
20,16,168,20,22,-2
20,16,169,19,8,11
20,16,170,14,18,-4
20,16,171,16,23,-7
20,16,172,6,12,-6
20,16,173,26,15,11
20,16,174,19,28,-9
20,16,175,15,20,-5
20,16,176,8,12,-4
20,16,177,11,5,6
20,16,178,13,15,-2
20,16,179,10,28,-18
20,16,180,6,19,-13
20,16,181,6,10,-4
20,16,182,15,28,-13
20,16,183,5,21,-16
20,16,184,13,18,-5
20,16,185,5,15,-10
20,16,186,9,14,-5
20,16,187,12,12,0
20,16,188,10,12,-2
20,16,189,10,15,-5
20,16,190,7,20,-13
20,16,191,12,34,-22
20,16,192,22,11,11
20,16,193,14,20,-6
20,16,194,7,35,-28
20,16,195,15,22,-7
20,16,196,15,18,-3
20,16,197,8,25,-17
20,16,198,10,17,-7
20,16,199,11,20,-9
20,16,200,19,31,-12
20,16,201,23,28,-5
20,16,202,10,32,-22
20,16,203,6,23,-17
20,16,204,14,12,2
20,16,205,22,26,-4
20,16,206,13,13,0
20,16,207,13,14,-1
20,16,208,17,16,1
20,16,209,20,12,8
20,16,210,13,17,-4
20,16,211,16,15,1
20,16,212,5,14,-9
20,16,213,13,21,-8
20,16,214,9,13,-4
20,16,215,12,8,4
20,16,216,14,14,0
20,16,217,21,8,13
20,16,218,9,11,-2
20,16,219,10,16,-6
20,16,220,17,24,-7
20,16,221,21,25,-4
20,16,222,24,14,10
20,16,223,22,28,-6
20,16,224,10,26,-16
20,16,225,7,14,-7
20,16,226,18,20,-2
20,16,227,21,14,7
20,16,228,14,25,-11
20,16,229,13,12,1
20,16,230,32,9,23
20,16,231,15,20,-5
20,16,232,10,21,-11
20,16,233,18,12,6
20,16,234,16,10,6
20,16,235,8,21,-13
20,16,236,14,13,1
20,16,237,6,17,-11
20,16,238,8,24,-16
20,16,239,9,8,1
20,16,240,25,24,1
20,16,241,8,23,-15
20,16,242,13,33,-20
20,16,243,14,15,-1
20,16,244,20,9,11
20,16,245,15,18,-3
20,16,246,20,21,-1
20,16,247,17,20,-3
20,16,248,12,11,1
20,16,249,16,22,-6
20,16,250,13,23,-10
20,16,251,7,22,-15
20,16,252,15,14,1
20,16,253,11,15,-4
20,16,254,16,35,-19
20,16,255,18,20,-2
20,16,256,29,12,17
20,16,257,14,15,-1
20,16,258,19,12,7
20,16,259,18,3,15
20,16,260,19,27,-8
20,16,261,13,10,3
20,16,262,4,15,-11
20,16,263,7,16,-9
20,16,264,8,28,-20
20,16,265,13,19,-6
20,16,266,17,19,-2
20,16,267,20,23,-3
20,16,268,9,12,-3
20,16,269,22,19,3
20,16,270,12,6,6
20,16,271,6,23,-17
20,16,272,10,24,-14
20,16,273,15,18,-3
20,16,274,20,14,6
20,16,275,5,11,-6
20,16,276,15,10,5
20,16,277,17,10,7
20,16,278,24,23,1
20,16,279,10,18,-8
20,16,280,22,13,9
20,16,281,15,42,-27
20,16,282,11,28,-17
20,16,283,8,14,-6
20,16,284,32,26,6
20,16,285,13,16,-3
20,16,286,13,7,6
20,16,287,11,23,-12
20,16,288,30,12,18
20,16,289,14,16,-2
20,16,290,21,27,-6
20,16,291,12,6,6
20,16,292,7,19,-12
20,16,293,14,19,-5
20,16,294,10,27,-17
20,16,295,8,10,-2
20,16,296,14,20,-6
20,16,297,16,26,-10
20,16,298,7,14,-7
20,16,299,13,19,-6
20,17,0,21,13,8
20,17,1,18,38,-20
20,17,2,20,15,5
20,17,3,6,18,-12
20,17,4,6,13,-7
20,17,5,15,13,2
20,17,6,6,8,-2
20,17,7,11,18,-7
20,17,8,21,18,3
20,17,9,7,8,-1
20,17,10,15,11,4
20,17,11,12,16,-4
20,17,12,13,21,-8
20,17,13,14,17,-3
20,17,14,22,10,12
20,17,15,4,18,-14
20,17,16,17,16,1
20,17,17,12,27,-15
20,17,18,5,1,4
20,17,19,17,13,4
20,17,20,8,15,-7
20,17,21,8,14,-6
20,17,22,7,12,-5
20,17,23,19,15,4
20,17,24,10,19,-9
20,17,25,20,23,-3
20,17,26,10,25,-15
20,17,27,20,29,-9
20,17,28,13,10,3
20,17,29,13,30,-17
20,17,30,20,9,11
20,17,31,16,12,4
20,17,32,9,17,-8
20,17,33,18,13,5
20,17,34,17,21,-4
20,17,35,15,27,-12
20,17,36,9,12,-3
20,17,37,17,22,-5
20,17,38,21,22,-1
20,17,39,17,10,7
20,17,40,7,17,-10
20,17,41,16,24,-8
20,17,42,13,38,-25
20,17,43,18,23,-5
20,17,44,10,12,-2
20,17,45,18,18,0
20,17,46,19,21,-2
20,17,47,11,34,-23
20,17,48,24,26,-2
20,17,49,9,9,0
20,17,50,28,13,15
20,17,51,18,17,1
20,17,52,21,18,3
20,17,53,15,27,-12
20,17,54,16,22,-6
20,17,55,19,11,8
20,17,56,4,8,-4
20,17,57,14,29,-15
20,17,58,26,13,13
20,17,59,13,5,8
20,17,60,9,21,-12
20,17,61,13,21,-8
20,17,62,15,14,1
20,17,63,11,10,1
20,17,64,17,10,7
20,17,65,18,28,-10
20,17,66,19,14,5
20,17,67,29,21,8
20,17,68,24,14,10
20,17,69,22,18,4
20,17,70,18,16,2
20,17,71,15,13,2
20,17,72,15,11,4
20,17,73,6,13,-7
20,17,74,11,7,4
20,17,75,10,20,-10
20,17,76,7,12,-5
20,17,77,14,18,-4
20,17,78,7,10,-3
20,17,79,17,14,3
20,17,80,24,22,2
20,17,81,7,12,-5
20,17,82,22,24,-2
20,17,83,11,15,-4
20,17,84,16,18,-2
20,17,85,16,18,-2
20,17,86,17,12,5
20,17,87,13,26,-13
20,17,88,21,12,9
20,17,89,18,15,3
20,17,90,24,14,10
20,17,91,11,9,2
20,17,92,1,12,-11
20,17,93,18,28,-10
20,17,94,13,10,3
20,17,95,15,20,-5
20,17,96,24,12,12
20,17,97,26,19,7
20,17,98,16,17,-1
20,17,99,20,19,1
20,17,100,10,11,-1
20,17,101,3,9,-6
20,17,102,12,15,-3
20,17,103,10,12,-2
20,17,104,5,16,-11
20,17,105,3,7,-4
20,17,106,21,12,9
20,17,107,17,22,-5
20,17,108,13,28,-15
20,17,109,7,9,-2
20,17,110,27,17,10
20,17,111,20,17,3
20,17,112,4,21,-17
20,17,113,1,15,-14
20,17,114,25,10,15
20,17,115,15,23,-8
20,17,116,10,17,-7
20,17,117,19,15,4
20,17,118,15,19,-4
20,17,119,8,9,-1
20,17,120,9,16,-7
20,17,121,8,12,-4
20,17,122,14,22,-8
20,17,123,14,21,-7
20,17,124,14,32,-18
20,17,125,23,9,14
20,17,126,12,19,-7
20,17,127,10,29,-19
20,17,128,8,17,-9
20,17,129,26,26,0
20,17,130,13,26,-13
20,17,131,7,23,-16
20,17,132,13,20,-7
20,17,133,25,21,4
20,17,134,5,2,3
20,17,135,12,7,5
20,17,136,14,10,4
20,17,137,3,16,-13
20,17,138,11,15,-4
20,17,139,32,26,6
20,17,140,13,16,-3
20,17,141,10,2,8
20,17,142,18,22,-4
20,17,143,12,25,-13
20,17,144,12,17,-5
20,17,145,12,10,2
20,17,146,9,15,-6
20,17,147,8,20,-12
20,17,148,10,17,-7
20,17,149,8,12,-4
20,17,150,17,13,4
20,17,151,11,17,-6
20,17,152,8,31,-23
20,17,153,10,14,-4
20,17,154,26,16,10
20,17,155,12,14,-2
20,17,156,19,25,-6
20,17,157,17,13,4
20,17,158,10,13,-3
20,17,159,5,24,-19
20,17,160,15,19,-4
20,17,161,15,17,-2
20,17,162,15,18,-3
20,17,163,10,15,-5
20,17,164,12,16,-4
20,17,165,9,22,-13
20,17,166,12,10,2
20,17,167,7,4,3
20,17,168,8,14,-6
20,17,169,12,16,-4
20,17,170,22,7,15
20,17,171,9,11,-2
20,17,172,16,23,-7
20,17,173,10,10,0
20,17,174,9,11,-2
20,17,175,17,17,0
20,17,176,31,24,7
20,17,177,22,10,12
20,17,178,9,11,-2
20,17,179,13,12,1
20,17,180,7,18,-11
20,17,181,17,15,2
20,17,182,5,17,-12
20,17,183,3,12,-9
20,17,184,22,25,-3
20,17,185,6,3,3
20,17,186,13,18,-5
20,17,187,15,20,-5
20,17,188,15,17,-2
20,17,189,16,18,-2
20,17,190,20,24,-4
20,17,191,13,9,4
20,17,192,12,12,0
20,17,193,8,11,-3
20,17,194,13,11,2
20,17,195,26,11,15
20,17,196,14,20,-6
20,17,197,13,9,4
20,17,198,11,17,-6
20,17,199,27,28,-1
20,17,200,13,12,1
20,17,201,14,23,-9
20,17,202,12,14,-2
20,17,203,18,8,10
20,17,204,12,6,6
20,17,205,12,9,3
20,17,206,7,10,-3
20,17,207,11,26,-15
20,17,208,13,14,-1
20,17,209,22,14,8
20,17,210,15,13,2
20,17,211,9,16,-7
20,17,212,17,19,-2
20,17,213,23,16,7
20,17,214,9,19,-10
20,17,215,8,11,-3
20,17,216,20,19,1
20,17,217,25,22,3
20,17,218,14,17,-3
20,17,219,21,26,-5
20,17,220,24,26,-2
20,17,221,23,11,12
20,17,222,15,13,2
20,17,223,20,19,1
20,17,224,14,21,-7
20,17,225,16,17,-1
20,17,226,6,11,-5
20,17,227,16,16,0
20,17,228,11,13,-2
20,17,229,14,24,-10
20,17,230,15,25,-10
20,17,231,10,15,-5
20,17,232,10,25,-15
20,17,233,17,13,4
20,17,234,9,11,-2
20,17,235,14,16,-2
20,17,236,10,9,1
20,17,237,10,17,-7
20,17,238,14,12,2
20,17,239,28,21,7
20,17,240,10,20,-10
20,17,241,11,8,3
20,17,242,21,14,7
20,17,243,5,7,-2
20,17,244,16,16,0
20,17,245,13,19,-6
20,17,246,18,16,2
20,17,247,10,15,-5
20,17,248,8,18,-10
20,17,249,17,14,3
20,17,250,14,29,-15
20,17,251,10,13,-3
20,17,252,7,10,-3
20,17,253,19,20,-1
20,17,254,6,13,-7
20,17,255,9,20,-11
20,17,256,13,11,2
20,17,257,4,9,-5
20,17,258,23,25,-2
20,17,259,8,7,1
20,17,260,17,10,7
20,17,261,22,15,7
20,17,262,9,12,-3
20,17,263,18,14,4
20,17,264,17,9,8
20,17,265,8,21,-13
20,17,266,19,10,9
20,17,267,11,13,-2
20,17,268,13,16,-3
20,17,269,11,16,-5
20,17,270,10,11,-1
20,17,271,12,15,-3
20,17,272,14,23,-9
20,17,273,19,9,10
20,17,274,7,12,-5
20,17,275,19,13,6
20,17,276,12,14,-2
20,17,277,23,17,6
20,17,278,26,15,11
20,17,279,11,6,5
20,17,280,16,13,3
20,17,281,14,20,-6
20,17,282,10,18,-8
20,17,283,10,16,-6
20,17,284,15,20,-5
20,17,285,8,12,-4
20,17,286,18,12,6
20,17,287,5,14,-9
20,17,288,14,26,-12
20,17,289,12,21,-9
20,17,290,12,15,-3
20,17,291,16,24,-8
20,17,292,11,14,-3
20,17,293,19,5,14
20,17,294,20,10,10
20,17,295,4,8,-4
20,17,296,12,21,-9
20,17,297,18,20,-2
20,17,298,14,6,8
20,17,299,23,7,16
20,18,0,15,14,1
20,18,1,21,16,5
20,18,2,18,15,3
20,18,3,5,10,-5
20,18,4,7,16,-9
20,18,5,10,18,-8
20,18,6,10,10,0
20,18,7,16,16,0
20,18,8,16,16,0
20,18,9,13,16,-3
20,18,10,16,26,-10
20,18,11,5,16,-11
20,18,12,23,26,-3
20,18,13,13,7,6
20,18,14,17,10,7
20,18,15,17,12,5
20,18,16,11,9,2
20,18,17,20,23,-3
20,18,18,8,21,-13
20,18,19,14,17,-3
20,18,20,21,18,3
20,18,21,21,13,8
20,18,22,18,30,-12
20,18,23,15,15,0
20,18,24,5,18,-13
20,18,25,9,15,-6
20,18,26,11,20,-9
20,18,27,7,10,-3
20,18,28,31,19,12
20,18,29,14,20,-6
20,18,30,12,11,1
20,18,31,17,9,8
20,18,32,11,17,-6
20,18,33,24,17,7
20,18,34,9,17,-8
20,18,35,18,25,-7
20,18,36,23,12,11
20,18,37,10,6,4
20,18,38,23,27,-4
20,18,39,11,10,1
20,18,40,10,6,4
20,18,41,15,13,2
20,18,42,19,23,-4
20,18,43,16,17,-1
20,18,44,23,12,11
20,18,45,7,8,-1
20,18,46,17,12,5
20,18,47,36,20,16
20,18,48,14,12,2
20,18,49,10,25,-15
20,18,50,15,15,0
20,18,51,16,17,-1
20,18,52,11,11,0
20,18,53,15,22,-7
20,18,54,13,11,2
20,18,55,16,16,0
20,18,56,3,10,-7
20,18,57,15,19,-4
20,18,58,17,23,-6
20,18,59,18,10,8
20,18,60,21,17,4
20,18,61,14,13,1
20,18,62,13,19,-6
20,18,63,10,12,-2
20,18,64,8,22,-14
20,18,65,13,12,1
20,18,66,10,11,-1
20,18,67,13,22,-9
20,18,68,22,20,2
20,18,69,24,19,5
20,18,70,6,17,-11
20,18,71,15,15,0
20,18,72,10,19,-9
20,18,73,14,9,5
20,18,74,18,13,5
20,18,75,16,11,5
20,18,76,12,10,2
20,18,77,14,9,5
20,18,78,7,10,-3
20,18,79,5,25,-20
20,18,80,5,14,-9
20,18,81,12,14,-2
20,18,82,6,12,-6
20,18,83,10,14,-4
20,18,84,18,12,6
20,18,85,15,9,6
20,18,86,11,14,-3
20,18,87,13,29,-16
20,18,88,14,25,-11
20,18,89,21,20,1
20,18,90,13,21,-8
20,18,91,6,10,-4
20,18,92,20,21,-1
20,18,93,24,17,7
20,18,94,20,17,3
20,18,95,24,22,2
20,18,96,15,10,5
20,18,97,15,15,0
20,18,98,14,14,0
20,18,99,12,10,2
20,18,100,15,18,-3
20,18,101,14,19,-5
20,18,102,10,22,-12
20,18,103,9,13,-4
20,18,104,17,18,-1
20,18,105,14,9,5
20,18,106,6,15,-9
20,18,107,10,21,-11
20,18,108,9,8,1
20,18,109,23,12,11
20,18,110,15,19,-4
20,18,111,29,15,14
20,18,112,27,18,9
20,18,113,13,11,2
20,18,114,13,14,-1
20,18,115,23,27,-4
20,18,116,21,20,1
20,18,117,13,12,1
20,18,118,19,20,-1
20,18,119,5,4,1
20,18,120,8,17,-9
20,18,121,16,11,5
20,18,122,5,16,-11
20,18,123,18,8,10
20,18,124,20,16,4
20,18,125,15,15,0
20,18,126,10,12,-2
20,18,127,8,26,-18
20,18,128,9,13,-4
20,18,129,15,23,-8
20,18,130,17,17,0
20,18,131,6,20,-14
20,18,132,13,25,-12
20,18,133,22,25,-3
20,18,134,22,19,3
20,18,135,27,22,5
20,18,136,9,11,-2
20,18,137,14,12,2
20,18,138,14,17,-3
20,18,139,10,23,-13
20,18,140,25,14,11
20,18,141,17,16,1
20,18,142,21,24,-3
20,18,143,9,10,-1
20,18,144,12,7,5
20,18,145,29,8,21
20,18,146,13,3,10
20,18,147,11,16,-5
20,18,148,13,9,4
20,18,149,24,17,7
20,18,150,16,13,3
20,18,151,19,26,-7
20,18,152,19,25,-6
20,18,153,17,13,4
20,18,154,33,23,10
20,18,155,9,20,-11
20,18,156,6,13,-7
20,18,157,15,30,-15
20,18,158,8,7,1
20,18,159,15,9,6
20,18,160,6,21,-15
20,18,161,10,5,5
20,18,162,14,22,-8
20,18,163,12,17,-5
20,18,164,13,12,1
20,18,165,20,15,5
20,18,166,5,24,-19
20,18,167,7,11,-4
20,18,168,17,20,-3
20,18,169,16,12,4
20,18,170,10,2,8
20,18,171,25,19,6
20,18,172,13,34,-21
20,18,173,20,23,-3
20,18,174,14,27,-13
20,18,175,20,17,3
20,18,176,11,10,1
20,18,177,11,7,4
20,18,178,9,7,2
20,18,179,14,21,-7
20,18,180,16,13,3
20,18,181,16,18,-2
20,18,182,6,3,3
20,18,183,13,13,0
20,18,184,18,17,1
20,18,185,15,18,-3
20,18,186,25,15,10
20,18,187,10,9,1
20,18,188,10,14,-4
20,18,189,14,14,0
20,18,190,12,5,7
20,18,191,18,14,4
20,18,192,15,10,5
20,18,193,13,14,-1
20,18,194,8,19,-11
20,18,195,20,16,4
20,18,196,20,16,4
20,18,197,14,18,-4
20,18,198,5,8,-3
20,18,199,14,17,-3
20,18,200,22,34,-12
20,18,201,11,18,-7
20,18,202,14,25,-11
20,18,203,21,20,1
20,18,204,8,6,2
20,18,205,11,18,-7
20,18,206,15,16,-1
20,18,207,6,13,-7
20,18,208,16,4,12
20,18,209,3,13,-10
20,18,210,12,12,0
20,18,211,8,12,-4
20,18,212,7,15,-8
20,18,213,13,15,-2
20,18,214,9,15,-6
20,18,215,7,10,-3
20,18,216,3,13,-10
20,18,217,9,19,-10
20,18,218,17,12,5
20,18,219,21,11,10
20,18,220,25,28,-3
20,18,221,20,6,14
20,18,222,5,10,-5
20,18,223,7,15,-8
20,18,224,11,14,-3
20,18,225,27,21,6
20,18,226,17,20,-3
20,18,227,10,17,-7
20,18,228,20,13,7
20,18,229,5,10,-5
20,18,230,7,22,-15
20,18,231,10,10,0
20,18,232,19,17,2
20,18,233,26,14,12
20,18,234,15,7,8
20,18,235,12,18,-6
20,18,236,7,22,-15
20,18,237,13,29,-16
20,18,238,27,15,12
20,18,239,15,11,4
20,18,240,25,31,-6
20,18,241,19,17,2
20,18,242,9,14,-5
20,18,243,17,17,0
20,18,244,17,12,5
20,18,245,26,26,0
20,18,246,26,23,3
20,18,247,13,6,7
20,18,248,13,19,-6
20,18,249,20,25,-5
20,18,250,11,11,0
20,18,251,17,20,-3
20,18,252,3,10,-7
20,18,253,17,20,-3
20,18,254,28,26,2
20,18,255,12,20,-8
20,18,256,11,22,-11
20,18,257,11,8,3
20,18,258,9,13,-4
20,18,259,13,11,2
20,18,260,15,13,2
20,18,261,10,19,-9
20,18,262,8,8,0
20,18,263,12,10,2
20,18,264,18,7,11
20,18,265,16,21,-5
20,18,266,17,24,-7
20,18,267,17,23,-6
20,18,268,4,5,-1
20,18,269,7,9,-2
20,18,270,7,16,-9
20,18,271,12,13,-1
20,18,272,11,19,-8
20,18,273,9,17,-8
20,18,274,9,15,-6
20,18,275,17,12,5
20,18,276,18,12,6
20,18,277,25,22,3
20,18,278,14,5,9
20,18,279,5,24,-19
20,18,280,24,25,-1
20,18,281,13,16,-3
20,18,282,10,22,-12
20,18,283,10,14,-4
20,18,284,12,16,-4
20,18,285,12,23,-11
20,18,286,14,20,-6
20,18,287,12,21,-9
20,18,288,26,28,-2
20,18,289,16,10,6
20,18,290,14,13,1
20,18,291,13,15,-2
20,18,292,11,18,-7
20,18,293,21,11,10
20,18,294,19,16,3
20,18,295,12,20,-8
20,18,296,9,10,-1
20,18,297,23,8,15
20,18,298,9,16,-7
20,18,299,5,15,-10
20,19,0,6,16,-10
20,19,1,9,21,-12
20,19,2,8,15,-7
20,19,3,11,16,-5
20,19,4,17,21,-4
20,19,5,19,22,-3
20,19,6,17,10,7
20,19,7,21,21,0
20,19,8,29,16,13
20,19,9,25,26,-1
20,19,10,15,15,0
20,19,11,26,12,14
20,19,12,24,21,3
20,19,13,12,14,-2
20,19,14,6,26,-20
20,19,15,12,14,-2
20,19,16,9,20,-11
20,19,17,18,20,-2
20,19,18,12,22,-10
20,19,19,11,15,-4
20,19,20,3,9,-6
20,19,21,13,8,5
20,19,22,10,12,-2
20,19,23,16,29,-13
20,19,24,9,18,-9
20,19,25,15,18,-3
20,19,26,21,16,5
20,19,27,21,31,-10
20,19,28,12,18,-6
20,19,29,8,13,-5
20,19,30,13,13,0
20,19,31,10,12,-2
20,19,32,12,11,1
20,19,33,6,8,-2
20,19,34,19,15,4
20,19,35,19,21,-2
20,19,36,18,10,8
20,19,37,10,16,-6
20,19,38,7,19,-12
20,19,39,12,18,-6
20,19,40,10,8,2
20,19,41,4,10,-6
20,19,42,10,27,-17
20,19,43,18,8,10
20,19,44,18,4,14
20,19,45,16,17,-1
20,19,46,5,10,-5
20,19,47,20,22,-2
20,19,48,18,20,-2
20,19,49,16,6,10
20,19,50,15,20,-5
20,19,51,16,9,7
20,19,52,27,18,9
20,19,53,12,11,1
20,19,54,8,21,-13
20,19,55,18,19,-1
20,19,56,13,14,-1
20,19,57,18,13,5
20,19,58,9,10,-1
20,19,59,11,17,-6
20,19,60,23,19,4
20,19,61,14,21,-7
20,19,62,7,11,-4
20,19,63,28,14,14
20,19,64,17,19,-2
20,19,65,4,2,2
20,19,66,12,13,-1
20,19,67,24,5,19
20,19,68,20,24,-4
20,19,69,15,11,4
20,19,70,14,28,-14
20,19,71,16,16,0
20,19,72,15,15,0
20,19,73,20,17,3
20,19,74,6,21,-15
20,19,75,19,28,-9
20,19,76,10,13,-3
20,19,77,4,23,-19
20,19,78,12,22,-10
20,19,79,32,10,22
20,19,80,19,15,4
20,19,81,9,12,-3
20,19,82,7,14,-7
20,19,83,13,7,6
20,19,84,16,16,0
20,19,85,16,23,-7
20,19,86,8,12,-4
20,19,87,9,24,-15
20,19,88,8,18,-10
20,19,89,11,9,2
20,19,90,17,12,5
20,19,91,22,15,7
20,19,92,11,15,-4
20,19,93,21,22,-1
20,19,94,8,20,-12
20,19,95,20,13,7
20,19,96,10,9,1
20,19,97,18,25,-7
20,19,98,16,28,-12
20,19,99,12,15,-3
20,19,100,15,14,1
20,19,101,16,10,6
20,19,102,25,36,-11
20,19,103,15,10,5
20,19,104,7,26,-19
20,19,105,10,31,-21
20,19,106,24,35,-11
20,19,107,9,8,1
20,19,108,19,21,-2
20,19,109,16,17,-1
20,19,110,16,20,-4
20,19,111,18,16,2
20,19,112,10,14,-4
20,19,113,12,17,-5
20,19,114,14,22,-8
20,19,115,22,19,3
20,19,116,22,16,6
20,19,117,18,17,1
20,19,118,4,9,-5
20,19,119,8,13,-5
20,19,120,9,8,1
20,19,121,12,10,2
20,19,122,16,23,-7
20,19,123,12,16,-4
20,19,124,7,2,5
20,19,125,26,31,-5
20,19,126,25,30,-5
20,19,127,13,10,3
20,19,128,12,10,2
20,19,129,12,20,-8
20,19,130,13,24,-11
20,19,131,12,14,-2
20,19,132,13,17,-4
20,19,133,11,13,-2
20,19,134,11,23,-12
20,19,135,15,14,1
20,19,136,7,16,-9
20,19,137,17,11,6
20,19,138,12,22,-10
20,19,139,25,23,2
20,19,140,7,13,-6
20,19,141,20,16,4
20,19,142,22,31,-9
20,19,143,9,9,0
20,19,144,17,18,-1
20,19,145,9,8,1
20,19,146,10,4,6
20,19,147,20,13,7
20,19,148,12,3,9
20,19,149,16,21,-5
20,19,150,8,24,-16
20,19,151,17,14,3
20,19,152,18,14,4
20,19,153,8,9,-1
20,19,154,8,22,-14
20,19,155,14,13,1
20,19,156,9,20,-11
20,19,157,15,10,5
20,19,158,14,11,3
20,19,159,13,22,-9
20,19,160,13,9,4
20,19,161,18,13,5
20,19,162,38,29,9
20,19,163,21,8,13
20,19,164,16,4,12
20,19,165,13,25,-12
20,19,166,23,18,5
20,19,167,21,17,4
20,19,168,14,10,4
20,19,169,15,17,-2
20,19,170,17,18,-1
20,19,171,12,11,1
20,19,172,26,30,-4
20,19,173,7,17,-10
20,19,174,11,8,3
20,19,175,21,12,9
20,19,176,12,13,-1
20,19,177,23,15,8
20,19,178,25,17,8
20,19,179,5,4,1
20,19,180,19,19,0
20,19,181,22,19,3
20,19,182,6,14,-8
20,19,183,16,14,2
20,19,184,21,27,-6
20,19,185,13,8,5
20,19,186,9,11,-2
20,19,187,9,10,-1
20,19,188,14,10,4
20,19,189,8,14,-6
20,19,190,11,7,4
20,19,191,15,21,-6
20,19,192,18,18,0
20,19,193,9,10,-1
20,19,194,16,22,-6
20,19,195,15,13,2
20,19,196,5,15,-10
20,19,197,21,23,-2
20,19,198,14,18,-4
20,19,199,12,24,-12
20,19,200,8,19,-11
20,19,201,8,12,-4
20,19,202,21,17,4
20,19,203,9,14,-5
20,19,204,4,16,-12
20,19,205,19,19,0
20,19,206,5,20,-15
20,19,207,12,12,0
20,19,208,22,23,-1
20,19,209,18,23,-5
20,19,210,14,19,-5
20,19,211,18,16,2
20,19,212,26,21,5
20,19,213,8,11,-3
20,19,214,16,12,4
20,19,215,13,11,2
20,19,216,15,16,-1
20,19,217,21,17,4
20,19,218,8,17,-9
20,19,219,17,6,11
20,19,220,7,19,-12
20,19,221,6,8,-2
20,19,222,8,30,-22
20,19,223,12,17,-5
20,19,224,26,27,-1
20,19,225,16,20,-4
20,19,226,19,14,5
20,19,227,11,9,2
20,19,228,10,15,-5
20,19,229,15,14,1
20,19,230,10,16,-6
20,19,231,17,12,5
20,19,232,14,11,3
20,19,233,7,9,-2
20,19,234,10,21,-11
20,19,235,8,14,-6
20,19,236,11,14,-3
20,19,237,12,14,-2
20,19,238,12,14,-2
20,19,239,10,9,1
20,19,240,13,15,-2
20,19,241,10,16,-6
20,19,242,16,26,-10
20,19,243,11,19,-8
20,19,244,21,14,7
20,19,245,30,18,12
20,19,246,9,19,-10
20,19,247,21,20,1
20,19,248,10,22,-12
20,19,249,19,11,8
20,19,250,15,23,-8
20,19,251,13,22,-9
20,19,252,13,24,-11
20,19,253,14,17,-3
20,19,254,14,13,1
20,19,255,6,14,-8
20,19,256,18,9,9
20,19,257,9,30,-21
20,19,258,8,7,1
20,19,259,11,14,-3
20,19,260,16,20,-4
20,19,261,8,16,-8
20,19,262,13,16,-3
20,19,263,16,23,-7
20,19,264,20,12,8
20,19,265,8,9,-1
20,19,266,17,18,-1
20,19,267,15,15,0
20,19,268,17,16,1
20,19,269,13,15,-2
20,19,270,21,20,1
20,19,271,8,9,-1
20,19,272,18,25,-7
20,19,273,7,9,-2
20,19,274,8,12,-4
20,19,275,14,11,3
20,19,276,20,25,-5
20,19,277,11,10,1
20,19,278,12,9,3
20,19,279,18,24,-6
20,19,280,18,18,0
20,19,281,21,11,10
20,19,282,9,14,-5
20,19,283,12,6,6
20,19,284,2,9,-7
20,19,285,16,33,-17
20,19,286,14,17,-3
20,19,287,11,20,-9
20,19,288,12,15,-3
20,19,289,16,23,-7
20,19,290,13,12,1
20,19,291,21,20,1
20,19,292,23,20,3
20,19,293,10,20,-10
20,19,294,11,24,-13
20,19,295,3,19,-16
20,19,296,32,20,12
20,19,297,21,14,7
20,19,298,16,17,-1
20,19,299,18,10,8
20,20,0,8,14,-6
20,20,1,12,17,-5
20,20,2,6,10,-4
20,20,3,26,25,1
20,20,4,19,12,7
20,20,5,31,16,15
20,20,6,21,17,4
20,20,7,5,14,-9
20,20,8,19,19,0
20,20,9,9,14,-5
20,20,10,23,25,-2
20,20,11,16,13,3
20,20,12,8,4,4
20,20,13,12,20,-8
20,20,14,8,21,-13
20,20,15,20,20,0
20,20,16,21,19,2
20,20,17,12,21,-9
20,20,18,12,15,-3
20,20,19,19,17,2
20,20,20,8,12,-4
20,20,21,22,19,3
20,20,22,14,17,-3
20,20,23,11,17,-6
20,20,24,15,19,-4
20,20,25,18,18,0
20,20,26,18,19,-1
20,20,27,13,20,-7
20,20,28,17,7,10
20,20,29,10,22,-12
20,20,30,20,26,-6
20,20,31,7,6,1
20,20,32,17,13,4
20,20,33,31,13,18
20,20,34,10,11,-1
20,20,35,8,5,3
20,20,36,7,14,-7
20,20,37,7,17,-10
20,20,38,13,19,-6
20,20,39,11,18,-7
20,20,40,14,5,9
20,20,41,15,23,-8
20,20,42,18,15,3
20,20,43,25,24,1
20,20,44,7,13,-6
20,20,45,13,12,1
20,20,46,11,19,-8
20,20,47,3,7,-4
20,20,48,23,14,9
20,20,49,27,16,11
20,20,50,12,15,-3
20,20,51,13,22,-9
20,20,52,12,10,2
20,20,53,12,14,-2
20,20,54,11,5,6
20,20,55,8,14,-6
20,20,56,10,22,-12
20,20,57,5,20,-15
20,20,58,30,23,7
20,20,59,18,12,6
20,20,60,24,24,0
20,20,61,26,20,6
20,20,62,14,20,-6
20,20,63,17,21,-4
20,20,64,6,18,-12
20,20,65,6,12,-6
20,20,66,10,2,8
20,20,67,24,7,17
20,20,68,9,10,-1
20,20,69,17,17,0
20,20,70,9,19,-10
20,20,71,19,16,3
20,20,72,12,15,-3
20,20,73,19,18,1
20,20,74,14,16,-2
20,20,75,10,18,-8
20,20,76,8,13,-5
20,20,77,10,11,-1
20,20,78,13,10,3
20,20,79,19,13,6
20,20,80,15,20,-5
20,20,81,25,8,17
20,20,82,8,20,-12
20,20,83,13,17,-4
20,20,84,29,18,11
20,20,85,5,14,-9
20,20,86,11,13,-2
20,20,87,11,10,1
20,20,88,14,26,-12
20,20,89,14,23,-9
20,20,90,22,23,-1
20,20,91,10,12,-2
20,20,92,19,16,3
20,20,93,10,5,5
20,20,94,8,14,-6
20,20,95,18,26,-8
20,20,96,18,11,7
20,20,97,11,10,1
20,20,98,21,18,3
20,20,99,6,17,-11
20,20,100,14,16,-2
20,20,101,18,17,1
20,20,102,13,25,-12
20,20,103,29,26,3
20,20,104,14,21,-7
20,20,105,8,17,-9
20,20,106,6,16,-10
20,20,107,12,3,9
20,20,108,17,14,3
20,20,109,9,14,-5
20,20,110,27,26,1
20,20,111,7,5,2
20,20,112,13,14,-1
20,20,113,17,20,-3
20,20,114,10,12,-2
20,20,115,16,18,-2
20,20,116,9,14,-5
20,20,117,7,6,1
20,20,118,7,13,-6
20,20,119,20,25,-5
20,20,120,8,12,-4
20,20,121,7,24,-17
20,20,122,10,20,-10
20,20,123,30,18,12
20,20,124,17,18,-1
20,20,125,5,12,-7
20,20,126,15,20,-5
20,20,127,15,13,2
20,20,128,9,13,-4
20,20,129,16,14,2
20,20,130,10,16,-6
20,20,131,15,18,-3
20,20,132,14,9,5
20,20,133,11,14,-3
20,20,134,3,14,-11
20,20,135,6,12,-6
20,20,136,11,17,-6
20,20,137,7,14,-7
20,20,138,15,24,-9
20,20,139,1,12,-11
20,20,140,12,25,-13
20,20,141,21,19,2
20,20,142,9,14,-5
20,20,143,13,4,9
20,20,144,9,21,-12
20,20,145,17,14,3
20,20,146,19,13,6
20,20,147,11,22,-11
20,20,148,7,14,-7
20,20,149,15,15,0
20,20,150,10,5,5
20,20,151,9,16,-7
20,20,152,12,9,3
20,20,153,28,30,-2
20,20,154,19,19,0
20,20,155,7,17,-10
20,20,156,13,16,-3
20,20,157,1,23,-22
20,20,158,20,32,-12
20,20,159,19,20,-1
20,20,160,16,24,-8
20,20,161,25,16,9
20,20,162,6,5,1
20,20,163,19,35,-16
20,20,164,16,15,1
20,20,165,6,7,-1
20,20,166,10,16,-6
20,20,167,8,11,-3
20,20,168,7,15,-8
20,20,169,25,33,-8
20,20,170,19,18,1
20,20,171,18,20,-2
20,20,172,11,16,-5
20,20,173,9,7,2
20,20,174,11,17,-6
20,20,175,6,22,-16
20,20,176,12,26,-14
20,20,177,16,12,4
20,20,178,17,20,-3
20,20,179,8,13,-5
20,20,180,2,17,-15
20,20,181,19,13,6
20,20,182,9,25,-16
20,20,183,12,16,-4
20,20,184,22,25,-3
20,20,185,13,19,-6
20,20,186,20,13,7
20,20,187,16,19,-3
20,20,188,15,7,8
20,20,189,18,12,6
20,20,190,16,19,-3
20,20,191,16,17,-1
20,20,192,8,18,-10
20,20,193,6,14,-8
20,20,194,17,18,-1
20,20,195,16,15,1
20,20,196,8,10,-2
20,20,197,11,14,-3
20,20,198,17,19,-2
20,20,199,9,5,4
20,20,200,13,16,-3
20,20,201,10,9,1
20,20,202,17,21,-4
20,20,203,11,30,-19
20,20,204,18,18,0
20,20,205,12,27,-15
20,20,206,16,16,0
20,20,207,12,11,1
20,20,208,12,27,-15
20,20,209,11,17,-6
20,20,210,15,15,0
20,20,211,14,9,5
20,20,212,8,5,3
20,20,213,9,13,-4
20,20,214,10,18,-8
20,20,215,11,19,-8
20,20,216,11,11,0
20,20,217,17,20,-3
20,20,218,13,16,-3
20,20,219,5,6,-1
20,20,220,13,7,6
20,20,221,19,14,5
20,20,222,5,19,-14
20,20,223,19,10,9
20,20,224,16,28,-12
20,20,225,16,12,4
20,20,226,8,11,-3
20,20,227,11,16,-5
20,20,228,11,22,-11
20,20,229,9,21,-12
20,20,230,15,17,-2
20,20,231,6,13,-7
20,20,232,24,33,-9
20,20,233,12,10,2
20,20,234,14,10,4
20,20,235,19,10,9
20,20,236,6,23,-17
20,20,237,16,17,-1
20,20,238,1,8,-7
20,20,239,18,23,-5
20,20,240,9,15,-6
20,20,241,21,11,10
20,20,242,18,24,-6
20,20,243,17,15,2
20,20,244,14,13,1
20,20,245,13,18,-5
20,20,246,9,10,-1
20,20,247,8,10,-2
20,20,248,13,10,3
20,20,249,9,18,-9
20,20,250,15,15,0
20,20,251,12,14,-2
20,20,252,11,10,1
20,20,253,23,24,-1
20,20,254,26,19,7
20,20,255,17,19,-2
20,20,256,13,24,-11
20,20,257,14,17,-3
20,20,258,18,13,5
20,20,259,7,23,-16
20,20,260,14,19,-5
20,20,261,19,10,9
20,20,262,19,25,-6
20,20,263,11,14,-3
20,20,264,9,17,-8
20,20,265,13,12,1
20,20,266,9,5,4
20,20,267,13,20,-7
20,20,268,15,10,5
20,20,269,8,16,-8
20,20,270,16,19,-3
20,20,271,27,23,4
20,20,272,22,11,11
20,20,273,7,9,-2
20,20,274,21,22,-1
20,20,275,13,26,-13
20,20,276,17,9,8
20,20,277,8,15,-7
20,20,278,26,24,2
20,20,279,3,6,-3
20,20,280,12,20,-8
20,20,281,15,9,6
20,20,282,16,14,2
20,20,283,22,12,10
20,20,284,11,10,1
20,20,285,16,16,0
20,20,286,9,10,-1
20,20,287,14,7,7
20,20,288,14,18,-4
20,20,289,13,20,-7
20,20,290,8,6,2
20,20,291,12,2,10
20,20,292,12,21,-9
20,20,293,6,19,-13
20,20,294,10,20,-10
20,20,295,4,8,-4
20,20,296,19,5,14
20,20,297,13,21,-8
20,20,298,21,14,7
20,20,299,8,18,-10
20,21,0,19,21,-2
20,21,1,17,20,-3
20,21,2,11,11,0
20,21,3,13,13,0
20,21,4,20,18,2
20,21,5,17,27,-10
20,21,6,15,1,14
20,21,7,14,6,8
20,21,8,19,17,2
20,21,9,8,21,-13
20,21,10,17,14,3
20,21,11,14,23,-9
20,21,12,13,17,-4
20,21,13,31,15,16
20,21,14,14,30,-16
20,21,15,9,12,-3
20,21,16,23,9,14
20,21,17,19,20,-1
20,21,18,6,11,-5
20,21,19,16,22,-6
20,21,20,16,13,3
20,21,21,13,8,5
20,21,22,17,15,2
20,21,23,17,18,-1
20,21,24,9,14,-5
20,21,25,25,16,9
20,21,26,13,7,6
20,21,27,11,11,0
20,21,28,4,16,-12
20,21,29,7,17,-10
20,21,30,9,13,-4
20,21,31,14,27,-13
20,21,32,25,22,3
20,21,33,13,19,-6
20,21,34,11,22,-11
20,21,35,12,5,7
20,21,36,13,16,-3
20,21,37,3,19,-16
20,21,38,8,13,-5
20,21,39,11,20,-9
20,21,40,11,12,-1
20,21,41,9,13,-4
20,21,42,14,11,3
20,21,43,9,24,-15
20,21,44,17,11,6
20,21,45,1,8,-7
20,21,46,8,14,-6
20,21,47,13,9,4
20,21,48,9,9,0
20,21,49,5,17,-12
20,21,50,13,9,4
20,21,51,11,22,-11
20,21,52,11,21,-10
20,21,53,9,20,-11
20,21,54,13,30,-17
20,21,55,14,12,2
20,21,56,12,13,-1
20,21,57,16,16,0
20,21,58,14,19,-5
20,21,59,11,17,-6
20,21,60,14,5,9
20,21,61,21,12,9
20,21,62,15,16,-1
20,21,63,15,11,4
20,21,64,9,7,2
20,21,65,17,17,0
20,21,66,14,12,2
20,21,67,16,8,8
20,21,68,17,16,1
20,21,69,16,23,-7
20,21,70,13,6,7
20,21,71,20,13,7
20,21,72,20,13,7
20,21,73,23,14,9
20,21,74,16,11,5
20,21,75,13,24,-11
20,21,76,16,13,3
20,21,77,14,13,1
20,21,78,13,32,-19
20,21,79,20,14,6
20,21,80,16,18,-2
20,21,81,9,11,-2
20,21,82,13,13,0
20,21,83,9,9,0
20,21,84,22,21,1
20,21,85,12,11,1
20,21,86,16,13,3
20,21,87,17,12,5
20,21,88,9,12,-3
20,21,89,8,8,0
20,21,90,11,14,-3
20,21,91,14,14,0
20,21,92,16,14,2
20,21,93,6,18,-12
20,21,94,33,30,3
20,21,95,19,18,1
20,21,96,18,21,-3
20,21,97,10,14,-4
20,21,98,19,19,0
20,21,99,10,15,-5
20,21,100,12,10,2
20,21,101,10,13,-3
20,21,102,23,21,2
20,21,103,3,10,-7
20,21,104,21,12,9
20,21,105,6,9,-3
20,21,106,6,11,-5
20,21,107,12,16,-4
20,21,108,23,16,7
20,21,109,15,18,-3
20,21,110,20,9,11
20,21,111,18,21,-3
20,21,112,5,6,-1
20,21,113,7,6,1
20,21,114,13,13,0
20,21,115,17,17,0
20,21,116,15,14,1
20,21,117,20,18,2
20,21,118,15,11,4
20,21,119,19,10,9
20,21,120,6,10,-4
20,21,121,15,18,-3
20,21,122,9,19,-10
20,21,123,12,13,-1
20,21,124,7,29,-22
20,21,125,9,10,-1
20,21,126,10,14,-4
20,21,127,23,22,1
20,21,128,12,7,5
20,21,129,18,11,7
20,21,130,24,12,12
20,21,131,17,7,10
20,21,132,17,17,0
20,21,133,8,13,-5
20,21,134,26,21,5
20,21,135,14,16,-2
20,21,136,9,11,-2
20,21,137,16,19,-3
20,21,138,8,12,-4
20,21,139,12,24,-12
20,21,140,6,7,-1
20,21,141,15,15,0
20,21,142,15,11,4
20,21,143,9,11,-2
20,21,144,7,16,-9
20,21,145,12,10,2
20,21,146,12,10,2
20,21,147,11,17,-6
20,21,148,10,18,-8
20,21,149,18,11,7
20,21,150,13,16,-3
20,21,151,5,11,-6
20,21,152,12,7,5
20,21,153,12,22,-10
20,21,154,16,10,6
20,21,155,18,15,3
20,21,156,17,12,5
20,21,157,11,21,-10
20,21,158,11,6,5
20,21,159,22,14,8
20,21,160,17,16,1
20,21,161,10,17,-7
20,21,162,14,22,-8
20,21,163,17,11,6
20,21,164,25,16,9
20,21,165,17,17,0
20,21,166,17,12,5
20,21,167,24,16,8
20,21,168,14,9,5
20,21,169,10,7,3
20,21,170,14,17,-3
20,21,171,18,8,10
20,21,172,15,20,-5
20,21,173,17,19,-2
20,21,174,12,10,2
20,21,175,21,9,12
20,21,176,8,17,-9
20,21,177,17,11,6
20,21,178,8,15,-7
20,21,179,13,14,-1
20,21,180,13,23,-10
20,21,181,5,6,-1
20,21,182,12,14,-2
20,21,183,8,13,-5
20,21,184,15,15,0
20,21,185,15,16,-1
20,21,186,4,8,-4
20,21,187,19,18,1
20,21,188,9,9,0
20,21,189,8,9,-1
20,21,190,21,14,7
20,21,191,13,22,-9
20,21,192,9,7,2
20,21,193,14,10,4
20,21,194,16,5,11
20,21,195,13,18,-5
20,21,196,2,9,-7
20,21,197,19,16,3
20,21,198,2,10,-8
20,21,199,20,10,10
20,21,200,11,15,-4
20,21,201,21,14,7
20,21,202,25,16,9
20,21,203,13,10,3
20,21,204,17,20,-3
20,21,205,23,26,-3
20,21,206,14,13,1
20,21,207,23,20,3
20,21,208,12,20,-8
20,21,209,27,17,10
20,21,210,12,16,-4
20,21,211,17,10,7
20,21,212,15,23,-8
20,21,213,26,20,6
20,21,214,28,14,14
20,21,215,26,20,6
20,21,216,22,8,14
20,21,217,18,19,-1
20,21,218,10,12,-2
20,21,219,20,14,6
20,21,220,20,15,5
20,21,221,10,22,-12
20,21,222,10,18,-8
20,21,223,15,13,2
20,21,224,19,17,2
20,21,225,10,6,4
20,21,226,4,11,-7
20,21,227,16,20,-4
20,21,228,13,17,-4
20,21,229,14,12,2
20,21,230,18,15,3
20,21,231,12,13,-1
20,21,232,6,13,-7
20,21,233,28,25,3
20,21,234,11,8,3
20,21,235,11,22,-11
20,21,236,15,7,8
20,21,237,11,7,4
20,21,238,13,13,0
20,21,239,13,24,-11
20,21,240,16,10,6
20,21,241,14,25,-11
20,21,242,15,22,-7
20,21,243,19,21,-2
20,21,244,32,12,20
20,21,245,11,12,-1
20,21,246,14,14,0
20,21,247,20,17,3
20,21,248,28,17,11
20,21,249,15,10,5
20,21,250,15,11,4
20,21,251,10,7,3
20,21,252,23,14,9
20,21,253,14,24,-10
20,21,254,17,33,-16
20,21,255,15,22,-7
20,21,256,15,16,-1
20,21,257,12,18,-6
20,21,258,18,14,4
20,21,259,10,24,-14
20,21,260,4,13,-9
20,21,261,12,23,-11
20,21,262,17,18,-1
20,21,263,15,26,-11
20,21,264,13,16,-3
20,21,265,10,22,-12
20,21,266,11,18,-7
20,21,267,13,15,-2
20,21,268,17,18,-1
20,21,269,14,15,-1
20,21,270,11,12,-1
20,21,271,17,17,0
20,21,272,14,15,-1
20,21,273,19,15,4
20,21,274,25,27,-2
20,21,275,12,17,-5
20,21,276,27,26,1
20,21,277,20,9,11
20,21,278,19,13,6
20,21,279,23,19,4
20,21,280,16,8,8
20,21,281,22,9,13
20,21,282,14,4,10
20,21,283,18,13,5
20,21,284,14,23,-9
20,21,285,7,22,-15
20,21,286,10,12,-2
20,21,287,15,26,-11
20,21,288,16,11,5
20,21,289,25,11,14
20,21,290,33,3,30
20,21,291,12,18,-6
20,21,292,19,10,9
20,21,293,18,15,3
20,21,294,17,20,-3
20,21,295,18,7,11
20,21,296,6,5,1
20,21,297,21,14,7
20,21,298,17,17,0
20,21,299,14,30,-16
20,22,0,13,22,-9
20,22,1,14,10,4
20,22,2,20,24,-4
20,22,3,18,13,5
20,22,4,14,9,5
20,22,5,11,20,-9
20,22,6,13,20,-7
20,22,7,10,13,-3
20,22,8,7,24,-17
20,22,9,13,11,2
20,22,10,15,15,0
20,22,11,19,10,9
20,22,12,8,4,4
20,22,13,31,18,13
20,22,14,9,7,2
20,22,15,16,1,15
20,22,16,11,14,-3
20,22,17,28,18,10
20,22,18,18,9,9
20,22,19,10,11,-1
20,22,20,16,12,4
20,22,21,17,20,-3
20,22,22,9,12,-3
20,22,23,28,29,-1
20,22,24,7,12,-5
20,22,25,24,10,14
20,22,26,17,5,12
20,22,27,13,14,-1
20,22,28,10,14,-4
20,22,29,6,9,-3
20,22,30,13,23,-10
20,22,31,9,9,0
20,22,32,9,17,-8
20,22,33,26,28,-2
20,22,34,13,16,-3
20,22,35,10,23,-13
20,22,36,32,26,6
20,22,37,11,15,-4
20,22,38,26,18,8
20,22,39,14,8,6
20,22,40,9,18,-9
20,22,41,24,32,-8
20,22,42,23,10,13
20,22,43,16,21,-5
20,22,44,17,5,12
20,22,45,15,12,3
20,22,46,15,19,-4
20,22,47,19,15,4
20,22,48,7,19,-12
20,22,49,15,15,0
20,22,50,12,12,0
20,22,51,10,28,-18
20,22,52,5,6,-1
20,22,53,21,17,4
20,22,54,15,24,-9
20,22,55,21,19,2
20,22,56,18,9,9
20,22,57,2,17,-15
20,22,58,9,11,-2
20,22,59,10,12,-2
20,22,60,18,19,-1
20,22,61,23,12,11
20,22,62,14,12,2
20,22,63,12,7,5
20,22,64,29,22,7
20,22,65,7,7,0
20,22,66,13,19,-6
20,22,67,6,15,-9
20,22,68,12,15,-3
20,22,69,5,9,-4
20,22,70,17,12,5
20,22,71,28,9,19
20,22,72,17,18,-1
20,22,73,14,23,-9
20,22,74,28,28,0
20,22,75,20,19,1
20,22,76,10,20,-10
20,22,77,5,13,-8
20,22,78,19,18,1
20,22,79,15,20,-5
20,22,80,4,14,-10
20,22,81,13,14,-1
20,22,82,9,12,-3
20,22,83,6,8,-2
20,22,84,11,15,-4
20,22,85,14,14,0
20,22,86,6,11,-5
20,22,87,13,13,0
20,22,88,20,22,-2
20,22,89,17,8,9
20,22,90,2,12,-10
20,22,91,11,18,-7
20,22,92,12,17,-5
20,22,93,7,2,5
20,22,94,9,18,-9
20,22,95,9,7,2
20,22,96,15,15,0
20,22,97,22,22,0
20,22,98,7,15,-8
20,22,99,12,12,0
20,22,100,15,10,5
20,22,101,18,14,4
20,22,102,17,18,-1
20,22,103,16,9,7
20,22,104,27,17,10
20,22,105,9,5,4
20,22,106,26,25,1
20,22,107,13,22,-9
20,22,108,2,12,-10
20,22,109,9,13,-4
20,22,110,13,22,-9
20,22,111,20,9,11
20,22,112,20,10,10
20,22,113,13,28,-15
20,22,114,12,14,-2
20,22,115,15,13,2
20,22,116,14,14,0
20,22,117,7,16,-9
20,22,118,10,11,-1
20,22,119,14,10,4
20,22,120,6,10,-4
20,22,121,17,16,1
20,22,122,13,11,2
20,22,123,21,14,7
20,22,124,16,18,-2
20,22,125,11,22,-11
20,22,126,21,15,6
20,22,127,6,12,-6
20,22,128,22,11,11
20,22,129,19,21,-2
20,22,130,22,17,5
20,22,131,10,12,-2
20,22,132,5,22,-17
20,22,133,10,18,-8
20,22,134,14,17,-3
20,22,135,11,13,-2
20,22,136,11,14,-3
20,22,137,11,17,-6
20,22,138,25,16,9
20,22,139,11,8,3
20,22,140,12,8,4
20,22,141,13,5,8
20,22,142,15,11,4
20,22,143,17,15,2
20,22,144,17,15,2
20,22,145,8,13,-5
20,22,146,6,16,-10
20,22,147,13,8,5
20,22,148,7,8,-1
20,22,149,9,8,1
20,22,150,13,10,3
20,22,151,9,23,-14
20,22,152,12,9,3
20,22,153,16,12,4
20,22,154,16,10,6
20,22,155,7,9,-2
20,22,156,26,9,17
20,22,157,10,9,1
20,22,158,26,21,5
20,22,159,7,7,0
20,22,160,4,6,-2
20,22,161,14,14,0
20,22,162,5,7,-2
20,22,163,17,13,4
20,22,164,15,17,-2
20,22,165,6,16,-10
20,22,166,21,18,3
20,22,167,15,13,2
20,22,168,19,18,1
20,22,169,15,24,-9
20,22,170,15,27,-12
20,22,171,12,11,1
20,22,172,24,16,8
20,22,173,8,12,-4
20,22,174,11,17,-6
20,22,175,13,7,6
20,22,176,15,13,2
20,22,177,26,31,-5
20,22,178,19,13,6
20,22,179,24,11,13
20,22,180,12,15,-3
20,22,181,11,21,-10
20,22,182,9,12,-3
20,22,183,7,5,2
20,22,184,13,24,-11
20,22,185,12,10,2
20,22,186,2,15,-13
20,22,187,17,13,4
20,22,188,10,11,-1
20,22,189,15,12,3
20,22,190,11,10,1
20,22,191,7,15,-8
20,22,192,16,17,-1
20,22,193,18,17,1
20,22,194,15,17,-2
20,22,195,12,19,-7
20,22,196,12,17,-5
20,22,197,18,14,4
20,22,198,18,11,7
20,22,199,4,11,-7
20,22,200,20,17,3
20,22,201,19,14,5
20,22,202,18,11,7
20,22,203,16,16,0
20,22,204,14,11,3
20,22,205,9,13,-4
20,22,206,9,11,-2
20,22,207,13,16,-3
20,22,208,13,11,2
20,22,209,13,26,-13
20,22,210,16,9,7
20,22,211,20,14,6
20,22,212,8,11,-3
20,22,213,12,15,-3
20,22,214,12,6,6
20,22,215,12,10,2
20,22,216,21,14,7
20,22,217,8,12,-4
20,22,218,6,13,-7
20,22,219,16,19,-3
20,22,220,6,9,-3
20,22,221,15,15,0
20,22,222,11,18,-7
20,22,223,19,14,5
20,22,224,12,12,0
20,22,225,14,19,-5
20,22,226,23,18,5
20,22,227,15,11,4
20,22,228,22,21,1
20,22,229,16,23,-7
20,22,230,13,10,3
20,22,231,10,15,-5
20,22,232,14,20,-6
20,22,233,18,16,2
20,22,234,13,13,0
20,22,235,14,10,4
20,22,236,10,18,-8
20,22,237,17,15,2
20,22,238,14,23,-9
20,22,239,9,15,-6
20,22,240,19,5,14
20,22,241,27,32,-5
20,22,242,13,13,0
20,22,243,16,29,-13
20,22,244,15,14,1
20,22,245,8,6,2
20,22,246,4,13,-9
20,22,247,15,15,0
20,22,248,21,23,-2
20,22,249,5,9,-4
20,22,250,17,13,4
20,22,251,17,17,0
20,22,252,9,20,-11
20,22,253,8,17,-9
20,22,254,10,15,-5
20,22,255,23,28,-5
20,22,256,4,2,2
20,22,257,16,17,-1
20,22,258,9,11,-2
20,22,259,31,14,17
20,22,260,12,25,-13
20,22,261,16,14,2
20,22,262,13,30,-17
20,22,263,16,15,1
20,22,264,7,14,-7
20,22,265,15,18,-3
20,22,266,17,30,-13
20,22,267,11,16,-5
20,22,268,17,15,2
20,22,269,19,19,0
20,22,270,8,7,1
20,22,271,19,13,6
20,22,272,23,18,5
20,22,273,12,16,-4
20,22,274,8,18,-10
20,22,275,8,13,-5
20,22,276,10,5,5
20,22,277,27,16,11
20,22,278,14,12,2
20,22,279,12,12,0
20,22,280,8,13,-5
20,22,281,15,15,0
20,22,282,17,26,-9
20,22,283,10,15,-5
20,22,284,10,20,-10
20,22,285,8,5,3
20,22,286,24,15,9
20,22,287,14,7,7
20,22,288,11,4,7
20,22,289,24,11,13
20,22,290,20,10,10
20,22,291,15,13,2
20,22,292,6,10,-4
20,22,293,17,13,4
20,22,294,16,15,1
20,22,295,13,14,-1
20,22,296,27,16,11
20,22,297,9,8,1
20,22,298,13,20,-7
20,22,299,14,13,1
20,23,0,27,18,9
20,23,1,4,8,-4
20,23,2,6,8,-2
20,23,3,10,15,-5
20,23,4,9,9,0
20,23,5,7,11,-4
20,23,6,13,24,-11
20,23,7,17,13,4
20,23,8,8,4,4
20,23,9,20,14,6
20,23,10,13,21,-8
20,23,11,5,11,-6
20,23,12,24,8,16
20,23,13,21,12,9
20,23,14,19,23,-4
20,23,15,22,20,2
20,23,16,24,15,9
20,23,17,14,14,0
20,23,18,12,8,4
20,23,19,21,10,11
20,23,20,10,19,-9
20,23,21,12,8,4
20,23,22,14,16,-2
20,23,23,20,8,12
20,23,24,12,25,-13
20,23,25,11,8,3
20,23,26,13,13,0
20,23,27,10,11,-1
20,23,28,23,19,4
20,23,29,12,24,-12
20,23,30,23,15,8
20,23,31,28,17,11
20,23,32,11,5,6
20,23,33,31,25,6
20,23,34,11,24,-13
20,23,35,11,16,-5
20,23,36,7,13,-6
20,23,37,28,11,17
20,23,38,12,8,4
20,23,39,14,10,4
20,23,40,14,11,3
20,23,41,15,13,2
20,23,42,23,27,-4
20,23,43,26,15,11
20,23,44,25,14,11
20,23,45,7,9,-2
20,23,46,20,15,5
20,23,47,19,14,5
20,23,48,17,5,12
20,23,49,21,4,17
20,23,50,16,12,4
20,23,51,14,10,4
20,23,52,16,1,15
20,23,53,12,10,2
20,23,54,35,21,14
20,23,55,7,16,-9
20,23,56,13,10,3
20,23,57,17,16,1
20,23,58,21,10,11
20,23,59,8,26,-18
20,23,60,13,16,-3
20,23,61,18,13,5
20,23,62,21,17,4
20,23,63,23,12,11
20,23,64,16,10,6
20,23,65,18,13,5
20,23,66,15,20,-5
20,23,67,14,20,-6
20,23,68,12,20,-8
20,23,69,12,3,9
20,23,70,12,20,-8
20,23,71,11,12,-1
20,23,72,17,18,-1
20,23,73,15,15,0
20,23,74,14,11,3
20,23,75,11,8,3
20,23,76,26,16,10
20,23,77,22,15,7
20,23,78,14,16,-2
20,23,79,16,13,3
20,23,80,20,16,4
20,23,81,14,10,4
20,23,82,23,22,1
20,23,83,7,10,-3
20,23,84,15,17,-2
20,23,85,15,16,-1
20,23,86,11,15,-4
20,23,87,23,15,8
20,23,88,23,21,2
20,23,89,2,12,-10
20,23,90,26,14,12
20,23,91,19,7,12
20,23,92,18,17,1
20,23,93,18,8,10
20,23,94,15,13,2
20,23,95,10,13,-3
20,23,96,18,23,-5
20,23,97,11,16,-5
20,23,98,37,22,15
20,23,99,12,13,-1
20,23,100,11,14,-3
20,23,101,14,12,2
20,23,102,11,15,-4
20,23,103,19,7,12
20,23,104,27,22,5
20,23,105,22,10,12
20,23,106,18,9,9
20,23,107,14,20,-6
20,23,108,5,15,-10
20,23,109,23,17,6
20,23,110,19,14,5
20,23,111,8,8,0
20,23,112,17,23,-6
20,23,113,14,14,0
20,23,114,15,16,-1
20,23,115,12,15,-3
20,23,116,14,24,-10
20,23,117,22,21,1
20,23,118,23,24,-1
20,23,119,12,14,-2
20,23,120,4,12,-8
20,23,121,16,9,7
20,23,122,23,19,4
20,23,123,18,9,9
20,23,124,13,17,-4
20,23,125,8,22,-14
20,23,126,21,21,0
20,23,127,16,19,-3
20,23,128,11,22,-11
20,23,129,8,14,-6
20,23,130,12,16,-4
20,23,131,11,26,-15
20,23,132,15,17,-2
20,23,133,26,14,12
20,23,134,15,23,-8
20,23,135,14,13,1
20,23,136,6,9,-3
20,23,137,9,13,-4
20,23,138,12,8,4
20,23,139,18,17,1
20,23,140,13,6,7
20,23,141,11,9,2
20,23,142,15,12,3
20,23,143,18,15,3
20,23,144,8,12,-4
20,23,145,11,12,-1
20,23,146,25,28,-3
20,23,147,10,9,1
20,23,148,26,20,6
20,23,149,9,23,-14
20,23,150,15,15,0
20,23,151,16,10,6
20,23,152,11,11,0
20,23,153,14,15,-1
20,23,154,21,13,8
20,23,155,14,17,-3
20,23,156,20,17,3
20,23,157,12,10,2
20,23,158,13,27,-14
20,23,159,14,17,-3
20,23,160,20,16,4
20,23,161,18,17,1
20,23,162,7,10,-3
20,23,163,4,9,-5
20,23,164,13,6,7
20,23,165,6,13,-7
20,23,166,9,15,-6
20,23,167,13,6,7
20,23,168,22,13,9
20,23,169,22,19,3
20,23,170,14,10,4
20,23,171,11,19,-8
20,23,172,17,21,-4
20,23,173,13,17,-4
20,23,174,33,14,19
20,23,175,13,20,-7
20,23,176,13,21,-8
20,23,177,8,8,0
20,23,178,20,9,11
20,23,179,11,11,0
20,23,180,7,11,-4
20,23,181,11,19,-8
20,23,182,15,29,-14
20,23,183,9,13,-4
20,23,184,4,9,-5
20,23,185,14,16,-2
20,23,186,14,16,-2
20,23,187,10,17,-7
20,23,188,10,9,1
20,23,189,7,7,0
20,23,190,11,11,0
20,23,191,16,12,4
20,23,192,14,20,-6
20,23,193,22,20,2
20,23,194,15,17,-2
20,23,195,15,16,-1
20,23,196,21,17,4
20,23,197,17,14,3
20,23,198,10,11,-1
20,23,199,22,22,0
20,23,200,16,7,9
20,23,201,15,13,2
20,23,202,8,8,0
20,23,203,7,16,-9
20,23,204,9,11,-2
20,23,205,25,21,4
20,23,206,13,9,4
20,23,207,25,18,7
20,23,208,5,12,-7
20,23,209,17,12,5
20,23,210,15,13,2
20,23,211,11,10,1
20,23,212,12,12,0
20,23,213,11,13,-2
20,23,214,22,18,4
20,23,215,9,7,2
20,23,216,21,22,-1
20,23,217,9,14,-5
20,23,218,16,13,3
20,23,219,14,21,-7
20,23,220,17,12,5
20,23,221,26,11,15
20,23,222,10,28,-18
20,23,223,13,10,3
20,23,224,12,8,4
20,23,225,18,16,2
20,23,226,14,11,3
20,23,227,14,9,5
20,23,228,12,5,7
20,23,229,12,7,5
20,23,230,17,4,13
20,23,231,13,16,-3
20,23,232,20,17,3
20,23,233,8,16,-8
20,23,234,24,14,10
20,23,235,16,11,5
20,23,236,14,16,-2
20,23,237,18,16,2
20,23,238,12,13,-1
20,23,239,15,12,3
20,23,240,17,8,9
20,23,241,9,16,-7
20,23,242,17,20,-3
20,23,243,8,16,-8
20,23,244,14,8,6
20,23,245,13,27,-14
20,23,246,9,6,3
20,23,247,7,1,6
20,23,248,14,15,-1
20,23,249,20,19,1
20,23,250,11,13,-2
20,23,251,15,15,0
20,23,252,15,25,-10
20,23,253,11,17,-6
20,23,254,15,17,-2
20,23,255,24,30,-6
20,23,256,24,15,9
20,23,257,7,7,0
20,23,258,25,21,4
20,23,259,13,4,9
20,23,260,9,17,-8
20,23,261,16,17,-1
20,23,262,15,12,3
20,23,263,14,11,3
20,23,264,19,21,-2
20,23,265,11,17,-6
20,23,266,9,15,-6
20,23,267,18,20,-2
20,23,268,25,19,6
20,23,269,18,17,1
20,23,270,18,24,-6
20,23,271,6,10,-4
20,23,272,16,11,5
20,23,273,13,10,3
20,23,274,12,18,-6
20,23,275,15,19,-4
20,23,276,18,29,-11
20,23,277,7,13,-6
20,23,278,12,15,-3
20,23,279,5,6,-1
20,23,280,20,19,1
20,23,281,16,12,4
20,23,282,9,13,-4
20,23,283,13,13,0
20,23,284,18,18,0
20,23,285,15,12,3
20,23,286,19,18,1
20,23,287,14,12,2
20,23,288,17,22,-5
20,23,289,28,18,10
20,23,290,17,6,11
20,23,291,8,16,-8
20,23,292,12,17,-5
20,23,293,32,19,13
20,23,294,17,22,-5
20,23,295,18,5,13
20,23,296,11,16,-5
20,23,297,5,26,-21
20,23,298,25,19,6
20,23,299,9,12,-3
20,24,0,10,11,-1
20,24,1,11,7,4
20,24,2,10,22,-12
20,24,3,9,8,1
20,24,4,18,17,1
20,24,5,21,7,14
20,24,6,11,9,2
20,24,7,9,21,-12
20,24,8,23,12,11
20,24,9,16,16,0
20,24,10,13,6,7
20,24,11,23,9,14
20,24,12,10,7,3
20,24,13,15,33,-18
20,24,14,20,15,5
20,24,15,5,5,0
20,24,16,6,19,-13
20,24,17,16,18,-2
20,24,18,14,6,8
20,24,19,15,13,2
20,24,20,20,5,15
20,24,21,6,25,-19
20,24,22,6,14,-8
20,24,23,16,8,8
20,24,24,9,13,-4
20,24,25,13,17,-4
20,24,26,18,12,6
20,24,27,6,14,-8
20,24,28,21,11,10
20,24,29,20,26,-6
20,24,30,13,14,-1
20,24,31,10,11,-1
20,24,32,4,16,-12
20,24,33,23,13,10
20,24,34,23,18,5
20,24,35,23,10,13
20,24,36,11,7,4
20,24,37,9,15,-6
20,24,38,21,19,2
20,24,39,20,11,9
20,24,40,25,16,9
20,24,41,7,16,-9
20,24,42,6,15,-9
20,24,43,19,17,2
20,24,44,18,17,1
20,24,45,27,8,19
20,24,46,20,15,5
20,24,47,16,14,2
20,24,48,14,20,-6
20,24,49,16,17,-1
20,24,50,24,12,12
20,24,51,17,17,0
20,24,52,12,11,1
20,24,53,13,10,3
20,24,54,16,18,-2
20,24,55,21,16,5
20,24,56,12,8,4
20,24,57,16,11,5
20,24,58,17,16,1
20,24,59,13,15,-2
20,24,60,24,25,-1
20,24,61,9,11,-2
20,24,62,9,4,5
20,24,63,15,7,8
20,24,64,20,15,5
20,24,65,23,18,5
20,24,66,12,20,-8
20,24,67,15,10,5
20,24,68,18,22,-4
20,24,69,17,8,9
20,24,70,12,24,-12
20,24,71,10,11,-1
20,24,72,24,19,5
20,24,73,12,12,0
20,24,74,17,19,-2
20,24,75,23,7,16
20,24,76,9,9,0
20,24,77,28,12,16
20,24,78,12,20,-8
20,24,79,6,9,-3
20,24,80,14,9,5
20,24,81,12,15,-3
20,24,82,22,32,-10
20,24,83,16,24,-8
20,24,84,14,20,-6
20,24,85,10,16,-6
20,24,86,19,16,3
20,24,87,11,14,-3
20,24,88,13,11,2
20,24,89,10,6,4
20,24,90,10,14,-4
20,24,91,15,13,2
20,24,92,15,11,4
20,24,93,22,14,8
20,24,94,14,11,3
20,24,95,26,10,16
20,24,96,17,12,5
20,24,97,13,13,0
20,24,98,7,21,-14
20,24,99,8,13,-5
20,24,100,19,11,8
20,24,101,14,5,9
20,24,102,23,19,4
20,24,103,10,15,-5
20,24,104,22,11,11
20,24,105,8,9,-1
20,24,106,17,14,3
20,24,107,12,23,-11
20,24,108,7,14,-7
20,24,109,5,19,-14
20,24,110,13,7,6
20,24,111,13,6,7
20,24,112,9,11,-2
20,24,113,19,13,6
20,24,114,13,33,-20
20,24,115,11,14,-3
20,24,116,9,15,-6
20,24,117,14,24,-10
20,24,118,19,4,15
20,24,119,26,10,16
20,24,120,17,15,2
20,24,121,11,20,-9
20,24,122,19,27,-8
20,24,123,21,16,5
20,24,124,10,22,-12
20,24,125,26,19,7
20,24,126,12,11,1
20,24,127,11,13,-2
20,24,128,15,19,-4
20,24,129,19,19,0
20,24,130,7,9,-2
20,24,131,14,22,-8
20,24,132,17,14,3
20,24,133,24,20,4
20,24,134,14,20,-6
20,24,135,14,15,-1
20,24,136,13,5,8
20,24,137,17,10,7
20,24,138,20,12,8
20,24,139,19,21,-2
20,24,140,14,13,1
20,24,141,11,11,0
20,24,142,19,12,7
20,24,143,10,12,-2
20,24,144,15,11,4
20,24,145,10,14,-4
20,24,146,29,10,19
20,24,147,3,7,-4
20,24,148,11,6,5
20,24,149,7,10,-3
20,24,150,16,11,5
20,24,151,18,22,-4
20,24,152,9,12,-3
20,24,153,13,7,6
20,24,154,12,21,-9
20,24,155,18,12,6
20,24,156,27,18,9
20,24,157,23,17,6
20,24,158,15,17,-2
20,24,159,5,13,-8
20,24,160,16,27,-11
20,24,161,9,5,4
20,24,162,6,17,-11
20,24,163,11,9,2
20,24,164,11,13,-2
20,24,165,20,11,9
20,24,166,18,19,-1
20,24,167,25,17,8
20,24,168,13,20,-7
20,24,169,9,17,-8
20,24,170,18,10,8
20,24,171,18,25,-7
20,24,172,12,19,-7
20,24,173,29,14,15
20,24,174,18,14,4
20,24,175,6,11,-5
20,24,176,21,16,5
20,24,177,8,13,-5
20,24,178,10,18,-8
20,24,179,24,19,5
20,24,180,20,31,-11
20,24,181,7,14,-7
20,24,182,16,9,7
20,24,183,12,13,-1
20,24,184,12,16,-4
20,24,185,4,12,-8
20,24,186,11,10,1
20,24,187,2,5,-3
20,24,188,14,23,-9
20,24,189,13,9,4
20,24,190,15,20,-5
20,24,191,32,21,11
20,24,192,16,13,3
20,24,193,17,1,16
20,24,194,20,16,4
20,24,195,16,15,1
20,24,196,8,6,2
20,24,197,17,7,10
20,24,198,25,18,7
20,24,199,2,10,-8
20,24,200,18,15,3
20,24,201,29,27,2
20,24,202,10,23,-13
20,24,203,24,15,9
20,24,204,14,14,0
20,24,205,22,18,4
20,24,206,12,15,-3
20,24,207,15,19,-4
20,24,208,8,14,-6
20,24,209,24,13,11
20,24,210,21,12,9
20,24,211,14,17,-3
20,24,212,15,10,5
20,24,213,9,15,-6
20,24,214,14,14,0
20,24,215,14,13,1
20,24,216,21,11,10
20,24,217,19,31,-12
20,24,218,13,13,0
20,24,219,14,13,1
20,24,220,21,6,15
20,24,221,18,28,-10
20,24,222,17,26,-9
20,24,223,13,5,8
20,24,224,15,5,10
20,24,225,32,23,9
20,24,226,23,16,7
20,24,227,16,19,-3
20,24,228,4,16,-12
20,24,229,18,18,0
20,24,230,14,15,-1
20,24,231,12,7,5
20,24,232,8,5,3
20,24,233,20,20,0
20,24,234,29,11,18
20,24,235,11,15,-4
20,24,236,7,9,-2
20,24,237,13,10,3
20,24,238,6,8,-2
20,24,239,27,12,15
20,24,240,13,8,5
20,24,241,22,14,8
20,24,242,22,12,10
20,24,243,11,11,0
20,24,244,33,17,16
20,24,245,14,5,9
20,24,246,6,7,-1
20,24,247,8,14,-6
20,24,248,25,22,3
20,24,249,35,23,12
20,24,250,13,11,2
20,24,251,13,10,3
20,24,252,16,22,-6
20,24,253,12,7,5
20,24,254,21,19,2
20,24,255,10,10,0
20,24,256,21,7,14
20,24,257,31,13,18
20,24,258,19,18,1
20,24,259,26,11,15
20,24,260,11,6,5
20,24,261,18,16,2
20,24,262,26,17,9
20,24,263,12,17,-5
20,24,264,16,8,8
20,24,265,15,11,4
20,24,266,10,25,-15
20,24,267,23,10,13
20,24,268,10,22,-12
20,24,269,10,12,-2
20,24,270,9,11,-2
20,24,271,17,10,7
20,24,272,22,17,5
20,24,273,12,29,-17
20,24,274,30,9,21
20,24,275,14,18,-4
20,24,276,18,21,-3
20,24,277,10,9,1
20,24,278,13,15,-2
20,24,279,18,20,-2
20,24,280,10,15,-5
20,24,281,8,13,-5
20,24,282,15,21,-6
20,24,283,11,9,2
20,24,284,14,7,7
20,24,285,11,7,4
20,24,286,9,4,5
20,24,287,25,11,14
20,24,288,14,15,-1
20,24,289,19,13,6
20,24,290,25,12,13
20,24,291,14,20,-6
20,24,292,14,20,-6
20,24,293,16,7,9
20,24,294,24,16,8
20,24,295,19,20,-1
20,24,296,12,19,-7
20,24,297,11,7,4
20,24,298,13,12,1
20,24,299,21,20,1
20,25,0,11,3,8
20,25,1,8,11,-3
20,25,2,2,8,-6
20,25,3,19,15,4
20,25,4,11,12,-1
20,25,5,5,10,-5
20,25,6,8,15,-7
20,25,7,20,13,7
20,25,8,16,15,1
20,25,9,21,15,6
20,25,10,15,12,3
20,25,11,15,13,2
20,25,12,9,10,-1
20,25,13,9,7,2
20,25,14,22,19,3
20,25,15,18,17,1
20,25,16,25,9,16
20,25,17,11,15,-4
20,25,18,13,14,-1
20,25,19,16,14,2
20,25,20,21,9,12
20,25,21,14,16,-2
20,25,22,23,21,2
20,25,23,12,11,1
20,25,24,18,11,7
20,25,25,15,18,-3
20,25,26,11,13,-2
20,25,27,15,14,1
20,25,28,17,14,3
20,25,29,6,8,-2
20,25,30,11,3,8
20,25,31,30,26,4
20,25,32,18,10,8
20,25,33,18,12,6
20,25,34,12,5,7
20,25,35,11,11,0
20,25,36,17,9,8
20,25,37,7,4,3
20,25,38,13,14,-1
20,25,39,7,23,-16
20,25,40,10,19,-9
20,25,41,12,8,4
20,25,42,10,9,1
20,25,43,11,9,2
20,25,44,24,14,10
20,25,45,20,27,-7
20,25,46,13,12,1
20,25,47,7,16,-9
20,25,48,20,13,7
20,25,49,19,17,2
20,25,50,14,5,9
20,25,51,8,14,-6
20,25,52,17,14,3
20,25,53,20,16,4
20,25,54,24,12,12
20,25,55,14,9,5
20,25,56,14,27,-13
20,25,57,15,11,4
20,25,58,8,7,1
20,25,59,21,10,11
20,25,60,10,11,-1
20,25,61,9,11,-2
20,25,62,13,12,1
20,25,63,18,6,12
20,25,64,14,14,0
20,25,65,25,22,3
20,25,66,16,6,10
20,25,67,19,10,9
20,25,68,21,19,2
20,25,69,10,12,-2
20,25,70,14,13,1
20,25,71,21,18,3
20,25,72,10,14,-4
20,25,73,16,7,9
20,25,74,9,13,-4
20,25,75,12,19,-7
20,25,76,17,12,5
20,25,77,10,15,-5
20,25,78,9,10,-1
20,25,79,11,5,6
20,25,80,10,10,0
20,25,81,4,8,-4
20,25,82,13,16,-3
20,25,83,9,12,-3
20,25,84,10,8,2
20,25,85,17,16,1
20,25,86,7,15,-8
20,25,87,18,14,4
20,25,88,24,11,13
20,25,89,10,15,-5
20,25,90,13,22,-9
20,25,91,18,7,11
20,25,92,15,26,-11
20,25,93,15,5,10
20,25,94,15,23,-8
20,25,95,15,11,4
20,25,96,23,9,14
20,25,97,23,15,8
20,25,98,8,10,-2
20,25,99,7,19,-12
20,25,100,10,15,-5
20,25,101,22,11,11
20,25,102,12,9,3
20,25,103,20,32,-12
20,25,104,27,17,10
20,25,105,8,13,-5
20,25,106,15,18,-3
20,25,107,16,13,3
20,25,108,15,12,3
20,25,109,13,13,0
20,25,110,11,7,4
20,25,111,20,14,6
20,25,112,12,20,-8
20,25,113,15,16,-1
20,25,114,23,19,4
20,25,115,19,15,4
20,25,116,13,9,4
20,25,117,11,11,0
20,25,118,11,6,5
20,25,119,10,14,-4
20,25,120,2,12,-10
20,25,121,12,12,0
20,25,122,18,16,2
20,25,123,18,18,0
20,25,124,12,15,-3
20,25,125,9,13,-4
20,25,126,21,21,0
20,25,127,13,13,0
20,25,128,9,15,-6
20,25,129,18,17,1
20,25,130,18,7,11
20,25,131,22,18,4
20,25,132,17,14,3
20,25,133,13,8,5
20,25,134,15,16,-1
20,25,135,12,8,4
20,25,136,30,14,16
20,25,137,10,9,1
20,25,138,16,8,8
20,25,139,11,13,-2
20,25,140,8,8,0
20,25,141,26,15,11
20,25,142,12,18,-6
20,25,143,18,11,7
20,25,144,12,7,5
20,25,145,13,6,7
20,25,146,14,16,-2
20,25,147,14,17,-3
20,25,148,16,11,5
20,25,149,10,13,-3
20,25,150,9,3,6
20,25,151,17,21,-4
20,25,152,5,11,-6
20,25,153,14,14,0
20,25,154,13,19,-6
20,25,155,20,8,12
20,25,156,10,17,-7
20,25,157,13,12,1
20,25,158,12,22,-10
20,25,159,10,13,-3
20,25,160,7,11,-4
20,25,161,7,7,0
20,25,162,24,8,16
20,25,163,15,19,-4
20,25,164,19,18,1
20,25,165,11,18,-7
20,25,166,20,17,3
20,25,167,16,10,6
20,25,168,10,15,-5
20,25,169,9,8,1
20,25,170,13,18,-5
20,25,171,17,16,1
20,25,172,7,9,-2
20,25,173,17,17,0
20,25,174,19,20,-1
20,25,175,15,13,2
20,25,176,16,18,-2
20,25,177,17,16,1
20,25,178,20,17,3
20,25,179,20,11,9
20,25,180,13,15,-2
20,25,181,30,18,12
20,25,182,7,10,-3
20,25,183,17,8,9
20,25,184,13,9,4
20,25,185,23,8,15
20,25,186,5,10,-5
20,25,187,19,12,7
20,25,188,19,11,8
20,25,189,12,11,1
20,25,190,18,14,4
20,25,191,8,10,-2
20,25,192,11,10,1
20,25,193,7,12,-5
20,25,194,18,12,6
20,25,195,19,11,8
20,25,196,8,5,3
20,25,197,24,13,11
20,25,198,21,18,3
20,25,199,16,11,5
20,25,200,13,14,-1
20,25,201,9,17,-8
20,25,202,7,10,-3
20,25,203,22,18,4
20,25,204,26,16,10
20,25,205,8,31,-23
20,25,206,7,11,-4
20,25,207,15,19,-4
20,25,208,19,13,6
20,25,209,15,20,-5
20,25,210,16,23,-7
20,25,211,25,15,10
20,25,212,12,12,0
20,25,213,13,23,-10
20,25,214,8,8,0
20,25,215,12,8,4
20,25,216,14,7,7
20,25,217,16,8,8
20,25,218,36,21,15
20,25,219,19,15,4
20,25,220,27,16,11
20,25,221,15,25,-10
20,25,222,15,22,-7
20,25,223,17,17,0
20,25,224,18,14,4
20,25,225,31,11,20
20,25,226,20,32,-12
20,25,227,21,7,14
20,25,228,16,16,0
20,25,229,12,6,6
20,25,230,12,18,-6
20,25,231,26,14,12
20,25,232,13,14,-1
20,25,233,18,30,-12
20,25,234,16,14,2
20,25,235,11,13,-2
20,25,236,25,10,15
20,25,237,9,9,0
20,25,238,8,15,-7
20,25,239,18,14,4
20,25,240,17,21,-4
20,25,241,8,9,-1
20,25,242,13,7,6
20,25,243,14,24,-10
20,25,244,18,17,1
20,25,245,8,11,-3
20,25,246,12,10,2
20,25,247,16,14,2
20,25,248,17,13,4
20,25,249,16,19,-3
20,25,250,10,7,3
20,25,251,17,15,2
20,25,252,16,25,-9
20,25,253,27,14,13
20,25,254,25,22,3
20,25,255,12,15,-3
20,25,256,6,7,-1
20,25,257,17,16,1
20,25,258,13,15,-2
20,25,259,18,16,2
20,25,260,20,15,5
20,25,261,23,21,2
20,25,262,20,16,4
20,25,263,13,20,-7
20,25,264,14,19,-5
20,25,265,27,16,11
20,25,266,6,6,0
20,25,267,12,7,5
20,25,268,18,10,8
20,25,269,10,24,-14
20,25,270,19,20,-1
20,25,271,24,17,7
20,25,272,14,5,9
20,25,273,6,14,-8
20,25,274,13,6,7
20,25,275,13,15,-2
20,25,276,13,15,-2
20,25,277,21,13,8
20,25,278,13,22,-9
20,25,279,8,8,0
20,25,280,14,13,1
20,25,281,19,9,10
20,25,282,24,6,18
20,25,283,4,3,1
20,25,284,13,17,-4
20,25,285,7,19,-12
20,25,286,13,18,-5
20,25,287,6,10,-4
20,25,288,15,16,-1
20,25,289,31,12,19
20,25,290,18,11,7
20,25,291,13,9,4
20,25,292,12,14,-2
20,25,293,4,5,-1
20,25,294,14,23,-9
20,25,295,19,13,6
20,25,296,10,11,-1
20,25,297,16,4,12
20,25,298,5,9,-4
20,25,299,14,13,1
20,26,0,14,19,-5
20,26,1,6,8,-2
20,26,2,13,10,3
20,26,3,10,16,-6
20,26,4,7,14,-7
20,26,5,25,20,5
20,26,6,17,11,6
20,26,7,6,6,0
20,26,8,16,11,5
20,26,9,22,18,4
20,26,10,11,13,-2
20,26,11,27,13,14
20,26,12,8,13,-5
20,26,13,17,14,3
20,26,14,15,4,11
20,26,15,7,12,-5
20,26,16,11,24,-13
20,26,17,13,22,-9
20,26,18,15,5,10
20,26,19,28,7,21
20,26,20,12,17,-5
20,26,21,21,17,4
20,26,22,15,10,5
20,26,23,17,11,6
20,26,24,29,28,1
20,26,25,7,10,-3
20,26,26,13,10,3
20,26,27,11,5,6
20,26,28,11,17,-6
20,26,29,8,5,3
20,26,30,12,19,-7
20,26,31,23,19,4
20,26,32,3,4,-1
20,26,33,9,12,-3
20,26,34,14,11,3
20,26,35,20,26,-6
20,26,36,17,11,6
20,26,37,10,8,2
20,26,38,21,8,13
20,26,39,13,10,3
20,26,40,21,21,0
20,26,41,18,10,8
20,26,42,26,29,-3
20,26,43,17,9,8
20,26,44,22,12,10
20,26,45,18,24,-6
20,26,46,9,20,-11
20,26,47,20,18,2
20,26,48,15,18,-3
20,26,49,21,12,9
20,26,50,14,4,10
20,26,51,27,31,-4
20,26,52,13,26,-13
20,26,53,14,7,7
20,26,54,18,12,6
20,26,55,8,13,-5
20,26,56,19,6,13
20,26,57,21,18,3
20,26,58,14,10,4
20,26,59,11,13,-2
20,26,60,19,17,2
20,26,61,4,4,0
20,26,62,16,17,-1
20,26,63,15,17,-2
20,26,64,16,19,-3
20,26,65,18,9,9
20,26,66,11,12,-1
20,26,67,15,11,4
20,26,68,14,6,8
20,26,69,31,14,17
20,26,70,19,17,2
20,26,71,12,10,2
20,26,72,25,19,6
20,26,73,19,25,-6
20,26,74,13,11,2
20,26,75,6,15,-9
20,26,76,30,17,13
20,26,77,15,11,4
20,26,78,15,13,2
20,26,79,11,8,3
20,26,80,23,31,-8
20,26,81,16,15,1
20,26,82,26,16,10
20,26,83,9,6,3
20,26,84,13,27,-14
20,26,85,19,16,3
20,26,86,11,13,-2
20,26,87,9,15,-6
20,26,88,18,18,0
20,26,89,21,16,5
20,26,90,22,7,15
20,26,91,2,3,-1
20,26,92,23,23,0
20,26,93,13,18,-5
20,26,94,13,15,-2
20,26,95,4,10,-6
20,26,96,6,15,-9
20,26,97,21,14,7
20,26,98,15,15,0
20,26,99,2,6,-4
20,26,100,9,9,0
20,26,101,1,10,-9
20,26,102,25,11,14
20,26,103,17,14,3
20,26,104,15,26,-11
20,26,105,19,18,1
20,26,106,15,20,-5
20,26,107,19,13,6
20,26,108,14,6,8
20,26,109,21,17,4
20,26,110,16,6,10
20,26,111,16,23,-7
20,26,112,17,8,9
20,26,113,28,29,-1
20,26,114,15,8,7
20,26,115,11,14,-3
20,26,116,14,3,11
20,26,117,16,9,7
20,26,118,26,23,3
20,26,119,10,6,4
20,26,120,14,7,7
20,26,121,10,19,-9
20,26,122,11,12,-1
20,26,123,8,7,1
20,26,124,21,15,6
20,26,125,15,8,7
20,26,126,11,22,-11
20,26,127,16,10,6
20,26,128,11,3,8
20,26,129,30,18,12
20,26,130,19,22,-3
20,26,131,23,17,6
20,26,132,17,12,5
20,26,133,23,17,6
20,26,134,24,11,13
20,26,135,10,15,-5
20,26,136,17,13,4
20,26,137,3,15,-12
20,26,138,17,14,3
20,26,139,15,14,1
20,26,140,16,13,3
20,26,141,11,15,-4
20,26,142,12,13,-1
20,26,143,21,19,2
20,26,144,13,12,1
20,26,145,19,13,6
20,26,146,22,27,-5
20,26,147,12,11,1
20,26,148,24,16,8
20,26,149,22,14,8
20,26,150,10,10,0
20,26,151,6,17,-11
20,26,152,25,28,-3
20,26,153,15,3,12
20,26,154,14,15,-1
20,26,155,19,7,12
20,26,156,15,21,-6
20,26,157,16,13,3
20,26,158,23,17,6
20,26,159,25,10,15
20,26,160,15,12,3
20,26,161,10,2,8
20,26,162,21,20,1
20,26,163,19,11,8
20,26,164,16,9,7
20,26,165,16,19,-3
20,26,166,8,11,-3
20,26,167,18,9,9
20,26,168,12,18,-6
20,26,169,6,11,-5
20,26,170,6,5,1
20,26,171,25,21,4
20,26,172,8,8,0
20,26,173,13,2,11
20,26,174,6,9,-3
20,26,175,11,5,6
20,26,176,7,13,-6
20,26,177,11,10,1
20,26,178,18,21,-3
20,26,179,12,6,6
20,26,180,12,16,-4
20,26,181,15,9,6
20,26,182,19,15,4
20,26,183,15,14,1
20,26,184,26,12,14
20,26,185,31,18,13
20,26,186,8,17,-9
20,26,187,22,26,-4
20,26,188,28,16,12
20,26,189,16,14,2
20,26,190,14,7,7
20,26,191,22,12,10
20,26,192,8,7,1
20,26,193,32,14,18
20,26,194,12,10,2
20,26,195,11,19,-8
20,26,196,12,12,0
20,26,197,14,13,1
20,26,198,17,14,3
20,26,199,19,26,-7
20,26,200,13,8,5
20,26,201,22,13,9
20,26,202,26,24,2
20,26,203,18,12,6
20,26,204,15,8,7
20,26,205,15,9,6
20,26,206,16,23,-7
20,26,207,18,19,-1
20,26,208,13,13,0
20,26,209,12,21,-9
20,26,210,20,18,2
20,26,211,19,12,7
20,26,212,6,8,-2
20,26,213,18,12,6
20,26,214,8,10,-2
20,26,215,7,15,-8
20,26,216,18,22,-4
20,26,217,17,17,0
20,26,218,16,16,0
20,26,219,10,14,-4
20,26,220,7,10,-3
20,26,221,13,9,4
20,26,222,14,7,7
20,26,223,12,13,-1
20,26,224,16,19,-3
20,26,225,9,15,-6
20,26,226,8,14,-6
20,26,227,11,14,-3
20,26,228,16,14,2
20,26,229,6,13,-7
20,26,230,11,13,-2
20,26,231,4,5,-1
20,26,232,10,10,0
20,26,233,10,18,-8
20,26,234,13,11,2
20,26,235,21,18,3
20,26,236,26,7,19
20,26,237,7,6,1
20,26,238,20,15,5
20,26,239,14,7,7
20,26,240,14,13,1
20,26,241,15,2,13
20,26,242,27,12,15
20,26,243,26,13,13
20,26,244,11,5,6
20,26,245,14,11,3
20,26,246,8,5,3
20,26,247,25,16,9
20,26,248,19,11,8
20,26,249,8,10,-2
20,26,250,22,10,12
20,26,251,21,23,-2
20,26,252,20,7,13
20,26,253,5,5,0
20,26,254,23,23,0
20,26,255,18,10,8
20,26,256,14,11,3
20,26,257,12,12,0
20,26,258,5,13,-8
20,26,259,33,16,17
20,26,260,12,19,-7
20,26,261,10,9,1
20,26,262,12,19,-7
20,26,263,16,4,12
20,26,264,8,9,-1
20,26,265,22,13,9
20,26,266,25,23,2
20,26,267,26,32,-6
20,26,268,15,14,1
20,26,269,17,7,10
20,26,270,8,4,4
20,26,271,11,13,-2
20,26,272,12,17,-5
20,26,273,12,13,-1
20,26,274,7,19,-12
20,26,275,7,8,-1
20,26,276,12,17,-5
20,26,277,28,16,12
20,26,278,25,10,15
20,26,279,10,11,-1
20,26,280,10,12,-2
20,26,281,11,11,0
20,26,282,16,12,4
20,26,283,15,16,-1
20,26,284,16,13,3
20,26,285,13,8,5
20,26,286,21,7,14
20,26,287,17,11,6
20,26,288,12,10,2
20,26,289,18,15,3
20,26,290,14,7,7
20,26,291,11,17,-6
20,26,292,20,8,12
20,26,293,15,14,1
20,26,294,22,16,6
20,26,295,18,3,15
20,26,296,19,7,12
20,26,297,22,12,10
20,26,298,14,10,4
20,26,299,14,8,6
20,27,0,19,19,0
20,27,1,11,8,3
20,27,2,7,17,-10
20,27,3,12,7,5
20,27,4,17,5,12
20,27,5,9,5,4
20,27,6,16,23,-7
20,27,7,14,21,-7
20,27,8,17,15,2
20,27,9,25,19,6
20,27,10,11,6,5
20,27,11,18,10,8
20,27,12,8,7,1
20,27,13,16,9,7
20,27,14,24,17,7
20,27,15,9,14,-5
20,27,16,19,13,6
20,27,17,12,23,-11
20,27,18,14,12,2
20,27,19,15,8,7
20,27,20,20,13,7
20,27,21,10,17,-7
20,27,22,8,13,-5
20,27,23,10,9,1
20,27,24,25,15,10
20,27,25,11,6,5
20,27,26,8,11,-3
20,27,27,30,13,17
20,27,28,19,18,1
20,27,29,15,5,10
20,27,30,18,13,5
20,27,31,10,17,-7
20,27,32,17,16,1
20,27,33,20,12,8
20,27,34,24,9,15
20,27,35,7,3,4
20,27,36,14,8,6
20,27,37,13,6,7
20,27,38,5,17,-12
20,27,39,10,10,0
20,27,40,20,15,5
20,27,41,14,13,1
20,27,42,16,16,0
20,27,43,10,11,-1
20,27,44,5,10,-5
20,27,45,8,18,-10
20,27,46,25,25,0
20,27,47,5,5,0
20,27,48,7,11,-4
20,27,49,15,14,1
20,27,50,8,9,-1
20,27,51,15,8,7
20,27,52,17,8,9
20,27,53,4,4,0
20,27,54,11,15,-4
20,27,55,8,12,-4
20,27,56,14,5,9
20,27,57,25,19,6
20,27,58,24,14,10
20,27,59,26,15,11
20,27,60,13,9,4
20,27,61,17,10,7
20,27,62,14,12,2
20,27,63,17,13,4
20,27,64,10,12,-2
20,27,65,8,3,5
20,27,66,15,21,-6
20,27,67,11,7,4
20,27,68,18,11,7
20,27,69,12,13,-1
20,27,70,11,10,1
20,27,71,12,14,-2
20,27,72,10,8,2
20,27,73,19,18,1
20,27,74,19,22,-3
20,27,75,18,17,1
20,27,76,20,15,5
20,27,77,34,16,18
20,27,78,11,3,8
20,27,79,19,12,7
20,27,80,14,6,8
20,27,81,17,15,2
20,27,82,25,13,12
20,27,83,17,12,5
20,27,84,10,7,3
20,27,85,5,10,-5
20,27,86,18,11,7
20,27,87,9,15,-6
20,27,88,22,14,8
20,27,89,24,8,16
20,27,90,20,14,6
20,27,91,12,23,-11
20,27,92,10,8,2
20,27,93,20,16,4
20,27,94,11,6,5
20,27,95,24,4,20
20,27,96,11,2,9
20,27,97,22,10,12
20,27,98,20,13,7
20,27,99,13,4,9
20,27,100,20,17,3
20,27,101,6,9,-3
20,27,102,10,10,0
20,27,103,20,12,8
20,27,104,15,13,2
20,27,105,10,10,0
20,27,106,23,14,9
20,27,107,8,6,2
20,27,108,25,21,4
20,27,109,13,15,-2
20,27,110,25,8,17
20,27,111,6,9,-3
20,27,112,25,10,15
20,27,113,12,32,-20
20,27,114,11,10,1
20,27,115,16,19,-3
20,27,116,22,10,12
20,27,117,6,8,-2
20,27,118,18,12,6
20,27,119,12,12,0
20,27,120,14,17,-3
20,27,121,24,12,12
20,27,122,15,11,4
20,27,123,20,9,11
20,27,124,21,13,8
20,27,125,19,5,14
20,27,126,7,17,-10
20,27,127,9,11,-2
20,27,128,21,16,5
20,27,129,25,16,9
20,27,130,21,16,5
20,27,131,12,7,5
20,27,132,13,7,6
20,27,133,12,11,1
20,27,134,13,11,2
20,27,135,15,13,2
20,27,136,9,12,-3
20,27,137,14,13,1
20,27,138,23,18,5
20,27,139,30,10,20
20,27,140,23,15,8
20,27,141,11,18,-7
20,27,142,13,10,3
20,27,143,26,17,9
20,27,144,18,18,0
20,27,145,16,12,4
20,27,146,16,6,10
20,27,147,5,14,-9
20,27,148,17,12,5
20,27,149,20,15,5
20,27,150,13,17,-4
20,27,151,16,6,10
20,27,152,11,11,0
20,27,153,13,15,-2
20,27,154,12,17,-5
20,27,155,2,7,-5
20,27,156,11,10,1
20,27,157,18,10,8
20,27,158,13,19,-6
20,27,159,11,28,-17
20,27,160,12,6,6
20,27,161,11,6,5
20,27,162,17,7,10
20,27,163,9,14,-5
20,27,164,15,6,9
20,27,165,11,15,-4
20,27,166,16,14,2
20,27,167,10,9,1
20,27,168,7,14,-7
20,27,169,13,8,5
20,27,170,14,16,-2
20,27,171,15,12,3
20,27,172,25,14,11
20,27,173,5,6,-1
20,27,174,14,4,10
20,27,175,13,19,-6
20,27,176,8,7,1
20,27,177,25,18,7
20,27,178,10,10,0
20,27,179,24,12,12
20,27,180,25,11,14
20,27,181,5,4,1
20,27,182,9,5,4
20,27,183,6,12,-6
20,27,184,13,11,2
20,27,185,23,14,9
20,27,186,19,15,4
20,27,187,3,7,-4
20,27,188,25,20,5
20,27,189,3,5,-2
20,27,190,15,11,4
20,27,191,17,5,12
20,27,192,18,4,14
20,27,193,9,12,-3
20,27,194,18,22,-4
20,27,195,27,15,12
20,27,196,17,9,8
20,27,197,9,7,2
20,27,198,16,19,-3
20,27,199,10,10,0
20,27,200,24,15,9
20,27,201,15,23,-8
20,27,202,29,13,16
20,27,203,17,12,5
20,27,204,18,16,2
20,27,205,13,20,-7
20,27,206,16,19,-3
20,27,207,8,5,3
20,27,208,18,6,12
20,27,209,19,26,-7
20,27,210,20,14,6
20,27,211,14,4,10
20,27,212,15,13,2
20,27,213,19,11,8
20,27,214,12,18,-6
20,27,215,14,11,3
20,27,216,20,10,10
20,27,217,9,4,5
20,27,218,4,13,-9
20,27,219,8,16,-8
20,27,220,16,10,6
20,27,221,17,20,-3
20,27,222,25,15,10
20,27,223,17,6,11
20,27,224,7,2,5
20,27,225,24,13,11
20,27,226,22,17,5
20,27,227,7,6,1
20,27,228,13,6,7
20,27,229,18,13,5
20,27,230,23,19,4
20,27,231,17,16,1
20,27,232,9,23,-14
20,27,233,11,2,9
20,27,234,7,17,-10
20,27,235,9,8,1
20,27,236,12,10,2
20,27,237,11,6,5
20,27,238,24,19,5
20,27,239,10,10,0
20,27,240,22,9,13
20,27,241,8,14,-6
20,27,242,15,12,3
20,27,243,18,16,2
20,27,244,17,13,4
20,27,245,22,15,7
20,27,246,7,10,-3
20,27,247,32,10,22
20,27,248,12,16,-4
20,27,249,17,14,3
20,27,250,13,11,2
20,27,251,12,18,-6
20,27,252,13,15,-2
20,27,253,18,17,1
20,27,254,12,9,3
20,27,255,17,28,-11
20,27,256,21,5,16
20,27,257,22,19,3
20,27,258,13,17,-4
20,27,259,15,15,0
20,27,260,17,21,-4
20,27,261,24,7,17
20,27,262,12,15,-3
20,27,263,21,5,16
20,27,264,19,16,3
20,27,265,27,18,9
20,27,266,15,8,7
20,27,267,5,7,-2
20,27,268,12,5,7
20,27,269,23,18,5
20,27,270,13,16,-3
20,27,271,19,22,-3
20,27,272,12,11,1
20,27,273,14,13,1
20,27,274,10,8,2
20,27,275,12,10,2
20,27,276,23,14,9
20,27,277,13,10,3
20,27,278,15,17,-2
20,27,279,9,14,-5
20,27,280,11,19,-8
20,27,281,23,13,10
20,27,282,15,6,9
20,27,283,9,16,-7
20,27,284,18,15,3
20,27,285,6,12,-6
20,27,286,7,12,-5
20,27,287,10,15,-5
20,27,288,13,14,-1
20,27,289,3,12,-9
20,27,290,11,9,2
20,27,291,15,25,-10
20,27,292,7,11,-4
20,27,293,17,15,2
20,27,294,17,10,7
20,27,295,18,18,0
20,27,296,14,16,-2
20,27,297,18,17,1
20,27,298,18,18,0
20,27,299,18,13,5
20,28,0,22,16,6
20,28,1,21,15,6
20,28,2,20,11,9
20,28,3,13,11,2
20,28,4,5,7,-2
20,28,5,19,14,5
20,28,6,9,9,0
20,28,7,11,24,-13
20,28,8,13,17,-4
20,28,9,24,7,17
20,28,10,14,15,-1
20,28,11,21,24,-3
20,28,12,9,24,-15
20,28,13,11,5,6
20,28,14,24,24,0
20,28,15,24,10,14
20,28,16,17,18,-1
20,28,17,12,12,0
20,28,18,8,12,-4
20,28,19,7,7,0
20,28,20,14,17,-3
20,28,21,13,13,0
20,28,22,8,13,-5
20,28,23,11,12,-1
20,28,24,19,16,3
20,28,25,12,23,-11
20,28,26,12,11,1
20,28,27,12,13,-1
20,28,28,17,16,1
20,28,29,22,8,14
20,28,30,19,14,5
20,28,31,17,8,9
20,28,32,16,11,5
20,28,33,10,9,1
20,28,34,18,20,-2
20,28,35,7,5,2
20,28,36,9,9,0
20,28,37,5,12,-7
20,28,38,7,16,-9
20,28,39,17,23,-6
20,28,40,12,8,4
20,28,41,9,23,-14
20,28,42,7,6,1
20,28,43,5,4,1
20,28,44,11,9,2
20,28,45,10,10,0
20,28,46,13,22,-9
20,28,47,20,15,5
20,28,48,23,7,16
20,28,49,17,15,2
20,28,50,5,10,-5
20,28,51,15,27,-12
20,28,52,19,8,11
20,28,53,9,14,-5
20,28,54,20,18,2
20,28,55,12,18,-6
20,28,56,25,14,11
20,28,57,15,8,7
20,28,58,16,7,9
20,28,59,13,11,2
20,28,60,19,4,15
20,28,61,18,12,6
20,28,62,3,6,-3
20,28,63,5,15,-10
20,28,64,6,8,-2
20,28,65,9,6,3
20,28,66,24,19,5
20,28,67,9,10,-1
20,28,68,19,7,12
20,28,69,19,19,0
20,28,70,17,10,7
20,28,71,21,7,14
20,28,72,17,16,1
20,28,73,13,10,3
20,28,74,15,15,0
20,28,75,15,10,5
20,28,76,15,18,-3
20,28,77,7,20,-13
20,28,78,13,15,-2
20,28,79,12,12,0
20,28,80,15,18,-3
20,28,81,25,18,7
20,28,82,10,14,-4
20,28,83,11,14,-3
20,28,84,19,4,15
20,28,85,15,8,7
20,28,86,11,6,5
20,28,87,20,21,-1
20,28,88,21,21,0
20,28,89,12,6,6
20,28,90,14,18,-4
20,28,91,14,22,-8
20,28,92,11,14,-3
20,28,93,17,10,7
20,28,94,16,11,5
20,28,95,23,13,10
20,28,96,12,15,-3
20,28,97,31,22,9
20,28,98,15,9,6
20,28,99,14,14,0
20,28,100,14,15,-1
20,28,101,23,22,1
20,28,102,29,14,15
20,28,103,18,16,2
20,28,104,6,9,-3
20,28,105,9,9,0
20,28,106,25,18,7
20,28,107,9,6,3
20,28,108,18,15,3
20,28,109,10,8,2
20,28,110,13,7,6
20,28,111,21,13,8
20,28,112,23,24,-1
20,28,113,10,10,0
20,28,114,8,10,-2
20,28,115,17,13,4
20,28,116,26,11,15
20,28,117,8,3,5
20,28,118,9,11,-2
20,28,119,16,13,3
20,28,120,18,14,4
20,28,121,15,13,2
20,28,122,25,7,18
20,28,123,16,3,13
20,28,124,22,23,-1
20,28,125,15,20,-5
20,28,126,23,16,7
20,28,127,14,7,7
20,28,128,23,16,7
20,28,129,7,4,3
20,28,130,14,8,6
20,28,131,17,15,2
20,28,132,7,10,-3
20,28,133,20,8,12
20,28,134,13,13,0
20,28,135,9,9,0
20,28,136,11,15,-4
20,28,137,10,6,4
20,28,138,12,12,0
20,28,139,5,16,-11
20,28,140,21,8,13
20,28,141,7,14,-7
20,28,142,13,9,4
20,28,143,13,13,0
20,28,144,14,13,1
20,28,145,7,10,-3
20,28,146,9,13,-4
20,28,147,10,11,-1
20,28,148,20,9,11
20,28,149,16,15,1
20,28,150,18,15,3
20,28,151,21,9,12
20,28,152,5,18,-13
20,28,153,12,12,0
20,28,154,27,20,7
20,28,155,22,15,7
20,28,156,19,11,8
20,28,157,28,26,2
20,28,158,17,6,11
20,28,159,15,11,4
20,28,160,17,11,6
20,28,161,16,12,4
20,28,162,10,6,4
20,28,163,15,15,0
20,28,164,22,10,12
20,28,165,19,14,5
20,28,166,12,12,0
20,28,167,11,13,-2
20,28,168,10,10,0
20,28,169,16,15,1
20,28,170,21,16,5
20,28,171,26,11,15
20,28,172,22,16,6
20,28,173,11,7,4
20,28,174,20,9,11
20,28,175,7,16,-9
20,28,176,13,14,-1
20,28,177,17,13,4
20,28,178,17,10,7
20,28,179,18,16,2
20,28,180,20,15,5
20,28,181,14,17,-3
20,28,182,9,9,0
20,28,183,16,17,-1
20,28,184,19,11,8
20,28,185,20,19,1
20,28,186,0,9,-9
20,28,187,9,12,-3
20,28,188,26,6,20
20,28,189,21,20,1
20,28,190,15,11,4
20,28,191,9,12,-3
20,28,192,13,16,-3
20,28,193,17,19,-2
20,28,194,12,13,-1
20,28,195,16,8,8
20,28,196,9,16,-7
20,28,197,16,12,4
20,28,198,16,13,3
20,28,199,17,10,7
20,28,200,13,10,3
20,28,201,11,13,-2
20,28,202,26,17,9
20,28,203,13,13,0
20,28,204,17,19,-2
20,28,205,8,7,1
20,28,206,20,14,6
20,28,207,13,11,2
20,28,208,28,22,6
20,28,209,12,26,-14
20,28,210,15,10,5
20,28,211,18,3,15
20,28,212,20,10,10
20,28,213,19,10,9
20,28,214,25,18,7
20,28,215,17,8,9
20,28,216,14,10,4
20,28,217,18,13,5
20,28,218,24,13,11
20,28,219,19,16,3
20,28,220,10,9,1
20,28,221,14,21,-7
20,28,222,20,12,8
20,28,223,19,21,-2
20,28,224,22,15,7
20,28,225,19,13,6
20,28,226,14,21,-7
20,28,227,9,6,3
20,28,228,7,8,-1
20,28,229,14,16,-2
20,28,230,18,12,6
20,28,231,16,25,-9
20,28,232,15,9,6
20,28,233,18,22,-4
20,28,234,7,12,-5
20,28,235,10,10,0
20,28,236,7,5,2
20,28,237,10,13,-3
20,28,238,15,17,-2
20,28,239,26,5,21
20,28,240,5,8,-3
20,28,241,11,14,-3
20,28,242,19,14,5
20,28,243,14,13,1
20,28,244,8,10,-2
20,28,245,23,7,16
20,28,246,18,16,2
20,28,247,11,6,5
20,28,248,20,22,-2
20,28,249,8,14,-6
20,28,250,12,8,4
20,28,251,10,13,-3
20,28,252,19,14,5
20,28,253,23,19,4
20,28,254,9,12,-3
20,28,255,6,5,1
20,28,256,10,9,1
20,28,257,10,14,-4
20,28,258,21,14,7
20,28,259,14,15,-1
20,28,260,7,13,-6
20,28,261,4,10,-6
20,28,262,20,5,15
20,28,263,21,21,0
20,28,264,10,16,-6
20,28,265,16,17,-1
20,28,266,23,8,15
20,28,267,22,19,3
20,28,268,12,9,3
20,28,269,9,13,-4
20,28,270,9,10,-1
20,28,271,9,12,-3
20,28,272,8,5,3
20,28,273,24,13,11
20,28,274,16,16,0
20,28,275,12,8,4
20,28,276,11,20,-9
20,28,277,16,15,1
20,28,278,32,16,16
20,28,279,15,2,13
20,28,280,16,4,12
20,28,281,15,15,0
20,28,282,6,19,-13
20,28,283,21,11,10
20,28,284,18,18,0
20,28,285,13,20,-7
20,28,286,16,14,2
20,28,287,14,5,9
20,28,288,12,4,8
20,28,289,18,26,-8
20,28,290,9,11,-2
20,28,291,17,13,4
20,28,292,3,3,0
20,28,293,15,9,6
20,28,294,18,18,0
20,28,295,11,12,-1
20,28,296,18,12,6
20,28,297,10,4,6
20,28,298,20,21,-1
20,28,299,9,11,-2
20,29,0,25,10,15
20,29,1,29,21,8
20,29,2,14,20,-6
20,29,3,12,8,4
20,29,4,18,23,-5
20,29,5,12,10,2
20,29,6,16,11,5
20,29,7,12,12,0
20,29,8,30,11,19
20,29,9,22,14,8
20,29,10,16,14,2
20,29,11,13,10,3
20,29,12,16,11,5
20,29,13,11,7,4
20,29,14,27,9,18
20,29,15,21,11,10
20,29,16,12,7,5
20,29,17,11,10,1
20,29,18,19,9,10
20,29,19,8,11,-3
20,29,20,15,7,8
20,29,21,17,9,8
20,29,22,12,15,-3
20,29,23,8,15,-7
20,29,24,11,14,-3
20,29,25,8,1,7
20,29,26,4,18,-14
20,29,27,21,12,9
20,29,28,12,16,-4
20,29,29,16,8,8
20,29,30,22,21,1
20,29,31,19,16,3
20,29,32,14,22,-8
20,29,33,23,19,4
20,29,34,18,20,-2
20,29,35,11,16,-5
20,29,36,28,23,5
20,29,37,11,13,-2
20,29,38,17,15,2
20,29,39,16,16,0
20,29,40,22,16,6
20,29,41,9,12,-3
20,29,42,7,11,-4
20,29,43,13,20,-7
20,29,44,10,5,5
20,29,45,11,8,3
20,29,46,12,12,0
20,29,47,7,6,1
20,29,48,13,4,9
20,29,49,13,13,0
20,29,50,11,11,0
20,29,51,4,11,-7
20,29,52,17,9,8
20,29,53,11,16,-5
20,29,54,14,6,8
20,29,55,16,17,-1
20,29,56,8,13,-5
20,29,57,16,24,-8
20,29,58,19,13,6
20,29,59,9,6,3
20,29,60,26,17,9
20,29,61,8,12,-4
20,29,62,23,10,13
20,29,63,15,19,-4
20,29,64,19,8,11
20,29,65,23,7,16
20,29,66,19,11,8
20,29,67,17,18,-1
20,29,68,5,10,-5
20,29,69,11,6,5
20,29,70,13,11,2
20,29,71,10,11,-1
20,29,72,14,15,-1
20,29,73,6,14,-8
20,29,74,2,9,-7
20,29,75,13,2,11
20,29,76,17,10,7
20,29,77,15,14,1
20,29,78,19,14,5
20,29,79,11,3,8
20,29,80,17,11,6
20,29,81,16,13,3
20,29,82,10,17,-7
20,29,83,21,14,7
20,29,84,22,14,8
20,29,85,11,9,2
20,29,86,21,8,13
20,29,87,18,16,2
20,29,88,22,13,9
20,29,89,15,7,8
20,29,90,6,9,-3
20,29,91,10,15,-5
20,29,92,5,6,-1
20,29,93,7,12,-5
20,29,94,9,8,1
20,29,95,11,16,-5
20,29,96,10,11,-1
20,29,97,13,7,6
20,29,98,11,2,9
20,29,99,19,12,7
20,29,100,20,4,16
20,29,101,15,18,-3
20,29,102,30,7,23
20,29,103,19,6,13
20,29,104,10,10,0
20,29,105,20,17,3
20,29,106,12,15,-3
20,29,107,10,20,-10
20,29,108,17,17,0
20,29,109,20,18,2
20,29,110,9,12,-3
20,29,111,13,7,6
20,29,112,21,7,14
20,29,113,12,6,6
20,29,114,12,5,7
20,29,115,5,24,-19
20,29,116,15,22,-7
20,29,117,11,14,-3
20,29,118,9,18,-9
20,29,119,13,7,6
20,29,120,19,19,0
20,29,121,5,5,0
20,29,122,11,6,5
20,29,123,12,13,-1
20,29,124,19,7,12
20,29,125,28,16,12
20,29,126,17,9,8
20,29,127,16,17,-1
20,29,128,8,16,-8
20,29,129,16,10,6
20,29,130,19,21,-2
20,29,131,5,9,-4
20,29,132,16,11,5
20,29,133,23,12,11
20,29,134,17,7,10
20,29,135,23,7,16
20,29,136,7,4,3
20,29,137,4,12,-8
20,29,138,22,10,12
20,29,139,18,5,13
20,29,140,20,11,9
20,29,141,9,10,-1
20,29,142,20,12,8
20,29,143,20,13,7
20,29,144,17,8,9
20,29,145,18,23,-5
20,29,146,17,22,-5
20,29,147,30,23,7
20,29,148,5,5,0
20,29,149,14,6,8
20,29,150,19,13,6
20,29,151,8,9,-1
20,29,152,16,9,7
20,29,153,11,5,6
20,29,154,16,13,3
20,29,155,18,12,6
20,29,156,9,6,3
20,29,157,17,14,3
20,29,158,14,9,5
20,29,159,9,11,-2
20,29,160,24,23,1
20,29,161,10,4,6
20,29,162,9,22,-13
20,29,163,20,16,4
20,29,164,14,16,-2
20,29,165,10,17,-7
20,29,166,16,8,8
20,29,167,11,14,-3
20,29,168,10,21,-11
20,29,169,21,5,16
20,29,170,17,8,9
20,29,171,12,21,-9
20,29,172,14,6,8
20,29,173,15,2,13
20,29,174,14,10,4
20,29,175,10,18,-8
20,29,176,4,7,-3
20,29,177,14,6,8
20,29,178,12,8,4
20,29,179,16,18,-2
20,29,180,20,9,11
20,29,181,19,15,4
20,29,182,5,9,-4
20,29,183,15,16,-1
20,29,184,13,13,0
20,29,185,19,14,5
20,29,186,26,10,16
20,29,187,7,17,-10
20,29,188,13,10,3
20,29,189,22,17,5
20,29,190,18,11,7
20,29,191,10,8,2
20,29,192,23,9,14
20,29,193,24,12,12
20,29,194,11,9,2
20,29,195,14,17,-3
20,29,196,23,21,2
20,29,197,12,9,3
20,29,198,17,19,-2
20,29,199,9,11,-2
20,29,200,8,10,-2
20,29,201,11,7,4
20,29,202,32,14,18
20,29,203,13,10,3
20,29,204,14,9,5
20,29,205,9,10,-1
20,29,206,16,17,-1
20,29,207,26,16,10
20,29,208,26,26,0
20,29,209,19,7,12
20,29,210,19,10,9
20,29,211,20,20,0
20,29,212,24,19,5
20,29,213,14,24,-10
20,29,214,21,9,12
20,29,215,18,7,11
20,29,216,13,17,-4
20,29,217,9,14,-5
20,29,218,12,10,2
20,29,219,16,18,-2
20,29,220,30,12,18
20,29,221,17,7,10
20,29,222,15,14,1
20,29,223,14,17,-3
20,29,224,22,12,10
20,29,225,22,10,12
20,29,226,6,8,-2
20,29,227,5,14,-9
20,29,228,23,6,17
20,29,229,13,28,-15
20,29,230,19,12,7
20,29,231,11,7,4
20,29,232,6,14,-8
20,29,233,21,16,5
20,29,234,6,5,1
20,29,235,18,11,7
20,29,236,6,9,-3
20,29,237,10,17,-7
20,29,238,11,8,3
20,29,239,14,15,-1
20,29,240,12,9,3
20,29,241,19,18,1
20,29,242,22,24,-2
20,29,243,19,16,3
20,29,244,9,12,-3
20,29,245,11,8,3
20,29,246,22,12,10
20,29,247,3,3,0
20,29,248,17,7,10
20,29,249,21,6,15
20,29,250,18,18,0
20,29,251,16,14,2
20,29,252,19,5,14
20,29,253,17,3,14
20,29,254,8,9,-1
20,29,255,12,7,5
20,29,256,20,7,13
20,29,257,4,13,-9
20,29,258,19,10,9
20,29,259,5,2,3
20,29,260,17,13,4
20,29,261,14,19,-5
20,29,262,17,14,3
20,29,263,9,10,-1
20,29,264,12,2,10
20,29,265,18,20,-2
20,29,266,20,10,10
20,29,267,5,17,-12
20,29,268,16,13,3
20,29,269,29,13,16
20,29,270,6,4,2
20,29,271,11,9,2
20,29,272,12,13,-1
20,29,273,4,8,-4
20,29,274,18,8,10
20,29,275,31,22,9
20,29,276,11,9,2
20,29,277,22,11,11
20,29,278,8,12,-4
20,29,279,8,15,-7
20,29,280,28,18,10
20,29,281,22,9,13
20,29,282,15,7,8
20,29,283,13,1,12
20,29,284,16,17,-1
20,29,285,8,7,1
20,29,286,18,8,10
20,29,287,7,9,-2
20,29,288,15,14,1
20,29,289,22,4,18
20,29,290,10,7,3
20,29,291,22,18,4
20,29,292,15,9,6
20,29,293,3,1,2
20,29,294,23,11,12
20,29,295,23,21,2
20,29,296,23,17,6
20,29,297,17,14,3
20,29,298,14,9,5
20,29,299,15,7,8
20,30,0,22,7,15
20,30,1,20,17,3
20,30,2,23,17,6
20,30,3,13,13,0
20,30,4,11,10,1
20,30,5,10,12,-2
20,30,6,10,7,3
20,30,7,26,10,16
20,30,8,16,19,-3
20,30,9,9,12,-3
20,30,10,29,15,14
20,30,11,9,13,-4
20,30,12,13,11,2
20,30,13,14,27,-13
20,30,14,18,12,6
20,30,15,11,6,5
20,30,16,18,14,4
20,30,17,20,17,3
20,30,18,29,15,14
20,30,19,20,16,4
20,30,20,18,21,-3
20,30,21,12,4,8
20,30,22,26,9,17
20,30,23,31,10,21
20,30,24,16,22,-6
20,30,25,26,11,15
20,30,26,18,9,9
20,30,27,16,24,-8
20,30,28,10,9,1
20,30,29,14,12,2
20,30,30,8,6,2
20,30,31,16,13,3
20,30,32,19,24,-5
20,30,33,11,10,1
20,30,34,21,19,2
20,30,35,14,15,-1
20,30,36,12,17,-5
20,30,37,9,7,2
20,30,38,17,14,3
20,30,39,10,23,-13
20,30,40,18,14,4
20,30,41,13,4,9
20,30,42,11,5,6
20,30,43,15,9,6
20,30,44,13,6,7
20,30,45,10,27,-17
20,30,46,13,14,-1
20,30,47,13,13,0
20,30,48,12,18,-6
20,30,49,11,4,7
20,30,50,21,14,7
20,30,51,16,16,0
20,30,52,22,21,1
20,30,53,24,21,3
20,30,54,19,5,14
20,30,55,26,12,14
20,30,56,14,2,12
20,30,57,18,7,11
20,30,58,17,10,7
20,30,59,11,9,2
20,30,60,15,15,0
20,30,61,11,12,-1
20,30,62,13,7,6
20,30,63,10,14,-4
20,30,64,20,22,-2
20,30,65,24,16,8
20,30,66,13,4,9
20,30,67,8,8,0
20,30,68,19,7,12
20,30,69,13,4,9
20,30,70,9,19,-10
20,30,71,8,5,3
20,30,72,7,6,1
20,30,73,17,7,10
20,30,74,20,7,13
20,30,75,19,14,5
20,30,76,14,5,9
20,30,77,13,4,9
20,30,78,18,12,6
20,30,79,30,15,15
20,30,80,24,12,12
20,30,81,18,10,8
20,30,82,27,22,5
20,30,83,14,18,-4
20,30,84,19,15,4
20,30,85,14,14,0
20,30,86,10,3,7
20,30,87,14,18,-4
20,30,88,12,11,1
20,30,89,25,24,1
20,30,90,10,7,3
20,30,91,10,10,0
20,30,92,12,4,8
20,30,93,10,12,-2
20,30,94,15,13,2
20,30,95,18,8,10
20,30,96,11,17,-6
20,30,97,19,9,10
20,30,98,14,8,6
20,30,99,20,18,2
20,30,100,6,9,-3
20,30,101,18,15,3
20,30,102,13,6,7
20,30,103,17,17,0
20,30,104,18,14,4
20,30,105,15,11,4
20,30,106,12,4,8
20,30,107,13,15,-2
20,30,108,27,18,9
20,30,109,8,12,-4
20,30,110,8,4,4
20,30,111,11,8,3
20,30,112,16,8,8
20,30,113,19,15,4
20,30,114,16,21,-5
20,30,115,13,1,12
20,30,116,14,15,-1
20,30,117,16,12,4
20,30,118,17,19,-2
20,30,119,22,14,8
20,30,120,10,11,-1
20,30,121,4,10,-6
20,30,122,20,10,10
20,30,123,24,16,8
20,30,124,21,16,5
20,30,125,18,12,6
20,30,126,10,13,-3
20,30,127,26,14,12
20,30,128,9,7,2
20,30,129,6,11,-5
20,30,130,10,16,-6
20,30,131,13,6,7
20,30,132,17,5,12
20,30,133,16,2,14
20,30,134,11,3,8
20,30,135,14,3,11
20,30,136,9,4,5
20,30,137,10,19,-9
20,30,138,5,6,-1
20,30,139,15,10,5
20,30,140,22,10,12
20,30,141,23,15,8
20,30,142,18,13,5
20,30,143,16,11,5
20,30,144,12,11,1
20,30,145,8,17,-9
20,30,146,10,13,-3
20,30,147,17,8,9
20,30,148,27,14,13
20,30,149,9,17,-8
20,30,150,21,11,10
20,30,151,17,29,-12
20,30,152,4,4,0
20,30,153,20,9,11
20,30,154,14,2,12
20,30,155,20,13,7
20,30,156,20,25,-5
20,30,157,29,18,11
20,30,158,7,6,1
20,30,159,21,10,11
20,30,160,8,12,-4
20,30,161,21,17,4
20,30,162,15,18,-3
20,30,163,11,6,5
20,30,164,24,15,9
20,30,165,8,12,-4
20,30,166,38,20,18
20,30,167,16,19,-3
20,30,168,10,4,6
20,30,169,11,10,1
20,30,170,13,17,-4
20,30,171,16,16,0
20,30,172,9,14,-5
20,30,173,17,10,7
20,30,174,13,8,5
20,30,175,8,13,-5
20,30,176,8,15,-7
20,30,177,17,18,-1
20,30,178,18,15,3
20,30,179,8,12,-4
20,30,180,12,9,3
20,30,181,27,9,18
20,30,182,16,13,3
20,30,183,12,19,-7
20,30,184,24,17,7
20,30,185,13,21,-8
20,30,186,3,10,-7
20,30,187,9,10,-1
20,30,188,15,16,-1
20,30,189,8,5,3
20,30,190,13,9,4
20,30,191,16,15,1
20,30,192,9,9,0
20,30,193,14,10,4
20,30,194,31,22,9
20,30,195,14,11,3
20,30,196,21,16,5
20,30,197,14,16,-2
20,30,198,15,11,4
20,30,199,19,15,4
20,30,200,12,16,-4
20,30,201,16,9,7
20,30,202,22,17,5
20,30,203,7,8,-1
20,30,204,13,14,-1
20,30,205,19,9,10
20,30,206,17,12,5
20,30,207,7,9,-2
20,30,208,13,17,-4
20,30,209,8,7,1
20,30,210,21,7,14
20,30,211,17,2,15
20,30,212,9,10,-1
20,30,213,14,16,-2
20,30,214,12,9,3
20,30,215,12,13,-1
20,30,216,21,8,13
20,30,217,15,12,3
20,30,218,4,0,4
20,30,219,15,5,10
20,30,220,13,13,0
20,30,221,16,14,2
20,30,222,19,14,5
20,30,223,5,16,-11
20,30,224,9,15,-6
20,30,225,22,4,18
20,30,226,14,13,1
20,30,227,11,3,8
20,30,228,8,9,-1
20,30,229,18,11,7
20,30,230,18,9,9
20,30,231,6,13,-7
20,30,232,11,15,-4
20,30,233,14,16,-2
20,30,234,17,15,2
20,30,235,7,11,-4
20,30,236,17,12,5
20,30,237,12,13,-1
20,30,238,18,10,8
20,30,239,12,14,-2
20,30,240,20,13,7
20,30,241,7,15,-8
20,30,242,16,9,7
20,30,243,12,9,3
20,30,244,22,8,14
20,30,245,14,12,2
20,30,246,6,7,-1
20,30,247,12,5,7
20,30,248,8,17,-9
20,30,249,20,13,7
20,30,250,26,7,19
20,30,251,15,11,4
20,30,252,21,12,9
20,30,253,8,8,0
20,30,254,16,13,3
20,30,255,10,27,-17
20,30,256,9,16,-7
20,30,257,18,8,10
20,30,258,21,14,7
20,30,259,15,18,-3
20,30,260,13,6,7
20,30,261,7,15,-8
20,30,262,19,6,13
20,30,263,5,12,-7
20,30,264,23,10,13
20,30,265,11,12,-1
20,30,266,27,18,9
20,30,267,25,10,15
20,30,268,10,9,1
20,30,269,20,16,4
20,30,270,21,9,12
20,30,271,12,6,6
20,30,272,19,4,15
20,30,273,17,15,2
20,30,274,16,14,2
20,30,275,19,8,11
20,30,276,23,16,7
20,30,277,6,7,-1
20,30,278,20,14,6
20,30,279,33,24,9
20,30,280,6,3,3
20,30,281,10,13,-3
20,30,282,13,14,-1
20,30,283,19,11,8
20,30,284,20,15,5
20,30,285,17,7,10
20,30,286,23,7,16
20,30,287,11,5,6
20,30,288,17,20,-3
20,30,289,15,13,2
20,30,290,7,17,-10
20,30,291,16,6,10
20,30,292,13,26,-13
20,30,293,20,5,15
20,30,294,13,10,3
20,30,295,19,12,7
20,30,296,28,14,14
20,30,297,12,11,1
20,30,298,9,10,-1
20,30,299,23,20,3
