# frame_skip_agent_A, frame_skip_agent_B, episode, score_A, score_B, reward
26,1,0,8,19,-11
26,1,1,12,12,0
26,1,2,7,18,-11
26,1,3,17,15,2
26,1,4,10,14,-4
26,1,5,10,13,-3
26,1,6,1,8,-7
26,1,7,8,14,-6
26,1,8,9,8,1
26,1,9,5,20,-15
26,1,10,4,16,-12
26,1,11,6,13,-7
26,1,12,2,15,-13
26,1,13,9,13,-4
26,1,14,7,17,-10
26,1,15,7,14,-7
26,1,16,10,20,-10
26,1,17,3,16,-13
26,1,18,7,8,-1
26,1,19,8,7,1
26,1,20,8,19,-11
26,1,21,6,19,-13
26,1,22,19,16,3
26,1,23,1,17,-16
26,1,24,9,7,2
26,1,25,9,12,-3
26,1,26,7,13,-6
26,1,27,6,25,-19
26,1,28,8,8,0
26,1,29,4,22,-18
26,1,30,10,16,-6
26,1,31,11,19,-8
26,1,32,4,7,-3
26,1,33,6,17,-11
26,1,34,7,20,-13
26,1,35,14,10,4
26,1,36,6,15,-9
26,1,37,15,13,2
26,1,38,7,20,-13
26,1,39,12,25,-13
26,1,40,0,13,-13
26,1,41,7,11,-4
26,1,42,6,25,-19
26,1,43,6,18,-12
26,1,44,14,21,-7
26,1,45,10,19,-9
26,1,46,12,16,-4
26,1,47,4,16,-12
26,1,48,6,9,-3
26,1,49,6,25,-19
26,1,50,4,6,-2
26,1,51,13,24,-11
26,1,52,8,12,-4
26,1,53,9,8,1
26,1,54,10,30,-20
26,1,55,8,12,-4
26,1,56,7,17,-10
26,1,57,5,24,-19
26,1,58,5,10,-5
26,1,59,8,16,-8
26,1,60,8,12,-4
26,1,61,10,18,-8
26,1,62,4,12,-8
26,1,63,3,11,-8
26,1,64,5,6,-1
26,1,65,17,25,-8
26,1,66,16,24,-8
26,1,67,10,17,-7
26,1,68,5,13,-8
26,1,69,14,14,0
26,1,70,14,19,-5
26,1,71,2,9,-7
26,1,72,10,28,-18
26,1,73,12,16,-4
26,1,74,3,7,-4
26,1,75,11,18,-7
26,1,76,8,19,-11
26,1,77,6,27,-21
26,1,78,14,14,0
26,1,79,5,11,-6
26,1,80,4,13,-9
26,1,81,14,20,-6
26,1,82,4,22,-18
26,1,83,9,9,0
26,1,84,9,7,2
26,1,85,5,14,-9
26,1,86,9,18,-9
26,1,87,11,26,-15
26,1,88,4,21,-17
26,1,89,8,8,0
26,1,90,6,16,-10
26,1,91,5,23,-18
26,1,92,2,8,-6
26,1,93,10,14,-4
26,1,94,9,18,-9
26,1,95,6,24,-18
26,1,96,11,8,3
26,1,97,7,21,-14
26,1,98,4,7,-3
26,1,99,6,21,-15
26,1,100,11,19,-8
26,1,101,2,6,-4
26,1,102,12,14,-2
26,1,103,10,24,-14
26,1,104,12,20,-8
26,1,105,2,7,-5
26,1,106,6,11,-5
26,1,107,7,27,-20
26,1,108,14,22,-8
26,1,109,3,15,-12
26,1,110,7,16,-9
26,1,111,5,17,-12
26,1,112,11,17,-6
26,1,113,2,19,-17
26,1,114,10,21,-11
26,1,115,16,19,-3
26,1,116,9,23,-14
26,1,117,13,24,-11
26,1,118,6,20,-14
26,1,119,3,21,-18
26,1,120,6,21,-15
26,1,121,4,8,-4
26,1,122,16,24,-8
26,1,123,6,9,-3
26,1,124,7,23,-16
26,1,125,7,17,-10
26,1,126,12,24,-12
26,1,127,1,10,-9
26,1,128,3,35,-32
26,1,129,8,9,-1
26,1,130,5,16,-11
26,1,131,17,15,2
26,1,132,3,21,-18
26,1,133,6,17,-11
26,1,134,9,30,-21
26,1,135,8,19,-11
26,1,136,17,12,5
26,1,137,8,15,-7
26,1,138,7,11,-4
26,1,139,7,9,-2
26,1,140,13,29,-16
26,1,141,4,33,-29
26,1,142,7,11,-4
26,1,143,5,14,-9
26,1,144,9,18,-9
26,1,145,11,18,-7
26,1,146,12,18,-6
26,1,147,3,11,-8
26,1,148,6,5,1
26,1,149,6,10,-4
26,1,150,14,25,-11
26,1,151,5,12,-7
26,1,152,3,6,-3
26,1,153,11,13,-2
26,1,154,6,21,-15
26,1,155,14,17,-3
26,1,156,0,9,-9
26,1,157,4,35,-31
26,1,158,12,14,-2
26,1,159,4,15,-11
26,1,160,6,16,-10
26,1,161,8,24,-16
26,1,162,8,11,-3
26,1,163,7,8,-1
26,1,164,7,9,-2
26,1,165,7,21,-14
26,1,166,9,11,-2
26,1,167,16,9,7
26,1,168,2,17,-15
26,1,169,8,20,-12
26,1,170,11,26,-15
26,1,171,1,13,-12
26,1,172,9,17,-8
26,1,173,3,4,-1
26,1,174,14,26,-12
26,1,175,2,19,-17
26,1,176,19,26,-7
26,1,177,11,11,0
26,1,178,14,18,-4
26,1,179,8,15,-7
26,1,180,9,17,-8
26,1,181,3,11,-8
26,1,182,1,8,-7
26,1,183,0,5,-5
26,1,184,11,26,-15
26,1,185,12,28,-16
26,1,186,8,21,-13
26,1,187,6,22,-16
26,1,188,3,18,-15
26,1,189,4,8,-4
26,1,190,9,16,-7
26,1,191,4,14,-10
26,1,192,0,7,-7
26,1,193,13,19,-6
26,1,194,8,16,-8
26,1,195,7,20,-13
26,1,196,12,11,1
26,1,197,11,15,-4
26,1,198,4,9,-5
26,1,199,11,16,-5
26,1,200,3,14,-11
26,1,201,13,22,-9
26,1,202,5,11,-6
26,1,203,13,25,-12
26,1,204,8,26,-18
26,1,205,4,16,-12
26,1,206,5,5,0
26,1,207,16,21,-5
26,1,208,6,33,-27
26,1,209,5,15,-10
26,1,210,12,21,-9
26,1,211,1,8,-7
26,1,212,8,30,-22
26,1,213,3,18,-15
26,1,214,6,5,1
26,1,215,2,9,-7
26,1,216,8,24,-16
26,1,217,5,15,-10
26,1,218,3,3,0
26,1,219,9,10,-1
26,1,220,13,19,-6
26,1,221,7,13,-6
26,1,222,8,15,-7
26,1,223,3,10,-7
26,1,224,9,20,-11
26,1,225,5,11,-6
26,1,226,8,19,-11
26,1,227,1,6,-5
26,1,228,7,22,-15
26,1,229,14,28,-14
26,1,230,0,19,-19
26,1,231,3,9,-6
26,1,232,5,8,-3
26,1,233,8,11,-3
26,1,234,6,19,-13
26,1,235,8,15,-7
26,1,236,12,10,2
26,1,237,12,16,-4
26,1,238,15,22,-7
26,1,239,5,10,-5
26,1,240,2,16,-14
26,1,241,6,13,-7
26,1,242,12,16,-4
26,1,243,3,8,-5
26,1,244,0,6,-6
26,1,245,10,7,3
26,1,246,3,21,-18
26,1,247,6,10,-4
26,1,248,5,22,-17
26,1,249,3,27,-24
26,1,250,10,18,-8
26,1,251,9,21,-12
26,1,252,11,30,-19
26,1,253,4,14,-10
26,1,254,1,22,-21
26,1,255,12,23,-11
26,1,256,12,8,4
26,1,257,7,23,-16
26,1,258,13,23,-10
26,1,259,11,14,-3
26,1,260,6,17,-11
26,1,261,5,14,-9
26,1,262,1,7,-6
26,1,263,9,14,-5
26,1,264,10,21,-11
26,1,265,12,22,-10
26,1,266,3,20,-17
26,1,267,4,5,-1
26,1,268,7,25,-18
26,1,269,9,11,-2
26,1,270,10,12,-2
26,1,271,7,8,-1
26,1,272,11,10,1
26,1,273,8,21,-13
26,1,274,7,14,-7
26,1,275,8,18,-10
26,1,276,8,15,-7
26,1,277,4,15,-11
26,1,278,9,29,-20
26,1,279,4,17,-13
26,1,280,3,11,-8
26,1,281,2,22,-20
26,1,282,11,19,-8
26,1,283,1,4,-3
26,1,284,3,25,-22
26,1,285,6,28,-22
26,1,286,9,21,-12
26,1,287,8,21,-13
26,1,288,4,23,-19
26,1,289,7,22,-15
26,1,290,10,8,2
26,1,291,7,22,-15
26,1,292,6,22,-16
26,1,293,6,8,-2
26,1,294,9,24,-15
26,1,295,5,12,-7
26,1,296,8,16,-8
26,1,297,10,13,-3
26,1,298,14,23,-9
26,1,299,9,13,-4
26,2,0,7,16,-9
26,2,1,5,22,-17
26,2,2,6,26,-20
26,2,3,7,5,2
26,2,4,2,29,-27
26,2,5,3,20,-17
26,2,6,3,20,-17
26,2,7,7,8,-1
26,2,8,3,20,-17
26,2,9,6,16,-10
26,2,10,17,15,2
26,2,11,6,4,2
26,2,12,7,17,-10
26,2,13,6,21,-15
26,2,14,6,35,-29
26,2,15,6,12,-6
26,2,16,1,4,-3
26,2,17,9,12,-3
26,2,18,10,31,-21
26,2,19,11,30,-19
26,2,20,7,13,-6
26,2,21,8,23,-15
26,2,22,13,14,-1
26,2,23,8,13,-5
26,2,24,13,17,-4
26,2,25,2,16,-14
26,2,26,6,18,-12
26,2,27,9,14,-5
26,2,28,6,17,-11
26,2,29,14,20,-6
26,2,30,0,9,-9
26,2,31,6,12,-6
26,2,32,5,12,-7
26,2,33,3,12,-9
26,2,34,2,16,-14
26,2,35,8,22,-14
26,2,36,3,20,-17
26,2,37,7,13,-6
26,2,38,7,17,-10
26,2,39,2,13,-11
26,2,40,0,13,-13
26,2,41,10,30,-20
26,2,42,5,18,-13
26,2,43,11,21,-10
26,2,44,6,25,-19
26,2,45,1,11,-10
26,2,46,10,26,-16
26,2,47,3,34,-31
26,2,48,11,25,-14
26,2,49,3,8,-5
26,2,50,2,14,-12
26,2,51,5,14,-9
26,2,52,7,27,-20
26,2,53,12,25,-13
26,2,54,4,24,-20
26,2,55,4,14,-10
26,2,56,13,10,3
26,2,57,12,23,-11
26,2,58,10,7,3
26,2,59,2,17,-15
26,2,60,9,17,-8
26,2,61,12,32,-20
26,2,62,9,13,-4
26,2,63,5,19,-14
26,2,64,8,32,-24
26,2,65,3,21,-18
26,2,66,6,26,-20
26,2,67,10,25,-15
26,2,68,11,28,-17
26,2,69,12,15,-3
26,2,70,7,24,-17
26,2,71,9,28,-19
26,2,72,19,31,-12
26,2,73,9,22,-13
26,2,74,2,14,-12
26,2,75,13,26,-13
26,2,76,8,11,-3
26,2,77,7,14,-7
26,2,78,2,8,-6
26,2,79,6,9,-3
26,2,80,10,19,-9
26,2,81,9,13,-4
26,2,82,13,12,1
26,2,83,4,7,-3
26,2,84,11,10,1
26,2,85,7,19,-12
26,2,86,12,30,-18
26,2,87,9,17,-8
26,2,88,7,15,-8
26,2,89,14,37,-23
26,2,90,3,12,-9
26,2,91,5,12,-7
26,2,92,11,25,-14
26,2,93,10,16,-6
26,2,94,3,24,-21
26,2,95,6,16,-10
26,2,96,12,19,-7
26,2,97,10,32,-22
26,2,98,5,20,-15
26,2,99,9,23,-14
26,2,100,6,27,-21
26,2,101,3,21,-18
26,2,102,7,21,-14
26,2,103,10,20,-10
26,2,104,9,13,-4
26,2,105,11,16,-5
26,2,106,4,16,-12
26,2,107,8,26,-18
26,2,108,5,16,-11
26,2,109,5,23,-18
26,2,110,17,33,-16
26,2,111,19,36,-17
26,2,112,4,23,-19
26,2,113,2,16,-14
26,2,114,10,15,-5
26,2,115,13,12,1
26,2,116,4,23,-19
26,2,117,4,16,-12
26,2,118,6,29,-23
26,2,119,4,5,-1
26,2,120,11,20,-9
26,2,121,7,25,-18
26,2,122,12,20,-8
26,2,123,7,8,-1
26,2,124,11,31,-20
26,2,125,9,18,-9
26,2,126,10,16,-6
26,2,127,12,38,-26
26,2,128,8,11,-3
26,2,129,7,18,-11
26,2,130,8,23,-15
26,2,131,11,24,-13
26,2,132,6,15,-9
26,2,133,7,48,-41
26,2,134,14,18,-4
26,2,135,5,14,-9
26,2,136,12,9,3
26,2,137,3,31,-28
26,2,138,7,14,-7
26,2,139,11,25,-14
26,2,140,2,12,-10
26,2,141,6,8,-2
26,2,142,6,20,-14
26,2,143,3,11,-8
26,2,144,6,7,-1
26,2,145,4,11,-7
26,2,146,4,18,-14
26,2,147,10,14,-4
26,2,148,5,19,-14
26,2,149,1,3,-2
26,2,150,12,31,-19
26,2,151,6,30,-24
26,2,152,11,20,-9
26,2,153,9,7,2
26,2,154,7,18,-11
26,2,155,14,33,-19
26,2,156,8,10,-2
26,2,157,10,18,-8
26,2,158,18,16,2
26,2,159,12,21,-9
26,2,160,15,17,-2
26,2,161,4,21,-17
26,2,162,13,18,-5
26,2,163,9,10,-1
26,2,164,11,26,-15
26,2,165,11,21,-10
26,2,166,3,10,-7
26,2,167,7,33,-26
26,2,168,10,19,-9
26,2,169,5,7,-2
26,2,170,1,22,-21
26,2,171,7,14,-7
26,2,172,11,18,-7
26,2,173,11,14,-3
26,2,174,6,15,-9
26,2,175,8,22,-14
26,2,176,9,17,-8
26,2,177,8,19,-11
26,2,178,7,20,-13
26,2,179,4,11,-7
26,2,180,5,11,-6
26,2,181,7,29,-22
26,2,182,4,19,-15
26,2,183,5,19,-14
26,2,184,3,12,-9
26,2,185,3,16,-13
26,2,186,1,22,-21
26,2,187,5,15,-10
26,2,188,2,12,-10
26,2,189,17,14,3
26,2,190,10,27,-17
26,2,191,4,13,-9
26,2,192,7,24,-17
26,2,193,14,10,4
26,2,194,15,20,-5
26,2,195,12,21,-9
26,2,196,10,21,-11
26,2,197,10,12,-2
26,2,198,10,23,-13
26,2,199,6,18,-12
26,2,200,5,5,0
26,2,201,17,16,1
26,2,202,8,18,-10
26,2,203,8,36,-28
26,2,204,7,26,-19
26,2,205,11,18,-7
26,2,206,7,15,-8
26,2,207,19,30,-11
26,2,208,7,25,-18
26,2,209,8,14,-6
26,2,210,22,39,-17
26,2,211,13,9,4
26,2,212,3,22,-19
26,2,213,10,11,-1
26,2,214,15,17,-2
26,2,215,7,16,-9
26,2,216,11,14,-3
26,2,217,11,25,-14
26,2,218,3,20,-17
26,2,219,4,9,-5
26,2,220,12,23,-11
26,2,221,2,33,-31
26,2,222,6,16,-10
26,2,223,8,20,-12
26,2,224,11,23,-12
26,2,225,5,12,-7
26,2,226,9,23,-14
26,2,227,3,30,-27
26,2,228,1,21,-20
26,2,229,7,29,-22
26,2,230,5,20,-15
26,2,231,8,18,-10
26,2,232,11,15,-4
26,2,233,4,7,-3
26,2,234,5,9,-4
26,2,235,8,42,-34
26,2,236,5,22,-17
26,2,237,3,14,-11
26,2,238,0,23,-23
26,2,239,5,16,-11
26,2,240,11,12,-1
26,2,241,2,11,-9
26,2,242,3,19,-16
26,2,243,6,15,-9
26,2,244,8,19,-11
26,2,245,3,18,-15
26,2,246,9,10,-1
26,2,247,4,26,-22
26,2,248,5,24,-19
26,2,249,7,15,-8
26,2,250,12,25,-13
26,2,251,5,17,-12
26,2,252,7,28,-21
26,2,253,8,21,-13
26,2,254,14,17,-3
26,2,255,5,21,-16
26,2,256,17,26,-9
26,2,257,5,25,-20
26,2,258,8,30,-22
26,2,259,8,26,-18
26,2,260,14,22,-8
26,2,261,6,15,-9
26,2,262,5,14,-9
26,2,263,7,9,-2
26,2,264,6,13,-7
26,2,265,19,13,6
26,2,266,10,25,-15
26,2,267,11,8,3
26,2,268,7,22,-15
26,2,269,11,25,-14
26,2,270,12,19,-7
26,2,271,16,26,-10
26,2,272,2,9,-7
26,2,273,5,11,-6
26,2,274,5,17,-12
26,2,275,4,21,-17
26,2,276,7,16,-9
26,2,277,6,33,-27
26,2,278,9,31,-22
26,2,279,11,9,2
26,2,280,6,15,-9
26,2,281,2,32,-30
26,2,282,3,21,-18
26,2,283,3,12,-9
26,2,284,6,21,-15
26,2,285,13,30,-17
26,2,286,7,23,-16
26,2,287,16,31,-15
26,2,288,11,15,-4
26,2,289,11,27,-16
26,2,290,12,20,-8
26,2,291,8,14,-6
26,2,292,10,30,-20
26,2,293,9,23,-14
26,2,294,7,26,-19
26,2,295,7,13,-6
26,2,296,8,10,-2
26,2,297,11,23,-12
26,2,298,5,18,-13
26,2,299,4,15,-11
26,3,0,12,7,5
26,3,1,4,7,-3
26,3,2,1,18,-17
26,3,3,5,11,-6
26,3,4,4,13,-9
26,3,5,6,13,-7
26,3,6,4,34,-30
26,3,7,13,21,-8
26,3,8,8,31,-23
26,3,9,10,25,-15
26,3,10,16,14,2
26,3,11,8,16,-8
26,3,12,10,20,-10
26,3,13,8,14,-6
26,3,14,6,19,-13
26,3,15,4,16,-12
26,3,16,5,21,-16
26,3,17,7,13,-6
26,3,18,6,12,-6
26,3,19,11,21,-10
26,3,20,16,32,-16
26,3,21,11,24,-13
26,3,22,9,12,-3
26,3,23,4,9,-5
26,3,24,10,9,1
26,3,25,7,24,-17
26,3,26,26,26,0
26,3,27,12,16,-4
26,3,28,5,11,-6
26,3,29,4,19,-15
26,3,30,6,16,-10
26,3,31,11,17,-6
26,3,32,16,34,-18
26,3,33,10,28,-18
26,3,34,3,24,-21
26,3,35,6,24,-18
26,3,36,6,14,-8
26,3,37,9,16,-7
26,3,38,10,26,-16
26,3,39,10,10,0
26,3,40,8,12,-4
26,3,41,10,18,-8
26,3,42,11,26,-15
26,3,43,6,24,-18
26,3,44,2,6,-4
26,3,45,4,8,-4
26,3,46,0,5,-5
26,3,47,7,16,-9
26,3,48,4,16,-12
26,3,49,5,17,-12
26,3,50,1,14,-13
26,3,51,7,32,-25
26,3,52,11,17,-6
26,3,53,14,22,-8
26,3,54,15,32,-17
26,3,55,5,22,-17
26,3,56,5,16,-11
26,3,57,11,20,-9
26,3,58,4,12,-8
26,3,59,5,13,-8
26,3,60,7,21,-14
26,3,61,13,22,-9
26,3,62,7,4,3
26,3,63,5,20,-15
26,3,64,7,24,-17
26,3,65,16,22,-6
26,3,66,9,22,-13
26,3,67,3,15,-12
26,3,68,16,27,-11
26,3,69,8,25,-17
26,3,70,10,21,-11
26,3,71,6,16,-10
26,3,72,13,17,-4
26,3,73,7,35,-28
26,3,74,20,14,6
26,3,75,9,19,-10
26,3,76,7,5,2
26,3,77,3,10,-7
26,3,78,15,21,-6
26,3,79,13,7,6
26,3,80,8,30,-22
26,3,81,5,19,-14
26,3,82,10,25,-15
26,3,83,9,11,-2
26,3,84,4,28,-24
26,3,85,8,32,-24
26,3,86,12,31,-19
26,3,87,4,15,-11
26,3,88,18,21,-3
26,3,89,4,13,-9
26,3,90,18,16,2
26,3,91,16,31,-15
26,3,92,8,17,-9
26,3,93,4,13,-9
26,3,94,8,21,-13
26,3,95,11,20,-9
26,3,96,10,10,0
26,3,97,3,10,-7
26,3,98,6,19,-13
26,3,99,12,22,-10
26,3,100,9,35,-26
26,3,101,12,18,-6
26,3,102,16,17,-1
26,3,103,8,31,-23
26,3,104,7,15,-8
26,3,105,3,8,-5
26,3,106,17,11,6
26,3,107,10,26,-16
26,3,108,3,29,-26
26,3,109,4,20,-16
26,3,110,10,29,-19
26,3,111,13,42,-29
26,3,112,7,22,-15
26,3,113,8,30,-22
26,3,114,13,20,-7
26,3,115,10,17,-7
26,3,116,10,36,-26
26,3,117,9,22,-13
26,3,118,10,18,-8
26,3,119,5,32,-27
26,3,120,12,7,5
26,3,121,5,22,-17
26,3,122,8,19,-11
26,3,123,5,31,-26
26,3,124,5,11,-6
26,3,125,12,13,-1
26,3,126,12,9,3
26,3,127,7,27,-20
26,3,128,2,10,-8
26,3,129,7,18,-11
26,3,130,8,31,-23
26,3,131,5,2,3
26,3,132,10,30,-20
26,3,133,8,23,-15
26,3,134,9,24,-15
26,3,135,10,16,-6
26,3,136,10,11,-1
26,3,137,6,21,-15
26,3,138,4,7,-3
26,3,139,6,19,-13
26,3,140,3,21,-18
26,3,141,15,27,-12
26,3,142,7,15,-8
26,3,143,4,24,-20
26,3,144,16,28,-12
26,3,145,11,12,-1
26,3,146,10,32,-22
26,3,147,8,16,-8
26,3,148,5,12,-7
26,3,149,8,29,-21
26,3,150,11,19,-8
26,3,151,15,16,-1
26,3,152,11,28,-17
26,3,153,10,22,-12
26,3,154,3,12,-9
26,3,155,10,22,-12
26,3,156,17,31,-14
26,3,157,9,17,-8
26,3,158,4,16,-12
26,3,159,8,32,-24
26,3,160,6,18,-12
26,3,161,8,17,-9
26,3,162,15,22,-7
26,3,163,3,13,-10
26,3,164,15,15,0
26,3,165,10,16,-6
26,3,166,9,21,-12
26,3,167,14,29,-15
26,3,168,14,19,-5
26,3,169,8,8,0
26,3,170,13,30,-17
26,3,171,2,20,-18
26,3,172,6,26,-20
26,3,173,9,11,-2
26,3,174,13,17,-4
26,3,175,13,19,-6
26,3,176,10,13,-3
26,3,177,11,25,-14
26,3,178,10,23,-13
26,3,179,4,16,-12
26,3,180,5,24,-19
26,3,181,8,12,-4
26,3,182,13,16,-3
26,3,183,17,27,-10
26,3,184,12,20,-8
26,3,185,2,8,-6
26,3,186,14,22,-8
26,3,187,6,14,-8
26,3,188,3,23,-20
26,3,189,10,13,-3
26,3,190,5,16,-11
26,3,191,8,31,-23
26,3,192,6,15,-9
26,3,193,0,6,-6
26,3,194,7,24,-17
26,3,195,5,17,-12
26,3,196,6,29,-23
26,3,197,6,41,-35
26,3,198,6,16,-10
26,3,199,7,18,-11
26,3,200,15,26,-11
26,3,201,4,30,-26
26,3,202,4,16,-12
26,3,203,20,28,-8
26,3,204,17,33,-16
26,3,205,9,22,-13
26,3,206,10,26,-16
26,3,207,5,22,-17
26,3,208,5,18,-13
26,3,209,9,21,-12
26,3,210,9,10,-1
26,3,211,14,25,-11
26,3,212,11,27,-16
26,3,213,5,14,-9
26,3,214,6,10,-4
26,3,215,4,22,-18
26,3,216,17,13,4
26,3,217,16,29,-13
26,3,218,8,15,-7
26,3,219,10,18,-8
26,3,220,10,19,-9
26,3,221,8,18,-10
26,3,222,8,15,-7
26,3,223,4,11,-7
26,3,224,8,22,-14
26,3,225,9,18,-9
26,3,226,7,11,-4
26,3,227,7,16,-9
26,3,228,9,25,-16
26,3,229,8,14,-6
26,3,230,5,10,-5
26,3,231,7,19,-12
26,3,232,12,25,-13
26,3,233,4,24,-20
26,3,234,12,19,-7
26,3,235,8,28,-20
26,3,236,6,31,-25
26,3,237,17,13,4
26,3,238,10,16,-6
26,3,239,13,20,-7
26,3,240,10,11,-1
26,3,241,6,13,-7
26,3,242,9,27,-18
26,3,243,5,18,-13
26,3,244,11,14,-3
26,3,245,10,37,-27
26,3,246,6,18,-12
26,3,247,6,12,-6
26,3,248,16,19,-3
26,3,249,12,22,-10
26,3,250,9,9,0
26,3,251,6,22,-16
26,3,252,19,17,2
26,3,253,7,20,-13
26,3,254,13,34,-21
26,3,255,11,33,-22
26,3,256,3,15,-12
26,3,257,11,17,-6
26,3,258,5,15,-10
26,3,259,8,29,-21
26,3,260,5,17,-12
26,3,261,3,17,-14
26,3,262,7,23,-16
26,3,263,10,33,-23
26,3,264,13,13,0
26,3,265,17,20,-3
26,3,266,2,25,-23
26,3,267,10,22,-12
26,3,268,8,13,-5
26,3,269,19,28,-9
26,3,270,18,31,-13
26,3,271,5,7,-2
26,3,272,10,20,-10
26,3,273,5,13,-8
26,3,274,10,27,-17
26,3,275,9,15,-6
26,3,276,12,27,-15
26,3,277,8,10,-2
26,3,278,13,42,-29
26,3,279,16,26,-10
26,3,280,11,35,-24
26,3,281,5,19,-14
26,3,282,4,20,-16
26,3,283,6,6,0
26,3,284,5,25,-20
26,3,285,5,23,-18
26,3,286,10,24,-14
26,3,287,11,25,-14
26,3,288,2,10,-8
26,3,289,12,37,-25
26,3,290,8,17,-9
26,3,291,7,22,-15
26,3,292,23,34,-11
26,3,293,8,21,-13
26,3,294,13,14,-1
26,3,295,6,22,-16
26,3,296,7,26,-19
26,3,297,5,42,-37
26,3,298,6,18,-12
26,3,299,5,22,-17
26,4,0,10,17,-7
26,4,1,10,17,-7
26,4,2,15,22,-7
26,4,3,12,18,-6
26,4,4,6,19,-13
26,4,5,14,21,-7
26,4,6,7,16,-9
26,4,7,11,28,-17
26,4,8,15,25,-10
26,4,9,6,9,-3
26,4,10,2,13,-11
26,4,11,8,30,-22
26,4,12,11,22,-11
26,4,13,3,17,-14
26,4,14,7,16,-9
26,4,15,3,27,-24
26,4,16,11,22,-11
26,4,17,4,11,-7
26,4,18,4,8,-4
26,4,19,7,18,-11
26,4,20,9,21,-12
26,4,21,9,20,-11
26,4,22,8,23,-15
26,4,23,11,20,-9
26,4,24,7,28,-21
26,4,25,7,20,-13
26,4,26,10,23,-13
26,4,27,16,24,-8
26,4,28,14,20,-6
26,4,29,8,23,-15
26,4,30,17,13,4
26,4,31,5,34,-29
26,4,32,10,20,-10
26,4,33,8,19,-11
26,4,34,4,18,-14
26,4,35,7,16,-9
26,4,36,5,25,-20
26,4,37,12,21,-9
26,4,38,15,33,-18
26,4,39,8,15,-7
26,4,40,6,16,-10
26,4,41,15,25,-10
26,4,42,3,23,-20
26,4,43,16,18,-2
26,4,44,11,22,-11
26,4,45,5,9,-4
26,4,46,7,24,-17
26,4,47,29,29,0
26,4,48,9,32,-23
26,4,49,6,17,-11
26,4,50,7,22,-15
26,4,51,4,20,-16
26,4,52,13,16,-3
26,4,53,13,24,-11
26,4,54,12,44,-32
26,4,55,18,23,-5
26,4,56,5,14,-9
26,4,57,12,15,-3
26,4,58,6,22,-16
26,4,59,5,15,-10
26,4,60,7,20,-13
26,4,61,7,14,-7
26,4,62,7,22,-15
26,4,63,7,17,-10
26,4,64,5,31,-26
26,4,65,4,7,-3
26,4,66,0,16,-16
26,4,67,6,21,-15
26,4,68,5,1,4
26,4,69,9,19,-10
26,4,70,8,8,0
26,4,71,6,29,-23
26,4,72,9,18,-9
26,4,73,13,21,-8
26,4,74,3,6,-3
26,4,75,5,9,-4
26,4,76,6,17,-11
26,4,77,9,20,-11
26,4,78,10,25,-15
26,4,79,11,12,-1
26,4,80,5,20,-15
26,4,81,13,19,-6
26,4,82,3,21,-18
26,4,83,7,26,-19
26,4,84,12,12,0
26,4,85,7,18,-11
26,4,86,9,25,-16
26,4,87,11,28,-17
26,4,88,4,24,-20
26,4,89,26,22,4
26,4,90,10,22,-12
26,4,91,15,30,-15
26,4,92,6,19,-13
26,4,93,4,11,-7
26,4,94,5,35,-30
26,4,95,14,11,3
26,4,96,5,15,-10
26,4,97,6,23,-17
26,4,98,5,18,-13
26,4,99,12,8,4
26,4,100,8,30,-22
26,4,101,9,7,2
26,4,102,10,33,-23
26,4,103,22,18,4
26,4,104,7,17,-10
26,4,105,7,8,-1
26,4,106,7,13,-6
26,4,107,6,14,-8
26,4,108,10,22,-12
26,4,109,9,19,-10
26,4,110,8,23,-15
26,4,111,6,21,-15
26,4,112,6,7,-1
26,4,113,10,20,-10
26,4,114,4,12,-8
26,4,115,19,21,-2
26,4,116,9,39,-30
26,4,117,26,25,1
26,4,118,9,23,-14
26,4,119,9,27,-18
26,4,120,2,17,-15
26,4,121,11,26,-15
26,4,122,8,15,-7
26,4,123,5,33,-28
26,4,124,12,26,-14
26,4,125,9,8,1
26,4,126,5,12,-7
26,4,127,11,16,-5
26,4,128,9,26,-17
26,4,129,10,28,-18
26,4,130,12,17,-5
26,4,131,3,24,-21
26,4,132,7,22,-15
26,4,133,11,13,-2
26,4,134,14,13,1
26,4,135,14,20,-6
26,4,136,12,24,-12
26,4,137,8,25,-17
26,4,138,12,23,-11
26,4,139,3,17,-14
26,4,140,7,18,-11
26,4,141,13,4,9
26,4,142,2,19,-17
26,4,143,12,23,-11
26,4,144,12,29,-17
26,4,145,12,38,-26
26,4,146,5,14,-9
26,4,147,4,16,-12
26,4,148,7,19,-12
26,4,149,1,5,-4
26,4,150,7,14,-7
26,4,151,5,28,-23
26,4,152,10,39,-29
26,4,153,6,21,-15
26,4,154,19,24,-5
26,4,155,11,10,1
26,4,156,17,28,-11
26,4,157,16,23,-7
26,4,158,14,19,-5
26,4,159,10,5,5
26,4,160,15,17,-2
26,4,161,3,11,-8
26,4,162,4,13,-9
26,4,163,3,20,-17
26,4,164,4,15,-11
26,4,165,15,19,-4
26,4,166,8,22,-14
26,4,167,3,15,-12
26,4,168,10,24,-14
26,4,169,12,22,-10
26,4,170,14,28,-14
26,4,171,12,33,-21
26,4,172,8,20,-12
26,4,173,4,18,-14
26,4,174,9,22,-13
26,4,175,13,21,-8
26,4,176,8,17,-9
26,4,177,7,21,-14
26,4,178,4,23,-19
26,4,179,7,18,-11
26,4,180,9,23,-14
26,4,181,8,19,-11
26,4,182,19,28,-9
26,4,183,7,19,-12
26,4,184,5,16,-11
26,4,185,7,30,-23
26,4,186,11,16,-5
26,4,187,7,12,-5
26,4,188,12,21,-9
26,4,189,7,25,-18
26,4,190,16,33,-17
26,4,191,11,29,-18
26,4,192,8,14,-6
26,4,193,11,30,-19
26,4,194,6,16,-10
26,4,195,13,32,-19
26,4,196,3,21,-18
26,4,197,6,26,-20
26,4,198,5,7,-2
26,4,199,9,31,-22
26,4,200,7,27,-20
26,4,201,12,29,-17
26,4,202,7,21,-14
26,4,203,15,16,-1
26,4,204,7,20,-13
26,4,205,9,25,-16
26,4,206,11,10,1
26,4,207,6,20,-14
26,4,208,3,12,-9
26,4,209,12,17,-5
26,4,210,6,34,-28
26,4,211,11,21,-10
26,4,212,8,22,-14
26,4,213,10,32,-22
26,4,214,9,22,-13
26,4,215,15,46,-31
26,4,216,7,27,-20
26,4,217,13,20,-7
26,4,218,8,21,-13
26,4,219,8,5,3
26,4,220,6,20,-14
26,4,221,11,15,-4
26,4,222,8,10,-2
26,4,223,6,27,-21
26,4,224,15,28,-13
26,4,225,13,21,-8
26,4,226,11,18,-7
26,4,227,18,29,-11
26,4,228,9,17,-8
26,4,229,8,19,-11
26,4,230,5,24,-19
26,4,231,2,15,-13
26,4,232,15,29,-14
26,4,233,17,20,-3
26,4,234,9,11,-2
26,4,235,7,14,-7
26,4,236,13,14,-1
26,4,237,9,12,-3
26,4,238,8,32,-24
26,4,239,17,28,-11
26,4,240,14,19,-5
26,4,241,10,22,-12
26,4,242,10,19,-9
26,4,243,10,35,-25
26,4,244,19,32,-13
26,4,245,14,19,-5
26,4,246,11,28,-17
26,4,247,8,24,-16
26,4,248,5,18,-13
26,4,249,11,22,-11
26,4,250,3,7,-4
26,4,251,20,17,3
26,4,252,9,30,-21
26,4,253,13,11,2
26,4,254,15,18,-3
26,4,255,11,41,-30
26,4,256,10,18,-8
26,4,257,9,20,-11
26,4,258,17,21,-4
26,4,259,7,15,-8
26,4,260,5,14,-9
26,4,261,10,14,-4
26,4,262,2,20,-18
26,4,263,6,13,-7
26,4,264,5,20,-15
26,4,265,13,30,-17
26,4,266,4,11,-7
26,4,267,6,15,-9
26,4,268,7,15,-8
26,4,269,12,15,-3
26,4,270,21,23,-2
26,4,271,14,29,-15
26,4,272,8,13,-5
26,4,273,2,25,-23
26,4,274,8,10,-2
26,4,275,10,32,-22
26,4,276,10,14,-4
26,4,277,9,5,4
26,4,278,8,17,-9
26,4,279,7,23,-16
26,4,280,10,24,-14
26,4,281,9,13,-4
26,4,282,6,18,-12
26,4,283,8,10,-2
26,4,284,7,14,-7
26,4,285,5,23,-18
26,4,286,7,13,-6
26,4,287,11,26,-15
26,4,288,12,17,-5
26,4,289,4,23,-19
26,4,290,11,8,3
26,4,291,6,24,-18
26,4,292,4,16,-12
26,4,293,2,34,-32
26,4,294,9,22,-13
26,4,295,4,23,-19
26,4,296,10,27,-17
26,4,297,8,18,-10
26,4,298,5,19,-14
26,4,299,9,21,-12
26,5,0,9,30,-21
26,5,1,7,15,-8
26,5,2,10,18,-8
26,5,3,11,25,-14
26,5,4,8,26,-18
26,5,5,9,19,-10
26,5,6,3,13,-10
26,5,7,7,9,-2
26,5,8,10,25,-15
26,5,9,7,23,-16
26,5,10,13,18,-5
26,5,11,5,9,-4
26,5,12,16,15,1
26,5,13,16,23,-7
26,5,14,8,16,-8
26,5,15,16,26,-10
26,5,16,14,26,-12
26,5,17,8,12,-4
26,5,18,6,16,-10
26,5,19,7,28,-21
26,5,20,14,28,-14
26,5,21,12,37,-25
26,5,22,12,27,-15
26,5,23,1,19,-18
26,5,24,2,7,-5
26,5,25,14,23,-9
26,5,26,12,23,-11
26,5,27,8,14,-6
26,5,28,12,30,-18
26,5,29,7,18,-11
26,5,30,13,16,-3
26,5,31,15,15,0
26,5,32,7,14,-7
26,5,33,2,12,-10
26,5,34,18,29,-11
26,5,35,6,16,-10
26,5,36,14,25,-11
26,5,37,4,15,-11
26,5,38,7,12,-5
26,5,39,6,14,-8
26,5,40,8,18,-10
26,5,41,8,17,-9
26,5,42,6,21,-15
26,5,43,3,35,-32
26,5,44,5,22,-17
26,5,45,14,27,-13
26,5,46,19,23,-4
26,5,47,16,22,-6
26,5,48,11,16,-5
26,5,49,4,20,-16
26,5,50,14,43,-29
26,5,51,8,24,-16
26,5,52,5,28,-23
26,5,53,5,12,-7
26,5,54,3,16,-13
26,5,55,8,30,-22
26,5,56,9,23,-14
26,5,57,8,22,-14
26,5,58,7,20,-13
26,5,59,3,17,-14
26,5,60,6,11,-5
26,5,61,9,19,-10
26,5,62,14,11,3
26,5,63,5,24,-19
26,5,64,12,21,-9
26,5,65,17,22,-5
26,5,66,9,14,-5
26,5,67,8,19,-11
26,5,68,12,25,-13
26,5,69,21,23,-2
26,5,70,14,15,-1
26,5,71,6,14,-8
26,5,72,2,24,-22
26,5,73,7,15,-8
26,5,74,13,21,-8
26,5,75,5,23,-18
26,5,76,14,22,-8
26,5,77,7,20,-13
26,5,78,3,18,-15
26,5,79,8,19,-11
26,5,80,17,27,-10
26,5,81,24,24,0
26,5,82,11,15,-4
26,5,83,8,22,-14
26,5,84,10,16,-6
26,5,85,12,24,-12
26,5,86,7,9,-2
26,5,87,9,24,-15
26,5,88,7,14,-7
26,5,89,4,17,-13
26,5,90,13,22,-9
26,5,91,13,24,-11
26,5,92,8,15,-7
26,5,93,6,20,-14
26,5,94,7,21,-14
26,5,95,3,30,-27
26,5,96,3,15,-12
26,5,97,6,16,-10
26,5,98,10,11,-1
26,5,99,4,15,-11
26,5,100,9,22,-13
26,5,101,10,13,-3
26,5,102,8,15,-7
26,5,103,8,33,-25
26,5,104,9,23,-14
26,5,105,10,15,-5
26,5,106,8,30,-22
26,5,107,13,19,-6
26,5,108,16,12,4
26,5,109,8,14,-6
26,5,110,8,24,-16
26,5,111,6,14,-8
26,5,112,9,35,-26
26,5,113,5,34,-29
26,5,114,11,15,-4
26,5,115,9,17,-8
26,5,116,17,39,-22
26,5,117,20,27,-7
26,5,118,4,21,-17
26,5,119,2,21,-19
26,5,120,4,36,-32
26,5,121,12,23,-11
26,5,122,8,18,-10
26,5,123,18,31,-13
26,5,124,5,17,-12
26,5,125,20,9,11
26,5,126,13,30,-17
26,5,127,8,31,-23
26,5,128,3,16,-13
26,5,129,8,18,-10
26,5,130,10,14,-4
26,5,131,11,10,1
26,5,132,3,20,-17
26,5,133,8,18,-10
26,5,134,12,29,-17
26,5,135,3,27,-24
26,5,136,12,23,-11
26,5,137,11,37,-26
26,5,138,9,9,0
26,5,139,4,19,-15
26,5,140,12,12,0
26,5,141,4,19,-15
26,5,142,13,21,-8
26,5,143,18,46,-28
26,5,144,7,27,-20
26,5,145,10,23,-13
26,5,146,5,20,-15
26,5,147,15,19,-4
26,5,148,10,34,-24
26,5,149,1,5,-4
26,5,150,7,14,-7
26,5,151,7,20,-13
26,5,152,19,23,-4
26,5,153,14,17,-3
26,5,154,17,20,-3
26,5,155,12,13,-1
26,5,156,7,22,-15
26,5,157,4,27,-23
26,5,158,7,21,-14
26,5,159,16,13,3
26,5,160,10,25,-15
26,5,161,6,24,-18
26,5,162,3,7,-4
26,5,163,11,19,-8
26,5,164,14,23,-9
26,5,165,9,12,-3
26,5,166,4,26,-22
26,5,167,6,26,-20
26,5,168,5,40,-35
26,5,169,14,29,-15
26,5,170,5,16,-11
26,5,171,10,19,-9
26,5,172,6,18,-12
26,5,173,4,19,-15
26,5,174,7,27,-20
26,5,175,6,22,-16
26,5,176,13,32,-19
26,5,177,4,20,-16
26,5,178,11,23,-12
26,5,179,11,22,-11
26,5,180,6,19,-13
26,5,181,3,19,-16
26,5,182,16,24,-8
26,5,183,11,20,-9
26,5,184,8,26,-18
26,5,185,16,15,1
26,5,186,6,19,-13
26,5,187,9,17,-8
26,5,188,4,17,-13
26,5,189,13,13,0
26,5,190,6,18,-12
26,5,191,15,22,-7
26,5,192,8,10,-2
26,5,193,6,24,-18
26,5,194,4,13,-9
26,5,195,2,27,-25
26,5,196,3,15,-12
26,5,197,5,1,4
26,5,198,9,25,-16
26,5,199,9,18,-9
26,5,200,9,24,-15
26,5,201,6,17,-11
26,5,202,11,24,-13
26,5,203,6,11,-5
26,5,204,13,18,-5
26,5,205,0,18,-18
26,5,206,9,30,-21
26,5,207,10,22,-12
26,5,208,11,21,-10
26,5,209,10,25,-15
26,5,210,10,19,-9
26,5,211,16,16,0
26,5,212,7,24,-17
26,5,213,7,9,-2
26,5,214,7,17,-10
26,5,215,8,19,-11
26,5,216,5,23,-18
26,5,217,8,26,-18
26,5,218,9,22,-13
26,5,219,11,27,-16
26,5,220,12,12,0
26,5,221,8,16,-8
26,5,222,7,11,-4
26,5,223,10,14,-4
26,5,224,23,22,1
26,5,225,9,24,-15
26,5,226,3,13,-10
26,5,227,4,17,-13
26,5,228,8,18,-10
26,5,229,9,13,-4
26,5,230,20,29,-9
26,5,231,11,43,-32
26,5,232,6,13,-7
26,5,233,6,22,-16
26,5,234,6,25,-19
26,5,235,18,12,6
26,5,236,13,22,-9
26,5,237,2,13,-11
26,5,238,3,31,-28
26,5,239,10,41,-31
26,5,240,7,23,-16
26,5,241,8,18,-10
26,5,242,8,20,-12
26,5,243,6,15,-9
26,5,244,6,22,-16
26,5,245,14,25,-11
26,5,246,3,19,-16
26,5,247,8,28,-20
26,5,248,11,16,-5
26,5,249,14,19,-5
26,5,250,11,28,-17
26,5,251,9,24,-15
26,5,252,13,17,-4
26,5,253,7,18,-11
26,5,254,6,21,-15
26,5,255,3,13,-10
26,5,256,6,11,-5
26,5,257,8,19,-11
26,5,258,10,15,-5
26,5,259,12,17,-5
26,5,260,8,19,-11
26,5,261,10,20,-10
26,5,262,4,24,-20
26,5,263,5,18,-13
26,5,264,8,10,-2
26,5,265,10,28,-18
26,5,266,10,13,-3
26,5,267,5,15,-10
26,5,268,10,17,-7
26,5,269,15,26,-11
26,5,270,4,14,-10
26,5,271,5,14,-9
26,5,272,11,22,-11
26,5,273,10,26,-16
26,5,274,7,15,-8
26,5,275,11,31,-20
26,5,276,10,13,-3
26,5,277,7,18,-11
26,5,278,9,18,-9
26,5,279,13,14,-1
26,5,280,14,29,-15
26,5,281,14,25,-11
26,5,282,12,26,-14
26,5,283,9,19,-10
26,5,284,6,18,-12
26,5,285,7,18,-11
26,5,286,7,20,-13
26,5,287,8,20,-12
26,5,288,6,23,-17
26,5,289,7,17,-10
26,5,290,23,15,8
26,5,291,7,17,-10
26,5,292,9,22,-13
26,5,293,1,7,-6
26,5,294,14,9,5
26,5,295,14,26,-12
26,5,296,9,17,-8
26,5,297,8,18,-10
26,5,298,14,19,-5
26,5,299,8,20,-12
26,6,0,8,23,-15
26,6,1,7,24,-17
26,6,2,10,27,-17
26,6,3,10,18,-8
26,6,4,7,20,-13
26,6,5,14,21,-7
26,6,6,7,27,-20
26,6,7,7,27,-20
26,6,8,15,12,3
26,6,9,6,7,-1
26,6,10,9,30,-21
26,6,11,10,22,-12
26,6,12,15,29,-14
26,6,13,9,14,-5
26,6,14,9,35,-26
26,6,15,14,9,5
26,6,16,6,30,-24
26,6,17,11,31,-20
26,6,18,9,40,-31
26,6,19,12,20,-8
26,6,20,6,32,-26
26,6,21,12,17,-5
26,6,22,16,15,1
26,6,23,8,15,-7
26,6,24,3,2,1
26,6,25,6,14,-8
26,6,26,0,18,-18
26,6,27,3,22,-19
26,6,28,14,25,-11
26,6,29,6,23,-17
26,6,30,9,23,-14
26,6,31,9,41,-32
26,6,32,5,11,-6
26,6,33,8,26,-18
26,6,34,10,9,1
26,6,35,5,18,-13
26,6,36,6,7,-1
26,6,37,3,21,-18
26,6,38,5,17,-12
26,6,39,12,21,-9
26,6,40,14,18,-4
26,6,41,16,26,-10
26,6,42,11,26,-15
26,6,43,14,38,-24
26,6,44,11,29,-18
26,6,45,10,17,-7
26,6,46,1,14,-13
26,6,47,8,31,-23
26,6,48,6,22,-16
26,6,49,14,12,2
26,6,50,9,32,-23
26,6,51,8,20,-12
26,6,52,17,19,-2
26,6,53,12,25,-13
26,6,54,11,29,-18
26,6,55,3,12,-9
26,6,56,4,28,-24
26,6,57,9,11,-2
26,6,58,5,16,-11
26,6,59,7,9,-2
26,6,60,9,34,-25
26,6,61,9,16,-7
26,6,62,6,20,-14
26,6,63,14,44,-30
26,6,64,7,22,-15
26,6,65,5,25,-20
26,6,66,9,18,-9
26,6,67,5,28,-23
26,6,68,10,24,-14
26,6,69,11,14,-3
26,6,70,13,35,-22
26,6,71,7,24,-17
26,6,72,10,31,-21
26,6,73,12,14,-2
26,6,74,12,25,-13
26,6,75,9,19,-10
26,6,76,7,29,-22
26,6,77,10,22,-12
26,6,78,15,32,-17
26,6,79,4,30,-26
26,6,80,17,41,-24
26,6,81,6,18,-12
26,6,82,16,23,-7
26,6,83,7,27,-20
26,6,84,10,8,2
26,6,85,2,7,-5
26,6,86,7,15,-8
26,6,87,6,19,-13
26,6,88,21,27,-6
26,6,89,5,10,-5
26,6,90,13,25,-12
26,6,91,16,18,-2
26,6,92,11,35,-24
26,6,93,14,29,-15
26,6,94,4,19,-15
26,6,95,11,19,-8
26,6,96,4,13,-9
26,6,97,16,12,4
26,6,98,7,17,-10
26,6,99,8,16,-8
26,6,100,13,23,-10
26,6,101,12,28,-16
26,6,102,8,13,-5
26,6,103,13,30,-17
26,6,104,14,23,-9
26,6,105,19,15,4
26,6,106,12,24,-12
26,6,107,8,25,-17
26,6,108,8,23,-15
26,6,109,14,32,-18
26,6,110,13,18,-5
26,6,111,20,29,-9
26,6,112,4,25,-21
26,6,113,4,26,-22
26,6,114,10,26,-16
26,6,115,13,19,-6
26,6,116,0,10,-10
26,6,117,12,30,-18
26,6,118,6,12,-6
26,6,119,5,14,-9
26,6,120,9,26,-17
26,6,121,6,12,-6
26,6,122,11,11,0
26,6,123,11,28,-17
26,6,124,10,24,-14
26,6,125,6,26,-20
26,6,126,8,15,-7
26,6,127,9,26,-17
26,6,128,8,12,-4
26,6,129,6,19,-13
26,6,130,12,34,-22
26,6,131,18,16,2
26,6,132,4,16,-12
26,6,133,8,15,-7
26,6,134,8,15,-7
26,6,135,17,12,5
26,6,136,10,22,-12
26,6,137,12,40,-28
26,6,138,11,15,-4
26,6,139,12,19,-7
26,6,140,3,14,-11
26,6,141,7,16,-9
26,6,142,7,25,-18
26,6,143,21,26,-5
26,6,144,7,14,-7
26,6,145,13,31,-18
26,6,146,12,16,-4
26,6,147,3,15,-12
26,6,148,7,16,-9
26,6,149,9,23,-14
26,6,150,9,15,-6
26,6,151,11,24,-13
26,6,152,6,31,-25
26,6,153,6,21,-15
26,6,154,11,21,-10
26,6,155,13,27,-14
26,6,156,10,30,-20
26,6,157,11,25,-14
26,6,158,6,8,-2
26,6,159,3,34,-31
26,6,160,9,19,-10
26,6,161,5,21,-16
26,6,162,11,25,-14
26,6,163,16,18,-2
26,6,164,11,23,-12
26,6,165,10,27,-17
26,6,166,7,24,-17
26,6,167,8,19,-11
26,6,168,12,13,-1
26,6,169,5,15,-10
26,6,170,10,37,-27
26,6,171,6,29,-23
26,6,172,12,19,-7
26,6,173,3,14,-11
26,6,174,16,26,-10
26,6,175,6,13,-7
26,6,176,6,12,-6
26,6,177,15,34,-19
26,6,178,12,17,-5
26,6,179,13,32,-19
26,6,180,15,33,-18
26,6,181,6,16,-10
26,6,182,9,29,-20
26,6,183,1,3,-2
26,6,184,16,18,-2
26,6,185,11,18,-7
26,6,186,6,12,-6
26,6,187,5,13,-8
26,6,188,9,9,0
26,6,189,15,34,-19
26,6,190,8,12,-4
26,6,191,15,30,-15
26,6,192,18,33,-15
26,6,193,7,20,-13
26,6,194,12,31,-19
26,6,195,8,11,-3
26,6,196,5,19,-14
26,6,197,6,18,-12
26,6,198,10,24,-14
26,6,199,10,24,-14
26,6,200,2,26,-24
26,6,201,16,25,-9
26,6,202,13,18,-5
26,6,203,12,13,-1
26,6,204,10,35,-25
26,6,205,11,9,2
26,6,206,13,25,-12
26,6,207,6,25,-19
26,6,208,5,17,-12
26,6,209,14,21,-7
26,6,210,7,10,-3
26,6,211,9,8,1
26,6,212,10,25,-15
26,6,213,15,38,-23
26,6,214,7,26,-19
26,6,215,12,17,-5
26,6,216,15,9,6
26,6,217,7,17,-10
26,6,218,11,14,-3
26,6,219,9,26,-17
26,6,220,7,4,3
26,6,221,8,37,-29
26,6,222,13,24,-11
26,6,223,8,27,-19
26,6,224,10,12,-2
26,6,225,17,14,3
26,6,226,10,19,-9
26,6,227,11,21,-10
26,6,228,6,22,-16
26,6,229,8,17,-9
26,6,230,3,13,-10
26,6,231,12,29,-17
26,6,232,4,11,-7
26,6,233,9,13,-4
26,6,234,9,22,-13
26,6,235,7,6,1
26,6,236,13,39,-26
26,6,237,14,38,-24
26,6,238,27,28,-1
26,6,239,9,25,-16
26,6,240,11,26,-15
26,6,241,16,23,-7
26,6,242,10,24,-14
26,6,243,7,11,-4
26,6,244,8,17,-9
26,6,245,16,19,-3
26,6,246,13,27,-14
26,6,247,4,15,-11
26,6,248,1,12,-11
26,6,249,16,28,-12
26,6,250,11,23,-12
26,6,251,2,7,-5
26,6,252,11,28,-17
26,6,253,7,16,-9
26,6,254,2,13,-11
26,6,255,7,20,-13
26,6,256,10,19,-9
26,6,257,6,27,-21
26,6,258,9,32,-23
26,6,259,7,17,-10
26,6,260,9,34,-25
26,6,261,9,10,-1
26,6,262,6,12,-6
26,6,263,7,38,-31
26,6,264,15,28,-13
26,6,265,16,6,10
26,6,266,10,12,-2
26,6,267,6,5,1
26,6,268,14,28,-14
26,6,269,11,27,-16
26,6,270,3,30,-27
26,6,271,8,19,-11
26,6,272,13,30,-17
26,6,273,15,22,-7
26,6,274,4,26,-22
26,6,275,11,23,-12
26,6,276,7,5,2
26,6,277,8,14,-6
26,6,278,11,16,-5
26,6,279,3,30,-27
26,6,280,16,34,-18
26,6,281,9,14,-5
26,6,282,7,13,-6
26,6,283,12,38,-26
26,6,284,12,21,-9
26,6,285,9,20,-11
26,6,286,8,26,-18
26,6,287,9,14,-5
26,6,288,6,16,-10
26,6,289,5,17,-12
26,6,290,19,15,4
26,6,291,10,19,-9
26,6,292,10,20,-10
26,6,293,13,30,-17
26,6,294,21,27,-6
26,6,295,3,16,-13
26,6,296,11,22,-11
26,6,297,6,27,-21
26,6,298,8,21,-13
26,6,299,3,20,-17
26,7,0,6,20,-14
26,7,1,8,21,-13
26,7,2,13,29,-16
26,7,3,16,17,-1
26,7,4,8,8,0
26,7,5,10,17,-7
26,7,6,17,17,0
26,7,7,6,17,-11
26,7,8,9,23,-14
26,7,9,15,25,-10
26,7,10,12,18,-6
26,7,11,7,16,-9
26,7,12,4,22,-18
26,7,13,7,27,-20
26,7,14,7,46,-39
26,7,15,9,23,-14
26,7,16,14,33,-19
26,7,17,11,19,-8
26,7,18,17,22,-5
26,7,19,14,7,7
26,7,20,7,31,-24
26,7,21,8,19,-11
26,7,22,10,22,-12
26,7,23,17,13,4
26,7,24,11,22,-11
26,7,25,6,10,-4
26,7,26,5,22,-17
26,7,27,17,13,4
26,7,28,9,16,-7
26,7,29,14,9,5
26,7,30,8,18,-10
26,7,31,12,22,-10
26,7,32,10,17,-7
26,7,33,6,6,0
26,7,34,14,41,-27
26,7,35,7,45,-38
26,7,36,13,12,1
26,7,37,5,13,-8
26,7,38,14,19,-5
26,7,39,7,31,-24
26,7,40,7,23,-16
26,7,41,16,19,-3
26,7,42,5,23,-18
26,7,43,13,32,-19
26,7,44,13,21,-8
26,7,45,9,26,-17
26,7,46,17,28,-11
26,7,47,10,9,1
26,7,48,4,15,-11
26,7,49,15,23,-8
26,7,50,4,13,-9
26,7,51,11,12,-1
26,7,52,6,24,-18
26,7,53,10,16,-6
26,7,54,15,17,-2
26,7,55,9,21,-12
26,7,56,14,20,-6
26,7,57,8,23,-15
26,7,58,19,24,-5
26,7,59,10,20,-10
26,7,60,7,23,-16
26,7,61,8,19,-11
26,7,62,17,31,-14
26,7,63,16,18,-2
26,7,64,13,20,-7
26,7,65,7,10,-3
26,7,66,12,16,-4
26,7,67,15,31,-16
26,7,68,8,9,-1
26,7,69,21,28,-7
26,7,70,11,17,-6
26,7,71,10,20,-10
26,7,72,9,13,-4
26,7,73,5,23,-18
26,7,74,12,14,-2
26,7,75,10,16,-6
26,7,76,5,21,-16
26,7,77,6,24,-18
26,7,78,5,15,-10
26,7,79,14,25,-11
26,7,80,10,28,-18
26,7,81,4,24,-20
26,7,82,13,30,-17
26,7,83,13,29,-16
26,7,84,12,17,-5
26,7,85,14,10,4
26,7,86,12,22,-10
26,7,87,7,19,-12
26,7,88,9,18,-9
26,7,89,9,30,-21
26,7,90,5,32,-27
26,7,91,11,18,-7
26,7,92,7,12,-5
26,7,93,9,12,-3
26,7,94,12,22,-10
26,7,95,11,18,-7
26,7,96,2,12,-10
26,7,97,10,27,-17
26,7,98,12,27,-15
26,7,99,22,16,6
26,7,100,11,18,-7
26,7,101,7,18,-11
26,7,102,23,14,9
26,7,103,6,16,-10
26,7,104,7,19,-12
26,7,105,10,27,-17
26,7,106,7,24,-17
26,7,107,7,20,-13
26,7,108,8,13,-5
26,7,109,11,33,-22
26,7,110,2,19,-17
26,7,111,20,36,-16
26,7,112,9,13,-4
26,7,113,5,3,2
26,7,114,9,16,-7
26,7,115,8,20,-12
26,7,116,17,26,-9
26,7,117,18,30,-12
26,7,118,9,23,-14
26,7,119,7,27,-20
26,7,120,16,21,-5
26,7,121,18,20,-2
26,7,122,14,26,-12
26,7,123,7,30,-23
26,7,124,6,9,-3
26,7,125,1,9,-8
26,7,126,14,21,-7
26,7,127,13,23,-10
26,7,128,14,36,-22
26,7,129,14,17,-3
26,7,130,9,29,-20
26,7,131,15,23,-8
26,7,132,14,27,-13
26,7,133,9,23,-14
26,7,134,12,19,-7
26,7,135,2,19,-17
26,7,136,13,16,-3
26,7,137,8,15,-7
26,7,138,21,36,-15
26,7,139,4,10,-6
26,7,140,17,31,-14
26,7,141,11,35,-24
26,7,142,10,17,-7
26,7,143,3,11,-8
26,7,144,6,19,-13
26,7,145,8,18,-10
26,7,146,15,32,-17
26,7,147,7,19,-12
26,7,148,12,32,-20
26,7,149,7,23,-16
26,7,150,5,28,-23
26,7,151,23,28,-5
26,7,152,3,17,-14
26,7,153,5,11,-6
26,7,154,10,17,-7
26,7,155,10,20,-10
26,7,156,11,17,-6
26,7,157,12,17,-5
26,7,158,9,21,-12
26,7,159,14,14,0
26,7,160,10,16,-6
26,7,161,13,31,-18
26,7,162,15,22,-7
26,7,163,8,25,-17
26,7,164,4,19,-15
26,7,165,10,20,-10
26,7,166,12,19,-7
26,7,167,7,14,-7
26,7,168,3,19,-16
26,7,169,3,12,-9
26,7,170,7,13,-6
26,7,171,21,20,1
26,7,172,11,32,-21
26,7,173,6,17,-11
26,7,174,4,10,-6
26,7,175,14,18,-4
26,7,176,6,8,-2
26,7,177,9,11,-2
26,7,178,10,23,-13
26,7,179,8,18,-10
26,7,180,13,31,-18
26,7,181,17,23,-6
26,7,182,10,22,-12
26,7,183,14,25,-11
26,7,184,7,9,-2
26,7,185,14,25,-11
26,7,186,4,13,-9
26,7,187,6,25,-19
26,7,188,10,31,-21
26,7,189,9,39,-30
26,7,190,5,23,-18
26,7,191,17,20,-3
26,7,192,3,19,-16
26,7,193,6,15,-9
26,7,194,8,21,-13
26,7,195,7,27,-20
26,7,196,14,28,-14
26,7,197,18,17,1
26,7,198,5,19,-14
26,7,199,8,12,-4
26,7,200,9,21,-12
26,7,201,15,39,-24
26,7,202,12,22,-10
26,7,203,7,27,-20
26,7,204,10,18,-8
26,7,205,14,12,2
26,7,206,3,13,-10
26,7,207,14,19,-5
26,7,208,5,23,-18
26,7,209,7,19,-12
26,7,210,4,14,-10
26,7,211,8,26,-18
26,7,212,7,15,-8
26,7,213,13,31,-18
26,7,214,11,29,-18
26,7,215,8,24,-16
26,7,216,6,24,-18
26,7,217,8,32,-24
26,7,218,3,13,-10
26,7,219,9,16,-7
26,7,220,13,28,-15
26,7,221,7,20,-13
26,7,222,4,20,-16
26,7,223,11,21,-10
26,7,224,3,17,-14
26,7,225,10,22,-12
26,7,226,7,25,-18
26,7,227,23,19,4
26,7,228,9,32,-23
26,7,229,12,29,-17
26,7,230,6,4,2
26,7,231,5,23,-18
26,7,232,13,28,-15
26,7,233,13,36,-23
26,7,234,12,20,-8
26,7,235,3,24,-21
26,7,236,12,37,-25
26,7,237,6,15,-9
26,7,238,5,14,-9
26,7,239,13,37,-24
26,7,240,12,28,-16
26,7,241,12,18,-6
26,7,242,23,28,-5
26,7,243,8,18,-10
26,7,244,10,11,-1
26,7,245,14,31,-17
26,7,246,9,21,-12
26,7,247,9,14,-5
26,7,248,10,17,-7
26,7,249,19,17,2
26,7,250,1,15,-14
26,7,251,9,22,-13
26,7,252,10,28,-18
26,7,253,12,29,-17
26,7,254,16,19,-3
26,7,255,6,17,-11
26,7,256,5,17,-12
26,7,257,9,11,-2
26,7,258,7,29,-22
26,7,259,10,30,-20
26,7,260,13,26,-13
26,7,261,14,27,-13
26,7,262,7,21,-14
26,7,263,16,13,3
26,7,264,16,22,-6
26,7,265,4,26,-22
26,7,266,11,35,-24
26,7,267,14,28,-14
26,7,268,6,17,-11
26,7,269,9,15,-6
26,7,270,9,23,-14
26,7,271,16,29,-13
26,7,272,7,11,-4
26,7,273,21,17,4
26,7,274,7,17,-10
26,7,275,7,14,-7
26,7,276,16,27,-11
26,7,277,20,32,-12
26,7,278,10,17,-7
26,7,279,3,20,-17
26,7,280,8,22,-14
26,7,281,17,11,6
26,7,282,9,23,-14
26,7,283,20,33,-13
26,7,284,9,32,-23
26,7,285,3,25,-22
26,7,286,11,23,-12
26,7,287,9,18,-9
26,7,288,13,17,-4
26,7,289,11,22,-11
26,7,290,10,28,-18
26,7,291,8,15,-7
26,7,292,8,12,-4
26,7,293,14,14,0
26,7,294,7,9,-2
26,7,295,11,19,-8
26,7,296,6,21,-15
26,7,297,8,21,-13
26,7,298,9,31,-22
26,7,299,8,15,-7
26,8,0,16,17,-1
26,8,1,17,27,-10
26,8,2,10,30,-20
26,8,3,16,27,-11
26,8,4,13,15,-2
26,8,5,25,35,-10
26,8,6,10,34,-24
26,8,7,11,16,-5
26,8,8,8,20,-12
26,8,9,16,40,-24
26,8,10,15,17,-2
26,8,11,5,15,-10
26,8,12,7,18,-11
26,8,13,11,19,-8
26,8,14,10,26,-16
26,8,15,9,17,-8
26,8,16,8,26,-18
26,8,17,15,15,0
26,8,18,11,12,-1
26,8,19,20,15,5
26,8,20,8,15,-7
26,8,21,11,23,-12
26,8,22,5,19,-14
26,8,23,18,19,-1
26,8,24,6,25,-19
26,8,25,7,13,-6
26,8,26,10,16,-6
26,8,27,14,24,-10
26,8,28,22,30,-8
26,8,29,12,36,-24
26,8,30,15,23,-8
26,8,31,12,26,-14
26,8,32,6,20,-14
26,8,33,17,25,-8
26,8,34,11,17,-6
26,8,35,7,13,-6
26,8,36,8,27,-19
26,8,37,7,22,-15
26,8,38,19,27,-8
26,8,39,6,18,-12
26,8,40,17,32,-15
26,8,41,10,23,-13
26,8,42,8,15,-7
26,8,43,11,14,-3
26,8,44,10,20,-10
26,8,45,11,23,-12
26,8,46,7,20,-13
26,8,47,17,23,-6
26,8,48,10,10,0
26,8,49,1,5,-4
26,8,50,7,23,-16
26,8,51,19,24,-5
26,8,52,10,20,-10
26,8,53,15,25,-10
26,8,54,11,16,-5
26,8,55,18,25,-7
26,8,56,8,26,-18
26,8,57,16,18,-2
26,8,58,14,22,-8
26,8,59,7,31,-24
26,8,60,16,23,-7
26,8,61,9,15,-6
26,8,62,8,15,-7
26,8,63,7,18,-11
26,8,64,6,3,3
26,8,65,20,23,-3
26,8,66,16,25,-9
26,8,67,16,27,-11
26,8,68,10,18,-8
26,8,69,10,27,-17
26,8,70,5,19,-14
26,8,71,6,26,-20
26,8,72,4,25,-21
26,8,73,11,23,-12
26,8,74,6,13,-7
26,8,75,5,8,-3
26,8,76,19,14,5
26,8,77,10,22,-12
26,8,78,9,26,-17
26,8,79,7,14,-7
26,8,80,6,18,-12
26,8,81,16,30,-14
26,8,82,5,27,-22
26,8,83,9,30,-21
26,8,84,10,18,-8
26,8,85,14,23,-9
26,8,86,4,26,-22
26,8,87,8,7,1
26,8,88,14,5,9
26,8,89,5,11,-6
26,8,90,16,18,-2
26,8,91,13,15,-2
26,8,92,9,24,-15
26,8,93,8,15,-7
26,8,94,7,17,-10
26,8,95,17,15,2
26,8,96,7,14,-7
26,8,97,15,20,-5
26,8,98,11,20,-9
26,8,99,15,27,-12
26,8,100,15,19,-4
26,8,101,4,10,-6
26,8,102,5,13,-8
26,8,103,5,17,-12
26,8,104,12,30,-18
26,8,105,4,6,-2
26,8,106,10,18,-8
26,8,107,13,17,-4
26,8,108,10,14,-4
26,8,109,10,17,-7
26,8,110,8,12,-4
26,8,111,13,22,-9
26,8,112,11,22,-11
26,8,113,5,23,-18
26,8,114,9,16,-7
26,8,115,10,11,-1
26,8,116,5,13,-8
26,8,117,6,17,-11
26,8,118,5,7,-2
26,8,119,8,8,0
26,8,120,16,32,-16
26,8,121,10,21,-11
26,8,122,8,16,-8
26,8,123,8,18,-10
26,8,124,8,23,-15
26,8,125,21,15,6
26,8,126,8,20,-12
26,8,127,8,23,-15
26,8,128,12,24,-12
26,8,129,15,25,-10
26,8,130,10,20,-10
26,8,131,10,7,3
26,8,132,15,14,1
26,8,133,10,21,-11
26,8,134,8,14,-6
26,8,135,17,18,-1
26,8,136,9,21,-12
26,8,137,3,5,-2
26,8,138,10,15,-5
26,8,139,10,14,-4
26,8,140,11,28,-17
26,8,141,11,32,-21
26,8,142,18,22,-4
26,8,143,8,19,-11
26,8,144,17,20,-3
26,8,145,18,21,-3
26,8,146,7,28,-21
26,8,147,13,17,-4
26,8,148,9,12,-3
26,8,149,11,11,0
26,8,150,8,23,-15
26,8,151,10,19,-9
26,8,152,6,22,-16
26,8,153,10,26,-16
26,8,154,5,20,-15
26,8,155,6,15,-9
26,8,156,8,30,-22
26,8,157,15,22,-7
26,8,158,10,22,-12
26,8,159,5,18,-13
26,8,160,11,18,-7
26,8,161,2,20,-18
26,8,162,11,20,-9
26,8,163,6,18,-12
26,8,164,19,33,-14
26,8,165,12,25,-13
26,8,166,3,9,-6
26,8,167,12,22,-10
26,8,168,17,33,-16
26,8,169,22,16,6
26,8,170,9,11,-2
26,8,171,12,20,-8
26,8,172,10,25,-15
26,8,173,9,6,3
26,8,174,12,18,-6
26,8,175,6,9,-3
26,8,176,4,33,-29
26,8,177,7,17,-10
26,8,178,12,30,-18
26,8,179,17,33,-16
26,8,180,7,21,-14
26,8,181,12,15,-3
26,8,182,4,10,-6
26,8,183,11,28,-17
26,8,184,2,22,-20
26,8,185,3,23,-20
26,8,186,10,12,-2
26,8,187,13,20,-7
26,8,188,7,20,-13
26,8,189,17,21,-4
26,8,190,4,11,-7
26,8,191,5,17,-12
26,8,192,13,21,-8
26,8,193,5,12,-7
26,8,194,6,21,-15
26,8,195,4,12,-8
26,8,196,7,18,-11
26,8,197,11,28,-17
26,8,198,11,20,-9
26,8,199,8,29,-21
26,8,200,15,26,-11
26,8,201,14,36,-22
26,8,202,14,19,-5
26,8,203,11,18,-7
26,8,204,11,17,-6
26,8,205,1,8,-7
26,8,206,15,21,-6
26,8,207,4,19,-15
26,8,208,5,38,-33
26,8,209,4,17,-13
26,8,210,8,33,-25
26,8,211,10,19,-9
26,8,212,9,13,-4
26,8,213,13,22,-9
26,8,214,10,30,-20
26,8,215,12,10,2
26,8,216,14,17,-3
26,8,217,12,25,-13
26,8,218,16,35,-19
26,8,219,8,14,-6
26,8,220,13,26,-13
26,8,221,15,22,-7
26,8,222,6,16,-10
26,8,223,8,19,-11
26,8,224,8,18,-10
26,8,225,4,17,-13
26,8,226,12,18,-6
26,8,227,5,29,-24
26,8,228,3,17,-14
26,8,229,7,21,-14
26,8,230,1,17,-16
26,8,231,6,12,-6
26,8,232,10,20,-10
26,8,233,7,11,-4
26,8,234,11,19,-8
26,8,235,9,18,-9
26,8,236,3,21,-18
26,8,237,7,6,1
26,8,238,8,23,-15
26,8,239,12,24,-12
26,8,240,14,21,-7
26,8,241,4,12,-8
26,8,242,14,27,-13
26,8,243,4,21,-17
26,8,244,8,13,-5
26,8,245,8,20,-12
26,8,246,16,23,-7
26,8,247,6,18,-12
26,8,248,4,19,-15
26,8,249,7,23,-16
26,8,250,12,27,-15
26,8,251,20,21,-1
26,8,252,11,24,-13
26,8,253,7,34,-27
26,8,254,5,2,3
26,8,255,6,20,-14
26,8,256,3,11,-8
26,8,257,22,18,4
26,8,258,8,14,-6
26,8,259,14,18,-4
26,8,260,10,12,-2
26,8,261,15,30,-15
26,8,262,13,30,-17
26,8,263,6,6,0
26,8,264,3,25,-22
26,8,265,14,10,4
26,8,266,12,19,-7
26,8,267,11,17,-6
26,8,268,11,19,-8
26,8,269,11,16,-5
26,8,270,1,14,-13
26,8,271,10,21,-11
26,8,272,10,12,-2
26,8,273,10,15,-5
26,8,274,4,20,-16
26,8,275,11,29,-18
26,8,276,14,20,-6
26,8,277,7,33,-26
26,8,278,19,31,-12
26,8,279,9,32,-23
26,8,280,8,15,-7
26,8,281,13,14,-1
26,8,282,6,19,-13
26,8,283,12,15,-3
26,8,284,15,12,3
26,8,285,9,17,-8
26,8,286,7,18,-11
26,8,287,16,30,-14
26,8,288,12,29,-17
26,8,289,11,13,-2
26,8,290,18,28,-10
26,8,291,9,7,2
26,8,292,9,12,-3
26,8,293,7,16,-9
26,8,294,11,15,-4
26,8,295,3,16,-13
26,8,296,12,26,-14
26,8,297,11,32,-21
26,8,298,4,15,-11
26,8,299,14,23,-9
26,9,0,10,25,-15
26,9,1,3,25,-22
26,9,2,7,13,-6
26,9,3,9,11,-2
26,9,4,6,11,-5
26,9,5,6,7,-1
26,9,6,5,4,1
26,9,7,12,31,-19
26,9,8,12,26,-14
26,9,9,9,25,-16
26,9,10,12,32,-20
26,9,11,5,14,-9
26,9,12,7,11,-4
26,9,13,5,11,-6
26,9,14,15,26,-11
26,9,15,6,13,-7
26,9,16,8,11,-3
26,9,17,17,14,3
26,9,18,9,9,0
26,9,19,10,21,-11
26,9,20,7,17,-10
26,9,21,6,21,-15
26,9,22,14,27,-13
26,9,23,16,27,-11
26,9,24,7,28,-21
26,9,25,5,15,-10
26,9,26,11,15,-4
26,9,27,6,15,-9
26,9,28,13,22,-9
26,9,29,22,17,5
26,9,30,8,30,-22
26,9,31,13,30,-17
26,9,32,12,24,-12
26,9,33,12,17,-5
26,9,34,5,27,-22
26,9,35,11,9,2
26,9,36,17,20,-3
26,9,37,23,22,1
26,9,38,10,17,-7
26,9,39,12,26,-14
26,9,40,8,15,-7
26,9,41,7,15,-8
26,9,42,14,11,3
26,9,43,6,6,0
26,9,44,14,18,-4
26,9,45,7,20,-13
26,9,46,15,22,-7
26,9,47,12,19,-7
26,9,48,10,33,-23
26,9,49,7,17,-10
26,9,50,13,31,-18
26,9,51,10,14,-4
26,9,52,10,23,-13
26,9,53,6,17,-11
26,9,54,10,15,-5
26,9,55,4,14,-10
26,9,56,12,21,-9
26,9,57,12,15,-3
26,9,58,15,30,-15
26,9,59,8,21,-13
26,9,60,2,31,-29
26,9,61,11,25,-14
26,9,62,12,21,-9
26,9,63,4,27,-23
26,9,64,5,22,-17
26,9,65,4,10,-6
26,9,66,9,23,-14
26,9,67,3,18,-15
26,9,68,10,17,-7
26,9,69,18,38,-20
26,9,70,6,30,-24
26,9,71,13,29,-16
26,9,72,3,12,-9
26,9,73,1,19,-18
26,9,74,5,17,-12
26,9,75,6,26,-20
26,9,76,6,8,-2
26,9,77,6,10,-4
26,9,78,6,25,-19
26,9,79,12,24,-12
26,9,80,4,11,-7
26,9,81,7,11,-4
26,9,82,12,13,-1
26,9,83,4,22,-18
26,9,84,12,21,-9
26,9,85,3,9,-6
26,9,86,12,21,-9
26,9,87,19,22,-3
26,9,88,16,31,-15
26,9,89,18,25,-7
26,9,90,9,10,-1
26,9,91,4,20,-16
26,9,92,13,29,-16
26,9,93,17,13,4
26,9,94,5,35,-30
26,9,95,6,14,-8
26,9,96,9,18,-9
26,9,97,12,28,-16
26,9,98,3,10,-7
26,9,99,11,12,-1
26,9,100,12,38,-26
26,9,101,5,14,-9
26,9,102,7,30,-23
26,9,103,13,31,-18
26,9,104,11,22,-11
26,9,105,14,15,-1
26,9,106,20,26,-6
26,9,107,7,23,-16
26,9,108,13,23,-10
26,9,109,5,18,-13
26,9,110,21,26,-5
26,9,111,4,12,-8
26,9,112,18,23,-5
26,9,113,5,14,-9
26,9,114,15,20,-5
26,9,115,6,14,-8
26,9,116,5,4,1
26,9,117,6,18,-12
26,9,118,6,18,-12
26,9,119,11,24,-13
26,9,120,14,34,-20
26,9,121,6,22,-16
26,9,122,15,20,-5
26,9,123,7,9,-2
26,9,124,8,35,-27
26,9,125,13,22,-9
26,9,126,10,23,-13
26,9,127,8,16,-8
26,9,128,8,19,-11
26,9,129,14,23,-9
26,9,130,9,17,-8
26,9,131,16,13,3
26,9,132,10,20,-10
26,9,133,8,20,-12
26,9,134,13,27,-14
26,9,135,16,18,-2
26,9,136,9,15,-6
26,9,137,8,21,-13
26,9,138,11,22,-11
26,9,139,11,8,3
26,9,140,10,11,-1
26,9,141,8,6,2
26,9,142,6,15,-9
26,9,143,9,15,-6
26,9,144,15,37,-22
26,9,145,10,19,-9
26,9,146,6,15,-9
26,9,147,5,12,-7
26,9,148,10,38,-28
26,9,149,18,30,-12
26,9,150,6,17,-11
26,9,151,10,20,-10
26,9,152,17,12,5
26,9,153,11,11,0
26,9,154,14,17,-3
26,9,155,9,19,-10
26,9,156,6,21,-15
26,9,157,17,14,3
26,9,158,11,16,-5
26,9,159,9,29,-20
26,9,160,20,23,-3
26,9,161,13,24,-11
26,9,162,12,24,-12
26,9,163,13,27,-14
26,9,164,13,23,-10
26,9,165,18,34,-16
26,9,166,14,28,-14
26,9,167,12,26,-14
26,9,168,10,15,-5
26,9,169,9,18,-9
26,9,170,8,26,-18
26,9,171,9,20,-11
26,9,172,9,16,-7
26,9,173,5,11,-6
26,9,174,12,25,-13
26,9,175,11,14,-3
26,9,176,13,23,-10
26,9,177,14,22,-8
26,9,178,2,10,-8
26,9,179,11,19,-8
26,9,180,11,15,-4
26,9,181,15,28,-13
26,9,182,10,33,-23
26,9,183,11,22,-11
26,9,184,15,31,-16
26,9,185,13,8,5
26,9,186,10,22,-12
26,9,187,8,18,-10
26,9,188,19,25,-6
26,9,189,7,22,-15
26,9,190,16,12,4
26,9,191,13,25,-12
26,9,192,1,23,-22
26,9,193,12,19,-7
26,9,194,5,13,-8
26,9,195,13,24,-11
26,9,196,15,22,-7
26,9,197,7,12,-5
26,9,198,8,20,-12
26,9,199,9,15,-6
26,9,200,16,16,0
26,9,201,4,29,-25
26,9,202,12,15,-3
26,9,203,11,21,-10
26,9,204,10,15,-5
26,9,205,16,25,-9
26,9,206,9,30,-21
26,9,207,11,17,-6
26,9,208,7,20,-13
26,9,209,10,22,-12
26,9,210,11,25,-14
26,9,211,17,20,-3
26,9,212,8,23,-15
26,9,213,7,27,-20
26,9,214,3,10,-7
26,9,215,10,24,-14
26,9,216,8,17,-9
26,9,217,21,15,6
26,9,218,10,24,-14
26,9,219,5,10,-5
26,9,220,7,12,-5
26,9,221,9,19,-10
26,9,222,14,8,6
26,9,223,15,10,5
26,9,224,15,20,-5
26,9,225,13,22,-9
26,9,226,7,14,-7
26,9,227,3,25,-22
26,9,228,10,17,-7
26,9,229,9,25,-16
26,9,230,11,26,-15
26,9,231,13,40,-27
26,9,232,8,7,1
26,9,233,9,12,-3
26,9,234,9,25,-16
26,9,235,6,14,-8
26,9,236,16,28,-12
26,9,237,6,15,-9
26,9,238,16,16,0
26,9,239,8,18,-10
26,9,240,8,18,-10
26,9,241,21,16,5
26,9,242,11,14,-3
26,9,243,19,25,-6
26,9,244,15,30,-15
26,9,245,3,10,-7
26,9,246,15,18,-3
26,9,247,10,20,-10
26,9,248,8,16,-8
26,9,249,5,22,-17
26,9,250,10,18,-8
26,9,251,10,8,2
26,9,252,14,16,-2
26,9,253,13,32,-19
26,9,254,14,23,-9
26,9,255,11,13,-2
26,9,256,18,24,-6
26,9,257,10,35,-25
26,9,258,11,11,0
26,9,259,12,18,-6
26,9,260,8,21,-13
26,9,261,17,21,-4
26,9,262,16,16,0
26,9,263,17,22,-5
26,9,264,10,17,-7
26,9,265,1,11,-10
26,9,266,0,4,-4
26,9,267,6,21,-15
26,9,268,11,12,-1
26,9,269,8,22,-14
26,9,270,8,26,-18
26,9,271,12,16,-4
26,9,272,12,24,-12
26,9,273,7,38,-31
26,9,274,5,25,-20
26,9,275,7,16,-9
26,9,276,22,20,2
26,9,277,4,25,-21
26,9,278,5,11,-6
26,9,279,11,18,-7
26,9,280,11,23,-12
26,9,281,13,11,2
26,9,282,8,34,-26
26,9,283,11,13,-2
26,9,284,9,18,-9
26,9,285,13,23,-10
26,9,286,16,21,-5
26,9,287,7,14,-7
26,9,288,12,16,-4
26,9,289,9,22,-13
26,9,290,8,18,-10
26,9,291,3,26,-23
26,9,292,9,22,-13
26,9,293,9,39,-30
26,9,294,12,7,5
26,9,295,16,28,-12
26,9,296,9,20,-11
26,9,297,5,18,-13
26,9,298,16,8,8
26,9,299,12,32,-20
26,10,0,18,21,-3
26,10,1,22,23,-1
26,10,2,14,14,0
26,10,3,9,15,-6
26,10,4,13,9,4
26,10,5,11,11,0
26,10,6,13,22,-9
26,10,7,11,19,-8
26,10,8,15,15,0
26,10,9,11,27,-16
26,10,10,11,16,-5
26,10,11,13,16,-3
26,10,12,1,13,-12
26,10,13,13,15,-2
26,10,14,18,23,-5
26,10,15,7,18,-11
26,10,16,15,15,0
26,10,17,15,27,-12
26,10,18,9,18,-9
26,10,19,12,18,-6
26,10,20,4,19,-15
26,10,21,2,13,-11
26,10,22,10,27,-17
26,10,23,21,24,-3
26,10,24,15,17,-2
26,10,25,12,20,-8
26,10,26,16,22,-6
26,10,27,24,34,-10
26,10,28,9,15,-6
26,10,29,8,10,-2
26,10,30,12,23,-11
26,10,31,13,13,0
26,10,32,12,16,-4
26,10,33,6,19,-13
26,10,34,10,20,-10
26,10,35,8,25,-17
26,10,36,14,26,-12
26,10,37,21,37,-16
26,10,38,7,29,-22
26,10,39,12,30,-18
26,10,40,12,21,-9
26,10,41,6,26,-20
26,10,42,8,12,-4
26,10,43,9,16,-7
26,10,44,4,26,-22
26,10,45,13,26,-13
26,10,46,8,13,-5
26,10,47,7,14,-7
26,10,48,10,22,-12
26,10,49,14,25,-11
26,10,50,24,32,-8
26,10,51,6,14,-8
26,10,52,10,12,-2
26,10,53,8,13,-5
26,10,54,8,25,-17
26,10,55,7,16,-9
26,10,56,12,19,-7
26,10,57,11,11,0
26,10,58,12,17,-5
26,10,59,7,8,-1
26,10,60,4,20,-16
26,10,61,19,21,-2
26,10,62,14,14,0
26,10,63,19,23,-4
26,10,64,14,23,-9
26,10,65,8,24,-16
26,10,66,13,18,-5
26,10,67,5,12,-7
26,10,68,8,15,-7
26,10,69,18,32,-14
26,10,70,16,19,-3
26,10,71,13,20,-7
26,10,72,13,32,-19
26,10,73,14,30,-16
26,10,74,12,11,1
26,10,75,5,22,-17
26,10,76,2,10,-8
26,10,77,5,16,-11
26,10,78,5,15,-10
26,10,79,17,25,-8
26,10,80,6,23,-17
26,10,81,12,24,-12
26,10,82,10,21,-11
26,10,83,16,21,-5
26,10,84,10,20,-10
26,10,85,11,5,6
26,10,86,8,23,-15
26,10,87,18,10,8
26,10,88,5,11,-6
26,10,89,14,18,-4
26,10,90,13,15,-2
26,10,91,6,10,-4
26,10,92,13,26,-13
26,10,93,8,16,-8
26,10,94,26,22,4
26,10,95,16,24,-8
26,10,96,21,17,4
26,10,97,4,21,-17
26,10,98,11,17,-6
26,10,99,15,14,1
26,10,100,15,32,-17
26,10,101,1,4,-3
26,10,102,8,17,-9
26,10,103,11,33,-22
26,10,104,3,6,-3
26,10,105,15,23,-8
26,10,106,20,24,-4
26,10,107,16,23,-7
26,10,108,13,26,-13
26,10,109,9,21,-12
26,10,110,3,31,-28
26,10,111,13,20,-7
26,10,112,19,20,-1
26,10,113,9,8,1
26,10,114,17,30,-13
26,10,115,6,4,2
26,10,116,16,20,-4
26,10,117,14,27,-13
26,10,118,14,14,0
26,10,119,14,27,-13
26,10,120,3,18,-15
26,10,121,4,18,-14
26,10,122,18,19,-1
26,10,123,14,21,-7
26,10,124,11,27,-16
26,10,125,13,25,-12
26,10,126,9,18,-9
26,10,127,8,39,-31
26,10,128,7,14,-7
26,10,129,11,14,-3
26,10,130,6,18,-12
26,10,131,4,13,-9
26,10,132,15,14,1
26,10,133,10,23,-13
26,10,134,6,28,-22
26,10,135,6,17,-11
26,10,136,10,16,-6
26,10,137,21,18,3
26,10,138,14,16,-2
26,10,139,8,3,5
26,10,140,6,7,-1
26,10,141,10,27,-17
26,10,142,13,21,-8
26,10,143,5,7,-2
26,10,144,3,12,-9
26,10,145,14,17,-3
26,10,146,19,27,-8
26,10,147,17,24,-7
26,10,148,11,19,-8
26,10,149,14,25,-11
26,10,150,16,22,-6
26,10,151,5,17,-12
26,10,152,14,13,1
26,10,153,13,17,-4
26,10,154,11,16,-5
26,10,155,9,21,-12
26,10,156,22,41,-19
26,10,157,4,13,-9
26,10,158,14,18,-4
26,10,159,8,14,-6
26,10,160,10,11,-1
26,10,161,6,16,-10
26,10,162,19,21,-2
26,10,163,13,27,-14
26,10,164,15,12,3
26,10,165,12,19,-7
26,10,166,7,18,-11
26,10,167,8,17,-9
26,10,168,2,14,-12
26,10,169,11,23,-12
26,10,170,13,32,-19
26,10,171,13,20,-7
26,10,172,8,14,-6
26,10,173,10,17,-7
26,10,174,8,17,-9
26,10,175,4,9,-5
26,10,176,12,31,-19
26,10,177,12,39,-27
26,10,178,16,11,5
26,10,179,7,16,-9
26,10,180,12,9,3
26,10,181,7,25,-18
26,10,182,4,18,-14
26,10,183,20,10,10
26,10,184,10,17,-7
26,10,185,11,21,-10
26,10,186,3,15,-12
26,10,187,9,23,-14
26,10,188,8,24,-16
26,10,189,2,18,-16
26,10,190,13,19,-6
26,10,191,15,19,-4
26,10,192,16,25,-9
26,10,193,8,20,-12
26,10,194,8,12,-4
26,10,195,6,9,-3
26,10,196,21,45,-24
26,10,197,13,34,-21
26,10,198,5,15,-10
26,10,199,8,23,-15
26,10,200,7,15,-8
26,10,201,17,20,-3
26,10,202,7,24,-17
26,10,203,14,8,6
26,10,204,13,17,-4
26,10,205,16,12,4
26,10,206,3,13,-10
26,10,207,9,31,-22
26,10,208,13,31,-18
26,10,209,14,12,2
26,10,210,8,17,-9
26,10,211,16,17,-1
26,10,212,6,26,-20
26,10,213,11,30,-19
26,10,214,12,19,-7
26,10,215,14,27,-13
26,10,216,4,7,-3
26,10,217,4,10,-6
26,10,218,16,10,6
26,10,219,9,34,-25
26,10,220,13,18,-5
26,10,221,13,23,-10
26,10,222,17,19,-2
26,10,223,12,23,-11
26,10,224,5,16,-11
26,10,225,9,13,-4
26,10,226,17,24,-7
26,10,227,11,17,-6
26,10,228,9,22,-13
26,10,229,7,9,-2
26,10,230,15,28,-13
26,10,231,7,15,-8
26,10,232,2,16,-14
26,10,233,14,21,-7
26,10,234,10,21,-11
26,10,235,9,24,-15
26,10,236,15,25,-10
26,10,237,8,13,-5
26,10,238,12,17,-5
26,10,239,19,24,-5
26,10,240,12,16,-4
26,10,241,8,26,-18
26,10,242,23,33,-10
26,10,243,9,17,-8
26,10,244,16,18,-2
26,10,245,16,24,-8
26,10,246,8,26,-18
26,10,247,2,14,-12
26,10,248,11,24,-13
26,10,249,9,27,-18
26,10,250,18,26,-8
26,10,251,13,18,-5
26,10,252,10,17,-7
26,10,253,6,16,-10
26,10,254,13,22,-9
26,10,255,10,19,-9
26,10,256,18,17,1
26,10,257,16,17,-1
26,10,258,13,26,-13
26,10,259,10,15,-5
26,10,260,12,19,-7
26,10,261,11,10,1
26,10,262,13,15,-2
26,10,263,8,26,-18
26,10,264,17,15,2
26,10,265,7,20,-13
26,10,266,12,28,-16
26,10,267,17,16,1
26,10,268,6,8,-2
26,10,269,6,27,-21
26,10,270,8,17,-9
26,10,271,10,26,-16
26,10,272,10,17,-7
26,10,273,11,17,-6
26,10,274,13,39,-26
26,10,275,9,10,-1
26,10,276,14,20,-6
26,10,277,7,5,2
26,10,278,9,14,-5
26,10,279,7,24,-17
26,10,280,14,33,-19
26,10,281,14,33,-19
26,10,282,14,15,-1
26,10,283,6,21,-15
26,10,284,5,21,-16
26,10,285,12,14,-2
26,10,286,14,22,-8
26,10,287,8,23,-15
26,10,288,6,23,-17
26,10,289,24,24,0
26,10,290,10,21,-11
26,10,291,9,13,-4
26,10,292,16,6,10
26,10,293,4,12,-8
26,10,294,24,17,7
26,10,295,4,11,-7
26,10,296,15,15,0
26,10,297,10,30,-20
26,10,298,9,18,-9
26,10,299,9,10,-1
26,11,0,15,20,-5
26,11,1,15,14,1
26,11,2,13,11,2
26,11,3,11,21,-10
26,11,4,6,18,-12
26,11,5,7,12,-5
26,11,6,8,16,-8
26,11,7,6,24,-18
26,11,8,6,15,-9
26,11,9,12,22,-10
26,11,10,26,34,-8
26,11,11,14,17,-3
26,11,12,3,19,-16
26,11,13,9,16,-7
26,11,14,5,12,-7
26,11,15,12,16,-4
26,11,16,6,36,-30
26,11,17,7,20,-13
26,11,18,10,28,-18
26,11,19,7,15,-8
26,11,20,20,20,0
26,11,21,8,32,-24
26,11,22,4,12,-8
26,11,23,5,5,0
26,11,24,13,23,-10
26,11,25,12,24,-12
26,11,26,9,24,-15
26,11,27,7,31,-24
26,11,28,11,28,-17
26,11,29,15,14,1
26,11,30,6,19,-13
26,11,31,13,17,-4
26,11,32,8,23,-15
26,11,33,7,12,-5
26,11,34,13,27,-14
26,11,35,16,22,-6
26,11,36,12,27,-15
26,11,37,12,20,-8
26,11,38,8,24,-16
26,11,39,10,22,-12
26,11,40,17,20,-3
26,11,41,13,24,-11
26,11,42,14,8,6
26,11,43,7,16,-9
26,11,44,11,13,-2
26,11,45,10,31,-21
26,11,46,5,15,-10
26,11,47,8,11,-3
26,11,48,5,30,-25
26,11,49,10,20,-10
26,11,50,14,25,-11
26,11,51,5,17,-12
26,11,52,10,11,-1
26,11,53,12,27,-15
26,11,54,14,16,-2
26,11,55,14,20,-6
26,11,56,12,20,-8
26,11,57,9,20,-11
26,11,58,11,13,-2
26,11,59,13,29,-16
26,11,60,6,21,-15
26,11,61,13,13,0
26,11,62,7,17,-10
26,11,63,6,8,-2
26,11,64,14,24,-10
26,11,65,11,17,-6
26,11,66,6,17,-11
26,11,67,6,15,-9
26,11,68,2,10,-8
26,11,69,19,26,-7
26,11,70,11,15,-4
26,11,71,9,10,-1
26,11,72,12,29,-17
26,11,73,9,29,-20
26,11,74,8,27,-19
26,11,75,10,14,-4
26,11,76,5,30,-25
26,11,77,15,8,7
26,11,78,7,13,-6
26,11,79,10,13,-3
26,11,80,5,13,-8
26,11,81,17,29,-12
26,11,82,2,29,-27
26,11,83,0,1,-1
26,11,84,14,13,1
26,11,85,11,17,-6
26,11,86,2,8,-6
26,11,87,6,16,-10
26,11,88,13,19,-6
26,11,89,6,20,-14
26,11,90,17,27,-10
26,11,91,5,12,-7
26,11,92,13,20,-7
26,11,93,6,14,-8
26,11,94,8,16,-8
26,11,95,10,9,1
26,11,96,12,32,-20
26,11,97,7,26,-19
26,11,98,2,14,-12
26,11,99,11,14,-3
26,11,100,13,13,0
26,11,101,11,26,-15
26,11,102,3,21,-18
26,11,103,9,21,-12
26,11,104,12,7,5
26,11,105,6,13,-7
26,11,106,10,20,-10
26,11,107,15,21,-6
26,11,108,10,12,-2
26,11,109,10,32,-22
26,11,110,11,18,-7
26,11,111,10,18,-8
26,11,112,7,19,-12
26,11,113,14,15,-1
26,11,114,19,23,-4
26,11,115,1,14,-13
26,11,116,24,20,4
26,11,117,13,34,-21
26,11,118,14,29,-15
26,11,119,14,27,-13
26,11,120,14,29,-15
26,11,121,10,24,-14
26,11,122,7,20,-13
26,11,123,13,19,-6
26,11,124,11,12,-1
26,11,125,5,13,-8
26,11,126,2,11,-9
26,11,127,9,16,-7
26,11,128,2,30,-28
26,11,129,12,20,-8
26,11,130,11,17,-6
26,11,131,8,17,-9
26,11,132,14,20,-6
26,11,133,16,21,-5
26,11,134,14,31,-17
26,11,135,8,22,-14
26,11,136,15,22,-7
26,11,137,11,11,0
26,11,138,21,28,-7
26,11,139,14,28,-14
26,11,140,12,30,-18
26,11,141,7,17,-10
26,11,142,13,19,-6
26,11,143,9,4,5
26,11,144,10,15,-5
26,11,145,10,18,-8
26,11,146,12,37,-25
26,11,147,9,18,-9
26,11,148,9,22,-13
26,11,149,11,8,3
26,11,150,17,19,-2
26,11,151,11,14,-3
26,11,152,5,23,-18
26,11,153,10,14,-4
26,11,154,9,25,-16
26,11,155,6,16,-10
26,11,156,12,19,-7
26,11,157,4,13,-9
26,11,158,3,19,-16
26,11,159,7,11,-4
26,11,160,8,28,-20
26,11,161,6,15,-9
26,11,162,8,26,-18
26,11,163,9,17,-8
26,11,164,9,38,-29
26,11,165,10,16,-6
26,11,166,18,13,5
26,11,167,6,17,-11
26,11,168,14,27,-13
26,11,169,9,19,-10
26,11,170,18,24,-6
26,11,171,15,25,-10
26,11,172,15,22,-7
26,11,173,13,23,-10
26,11,174,11,21,-10
26,11,175,6,24,-18
26,11,176,9,22,-13
26,11,177,11,14,-3
26,11,178,14,27,-13
26,11,179,17,23,-6
26,11,180,18,38,-20
26,11,181,8,22,-14
26,11,182,14,22,-8
26,11,183,1,10,-9
26,11,184,21,22,-1
26,11,185,11,22,-11
26,11,186,13,14,-1
26,11,187,8,32,-24
26,11,188,4,22,-18
26,11,189,20,19,1
26,11,190,9,11,-2
26,11,191,9,25,-16
26,11,192,4,18,-14
26,11,193,18,24,-6
26,11,194,6,31,-25
26,11,195,7,22,-15
26,11,196,9,5,4
26,11,197,17,21,-4
26,11,198,7,20,-13
26,11,199,14,15,-1
26,11,200,10,23,-13
26,11,201,12,11,1
26,11,202,13,11,2
26,11,203,3,19,-16
26,11,204,9,17,-8
26,11,205,6,14,-8
26,11,206,5,21,-16
26,11,207,8,12,-4
26,11,208,9,30,-21
26,11,209,16,30,-14
26,11,210,15,22,-7
26,11,211,16,17,-1
26,11,212,12,16,-4
26,11,213,10,19,-9
26,11,214,6,17,-11
26,11,215,10,18,-8
26,11,216,12,30,-18
26,11,217,15,12,3
26,11,218,15,9,6
26,11,219,20,39,-19
26,11,220,18,24,-6
26,11,221,14,19,-5
26,11,222,6,20,-14
26,11,223,7,24,-17
26,11,224,9,22,-13
26,11,225,33,23,10
26,11,226,13,37,-24
26,11,227,11,13,-2
26,11,228,11,19,-8
26,11,229,14,14,0
26,11,230,7,14,-7
26,11,231,14,26,-12
26,11,232,11,25,-14
26,11,233,11,29,-18
26,11,234,7,12,-5
26,11,235,18,10,8
26,11,236,7,25,-18
26,11,237,15,37,-22
26,11,238,11,14,-3
26,11,239,6,6,0
26,11,240,13,9,4
26,11,241,12,12,0
26,11,242,8,28,-20
26,11,243,10,16,-6
26,11,244,8,10,-2
26,11,245,14,21,-7
26,11,246,14,26,-12
26,11,247,8,23,-15
26,11,248,15,19,-4
26,11,249,13,25,-12
26,11,250,12,22,-10
26,11,251,12,10,2
26,11,252,13,44,-31
26,11,253,11,24,-13
26,11,254,9,20,-11
26,11,255,16,16,0
26,11,256,14,20,-6
26,11,257,28,21,7
26,11,258,12,26,-14
26,11,259,6,14,-8
26,11,260,22,21,1
26,11,261,1,12,-11
26,11,262,7,26,-19
26,11,263,6,18,-12
26,11,264,11,25,-14
26,11,265,12,19,-7
26,11,266,11,25,-14
26,11,267,13,23,-10
26,11,268,14,18,-4
26,11,269,7,14,-7
26,11,270,17,26,-9
26,11,271,18,20,-2
26,11,272,16,12,4
26,11,273,15,18,-3
26,11,274,10,14,-4
26,11,275,14,29,-15
26,11,276,5,8,-3
26,11,277,8,29,-21
26,11,278,9,12,-3
26,11,279,7,25,-18
26,11,280,5,35,-30
26,11,281,21,21,0
26,11,282,0,10,-10
26,11,283,13,13,0
26,11,284,8,10,-2
26,11,285,8,12,-4
26,11,286,18,13,5
26,11,287,9,31,-22
26,11,288,5,13,-8
26,11,289,9,18,-9
26,11,290,4,15,-11
26,11,291,12,16,-4
26,11,292,9,15,-6
26,11,293,13,15,-2
26,11,294,13,21,-8
26,11,295,16,24,-8
26,11,296,12,26,-14
26,11,297,19,18,1
26,11,298,14,15,-1
26,11,299,16,19,-3
26,12,0,6,7,-1
26,12,1,12,20,-8
26,12,2,7,12,-5
26,12,3,13,17,-4
26,12,4,4,20,-16
26,12,5,21,9,12
26,12,6,17,13,4
26,12,7,11,14,-3
26,12,8,13,17,-4
26,12,9,5,13,-8
26,12,10,13,20,-7
26,12,11,9,16,-7
26,12,12,11,9,2
26,12,13,19,12,7
26,12,14,15,23,-8
26,12,15,13,28,-15
26,12,16,7,10,-3
26,12,17,22,18,4
26,12,18,17,25,-8
26,12,19,15,19,-4
26,12,20,19,30,-11
26,12,21,7,9,-2
26,12,22,12,22,-10
26,12,23,15,27,-12
26,12,24,4,16,-12
26,12,25,4,19,-15
26,12,26,16,16,0
26,12,27,9,13,-4
26,12,28,8,24,-16
26,12,29,9,17,-8
26,12,30,18,16,2
26,12,31,11,22,-11
26,12,32,11,8,3
26,12,33,10,16,-6
26,12,34,6,15,-9
26,12,35,4,11,-7
26,12,36,13,23,-10
26,12,37,11,18,-7
26,12,38,8,9,-1
26,12,39,13,13,0
26,12,40,10,30,-20
26,12,41,13,26,-13
26,12,42,14,19,-5
26,12,43,16,19,-3
26,12,44,6,17,-11
26,12,45,12,12,0
26,12,46,10,21,-11
26,12,47,10,10,0
26,12,48,6,11,-5
26,12,49,4,11,-7
26,12,50,12,16,-4
26,12,51,18,6,12
26,12,52,19,24,-5
26,12,53,7,17,-10
26,12,54,10,12,-2
26,12,55,17,27,-10
26,12,56,9,31,-22
26,12,57,19,17,2
26,12,58,6,47,-41
26,12,59,17,20,-3
26,12,60,14,30,-16
26,12,61,13,16,-3
26,12,62,11,15,-4
26,12,63,19,17,2
26,12,64,7,38,-31
26,12,65,20,32,-12
26,12,66,10,13,-3
26,12,67,10,18,-8
26,12,68,11,24,-13
26,12,69,12,16,-4
26,12,70,9,18,-9
26,12,71,17,18,-1
26,12,72,9,13,-4
26,12,73,7,13,-6
26,12,74,16,12,4
26,12,75,12,19,-7
26,12,76,4,6,-2
26,12,77,13,14,-1
26,12,78,14,13,1
26,12,79,10,27,-17
26,12,80,13,14,-1
26,12,81,12,16,-4
26,12,82,7,21,-14
26,12,83,22,24,-2
26,12,84,6,5,1
26,12,85,8,19,-11
26,12,86,8,25,-17
26,12,87,12,29,-17
26,12,88,18,23,-5
26,12,89,12,12,0
26,12,90,9,10,-1
26,12,91,6,17,-11
26,12,92,6,3,3
26,12,93,22,15,7
26,12,94,5,8,-3
26,12,95,20,21,-1
26,12,96,9,11,-2
26,12,97,9,18,-9
26,12,98,11,31,-20
26,12,99,12,20,-8
26,12,100,20,29,-9
26,12,101,8,9,-1
26,12,102,1,0,1
26,12,103,16,18,-2
26,12,104,11,24,-13
26,12,105,5,15,-10
26,12,106,10,19,-9
26,12,107,14,16,-2
26,12,108,9,17,-8
26,12,109,5,28,-23
26,12,110,16,13,3
26,12,111,4,5,-1
26,12,112,7,23,-16
26,12,113,12,18,-6
26,12,114,10,12,-2
26,12,115,15,21,-6
26,12,116,13,20,-7
26,12,117,15,11,4
26,12,118,6,19,-13
26,12,119,12,18,-6
26,12,120,13,10,3
26,12,121,5,15,-10
26,12,122,5,14,-9
26,12,123,17,19,-2
26,12,124,14,25,-11
26,12,125,12,22,-10
26,12,126,16,42,-26
26,12,127,20,15,5
26,12,128,17,11,6
26,12,129,21,11,10
26,12,130,9,19,-10
26,12,131,19,25,-6
26,12,132,18,19,-1
26,12,133,11,20,-9
26,12,134,18,16,2
26,12,135,8,9,-1
26,12,136,9,19,-10
26,12,137,15,18,-3
26,12,138,10,15,-5
26,12,139,12,24,-12
26,12,140,14,27,-13
26,12,141,5,5,0
26,12,142,17,14,3
26,12,143,15,7,8
26,12,144,11,21,-10
26,12,145,10,19,-9
26,12,146,16,29,-13
26,12,147,9,16,-7
26,12,148,11,19,-8
26,12,149,9,21,-12
26,12,150,5,12,-7
26,12,151,11,11,0
26,12,152,5,8,-3
26,12,153,14,25,-11
26,12,154,4,17,-13
26,12,155,13,22,-9
26,12,156,12,24,-12
26,12,157,14,18,-4
26,12,158,10,16,-6
26,12,159,7,9,-2
26,12,160,13,28,-15
26,12,161,10,21,-11
26,12,162,13,36,-23
26,12,163,1,14,-13
26,12,164,3,8,-5
26,12,165,16,18,-2
26,12,166,15,32,-17
26,12,167,16,28,-12
26,12,168,12,11,1
26,12,169,19,28,-9
26,12,170,6,15,-9
26,12,171,8,7,1
26,12,172,14,29,-15
26,12,173,12,10,2
26,12,174,5,16,-11
26,12,175,10,43,-33
26,12,176,13,17,-4
26,12,177,10,17,-7
26,12,178,10,10,0
26,12,179,7,17,-10
26,12,180,7,24,-17
26,12,181,12,34,-22
26,12,182,20,24,-4
26,12,183,8,12,-4
26,12,184,9,7,2
26,12,185,6,22,-16
26,12,186,11,13,-2
26,12,187,10,14,-4
26,12,188,9,25,-16
26,12,189,11,17,-6
26,12,190,13,25,-12
26,12,191,11,24,-13
26,12,192,16,16,0
26,12,193,9,11,-2
26,12,194,8,27,-19
26,12,195,11,16,-5
26,12,196,6,14,-8
26,12,197,23,19,4
26,12,198,19,17,2
26,12,199,11,29,-18
26,12,200,17,18,-1
26,12,201,12,21,-9
26,12,202,8,10,-2
26,12,203,9,32,-23
26,12,204,12,21,-9
26,12,205,5,12,-7
26,12,206,9,15,-6
26,12,207,15,26,-11
26,12,208,12,18,-6
26,12,209,6,21,-15
26,12,210,8,14,-6
26,12,211,9,15,-6
26,12,212,13,11,2
26,12,213,22,25,-3
26,12,214,14,11,3
26,12,215,16,38,-22
26,12,216,12,16,-4
26,12,217,4,10,-6
26,12,218,7,23,-16
26,12,219,7,16,-9
26,12,220,11,13,-2
26,12,221,27,24,3
26,12,222,2,15,-13
26,12,223,11,15,-4
26,12,224,7,26,-19
26,12,225,7,15,-8
26,12,226,8,15,-7
26,12,227,8,27,-19
26,12,228,8,18,-10
26,12,229,8,11,-3
26,12,230,1,11,-10
26,12,231,3,15,-12
26,12,232,16,16,0
26,12,233,11,19,-8
26,12,234,12,28,-16
26,12,235,14,19,-5
26,12,236,10,22,-12
26,12,237,4,9,-5
26,12,238,16,18,-2
26,12,239,13,13,0
26,12,240,12,13,-1
26,12,241,17,18,-1
26,12,242,16,8,8
26,12,243,16,19,-3
26,12,244,23,18,5
26,12,245,9,17,-8
26,12,246,6,18,-12
26,12,247,8,18,-10
26,12,248,8,24,-16
26,12,249,8,13,-5
26,12,250,16,22,-6
26,12,251,12,28,-16
26,12,252,2,7,-5
26,12,253,4,18,-14
26,12,254,16,22,-6
26,12,255,13,15,-2
26,12,256,7,19,-12
26,12,257,21,24,-3
26,12,258,12,29,-17
26,12,259,13,28,-15
26,12,260,10,21,-11
26,12,261,10,34,-24
26,12,262,5,20,-15
26,12,263,14,23,-9
26,12,264,9,15,-6
26,12,265,4,10,-6
26,12,266,9,4,5
26,12,267,17,22,-5
26,12,268,12,18,-6
26,12,269,15,22,-7
26,12,270,7,27,-20
26,12,271,6,22,-16
26,12,272,9,10,-1
26,12,273,11,10,1
26,12,274,9,15,-6
26,12,275,4,13,-9
26,12,276,17,8,9
26,12,277,9,18,-9
26,12,278,15,35,-20
26,12,279,8,9,-1
26,12,280,10,15,-5
26,12,281,24,25,-1
26,12,282,21,29,-8
26,12,283,15,14,1
26,12,284,6,17,-11
26,12,285,7,14,-7
26,12,286,11,19,-8
26,12,287,12,12,0
26,12,288,20,18,2
26,12,289,12,15,-3
26,12,290,4,18,-14
26,12,291,5,14,-9
26,12,292,11,19,-8
26,12,293,7,23,-16
26,12,294,13,14,-1
26,12,295,26,16,10
26,12,296,18,14,4
26,12,297,6,6,0
26,12,298,8,29,-21
26,12,299,8,8,0
26,13,0,4,13,-9
26,13,1,12,13,-1
26,13,2,4,13,-9
26,13,3,11,26,-15
26,13,4,10,17,-7
26,13,5,4,20,-16
26,13,6,10,13,-3
26,13,7,6,5,1
26,13,8,24,16,8
26,13,9,8,25,-17
26,13,10,13,23,-10
26,13,11,8,13,-5
26,13,12,6,11,-5
26,13,13,6,27,-21
26,13,14,10,24,-14
26,13,15,7,21,-14
26,13,16,12,25,-13
26,13,17,8,21,-13
26,13,18,12,29,-17
26,13,19,8,29,-21
26,13,20,5,11,-6
26,13,21,15,23,-8
26,13,22,7,16,-9
26,13,23,2,23,-21
26,13,24,8,25,-17
26,13,25,6,13,-7
26,13,26,12,16,-4
26,13,27,13,18,-5
26,13,28,13,22,-9
26,13,29,2,10,-8
26,13,30,14,13,1
26,13,31,31,35,-4
26,13,32,8,19,-11
26,13,33,10,8,2
26,13,34,13,19,-6
26,13,35,8,18,-10
26,13,36,11,12,-1
26,13,37,12,18,-6
26,13,38,7,14,-7
26,13,39,18,20,-2
26,13,40,5,17,-12
26,13,41,9,11,-2
26,13,42,13,23,-10
26,13,43,7,16,-9
26,13,44,13,14,-1
26,13,45,9,17,-8
26,13,46,7,5,2
26,13,47,18,20,-2
26,13,48,22,22,0
26,13,49,13,7,6
26,13,50,7,11,-4
26,13,51,20,21,-1
26,13,52,15,6,9
26,13,53,12,13,-1
26,13,54,10,16,-6
26,13,55,6,15,-9
26,13,56,7,17,-10
26,13,57,6,21,-15
26,13,58,8,16,-8
26,13,59,4,11,-7
26,13,60,15,18,-3
26,13,61,12,20,-8
26,13,62,12,24,-12
26,13,63,4,18,-14
26,13,64,12,23,-11
26,13,65,11,13,-2
26,13,66,12,8,4
26,13,67,16,18,-2
26,13,68,1,4,-3
26,13,69,8,9,-1
26,13,70,9,21,-12
26,13,71,9,16,-7
26,13,72,11,19,-8
26,13,73,4,23,-19
26,13,74,5,28,-23
26,13,75,8,33,-25
26,13,76,4,19,-15
26,13,77,12,19,-7
26,13,78,7,17,-10
26,13,79,5,17,-12
26,13,80,11,17,-6
26,13,81,8,19,-11
26,13,82,6,24,-18
26,13,83,3,13,-10
26,13,84,11,13,-2
26,13,85,12,16,-4
26,13,86,14,26,-12
26,13,87,8,10,-2
26,13,88,12,30,-18
26,13,89,10,15,-5
26,13,90,13,15,-2
26,13,91,8,22,-14
26,13,92,18,32,-14
26,13,93,8,11,-3
26,13,94,5,13,-8
26,13,95,10,22,-12
26,13,96,25,10,15
26,13,97,18,25,-7
26,13,98,9,17,-8
26,13,99,15,19,-4
26,13,100,11,34,-23
26,13,101,10,22,-12
26,13,102,5,25,-20
26,13,103,12,24,-12
26,13,104,11,34,-23
26,13,105,15,27,-12
26,13,106,8,6,2
26,13,107,6,10,-4
26,13,108,5,14,-9
26,13,109,5,10,-5
26,13,110,7,15,-8
26,13,111,11,16,-5
26,13,112,9,25,-16
26,13,113,6,8,-2
26,13,114,9,24,-15
26,13,115,21,13,8
26,13,116,9,9,0
26,13,117,17,32,-15
26,13,118,21,34,-13
26,13,119,18,25,-7
26,13,120,10,23,-13
26,13,121,12,24,-12
26,13,122,16,30,-14
26,13,123,10,24,-14
26,13,124,11,20,-9
26,13,125,19,18,1
26,13,126,6,13,-7
26,13,127,22,33,-11
26,13,128,12,21,-9
26,13,129,34,41,-7
26,13,130,5,13,-8
26,13,131,12,26,-14
26,13,132,5,20,-15
26,13,133,9,6,3
26,13,134,4,17,-13
26,13,135,19,32,-13
26,13,136,15,21,-6
26,13,137,10,14,-4
26,13,138,13,17,-4
26,13,139,18,25,-7
26,13,140,25,21,4
26,13,141,4,21,-17
26,13,142,13,26,-13
26,13,143,6,24,-18
26,13,144,13,21,-8
26,13,145,3,10,-7
26,13,146,8,21,-13
26,13,147,10,7,3
26,13,148,19,17,2
26,13,149,12,5,7
26,13,150,6,13,-7
26,13,151,16,23,-7
26,13,152,4,21,-17
26,13,153,7,19,-12
26,13,154,5,20,-15
26,13,155,9,19,-10
26,13,156,16,14,2
26,13,157,8,13,-5
26,13,158,5,13,-8
26,13,159,6,34,-28
26,13,160,6,19,-13
26,13,161,4,23,-19
26,13,162,17,18,-1
26,13,163,11,15,-4
26,13,164,11,20,-9
26,13,165,14,15,-1
26,13,166,8,16,-8
26,13,167,12,23,-11
26,13,168,9,18,-9
26,13,169,15,38,-23
26,13,170,18,10,8
26,13,171,11,9,2
26,13,172,10,27,-17
26,13,173,6,19,-13
26,13,174,11,25,-14
26,13,175,11,25,-14
26,13,176,15,23,-8
26,13,177,27,35,-8
26,13,178,9,16,-7
26,13,179,9,23,-14
26,13,180,5,29,-24
26,13,181,9,23,-14
26,13,182,5,16,-11
26,13,183,7,22,-15
26,13,184,13,12,1
26,13,185,5,13,-8
26,13,186,15,21,-6
26,13,187,2,12,-10
26,13,188,3,10,-7
26,13,189,10,17,-7
26,13,190,11,7,4
26,13,191,17,7,10
26,13,192,18,13,5
26,13,193,13,9,4
26,13,194,7,12,-5
26,13,195,7,11,-4
26,13,196,12,16,-4
26,13,197,6,9,-3
26,13,198,3,19,-16
26,13,199,6,6,0
26,13,200,6,14,-8
26,13,201,5,12,-7
26,13,202,9,20,-11
26,13,203,11,24,-13
26,13,204,4,15,-11
26,13,205,10,15,-5
26,13,206,3,13,-10
26,13,207,10,10,0
26,13,208,30,26,4
26,13,209,9,11,-2
26,13,210,12,17,-5
26,13,211,7,18,-11
26,13,212,9,18,-9
26,13,213,9,26,-17
26,13,214,7,30,-23
26,13,215,6,8,-2
26,13,216,8,30,-22
26,13,217,10,20,-10
26,13,218,1,30,-29
26,13,219,8,12,-4
26,13,220,6,9,-3
26,13,221,15,21,-6
26,13,222,11,23,-12
26,13,223,13,16,-3
26,13,224,21,16,5
26,13,225,14,21,-7
26,13,226,9,8,1
26,13,227,10,15,-5
26,13,228,10,15,-5
26,13,229,16,25,-9
26,13,230,9,9,0
26,13,231,13,18,-5
26,13,232,8,36,-28
26,13,233,8,17,-9
26,13,234,14,20,-6
26,13,235,12,25,-13
26,13,236,7,13,-6
26,13,237,3,15,-12
26,13,238,10,12,-2
26,13,239,11,9,2
26,13,240,9,28,-19
26,13,241,11,20,-9
26,13,242,11,16,-5
26,13,243,11,31,-20
26,13,244,17,27,-10
26,13,245,9,10,-1
26,13,246,6,20,-14
26,13,247,5,14,-9
26,13,248,11,25,-14
26,13,249,22,31,-9
26,13,250,5,24,-19
26,13,251,14,26,-12
26,13,252,14,23,-9
26,13,253,6,16,-10
26,13,254,13,15,-2
26,13,255,2,29,-27
26,13,256,10,22,-12
26,13,257,14,18,-4
26,13,258,17,29,-12
26,13,259,6,25,-19
26,13,260,11,26,-15
26,13,261,7,15,-8
26,13,262,15,23,-8
26,13,263,7,16,-9
26,13,264,12,18,-6
26,13,265,21,29,-8
26,13,266,7,19,-12
26,13,267,11,31,-20
26,13,268,17,16,1
26,13,269,8,12,-4
26,13,270,6,9,-3
26,13,271,9,18,-9
26,13,272,14,9,5
26,13,273,14,33,-19
26,13,274,2,15,-13
26,13,275,10,16,-6
26,13,276,4,19,-15
26,13,277,13,18,-5
26,13,278,14,27,-13
26,13,279,11,16,-5
26,13,280,19,18,1
26,13,281,19,33,-14
26,13,282,8,19,-11
26,13,283,12,33,-21
26,13,284,13,18,-5
26,13,285,15,16,-1
26,13,286,13,23,-10
26,13,287,5,23,-18
26,13,288,13,7,6
26,13,289,15,36,-21
26,13,290,18,27,-9
26,13,291,15,30,-15
26,13,292,17,24,-7
26,13,293,10,24,-14
26,13,294,12,18,-6
26,13,295,14,17,-3
26,13,296,6,19,-13
26,13,297,11,13,-2
26,13,298,4,24,-20
26,13,299,9,22,-13
26,14,0,13,11,2
26,14,1,18,17,1
26,14,2,8,14,-6
26,14,3,5,17,-12
26,14,4,17,14,3
26,14,5,7,9,-2
26,14,6,15,20,-5
26,14,7,9,27,-18
26,14,8,19,29,-10
26,14,9,10,23,-13
26,14,10,13,9,4
26,14,11,13,21,-8
26,14,12,16,11,5
26,14,13,5,12,-7
26,14,14,13,21,-8
26,14,15,10,20,-10
26,14,16,16,16,0
26,14,17,13,12,1
26,14,18,9,17,-8
26,14,19,14,27,-13
26,14,20,10,31,-21
26,14,21,10,28,-18
26,14,22,16,12,4
26,14,23,11,11,0
26,14,24,16,9,7
26,14,25,11,20,-9
26,14,26,11,11,0
26,14,27,6,16,-10
26,14,28,7,10,-3
26,14,29,11,19,-8
26,14,30,10,12,-2
26,14,31,15,22,-7
26,14,32,8,23,-15
26,14,33,21,23,-2
26,14,34,2,8,-6
26,14,35,8,24,-16
26,14,36,18,26,-8
26,14,37,7,6,1
26,14,38,10,9,1
26,14,39,3,18,-15
26,14,40,18,10,8
26,14,41,10,23,-13
26,14,42,20,17,3
26,14,43,8,9,-1
26,14,44,10,7,3
26,14,45,12,12,0
26,14,46,8,14,-6
26,14,47,10,4,6
26,14,48,15,17,-2
26,14,49,9,22,-13
26,14,50,15,17,-2
26,14,51,15,9,6
26,14,52,9,17,-8
26,14,53,14,15,-1
26,14,54,10,24,-14
26,14,55,20,20,0
26,14,56,20,21,-1
26,14,57,9,15,-6
26,14,58,15,23,-8
26,14,59,7,26,-19
26,14,60,15,29,-14
26,14,61,11,29,-18
26,14,62,14,29,-15
26,14,63,6,33,-27
26,14,64,5,24,-19
26,14,65,11,12,-1
26,14,66,10,19,-9
26,14,67,27,21,6
26,14,68,7,11,-4
26,14,69,7,16,-9
26,14,70,1,18,-17
26,14,71,13,10,3
26,14,72,14,20,-6
26,14,73,11,25,-14
26,14,74,8,16,-8
26,14,75,18,26,-8
26,14,76,18,26,-8
26,14,77,24,18,6
26,14,78,12,21,-9
26,14,79,15,12,3
26,14,80,2,8,-6
26,14,81,16,19,-3
26,14,82,14,19,-5
26,14,83,16,15,1
26,14,84,15,16,-1
26,14,85,11,12,-1
26,14,86,8,24,-16
26,14,87,6,11,-5
26,14,88,17,25,-8
26,14,89,8,21,-13
26,14,90,11,20,-9
26,14,91,6,19,-13
26,14,92,9,15,-6
26,14,93,9,17,-8
26,14,94,10,42,-32
26,14,95,12,15,-3
26,14,96,17,16,1
26,14,97,12,22,-10
26,14,98,16,12,4
26,14,99,14,17,-3
26,14,100,13,8,5
26,14,101,5,9,-4
26,14,102,8,12,-4
26,14,103,14,14,0
26,14,104,14,15,-1
26,14,105,18,34,-16
26,14,106,14,36,-22
26,14,107,12,22,-10
26,14,108,16,18,-2
26,14,109,5,16,-11
26,14,110,14,26,-12
26,14,111,7,11,-4
26,14,112,4,19,-15
26,14,113,11,13,-2
26,14,114,8,22,-14
26,14,115,13,17,-4
26,14,116,10,24,-14
26,14,117,15,16,-1
26,14,118,6,11,-5
26,14,119,8,10,-2
26,14,120,11,9,2
26,14,121,15,16,-1
26,14,122,9,13,-4
26,14,123,14,16,-2
26,14,124,10,10,0
26,14,125,14,18,-4
26,14,126,16,12,4
26,14,127,7,15,-8
26,14,128,9,29,-20
26,14,129,13,15,-2
26,14,130,12,20,-8
26,14,131,15,24,-9
26,14,132,21,20,1
26,14,133,1,13,-12
26,14,134,15,16,-1
26,14,135,9,20,-11
26,14,136,7,34,-27
26,14,137,16,25,-9
26,14,138,16,13,3
26,14,139,15,21,-6
26,14,140,9,14,-5
26,14,141,9,13,-4
26,14,142,12,18,-6
26,14,143,10,16,-6
26,14,144,13,17,-4
26,14,145,9,18,-9
26,14,146,9,24,-15
26,14,147,22,22,0
26,14,148,11,14,-3
26,14,149,14,28,-14
26,14,150,19,29,-10
26,14,151,12,22,-10
26,14,152,13,17,-4
26,14,153,8,29,-21
26,14,154,9,24,-15
26,14,155,12,16,-4
26,14,156,8,17,-9
26,14,157,5,23,-18
26,14,158,5,14,-9
26,14,159,15,19,-4
26,14,160,14,14,0
26,14,161,18,19,-1
26,14,162,6,5,1
26,14,163,12,20,-8
26,14,164,12,16,-4
26,14,165,19,36,-17
26,14,166,9,20,-11
26,14,167,15,14,1
26,14,168,4,12,-8
26,14,169,13,19,-6
26,14,170,8,15,-7
26,14,171,12,16,-4
26,14,172,12,12,0
26,14,173,20,20,0
26,14,174,21,30,-9
26,14,175,18,29,-11
26,14,176,10,19,-9
26,14,177,23,31,-8
26,14,178,3,9,-6
26,14,179,13,14,-1
26,14,180,11,16,-5
26,14,181,11,28,-17
26,14,182,14,18,-4
26,14,183,6,23,-17
26,14,184,7,6,1
26,14,185,18,9,9
26,14,186,11,16,-5
26,14,187,8,27,-19
26,14,188,7,14,-7
26,14,189,5,14,-9
26,14,190,6,19,-13
26,14,191,5,15,-10
26,14,192,19,13,6
26,14,193,19,29,-10
26,14,194,18,14,4
26,14,195,10,20,-10
26,14,196,5,25,-20
26,14,197,16,19,-3
26,14,198,12,20,-8
26,14,199,11,18,-7
26,14,200,20,25,-5
26,14,201,21,23,-2
26,14,202,9,22,-13
26,14,203,14,14,0
26,14,204,14,11,3
26,14,205,0,9,-9
26,14,206,13,15,-2
26,14,207,17,18,-1
26,14,208,3,5,-2
26,14,209,9,13,-4
26,14,210,6,18,-12
26,14,211,6,12,-6
26,14,212,5,16,-11
26,14,213,18,28,-10
26,14,214,5,22,-17
26,14,215,10,12,-2
26,14,216,20,22,-2
26,14,217,13,21,-8
26,14,218,13,17,-4
26,14,219,7,20,-13
26,14,220,13,37,-24
26,14,221,9,15,-6
26,14,222,17,28,-11
26,14,223,12,10,2
26,14,224,16,22,-6
26,14,225,9,18,-9
26,14,226,13,17,-4
26,14,227,13,13,0
26,14,228,16,22,-6
26,14,229,10,14,-4
26,14,230,9,18,-9
26,14,231,5,28,-23
26,14,232,8,13,-5
26,14,233,13,19,-6
26,14,234,13,27,-14
26,14,235,12,27,-15
26,14,236,21,26,-5
26,14,237,8,9,-1
26,14,238,14,20,-6
26,14,239,13,17,-4
26,14,240,16,25,-9
26,14,241,18,17,1
26,14,242,3,9,-6
26,14,243,17,13,4
26,14,244,19,18,1
26,14,245,7,28,-21
26,14,246,27,28,-1
26,14,247,11,23,-12
26,14,248,20,35,-15
26,14,249,19,25,-6
26,14,250,5,5,0
26,14,251,5,11,-6
26,14,252,17,19,-2
26,14,253,15,12,3
26,14,254,13,10,3
26,14,255,13,14,-1
26,14,256,16,25,-9
26,14,257,17,17,0
26,14,258,10,20,-10
26,14,259,11,19,-8
26,14,260,14,17,-3
26,14,261,10,19,-9
26,14,262,4,11,-7
26,14,263,4,17,-13
26,14,264,17,20,-3
26,14,265,12,13,-1
26,14,266,8,32,-24
26,14,267,6,17,-11
26,14,268,13,14,-1
26,14,269,23,18,5
26,14,270,2,10,-8
26,14,271,3,8,-5
26,14,272,14,15,-1
26,14,273,23,37,-14
26,14,274,11,18,-7
26,14,275,7,22,-15
26,14,276,19,8,11
26,14,277,9,22,-13
26,14,278,12,22,-10
26,14,279,16,23,-7
26,14,280,9,24,-15
26,14,281,9,16,-7
26,14,282,16,15,1
26,14,283,15,25,-10
26,14,284,12,20,-8
26,14,285,14,23,-9
26,14,286,14,14,0
26,14,287,13,14,-1
26,14,288,20,26,-6
26,14,289,12,15,-3
26,14,290,12,13,-1
26,14,291,12,9,3
26,14,292,11,5,6
26,14,293,9,10,-1
26,14,294,17,20,-3
26,14,295,17,15,2
26,14,296,11,20,-9
26,14,297,13,18,-5
26,14,298,10,24,-14
26,14,299,6,20,-14
26,15,0,9,16,-7
26,15,1,14,17,-3
26,15,2,11,15,-4
26,15,3,10,19,-9
26,15,4,11,17,-6
26,15,5,17,21,-4
26,15,6,11,29,-18
26,15,7,15,19,-4
26,15,8,9,18,-9
26,15,9,15,19,-4
26,15,10,13,21,-8
26,15,11,8,5,3
26,15,12,15,24,-9
26,15,13,7,3,4
26,15,14,12,24,-12
26,15,15,12,4,8
26,15,16,9,14,-5
26,15,17,15,23,-8
26,15,18,10,12,-2
26,15,19,4,22,-18
26,15,20,13,34,-21
26,15,21,13,14,-1
26,15,22,8,13,-5
26,15,23,10,10,0
26,15,24,6,15,-9
26,15,25,11,23,-12
26,15,26,11,16,-5
26,15,27,12,8,4
26,15,28,12,14,-2
26,15,29,17,19,-2
26,15,30,15,17,-2
26,15,31,7,18,-11
26,15,32,6,9,-3
26,15,33,16,18,-2
26,15,34,15,18,-3
26,15,35,6,28,-22
26,15,36,13,13,0
26,15,37,8,25,-17
26,15,38,10,18,-8
26,15,39,4,24,-20
26,15,40,16,16,0
26,15,41,11,16,-5
26,15,42,15,15,0
26,15,43,22,18,4
26,15,44,21,18,3
26,15,45,11,12,-1
26,15,46,13,18,-5
26,15,47,9,11,-2
26,15,48,26,29,-3
26,15,49,13,25,-12
26,15,50,14,6,8
26,15,51,8,23,-15
26,15,52,4,7,-3
26,15,53,10,15,-5
26,15,54,12,32,-20
26,15,55,8,24,-16
26,15,56,4,17,-13
26,15,57,19,15,4
26,15,58,3,4,-1
26,15,59,2,23,-21
26,15,60,9,12,-3
26,15,61,15,28,-13
26,15,62,18,19,-1
26,15,63,7,12,-5
26,15,64,19,37,-18
26,15,65,11,14,-3
26,15,66,12,25,-13
26,15,67,15,27,-12
26,15,68,10,17,-7
26,15,69,3,8,-5
26,15,70,22,25,-3
26,15,71,18,19,-1
26,15,72,16,14,2
26,15,73,8,14,-6
26,15,74,15,24,-9
26,15,75,10,19,-9
26,15,76,12,28,-16
26,15,77,8,12,-4
26,15,78,19,15,4
26,15,79,17,18,-1
26,15,80,7,18,-11
26,15,81,11,20,-9
26,15,82,13,13,0
26,15,83,14,17,-3
26,15,84,15,17,-2
26,15,85,8,21,-13
26,15,86,12,18,-6
26,15,87,16,14,2
26,15,88,13,14,-1
26,15,89,21,10,11
26,15,90,17,12,5
26,15,91,8,12,-4
26,15,92,10,16,-6
26,15,93,4,34,-30
26,15,94,3,10,-7
26,15,95,25,14,11
26,15,96,13,19,-6
26,15,97,7,15,-8
26,15,98,14,22,-8
26,15,99,11,9,2
26,15,100,19,16,3
26,15,101,15,25,-10
26,15,102,14,16,-2
26,15,103,2,5,-3
26,15,104,19,20,-1
26,15,105,15,18,-3
26,15,106,21,9,12
26,15,107,13,8,5
26,15,108,11,22,-11
26,15,109,22,22,0
26,15,110,13,18,-5
26,15,111,11,28,-17
26,15,112,10,30,-20
26,15,113,5,15,-10
26,15,114,8,11,-3
26,15,115,4,8,-4
26,15,116,17,18,-1
26,15,117,4,14,-10
26,15,118,8,22,-14
26,15,119,18,18,0
26,15,120,6,21,-15
26,15,121,7,22,-15
26,15,122,7,24,-17
26,15,123,15,9,6
26,15,124,16,17,-1
26,15,125,12,17,-5
26,15,126,9,13,-4
26,15,127,12,22,-10
26,15,128,14,19,-5
26,15,129,8,7,1
26,15,130,11,20,-9
26,15,131,11,32,-21
26,15,132,10,20,-10
26,15,133,19,15,4
26,15,134,16,26,-10
26,15,135,4,28,-24
26,15,136,19,22,-3
26,15,137,15,23,-8
26,15,138,16,15,1
26,15,139,13,18,-5
26,15,140,9,19,-10
26,15,141,12,21,-9
26,15,142,19,18,1
26,15,143,9,23,-14
26,15,144,16,17,-1
26,15,145,9,15,-6
26,15,146,11,27,-16
26,15,147,4,11,-7
26,15,148,15,25,-10
26,15,149,16,23,-7
26,15,150,12,10,2
26,15,151,14,23,-9
26,15,152,13,20,-7
26,15,153,11,28,-17
26,15,154,14,16,-2
26,15,155,9,17,-8
26,15,156,9,9,0
26,15,157,16,22,-6
26,15,158,14,18,-4
26,15,159,13,15,-2
26,15,160,8,22,-14
26,15,161,18,16,2
26,15,162,11,9,2
26,15,163,16,23,-7
26,15,164,30,26,4
26,15,165,9,20,-11
26,15,166,5,5,0
26,15,167,8,14,-6
26,15,168,10,22,-12
26,15,169,11,28,-17
26,15,170,3,23,-20
26,15,171,11,8,3
26,15,172,11,20,-9
26,15,173,12,19,-7
26,15,174,12,9,3
26,15,175,11,20,-9
26,15,176,12,43,-31
26,15,177,5,6,-1
26,15,178,5,15,-10
26,15,179,10,14,-4
26,15,180,8,13,-5
26,15,181,5,10,-5
26,15,182,11,14,-3
26,15,183,13,11,2
26,15,184,8,10,-2
26,15,185,12,17,-5
26,15,186,6,21,-15
26,15,187,10,24,-14
26,15,188,17,17,0
26,15,189,16,24,-8
26,15,190,17,12,5
26,15,191,19,21,-2
26,15,192,15,13,2
26,15,193,17,21,-4
26,15,194,14,23,-9
26,15,195,8,20,-12
26,15,196,10,28,-18
26,15,197,17,9,8
26,15,198,11,26,-15
26,15,199,9,10,-1
26,15,200,20,25,-5
26,15,201,11,9,2
26,15,202,16,34,-18
26,15,203,9,20,-11
26,15,204,18,16,2
26,15,205,15,9,6
26,15,206,11,18,-7
26,15,207,9,19,-10
26,15,208,15,26,-11
26,15,209,7,16,-9
26,15,210,15,30,-15
26,15,211,8,19,-11
26,15,212,16,26,-10
26,15,213,13,10,3
26,15,214,7,16,-9
26,15,215,8,17,-9
26,15,216,19,14,5
26,15,217,5,14,-9
26,15,218,8,16,-8
26,15,219,14,16,-2
26,15,220,12,19,-7
26,15,221,11,22,-11
26,15,222,17,15,2
26,15,223,10,19,-9
26,15,224,11,20,-9
26,15,225,8,6,2
26,15,226,15,16,-1
26,15,227,17,31,-14
26,15,228,11,17,-6
26,15,229,14,26,-12
26,15,230,11,26,-15
26,15,231,3,10,-7
26,15,232,9,8,1
26,15,233,12,21,-9
26,15,234,10,23,-13
26,15,235,17,9,8
26,15,236,11,12,-1
26,15,237,20,20,0
26,15,238,15,16,-1
26,15,239,9,12,-3
26,15,240,9,27,-18
26,15,241,12,18,-6
26,15,242,14,16,-2
26,15,243,6,21,-15
26,15,244,21,29,-8
26,15,245,11,15,-4
26,15,246,14,9,5
26,15,247,6,28,-22
26,15,248,10,18,-8
26,15,249,13,36,-23
26,15,250,5,17,-12
26,15,251,11,20,-9
26,15,252,12,32,-20
26,15,253,23,19,4
26,15,254,15,16,-1
26,15,255,15,20,-5
26,15,256,13,19,-6
26,15,257,17,7,10
26,15,258,8,10,-2
26,15,259,12,24,-12
26,15,260,4,22,-18
26,15,261,14,21,-7
26,15,262,4,19,-15
26,15,263,9,37,-28
26,15,264,9,19,-10
26,15,265,14,12,2
26,15,266,5,14,-9
26,15,267,9,21,-12
26,15,268,5,25,-20
26,15,269,20,23,-3
26,15,270,9,12,-3
26,15,271,5,15,-10
26,15,272,13,19,-6
26,15,273,13,17,-4
26,15,274,13,17,-4
26,15,275,15,10,5
26,15,276,16,25,-9
26,15,277,7,10,-3
26,15,278,5,8,-3
26,15,279,17,14,3
26,15,280,28,24,4
26,15,281,14,22,-8
26,15,282,13,17,-4
26,15,283,8,17,-9
26,15,284,23,16,7
26,15,285,8,11,-3
26,15,286,8,20,-12
26,15,287,10,27,-17
26,15,288,15,40,-25
26,15,289,14,23,-9
26,15,290,10,30,-20
26,15,291,12,17,-5
26,15,292,15,18,-3
26,15,293,17,20,-3
26,15,294,14,14,0
26,15,295,11,17,-6
26,15,296,13,9,4
26,15,297,18,23,-5
26,15,298,12,27,-15
26,15,299,8,19,-11
26,16,0,8,31,-23
26,16,1,9,9,0
26,16,2,10,15,-5
26,16,3,9,7,2
26,16,4,5,17,-12
26,16,5,12,15,-3
26,16,6,20,15,5
26,16,7,7,14,-7
26,16,8,8,21,-13
26,16,9,20,35,-15
26,16,10,4,10,-6
26,16,11,12,9,3
26,16,12,9,27,-18
26,16,13,1,11,-10
26,16,14,13,18,-5
26,16,15,34,13,21
26,16,16,9,9,0
26,16,17,8,19,-11
26,16,18,7,14,-7
26,16,19,15,19,-4
26,16,20,11,11,0
26,16,21,5,9,-4
26,16,22,12,17,-5
26,16,23,7,12,-5
26,16,24,14,18,-4
26,16,25,5,15,-10
26,16,26,14,13,1
26,16,27,19,32,-13
26,16,28,9,16,-7
26,16,29,12,19,-7
26,16,30,10,22,-12
26,16,31,12,17,-5
26,16,32,11,18,-7
26,16,33,8,19,-11
26,16,34,23,18,5
26,16,35,19,24,-5
26,16,36,7,10,-3
26,16,37,9,24,-15
26,16,38,12,13,-1
26,16,39,11,21,-10
26,16,40,15,18,-3
26,16,41,13,27,-14
26,16,42,5,6,-1
26,16,43,2,11,-9
26,16,44,15,13,2
26,16,45,9,17,-8
26,16,46,9,23,-14
26,16,47,6,15,-9
26,16,48,17,17,0
26,16,49,11,14,-3
26,16,50,13,14,-1
26,16,51,11,21,-10
26,16,52,6,16,-10
26,16,53,21,18,3
26,16,54,14,24,-10
26,16,55,17,15,2
26,16,56,24,21,3
26,16,57,17,9,8
26,16,58,26,17,9
26,16,59,11,9,2
26,16,60,13,15,-2
26,16,61,17,20,-3
26,16,62,7,3,4
26,16,63,8,10,-2
26,16,64,8,4,4
26,16,65,14,25,-11
26,16,66,21,20,1
26,16,67,7,11,-4
26,16,68,11,10,1
26,16,69,9,11,-2
26,16,70,11,17,-6
26,16,71,10,10,0
26,16,72,21,31,-10
26,16,73,18,19,-1
26,16,74,6,20,-14
26,16,75,15,27,-12
26,16,76,20,18,2
26,16,77,19,16,3
26,16,78,13,19,-6
26,16,79,9,14,-5
26,16,80,8,18,-10
26,16,81,11,16,-5
26,16,82,19,21,-2
26,16,83,10,24,-14
26,16,84,15,23,-8
26,16,85,6,19,-13
26,16,86,14,29,-15
26,16,87,13,13,0
26,16,88,12,16,-4
26,16,89,9,20,-11
26,16,90,12,8,4
26,16,91,19,15,4
26,16,92,20,13,7
26,16,93,11,7,4
26,16,94,14,16,-2
26,16,95,11,10,1
26,16,96,8,11,-3
26,16,97,17,19,-2
26,16,98,8,45,-37
26,16,99,15,15,0
26,16,100,12,30,-18
26,16,101,5,24,-19
26,16,102,31,16,15
26,16,103,13,29,-16
26,16,104,9,19,-10
26,16,105,9,5,4
26,16,106,17,22,-5
26,16,107,16,14,2
26,16,108,16,20,-4
26,16,109,11,11,0
26,16,110,10,15,-5
26,16,111,15,16,-1
26,16,112,4,20,-16
26,16,113,13,15,-2
26,16,114,12,10,2
26,16,115,15,24,-9
26,16,116,10,12,-2
26,16,117,17,39,-22
26,16,118,15,35,-20
26,16,119,11,15,-4
26,16,120,9,14,-5
26,16,121,15,25,-10
26,16,122,16,11,5
26,16,123,6,17,-11
26,16,124,13,18,-5
26,16,125,11,13,-2
26,16,126,9,23,-14
26,16,127,9,7,2
26,16,128,15,10,5
26,16,129,12,17,-5
26,16,130,6,12,-6
26,16,131,16,24,-8
26,16,132,9,19,-10
26,16,133,11,11,0
26,16,134,11,17,-6
26,16,135,7,15,-8
26,16,136,13,7,6
26,16,137,14,28,-14
26,16,138,16,18,-2
26,16,139,13,8,5
26,16,140,15,12,3
26,16,141,14,19,-5
26,16,142,13,20,-7
26,16,143,10,16,-6
26,16,144,8,13,-5
26,16,145,2,8,-6
26,16,146,9,25,-16
26,16,147,11,8,3
26,16,148,16,22,-6
26,16,149,13,17,-4
26,16,150,9,9,0
26,16,151,16,19,-3
26,16,152,10,21,-11
26,16,153,10,6,4
26,16,154,4,14,-10
26,16,155,17,13,4
26,16,156,11,18,-7
26,16,157,10,8,2
26,16,158,10,19,-9
26,16,159,15,7,8
26,16,160,10,13,-3
26,16,161,5,18,-13
26,16,162,11,15,-4
26,16,163,13,20,-7
26,16,164,13,13,0
26,16,165,9,17,-8
26,16,166,14,18,-4
26,16,167,9,18,-9
26,16,168,14,28,-14
26,16,169,12,17,-5
26,16,170,7,18,-11
26,16,171,6,12,-6
26,16,172,6,29,-23
26,16,173,9,8,1
26,16,174,12,17,-5
26,16,175,21,13,8
26,16,176,15,25,-10
26,16,177,11,18,-7
26,16,178,2,19,-17
26,16,179,8,20,-12
26,16,180,13,21,-8
26,16,181,23,9,14
26,16,182,2,13,-11
26,16,183,17,23,-6
26,16,184,7,18,-11
26,16,185,20,13,7
26,16,186,20,37,-17
26,16,187,10,16,-6
26,16,188,24,25,-1
26,16,189,13,4,9
26,16,190,12,17,-5
26,16,191,13,8,5
26,16,192,8,26,-18
26,16,193,16,18,-2
26,16,194,6,15,-9
26,16,195,15,18,-3
26,16,196,20,15,5
26,16,197,16,12,4
26,16,198,10,17,-7
26,16,199,15,24,-9
26,16,200,9,10,-1
26,16,201,13,16,-3
26,16,202,11,5,6
26,16,203,8,16,-8
26,16,204,4,5,-1
26,16,205,9,28,-19
26,16,206,19,23,-4
26,16,207,17,24,-7
26,16,208,9,12,-3
26,16,209,6,18,-12
26,16,210,13,20,-7
26,16,211,15,17,-2
26,16,212,12,7,5
26,16,213,10,12,-2
26,16,214,15,21,-6
26,16,215,10,23,-13
26,16,216,13,17,-4
26,16,217,13,25,-12
26,16,218,10,25,-15
26,16,219,15,15,0
26,16,220,9,15,-6
26,16,221,15,25,-10
26,16,222,4,26,-22
26,16,223,18,15,3
26,16,224,22,32,-10
26,16,225,10,14,-4
26,16,226,14,20,-6
26,16,227,11,9,2
26,16,228,19,14,5
26,16,229,3,4,-1
26,16,230,17,31,-14
26,16,231,14,20,-6
26,16,232,10,18,-8
26,16,233,13,12,1
26,16,234,13,20,-7
26,16,235,17,16,1
26,16,236,19,18,1
26,16,237,12,19,-7
26,16,238,14,24,-10
26,16,239,25,23,2
26,16,240,9,14,-5
26,16,241,13,14,-1
26,16,242,12,4,8
26,16,243,4,20,-16
26,16,244,18,20,-2
26,16,245,11,19,-8
26,16,246,13,6,7
26,16,247,11,18,-7
26,16,248,11,15,-4
26,16,249,11,18,-7
26,16,250,13,14,-1
26,16,251,17,26,-9
26,16,252,10,11,-1
26,16,253,13,13,0
26,16,254,13,13,0
26,16,255,6,5,1
26,16,256,24,32,-8
26,16,257,11,18,-7
26,16,258,10,16,-6
26,16,259,9,11,-2
26,16,260,16,17,-1
26,16,261,12,20,-8
26,16,262,5,8,-3
26,16,263,16,16,0
26,16,264,7,18,-11
26,16,265,5,16,-11
26,16,266,16,16,0
26,16,267,5,9,-4
26,16,268,11,29,-18
26,16,269,7,10,-3
26,16,270,18,24,-6
26,16,271,21,15,6
26,16,272,5,23,-18
26,16,273,10,9,1
26,16,274,11,23,-12
26,16,275,3,5,-2
26,16,276,5,17,-12
26,16,277,13,27,-14
26,16,278,9,12,-3
26,16,279,6,7,-1
26,16,280,14,13,1
26,16,281,14,22,-8
26,16,282,6,11,-5
26,16,283,7,21,-14
26,16,284,14,15,-1
26,16,285,19,17,2
26,16,286,15,14,1
26,16,287,10,12,-2
26,16,288,3,13,-10
26,16,289,11,15,-4
26,16,290,10,22,-12
26,16,291,11,11,0
26,16,292,15,18,-3
26,16,293,15,22,-7
26,16,294,9,10,-1
26,16,295,9,12,-3
26,16,296,6,23,-17
26,16,297,13,23,-10
26,16,298,7,17,-10
26,16,299,8,5,3
26,17,0,11,24,-13
26,17,1,14,20,-6
26,17,2,4,3,1
26,17,3,13,18,-5
26,17,4,6,9,-3
26,17,5,6,16,-10
26,17,6,10,18,-8
26,17,7,11,15,-4
26,17,8,9,11,-2
26,17,9,5,14,-9
26,17,10,7,14,-7
26,17,11,15,16,-1
26,17,12,11,22,-11
26,17,13,15,21,-6
26,17,14,13,28,-15
26,17,15,8,15,-7
26,17,16,15,11,4
26,17,17,14,14,0
26,17,18,17,16,1
26,17,19,6,19,-13
26,17,20,24,16,8
26,17,21,8,23,-15
26,17,22,24,20,4
26,17,23,14,22,-8
26,17,24,9,7,2
26,17,25,16,26,-10
26,17,26,6,25,-19
26,17,27,7,6,1
26,17,28,16,23,-7
26,17,29,8,16,-8
26,17,30,11,16,-5
26,17,31,15,22,-7
26,17,32,7,10,-3
26,17,33,7,18,-11
26,17,34,21,21,0
26,17,35,3,7,-4
26,17,36,7,19,-12
26,17,37,16,15,1
26,17,38,10,13,-3
26,17,39,27,18,9
26,17,40,11,15,-4
26,17,41,9,14,-5
26,17,42,13,20,-7
26,17,43,5,17,-12
26,17,44,22,24,-2
26,17,45,8,22,-14
26,17,46,11,30,-19
26,17,47,8,2,6
26,17,48,3,10,-7
26,17,49,5,20,-15
26,17,50,7,8,-1
26,17,51,15,13,2
26,17,52,7,14,-7
26,17,53,11,15,-4
26,17,54,22,11,11
26,17,55,14,14,0
26,17,56,10,14,-4
26,17,57,8,13,-5
26,17,58,11,10,1
26,17,59,13,14,-1
26,17,60,12,11,1
26,17,61,10,10,0
26,17,62,12,14,-2
26,17,63,15,13,2
26,17,64,22,19,3
26,17,65,5,22,-17
26,17,66,5,25,-20
26,17,67,4,11,-7
26,17,68,9,13,-4
26,17,69,10,19,-9
26,17,70,10,20,-10
26,17,71,8,14,-6
26,17,72,19,30,-11
26,17,73,4,9,-5
26,17,74,10,25,-15
26,17,75,17,17,0
26,17,76,10,19,-9
26,17,77,6,10,-4
26,17,78,13,23,-10
26,17,79,15,18,-3
26,17,80,18,16,2
26,17,81,13,19,-6
26,17,82,11,22,-11
26,17,83,9,12,-3
26,17,84,17,24,-7
26,17,85,12,25,-13
26,17,86,13,22,-9
26,17,87,11,24,-13
26,17,88,7,6,1
26,17,89,25,16,9
26,17,90,10,23,-13
26,17,91,6,17,-11
26,17,92,5,15,-10
26,17,93,4,18,-14
26,17,94,18,12,6
26,17,95,13,18,-5
26,17,96,15,19,-4
26,17,97,12,18,-6
26,17,98,11,23,-12
26,17,99,14,9,5
26,17,100,10,16,-6
26,17,101,21,27,-6
26,17,102,6,13,-7
26,17,103,14,12,2
26,17,104,12,10,2
26,17,105,18,9,9
26,17,106,10,13,-3
26,17,107,10,11,-1
26,17,108,11,9,2
26,17,109,13,16,-3
26,17,110,5,20,-15
26,17,111,3,12,-9
26,17,112,15,13,2
26,17,113,18,30,-12
26,17,114,10,8,2
26,17,115,5,9,-4
26,17,116,1,17,-16
26,17,117,6,7,-1
26,17,118,8,23,-15
26,17,119,15,14,1
26,17,120,1,17,-16
26,17,121,22,19,3
26,17,122,12,19,-7
26,17,123,14,13,1
26,17,124,16,22,-6
26,17,125,5,12,-7
26,17,126,15,15,0
26,17,127,19,9,10
26,17,128,6,20,-14
26,17,129,15,11,4
26,17,130,15,24,-9
26,17,131,12,13,-1
26,17,132,11,23,-12
26,17,133,12,6,6
26,17,134,8,13,-5
26,17,135,12,17,-5
26,17,136,11,21,-10
26,17,137,10,28,-18
26,17,138,16,16,0
26,17,139,2,7,-5
26,17,140,7,14,-7
26,17,141,3,8,-5
26,17,142,12,15,-3
26,17,143,6,23,-17
26,17,144,7,7,0
26,17,145,5,7,-2
26,17,146,14,11,3
26,17,147,9,18,-9
26,17,148,13,11,2
26,17,149,19,13,6
26,17,150,16,16,0
26,17,151,15,19,-4
26,17,152,22,18,4
26,17,153,11,29,-18
26,17,154,16,19,-3
26,17,155,9,10,-1
26,17,156,25,25,0
26,17,157,10,21,-11
26,17,158,25,17,8
26,17,159,7,18,-11
26,17,160,8,16,-8
26,17,161,17,12,5
26,17,162,20,22,-2
26,17,163,10,7,3
26,17,164,15,13,2
26,17,165,9,15,-6
26,17,166,12,14,-2
26,17,167,19,23,-4
26,17,168,12,27,-15
26,17,169,10,21,-11
26,17,170,15,12,3
26,17,171,10,27,-17
26,17,172,12,16,-4
26,17,173,11,12,-1
26,17,174,17,20,-3
26,17,175,17,12,5
26,17,176,18,16,2
26,17,177,18,18,0
26,17,178,21,10,11
26,17,179,15,18,-3
26,17,180,10,14,-4
26,17,181,15,18,-3
26,17,182,12,10,2
26,17,183,9,10,-1
26,17,184,7,14,-7
26,17,185,7,14,-7
26,17,186,15,23,-8
26,17,187,9,21,-12
26,17,188,7,16,-9
26,17,189,8,12,-4
26,17,190,11,13,-2
26,17,191,17,28,-11
26,17,192,14,16,-2
26,17,193,8,16,-8
26,17,194,15,14,1
26,17,195,5,10,-5
26,17,196,10,12,-2
26,17,197,16,11,5
26,17,198,17,16,1
26,17,199,8,16,-8
26,17,200,8,16,-8
26,17,201,12,17,-5
26,17,202,15,19,-4
26,17,203,11,5,6
26,17,204,9,14,-5
26,17,205,8,25,-17
26,17,206,19,16,3
26,17,207,7,7,0
26,17,208,3,21,-18
26,17,209,4,27,-23
26,17,210,13,12,1
26,17,211,12,12,0
26,17,212,18,13,5
26,17,213,3,8,-5
26,17,214,17,14,3
26,17,215,8,22,-14
26,17,216,16,22,-6
26,17,217,11,11,0
26,17,218,7,16,-9
26,17,219,10,13,-3
26,17,220,14,16,-2
26,17,221,11,15,-4
26,17,222,6,15,-9
26,17,223,8,17,-9
26,17,224,19,32,-13
26,17,225,20,13,7
26,17,226,8,11,-3
26,17,227,16,31,-15
26,17,228,13,27,-14
26,17,229,10,12,-2
26,17,230,19,19,0
26,17,231,15,19,-4
26,17,232,22,12,10
26,17,233,9,14,-5
26,17,234,19,17,2
26,17,235,3,14,-11
26,17,236,12,13,-1
26,17,237,15,23,-8
26,17,238,8,29,-21
26,17,239,10,14,-4
26,17,240,6,18,-12
26,17,241,11,13,-2
26,17,242,29,45,-16
26,17,243,12,16,-4
26,17,244,19,21,-2
26,17,245,7,11,-4
26,17,246,12,9,3
26,17,247,18,18,0
26,17,248,5,11,-6
26,17,249,20,21,-1
26,17,250,9,18,-9
26,17,251,12,26,-14
26,17,252,10,12,-2
26,17,253,4,14,-10
26,17,254,9,24,-15
26,17,255,12,19,-7
26,17,256,17,20,-3
26,17,257,14,15,-1
26,17,258,12,12,0
26,17,259,11,11,0
26,17,260,15,12,3
26,17,261,10,34,-24
26,17,262,8,20,-12
26,17,263,10,15,-5
26,17,264,20,11,9
26,17,265,6,18,-12
26,17,266,15,14,1
26,17,267,7,9,-2
26,17,268,12,15,-3
26,17,269,15,26,-11
26,17,270,22,23,-1
26,17,271,12,16,-4
26,17,272,14,23,-9
26,17,273,17,32,-15
26,17,274,13,15,-2
26,17,275,10,9,1
26,17,276,9,16,-7
26,17,277,18,28,-10
26,17,278,10,17,-7
26,17,279,12,18,-6
26,17,280,8,16,-8
26,17,281,17,33,-16
26,17,282,18,13,5
26,17,283,15,12,3
26,17,284,17,15,2
26,17,285,6,13,-7
26,17,286,13,18,-5
26,17,287,14,17,-3
26,17,288,16,10,6
26,17,289,8,14,-6
26,17,290,8,23,-15
26,17,291,19,12,7
26,17,292,17,15,2
26,17,293,13,14,-1
26,17,294,6,11,-5
26,17,295,13,16,-3
26,17,296,6,22,-16
26,17,297,14,22,-8
26,17,298,17,19,-2
26,17,299,7,14,-7
26,18,0,9,16,-7
26,18,1,9,20,-11
26,18,2,5,9,-4
26,18,3,14,20,-6
26,18,4,15,12,3
26,18,5,12,24,-12
26,18,6,12,17,-5
26,18,7,16,14,2
26,18,8,8,14,-6
26,18,9,6,18,-12
26,18,10,15,23,-8
26,18,11,19,18,1
26,18,12,14,8,6
26,18,13,6,24,-18
26,18,14,7,12,-5
26,18,15,18,18,0
26,18,16,8,12,-4
26,18,17,6,17,-11
26,18,18,4,14,-10
26,18,19,3,22,-19
26,18,20,20,12,8
26,18,21,19,11,8
26,18,22,15,21,-6
26,18,23,18,17,1
26,18,24,12,14,-2
26,18,25,7,10,-3
26,18,26,8,17,-9
26,18,27,7,14,-7
26,18,28,10,7,3
26,18,29,18,15,3
26,18,30,13,4,9
26,18,31,10,10,0
26,18,32,16,19,-3
26,18,33,19,16,3
26,18,34,22,22,0
26,18,35,6,15,-9
26,18,36,11,13,-2
26,18,37,10,16,-6
26,18,38,18,14,4
26,18,39,10,18,-8
26,18,40,7,13,-6
26,18,41,14,7,7
26,18,42,28,26,2
26,18,43,19,24,-5
26,18,44,12,11,1
26,18,45,18,20,-2
26,18,46,8,17,-9
26,18,47,10,30,-20
26,18,48,10,16,-6
26,18,49,14,17,-3
26,18,50,23,31,-8
26,18,51,8,15,-7
26,18,52,7,18,-11
26,18,53,11,23,-12
26,18,54,8,21,-13
26,18,55,13,20,-7
26,18,56,23,23,0
26,18,57,11,35,-24
26,18,58,13,13,0
26,18,59,8,10,-2
26,18,60,18,18,0
26,18,61,15,27,-12
26,18,62,23,23,0
26,18,63,8,6,2
26,18,64,6,12,-6
26,18,65,11,17,-6
26,18,66,4,5,-1
26,18,67,11,22,-11
26,18,68,11,16,-5
26,18,69,12,11,1
26,18,70,9,27,-18
26,18,71,5,9,-4
26,18,72,5,18,-13
26,18,73,14,12,2
26,18,74,15,18,-3
26,18,75,7,19,-12
26,18,76,7,17,-10
26,18,77,8,26,-18
26,18,78,10,14,-4
26,18,79,6,15,-9
26,18,80,5,11,-6
26,18,81,4,21,-17
26,18,82,13,14,-1
26,18,83,12,23,-11
26,18,84,17,14,3
26,18,85,16,27,-11
26,18,86,4,13,-9
26,18,87,19,22,-3
26,18,88,14,15,-1
26,18,89,10,9,1
26,18,90,5,29,-24
26,18,91,6,16,-10
26,18,92,6,9,-3
26,18,93,6,23,-17
26,18,94,7,14,-7
26,18,95,11,19,-8
26,18,96,21,25,-4
26,18,97,12,11,1
26,18,98,14,9,5
26,18,99,14,14,0
26,18,100,10,8,2
26,18,101,4,10,-6
26,18,102,13,17,-4
26,18,103,16,22,-6
26,18,104,8,15,-7
26,18,105,13,12,1
26,18,106,17,16,1
26,18,107,16,12,4
26,18,108,14,20,-6
26,18,109,15,20,-5
26,18,110,11,26,-15
26,18,111,8,6,2
26,18,112,5,23,-18
26,18,113,6,11,-5
26,18,114,14,20,-6
26,18,115,13,29,-16
26,18,116,13,24,-11
26,18,117,16,27,-11
26,18,118,12,23,-11
26,18,119,26,14,12
26,18,120,20,25,-5
26,18,121,15,15,0
26,18,122,15,13,2
26,18,123,15,22,-7
26,18,124,12,16,-4
26,18,125,22,20,2
26,18,126,16,20,-4
26,18,127,15,9,6
26,18,128,17,37,-20
26,18,129,7,10,-3
26,18,130,13,26,-13
26,18,131,18,20,-2
26,18,132,24,29,-5
26,18,133,13,9,4
26,18,134,7,10,-3
26,18,135,7,12,-5
26,18,136,7,11,-4
26,18,137,12,11,1
26,18,138,16,24,-8
26,18,139,16,10,6
26,18,140,10,14,-4
26,18,141,12,15,-3
26,18,142,27,13,14
26,18,143,1,7,-6
26,18,144,8,9,-1
26,18,145,3,9,-6
26,18,146,8,9,-1
26,18,147,20,25,-5
26,18,148,2,16,-14
26,18,149,16,23,-7
26,18,150,17,10,7
26,18,151,14,19,-5
26,18,152,21,25,-4
26,18,153,14,23,-9
26,18,154,20,22,-2
26,18,155,6,25,-19
26,18,156,12,21,-9
26,18,157,10,19,-9
26,18,158,13,9,4
26,18,159,6,5,1
26,18,160,11,14,-3
26,18,161,18,17,1
26,18,162,19,20,-1
26,18,163,13,11,2
26,18,164,8,6,2
26,18,165,8,18,-10
26,18,166,20,20,0
26,18,167,14,14,0
26,18,168,6,9,-3
26,18,169,21,15,6
26,18,170,14,21,-7
26,18,171,27,13,14
26,18,172,14,17,-3
26,18,173,16,17,-1
26,18,174,15,28,-13
26,18,175,14,18,-4
26,18,176,5,27,-22
26,18,177,12,13,-1
26,18,178,13,23,-10
26,18,179,15,18,-3
26,18,180,8,14,-6
26,18,181,15,27,-12
26,18,182,19,19,0
26,18,183,16,17,-1
26,18,184,2,12,-10
26,18,185,7,21,-14
26,18,186,5,24,-19
26,18,187,11,22,-11
26,18,188,23,14,9
26,18,189,11,27,-16
26,18,190,7,18,-11
26,18,191,10,11,-1
26,18,192,16,14,2
26,18,193,13,6,7
26,18,194,10,17,-7
26,18,195,6,6,0
26,18,196,14,15,-1
26,18,197,15,30,-15
26,18,198,8,17,-9
26,18,199,16,24,-8
26,18,200,13,15,-2
26,18,201,12,16,-4
26,18,202,6,10,-4
26,18,203,8,21,-13
26,18,204,8,14,-6
26,18,205,16,16,0
26,18,206,14,18,-4
26,18,207,10,20,-10
26,18,208,10,3,7
26,18,209,12,14,-2
26,18,210,17,28,-11
26,18,211,17,18,-1
26,18,212,10,12,-2
26,18,213,10,20,-10
26,18,214,14,13,1
26,18,215,8,22,-14
26,18,216,9,16,-7
26,18,217,13,10,3
26,18,218,12,21,-9
26,18,219,14,20,-6
26,18,220,7,12,-5
26,18,221,7,7,0
26,18,222,13,27,-14
26,18,223,9,10,-1
26,18,224,12,11,1
26,18,225,6,12,-6
26,18,226,9,18,-9
26,18,227,8,15,-7
26,18,228,16,12,4
26,18,229,10,22,-12
26,18,230,7,7,0
26,18,231,12,13,-1
26,18,232,13,15,-2
26,18,233,11,17,-6
26,18,234,18,21,-3
26,18,235,9,15,-6
26,18,236,8,20,-12
26,18,237,15,21,-6
26,18,238,9,16,-7
26,18,239,11,12,-1
26,18,240,13,12,1
26,18,241,8,16,-8
26,18,242,9,19,-10
26,18,243,15,16,-1
26,18,244,2,15,-13
26,18,245,13,18,-5
26,18,246,9,5,4
26,18,247,4,21,-17
26,18,248,15,14,1
26,18,249,4,18,-14
26,18,250,7,17,-10
26,18,251,18,22,-4
26,18,252,12,17,-5
26,18,253,10,5,5
26,18,254,7,15,-8
26,18,255,11,20,-9
26,18,256,17,12,5
26,18,257,8,16,-8
26,18,258,11,16,-5
26,18,259,16,29,-13
26,18,260,11,12,-1
26,18,261,3,11,-8
26,18,262,8,13,-5
26,18,263,24,9,15
26,18,264,11,16,-5
26,18,265,6,18,-12
26,18,266,21,24,-3
26,18,267,18,21,-3
26,18,268,12,4,8
26,18,269,8,16,-8
26,18,270,5,18,-13
26,18,271,14,10,4
26,18,272,7,11,-4
26,18,273,9,15,-6
26,18,274,18,26,-8
26,18,275,8,19,-11
26,18,276,16,17,-1
26,18,277,13,22,-9
26,18,278,10,15,-5
26,18,279,20,20,0
26,18,280,10,23,-13
26,18,281,14,14,0
26,18,282,5,4,1
26,18,283,26,25,1
26,18,284,10,21,-11
26,18,285,11,14,-3
26,18,286,21,16,5
26,18,287,10,10,0
26,18,288,14,27,-13
26,18,289,13,10,3
26,18,290,15,17,-2
26,18,291,8,11,-3
26,18,292,10,16,-6
26,18,293,14,18,-4
26,18,294,15,18,-3
26,18,295,5,20,-15
26,18,296,13,5,8
26,18,297,5,11,-6
26,18,298,10,17,-7
26,18,299,10,4,6
26,19,0,12,14,-2
26,19,1,1,20,-19
26,19,2,16,14,2
26,19,3,8,15,-7
26,19,4,6,10,-4
26,19,5,10,18,-8
26,19,6,7,12,-5
26,19,7,4,18,-14
26,19,8,29,16,13
26,19,9,7,9,-2
26,19,10,5,15,-10
26,19,11,13,11,2
26,19,12,7,19,-12
26,19,13,13,10,3
26,19,14,7,11,-4
26,19,15,10,14,-4
26,19,16,8,7,1
26,19,17,11,13,-2
26,19,18,14,17,-3
26,19,19,9,11,-2
26,19,20,9,22,-13
26,19,21,11,8,3
26,19,22,11,13,-2
26,19,23,19,14,5
26,19,24,13,14,-1
26,19,25,14,11,3
26,19,26,28,32,-4
26,19,27,9,11,-2
26,19,28,11,22,-11
26,19,29,5,21,-16
26,19,30,6,13,-7
26,19,31,7,10,-3
26,19,32,14,24,-10
26,19,33,17,18,-1
26,19,34,12,11,1
26,19,35,5,8,-3
26,19,36,19,32,-13
26,19,37,18,21,-3
26,19,38,17,12,5
26,19,39,9,15,-6
26,19,40,16,21,-5
26,19,41,16,22,-6
26,19,42,15,14,1
26,19,43,13,12,1
26,19,44,22,17,5
26,19,45,20,30,-10
26,19,46,11,26,-15
26,19,47,6,12,-6
26,19,48,15,29,-14
26,19,49,5,17,-12
26,19,50,11,18,-7
26,19,51,9,25,-16
26,19,52,13,19,-6
26,19,53,10,16,-6
26,19,54,10,14,-4
26,19,55,8,18,-10
26,19,56,5,11,-6
26,19,57,9,9,0
26,19,58,6,16,-10
26,19,59,11,7,4
26,19,60,10,10,0
26,19,61,18,8,10
26,19,62,13,15,-2
26,19,63,21,26,-5
26,19,64,8,15,-7
26,19,65,20,25,-5
26,19,66,4,13,-9
26,19,67,13,23,-10
26,19,68,15,25,-10
26,19,69,2,7,-5
26,19,70,18,17,1
26,19,71,15,14,1
26,19,72,15,12,3
26,19,73,18,18,0
26,19,74,19,11,8
26,19,75,4,14,-10
26,19,76,14,12,2
26,19,77,8,15,-7
26,19,78,17,20,-3
26,19,79,5,13,-8
26,19,80,13,27,-14
26,19,81,11,11,0
26,19,82,5,16,-11
26,19,83,8,4,4
26,19,84,12,15,-3
26,19,85,10,5,5
26,19,86,17,27,-10
26,19,87,19,21,-2
26,19,88,4,4,0
26,19,89,14,17,-3
26,19,90,10,19,-9
26,19,91,6,22,-16
26,19,92,29,26,3
26,19,93,16,11,5
26,19,94,13,15,-2
26,19,95,15,18,-3
26,19,96,12,11,1
26,19,97,20,24,-4
26,19,98,9,15,-6
26,19,99,2,9,-7
26,19,100,7,10,-3
26,19,101,7,11,-4
26,19,102,12,12,0
26,19,103,3,14,-11
26,19,104,11,10,1
26,19,105,7,14,-7
26,19,106,13,7,6
26,19,107,15,21,-6
26,19,108,8,13,-5
26,19,109,12,14,-2
26,19,110,11,25,-14
26,19,111,10,11,-1
26,19,112,9,12,-3
26,19,113,12,15,-3
26,19,114,15,12,3
26,19,115,6,15,-9
26,19,116,7,9,-2
26,19,117,16,9,7
26,19,118,32,34,-2
26,19,119,15,26,-11
26,19,120,7,8,-1
26,19,121,7,15,-8
26,19,122,7,12,-5
26,19,123,16,19,-3
26,19,124,18,18,0
26,19,125,8,19,-11
26,19,126,13,27,-14
26,19,127,5,14,-9
26,19,128,11,20,-9
26,19,129,20,18,2
26,19,130,3,11,-8
26,19,131,15,24,-9
26,19,132,16,22,-6
26,19,133,6,22,-16
26,19,134,8,22,-14
26,19,135,17,14,3
26,19,136,7,17,-10
26,19,137,13,23,-10
26,19,138,11,5,6
26,19,139,16,28,-12
26,19,140,5,12,-7
26,19,141,17,36,-19
26,19,142,6,8,-2
26,19,143,12,9,3
26,19,144,11,27,-16
26,19,145,7,10,-3
26,19,146,16,13,3
26,19,147,5,14,-9
26,19,148,8,10,-2
26,19,149,12,9,3
26,19,150,14,15,-1
26,19,151,8,16,-8
26,19,152,13,12,1
26,19,153,16,12,4
26,19,154,5,20,-15
26,19,155,25,29,-4
26,19,156,12,14,-2
26,19,157,13,18,-5
26,19,158,27,27,0
26,19,159,6,13,-7
26,19,160,16,21,-5
26,19,161,16,14,2
26,19,162,14,25,-11
26,19,163,15,11,4
26,19,164,10,15,-5
26,19,165,15,22,-7
26,19,166,29,16,13
26,19,167,9,12,-3
26,19,168,14,23,-9
26,19,169,15,17,-2
26,19,170,10,9,1
26,19,171,15,13,2
26,19,172,7,9,-2
26,19,173,4,8,-4
26,19,174,11,29,-18
26,19,175,14,22,-8
26,19,176,10,10,0
26,19,177,15,11,4
26,19,178,6,7,-1
26,19,179,11,20,-9
26,19,180,11,17,-6
26,19,181,11,13,-2
26,19,182,13,17,-4
26,19,183,10,18,-8
26,19,184,19,23,-4
26,19,185,12,15,-3
26,19,186,13,15,-2
26,19,187,9,19,-10
26,19,188,5,13,-8
26,19,189,14,12,2
26,19,190,9,11,-2
26,19,191,15,17,-2
26,19,192,17,17,0
26,19,193,17,13,4
26,19,194,20,13,7
26,19,195,19,17,2
26,19,196,11,13,-2
26,19,197,9,14,-5
26,19,198,9,9,0
26,19,199,15,14,1
26,19,200,5,8,-3
26,19,201,7,13,-6
26,19,202,14,12,2
26,19,203,13,25,-12
26,19,204,10,21,-11
26,19,205,9,6,3
26,19,206,6,12,-6
26,19,207,13,17,-4
26,19,208,11,10,1
26,19,209,7,9,-2
26,19,210,16,23,-7
26,19,211,8,8,0
26,19,212,9,22,-13
26,19,213,20,19,1
26,19,214,10,23,-13
26,19,215,13,16,-3
26,19,216,11,16,-5
26,19,217,12,6,6
26,19,218,25,12,13
26,19,219,9,23,-14
26,19,220,6,9,-3
26,19,221,11,22,-11
26,19,222,8,21,-13
26,19,223,17,20,-3
26,19,224,18,17,1
26,19,225,24,13,11
26,19,226,11,16,-5
26,19,227,16,22,-6
26,19,228,10,19,-9
26,19,229,10,14,-4
26,19,230,15,17,-2
26,19,231,6,18,-12
26,19,232,13,20,-7
26,19,233,13,8,5
26,19,234,15,22,-7
26,19,235,12,14,-2
26,19,236,16,22,-6
26,19,237,8,18,-10
26,19,238,10,14,-4
26,19,239,12,12,0
26,19,240,7,7,0
26,19,241,1,11,-10
26,19,242,19,20,-1
26,19,243,9,20,-11
26,19,244,6,17,-11
26,19,245,9,20,-11
26,19,246,6,12,-6
26,19,247,9,32,-23
26,19,248,18,13,5
26,19,249,8,12,-4
26,19,250,8,15,-7
26,19,251,8,17,-9
26,19,252,4,11,-7
26,19,253,22,17,5
26,19,254,22,7,15
26,19,255,17,17,0
26,19,256,26,13,13
26,19,257,7,16,-9
26,19,258,17,9,8
26,19,259,9,12,-3
26,19,260,11,15,-4
26,19,261,6,4,2
26,19,262,28,26,2
26,19,263,18,14,4
26,19,264,13,20,-7
26,19,265,10,17,-7
26,19,266,10,18,-8
26,19,267,17,16,1
26,19,268,12,16,-4
26,19,269,15,25,-10
26,19,270,7,41,-34
26,19,271,4,13,-9
26,19,272,15,17,-2
26,19,273,14,18,-4
26,19,274,11,3,8
26,19,275,13,33,-20
26,19,276,16,29,-13
26,19,277,11,22,-11
26,19,278,13,13,0
26,19,279,7,12,-5
26,19,280,10,16,-6
26,19,281,8,13,-5
26,19,282,10,13,-3
26,19,283,14,13,1
26,19,284,16,30,-14
26,19,285,12,14,-2
26,19,286,17,9,8
26,19,287,7,31,-24
26,19,288,12,18,-6
26,19,289,16,16,0
26,19,290,15,17,-2
26,19,291,5,7,-2
26,19,292,12,15,-3
26,19,293,10,19,-9
26,19,294,10,13,-3
26,19,295,9,22,-13
26,19,296,18,23,-5
26,19,297,11,9,2
26,19,298,17,11,6
26,19,299,14,18,-4
26,20,0,16,16,0
26,20,1,27,23,4
26,20,2,15,11,4
26,20,3,4,15,-11
26,20,4,13,19,-6
26,20,5,18,23,-5
26,20,6,10,13,-3
26,20,7,14,27,-13
26,20,8,10,30,-20
26,20,9,13,17,-4
26,20,10,10,5,5
26,20,11,16,15,1
26,20,12,11,12,-1
26,20,13,19,31,-12
26,20,14,4,15,-11
26,20,15,17,18,-1
26,20,16,14,20,-6
26,20,17,10,5,5
26,20,18,13,19,-6
26,20,19,15,25,-10
26,20,20,9,19,-10
26,20,21,11,10,1
26,20,22,24,22,2
26,20,23,4,4,0
26,20,24,9,23,-14
26,20,25,0,17,-17
26,20,26,27,27,0
26,20,27,6,10,-4
26,20,28,6,15,-9
26,20,29,11,16,-5
26,20,30,10,19,-9
26,20,31,8,7,1
26,20,32,5,23,-18
26,20,33,24,17,7
26,20,34,13,19,-6
26,20,35,17,6,11
26,20,36,6,17,-11
26,20,37,15,24,-9
26,20,38,11,20,-9
26,20,39,7,17,-10
26,20,40,23,21,2
26,20,41,10,19,-9
26,20,42,13,17,-4
26,20,43,14,19,-5
26,20,44,18,18,0
26,20,45,17,10,7
26,20,46,9,14,-5
26,20,47,8,11,-3
26,20,48,12,13,-1
26,20,49,10,19,-9
26,20,50,10,28,-18
26,20,51,21,11,10
26,20,52,15,7,8
26,20,53,19,10,9
26,20,54,11,13,-2
26,20,55,13,10,3
26,20,56,13,31,-18
26,20,57,19,16,3
26,20,58,14,18,-4
26,20,59,8,14,-6
26,20,60,13,26,-13
26,20,61,9,15,-6
26,20,62,22,26,-4
26,20,63,9,17,-8
26,20,64,8,20,-12
26,20,65,10,21,-11
26,20,66,14,9,5
26,20,67,9,20,-11
26,20,68,11,20,-9
26,20,69,15,13,2
26,20,70,14,10,4
26,20,71,8,11,-3
26,20,72,17,25,-8
26,20,73,12,13,-1
26,20,74,15,13,2
26,20,75,14,10,4
26,20,76,6,9,-3
26,20,77,9,16,-7
26,20,78,18,23,-5
26,20,79,6,6,0
26,20,80,4,6,-2
26,20,81,8,10,-2
26,20,82,13,20,-7
26,20,83,10,16,-6
26,20,84,10,6,4
26,20,85,15,22,-7
26,20,86,14,11,3
26,20,87,15,22,-7
26,20,88,16,16,0
26,20,89,11,10,1
26,20,90,21,14,7
26,20,91,24,17,7
26,20,92,19,6,13
26,20,93,10,19,-9
26,20,94,7,25,-18
26,20,95,12,10,2
26,20,96,9,4,5
26,20,97,8,17,-9
26,20,98,16,19,-3
26,20,99,15,20,-5
26,20,100,8,14,-6
26,20,101,21,10,11
26,20,102,7,13,-6
26,20,103,11,15,-4
26,20,104,13,16,-3
26,20,105,18,19,-1
26,20,106,17,16,1
26,20,107,12,11,1
26,20,108,13,11,2
26,20,109,9,8,1
26,20,110,12,24,-12
26,20,111,7,10,-3
26,20,112,14,23,-9
26,20,113,10,18,-8
26,20,114,12,11,1
26,20,115,8,15,-7
26,20,116,8,11,-3
26,20,117,16,12,4
26,20,118,12,20,-8
26,20,119,12,17,-5
26,20,120,20,23,-3
26,20,121,13,16,-3
26,20,122,10,16,-6
26,20,123,0,12,-12
26,20,124,10,9,1
26,20,125,14,24,-10
26,20,126,11,8,3
26,20,127,9,10,-1
26,20,128,15,13,2
26,20,129,8,10,-2
26,20,130,19,22,-3
26,20,131,20,26,-6
26,20,132,8,12,-4
26,20,133,13,18,-5
26,20,134,14,21,-7
26,20,135,11,20,-9
26,20,136,17,17,0
26,20,137,5,11,-6
26,20,138,17,21,-4
26,20,139,7,17,-10
26,20,140,7,15,-8
26,20,141,12,10,2
26,20,142,20,15,5
26,20,143,10,23,-13
26,20,144,13,19,-6
26,20,145,14,8,6
26,20,146,9,14,-5
26,20,147,11,27,-16
26,20,148,12,9,3
26,20,149,13,12,1
26,20,150,16,12,4
26,20,151,12,15,-3
26,20,152,15,20,-5
26,20,153,20,23,-3
26,20,154,14,27,-13
26,20,155,6,8,-2
26,20,156,5,15,-10
26,20,157,11,16,-5
26,20,158,7,16,-9
26,20,159,12,22,-10
26,20,160,14,16,-2
26,20,161,6,22,-16
26,20,162,10,7,3
26,20,163,18,16,2
26,20,164,10,14,-4
26,20,165,13,17,-4
26,20,166,12,16,-4
26,20,167,10,24,-14
26,20,168,6,4,2
26,20,169,29,22,7
26,20,170,9,15,-6
26,20,171,17,20,-3
26,20,172,7,9,-2
26,20,173,9,12,-3
26,20,174,14,13,1
26,20,175,10,11,-1
26,20,176,27,19,8
26,20,177,14,17,-3
26,20,178,17,18,-1
26,20,179,7,19,-12
26,20,180,16,10,6
26,20,181,13,7,6
26,20,182,21,20,1
26,20,183,15,13,2
26,20,184,12,16,-4
26,20,185,13,24,-11
26,20,186,16,19,-3
26,20,187,12,23,-11
26,20,188,21,19,2
26,20,189,22,11,11
26,20,190,8,17,-9
26,20,191,6,13,-7
26,20,192,16,28,-12
26,20,193,23,22,1
26,20,194,7,20,-13
26,20,195,21,27,-6
26,20,196,15,14,1
26,20,197,12,12,0
26,20,198,13,16,-3
26,20,199,7,11,-4
26,20,200,8,24,-16
26,20,201,7,21,-14
26,20,202,12,10,2
26,20,203,7,11,-4
26,20,204,16,24,-8
26,20,205,14,16,-2
26,20,206,4,20,-16
26,20,207,4,8,-4
26,20,208,22,24,-2
26,20,209,9,32,-23
26,20,210,3,12,-9
26,20,211,13,23,-10
26,20,212,12,12,0
26,20,213,10,14,-4
26,20,214,7,12,-5
26,20,215,7,7,0
26,20,216,7,11,-4
26,20,217,6,12,-6
26,20,218,12,24,-12
26,20,219,16,19,-3
26,20,220,19,17,2
26,20,221,10,14,-4
26,20,222,20,10,10
26,20,223,17,23,-6
26,20,224,14,24,-10
26,20,225,6,11,-5
26,20,226,8,13,-5
26,20,227,1,4,-3
26,20,228,19,15,4
26,20,229,7,15,-8
26,20,230,4,21,-17
26,20,231,10,9,1
26,20,232,18,24,-6
26,20,233,13,19,-6
26,20,234,9,26,-17
26,20,235,8,14,-6
26,20,236,13,18,-5
26,20,237,23,20,3
26,20,238,11,12,-1
26,20,239,14,10,4
26,20,240,13,11,2
26,20,241,12,2,10
26,20,242,19,22,-3
26,20,243,24,23,1
26,20,244,17,15,2
26,20,245,20,11,9
26,20,246,10,10,0
26,20,247,18,20,-2
26,20,248,11,14,-3
26,20,249,4,7,-3
26,20,250,11,15,-4
26,20,251,10,21,-11
26,20,252,18,25,-7
26,20,253,8,8,0
26,20,254,9,12,-3
26,20,255,20,25,-5
26,20,256,12,20,-8
26,20,257,5,18,-13
26,20,258,11,18,-7
26,20,259,22,17,5
26,20,260,23,14,9
26,20,261,8,10,-2
26,20,262,10,20,-10
26,20,263,13,14,-1
26,20,264,15,12,3
26,20,265,8,15,-7
26,20,266,13,13,0
26,20,267,17,21,-4
26,20,268,9,19,-10
26,20,269,5,8,-3
26,20,270,7,14,-7
26,20,271,13,12,1
26,20,272,12,6,6
26,20,273,19,10,9
26,20,274,16,11,5
26,20,275,12,8,4
26,20,276,9,11,-2
26,20,277,7,21,-14
26,20,278,17,18,-1
26,20,279,12,19,-7
26,20,280,21,10,11
26,20,281,8,13,-5
26,20,282,16,21,-5
26,20,283,14,20,-6
26,20,284,14,25,-11
26,20,285,9,15,-6
26,20,286,17,22,-5
26,20,287,14,19,-5
26,20,288,8,11,-3
26,20,289,10,16,-6
26,20,290,6,16,-10
26,20,291,10,16,-6
26,20,292,8,23,-15
26,20,293,7,19,-12
26,20,294,18,12,6
26,20,295,10,12,-2
26,20,296,20,7,13
26,20,297,15,18,-3
26,20,298,8,12,-4
26,20,299,8,13,-5
26,21,0,17,17,0
26,21,1,11,19,-8
26,21,2,12,13,-1
26,21,3,7,23,-16
26,21,4,9,10,-1
26,21,5,23,26,-3
26,21,6,17,26,-9
26,21,7,15,8,7
26,21,8,8,17,-9
26,21,9,16,12,4
26,21,10,13,27,-14
26,21,11,6,14,-8
26,21,12,7,22,-15
26,21,13,16,17,-1
26,21,14,13,24,-11
26,21,15,13,20,-7
26,21,16,20,31,-11
26,21,17,17,22,-5
26,21,18,8,19,-11
26,21,19,4,9,-5
26,21,20,14,8,6
26,21,21,13,14,-1
26,21,22,8,9,-1
26,21,23,7,9,-2
26,21,24,19,14,5
26,21,25,15,10,5
26,21,26,10,25,-15
26,21,27,14,22,-8
26,21,28,3,8,-5
26,21,29,14,10,4
26,21,30,7,16,-9
26,21,31,5,13,-8
26,21,32,15,24,-9
26,21,33,24,27,-3
26,21,34,19,13,6
26,21,35,12,7,5
26,21,36,12,9,3
26,21,37,7,17,-10
26,21,38,7,14,-7
26,21,39,14,20,-6
26,21,40,15,21,-6
26,21,41,9,9,0
26,21,42,19,26,-7
26,21,43,25,13,12
26,21,44,17,21,-4
26,21,45,17,19,-2
26,21,46,13,24,-11
26,21,47,15,11,4
26,21,48,10,14,-4
26,21,49,14,24,-10
26,21,50,15,15,0
26,21,51,10,13,-3
26,21,52,10,14,-4
26,21,53,13,19,-6
26,21,54,15,17,-2
26,21,55,11,18,-7
26,21,56,12,10,2
26,21,57,7,13,-6
26,21,58,9,20,-11
26,21,59,10,14,-4
26,21,60,33,27,6
26,21,61,9,12,-3
26,21,62,14,14,0
26,21,63,14,23,-9
26,21,64,14,10,4
26,21,65,6,14,-8
26,21,66,14,11,3
26,21,67,11,11,0
26,21,68,14,15,-1
26,21,69,11,11,0
26,21,70,16,27,-11
26,21,71,15,19,-4
26,21,72,18,11,7
26,21,73,12,12,0
26,21,74,15,34,-19
26,21,75,9,17,-8
26,21,76,13,9,4
26,21,77,17,15,2
26,21,78,9,7,2
26,21,79,22,13,9
26,21,80,9,15,-6
26,21,81,10,8,2
26,21,82,13,25,-12
26,21,83,5,31,-26
26,21,84,14,11,3
26,21,85,14,15,-1
26,21,86,11,12,-1
26,21,87,10,10,0
26,21,88,15,15,0
26,21,89,28,14,14
26,21,90,5,14,-9
26,21,91,14,10,4
26,21,92,9,18,-9
26,21,93,15,16,-1
26,21,94,12,17,-5
26,21,95,20,23,-3
26,21,96,13,21,-8
26,21,97,11,12,-1
26,21,98,16,18,-2
26,21,99,10,7,3
26,21,100,22,23,-1
26,21,101,5,9,-4
26,21,102,10,23,-13
26,21,103,22,15,7
26,21,104,16,13,3
26,21,105,14,19,-5
26,21,106,15,17,-2
26,21,107,20,24,-4
26,21,108,10,6,4
26,21,109,10,19,-9
26,21,110,13,20,-7
26,21,111,6,6,0
26,21,112,17,24,-7
26,21,113,15,7,8
26,21,114,16,12,4
26,21,115,12,13,-1
26,21,116,13,6,7
26,21,117,8,11,-3
26,21,118,11,13,-2
26,21,119,10,12,-2
26,21,120,8,15,-7
26,21,121,20,8,12
26,21,122,2,16,-14
26,21,123,14,16,-2
26,21,124,10,6,4
26,21,125,14,15,-1
26,21,126,11,11,0
26,21,127,10,9,1
26,21,128,13,16,-3
26,21,129,14,17,-3
26,21,130,13,22,-9
26,21,131,9,5,4
26,21,132,13,14,-1
26,21,133,3,22,-19
26,21,134,11,12,-1
26,21,135,18,16,2
26,21,136,16,11,5
26,21,137,5,6,-1
26,21,138,10,17,-7
26,21,139,11,19,-8
26,21,140,11,6,5
26,21,141,10,8,2
26,21,142,4,6,-2
26,21,143,14,18,-4
26,21,144,11,22,-11
26,21,145,5,16,-11
26,21,146,9,15,-6
26,21,147,14,12,2
26,21,148,11,23,-12
26,21,149,10,18,-8
26,21,150,20,17,3
26,21,151,12,15,-3
26,21,152,5,6,-1
26,21,153,12,16,-4
26,21,154,8,8,0
26,21,155,2,13,-11
26,21,156,9,14,-5
26,21,157,15,25,-10
26,21,158,20,13,7
26,21,159,11,16,-5
26,21,160,9,10,-1
26,21,161,20,18,2
26,21,162,10,11,-1
26,21,163,8,26,-18
26,21,164,15,11,4
26,21,165,20,23,-3
26,21,166,5,13,-8
26,21,167,5,14,-9
26,21,168,17,22,-5
26,21,169,11,10,1
26,21,170,4,10,-6
26,21,171,5,23,-18
26,21,172,17,24,-7
26,21,173,13,19,-6
26,21,174,7,11,-4
26,21,175,15,25,-10
26,21,176,6,15,-9
26,21,177,13,12,1
26,21,178,12,6,6
26,21,179,13,19,-6
26,21,180,7,7,0
26,21,181,8,15,-7
26,21,182,8,16,-8
26,21,183,15,18,-3
26,21,184,12,25,-13
26,21,185,13,30,-17
26,21,186,19,11,8
26,21,187,11,15,-4
26,21,188,6,17,-11
26,21,189,10,12,-2
26,21,190,8,13,-5
26,21,191,16,20,-4
26,21,192,16,4,12
26,21,193,12,8,4
26,21,194,5,19,-14
26,21,195,12,11,1
26,21,196,12,15,-3
26,21,197,9,11,-2
26,21,198,12,18,-6
26,21,199,9,17,-8
26,21,200,9,11,-2
26,21,201,5,10,-5
26,21,202,20,17,3
26,21,203,15,17,-2
26,21,204,11,5,6
26,21,205,12,9,3
26,21,206,10,14,-4
26,21,207,4,25,-21
26,21,208,7,24,-17
26,21,209,8,6,2
26,21,210,11,30,-19
26,21,211,16,21,-5
26,21,212,14,18,-4
26,21,213,14,25,-11
26,21,214,14,17,-3
26,21,215,14,23,-9
26,21,216,5,11,-6
26,21,217,10,18,-8
26,21,218,3,9,-6
26,21,219,9,11,-2
26,21,220,4,9,-5
26,21,221,13,6,7
26,21,222,14,25,-11
26,21,223,10,13,-3
26,21,224,15,22,-7
26,21,225,4,9,-5
26,21,226,6,9,-3
26,21,227,6,11,-5
26,21,228,4,13,-9
26,21,229,14,19,-5
26,21,230,7,13,-6
26,21,231,10,21,-11
26,21,232,7,13,-6
26,21,233,17,10,7
26,21,234,22,17,5
26,21,235,8,23,-15
26,21,236,5,12,-7
26,21,237,20,15,5
26,21,238,6,12,-6
26,21,239,10,19,-9
26,21,240,14,14,0
26,21,241,7,9,-2
26,21,242,2,2,0
26,21,243,19,11,8
26,21,244,11,12,-1
26,21,245,3,16,-13
26,21,246,4,16,-12
26,21,247,13,10,3
26,21,248,15,14,1
26,21,249,6,18,-12
26,21,250,12,10,2
26,21,251,11,6,5
26,21,252,5,8,-3
26,21,253,7,6,1
26,21,254,11,16,-5
26,21,255,17,13,4
26,21,256,21,15,6
26,21,257,16,11,5
26,21,258,8,12,-4
26,21,259,12,11,1
26,21,260,6,8,-2
26,21,261,11,16,-5
26,21,262,14,28,-14
26,21,263,18,22,-4
26,21,264,12,26,-14
26,21,265,12,7,5
26,21,266,9,13,-4
26,21,267,4,8,-4
26,21,268,11,19,-8
26,21,269,4,11,-7
26,21,270,3,29,-26
26,21,271,25,21,4
26,21,272,7,11,-4
26,21,273,6,16,-10
26,21,274,20,24,-4
26,21,275,8,16,-8
26,21,276,9,16,-7
26,21,277,7,12,-5
26,21,278,8,10,-2
26,21,279,19,12,7
26,21,280,24,17,7
26,21,281,11,21,-10
26,21,282,1,6,-5
26,21,283,21,18,3
26,21,284,8,22,-14
26,21,285,5,13,-8
26,21,286,12,17,-5
26,21,287,9,10,-1
26,21,288,18,29,-11
26,21,289,10,32,-22
26,21,290,23,16,7
26,21,291,16,22,-6
26,21,292,9,13,-4
26,21,293,11,13,-2
26,21,294,9,16,-7
26,21,295,9,10,-1
26,21,296,19,8,11
26,21,297,14,15,-1
26,21,298,18,6,12
26,21,299,15,16,-1
26,22,0,17,11,6
26,22,1,16,9,7
26,22,2,23,14,9
26,22,3,11,8,3
26,22,4,12,7,5
26,22,5,16,19,-3
26,22,6,21,12,9
26,22,7,13,22,-9
26,22,8,8,19,-11
26,22,9,6,10,-4
26,22,10,23,17,6
26,22,11,10,13,-3
26,22,12,7,13,-6
26,22,13,8,11,-3
26,22,14,4,19,-15
26,22,15,15,23,-8
26,22,16,9,8,1
26,22,17,9,11,-2
26,22,18,17,8,9
26,22,19,11,19,-8
26,22,20,19,13,6
26,22,21,11,16,-5
26,22,22,13,10,3
26,22,23,14,13,1
26,22,24,8,18,-10
26,22,25,17,19,-2
26,22,26,14,4,10
26,22,27,11,28,-17
26,22,28,14,18,-4
26,22,29,15,15,0
26,22,30,15,21,-6
26,22,31,22,8,14
26,22,32,10,13,-3
26,22,33,8,12,-4
26,22,34,16,18,-2
26,22,35,15,13,2
26,22,36,16,3,13
26,22,37,20,17,3
26,22,38,5,9,-4
26,22,39,13,22,-9
26,22,40,17,11,6
26,22,41,17,14,3
26,22,42,9,17,-8
26,22,43,22,30,-8
26,22,44,13,20,-7
26,22,45,14,13,1
26,22,46,15,26,-11
26,22,47,20,17,3
26,22,48,18,20,-2
26,22,49,8,17,-9
26,22,50,13,28,-15
26,22,51,17,26,-9
26,22,52,8,11,-3
26,22,53,15,15,0
26,22,54,9,12,-3
26,22,55,13,32,-19
26,22,56,7,19,-12
26,22,57,17,9,8
26,22,58,17,19,-2
26,22,59,10,12,-2
26,22,60,14,12,2
26,22,61,14,19,-5
26,22,62,14,14,0
26,22,63,14,17,-3
26,22,64,12,11,1
26,22,65,18,25,-7
26,22,66,16,7,9
26,22,67,12,25,-13
26,22,68,6,12,-6
26,22,69,10,20,-10
26,22,70,5,18,-13
26,22,71,9,8,1
26,22,72,21,18,3
26,22,73,9,16,-7
26,22,74,19,9,10
26,22,75,16,13,3
26,22,76,13,15,-2
26,22,77,17,19,-2
26,22,78,13,19,-6
26,22,79,9,23,-14
26,22,80,20,21,-1
26,22,81,11,15,-4
26,22,82,17,18,-1
26,22,83,18,22,-4
26,22,84,12,2,10
26,22,85,11,11,0
26,22,86,10,12,-2
26,22,87,26,11,15
26,22,88,18,13,5
26,22,89,15,16,-1
26,22,90,14,11,3
26,22,91,10,16,-6
26,22,92,16,10,6
26,22,93,4,13,-9
26,22,94,8,7,1
26,22,95,8,10,-2
26,22,96,20,14,6
26,22,97,5,10,-5
26,22,98,13,15,-2
26,22,99,11,22,-11
26,22,100,16,13,3
26,22,101,16,22,-6
26,22,102,15,19,-4
26,22,103,12,16,-4
26,22,104,18,18,0
26,22,105,11,12,-1
26,22,106,7,8,-1
26,22,107,9,14,-5
26,22,108,6,10,-4
26,22,109,18,17,1
26,22,110,10,23,-13
26,22,111,15,21,-6
26,22,112,11,24,-13
26,22,113,11,34,-23
26,22,114,10,22,-12
26,22,115,5,20,-15
26,22,116,19,11,8
26,22,117,12,16,-4
26,22,118,17,12,5
26,22,119,15,20,-5
26,22,120,19,8,11
26,22,121,10,10,0
26,22,122,5,12,-7
26,22,123,8,18,-10
26,22,124,18,8,10
26,22,125,7,12,-5
26,22,126,13,16,-3
26,22,127,16,13,3
26,22,128,15,24,-9
26,22,129,13,23,-10
26,22,130,11,8,3
26,22,131,10,22,-12
26,22,132,15,14,1
26,22,133,14,13,1
26,22,134,17,27,-10
26,22,135,30,17,13
26,22,136,7,16,-9
26,22,137,3,20,-17
26,22,138,5,20,-15
26,22,139,12,15,-3
26,22,140,9,9,0
26,22,141,6,20,-14
26,22,142,21,12,9
26,22,143,17,20,-3
26,22,144,15,13,2
26,22,145,4,11,-7
26,22,146,16,25,-9
26,22,147,23,29,-6
26,22,148,14,20,-6
26,22,149,16,20,-4
26,22,150,10,14,-4
26,22,151,12,19,-7
26,22,152,8,13,-5
26,22,153,6,11,-5
26,22,154,10,12,-2
26,22,155,16,22,-6
26,22,156,14,15,-1
26,22,157,13,19,-6
26,22,158,10,8,2
26,22,159,20,8,12
26,22,160,14,8,6
26,22,161,11,13,-2
26,22,162,11,10,1
26,22,163,8,23,-15
26,22,164,10,12,-2
26,22,165,28,27,1
26,22,166,10,15,-5
26,22,167,14,29,-15
26,22,168,7,32,-25
26,22,169,22,18,4
26,22,170,12,28,-16
26,22,171,8,6,2
26,22,172,7,26,-19
26,22,173,12,25,-13
26,22,174,4,7,-3
26,22,175,17,13,4
26,22,176,16,8,8
26,22,177,10,11,-1
26,22,178,6,15,-9
26,22,179,2,10,-8
26,22,180,27,14,13
26,22,181,10,7,3
26,22,182,17,15,2
26,22,183,16,25,-9
26,22,184,17,19,-2
26,22,185,9,16,-7
26,22,186,12,17,-5
26,22,187,15,22,-7
26,22,188,11,16,-5
26,22,189,11,13,-2
26,22,190,16,26,-10
26,22,191,18,13,5
26,22,192,13,29,-16
26,22,193,5,5,0
26,22,194,8,14,-6
26,22,195,8,20,-12
26,22,196,18,10,8
26,22,197,8,7,1
26,22,198,10,14,-4
26,22,199,15,9,6
26,22,200,18,14,4
26,22,201,24,22,2
26,22,202,14,11,3
26,22,203,2,20,-18
26,22,204,12,16,-4
26,22,205,17,10,7
26,22,206,11,3,8
26,22,207,5,16,-11
26,22,208,13,22,-9
26,22,209,8,6,2
26,22,210,13,12,1
26,22,211,17,12,5
26,22,212,10,10,0
26,22,213,12,10,2
26,22,214,6,12,-6
26,22,215,9,9,0
26,22,216,17,14,3
26,22,217,9,6,3
26,22,218,11,18,-7
26,22,219,16,13,3
26,22,220,8,11,-3
26,22,221,19,17,2
26,22,222,11,12,-1
26,22,223,12,21,-9
26,22,224,11,11,0
26,22,225,18,10,8
26,22,226,21,17,4
26,22,227,11,14,-3
26,22,228,17,15,2
26,22,229,10,9,1
26,22,230,19,16,3
26,22,231,12,14,-2
26,22,232,20,21,-1
26,22,233,10,15,-5
26,22,234,5,18,-13
26,22,235,9,15,-6
26,22,236,18,27,-9
26,22,237,11,17,-6
26,22,238,17,11,6
26,22,239,20,11,9
26,22,240,16,17,-1
26,22,241,5,13,-8
26,22,242,19,15,4
26,22,243,9,28,-19
26,22,244,16,15,1
26,22,245,12,19,-7
26,22,246,6,16,-10
26,22,247,17,17,0
26,22,248,17,21,-4
26,22,249,18,15,3
26,22,250,9,18,-9
26,22,251,9,19,-10
26,22,252,4,3,1
26,22,253,8,9,-1
26,22,254,12,15,-3
26,22,255,9,11,-2
26,22,256,7,10,-3
26,22,257,12,17,-5
26,22,258,19,25,-6
26,22,259,8,20,-12
26,22,260,13,13,0
26,22,261,10,18,-8
26,22,262,4,4,0
26,22,263,13,23,-10
26,22,264,15,20,-5
26,22,265,15,17,-2
26,22,266,15,20,-5
26,22,267,25,19,6
26,22,268,19,13,6
26,22,269,16,17,-1
26,22,270,29,17,12
26,22,271,23,30,-7
26,22,272,11,15,-4
26,22,273,15,29,-14
26,22,274,8,13,-5
26,22,275,17,15,2
26,22,276,5,28,-23
26,22,277,19,19,0
26,22,278,15,18,-3
26,22,279,21,12,9
26,22,280,24,16,8
26,22,281,12,12,0
26,22,282,10,14,-4
26,22,283,14,12,2
26,22,284,19,14,5
26,22,285,11,13,-2
26,22,286,6,20,-14
26,22,287,7,8,-1
26,22,288,11,32,-21
26,22,289,7,11,-4
26,22,290,1,14,-13
26,22,291,11,11,0
26,22,292,13,11,2
26,22,293,17,18,-1
26,22,294,9,19,-10
26,22,295,7,12,-5
26,22,296,8,19,-11
26,22,297,12,9,3
26,22,298,12,7,5
26,22,299,10,20,-10
26,23,0,7,15,-8
26,23,1,25,11,14
26,23,2,11,14,-3
26,23,3,9,10,-1
26,23,4,8,4,4
26,23,5,8,8,0
26,23,6,7,9,-2
26,23,7,24,12,12
26,23,8,13,13,0
26,23,9,10,11,-1
26,23,10,12,23,-11
26,23,11,14,17,-3
26,23,12,6,2,4
26,23,13,8,14,-6
26,23,14,16,5,11
26,23,15,28,9,19
26,23,16,12,19,-7
26,23,17,17,10,7
26,23,18,16,18,-2
26,23,19,23,16,7
26,23,20,5,16,-11
26,23,21,13,11,2
26,23,22,15,19,-4
26,23,23,9,7,2
26,23,24,14,13,1
26,23,25,12,23,-11
26,23,26,19,20,-1
26,23,27,4,17,-13
26,23,28,16,22,-6
26,23,29,5,25,-20
26,23,30,13,11,2
26,23,31,11,13,-2
26,23,32,7,15,-8
26,23,33,10,7,3
26,23,34,13,18,-5
26,23,35,11,12,-1
26,23,36,15,16,-1
26,23,37,9,25,-16
26,23,38,3,2,1
26,23,39,16,11,5
26,23,40,15,7,8
26,23,41,13,14,-1
26,23,42,6,7,-1
26,23,43,12,10,2
26,23,44,15,20,-5
26,23,45,14,6,8
26,23,46,12,14,-2
26,23,47,4,11,-7
26,23,48,13,24,-11
26,23,49,9,13,-4
26,23,50,7,12,-5
26,23,51,9,3,6
26,23,52,9,9,0
26,23,53,9,17,-8
26,23,54,10,20,-10
26,23,55,13,20,-7
26,23,56,25,16,9
26,23,57,23,9,14
26,23,58,15,18,-3
26,23,59,12,10,2
26,23,60,3,18,-15
26,23,61,9,9,0
26,23,62,24,15,9
26,23,63,13,14,-1
26,23,64,17,19,-2
26,23,65,18,23,-5
26,23,66,22,21,1
26,23,67,4,5,-1
26,23,68,24,16,8
26,23,69,19,12,7
26,23,70,13,23,-10
26,23,71,5,8,-3
26,23,72,7,12,-5
26,23,73,11,31,-20
26,23,74,7,10,-3
26,23,75,12,6,6
26,23,76,9,10,-1
26,23,77,9,1,8
26,23,78,26,13,13
26,23,79,8,5,3
26,23,80,15,22,-7
26,23,81,17,11,6
26,23,82,13,8,5
26,23,83,12,12,0
26,23,84,15,14,1
26,23,85,17,14,3
26,23,86,10,20,-10
26,23,87,2,7,-5
26,23,88,8,16,-8
26,23,89,7,10,-3
26,23,90,6,14,-8
26,23,91,18,20,-2
26,23,92,6,20,-14
26,23,93,19,18,1
26,23,94,8,5,3
26,23,95,4,10,-6
26,23,96,9,11,-2
26,23,97,19,13,6
26,23,98,15,9,6
26,23,99,9,9,0
26,23,100,14,18,-4
26,23,101,13,19,-6
26,23,102,11,15,-4
26,23,103,18,26,-8
26,23,104,13,18,-5
26,23,105,7,13,-6
26,23,106,20,23,-3
26,23,107,9,7,2
26,23,108,11,9,2
26,23,109,6,16,-10
26,23,110,15,13,2
26,23,111,11,23,-12
26,23,112,14,13,1
26,23,113,16,20,-4
26,23,114,20,17,3
26,23,115,10,10,0
26,23,116,21,14,7
26,23,117,16,22,-6
26,23,118,14,18,-4
26,23,119,15,16,-1
26,23,120,6,14,-8
26,23,121,17,22,-5
26,23,122,12,15,-3
26,23,123,15,17,-2
26,23,124,2,15,-13
26,23,125,17,16,1
26,23,126,10,19,-9
26,23,127,5,6,-1
26,23,128,5,19,-14
26,23,129,17,9,8
26,23,130,5,14,-9
26,23,131,13,13,0
26,23,132,8,8,0
26,23,133,18,11,7
26,23,134,16,17,-1
26,23,135,19,27,-8
26,23,136,8,17,-9
26,23,137,9,18,-9
26,23,138,10,11,-1
26,23,139,16,11,5
26,23,140,13,14,-1
26,23,141,19,17,2
26,23,142,11,22,-11
26,23,143,15,14,1
26,23,144,7,20,-13
26,23,145,14,5,9
26,23,146,11,14,-3
26,23,147,7,18,-11
26,23,148,2,8,-6
26,23,149,9,25,-16
26,23,150,20,16,4
26,23,151,14,22,-8
26,23,152,3,8,-5
26,23,153,24,10,14
26,23,154,4,16,-12
26,23,155,21,8,13
26,23,156,7,8,-1
26,23,157,16,13,3
26,23,158,17,17,0
26,23,159,13,12,1
26,23,160,16,16,0
26,23,161,20,12,8
26,23,162,4,15,-11
26,23,163,14,18,-4
26,23,164,15,20,-5
26,23,165,6,5,1
26,23,166,5,15,-10
26,23,167,12,12,0
26,23,168,5,9,-4
26,23,169,7,9,-2
26,23,170,12,13,-1
26,23,171,4,16,-12
26,23,172,7,13,-6
26,23,173,6,12,-6
26,23,174,11,9,2
26,23,175,12,26,-14
26,23,176,12,17,-5
26,23,177,8,13,-5
26,23,178,6,10,-4
26,23,179,9,18,-9
26,23,180,8,9,-1
26,23,181,12,17,-5
26,23,182,14,12,2
26,23,183,9,22,-13
26,23,184,18,19,-1
26,23,185,13,9,4
26,23,186,10,7,3
26,23,187,11,13,-2
26,23,188,18,31,-13
26,23,189,23,15,8
26,23,190,14,11,3
26,23,191,18,11,7
26,23,192,13,13,0
26,23,193,12,14,-2
26,23,194,13,7,6
26,23,195,14,8,6
26,23,196,11,5,6
26,23,197,10,14,-4
26,23,198,12,16,-4
26,23,199,16,6,10
26,23,200,9,18,-9
26,23,201,15,20,-5
26,23,202,3,16,-13
26,23,203,8,12,-4
26,23,204,10,17,-7
26,23,205,13,18,-5
26,23,206,11,13,-2
26,23,207,14,8,6
26,23,208,9,16,-7
26,23,209,9,16,-7
26,23,210,7,21,-14
26,23,211,13,15,-2
26,23,212,5,3,2
26,23,213,11,14,-3
26,23,214,6,14,-8
26,23,215,5,9,-4
26,23,216,15,22,-7
26,23,217,10,14,-4
26,23,218,13,15,-2
26,23,219,17,16,1
26,23,220,11,16,-5
26,23,221,13,20,-7
26,23,222,2,16,-14
26,23,223,32,22,10
26,23,224,7,13,-6
26,23,225,14,6,8
26,23,226,5,18,-13
26,23,227,18,16,2
26,23,228,11,21,-10
26,23,229,14,14,0
26,23,230,20,10,10
26,23,231,9,10,-1
26,23,232,13,12,1
26,23,233,14,21,-7
26,23,234,9,11,-2
26,23,235,4,17,-13
26,23,236,9,16,-7
26,23,237,16,28,-12
26,23,238,16,22,-6
26,23,239,6,8,-2
26,23,240,12,12,0
26,23,241,21,32,-11
26,23,242,16,31,-15
26,23,243,11,6,5
26,23,244,16,15,1
26,23,245,12,6,6
26,23,246,12,20,-8
26,23,247,9,11,-2
26,23,248,14,17,-3
26,23,249,3,3,0
26,23,250,10,10,0
26,23,251,6,9,-3
26,23,252,33,24,9
26,23,253,10,19,-9
26,23,254,9,11,-2
26,23,255,15,16,-1
26,23,256,7,8,-1
26,23,257,7,15,-8
26,23,258,10,22,-12
26,23,259,8,10,-2
26,23,260,7,13,-6
26,23,261,14,27,-13
26,23,262,6,16,-10
26,23,263,15,17,-2
26,23,264,23,20,3
26,23,265,8,16,-8
26,23,266,18,15,3
26,23,267,12,6,6
26,23,268,12,10,2
26,23,269,17,14,3
26,23,270,14,19,-5
26,23,271,12,22,-10
26,23,272,7,10,-3
26,23,273,8,15,-7
26,23,274,14,9,5
26,23,275,13,6,7
26,23,276,9,20,-11
26,23,277,13,12,1
26,23,278,7,7,0
26,23,279,17,12,5
26,23,280,10,9,1
26,23,281,1,9,-8
26,23,282,17,18,-1
26,23,283,8,6,2
26,23,284,25,16,9
26,23,285,12,18,-6
26,23,286,15,10,5
26,23,287,26,22,4
26,23,288,8,8,0
26,23,289,6,16,-10
26,23,290,15,18,-3
26,23,291,16,10,6
26,23,292,12,20,-8
26,23,293,8,14,-6
26,23,294,8,21,-13
26,23,295,7,16,-9
26,23,296,10,15,-5
26,23,297,13,14,-1
26,23,298,11,21,-10
26,23,299,12,19,-7
26,24,0,7,10,-3
26,24,1,17,21,-4
26,24,2,18,19,-1
26,24,3,8,22,-14
26,24,4,9,17,-8
26,24,5,10,18,-8
26,24,6,21,13,8
26,24,7,10,10,0
26,24,8,27,13,14
26,24,9,9,15,-6
26,24,10,13,17,-4
26,24,11,21,11,10
26,24,12,10,12,-2
26,24,13,8,6,2
26,24,14,13,11,2
26,24,15,3,10,-7
26,24,16,24,19,5
26,24,17,20,4,16
26,24,18,21,33,-12
26,24,19,19,11,8
26,24,20,18,14,4
26,24,21,20,13,7
26,24,22,18,25,-7
26,24,23,8,14,-6
26,24,24,13,11,2
26,24,25,10,9,1
26,24,26,17,22,-5
26,24,27,20,15,5
26,24,28,15,21,-6
26,24,29,3,21,-18
26,24,30,6,21,-15
26,24,31,21,12,9
26,24,32,14,13,1
26,24,33,10,9,1
26,24,34,16,16,0
26,24,35,20,12,8
26,24,36,10,13,-3
26,24,37,7,6,1
26,24,38,18,17,1
26,24,39,9,11,-2
26,24,40,9,9,0
26,24,41,5,13,-8
26,24,42,3,11,-8
26,24,43,16,6,10
26,24,44,10,7,3
26,24,45,8,18,-10
26,24,46,8,15,-7
26,24,47,15,14,1
26,24,48,17,8,9
26,24,49,13,17,-4
26,24,50,21,21,0
26,24,51,9,12,-3
26,24,52,7,7,0
26,24,53,10,9,1
26,24,54,15,17,-2
26,24,55,20,22,-2
26,24,56,20,10,10
26,24,57,14,18,-4
26,24,58,4,10,-6
26,24,59,8,9,-1
26,24,60,18,10,8
26,24,61,17,20,-3
26,24,62,8,8,0
26,24,63,10,14,-4
26,24,64,13,12,1
26,24,65,10,14,-4
26,24,66,11,12,-1
26,24,67,16,9,7
26,24,68,6,11,-5
26,24,69,15,7,8
26,24,70,21,18,3
26,24,71,9,17,-8
26,24,72,7,7,0
26,24,73,16,17,-1
26,24,74,22,7,15
26,24,75,10,17,-7
26,24,76,17,9,8
26,24,77,4,5,-1
26,24,78,15,13,2
26,24,79,6,6,0
26,24,80,10,16,-6
26,24,81,12,19,-7
26,24,82,12,9,3
26,24,83,12,21,-9
26,24,84,14,25,-11
26,24,85,9,16,-7
26,24,86,4,9,-5
26,24,87,19,10,9
26,24,88,18,19,-1
26,24,89,17,23,-6
26,24,90,2,14,-12
26,24,91,7,12,-5
26,24,92,14,25,-11
26,24,93,17,16,1
26,24,94,15,18,-3
26,24,95,10,14,-4
26,24,96,11,12,-1
26,24,97,15,8,7
26,24,98,6,13,-7
26,24,99,4,12,-8
26,24,100,6,10,-4
26,24,101,18,20,-2
26,24,102,7,6,1
26,24,103,10,6,4
26,24,104,12,18,-6
26,24,105,23,24,-1
26,24,106,14,11,3
26,24,107,3,12,-9
26,24,108,17,19,-2
26,24,109,3,11,-8
26,24,110,11,17,-6
26,24,111,14,14,0
26,24,112,7,17,-10
26,24,113,9,11,-2
26,24,114,11,7,4
26,24,115,19,18,1
26,24,116,9,8,1
26,24,117,8,13,-5
26,24,118,11,13,-2
26,24,119,19,25,-6
26,24,120,7,14,-7
26,24,121,6,9,-3
26,24,122,9,14,-5
26,24,123,12,14,-2
26,24,124,10,10,0
26,24,125,8,27,-19
26,24,126,7,12,-5
26,24,127,15,30,-15
26,24,128,17,3,14
26,24,129,24,14,10
26,24,130,12,20,-8
26,24,131,6,19,-13
26,24,132,8,12,-4
26,24,133,27,15,12
26,24,134,13,16,-3
26,24,135,9,24,-15
26,24,136,28,20,8
26,24,137,4,12,-8
26,24,138,14,13,1
26,24,139,12,22,-10
26,24,140,10,11,-1
26,24,141,15,16,-1
26,24,142,15,26,-11
26,24,143,5,9,-4
26,24,144,7,7,0
26,24,145,11,12,-1
26,24,146,8,15,-7
26,24,147,11,9,2
26,24,148,7,14,-7
26,24,149,11,12,-1
26,24,150,20,27,-7
26,24,151,23,21,2
26,24,152,5,8,-3
26,24,153,23,18,5
26,24,154,22,12,10
26,24,155,16,15,1
26,24,156,20,19,1
26,24,157,18,27,-9
26,24,158,19,17,2
26,24,159,15,18,-3
26,24,160,8,4,4
26,24,161,9,11,-2
26,24,162,12,10,2
26,24,163,8,18,-10
26,24,164,15,24,-9
26,24,165,9,11,-2
26,24,166,11,14,-3
26,24,167,9,11,-2
26,24,168,21,8,13
26,24,169,7,10,-3
26,24,170,12,15,-3
26,24,171,12,9,3
26,24,172,18,18,0
26,24,173,10,17,-7
26,24,174,12,11,1
26,24,175,8,9,-1
26,24,176,16,12,4
26,24,177,13,15,-2
26,24,178,18,19,-1
26,24,179,18,19,-1
26,24,180,15,13,2
26,24,181,20,19,1
26,24,182,8,11,-3
26,24,183,4,6,-2
26,24,184,8,14,-6
26,24,185,5,16,-11
26,24,186,17,13,4
26,24,187,7,15,-8
26,24,188,4,10,-6
26,24,189,6,16,-10
26,24,190,12,14,-2
26,24,191,20,16,4
26,24,192,10,17,-7
26,24,193,14,19,-5
26,24,194,12,14,-2
26,24,195,8,14,-6
26,24,196,2,9,-7
26,24,197,11,8,3
26,24,198,14,23,-9
26,24,199,4,9,-5
26,24,200,9,10,-1
26,24,201,13,8,5
26,24,202,12,10,2
26,24,203,10,18,-8
26,24,204,6,10,-4
26,24,205,10,12,-2
26,24,206,10,13,-3
26,24,207,30,16,14
26,24,208,20,18,2
26,24,209,15,16,-1
26,24,210,9,13,-4
26,24,211,13,12,1
26,24,212,24,18,6
26,24,213,19,23,-4
26,24,214,10,19,-9
26,24,215,6,17,-11
26,24,216,15,18,-3
26,24,217,15,12,3
26,24,218,10,14,-4
26,24,219,11,10,1
26,24,220,19,14,5
26,24,221,12,13,-1
26,24,222,14,10,4
26,24,223,19,17,2
26,24,224,12,10,2
26,24,225,1,4,-3
26,24,226,14,21,-7
26,24,227,14,9,5
26,24,228,9,16,-7
26,24,229,11,21,-10
26,24,230,5,3,2
26,24,231,12,27,-15
26,24,232,10,7,3
26,24,233,10,7,3
26,24,234,16,14,2
26,24,235,6,22,-16
26,24,236,12,24,-12
26,24,237,6,7,-1
26,24,238,12,13,-1
26,24,239,8,9,-1
26,24,240,14,10,4
26,24,241,9,13,-4
26,24,242,2,12,-10
26,24,243,11,9,2
26,24,244,14,10,4
26,24,245,11,23,-12
26,24,246,13,16,-3
26,24,247,4,8,-4
26,24,248,10,18,-8
26,24,249,10,9,1
26,24,250,14,12,2
26,24,251,9,14,-5
26,24,252,10,15,-5
26,24,253,10,9,1
26,24,254,9,8,1
26,24,255,27,7,20
26,24,256,23,10,13
26,24,257,16,16,0
26,24,258,11,10,1
26,24,259,7,17,-10
26,24,260,18,9,9
26,24,261,12,11,1
26,24,262,17,9,8
26,24,263,10,27,-17
26,24,264,12,8,4
26,24,265,9,14,-5
26,24,266,9,27,-18
26,24,267,3,9,-6
26,24,268,12,13,-1
26,24,269,19,18,1
26,24,270,7,19,-12
26,24,271,11,22,-11
26,24,272,9,9,0
26,24,273,17,20,-3
26,24,274,6,11,-5
26,24,275,24,22,2
26,24,276,14,11,3
26,24,277,17,13,4
26,24,278,23,24,-1
26,24,279,18,14,4
26,24,280,18,11,7
26,24,281,12,13,-1
26,24,282,4,15,-11
26,24,283,16,18,-2
26,24,284,12,10,2
26,24,285,7,9,-2
26,24,286,13,15,-2
26,24,287,19,8,11
26,24,288,17,30,-13
26,24,289,10,24,-14
26,24,290,15,11,4
26,24,291,10,13,-3
26,24,292,10,16,-6
26,24,293,15,17,-2
26,24,294,12,18,-6
26,24,295,10,13,-3
26,24,296,11,22,-11
26,24,297,7,12,-5
26,24,298,12,19,-7
26,24,299,8,11,-3
26,25,0,25,16,9
26,25,1,15,17,-2
26,25,2,7,8,-1
26,25,3,17,20,-3
26,25,4,14,9,5
26,25,5,16,11,5
26,25,6,16,21,-5
26,25,7,19,16,3
26,25,8,7,13,-6
26,25,9,6,13,-7
26,25,10,14,19,-5
26,25,11,7,16,-9
26,25,12,15,11,4
26,25,13,14,25,-11
26,25,14,11,11,0
26,25,15,10,16,-6
26,25,16,11,13,-2
26,25,17,13,6,7
26,25,18,6,9,-3
26,25,19,19,6,13
26,25,20,21,27,-6
26,25,21,7,16,-9
26,25,22,15,12,3
26,25,23,8,13,-5
26,25,24,18,8,10
26,25,25,10,18,-8
26,25,26,9,9,0
26,25,27,13,19,-6
26,25,28,7,7,0
26,25,29,9,9,0
26,25,30,8,7,1
26,25,31,6,16,-10
26,25,32,15,14,1
26,25,33,16,13,3
26,25,34,21,18,3
26,25,35,5,12,-7
26,25,36,5,11,-6
26,25,37,10,8,2
26,25,38,17,17,0
26,25,39,8,7,1
26,25,40,21,21,0
26,25,41,18,18,0
26,25,42,8,10,-2
26,25,43,9,7,2
26,25,44,20,13,7
26,25,45,9,17,-8
26,25,46,14,10,4
26,25,47,10,6,4
26,25,48,10,21,-11
26,25,49,11,11,0
26,25,50,17,19,-2
26,25,51,10,11,-1
26,25,52,8,19,-11
26,25,53,19,14,5
26,25,54,25,25,0
26,25,55,11,17,-6
26,25,56,7,5,2
26,25,57,9,10,-1
26,25,58,9,6,3
26,25,59,8,4,4
26,25,60,5,8,-3
26,25,61,18,22,-4
26,25,62,8,3,5
26,25,63,8,10,-2
26,25,64,9,28,-19
26,25,65,6,14,-8
26,25,66,5,9,-4
26,25,67,16,12,4
26,25,68,22,20,2
26,25,69,10,15,-5
26,25,70,15,16,-1
26,25,71,17,6,11
26,25,72,2,7,-5
26,25,73,19,22,-3
26,25,74,17,21,-4
26,25,75,10,15,-5
26,25,76,24,8,16
26,25,77,19,12,7
26,25,78,14,16,-2
26,25,79,16,18,-2
26,25,80,13,10,3
26,25,81,5,8,-3
26,25,82,14,20,-6
26,25,83,6,7,-1
26,25,84,21,19,2
26,25,85,13,13,0
26,25,86,18,8,10
26,25,87,19,11,8
26,25,88,9,19,-10
26,25,89,19,16,3
26,25,90,12,10,2
26,25,91,10,14,-4
26,25,92,18,11,7
26,25,93,7,13,-6
26,25,94,16,15,1
26,25,95,4,24,-20
26,25,96,18,12,6
26,25,97,19,25,-6
26,25,98,14,5,9
26,25,99,10,23,-13
26,25,100,12,12,0
26,25,101,20,20,0
26,25,102,13,7,6
26,25,103,9,11,-2
26,25,104,19,10,9
26,25,105,14,13,1
26,25,106,12,15,-3
26,25,107,17,11,6
26,25,108,12,8,4
26,25,109,14,10,4
26,25,110,8,6,2
26,25,111,24,24,0
26,25,112,10,7,3
26,25,113,13,11,2
26,25,114,15,11,4
26,25,115,17,17,0
26,25,116,5,10,-5
26,25,117,19,18,1
26,25,118,5,17,-12
26,25,119,31,28,3
26,25,120,7,14,-7
26,25,121,16,16,0
26,25,122,9,15,-6
26,25,123,22,20,2
26,25,124,11,24,-13
26,25,125,8,18,-10
26,25,126,21,12,9
26,25,127,9,12,-3
26,25,128,11,18,-7
26,25,129,12,9,3
26,25,130,20,26,-6
26,25,131,5,5,0
26,25,132,12,16,-4
26,25,133,10,21,-11
26,25,134,9,21,-12
26,25,135,12,12,0
26,25,136,8,17,-9
26,25,137,12,3,9
26,25,138,15,20,-5
26,25,139,7,21,-14
26,25,140,19,16,3
26,25,141,5,10,-5
26,25,142,22,19,3
26,25,143,18,17,1
26,25,144,1,8,-7
26,25,145,13,14,-1
26,25,146,5,16,-11
26,25,147,8,10,-2
26,25,148,18,13,5
26,25,149,15,17,-2
26,25,150,11,16,-5
26,25,151,6,8,-2
26,25,152,10,7,3
26,25,153,19,10,9
26,25,154,12,20,-8
26,25,155,17,18,-1
26,25,156,12,8,4
26,25,157,5,13,-8
26,25,158,10,15,-5
26,25,159,14,16,-2
26,25,160,13,13,0
26,25,161,6,13,-7
26,25,162,17,27,-10
26,25,163,21,7,14
26,25,164,14,15,-1
26,25,165,16,10,6
26,25,166,3,7,-4
26,25,167,17,5,12
26,25,168,22,13,9
26,25,169,11,8,3
26,25,170,22,12,10
26,25,171,8,10,-2
26,25,172,5,12,-7
26,25,173,9,12,-3
26,25,174,8,10,-2
26,25,175,16,11,5
26,25,176,17,26,-9
26,25,177,8,8,0
26,25,178,10,6,4
26,25,179,4,11,-7
26,25,180,7,25,-18
26,25,181,6,8,-2
26,25,182,5,13,-8
26,25,183,21,12,9
26,25,184,14,19,-5
26,25,185,11,13,-2
26,25,186,20,10,10
26,25,187,12,18,-6
26,25,188,16,17,-1
26,25,189,15,7,8
26,25,190,12,12,0
26,25,191,5,18,-13
26,25,192,6,9,-3
26,25,193,11,26,-15
26,25,194,11,9,2
26,25,195,11,8,3
26,25,196,13,8,5
26,25,197,15,15,0
26,25,198,10,17,-7
26,25,199,21,22,-1
26,25,200,10,9,1
26,25,201,8,10,-2
26,25,202,12,22,-10
26,25,203,9,12,-3
26,25,204,11,11,0
26,25,205,20,12,8
26,25,206,17,15,2
26,25,207,9,23,-14
26,25,208,23,14,9
26,25,209,10,12,-2
26,25,210,17,12,5
26,25,211,10,19,-9
26,25,212,8,20,-12
26,25,213,3,9,-6
26,25,214,9,10,-1
26,25,215,13,10,3
26,25,216,13,20,-7
26,25,217,15,14,1
26,25,218,21,18,3
26,25,219,25,17,8
26,25,220,11,12,-1
26,25,221,15,21,-6
26,25,222,10,17,-7
26,25,223,15,22,-7
26,25,224,6,13,-7
26,25,225,6,11,-5
26,25,226,13,11,2
26,25,227,8,12,-4
26,25,228,15,24,-9
26,25,229,8,28,-20
26,25,230,14,17,-3
26,25,231,10,16,-6
26,25,232,7,23,-16
26,25,233,10,6,4
26,25,234,22,8,14
26,25,235,7,7,0
26,25,236,0,12,-12
26,25,237,9,6,3
26,25,238,6,8,-2
26,25,239,21,17,4
26,25,240,6,6,0
26,25,241,6,16,-10
26,25,242,9,10,-1
26,25,243,19,16,3
26,25,244,14,11,3
26,25,245,13,16,-3
26,25,246,13,12,1
26,25,247,6,10,-4
26,25,248,14,8,6
26,25,249,7,6,1
26,25,250,6,7,-1
26,25,251,9,18,-9
26,25,252,20,12,8
26,25,253,24,15,9
26,25,254,12,19,-7
26,25,255,12,9,3
26,25,256,17,26,-9
26,25,257,15,10,5
26,25,258,14,9,5
26,25,259,4,9,-5
26,25,260,11,14,-3
26,25,261,17,3,14
26,25,262,20,7,13
26,25,263,11,17,-6
26,25,264,9,11,-2
26,25,265,14,15,-1
26,25,266,18,17,1
26,25,267,12,18,-6
26,25,268,14,12,2
26,25,269,12,24,-12
26,25,270,12,24,-12
26,25,271,14,8,6
26,25,272,15,13,2
26,25,273,12,12,0
26,25,274,9,13,-4
26,25,275,12,18,-6
26,25,276,14,16,-2
26,25,277,7,18,-11
26,25,278,13,10,3
26,25,279,15,21,-6
26,25,280,12,8,4
26,25,281,10,16,-6
26,25,282,5,13,-8
26,25,283,15,6,9
26,25,284,11,14,-3
26,25,285,2,6,-4
26,25,286,17,15,2
26,25,287,11,3,8
26,25,288,16,16,0
26,25,289,7,4,3
26,25,290,12,18,-6
26,25,291,12,8,4
26,25,292,9,6,3
26,25,293,17,16,1
26,25,294,5,14,-9
26,25,295,15,10,5
26,25,296,16,17,-1
26,25,297,14,13,1
26,25,298,14,6,8
26,25,299,16,17,-1
26,26,0,15,19,-4
26,26,1,18,6,12
26,26,2,12,16,-4
26,26,3,9,2,7
26,26,4,7,13,-6
26,26,5,13,15,-2
26,26,6,18,7,11
26,26,7,16,19,-3
26,26,8,4,11,-7
26,26,9,5,4,1
26,26,10,15,8,7
26,26,11,19,9,10
26,26,12,8,10,-2
26,26,13,24,14,10
26,26,14,11,14,-3
26,26,15,3,6,-3
26,26,16,14,4,10
26,26,17,11,13,-2
26,26,18,12,5,7
26,26,19,13,14,-1
26,26,20,11,5,6
26,26,21,9,14,-5
26,26,22,16,12,4
26,26,23,10,7,3
26,26,24,22,17,5
26,26,25,12,5,7
26,26,26,12,24,-12
26,26,27,18,11,7
26,26,28,9,14,-5
26,26,29,21,14,7
26,26,30,7,8,-1
26,26,31,8,14,-6
26,26,32,5,10,-5
26,26,33,14,22,-8
26,26,34,11,9,2
26,26,35,14,8,6
26,26,36,8,20,-12
26,26,37,13,14,-1
26,26,38,30,19,11
26,26,39,3,17,-14
26,26,40,19,18,1
26,26,41,12,18,-6
26,26,42,13,11,2
26,26,43,11,11,0
26,26,44,17,14,3
26,26,45,9,13,-4
26,26,46,14,36,-22
26,26,47,7,6,1
26,26,48,12,6,6
26,26,49,18,17,1
26,26,50,12,14,-2
26,26,51,2,19,-17
26,26,52,17,22,-5
26,26,53,17,24,-7
26,26,54,19,12,7
26,26,55,14,24,-10
26,26,56,14,11,3
26,26,57,16,13,3
26,26,58,17,18,-1
26,26,59,11,22,-11
26,26,60,10,4,6
26,26,61,9,20,-11
26,26,62,9,14,-5
26,26,63,8,21,-13
26,26,64,16,12,4
26,26,65,14,18,-4
26,26,66,7,12,-5
26,26,67,21,20,1
26,26,68,6,3,3
26,26,69,6,6,0
26,26,70,12,14,-2
26,26,71,11,13,-2
26,26,72,13,14,-1
26,26,73,14,13,1
26,26,74,17,22,-5
26,26,75,14,13,1
26,26,76,10,12,-2
26,26,77,10,17,-7
26,26,78,15,23,-8
26,26,79,7,18,-11
26,26,80,4,17,-13
26,26,81,15,9,6
26,26,82,12,8,4
26,26,83,9,12,-3
26,26,84,20,11,9
26,26,85,10,24,-14
26,26,86,14,18,-4
26,26,87,12,13,-1
26,26,88,12,18,-6
26,26,89,15,12,3
26,26,90,25,11,14
26,26,91,11,20,-9
26,26,92,5,3,2
26,26,93,11,23,-12
26,26,94,13,9,4
26,26,95,15,26,-11
26,26,96,17,17,0
26,26,97,5,10,-5
26,26,98,19,12,7
26,26,99,16,9,7
26,26,100,6,15,-9
26,26,101,13,17,-4
26,26,102,15,12,3
26,26,103,8,14,-6
26,26,104,24,28,-4
26,26,105,9,21,-12
26,26,106,16,5,11
26,26,107,6,11,-5
26,26,108,12,17,-5
26,26,109,0,5,-5
26,26,110,17,26,-9
26,26,111,13,18,-5
26,26,112,0,6,-6
26,26,113,3,8,-5
26,26,114,13,12,1
26,26,115,8,17,-9
26,26,116,10,12,-2
26,26,117,16,24,-8
26,26,118,12,15,-3
26,26,119,21,13,8
26,26,120,24,19,5
26,26,121,8,9,-1
26,26,122,10,9,1
26,26,123,8,17,-9
26,26,124,5,21,-16
26,26,125,7,6,1
26,26,126,17,13,4
26,26,127,11,23,-12
26,26,128,8,14,-6
26,26,129,15,6,9
26,26,130,5,19,-14
26,26,131,10,7,3
26,26,132,10,9,1
26,26,133,12,9,3
26,26,134,23,16,7
26,26,135,8,3,5
26,26,136,25,12,13
26,26,137,11,4,7
26,26,138,12,18,-6
26,26,139,9,8,1
26,26,140,17,27,-10
26,26,141,17,23,-6
26,26,142,5,26,-21
26,26,143,18,11,7
26,26,144,4,11,-7
26,26,145,11,11,0
26,26,146,15,17,-2
26,26,147,12,8,4
26,26,148,10,14,-4
26,26,149,12,12,0
26,26,150,12,15,-3
26,26,151,13,11,2
26,26,152,8,5,3
26,26,153,11,16,-5
26,26,154,10,12,-2
26,26,155,3,13,-10
26,26,156,5,0,5
26,26,157,23,10,13
26,26,158,13,11,2
26,26,159,12,11,1
26,26,160,12,13,-1
26,26,161,8,8,0
26,26,162,10,13,-3
26,26,163,21,13,8
26,26,164,11,19,-8
26,26,165,13,24,-11
26,26,166,15,12,3
26,26,167,5,6,-1
26,26,168,15,12,3
26,26,169,8,20,-12
26,26,170,8,11,-3
26,26,171,9,12,-3
26,26,172,6,6,0
26,26,173,11,21,-10
26,26,174,13,16,-3
26,26,175,13,6,7
26,26,176,5,13,-8
26,26,177,8,11,-3
26,26,178,7,15,-8
26,26,179,10,15,-5
26,26,180,8,22,-14
26,26,181,14,18,-4
26,26,182,8,10,-2
26,26,183,10,7,3
26,26,184,17,13,4
26,26,185,5,11,-6
26,26,186,8,16,-8
26,26,187,20,15,5
26,26,188,12,13,-1
26,26,189,13,15,-2
26,26,190,15,20,-5
26,26,191,22,8,14
26,26,192,6,8,-2
26,26,193,11,6,5
26,26,194,6,13,-7
26,26,195,9,13,-4
26,26,196,6,9,-3
26,26,197,15,12,3
26,26,198,12,9,3
26,26,199,6,7,-1
26,26,200,13,13,0
26,26,201,5,10,-5
26,26,202,8,12,-4
26,26,203,4,9,-5
26,26,204,4,17,-13
26,26,205,17,8,9
26,26,206,10,10,0
26,26,207,12,8,4
26,26,208,4,14,-10
26,26,209,7,6,1
26,26,210,6,16,-10
26,26,211,13,13,0
26,26,212,7,17,-10
26,26,213,17,16,1
26,26,214,17,22,-5
26,26,215,13,9,4
26,26,216,11,9,2
26,26,217,6,16,-10
26,26,218,13,14,-1
26,26,219,10,19,-9
26,26,220,11,15,-4
26,26,221,13,13,0
26,26,222,8,6,2
26,26,223,12,16,-4
26,26,224,15,19,-4
26,26,225,16,5,11
26,26,226,9,20,-11
26,26,227,10,19,-9
26,26,228,18,30,-12
26,26,229,10,6,4
26,26,230,8,7,1
26,26,231,13,22,-9
26,26,232,4,11,-7
26,26,233,7,17,-10
26,26,234,7,16,-9
26,26,235,15,16,-1
26,26,236,9,8,1
26,26,237,5,7,-2
26,26,238,8,11,-3
26,26,239,11,29,-18
26,26,240,17,11,6
26,26,241,18,17,1
26,26,242,3,10,-7
26,26,243,14,5,9
26,26,244,9,6,3
26,26,245,10,12,-2
26,26,246,11,15,-4
26,26,247,15,14,1
26,26,248,8,10,-2
26,26,249,15,6,9
26,26,250,16,10,6
26,26,251,8,15,-7
26,26,252,15,9,6
26,26,253,14,8,6
26,26,254,12,16,-4
26,26,255,11,4,7
26,26,256,8,15,-7
26,26,257,6,19,-13
26,26,258,10,14,-4
26,26,259,17,16,1
26,26,260,6,12,-6
26,26,261,15,15,0
26,26,262,12,22,-10
26,26,263,9,6,3
26,26,264,11,7,4
26,26,265,18,14,4
26,26,266,8,13,-5
26,26,267,9,16,-7
26,26,268,8,7,1
26,26,269,14,18,-4
26,26,270,10,20,-10
26,26,271,13,7,6
26,26,272,8,24,-16
26,26,273,9,19,-10
26,26,274,9,16,-7
26,26,275,6,6,0
26,26,276,14,9,5
26,26,277,18,13,5
26,26,278,13,10,3
26,26,279,10,15,-5
26,26,280,5,10,-5
26,26,281,6,7,-1
26,26,282,12,24,-12
26,26,283,4,6,-2
26,26,284,5,15,-10
26,26,285,3,18,-15
26,26,286,9,5,4
26,26,287,11,8,3
26,26,288,7,12,-5
26,26,289,9,18,-9
26,26,290,11,16,-5
26,26,291,18,18,0
26,26,292,8,9,-1
26,26,293,20,16,4
26,26,294,19,25,-6
26,26,295,15,23,-8
26,26,296,15,18,-3
26,26,297,9,7,2
26,26,298,11,10,1
26,26,299,17,26,-9
26,27,0,8,9,-1
26,27,1,12,13,-1
26,27,2,14,12,2
26,27,3,15,13,2
26,27,4,15,8,7
26,27,5,8,13,-5
26,27,6,9,15,-6
26,27,7,23,20,3
26,27,8,12,8,4
26,27,9,10,8,2
26,27,10,12,20,-8
26,27,11,10,11,-1
26,27,12,23,8,15
26,27,13,9,13,-4
26,27,14,16,5,11
26,27,15,9,9,0
26,27,16,6,16,-10
26,27,17,19,14,5
26,27,18,9,8,1
26,27,19,7,18,-11
26,27,20,14,8,6
26,27,21,14,8,6
26,27,22,6,13,-7
26,27,23,20,18,2
26,27,24,7,9,-2
26,27,25,9,11,-2
26,27,26,9,14,-5
26,27,27,13,5,8
26,27,28,12,4,8
26,27,29,14,6,8
26,27,30,7,12,-5
26,27,31,6,15,-9
26,27,32,8,7,1
26,27,33,18,20,-2
26,27,34,9,6,3
26,27,35,16,12,4
26,27,36,9,10,-1
26,27,37,10,14,-4
26,27,38,11,16,-5
26,27,39,15,14,1
26,27,40,14,18,-4
26,27,41,10,14,-4
26,27,42,6,6,0
26,27,43,18,8,10
26,27,44,7,2,5
26,27,45,14,5,9
26,27,46,10,5,5
26,27,47,12,13,-1
26,27,48,17,7,10
26,27,49,9,12,-3
26,27,50,16,24,-8
26,27,51,16,19,-3
26,27,52,5,8,-3
26,27,53,18,21,-3
26,27,54,8,19,-11
26,27,55,14,14,0
26,27,56,10,7,3
26,27,57,16,14,2
26,27,58,21,16,5
26,27,59,3,4,-1
26,27,60,8,8,0
26,27,61,23,17,6
26,27,62,15,16,-1
26,27,63,8,12,-4
26,27,64,11,19,-8
26,27,65,18,21,-3
26,27,66,8,10,-2
26,27,67,13,9,4
26,27,68,12,8,4
26,27,69,4,12,-8
26,27,70,19,29,-10
26,27,71,10,4,6
26,27,72,10,10,0
26,27,73,13,15,-2
26,27,74,6,9,-3
26,27,75,23,8,15
26,27,76,11,24,-13
26,27,77,4,19,-15
26,27,78,4,22,-18
26,27,79,19,9,10
26,27,80,7,7,0
26,27,81,13,11,2
26,27,82,18,14,4
26,27,83,13,11,2
26,27,84,13,8,5
26,27,85,7,8,-1
26,27,86,14,7,7
26,27,87,7,10,-3
26,27,88,12,17,-5
26,27,89,17,20,-3
26,27,90,17,9,8
26,27,91,10,16,-6
26,27,92,15,17,-2
26,27,93,13,17,-4
26,27,94,11,11,0
26,27,95,12,7,5
26,27,96,7,17,-10
26,27,97,14,10,4
26,27,98,13,15,-2
26,27,99,8,5,3
26,27,100,8,6,2
26,27,101,16,12,4
26,27,102,8,7,1
26,27,103,29,18,11
26,27,104,8,9,-1
26,27,105,10,6,4
26,27,106,13,13,0
26,27,107,18,13,5
26,27,108,14,11,3
26,27,109,13,12,1
26,27,110,11,5,6
26,27,111,7,17,-10
26,27,112,8,11,-3
26,27,113,16,15,1
26,27,114,18,12,6
26,27,115,14,13,1
26,27,116,6,8,-2
26,27,117,4,14,-10
26,27,118,34,15,19
26,27,119,17,13,4
26,27,120,15,5,10
26,27,121,8,6,2
26,27,122,4,22,-18
26,27,123,19,12,7
26,27,124,21,19,2
26,27,125,19,14,5
26,27,126,13,9,4
26,27,127,7,18,-11
26,27,128,21,9,12
26,27,129,12,13,-1
26,27,130,6,15,-9
26,27,131,15,17,-2
26,27,132,5,16,-11
26,27,133,8,10,-2
26,27,134,13,13,0
26,27,135,9,10,-1
26,27,136,15,19,-4
26,27,137,26,7,19
26,27,138,19,17,2
26,27,139,20,12,8
26,27,140,9,8,1
26,27,141,20,8,12
26,27,142,9,6,3
26,27,143,13,7,6
26,27,144,11,10,1
26,27,145,8,11,-3
26,27,146,10,11,-1
26,27,147,11,15,-4
26,27,148,15,22,-7
26,27,149,15,13,2
26,27,150,18,14,4
26,27,151,9,13,-4
26,27,152,8,7,1
26,27,153,5,20,-15
26,27,154,17,6,11
26,27,155,10,21,-11
26,27,156,8,12,-4
26,27,157,23,9,14
26,27,158,11,12,-1
26,27,159,14,16,-2
26,27,160,9,17,-8
26,27,161,18,7,11
26,27,162,9,14,-5
26,27,163,22,11,11
26,27,164,10,16,-6
26,27,165,15,17,-2
26,27,166,16,20,-4
26,27,167,5,11,-6
26,27,168,11,9,2
26,27,169,12,10,2
26,27,170,12,23,-11
26,27,171,8,23,-15
26,27,172,8,7,1
26,27,173,14,15,-1
26,27,174,11,18,-7
26,27,175,15,9,6
26,27,176,18,12,6
26,27,177,8,17,-9
26,27,178,14,9,5
26,27,179,12,6,6
26,27,180,12,18,-6
26,27,181,9,14,-5
26,27,182,15,11,4
26,27,183,10,22,-12
26,27,184,16,3,13
26,27,185,11,8,3
26,27,186,25,9,16
26,27,187,15,4,11
26,27,188,18,21,-3
26,27,189,6,13,-7
26,27,190,16,15,1
26,27,191,14,14,0
26,27,192,25,10,15
26,27,193,16,16,0
26,27,194,11,7,4
26,27,195,12,11,1
26,27,196,12,9,3
26,27,197,9,7,2
26,27,198,8,14,-6
26,27,199,10,16,-6
26,27,200,11,19,-8
26,27,201,22,26,-4
26,27,202,15,14,1
26,27,203,8,14,-6
26,27,204,1,7,-6
26,27,205,10,11,-1
26,27,206,4,17,-13
26,27,207,26,24,2
26,27,208,21,18,3
26,27,209,22,8,14
26,27,210,9,7,2
26,27,211,6,10,-4
26,27,212,13,7,6
26,27,213,13,23,-10
26,27,214,10,11,-1
26,27,215,14,13,1
26,27,216,5,5,0
26,27,217,11,6,5
26,27,218,10,5,5
26,27,219,17,10,7
26,27,220,13,18,-5
26,27,221,7,10,-3
26,27,222,12,22,-10
26,27,223,17,14,3
26,27,224,14,7,7
26,27,225,13,19,-6
26,27,226,12,23,-11
26,27,227,9,12,-3
26,27,228,15,15,0
26,27,229,18,5,13
26,27,230,14,13,1
26,27,231,11,10,1
26,27,232,10,13,-3
26,27,233,14,12,2
26,27,234,17,12,5
26,27,235,10,9,1
26,27,236,7,8,-1
26,27,237,16,15,1
26,27,238,11,19,-8
26,27,239,8,14,-6
26,27,240,12,8,4
26,27,241,11,18,-7
26,27,242,19,24,-5
26,27,243,6,9,-3
26,27,244,8,19,-11
26,27,245,10,10,0
26,27,246,10,10,0
26,27,247,18,13,5
26,27,248,21,14,7
26,27,249,10,14,-4
26,27,250,10,12,-2
26,27,251,18,15,3
26,27,252,8,7,1
26,27,253,13,15,-2
26,27,254,10,7,3
26,27,255,10,16,-6
26,27,256,16,19,-3
26,27,257,17,10,7
26,27,258,6,11,-5
26,27,259,26,12,14
26,27,260,10,9,1
26,27,261,9,8,1
26,27,262,6,10,-4
26,27,263,13,19,-6
26,27,264,13,9,4
26,27,265,17,10,7
26,27,266,6,7,-1
26,27,267,8,10,-2
26,27,268,13,15,-2
26,27,269,8,9,-1
26,27,270,15,16,-1
26,27,271,11,21,-10
26,27,272,10,16,-6
26,27,273,13,11,2
26,27,274,13,10,3
26,27,275,10,10,0
26,27,276,11,12,-1
26,27,277,9,17,-8
26,27,278,12,3,9
26,27,279,14,3,11
26,27,280,15,9,6
26,27,281,13,22,-9
26,27,282,1,17,-16
26,27,283,13,7,6
26,27,284,15,13,2
26,27,285,5,11,-6
26,27,286,6,16,-10
26,27,287,2,3,-1
26,27,288,12,19,-7
26,27,289,10,11,-1
26,27,290,11,14,-3
26,27,291,16,26,-10
26,27,292,14,20,-6
26,27,293,22,11,11
26,27,294,12,12,0
26,27,295,15,15,0
26,27,296,17,22,-5
26,27,297,19,11,8
26,27,298,10,10,0
26,27,299,17,19,-2
26,28,0,12,15,-3
26,28,1,4,2,2
26,28,2,10,16,-6
26,28,3,5,11,-6
26,28,4,17,26,-9
26,28,5,11,6,5
26,28,6,21,14,7
26,28,7,14,16,-2
26,28,8,18,19,-1
26,28,9,16,7,9
26,28,10,19,24,-5
26,28,11,10,2,8
26,28,12,10,20,-10
26,28,13,6,3,3
26,28,14,13,11,2
26,28,15,14,11,3
26,28,16,6,8,-2
26,28,17,11,9,2
26,28,18,16,6,10
26,28,19,12,13,-1
26,28,20,18,13,5
26,28,21,11,13,-2
26,28,22,11,19,-8
26,28,23,5,4,1
26,28,24,12,12,0
26,28,25,9,12,-3
26,28,26,17,11,6
26,28,27,16,17,-1
26,28,28,4,19,-15
26,28,29,9,11,-2
26,28,30,14,11,3
26,28,31,14,10,4
26,28,32,12,19,-7
26,28,33,10,18,-8
26,28,34,28,22,6
26,28,35,5,16,-11
26,28,36,17,15,2
26,28,37,23,12,11
26,28,38,13,19,-6
26,28,39,12,17,-5
26,28,40,15,16,-1
26,28,41,4,4,0
26,28,42,16,15,1
26,28,43,12,8,4
26,28,44,10,21,-11
26,28,45,20,11,9
26,28,46,11,5,6
26,28,47,10,15,-5
26,28,48,8,21,-13
26,28,49,10,15,-5
26,28,50,8,4,4
26,28,51,20,25,-5
26,28,52,11,10,1
26,28,53,21,13,8
26,28,54,13,16,-3
26,28,55,11,11,0
26,28,56,9,13,-4
26,28,57,12,21,-9
26,28,58,4,6,-2
26,28,59,14,15,-1
26,28,60,19,11,8
26,28,61,9,17,-8
26,28,62,12,11,1
26,28,63,10,13,-3
26,28,64,13,20,-7
26,28,65,15,10,5
26,28,66,19,15,4
26,28,67,18,22,-4
26,28,68,9,11,-2
26,28,69,11,8,3
26,28,70,23,9,14
26,28,71,12,8,4
26,28,72,14,16,-2
26,28,73,12,15,-3
26,28,74,9,8,1
26,28,75,2,8,-6
26,28,76,9,14,-5
26,28,77,18,22,-4
26,28,78,15,26,-11
26,28,79,22,14,8
26,28,80,5,5,0
26,28,81,15,16,-1
26,28,82,10,18,-8
26,28,83,7,8,-1
26,28,84,16,18,-2
26,28,85,17,25,-8
26,28,86,9,10,-1
26,28,87,13,8,5
26,28,88,14,14,0
26,28,89,19,5,14
26,28,90,7,9,-2
26,28,91,13,12,1
26,28,92,10,14,-4
26,28,93,19,18,1
26,28,94,19,22,-3
26,28,95,11,22,-11
26,28,96,13,15,-2
26,28,97,7,15,-8
26,28,98,10,10,0
26,28,99,11,10,1
26,28,100,16,19,-3
26,28,101,12,23,-11
26,28,102,2,11,-9
26,28,103,13,8,5
26,28,104,15,10,5
26,28,105,23,17,6
26,28,106,8,17,-9
26,28,107,7,9,-2
26,28,108,13,14,-1
26,28,109,7,13,-6
26,28,110,16,18,-2
26,28,111,17,13,4
26,28,112,21,15,6
26,28,113,10,5,5
26,28,114,17,22,-5
26,28,115,13,8,5
26,28,116,11,11,0
26,28,117,9,15,-6
26,28,118,19,14,5
26,28,119,13,5,8
26,28,120,17,22,-5
26,28,121,8,19,-11
26,28,122,10,10,0
26,28,123,11,14,-3
26,28,124,10,15,-5
26,28,125,9,7,2
26,28,126,8,14,-6
26,28,127,11,11,0
26,28,128,8,13,-5
26,28,129,19,23,-4
26,28,130,15,23,-8
26,28,131,15,4,11
26,28,132,8,22,-14
26,28,133,16,7,9
26,28,134,7,11,-4
26,28,135,12,16,-4
26,28,136,13,11,2
26,28,137,12,5,7
26,28,138,15,20,-5
26,28,139,9,17,-8
26,28,140,15,9,6
26,28,141,11,10,1
26,28,142,9,20,-11
26,28,143,6,3,3
26,28,144,10,12,-2
26,28,145,10,13,-3
26,28,146,17,13,4
26,28,147,14,9,5
26,28,148,12,10,2
26,28,149,19,11,8
26,28,150,4,14,-10
26,28,151,11,26,-15
26,28,152,5,13,-8
26,28,153,11,16,-5
26,28,154,18,12,6
26,28,155,5,11,-6
26,28,156,24,12,12
26,28,157,9,13,-4
26,28,158,6,9,-3
26,28,159,10,8,2
26,28,160,21,27,-6
26,28,161,9,16,-7
26,28,162,8,15,-7
26,28,163,13,10,3
26,28,164,6,12,-6
26,28,165,18,13,5
26,28,166,12,17,-5
26,28,167,16,14,2
26,28,168,7,16,-9
26,28,169,11,13,-2
26,28,170,19,10,9
26,28,171,9,12,-3
26,28,172,9,19,-10
26,28,173,9,16,-7
26,28,174,11,13,-2
26,28,175,12,12,0
26,28,176,9,13,-4
26,28,177,15,22,-7
26,28,178,17,12,5
26,28,179,6,10,-4
26,28,180,11,23,-12
26,28,181,18,25,-7
26,28,182,2,16,-14
26,28,183,10,9,1
26,28,184,16,17,-1
26,28,185,14,6,8
26,28,186,12,15,-3
26,28,187,16,14,2
26,28,188,23,27,-4
26,28,189,18,14,4
26,28,190,10,13,-3
26,28,191,3,6,-3
26,28,192,12,12,0
26,28,193,2,10,-8
26,28,194,19,17,2
26,28,195,11,12,-1
26,28,196,9,12,-3
26,28,197,11,11,0
26,28,198,14,9,5
26,28,199,2,4,-2
26,28,200,12,17,-5
26,28,201,10,6,4
26,28,202,13,9,4
26,28,203,16,10,6
26,28,204,21,7,14
26,28,205,16,17,-1
26,28,206,9,6,3
26,28,207,12,19,-7
26,28,208,16,11,5
26,28,209,9,5,4
26,28,210,15,10,5
26,28,211,22,9,13
26,28,212,10,21,-11
26,28,213,10,7,3
26,28,214,19,5,14
26,28,215,7,14,-7
26,28,216,12,9,3
26,28,217,8,5,3
26,28,218,6,14,-8
26,28,219,9,11,-2
26,28,220,24,14,10
26,28,221,8,13,-5
26,28,222,16,22,-6
26,28,223,6,21,-15
26,28,224,19,13,6
26,28,225,14,11,3
26,28,226,5,13,-8
26,28,227,8,17,-9
26,28,228,20,15,5
26,28,229,20,7,13
26,28,230,8,11,-3
26,28,231,6,4,2
26,28,232,7,14,-7
26,28,233,11,10,1
26,28,234,29,15,14
26,28,235,22,11,11
26,28,236,24,29,-5
26,28,237,15,17,-2
26,28,238,13,17,-4
26,28,239,8,7,1
26,28,240,16,18,-2
26,28,241,5,13,-8
26,28,242,13,7,6
26,28,243,10,11,-1
26,28,244,11,15,-4
26,28,245,14,9,5
26,28,246,21,17,4
26,28,247,11,10,1
26,28,248,7,6,1
26,28,249,15,10,5
26,28,250,1,10,-9
26,28,251,10,16,-6
26,28,252,10,14,-4
26,28,253,20,10,10
26,28,254,7,4,3
26,28,255,7,8,-1
26,28,256,12,16,-4
26,28,257,14,27,-13
26,28,258,17,12,5
26,28,259,20,9,11
26,28,260,8,12,-4
26,28,261,15,18,-3
26,28,262,8,12,-4
26,28,263,15,17,-2
26,28,264,9,15,-6
26,28,265,12,12,0
26,28,266,10,14,-4
26,28,267,14,17,-3
26,28,268,19,15,4
26,28,269,13,11,2
26,28,270,19,12,7
26,28,271,9,13,-4
26,28,272,21,20,1
26,28,273,9,16,-7
26,28,274,12,16,-4
26,28,275,9,14,-5
26,28,276,7,30,-23
26,28,277,7,20,-13
26,28,278,7,4,3
26,28,279,21,17,4
26,28,280,6,13,-7
26,28,281,17,16,1
26,28,282,9,5,4
26,28,283,10,19,-9
26,28,284,13,11,2
26,28,285,13,12,1
26,28,286,7,7,0
26,28,287,16,18,-2
26,28,288,18,25,-7
26,28,289,16,11,5
26,28,290,8,5,3
26,28,291,12,14,-2
26,28,292,8,14,-6
26,28,293,17,23,-6
26,28,294,5,11,-6
26,28,295,24,16,8
26,28,296,7,17,-10
26,28,297,14,10,4
26,28,298,22,20,2
26,28,299,27,22,5
26,29,0,15,18,-3
26,29,1,7,5,2
26,29,2,5,4,1
26,29,3,17,11,6
26,29,4,14,21,-7
26,29,5,17,4,13
26,29,6,13,19,-6
26,29,7,9,10,-1
26,29,8,13,17,-4
26,29,9,7,8,-1
26,29,10,10,18,-8
26,29,11,7,8,-1
26,29,12,24,15,9
26,29,13,6,11,-5
26,29,14,10,8,2
26,29,15,10,9,1
26,29,16,7,12,-5
26,29,17,3,8,-5
26,29,18,11,12,-1
26,29,19,4,4,0
26,29,20,7,13,-6
26,29,21,12,13,-1
26,29,22,19,11,8
26,29,23,16,21,-5
26,29,24,12,11,1
26,29,25,15,16,-1
26,29,26,24,20,4
26,29,27,17,19,-2
26,29,28,7,20,-13
26,29,29,23,12,11
26,29,30,11,13,-2
26,29,31,6,17,-11
26,29,32,10,15,-5
26,29,33,12,20,-8
26,29,34,14,15,-1
26,29,35,16,8,8
26,29,36,20,11,9
26,29,37,6,8,-2
26,29,38,4,4,0
26,29,39,11,8,3
26,29,40,14,14,0
26,29,41,11,10,1
26,29,42,7,8,-1
26,29,43,5,8,-3
26,29,44,17,19,-2
26,29,45,17,13,4
26,29,46,4,3,1
26,29,47,13,12,1
26,29,48,7,8,-1
26,29,49,23,12,11
26,29,50,11,30,-19
26,29,51,10,8,2
26,29,52,16,13,3
26,29,53,14,17,-3
26,29,54,23,12,11
26,29,55,13,10,3
26,29,56,5,2,3
26,29,57,4,6,-2
26,29,58,18,18,0
26,29,59,6,13,-7
26,29,60,8,21,-13
26,29,61,12,15,-3
26,29,62,10,4,6
26,29,63,4,7,-3
26,29,64,18,27,-9
26,29,65,17,8,9
26,29,66,11,7,4
26,29,67,12,6,6
26,29,68,7,6,1
26,29,69,18,18,0
26,29,70,11,8,3
26,29,71,3,5,-2
26,29,72,18,15,3
26,29,73,15,5,10
26,29,74,7,13,-6
26,29,75,8,8,0
26,29,76,11,10,1
26,29,77,7,15,-8
26,29,78,11,9,2
26,29,79,11,4,7
26,29,80,11,10,1
26,29,81,6,13,-7
26,29,82,17,14,3
26,29,83,7,7,0
26,29,84,16,12,4
26,29,85,7,11,-4
26,29,86,10,8,2
26,29,87,11,19,-8
26,29,88,8,11,-3
26,29,89,18,12,6
26,29,90,12,16,-4
26,29,91,15,10,5
26,29,92,10,10,0
26,29,93,10,12,-2
26,29,94,16,17,-1
26,29,95,10,15,-5
26,29,96,12,9,3
26,29,97,14,12,2
26,29,98,14,10,4
26,29,99,5,15,-10
26,29,100,14,11,3
26,29,101,14,19,-5
26,29,102,15,17,-2
26,29,103,7,6,1
26,29,104,21,11,10
26,29,105,13,17,-4
26,29,106,14,23,-9
26,29,107,8,16,-8
26,29,108,14,15,-1
26,29,109,8,7,1
26,29,110,19,18,1
26,29,111,9,14,-5
26,29,112,10,12,-2
26,29,113,15,13,2
26,29,114,13,22,-9
26,29,115,18,15,3
26,29,116,12,1,11
26,29,117,11,22,-11
26,29,118,18,11,7
26,29,119,11,6,5
26,29,120,15,8,7
26,29,121,9,6,3
26,29,122,12,8,4
26,29,123,23,14,9
26,29,124,8,20,-12
26,29,125,9,5,4
26,29,126,11,3,8
26,29,127,14,14,0
26,29,128,22,22,0
26,29,129,4,5,-1
26,29,130,12,12,0
26,29,131,13,12,1
26,29,132,13,7,6
26,29,133,25,29,-4
26,29,134,21,9,12
26,29,135,8,9,-1
26,29,136,11,10,1
26,29,137,14,7,7
26,29,138,19,19,0
26,29,139,18,14,4
26,29,140,11,4,7
26,29,141,30,13,17
26,29,142,13,13,0
26,29,143,13,3,10
26,29,144,18,14,4
26,29,145,5,12,-7
26,29,146,4,0,4
26,29,147,27,22,5
26,29,148,19,21,-2
26,29,149,12,14,-2
26,29,150,7,15,-8
26,29,151,9,11,-2
26,29,152,10,7,3
26,29,153,12,7,5
26,29,154,2,14,-12
26,29,155,9,6,3
26,29,156,13,9,4
26,29,157,11,10,1
26,29,158,22,11,11
26,29,159,23,16,7
26,29,160,12,10,2
26,29,161,21,16,5
26,29,162,10,9,1
26,29,163,14,11,3
26,29,164,14,9,5
26,29,165,10,8,2
26,29,166,3,20,-17
26,29,167,24,14,10
26,29,168,10,17,-7
26,29,169,11,14,-3
26,29,170,9,14,-5
26,29,171,13,9,4
26,29,172,6,7,-1
26,29,173,9,14,-5
26,29,174,16,24,-8
26,29,175,9,17,-8
26,29,176,13,28,-15
26,29,177,20,11,9
26,29,178,11,8,3
26,29,179,19,16,3
26,29,180,13,11,2
26,29,181,10,18,-8
26,29,182,14,14,0
26,29,183,11,14,-3
26,29,184,10,12,-2
26,29,185,12,12,0
26,29,186,19,9,10
26,29,187,18,14,4
26,29,188,15,14,1
26,29,189,11,9,2
26,29,190,4,10,-6
26,29,191,9,7,2
26,29,192,16,11,5
26,29,193,6,5,1
26,29,194,12,13,-1
26,29,195,13,10,3
26,29,196,14,9,5
26,29,197,18,12,6
26,29,198,11,9,2
26,29,199,11,4,7
26,29,200,15,7,8
26,29,201,11,15,-4
26,29,202,16,8,8
26,29,203,15,11,4
26,29,204,25,9,16
26,29,205,6,11,-5
26,29,206,15,9,6
26,29,207,4,10,-6
26,29,208,17,13,4
26,29,209,7,13,-6
26,29,210,13,10,3
26,29,211,9,8,1
26,29,212,14,8,6
26,29,213,6,6,0
26,29,214,33,20,13
26,29,215,10,17,-7
26,29,216,15,17,-2
26,29,217,7,14,-7
26,29,218,6,8,-2
26,29,219,11,13,-2
26,29,220,11,12,-1
26,29,221,14,17,-3
26,29,222,20,24,-4
26,29,223,6,8,-2
26,29,224,20,8,12
26,29,225,19,22,-3
26,29,226,9,2,7
26,29,227,13,9,4
26,29,228,15,15,0
26,29,229,15,10,5
26,29,230,16,22,-6
26,29,231,13,10,3
26,29,232,14,11,3
26,29,233,15,10,5
26,29,234,11,12,-1
26,29,235,14,11,3
26,29,236,20,25,-5
26,29,237,10,10,0
26,29,238,16,7,9
26,29,239,14,21,-7
26,29,240,7,4,3
26,29,241,9,8,1
26,29,242,9,12,-3
26,29,243,13,16,-3
26,29,244,16,13,3
26,29,245,13,10,3
26,29,246,15,18,-3
26,29,247,13,12,1
26,29,248,4,4,0
26,29,249,10,8,2
26,29,250,13,12,1
26,29,251,12,13,-1
26,29,252,12,11,1
26,29,253,14,9,5
26,29,254,7,17,-10
26,29,255,14,24,-10
26,29,256,9,12,-3
26,29,257,15,13,2
26,29,258,17,10,7
26,29,259,9,14,-5
26,29,260,4,5,-1
26,29,261,8,14,-6
26,29,262,17,6,11
26,29,263,12,10,2
26,29,264,15,10,5
26,29,265,11,5,6
26,29,266,14,13,1
26,29,267,13,14,-1
26,29,268,8,21,-13
26,29,269,10,13,-3
26,29,270,13,12,1
26,29,271,14,9,5
26,29,272,12,8,4
26,29,273,8,15,-7
26,29,274,6,7,-1
26,29,275,16,18,-2
26,29,276,23,15,8
26,29,277,12,10,2
26,29,278,12,7,5
26,29,279,9,8,1
26,29,280,12,20,-8
26,29,281,10,18,-8
26,29,282,19,13,6
26,29,283,12,5,7
26,29,284,14,14,0
26,29,285,9,12,-3
26,29,286,19,17,2
26,29,287,7,11,-4
26,29,288,15,8,7
26,29,289,19,11,8
26,29,290,23,15,8
26,29,291,14,18,-4
26,29,292,20,8,12
26,29,293,10,13,-3
26,29,294,14,3,11
26,29,295,12,13,-1
26,29,296,12,11,1
26,29,297,13,5,8
26,29,298,12,9,3
26,29,299,9,19,-10
26,30,0,13,8,5
26,30,1,14,31,-17
26,30,2,9,13,-4
26,30,3,17,16,1
26,30,4,9,17,-8
26,30,5,8,8,0
26,30,6,10,7,3
26,30,7,12,13,-1
26,30,8,14,21,-7
26,30,9,17,21,-4
26,30,10,10,11,-1
26,30,11,14,14,0
26,30,12,10,13,-3
26,30,13,16,13,3
26,30,14,16,17,-1
26,30,15,20,9,11
26,30,16,12,8,4
26,30,17,13,21,-8
26,30,18,5,4,1
26,30,19,4,6,-2
26,30,20,17,8,9
26,30,21,7,17,-10
26,30,22,9,9,0
26,30,23,27,21,6
26,30,24,14,15,-1
26,30,25,7,2,5
26,30,26,14,8,6
26,30,27,23,7,16
26,30,28,7,17,-10
26,30,29,14,30,-16
26,30,30,8,0,8
26,30,31,10,6,4
26,30,32,12,14,-2
26,30,33,8,10,-2
26,30,34,10,13,-3
26,30,35,9,13,-4
26,30,36,12,19,-7
26,30,37,12,10,2
26,30,38,16,17,-1
26,30,39,1,12,-11
26,30,40,8,10,-2
26,30,41,12,8,4
26,30,42,14,17,-3
26,30,43,18,15,3
26,30,44,12,4,8
26,30,45,7,8,-1
26,30,46,13,7,6
26,30,47,16,13,3
26,30,48,12,10,2
26,30,49,17,19,-2
26,30,50,15,12,3
26,30,51,8,16,-8
26,30,52,19,15,4
26,30,53,16,16,0
26,30,54,13,8,5
26,30,55,14,14,0
26,30,56,10,17,-7
26,30,57,16,15,1
26,30,58,18,10,8
26,30,59,7,9,-2
26,30,60,10,20,-10
26,30,61,13,16,-3
26,30,62,2,10,-8
26,30,63,11,16,-5
26,30,64,8,8,0
26,30,65,15,12,3
26,30,66,9,14,-5
26,30,67,13,12,1
26,30,68,13,21,-8
26,30,69,17,16,1
26,30,70,18,10,8
26,30,71,5,10,-5
26,30,72,8,8,0
26,30,73,11,13,-2
26,30,74,21,14,7
26,30,75,13,6,7
26,30,76,13,11,2
26,30,77,12,20,-8
26,30,78,13,15,-2
26,30,79,22,15,7
26,30,80,13,16,-3
26,30,81,7,15,-8
26,30,82,31,21,10
26,30,83,22,14,8
26,30,84,1,7,-6
26,30,85,24,13,11
26,30,86,19,24,-5
26,30,87,3,4,-1
26,30,88,9,18,-9
26,30,89,15,23,-8
26,30,90,13,11,2
26,30,91,20,14,6
26,30,92,9,15,-6
26,30,93,16,16,0
26,30,94,17,23,-6
26,30,95,15,17,-2
26,30,96,5,10,-5
26,30,97,12,13,-1
26,30,98,12,7,5
26,30,99,6,12,-6
26,30,100,4,12,-8
26,30,101,7,8,-1
26,30,102,12,14,-2
26,30,103,19,12,7
26,30,104,11,13,-2
26,30,105,6,12,-6
26,30,106,7,15,-8
26,30,107,14,8,6
26,30,108,13,8,5
26,30,109,22,7,15
26,30,110,9,13,-4
26,30,111,18,12,6
26,30,112,16,5,11
26,30,113,14,13,1
26,30,114,20,18,2
26,30,115,11,8,3
26,30,116,24,22,2
26,30,117,17,20,-3
26,30,118,11,23,-12
26,30,119,17,18,-1
26,30,120,18,21,-3
26,30,121,9,10,-1
26,30,122,10,14,-4
26,30,123,26,18,8
26,30,124,22,12,10
26,30,125,9,12,-3
26,30,126,10,17,-7
26,30,127,11,15,-4
26,30,128,11,11,0
26,30,129,9,16,-7
26,30,130,12,8,4
26,30,131,9,7,2
26,30,132,15,16,-1
26,30,133,14,7,7
26,30,134,12,13,-1
26,30,135,19,16,3
26,30,136,14,8,6
26,30,137,5,13,-8
26,30,138,18,7,11
26,30,139,17,18,-1
26,30,140,9,13,-4
26,30,141,14,12,2
26,30,142,15,12,3
26,30,143,31,18,13
26,30,144,8,14,-6
26,30,145,21,17,4
26,30,146,11,8,3
26,30,147,15,12,3
26,30,148,17,10,7
26,30,149,6,4,2
26,30,150,17,10,7
26,30,151,9,8,1
26,30,152,12,21,-9
26,30,153,13,17,-4
26,30,154,16,15,1
26,30,155,8,14,-6
26,30,156,16,13,3
26,30,157,9,16,-7
26,30,158,11,13,-2
26,30,159,6,4,2
26,30,160,17,8,9
26,30,161,15,10,5
26,30,162,9,5,4
26,30,163,5,14,-9
26,30,164,17,12,5
26,30,165,18,14,4
26,30,166,6,6,0
26,30,167,8,7,1
26,30,168,7,12,-5
26,30,169,16,21,-5
26,30,170,20,8,12
26,30,171,12,13,-1
26,30,172,14,16,-2
26,30,173,8,7,1
26,30,174,14,17,-3
26,30,175,6,4,2
26,30,176,15,4,11
26,30,177,15,8,7
26,30,178,5,18,-13
26,30,179,14,14,0
26,30,180,13,3,10
26,30,181,18,18,0
26,30,182,21,10,11
26,30,183,9,6,3
26,30,184,9,4,5
26,30,185,21,16,5
26,30,186,9,13,-4
26,30,187,6,11,-5
26,30,188,19,17,2
26,30,189,8,13,-5
26,30,190,12,11,1
26,30,191,12,12,0
26,30,192,7,12,-5
26,30,193,12,10,2
26,30,194,5,14,-9
26,30,195,18,4,14
26,30,196,8,2,6
26,30,197,14,14,0
26,30,198,20,16,4
26,30,199,12,5,7
26,30,200,14,21,-7
26,30,201,19,13,6
26,30,202,10,13,-3
26,30,203,7,11,-4
26,30,204,9,9,0
26,30,205,12,8,4
26,30,206,14,9,5
26,30,207,11,8,3
26,30,208,8,8,0
26,30,209,18,11,7
26,30,210,16,12,4
26,30,211,15,15,0
26,30,212,12,9,3
26,30,213,4,10,-6
26,30,214,9,9,0
26,30,215,13,11,2
26,30,216,15,6,9
26,30,217,18,11,7
26,30,218,20,12,8
26,30,219,11,19,-8
26,30,220,7,19,-12
26,30,221,4,3,1
26,30,222,9,14,-5
26,30,223,8,8,0
26,30,224,14,9,5
26,30,225,16,18,-2
26,30,226,13,3,10
26,30,227,14,7,7
26,30,228,9,11,-2
26,30,229,10,18,-8
26,30,230,12,14,-2
26,30,231,9,10,-1
26,30,232,12,21,-9
26,30,233,12,12,0
26,30,234,18,16,2
26,30,235,11,12,-1
26,30,236,5,11,-6
26,30,237,14,19,-5
26,30,238,18,12,6
26,30,239,9,10,-1
26,30,240,22,19,3
26,30,241,11,10,1
26,30,242,13,13,0
26,30,243,8,10,-2
26,30,244,13,12,1
26,30,245,6,15,-9
26,30,246,14,21,-7
26,30,247,16,12,4
26,30,248,1,2,-1
26,30,249,14,6,8
26,30,250,12,9,3
26,30,251,14,12,2
26,30,252,16,16,0
26,30,253,7,6,1
26,30,254,10,6,4
26,30,255,9,26,-17
26,30,256,19,14,5
26,30,257,21,20,1
26,30,258,12,8,4
26,30,259,14,11,3
26,30,260,11,12,-1
26,30,261,11,17,-6
26,30,262,10,8,2
26,30,263,2,3,-1
26,30,264,14,4,10
26,30,265,19,7,12
26,30,266,11,13,-2
26,30,267,11,14,-3
26,30,268,5,12,-7
26,30,269,7,22,-15
26,30,270,10,10,0
26,30,271,8,8,0
26,30,272,17,10,7
26,30,273,19,22,-3
26,30,274,9,17,-8
26,30,275,7,8,-1
26,30,276,10,9,1
26,30,277,9,13,-4
26,30,278,5,6,-1
26,30,279,14,4,10
26,30,280,13,8,5
26,30,281,12,19,-7
26,30,282,4,8,-4
26,30,283,17,15,2
26,30,284,9,7,2
26,30,285,17,9,8
26,30,286,10,7,3
26,30,287,14,13,1
26,30,288,7,3,4
26,30,289,19,20,-1
26,30,290,11,9,2
26,30,291,10,9,1
26,30,292,15,10,5
26,30,293,16,7,9
26,30,294,14,12,2
26,30,295,17,12,5
26,30,296,8,13,-5
26,30,297,14,14,0
26,30,298,13,14,-1
26,30,299,18,25,-7
27,1,0,3,18,-15
27,1,1,1,2,-1
27,1,2,10,21,-11
27,1,3,7,9,-2
27,1,4,7,28,-21
27,1,5,4,17,-13
27,1,6,12,21,-9
27,1,7,9,25,-16
27,1,8,8,23,-15
27,1,9,3,18,-15
27,1,10,11,9,2
27,1,11,3,31,-28
27,1,12,7,18,-11
27,1,13,6,13,-7
27,1,14,14,24,-10
27,1,15,9,26,-17
27,1,16,15,14,1
27,1,17,6,18,-12
27,1,18,13,23,-10
27,1,19,8,27,-19
27,1,20,8,13,-5
27,1,21,8,10,-2
27,1,22,4,17,-13
27,1,23,8,22,-14
27,1,24,7,17,-10
27,1,25,6,25,-19
27,1,26,5,11,-6
27,1,27,2,10,-8
27,1,28,7,17,-10
27,1,29,7,30,-23
27,1,30,9,24,-15
27,1,31,1,7,-6
27,1,32,15,34,-19
27,1,33,2,9,-7
27,1,34,3,10,-7
27,1,35,5,19,-14
27,1,36,4,11,-7
27,1,37,3,16,-13
27,1,38,10,19,-9
27,1,39,3,34,-31
27,1,40,6,20,-14
27,1,41,7,19,-12
27,1,42,11,17,-6
27,1,43,10,11,-1
27,1,44,6,22,-16
27,1,45,15,24,-9
27,1,46,7,13,-6
27,1,47,3,27,-24
27,1,48,10,38,-28
27,1,49,7,13,-6
27,1,50,4,3,1
27,1,51,2,25,-23
27,1,52,7,18,-11
27,1,53,9,6,3
27,1,54,9,9,0
27,1,55,9,14,-5
27,1,56,13,38,-25
27,1,57,9,17,-8
27,1,58,12,20,-8
27,1,59,6,25,-19
27,1,60,6,10,-4
27,1,61,6,20,-14
27,1,62,9,14,-5
27,1,63,16,23,-7
27,1,64,9,23,-14
27,1,65,13,15,-2
27,1,66,4,24,-20
27,1,67,2,6,-4
27,1,68,9,12,-3
27,1,69,5,12,-7
27,1,70,7,12,-5
27,1,71,8,27,-19
27,1,72,5,23,-18
27,1,73,12,22,-10
27,1,74,1,11,-10
27,1,75,1,15,-14
27,1,76,2,17,-15
27,1,77,7,15,-8
27,1,78,4,11,-7
27,1,79,10,15,-5
27,1,80,11,12,-1
27,1,81,4,23,-19
27,1,82,14,16,-2
27,1,83,11,9,2
27,1,84,12,33,-21
27,1,85,5,24,-19
27,1,86,5,11,-6
27,1,87,2,11,-9
27,1,88,9,24,-15
27,1,89,5,13,-8
27,1,90,15,37,-22
27,1,91,5,27,-22
27,1,92,7,16,-9
27,1,93,6,25,-19
27,1,94,8,14,-6
27,1,95,9,13,-4
27,1,96,5,8,-3
27,1,97,6,8,-2
27,1,98,10,25,-15
27,1,99,6,19,-13
27,1,100,9,28,-19
27,1,101,11,8,3
27,1,102,4,13,-9
27,1,103,7,14,-7
27,1,104,16,13,3
27,1,105,0,23,-23
27,1,106,7,21,-14
27,1,107,9,19,-10
27,1,108,4,10,-6
27,1,109,10,20,-10
27,1,110,3,16,-13
27,1,111,10,12,-2
27,1,112,1,9,-8
27,1,113,3,32,-29
27,1,114,7,7,0
27,1,115,12,22,-10
27,1,116,10,7,3
27,1,117,4,10,-6
27,1,118,5,15,-10
27,1,119,7,17,-10
27,1,120,3,9,-6
27,1,121,7,7,0
27,1,122,9,17,-8
27,1,123,12,32,-20
27,1,124,5,17,-12
27,1,125,5,12,-7
27,1,126,1,3,-2
27,1,127,4,25,-21
27,1,128,6,12,-6
27,1,129,10,17,-7
27,1,130,3,17,-14
27,1,131,14,22,-8
27,1,132,10,11,-1
27,1,133,8,7,1
27,1,134,4,4,0
27,1,135,3,17,-14
27,1,136,6,9,-3
27,1,137,3,6,-3
27,1,138,4,10,-6
27,1,139,2,8,-6
27,1,140,5,16,-11
27,1,141,2,11,-9
27,1,142,3,10,-7
27,1,143,11,20,-9
27,1,144,5,5,0
27,1,145,9,23,-14
27,1,146,1,8,-7
27,1,147,7,12,-5
27,1,148,14,25,-11
27,1,149,8,8,0
27,1,150,7,23,-16
27,1,151,2,17,-15
27,1,152,7,11,-4
27,1,153,13,37,-24
27,1,154,7,22,-15
27,1,155,2,13,-11
27,1,156,3,17,-14
27,1,157,12,24,-12
27,1,158,4,12,-8
27,1,159,5,13,-8
27,1,160,3,16,-13
27,1,161,7,15,-8
27,1,162,10,22,-12
27,1,163,2,4,-2
27,1,164,9,21,-12
27,1,165,6,16,-10
27,1,166,0,9,-9
27,1,167,11,13,-2
27,1,168,14,18,-4
27,1,169,4,12,-8
27,1,170,5,16,-11
27,1,171,5,13,-8
27,1,172,8,7,1
27,1,173,6,8,-2
27,1,174,6,8,-2
27,1,175,12,10,2
27,1,176,17,26,-9
27,1,177,10,19,-9
27,1,178,3,16,-13
27,1,179,8,4,4
27,1,180,4,13,-9
27,1,181,2,11,-9
27,1,182,11,20,-9
27,1,183,14,18,-4
27,1,184,3,15,-12
27,1,185,7,9,-2
27,1,186,6,19,-13
27,1,187,12,21,-9
27,1,188,9,16,-7
27,1,189,15,20,-5
27,1,190,5,7,-2
27,1,191,6,28,-22
27,1,192,8,19,-11
27,1,193,8,23,-15
27,1,194,5,17,-12
27,1,195,7,20,-13
27,1,196,2,11,-9
27,1,197,1,23,-22
27,1,198,2,9,-7
27,1,199,9,23,-14
27,1,200,3,10,-7
27,1,201,5,18,-13
27,1,202,9,8,1
27,1,203,0,10,-10
27,1,204,8,26,-18
27,1,205,5,11,-6
27,1,206,7,14,-7
27,1,207,5,14,-9
27,1,208,9,12,-3
27,1,209,12,14,-2
27,1,210,7,7,0
27,1,211,8,7,1
27,1,212,4,16,-12
27,1,213,2,9,-7
27,1,214,5,26,-21
27,1,215,8,25,-17
27,1,216,4,19,-15
27,1,217,5,11,-6
27,1,218,6,10,-4
27,1,219,4,22,-18
27,1,220,8,14,-6
27,1,221,6,19,-13
27,1,222,7,20,-13
27,1,223,2,7,-5
27,1,224,9,20,-11
27,1,225,12,25,-13
27,1,226,4,11,-7
27,1,227,9,18,-9
27,1,228,4,12,-8
27,1,229,4,6,-2
27,1,230,10,15,-5
27,1,231,5,20,-15
27,1,232,11,35,-24
27,1,233,15,37,-22
27,1,234,4,11,-7
27,1,235,5,11,-6
27,1,236,12,13,-1
27,1,237,7,16,-9
27,1,238,9,16,-7
27,1,239,7,17,-10
27,1,240,10,13,-3
27,1,241,7,23,-16
27,1,242,15,25,-10
27,1,243,6,5,1
27,1,244,2,13,-11
27,1,245,12,32,-20
27,1,246,2,12,-10
27,1,247,6,10,-4
27,1,248,7,14,-7
27,1,249,9,14,-5
27,1,250,9,10,-1
27,1,251,2,6,-4
27,1,252,7,18,-11
27,1,253,9,25,-16
27,1,254,6,13,-7
27,1,255,5,4,1
27,1,256,7,26,-19
27,1,257,5,10,-5
27,1,258,6,14,-8
27,1,259,8,15,-7
27,1,260,4,17,-13
27,1,261,7,12,-5
27,1,262,7,15,-8
27,1,263,7,17,-10
27,1,264,5,10,-5
27,1,265,12,10,2
27,1,266,6,17,-11
27,1,267,15,25,-10
27,1,268,8,21,-13
27,1,269,3,22,-19
27,1,270,2,23,-21
27,1,271,7,15,-8
27,1,272,9,26,-17
27,1,273,7,15,-8
27,1,274,23,27,-4
27,1,275,9,17,-8
27,1,276,1,25,-24
27,1,277,6,17,-11
27,1,278,10,14,-4
27,1,279,8,10,-2
27,1,280,8,14,-6
27,1,281,4,6,-2
27,1,282,5,17,-12
27,1,283,12,22,-10
27,1,284,17,23,-6
27,1,285,5,16,-11
27,1,286,8,11,-3
27,1,287,10,18,-8
27,1,288,8,11,-3
27,1,289,5,16,-11
27,1,290,9,10,-1
27,1,291,12,26,-14
27,1,292,1,20,-19
27,1,293,5,8,-3
27,1,294,8,13,-5
27,1,295,4,14,-10
27,1,296,8,31,-23
27,1,297,3,12,-9
27,1,298,9,17,-8
27,1,299,6,20,-14
27,2,0,9,12,-3
27,2,1,8,16,-8
27,2,2,8,18,-10
27,2,3,12,14,-2
27,2,4,10,27,-17
27,2,5,18,19,-1
27,2,6,18,36,-18
27,2,7,1,18,-17
27,2,8,9,6,3
27,2,9,2,28,-26
27,2,10,4,17,-13
27,2,11,5,25,-20
27,2,12,16,23,-7
27,2,13,14,18,-4
27,2,14,2,26,-24
27,2,15,6,9,-3
27,2,16,6,7,-1
27,2,17,4,10,-6
27,2,18,10,30,-20
27,2,19,14,22,-8
27,2,20,11,20,-9
27,2,21,5,15,-10
27,2,22,10,16,-6
27,2,23,7,9,-2
27,2,24,4,13,-9
27,2,25,10,7,3
27,2,26,2,16,-14
27,2,27,9,18,-9
27,2,28,10,18,-8
27,2,29,4,13,-9
27,2,30,2,15,-13
27,2,31,11,19,-8
27,2,32,7,15,-8
27,2,33,4,27,-23
27,2,34,4,4,0
27,2,35,4,17,-13
27,2,36,8,19,-11
27,2,37,6,16,-10
27,2,38,6,20,-14
27,2,39,13,13,0
27,2,40,8,17,-9
27,2,41,2,16,-14
27,2,42,2,9,-7
27,2,43,7,21,-14
27,2,44,13,17,-4
27,2,45,11,18,-7
27,2,46,11,12,-1
27,2,47,12,27,-15
27,2,48,8,29,-21
27,2,49,14,31,-17
27,2,50,5,14,-9
27,2,51,7,4,3
27,2,52,5,26,-21
27,2,53,10,25,-15
27,2,54,9,14,-5
27,2,55,1,10,-9
27,2,56,8,18,-10
27,2,57,13,16,-3
27,2,58,9,19,-10
27,2,59,4,16,-12
27,2,60,3,23,-20
27,2,61,5,17,-12
27,2,62,6,12,-6
27,2,63,5,20,-15
27,2,64,6,11,-5
27,2,65,10,9,1
27,2,66,12,21,-9
27,2,67,7,25,-18
27,2,68,1,8,-7
27,2,69,6,12,-6
27,2,70,5,13,-8
27,2,71,7,18,-11
27,2,72,14,18,-4
27,2,73,8,23,-15
27,2,74,9,15,-6
27,2,75,12,29,-17
27,2,76,7,18,-11
27,2,77,16,28,-12
27,2,78,9,15,-6
27,2,79,13,21,-8
27,2,80,5,16,-11
27,2,81,2,4,-2
27,2,82,11,22,-11
27,2,83,8,17,-9
27,2,84,7,32,-25
27,2,85,10,17,-7
27,2,86,10,20,-10
27,2,87,7,28,-21
27,2,88,7,21,-14
27,2,89,2,16,-14
27,2,90,4,18,-14
27,2,91,9,25,-16
27,2,92,4,16,-12
27,2,93,5,14,-9
27,2,94,3,8,-5
27,2,95,3,23,-20
27,2,96,6,40,-34
27,2,97,6,19,-13
27,2,98,4,12,-8
27,2,99,6,20,-14
27,2,100,3,16,-13
27,2,101,2,13,-11
27,2,102,11,22,-11
27,2,103,17,11,6
27,2,104,9,23,-14
27,2,105,3,23,-20
27,2,106,6,10,-4
27,2,107,4,10,-6
27,2,108,8,28,-20
27,2,109,4,19,-15
27,2,110,6,18,-12
27,2,111,9,11,-2
27,2,112,6,18,-12
27,2,113,6,21,-15
27,2,114,4,31,-27
27,2,115,7,14,-7
27,2,116,5,20,-15
27,2,117,13,16,-3
27,2,118,9,7,2
27,2,119,9,20,-11
27,2,120,3,12,-9
27,2,121,4,17,-13
27,2,122,11,20,-9
27,2,123,7,15,-8
27,2,124,5,15,-10
27,2,125,20,12,8
27,2,126,4,18,-14
27,2,127,10,9,1
27,2,128,12,23,-11
27,2,129,13,22,-9
27,2,130,7,15,-8
27,2,131,9,14,-5
27,2,132,5,22,-17
27,2,133,2,10,-8
27,2,134,9,26,-17
27,2,135,15,21,-6
27,2,136,4,21,-17
27,2,137,2,20,-18
27,2,138,11,12,-1
27,2,139,11,19,-8
27,2,140,5,19,-14
27,2,141,9,18,-9
27,2,142,9,24,-15
27,2,143,8,30,-22
27,2,144,5,20,-15
27,2,145,7,14,-7
27,2,146,2,26,-24
27,2,147,5,19,-14
27,2,148,11,32,-21
27,2,149,9,14,-5
27,2,150,8,38,-30
27,2,151,8,24,-16
27,2,152,6,19,-13
27,2,153,11,26,-15
27,2,154,5,20,-15
27,2,155,9,18,-9
27,2,156,4,14,-10
27,2,157,5,25,-20
27,2,158,3,22,-19
27,2,159,6,16,-10
27,2,160,6,19,-13
27,2,161,9,19,-10
27,2,162,1,10,-9
27,2,163,3,9,-6
27,2,164,7,22,-15
27,2,165,11,22,-11
27,2,166,11,14,-3
27,2,167,6,9,-3
27,2,168,8,17,-9
27,2,169,5,13,-8
27,2,170,14,23,-9
27,2,171,17,19,-2
27,2,172,5,24,-19
27,2,173,5,13,-8
27,2,174,0,17,-17
27,2,175,9,18,-9
27,2,176,6,19,-13
27,2,177,9,21,-12
27,2,178,5,16,-11
27,2,179,11,19,-8
27,2,180,1,5,-4
27,2,181,7,27,-20
27,2,182,9,26,-17
27,2,183,3,26,-23
27,2,184,1,20,-19
27,2,185,5,17,-12
27,2,186,7,36,-29
27,2,187,6,19,-13
27,2,188,12,27,-15
27,2,189,9,17,-8
27,2,190,7,18,-11
27,2,191,11,24,-13
27,2,192,5,12,-7
27,2,193,9,19,-10
27,2,194,6,12,-6
27,2,195,4,22,-18
27,2,196,7,18,-11
27,2,197,5,8,-3
27,2,198,5,22,-17
27,2,199,6,9,-3
27,2,200,5,24,-19
27,2,201,3,19,-16
27,2,202,7,13,-6
27,2,203,5,25,-20
27,2,204,9,22,-13
27,2,205,9,12,-3
27,2,206,7,26,-19
27,2,207,1,36,-35
27,2,208,4,9,-5
27,2,209,6,12,-6
27,2,210,11,9,2
27,2,211,13,19,-6
27,2,212,18,25,-7
27,2,213,7,33,-26
27,2,214,16,19,-3
27,2,215,8,8,0
27,2,216,9,28,-19
27,2,217,13,21,-8
27,2,218,14,19,-5
27,2,219,3,5,-2
27,2,220,14,24,-10
27,2,221,4,26,-22
27,2,222,7,29,-22
27,2,223,5,17,-12
27,2,224,13,33,-20
27,2,225,4,14,-10
27,2,226,3,7,-4
27,2,227,5,12,-7
27,2,228,7,14,-7
27,2,229,4,17,-13
27,2,230,17,14,3
27,2,231,3,17,-14
27,2,232,7,20,-13
27,2,233,1,24,-23
27,2,234,13,14,-1
27,2,235,8,19,-11
27,2,236,6,22,-16
27,2,237,11,20,-9
27,2,238,9,3,6
27,2,239,10,12,-2
27,2,240,9,17,-8
27,2,241,9,21,-12
27,2,242,13,16,-3
27,2,243,9,9,0
27,2,244,9,33,-24
27,2,245,6,18,-12
27,2,246,7,19,-12
27,2,247,10,15,-5
27,2,248,10,14,-4
27,2,249,7,28,-21
27,2,250,12,35,-23
27,2,251,9,12,-3
27,2,252,8,9,-1
27,2,253,12,21,-9
27,2,254,12,27,-15
27,2,255,10,19,-9
27,2,256,2,14,-12
27,2,257,12,18,-6
27,2,258,7,30,-23
27,2,259,6,17,-11
27,2,260,10,18,-8
27,2,261,12,29,-17
27,2,262,10,27,-17
27,2,263,7,24,-17
27,2,264,14,13,1
27,2,265,7,20,-13
27,2,266,8,22,-14
27,2,267,8,23,-15
27,2,268,4,20,-16
27,2,269,6,25,-19
27,2,270,7,9,-2
27,2,271,9,15,-6
27,2,272,11,18,-7
27,2,273,11,37,-26
27,2,274,5,15,-10
27,2,275,8,14,-6
27,2,276,6,17,-11
27,2,277,9,16,-7
27,2,278,9,16,-7
27,2,279,6,18,-12
27,2,280,2,12,-10
27,2,281,13,20,-7
27,2,282,5,16,-11
27,2,283,7,21,-14
27,2,284,8,10,-2
27,2,285,3,15,-12
27,2,286,8,19,-11
27,2,287,10,19,-9
27,2,288,8,22,-14
27,2,289,11,13,-2
27,2,290,7,21,-14
27,2,291,8,28,-20
27,2,292,8,17,-9
27,2,293,13,32,-19
27,2,294,7,16,-9
27,2,295,5,25,-20
27,2,296,6,26,-20
27,2,297,3,6,-3
27,2,298,9,7,2
27,2,299,5,9,-4
27,3,0,10,21,-11
27,3,1,7,35,-28
27,3,2,0,11,-11
27,3,3,10,19,-9
27,3,4,9,12,-3
27,3,5,7,12,-5
27,3,6,5,16,-11
27,3,7,7,12,-5
27,3,8,4,25,-21
27,3,9,11,22,-11
27,3,10,6,22,-16
27,3,11,11,26,-15
27,3,12,6,3,3
27,3,13,2,17,-15
27,3,14,6,21,-15
27,3,15,7,18,-11
27,3,16,12,21,-9
27,3,17,8,22,-14
27,3,18,12,16,-4
27,3,19,4,19,-15
27,3,20,6,16,-10
27,3,21,11,12,-1
27,3,22,9,11,-2
27,3,23,14,23,-9
27,3,24,8,20,-12
27,3,25,10,18,-8
27,3,26,13,19,-6
27,3,27,4,42,-38
27,3,28,12,21,-9
27,3,29,6,3,3
27,3,30,16,33,-17
27,3,31,6,12,-6
27,3,32,14,16,-2
27,3,33,11,10,1
27,3,34,11,21,-10
27,3,35,3,16,-13
27,3,36,8,19,-11
27,3,37,2,12,-10
27,3,38,16,28,-12
27,3,39,13,20,-7
27,3,40,16,13,3
27,3,41,14,20,-6
27,3,42,11,15,-4
27,3,43,16,19,-3
27,3,44,12,17,-5
27,3,45,8,12,-4
27,3,46,3,23,-20
27,3,47,4,19,-15
27,3,48,14,17,-3
27,3,49,20,23,-3
27,3,50,8,13,-5
27,3,51,16,34,-18
27,3,52,19,17,2
27,3,53,12,19,-7
27,3,54,5,18,-13
27,3,55,16,29,-13
27,3,56,12,8,4
27,3,57,8,25,-17
27,3,58,9,16,-7
27,3,59,13,31,-18
27,3,60,4,14,-10
27,3,61,9,23,-14
27,3,62,7,16,-9
27,3,63,6,18,-12
27,3,64,10,18,-8
27,3,65,12,33,-21
27,3,66,2,13,-11
27,3,67,13,26,-13
27,3,68,9,16,-7
27,3,69,14,21,-7
27,3,70,5,18,-13
27,3,71,12,32,-20
27,3,72,8,20,-12
27,3,73,6,8,-2
27,3,74,6,17,-11
27,3,75,10,14,-4
27,3,76,15,21,-6
27,3,77,6,17,-11
27,3,78,15,23,-8
27,3,79,9,20,-11
27,3,80,4,16,-12
27,3,81,12,35,-23
27,3,82,7,20,-13
27,3,83,6,24,-18
27,3,84,1,8,-7
27,3,85,7,17,-10
27,3,86,4,15,-11
27,3,87,9,13,-4
27,3,88,10,34,-24
27,3,89,10,24,-14
27,3,90,3,17,-14
27,3,91,8,19,-11
27,3,92,6,17,-11
27,3,93,4,23,-19
27,3,94,9,15,-6
27,3,95,14,13,1
27,3,96,9,23,-14
27,3,97,11,23,-12
27,3,98,4,20,-16
27,3,99,12,23,-11
27,3,100,0,9,-9
27,3,101,10,24,-14
27,3,102,4,21,-17
27,3,103,6,27,-21
27,3,104,16,23,-7
27,3,105,12,32,-20
27,3,106,5,36,-31
27,3,107,6,20,-14
27,3,108,11,20,-9
27,3,109,7,11,-4
27,3,110,17,24,-7
27,3,111,6,8,-2
27,3,112,10,19,-9
27,3,113,4,31,-27
27,3,114,11,20,-9
27,3,115,13,28,-15
27,3,116,8,17,-9
27,3,117,10,33,-23
27,3,118,2,15,-13
27,3,119,9,9,0
27,3,120,5,27,-22
27,3,121,12,25,-13
27,3,122,9,7,2
27,3,123,6,13,-7
27,3,124,12,14,-2
27,3,125,15,24,-9
27,3,126,7,17,-10
27,3,127,17,20,-3
27,3,128,3,17,-14
27,3,129,5,12,-7
27,3,130,4,29,-25
27,3,131,8,19,-11
27,3,132,6,17,-11
27,3,133,15,31,-16
27,3,134,4,14,-10
27,3,135,7,18,-11
27,3,136,10,15,-5
27,3,137,10,25,-15
27,3,138,6,29,-23
27,3,139,3,17,-14
27,3,140,8,17,-9
27,3,141,11,25,-14
27,3,142,9,39,-30
27,3,143,13,15,-2
27,3,144,4,18,-14
27,3,145,11,15,-4
27,3,146,4,15,-11
27,3,147,3,24,-21
27,3,148,7,15,-8
27,3,149,5,5,0
27,3,150,8,10,-2
27,3,151,9,24,-15
27,3,152,6,19,-13
27,3,153,6,10,-4
27,3,154,8,21,-13
27,3,155,5,20,-15
27,3,156,6,18,-12
27,3,157,5,17,-12
27,3,158,8,22,-14
27,3,159,3,28,-25
27,3,160,0,8,-8
27,3,161,14,20,-6
27,3,162,8,20,-12
27,3,163,12,17,-5
27,3,164,14,22,-8
27,3,165,12,21,-9
27,3,166,5,27,-22
27,3,167,11,17,-6
27,3,168,10,17,-7
27,3,169,12,23,-11
27,3,170,7,15,-8
27,3,171,8,16,-8
27,3,172,10,16,-6
27,3,173,6,30,-24
27,3,174,5,24,-19
27,3,175,3,3,0
27,3,176,9,15,-6
27,3,177,12,29,-17
27,3,178,9,27,-18
27,3,179,15,23,-8
27,3,180,7,14,-7
27,3,181,15,21,-6
27,3,182,6,16,-10
27,3,183,1,17,-16
27,3,184,7,15,-8
27,3,185,15,19,-4
27,3,186,3,12,-9
27,3,187,9,7,2
27,3,188,9,20,-11
27,3,189,15,25,-10
27,3,190,12,30,-18
27,3,191,13,19,-6
27,3,192,11,15,-4
27,3,193,2,17,-15
27,3,194,6,24,-18
27,3,195,3,16,-13
27,3,196,4,18,-14
27,3,197,8,21,-13
27,3,198,9,27,-18
27,3,199,7,36,-29
27,3,200,7,10,-3
27,3,201,6,10,-4
27,3,202,11,17,-6
27,3,203,3,15,-12
27,3,204,6,8,-2
27,3,205,1,19,-18
27,3,206,4,20,-16
27,3,207,4,5,-1
27,3,208,20,28,-8
27,3,209,6,19,-13
27,3,210,9,15,-6
27,3,211,5,27,-22
27,3,212,12,13,-1
27,3,213,9,10,-1
27,3,214,16,23,-7
27,3,215,12,24,-12
27,3,216,10,26,-16
27,3,217,3,13,-10
27,3,218,7,11,-4
27,3,219,5,14,-9
27,3,220,9,26,-17
27,3,221,2,29,-27
27,3,222,9,31,-22
27,3,223,9,23,-14
27,3,224,7,10,-3
27,3,225,21,30,-9
27,3,226,7,22,-15
27,3,227,5,30,-25
27,3,228,15,18,-3
27,3,229,3,28,-25
27,3,230,12,14,-2
27,3,231,6,22,-16
27,3,232,7,14,-7
27,3,233,16,11,5
27,3,234,3,21,-18
27,3,235,11,23,-12
27,3,236,2,28,-26
27,3,237,7,10,-3
27,3,238,4,24,-20
27,3,239,10,16,-6
27,3,240,7,25,-18
27,3,241,8,25,-17
27,3,242,11,17,-6
27,3,243,11,35,-24
27,3,244,6,10,-4
27,3,245,8,12,-4
27,3,246,9,14,-5
27,3,247,9,24,-15
27,3,248,11,27,-16
27,3,249,5,37,-32
27,3,250,6,37,-31
27,3,251,6,17,-11
27,3,252,9,25,-16
27,3,253,9,28,-19
27,3,254,9,19,-10
27,3,255,2,15,-13
27,3,256,1,8,-7
27,3,257,15,18,-3
27,3,258,11,29,-18
27,3,259,9,15,-6
27,3,260,13,23,-10
27,3,261,1,11,-10
27,3,262,3,18,-15
27,3,263,10,18,-8
27,3,264,9,21,-12
27,3,265,8,16,-8
27,3,266,12,21,-9
27,3,267,14,18,-4
27,3,268,8,14,-6
27,3,269,8,26,-18
27,3,270,5,21,-16
27,3,271,11,29,-18
27,3,272,5,20,-15
27,3,273,16,21,-5
27,3,274,12,21,-9
27,3,275,4,24,-20
27,3,276,2,10,-8
27,3,277,9,8,1
27,3,278,6,28,-22
27,3,279,12,12,0
27,3,280,14,17,-3
27,3,281,11,25,-14
27,3,282,5,13,-8
27,3,283,4,6,-2
27,3,284,2,14,-12
27,3,285,14,12,2
27,3,286,3,13,-10
27,3,287,10,22,-12
27,3,288,11,13,-2
27,3,289,9,21,-12
27,3,290,8,25,-17
27,3,291,12,24,-12
27,3,292,7,13,-6
27,3,293,3,14,-11
27,3,294,10,23,-13
27,3,295,11,22,-11
27,3,296,9,11,-2
27,3,297,6,23,-17
27,3,298,8,26,-18
27,3,299,26,26,0
27,4,0,10,25,-15
27,4,1,9,24,-15
27,4,2,11,31,-20
27,4,3,10,28,-18
27,4,4,11,16,-5
27,4,5,9,28,-19
27,4,6,6,33,-27
27,4,7,0,13,-13
27,4,8,9,7,2
27,4,9,7,13,-6
27,4,10,8,33,-25
27,4,11,6,23,-17
27,4,12,7,19,-12
27,4,13,7,15,-8
27,4,14,12,31,-19
27,4,15,11,20,-9
27,4,16,10,20,-10
27,4,17,3,9,-6
27,4,18,9,20,-11
27,4,19,14,32,-18
27,4,20,9,21,-12
27,4,21,7,9,-2
27,4,22,12,21,-9
27,4,23,6,21,-15
27,4,24,12,17,-5
27,4,25,13,23,-10
27,4,26,2,16,-14
27,4,27,4,18,-14
27,4,28,11,22,-11
27,4,29,7,13,-6
27,4,30,6,13,-7
27,4,31,9,15,-6
27,4,32,11,15,-4
27,4,33,8,27,-19
27,4,34,10,11,-1
27,4,35,8,23,-15
27,4,36,6,6,0
27,4,37,4,23,-19
27,4,38,5,17,-12
27,4,39,7,12,-5
27,4,40,10,29,-19
27,4,41,8,15,-7
27,4,42,4,15,-11
27,4,43,7,28,-21
27,4,44,5,14,-9
27,4,45,11,20,-9
27,4,46,5,9,-4
27,4,47,10,10,0
27,4,48,4,13,-9
27,4,49,7,29,-22
27,4,50,6,15,-9
27,4,51,4,7,-3
27,4,52,5,13,-8
27,4,53,16,18,-2
27,4,54,6,18,-12
27,4,55,5,11,-6
27,4,56,2,14,-12
27,4,57,8,25,-17
27,4,58,9,22,-13
27,4,59,0,15,-15
27,4,60,6,28,-22
27,4,61,14,28,-14
27,4,62,15,32,-17
27,4,63,6,14,-8
27,4,64,6,7,-1
27,4,65,12,31,-19
27,4,66,5,21,-16
27,4,67,8,9,-1
27,4,68,10,19,-9
27,4,69,6,23,-17
27,4,70,6,16,-10
27,4,71,15,21,-6
27,4,72,9,17,-8
27,4,73,12,24,-12
27,4,74,22,24,-2
27,4,75,6,17,-11
27,4,76,5,7,-2
27,4,77,7,18,-11
27,4,78,10,39,-29
27,4,79,13,10,3
27,4,80,6,18,-12
27,4,81,13,18,-5
27,4,82,16,35,-19
27,4,83,15,33,-18
27,4,84,3,21,-18
27,4,85,18,21,-3
27,4,86,7,10,-3
27,4,87,4,18,-14
27,4,88,9,10,-1
27,4,89,12,21,-9
27,4,90,11,27,-16
27,4,91,8,16,-8
27,4,92,6,21,-15
27,4,93,7,13,-6
27,4,94,7,25,-18
27,4,95,7,9,-2
27,4,96,16,25,-9
27,4,97,3,20,-17
27,4,98,2,32,-30
27,4,99,9,17,-8
27,4,100,12,29,-17
27,4,101,6,14,-8
27,4,102,11,19,-8
27,4,103,12,13,-1
27,4,104,10,14,-4
27,4,105,9,29,-20
27,4,106,0,10,-10
27,4,107,2,28,-26
27,4,108,6,10,-4
27,4,109,7,16,-9
27,4,110,10,14,-4
27,4,111,7,17,-10
27,4,112,11,24,-13
27,4,113,6,23,-17
27,4,114,7,2,5
27,4,115,16,25,-9
27,4,116,5,29,-24
27,4,117,12,9,3
27,4,118,1,17,-16
27,4,119,2,24,-22
27,4,120,14,18,-4
27,4,121,6,16,-10
27,4,122,7,33,-26
27,4,123,10,11,-1
27,4,124,5,14,-9
27,4,125,11,18,-7
27,4,126,16,13,3
27,4,127,13,36,-23
27,4,128,6,11,-5
27,4,129,10,23,-13
27,4,130,15,25,-10
27,4,131,11,25,-14
27,4,132,12,14,-2
27,4,133,7,16,-9
27,4,134,20,31,-11
27,4,135,5,16,-11
27,4,136,6,34,-28
27,4,137,9,13,-4
27,4,138,6,19,-13
27,4,139,7,20,-13
27,4,140,15,26,-11
27,4,141,8,33,-25
27,4,142,11,26,-15
27,4,143,8,27,-19
27,4,144,18,40,-22
27,4,145,9,24,-15
27,4,146,6,23,-17
27,4,147,11,24,-13
27,4,148,8,16,-8
27,4,149,2,16,-14
27,4,150,17,29,-12
27,4,151,11,28,-17
27,4,152,13,20,-7
27,4,153,10,26,-16
27,4,154,4,15,-11
27,4,155,4,13,-9
27,4,156,9,25,-16
27,4,157,13,19,-6
27,4,158,5,16,-11
27,4,159,14,20,-6
27,4,160,15,27,-12
27,4,161,7,17,-10
27,4,162,6,18,-12
27,4,163,8,12,-4
27,4,164,10,24,-14
27,4,165,10,22,-12
27,4,166,8,27,-19
27,4,167,13,26,-13
27,4,168,15,11,4
27,4,169,2,4,-2
27,4,170,9,17,-8
27,4,171,3,17,-14
27,4,172,6,20,-14
27,4,173,3,26,-23
27,4,174,14,25,-11
27,4,175,9,26,-17
27,4,176,22,26,-4
27,4,177,3,14,-11
27,4,178,11,26,-15
27,4,179,14,19,-5
27,4,180,5,5,0
27,4,181,7,27,-20
27,4,182,7,12,-5
27,4,183,15,25,-10
27,4,184,10,24,-14
27,4,185,12,23,-11
27,4,186,2,6,-4
27,4,187,4,12,-8
27,4,188,10,19,-9
27,4,189,7,18,-11
27,4,190,7,12,-5
27,4,191,9,10,-1
27,4,192,11,19,-8
27,4,193,5,29,-24
27,4,194,3,16,-13
27,4,195,8,9,-1
27,4,196,3,27,-24
27,4,197,6,8,-2
27,4,198,3,20,-17
27,4,199,4,8,-4
27,4,200,5,15,-10
27,4,201,6,12,-6
27,4,202,7,16,-9
27,4,203,9,29,-20
27,4,204,8,25,-17
27,4,205,12,13,-1
27,4,206,6,19,-13
27,4,207,4,29,-25
27,4,208,14,29,-15
27,4,209,4,13,-9
27,4,210,4,24,-20
27,4,211,13,25,-12
27,4,212,15,25,-10
27,4,213,7,28,-21
27,4,214,5,24,-19
27,4,215,5,14,-9
27,4,216,7,23,-16
27,4,217,7,25,-18
27,4,218,4,18,-14
27,4,219,16,24,-8
27,4,220,5,15,-10
27,4,221,12,17,-5
27,4,222,6,10,-4
27,4,223,8,29,-21
27,4,224,11,30,-19
27,4,225,8,22,-14
27,4,226,5,12,-7
27,4,227,4,12,-8
27,4,228,6,20,-14
27,4,229,15,27,-12
27,4,230,2,38,-36
27,4,231,12,29,-17
27,4,232,6,31,-25
27,4,233,8,31,-23
27,4,234,6,24,-18
27,4,235,5,12,-7
27,4,236,11,34,-23
27,4,237,9,16,-7
27,4,238,8,8,0
27,4,239,8,17,-9
27,4,240,7,15,-8
27,4,241,8,15,-7
27,4,242,5,15,-10
27,4,243,7,24,-17
27,4,244,7,25,-18
27,4,245,18,22,-4
27,4,246,4,23,-19
27,4,247,13,7,6
27,4,248,8,17,-9
27,4,249,8,17,-9
27,4,250,13,40,-27
27,4,251,8,14,-6
27,4,252,10,25,-15
27,4,253,3,26,-23
27,4,254,9,16,-7
27,4,255,3,38,-35
27,4,256,14,19,-5
27,4,257,14,18,-4
27,4,258,12,22,-10
27,4,259,19,24,-5
27,4,260,10,21,-11
27,4,261,11,11,0
27,4,262,11,8,3
27,4,263,6,23,-17
27,4,264,9,22,-13
27,4,265,10,13,-3
27,4,266,4,13,-9
27,4,267,15,29,-14
27,4,268,7,26,-19
27,4,269,6,25,-19
27,4,270,4,40,-36
27,4,271,5,22,-17
27,4,272,4,14,-10
27,4,273,9,20,-11
27,4,274,3,10,-7
27,4,275,9,23,-14
27,4,276,4,14,-10
27,4,277,12,19,-7
27,4,278,15,24,-9
27,4,279,2,16,-14
27,4,280,13,22,-9
27,4,281,9,17,-8
27,4,282,7,10,-3
27,4,283,5,17,-12
27,4,284,6,20,-14
27,4,285,13,14,-1
27,4,286,4,20,-16
27,4,287,2,16,-14
27,4,288,4,22,-18
27,4,289,7,22,-15
27,4,290,23,50,-27
27,4,291,8,16,-8
27,4,292,11,21,-10
27,4,293,4,18,-14
27,4,294,4,25,-21
27,4,295,7,20,-13
27,4,296,16,21,-5
27,4,297,17,24,-7
27,4,298,16,16,0
27,4,299,10,11,-1
27,5,0,6,18,-12
27,5,1,7,28,-21
27,5,2,8,20,-12
27,5,3,7,13,-6
27,5,4,8,15,-7
27,5,5,8,20,-12
27,5,6,8,24,-16
27,5,7,6,18,-12
27,5,8,4,17,-13
27,5,9,8,21,-13
27,5,10,7,54,-47
27,5,11,16,21,-5
27,5,12,9,22,-13
27,5,13,11,29,-18
27,5,14,13,20,-7
27,5,15,6,26,-20
27,5,16,3,17,-14
27,5,17,13,24,-11
27,5,18,4,16,-12
27,5,19,11,28,-17
27,5,20,6,13,-7
27,5,21,3,20,-17
27,5,22,4,10,-6
27,5,23,10,20,-10
27,5,24,7,23,-16
27,5,25,8,11,-3
27,5,26,11,19,-8
27,5,27,5,17,-12
27,5,28,9,8,1
27,5,29,2,7,-5
27,5,30,9,26,-17
27,5,31,18,42,-24
27,5,32,7,16,-9
27,5,33,5,27,-22
27,5,34,14,14,0
27,5,35,7,38,-31
27,5,36,14,19,-5
27,5,37,12,32,-20
27,5,38,9,21,-12
27,5,39,4,4,0
27,5,40,7,28,-21
27,5,41,5,20,-15
27,5,42,4,25,-21
27,5,43,2,9,-7
27,5,44,7,15,-8
27,5,45,5,11,-6
27,5,46,8,18,-10
27,5,47,11,30,-19
27,5,48,11,28,-17
27,5,49,11,17,-6
27,5,50,8,21,-13
27,5,51,4,21,-17
27,5,52,6,17,-11
27,5,53,3,13,-10
27,5,54,5,13,-8
27,5,55,7,19,-12
27,5,56,8,32,-24
27,5,57,5,16,-11
27,5,58,2,16,-14
27,5,59,6,31,-25
27,5,60,21,21,0
27,5,61,10,7,3
27,5,62,2,19,-17
27,5,63,0,15,-15
27,5,64,3,19,-16
27,5,65,6,10,-4
27,5,66,13,22,-9
27,5,67,7,29,-22
27,5,68,5,14,-9
27,5,69,12,20,-8
27,5,70,10,24,-14
27,5,71,6,25,-19
27,5,72,8,18,-10
27,5,73,7,25,-18
27,5,74,23,22,1
27,5,75,5,25,-20
27,5,76,7,13,-6
27,5,77,10,22,-12
27,5,78,9,33,-24
27,5,79,11,25,-14
27,5,80,5,28,-23
27,5,81,7,20,-13
27,5,82,20,25,-5
27,5,83,6,15,-9
27,5,84,18,36,-18
27,5,85,3,29,-26
27,5,86,9,24,-15
27,5,87,6,20,-14
27,5,88,9,15,-6
27,5,89,8,15,-7
27,5,90,5,24,-19
27,5,91,10,23,-13
27,5,92,15,26,-11
27,5,93,6,33,-27
27,5,94,11,15,-4
27,5,95,4,7,-3
27,5,96,5,15,-10
27,5,97,2,28,-26
27,5,98,13,11,2
27,5,99,5,28,-23
27,5,100,13,31,-18
27,5,101,7,17,-10
27,5,102,16,18,-2
27,5,103,11,9,2
27,5,104,6,22,-16
27,5,105,4,38,-34
27,5,106,10,21,-11
27,5,107,13,21,-8
27,5,108,9,27,-18
27,5,109,12,26,-14
27,5,110,1,25,-24
27,5,111,9,27,-18
27,5,112,15,37,-22
27,5,113,5,12,-7
27,5,114,12,29,-17
27,5,115,9,6,3
27,5,116,1,6,-5
27,5,117,0,14,-14
27,5,118,8,22,-14
27,5,119,3,11,-8
27,5,120,11,15,-4
27,5,121,14,18,-4
27,5,122,12,23,-11
27,5,123,4,28,-24
27,5,124,2,12,-10
27,5,125,16,21,-5
27,5,126,8,17,-9
27,5,127,7,31,-24
27,5,128,13,19,-6
27,5,129,8,26,-18
27,5,130,11,24,-13
27,5,131,6,14,-8
27,5,132,6,19,-13
27,5,133,4,22,-18
27,5,134,8,12,-4
27,5,135,10,14,-4
27,5,136,8,26,-18
27,5,137,9,24,-15
27,5,138,8,39,-31
27,5,139,13,28,-15
27,5,140,16,16,0
27,5,141,12,25,-13
27,5,142,12,20,-8
27,5,143,5,22,-17
27,5,144,5,12,-7
27,5,145,3,19,-16
27,5,146,9,20,-11
27,5,147,7,24,-17
27,5,148,21,40,-19
27,5,149,9,11,-2
27,5,150,4,23,-19
27,5,151,12,16,-4
27,5,152,8,17,-9
27,5,153,13,19,-6
27,5,154,10,18,-8
27,5,155,13,20,-7
27,5,156,6,27,-21
27,5,157,7,5,2
27,5,158,4,24,-20
27,5,159,6,6,0
27,5,160,5,22,-17
27,5,161,16,31,-15
27,5,162,4,18,-14
27,5,163,4,14,-10
27,5,164,9,20,-11
27,5,165,7,20,-13
27,5,166,10,30,-20
27,5,167,5,21,-16
27,5,168,6,20,-14
27,5,169,7,11,-4
27,5,170,6,19,-13
27,5,171,19,19,0
27,5,172,5,11,-6
27,5,173,2,34,-32
27,5,174,7,20,-13
27,5,175,15,18,-3
27,5,176,19,31,-12
27,5,177,12,20,-8
27,5,178,10,17,-7
27,5,179,3,27,-24
27,5,180,9,22,-13
27,5,181,2,14,-12
27,5,182,11,19,-8
27,5,183,16,16,0
27,5,184,15,26,-11
27,5,185,4,10,-6
27,5,186,11,22,-11
27,5,187,12,28,-16
27,5,188,7,25,-18
27,5,189,8,18,-10
27,5,190,4,25,-21
27,5,191,5,23,-18
27,5,192,6,28,-22
27,5,193,20,16,4
27,5,194,4,32,-28
27,5,195,8,17,-9
27,5,196,12,22,-10
27,5,197,14,22,-8
27,5,198,7,27,-20
27,5,199,7,16,-9
27,5,200,10,28,-18
27,5,201,6,18,-12
27,5,202,11,17,-6
27,5,203,14,26,-12
27,5,204,3,12,-9
27,5,205,15,38,-23
27,5,206,8,27,-19
27,5,207,16,18,-2
27,5,208,8,33,-25
27,5,209,16,19,-3
27,5,210,5,29,-24
27,5,211,5,27,-22
27,5,212,3,21,-18
27,5,213,5,31,-26
27,5,214,7,20,-13
27,5,215,9,19,-10
27,5,216,12,35,-23
27,5,217,12,31,-19
27,5,218,13,23,-10
27,5,219,15,31,-16
27,5,220,8,8,0
27,5,221,13,16,-3
27,5,222,2,11,-9
27,5,223,3,18,-15
27,5,224,7,22,-15
27,5,225,10,8,2
27,5,226,9,10,-1
27,5,227,2,27,-25
27,5,228,18,25,-7
27,5,229,13,22,-9
27,5,230,10,29,-19
27,5,231,12,23,-11
27,5,232,9,17,-8
27,5,233,5,27,-22
27,5,234,6,26,-20
27,5,235,6,17,-11
27,5,236,15,26,-11
27,5,237,14,26,-12
27,5,238,11,24,-13
27,5,239,10,20,-10
27,5,240,8,35,-27
27,5,241,7,24,-17
27,5,242,0,8,-8
27,5,243,23,26,-3
27,5,244,5,26,-21
27,5,245,12,29,-17
27,5,246,10,16,-6
27,5,247,15,18,-3
27,5,248,9,27,-18
27,5,249,14,16,-2
27,5,250,6,27,-21
27,5,251,9,30,-21
27,5,252,2,26,-24
27,5,253,14,18,-4
27,5,254,16,21,-5
27,5,255,9,23,-14
27,5,256,3,25,-22
27,5,257,16,16,0
27,5,258,5,28,-23
27,5,259,8,21,-13
27,5,260,4,19,-15
27,5,261,5,26,-21
27,5,262,5,16,-11
27,5,263,11,27,-16
27,5,264,13,27,-14
27,5,265,23,39,-16
27,5,266,13,30,-17
27,5,267,15,19,-4
27,5,268,6,19,-13
27,5,269,5,20,-15
27,5,270,9,17,-8
27,5,271,10,23,-13
27,5,272,5,33,-28
27,5,273,10,17,-7
27,5,274,11,14,-3
27,5,275,7,13,-6
27,5,276,14,58,-44
27,5,277,12,38,-26
27,5,278,0,19,-19
27,5,279,35,25,10
27,5,280,5,13,-8
27,5,281,9,16,-7
27,5,282,9,24,-15
27,5,283,5,16,-11
27,5,284,2,17,-15
27,5,285,6,11,-5
27,5,286,5,22,-17
27,5,287,7,30,-23
27,5,288,9,33,-24
27,5,289,11,10,1
27,5,290,13,15,-2
27,5,291,18,24,-6
27,5,292,9,20,-11
27,5,293,7,22,-15
27,5,294,6,14,-8
27,5,295,12,18,-6
27,5,296,3,15,-12
27,5,297,15,37,-22
27,5,298,7,12,-5
27,5,299,5,12,-7
27,6,0,14,19,-5
27,6,1,8,18,-10
27,6,2,12,35,-23
27,6,3,7,34,-27
27,6,4,3,14,-11
27,6,5,5,13,-8
27,6,6,9,24,-15
27,6,7,16,17,-1
27,6,8,3,21,-18
27,6,9,9,17,-8
27,6,10,12,16,-4
27,6,11,11,32,-21
27,6,12,3,9,-6
27,6,13,7,10,-3
27,6,14,10,15,-5
27,6,15,5,30,-25
27,6,16,13,25,-12
27,6,17,17,18,-1
27,6,18,10,20,-10
27,6,19,10,15,-5
27,6,20,8,25,-17
27,6,21,10,20,-10
27,6,22,10,13,-3
27,6,23,11,17,-6
27,6,24,9,13,-4
27,6,25,10,19,-9
27,6,26,13,25,-12
27,6,27,10,9,1
27,6,28,5,24,-19
27,6,29,4,14,-10
27,6,30,13,21,-8
27,6,31,7,15,-8
27,6,32,2,15,-13
27,6,33,18,21,-3
27,6,34,8,21,-13
27,6,35,13,16,-3
27,6,36,16,21,-5
27,6,37,17,26,-9
27,6,38,6,24,-18
27,6,39,16,22,-6
27,6,40,8,17,-9
27,6,41,4,21,-17
27,6,42,9,31,-22
27,6,43,9,22,-13
27,6,44,9,24,-15
27,6,45,5,11,-6
27,6,46,6,18,-12
27,6,47,12,32,-20
27,6,48,12,17,-5
27,6,49,18,26,-8
27,6,50,5,15,-10
27,6,51,3,20,-17
27,6,52,4,13,-9
27,6,53,8,22,-14
27,6,54,15,18,-3
27,6,55,12,16,-4
27,6,56,12,20,-8
27,6,57,8,12,-4
27,6,58,3,12,-9
27,6,59,17,44,-27
27,6,60,14,24,-10
27,6,61,10,14,-4
27,6,62,10,20,-10
27,6,63,5,10,-5
27,6,64,9,22,-13
27,6,65,13,13,0
27,6,66,11,15,-4
27,6,67,15,25,-10
27,6,68,3,33,-30
27,6,69,12,19,-7
27,6,70,9,28,-19
27,6,71,6,8,-2
27,6,72,5,33,-28
27,6,73,3,15,-12
27,6,74,7,16,-9
27,6,75,3,13,-10
27,6,76,12,30,-18
27,6,77,7,7,0
27,6,78,11,29,-18
27,6,79,8,15,-7
27,6,80,2,12,-10
27,6,81,8,29,-21
27,6,82,12,23,-11
27,6,83,14,33,-19
27,6,84,7,14,-7
27,6,85,16,24,-8
27,6,86,20,21,-1
27,6,87,9,27,-18
27,6,88,29,18,11
27,6,89,3,31,-28
27,6,90,6,15,-9
27,6,91,7,24,-17
27,6,92,17,24,-7
27,6,93,7,23,-16
27,6,94,10,36,-26
27,6,95,16,37,-21
27,6,96,8,33,-25
27,6,97,7,39,-32
27,6,98,0,20,-20
27,6,99,10,18,-8
27,6,100,12,22,-10
27,6,101,12,19,-7
27,6,102,9,10,-1
27,6,103,9,26,-17
27,6,104,6,28,-22
27,6,105,22,28,-6
27,6,106,5,12,-7
27,6,107,5,18,-13
27,6,108,11,16,-5
27,6,109,3,21,-18
27,6,110,4,11,-7
27,6,111,13,24,-11
27,6,112,2,23,-21
27,6,113,3,13,-10
27,6,114,9,17,-8
27,6,115,12,24,-12
27,6,116,8,11,-3
27,6,117,3,9,-6
27,6,118,7,15,-8
27,6,119,11,25,-14
27,6,120,5,19,-14
27,6,121,9,20,-11
27,6,122,8,22,-14
27,6,123,10,29,-19
27,6,124,18,27,-9
27,6,125,5,19,-14
27,6,126,23,12,11
27,6,127,8,33,-25
27,6,128,7,17,-10
27,6,129,9,21,-12
27,6,130,7,18,-11
27,6,131,6,18,-12
27,6,132,3,18,-15
27,6,133,20,18,2
27,6,134,6,16,-10
27,6,135,13,37,-24
27,6,136,5,21,-16
27,6,137,16,26,-10
27,6,138,19,21,-2
27,6,139,5,9,-4
27,6,140,12,23,-11
27,6,141,7,15,-8
27,6,142,5,23,-18
27,6,143,16,32,-16
27,6,144,10,25,-15
27,6,145,4,9,-5
27,6,146,6,6,0
27,6,147,8,18,-10
27,6,148,17,23,-6
27,6,149,15,24,-9
27,6,150,9,18,-9
27,6,151,10,14,-4
27,6,152,6,16,-10
27,6,153,13,35,-22
27,6,154,15,17,-2
27,6,155,10,28,-18
27,6,156,3,19,-16
27,6,157,4,15,-11
27,6,158,7,18,-11
27,6,159,7,16,-9
27,6,160,15,19,-4
27,6,161,0,10,-10
27,6,162,8,22,-14
27,6,163,6,33,-27
27,6,164,6,13,-7
27,6,165,16,29,-13
27,6,166,13,16,-3
27,6,167,7,12,-5
27,6,168,24,37,-13
27,6,169,7,30,-23
27,6,170,13,24,-11
27,6,171,4,20,-16
27,6,172,6,28,-22
27,6,173,4,14,-10
27,6,174,11,27,-16
27,6,175,9,28,-19
27,6,176,8,21,-13
27,6,177,17,23,-6
27,6,178,7,17,-10
27,6,179,19,32,-13
27,6,180,12,33,-21
27,6,181,6,24,-18
27,6,182,5,4,1
27,6,183,4,29,-25
27,6,184,9,16,-7
27,6,185,14,27,-13
27,6,186,4,16,-12
27,6,187,4,29,-25
27,6,188,5,19,-14
27,6,189,0,20,-20
27,6,190,9,24,-15
27,6,191,9,26,-17
27,6,192,9,14,-5
27,6,193,22,32,-10
27,6,194,9,15,-6
27,6,195,13,32,-19
27,6,196,11,8,3
27,6,197,4,8,-4
27,6,198,3,14,-11
27,6,199,5,10,-5
27,6,200,9,20,-11
27,6,201,13,17,-4
27,6,202,12,23,-11
27,6,203,5,22,-17
27,6,204,12,26,-14
27,6,205,9,22,-13
27,6,206,12,12,0
27,6,207,12,15,-3
27,6,208,10,25,-15
27,6,209,12,14,-2
27,6,210,9,25,-16
27,6,211,14,22,-8
27,6,212,13,24,-11
27,6,213,11,33,-22
27,6,214,11,16,-5
27,6,215,4,15,-11
27,6,216,7,10,-3
27,6,217,8,13,-5
27,6,218,16,36,-20
27,6,219,10,17,-7
27,6,220,12,11,1
27,6,221,5,17,-12
27,6,222,4,12,-8
27,6,223,8,15,-7
27,6,224,12,27,-15
27,6,225,3,25,-22
27,6,226,9,16,-7
27,6,227,18,10,8
27,6,228,9,35,-26
27,6,229,12,39,-27
27,6,230,13,30,-17
27,6,231,17,29,-12
27,6,232,9,15,-6
27,6,233,11,20,-9
27,6,234,7,38,-31
27,6,235,21,33,-12
27,6,236,5,15,-10
27,6,237,13,20,-7
27,6,238,2,21,-19
27,6,239,11,25,-14
27,6,240,3,18,-15
27,6,241,10,17,-7
27,6,242,11,11,0
27,6,243,12,25,-13
27,6,244,7,27,-20
27,6,245,7,14,-7
27,6,246,6,32,-26
27,6,247,7,19,-12
27,6,248,13,18,-5
27,6,249,8,25,-17
27,6,250,9,19,-10
27,6,251,5,14,-9
27,6,252,13,18,-5
27,6,253,3,22,-19
27,6,254,8,14,-6
27,6,255,6,17,-11
27,6,256,13,31,-18
27,6,257,17,13,4
27,6,258,10,26,-16
27,6,259,10,25,-15
27,6,260,10,20,-10
27,6,261,3,11,-8
27,6,262,10,18,-8
27,6,263,7,22,-15
27,6,264,11,22,-11
27,6,265,7,27,-20
27,6,266,6,28,-22
27,6,267,7,18,-11
27,6,268,2,30,-28
27,6,269,10,20,-10
27,6,270,5,37,-32
27,6,271,4,12,-8
27,6,272,12,27,-15
27,6,273,10,21,-11
27,6,274,9,14,-5
27,6,275,6,17,-11
27,6,276,2,18,-16
27,6,277,5,16,-11
27,6,278,8,13,-5
27,6,279,10,18,-8
27,6,280,16,18,-2
27,6,281,5,13,-8
27,6,282,4,10,-6
27,6,283,19,25,-6
27,6,284,19,16,3
27,6,285,18,15,3
27,6,286,3,14,-11
27,6,287,15,31,-16
27,6,288,2,32,-30
27,6,289,8,15,-7
27,6,290,5,12,-7
27,6,291,7,19,-12
27,6,292,9,31,-22
27,6,293,3,16,-13
27,6,294,9,13,-4
27,6,295,14,27,-13
27,6,296,13,18,-5
27,6,297,10,12,-2
27,6,298,8,24,-16
27,6,299,15,14,1
27,7,0,12,25,-13
27,7,1,12,24,-12
27,7,2,18,18,0
27,7,3,3,18,-15
27,7,4,11,13,-2
27,7,5,3,7,-4
27,7,6,16,18,-2
27,7,7,12,26,-14
27,7,8,10,18,-8
27,7,9,10,30,-20
27,7,10,14,17,-3
27,7,11,18,33,-15
27,7,12,16,22,-6
27,7,13,11,18,-7
27,7,14,4,39,-35
27,7,15,9,17,-8
27,7,16,17,31,-14
27,7,17,8,21,-13
27,7,18,16,22,-6
27,7,19,12,9,3
27,7,20,9,25,-16
27,7,21,4,17,-13
27,7,22,9,34,-25
27,7,23,18,26,-8
27,7,24,11,19,-8
27,7,25,15,30,-15
27,7,26,10,12,-2
27,7,27,10,15,-5
27,7,28,10,27,-17
27,7,29,11,38,-27
27,7,30,1,26,-25
27,7,31,9,18,-9
27,7,32,10,28,-18
27,7,33,14,17,-3
27,7,34,9,10,-1
27,7,35,7,25,-18
27,7,36,13,18,-5
27,7,37,9,18,-9
27,7,38,5,16,-11
27,7,39,14,21,-7
27,7,40,19,37,-18
27,7,41,12,27,-15
27,7,42,7,7,0
27,7,43,15,30,-15
27,7,44,12,24,-12
27,7,45,12,24,-12
27,7,46,11,18,-7
27,7,47,21,34,-13
27,7,48,12,24,-12
27,7,49,4,9,-5
27,7,50,12,30,-18
27,7,51,6,18,-12
27,7,52,6,21,-15
27,7,53,26,35,-9
27,7,54,2,22,-20
27,7,55,11,18,-7
27,7,56,5,20,-15
27,7,57,2,31,-29
27,7,58,16,19,-3
27,7,59,12,23,-11
27,7,60,17,34,-17
27,7,61,15,23,-8
27,7,62,8,29,-21
27,7,63,8,13,-5
27,7,64,12,9,3
27,7,65,9,21,-12
27,7,66,9,20,-11
27,7,67,4,32,-28
27,7,68,7,33,-26
27,7,69,6,6,0
27,7,70,10,30,-20
27,7,71,6,20,-14
27,7,72,9,19,-10
27,7,73,7,15,-8
27,7,74,1,26,-25
27,7,75,19,23,-4
27,7,76,10,34,-24
27,7,77,9,24,-15
27,7,78,11,15,-4
27,7,79,5,11,-6
27,7,80,18,25,-7
27,7,81,7,21,-14
27,7,82,14,18,-4
27,7,83,14,33,-19
27,7,84,6,27,-21
27,7,85,7,19,-12
27,7,86,11,8,3
27,7,87,6,17,-11
27,7,88,15,22,-7
27,7,89,13,19,-6
27,7,90,11,29,-18
27,7,91,12,31,-19
27,7,92,3,27,-24
27,7,93,15,20,-5
27,7,94,5,13,-8
27,7,95,10,16,-6
27,7,96,12,16,-4
27,7,97,8,15,-7
27,7,98,11,25,-14
27,7,99,20,25,-5
27,7,100,3,11,-8
27,7,101,7,18,-11
27,7,102,8,20,-12
27,7,103,5,22,-17
27,7,104,10,25,-15
27,7,105,6,9,-3
27,7,106,9,6,3
27,7,107,18,21,-3
27,7,108,5,20,-15
27,7,109,1,10,-9
27,7,110,7,14,-7
27,7,111,11,17,-6
27,7,112,8,17,-9
27,7,113,7,28,-21
27,7,114,10,13,-3
27,7,115,8,21,-13
27,7,116,10,21,-11
27,7,117,8,31,-23
27,7,118,13,30,-17
27,7,119,21,35,-14
27,7,120,9,26,-17
27,7,121,12,24,-12
27,7,122,7,31,-24
27,7,123,10,36,-26
27,7,124,8,20,-12
27,7,125,11,16,-5
27,7,126,11,26,-15
27,7,127,16,32,-16
27,7,128,3,11,-8
27,7,129,11,34,-23
27,7,130,9,23,-14
27,7,131,11,14,-3
27,7,132,14,16,-2
27,7,133,4,14,-10
27,7,134,8,17,-9
27,7,135,23,29,-6
27,7,136,7,3,4
27,7,137,5,20,-15
27,7,138,3,16,-13
27,7,139,5,24,-19
27,7,140,15,15,0
27,7,141,9,23,-14
27,7,142,9,15,-6
27,7,143,17,39,-22
27,7,144,4,17,-13
27,7,145,14,23,-9
27,7,146,10,11,-1
27,7,147,7,27,-20
27,7,148,10,20,-10
27,7,149,7,14,-7
27,7,150,8,17,-9
27,7,151,7,10,-3
27,7,152,8,18,-10
27,7,153,14,41,-27
27,7,154,13,16,-3
27,7,155,7,18,-11
27,7,156,3,4,-1
27,7,157,11,14,-3
27,7,158,13,23,-10
27,7,159,5,17,-12
27,7,160,10,28,-18
27,7,161,9,16,-7
27,7,162,13,28,-15
27,7,163,8,22,-14
27,7,164,9,23,-14
27,7,165,14,11,3
27,7,166,14,16,-2
27,7,167,19,13,6
27,7,168,4,19,-15
27,7,169,11,11,0
27,7,170,13,27,-14
27,7,171,10,19,-9
27,7,172,15,25,-10
27,7,173,16,14,2
27,7,174,4,20,-16
27,7,175,7,26,-19
27,7,176,18,35,-17
27,7,177,16,24,-8
27,7,178,6,4,2
27,7,179,9,39,-30
27,7,180,6,16,-10
27,7,181,11,40,-29
27,7,182,10,28,-18
27,7,183,8,15,-7
27,7,184,9,23,-14
27,7,185,17,32,-15
27,7,186,8,27,-19
27,7,187,13,19,-6
27,7,188,12,24,-12
27,7,189,4,9,-5
27,7,190,12,21,-9
27,7,191,10,26,-16
27,7,192,9,11,-2
27,7,193,16,21,-5
27,7,194,9,16,-7
27,7,195,16,27,-11
27,7,196,5,13,-8
27,7,197,9,20,-11
27,7,198,11,37,-26
27,7,199,5,12,-7
27,7,200,11,30,-19
27,7,201,9,18,-9
27,7,202,12,17,-5
27,7,203,4,15,-11
27,7,204,2,29,-27
27,7,205,15,14,1
27,7,206,5,16,-11
27,7,207,10,22,-12
27,7,208,10,17,-7
27,7,209,18,20,-2
27,7,210,15,18,-3
27,7,211,20,34,-14
27,7,212,5,25,-20
27,7,213,7,20,-13
27,7,214,10,10,0
27,7,215,6,17,-11
27,7,216,8,13,-5
27,7,217,10,12,-2
27,7,218,7,21,-14
27,7,219,6,20,-14
27,7,220,9,24,-15
27,7,221,9,28,-19
27,7,222,9,19,-10
27,7,223,5,15,-10
27,7,224,10,35,-25
27,7,225,24,30,-6
27,7,226,4,17,-13
27,7,227,7,23,-16
27,7,228,18,12,6
27,7,229,3,14,-11
27,7,230,8,17,-9
27,7,231,18,48,-30
27,7,232,10,16,-6
27,7,233,14,27,-13
27,7,234,2,32,-30
27,7,235,5,15,-10
27,7,236,6,7,-1
27,7,237,17,24,-7
27,7,238,9,19,-10
27,7,239,14,35,-21
27,7,240,5,22,-17
27,7,241,11,19,-8
27,7,242,8,33,-25
27,7,243,10,37,-27
27,7,244,9,14,-5
27,7,245,12,36,-24
27,7,246,15,38,-23
27,7,247,2,11,-9
27,7,248,12,16,-4
27,7,249,9,24,-15
27,7,250,9,27,-18
27,7,251,9,25,-16
27,7,252,9,25,-16
27,7,253,5,28,-23
27,7,254,14,32,-18
27,7,255,14,26,-12
27,7,256,12,16,-4
27,7,257,4,34,-30
27,7,258,6,17,-11
27,7,259,9,24,-15
27,7,260,14,16,-2
27,7,261,10,19,-9
27,7,262,7,27,-20
27,7,263,13,15,-2
27,7,264,6,19,-13
27,7,265,5,17,-12
27,7,266,10,16,-6
27,7,267,20,36,-16
27,7,268,13,16,-3
27,7,269,9,16,-7
27,7,270,11,23,-12
27,7,271,10,15,-5
27,7,272,9,33,-24
27,7,273,9,17,-8
27,7,274,6,17,-11
27,7,275,10,19,-9
27,7,276,21,32,-11
27,7,277,7,31,-24
27,7,278,2,11,-9
27,7,279,11,19,-8
27,7,280,13,18,-5
27,7,281,15,18,-3
27,7,282,23,15,8
27,7,283,13,22,-9
27,7,284,10,4,6
27,7,285,7,15,-8
27,7,286,10,6,4
27,7,287,13,22,-9
27,7,288,13,30,-17
27,7,289,8,24,-16
27,7,290,12,22,-10
27,7,291,8,20,-12
27,7,292,5,14,-9
27,7,293,8,21,-13
27,7,294,14,17,-3
27,7,295,12,23,-11
27,7,296,7,24,-17
27,7,297,9,31,-22
27,7,298,11,8,3
27,7,299,4,21,-17
27,8,0,7,19,-12
27,8,1,3,14,-11
27,8,2,6,15,-9
27,8,3,5,14,-9
27,8,4,9,21,-12
27,8,5,11,31,-20
27,8,6,7,14,-7
27,8,7,4,14,-10
27,8,8,9,16,-7
27,8,9,5,35,-30
27,8,10,12,18,-6
27,8,11,13,29,-16
27,8,12,17,19,-2
27,8,13,9,18,-9
27,8,14,14,19,-5
27,8,15,4,21,-17
27,8,16,12,12,0
27,8,17,9,23,-14
27,8,18,7,12,-5
27,8,19,7,30,-23
27,8,20,2,5,-3
27,8,21,8,14,-6
27,8,22,7,8,-1
27,8,23,12,25,-13
27,8,24,20,26,-6
27,8,25,14,28,-14
27,8,26,5,7,-2
27,8,27,7,15,-8
27,8,28,8,18,-10
27,8,29,11,15,-4
27,8,30,5,13,-8
27,8,31,11,22,-11
27,8,32,11,33,-22
27,8,33,11,12,-1
27,8,34,11,21,-10
27,8,35,5,13,-8
27,8,36,15,24,-9
27,8,37,21,40,-19
27,8,38,9,21,-12
27,8,39,15,15,0
27,8,40,13,24,-11
27,8,41,12,16,-4
27,8,42,8,17,-9
27,8,43,13,27,-14
27,8,44,16,27,-11
27,8,45,7,22,-15
27,8,46,7,19,-12
27,8,47,19,19,0
27,8,48,12,25,-13
27,8,49,12,26,-14
27,8,50,4,18,-14
27,8,51,11,14,-3
27,8,52,16,17,-1
27,8,53,7,31,-24
27,8,54,7,18,-11
27,8,55,16,22,-6
27,8,56,12,15,-3
27,8,57,23,15,8
27,8,58,7,13,-6
27,8,59,7,18,-11
27,8,60,12,29,-17
27,8,61,13,27,-14
27,8,62,14,17,-3
27,8,63,10,9,1
27,8,64,14,17,-3
27,8,65,7,26,-19
27,8,66,13,11,2
27,8,67,8,16,-8
27,8,68,2,16,-14
27,8,69,15,20,-5
27,8,70,3,30,-27
27,8,71,7,20,-13
27,8,72,18,22,-4
27,8,73,9,14,-5
27,8,74,7,14,-7
27,8,75,21,21,0
27,8,76,12,29,-17
27,8,77,10,26,-16
27,8,78,10,20,-10
27,8,79,14,18,-4
27,8,80,11,21,-10
27,8,81,10,10,0
27,8,82,18,19,-1
27,8,83,12,30,-18
27,8,84,4,14,-10
27,8,85,17,20,-3
27,8,86,2,21,-19
27,8,87,8,19,-11
27,8,88,3,21,-18
27,8,89,9,10,-1
27,8,90,6,16,-10
27,8,91,19,34,-15
27,8,92,16,23,-7
27,8,93,5,22,-17
27,8,94,23,23,0
27,8,95,12,18,-6
27,8,96,10,19,-9
27,8,97,14,23,-9
27,8,98,6,12,-6
27,8,99,15,18,-3
27,8,100,8,18,-10
27,8,101,16,17,-1
27,8,102,10,22,-12
27,8,103,19,21,-2
27,8,104,8,18,-10
27,8,105,9,22,-13
27,8,106,9,26,-17
27,8,107,21,33,-12
27,8,108,8,21,-13
27,8,109,8,15,-7
27,8,110,18,20,-2
27,8,111,15,22,-7
27,8,112,8,46,-38
27,8,113,17,16,1
27,8,114,6,28,-22
27,8,115,14,27,-13
27,8,116,13,17,-4
27,8,117,16,32,-16
27,8,118,10,12,-2
27,8,119,15,22,-7
27,8,120,8,25,-17
27,8,121,12,14,-2
27,8,122,7,14,-7
27,8,123,13,13,0
27,8,124,24,25,-1
27,8,125,5,15,-10
27,8,126,3,12,-9
27,8,127,11,27,-16
27,8,128,10,25,-15
27,8,129,13,25,-12
27,8,130,12,9,3
27,8,131,14,13,1
27,8,132,3,10,-7
27,8,133,15,17,-2
27,8,134,8,27,-19
27,8,135,14,23,-9
27,8,136,7,11,-4
27,8,137,8,28,-20
27,8,138,9,26,-17
27,8,139,17,29,-12
27,8,140,8,12,-4
27,8,141,11,36,-25
27,8,142,5,21,-16
27,8,143,15,31,-16
27,8,144,16,28,-12
27,8,145,6,16,-10
27,8,146,11,27,-16
27,8,147,5,22,-17
27,8,148,8,24,-16
27,8,149,14,18,-4
27,8,150,9,10,-1
27,8,151,12,20,-8
27,8,152,7,13,-6
27,8,153,25,30,-5
27,8,154,3,16,-13
27,8,155,14,9,5
27,8,156,15,20,-5
27,8,157,10,21,-11
27,8,158,0,18,-18
27,8,159,17,34,-17
27,8,160,9,26,-17
27,8,161,6,18,-12
27,8,162,4,17,-13
27,8,163,5,31,-26
27,8,164,10,16,-6
27,8,165,7,11,-4
27,8,166,15,32,-17
27,8,167,13,26,-13
27,8,168,13,28,-15
27,8,169,11,9,2
27,8,170,7,23,-16
27,8,171,13,30,-17
27,8,172,10,25,-15
27,8,173,11,16,-5
27,8,174,11,23,-12
27,8,175,8,14,-6
27,8,176,6,20,-14
27,8,177,5,29,-24
27,8,178,6,25,-19
27,8,179,8,19,-11
27,8,180,10,15,-5
27,8,181,13,24,-11
27,8,182,12,27,-15
27,8,183,6,12,-6
27,8,184,4,21,-17
27,8,185,15,24,-9
27,8,186,5,22,-17
27,8,187,10,18,-8
27,8,188,10,18,-8
27,8,189,8,19,-11
27,8,190,18,26,-8
27,8,191,12,28,-16
27,8,192,11,16,-5
27,8,193,10,27,-17
27,8,194,9,13,-4
27,8,195,16,21,-5
27,8,196,10,15,-5
27,8,197,4,21,-17
27,8,198,7,7,0
27,8,199,8,17,-9
27,8,200,11,11,0
27,8,201,16,40,-24
27,8,202,15,22,-7
27,8,203,6,7,-1
27,8,204,13,19,-6
27,8,205,9,25,-16
27,8,206,10,24,-14
27,8,207,3,22,-19
27,8,208,17,18,-1
27,8,209,1,21,-20
27,8,210,2,11,-9
27,8,211,10,25,-15
27,8,212,12,16,-4
27,8,213,20,13,7
27,8,214,13,24,-11
27,8,215,8,19,-11
27,8,216,14,21,-7
27,8,217,10,13,-3
27,8,218,8,21,-13
27,8,219,19,16,3
27,8,220,4,20,-16
27,8,221,11,29,-18
27,8,222,9,14,-5
27,8,223,12,27,-15
27,8,224,12,15,-3
27,8,225,11,23,-12
27,8,226,12,14,-2
27,8,227,19,28,-9
27,8,228,12,9,3
27,8,229,3,13,-10
27,8,230,15,28,-13
27,8,231,15,17,-2
27,8,232,6,31,-25
27,8,233,9,39,-30
27,8,234,9,24,-15
27,8,235,16,18,-2
27,8,236,8,25,-17
27,8,237,7,19,-12
27,8,238,19,30,-11
27,8,239,14,34,-20
27,8,240,6,14,-8
27,8,241,11,19,-8
27,8,242,12,27,-15
27,8,243,10,20,-10
27,8,244,23,19,4
27,8,245,10,25,-15
27,8,246,6,22,-16
27,8,247,3,14,-11
27,8,248,14,21,-7
27,8,249,19,25,-6
27,8,250,10,22,-12
27,8,251,7,25,-18
27,8,252,11,12,-1
27,8,253,6,12,-6
27,8,254,7,25,-18
27,8,255,12,10,2
27,8,256,7,24,-17
27,8,257,14,24,-10
27,8,258,11,9,2
27,8,259,15,37,-22
27,8,260,9,17,-8
27,8,261,6,22,-16
27,8,262,8,13,-5
27,8,263,3,16,-13
27,8,264,10,24,-14
27,8,265,15,13,2
27,8,266,8,18,-10
27,8,267,8,20,-12
27,8,268,3,33,-30
27,8,269,21,25,-4
27,8,270,11,22,-11
27,8,271,3,8,-5
27,8,272,11,25,-14
27,8,273,9,22,-13
27,8,274,10,16,-6
27,8,275,9,13,-4
27,8,276,4,18,-14
27,8,277,4,19,-15
27,8,278,6,14,-8
27,8,279,9,22,-13
27,8,280,12,20,-8
27,8,281,10,17,-7
27,8,282,9,15,-6
27,8,283,7,23,-16
27,8,284,4,17,-13
27,8,285,10,26,-16
27,8,286,2,13,-11
27,8,287,22,12,10
27,8,288,6,33,-27
27,8,289,14,27,-13
27,8,290,14,48,-34
27,8,291,2,15,-13
27,8,292,2,15,-13
27,8,293,6,18,-12
27,8,294,3,26,-23
27,8,295,21,24,-3
27,8,296,13,19,-6
27,8,297,11,21,-10
27,8,298,14,19,-5
27,8,299,7,9,-2
27,9,0,13,18,-5
27,9,1,16,14,2
27,9,2,6,19,-13
27,9,3,11,4,7
27,9,4,11,24,-13
27,9,5,4,23,-19
27,9,6,9,23,-14
27,9,7,9,20,-11
27,9,8,4,8,-4
27,9,9,2,19,-17
27,9,10,9,25,-16
27,9,11,5,19,-14
27,9,12,7,10,-3
27,9,13,15,39,-24
27,9,14,7,20,-13
27,9,15,10,16,-6
27,9,16,9,10,-1
27,9,17,7,15,-8
27,9,18,6,24,-18
27,9,19,7,17,-10
27,9,20,13,36,-23
27,9,21,5,16,-11
27,9,22,7,14,-7
27,9,23,14,19,-5
27,9,24,7,10,-3
27,9,25,14,11,3
27,9,26,4,15,-11
27,9,27,10,24,-14
27,9,28,6,15,-9
27,9,29,15,21,-6
27,9,30,5,35,-30
27,9,31,14,28,-14
27,9,32,11,8,3
27,9,33,8,10,-2
27,9,34,5,16,-11
27,9,35,6,15,-9
27,9,36,12,21,-9
27,9,37,8,18,-10
27,9,38,16,22,-6
27,9,39,6,12,-6
27,9,40,11,25,-14
27,9,41,19,24,-5
27,9,42,10,31,-21
27,9,43,11,23,-12
27,9,44,6,17,-11
27,9,45,4,20,-16
27,9,46,15,30,-15
27,9,47,9,24,-15
27,9,48,9,25,-16
27,9,49,8,32,-24
27,9,50,5,26,-21
27,9,51,17,27,-10
27,9,52,7,14,-7
27,9,53,4,7,-3
27,9,54,12,35,-23
27,9,55,12,16,-4
27,9,56,8,18,-10
27,9,57,9,13,-4
27,9,58,10,27,-17
27,9,59,8,18,-10
27,9,60,8,16,-8
27,9,61,4,15,-11
27,9,62,12,14,-2
27,9,63,12,17,-5
27,9,64,6,20,-14
27,9,65,9,27,-18
27,9,66,19,30,-11
27,9,67,10,20,-10
27,9,68,20,16,4
27,9,69,7,26,-19
27,9,70,4,17,-13
27,9,71,12,23,-11
27,9,72,10,8,2
27,9,73,6,23,-17
27,9,74,7,16,-9
27,9,75,19,35,-16
27,9,76,10,11,-1
27,9,77,3,10,-7
27,9,78,17,16,1
27,9,79,4,8,-4
27,9,80,15,16,-1
27,9,81,9,19,-10
27,9,82,6,33,-27
27,9,83,11,22,-11
27,9,84,18,41,-23
27,9,85,13,24,-11
27,9,86,2,14,-12
27,9,87,5,14,-9
27,9,88,12,25,-13
27,9,89,12,21,-9
27,9,90,10,14,-4
27,9,91,11,30,-19
27,9,92,18,21,-3
27,9,93,12,25,-13
27,9,94,7,13,-6
27,9,95,5,17,-12
27,9,96,10,24,-14
27,9,97,5,22,-17
27,9,98,18,29,-11
27,9,99,8,15,-7
27,9,100,14,21,-7
27,9,101,19,15,4
27,9,102,8,27,-19
27,9,103,9,20,-11
27,9,104,14,31,-17
27,9,105,9,12,-3
27,9,106,19,30,-11
27,9,107,10,21,-11
27,9,108,15,14,1
27,9,109,17,27,-10
27,9,110,12,17,-5
27,9,111,12,16,-4
27,9,112,11,21,-10
27,9,113,9,26,-17
27,9,114,6,18,-12
27,9,115,11,17,-6
27,9,116,3,11,-8
27,9,117,9,11,-2
27,9,118,12,34,-22
27,9,119,12,22,-10
27,9,120,13,27,-14
27,9,121,7,19,-12
27,9,122,21,16,5
27,9,123,9,14,-5
27,9,124,8,25,-17
27,9,125,13,13,0
27,9,126,10,24,-14
27,9,127,10,21,-11
27,9,128,2,13,-11
27,9,129,13,23,-10
27,9,130,3,15,-12
27,9,131,14,28,-14
27,9,132,10,29,-19
27,9,133,6,22,-16
27,9,134,10,20,-10
27,9,135,10,11,-1
27,9,136,11,17,-6
27,9,137,17,33,-16
27,9,138,10,18,-8
27,9,139,6,15,-9
27,9,140,9,27,-18
27,9,141,10,31,-21
27,9,142,14,25,-11
27,9,143,16,22,-6
27,9,144,16,15,1
27,9,145,13,24,-11
27,9,146,16,23,-7
27,9,147,13,27,-14
27,9,148,6,31,-25
27,9,149,6,18,-12
27,9,150,7,13,-6
27,9,151,14,32,-18
27,9,152,5,15,-10
27,9,153,15,16,-1
27,9,154,3,12,-9
27,9,155,10,35,-25
27,9,156,4,17,-13
27,9,157,19,30,-11
27,9,158,8,14,-6
27,9,159,12,11,1
27,9,160,11,31,-20
27,9,161,11,25,-14
27,9,162,21,22,-1
27,9,163,15,11,4
27,9,164,8,18,-10
27,9,165,7,30,-23
27,9,166,11,11,0
27,9,167,6,25,-19
27,9,168,12,20,-8
27,9,169,6,20,-14
27,9,170,7,4,3
27,9,171,7,22,-15
27,9,172,15,18,-3
27,9,173,17,24,-7
27,9,174,11,15,-4
27,9,175,12,11,1
27,9,176,4,12,-8
27,9,177,4,19,-15
27,9,178,9,22,-13
27,9,179,8,18,-10
27,9,180,9,20,-11
27,9,181,18,11,7
27,9,182,7,21,-14
27,9,183,15,8,7
27,9,184,14,26,-12
27,9,185,10,9,1
27,9,186,13,13,0
27,9,187,2,31,-29
27,9,188,10,35,-25
27,9,189,7,25,-18
27,9,190,11,31,-20
27,9,191,9,28,-19
27,9,192,16,14,2
27,9,193,8,28,-20
27,9,194,6,22,-16
27,9,195,11,22,-11
27,9,196,16,15,1
27,9,197,8,23,-15
27,9,198,3,23,-20
27,9,199,2,23,-21
27,9,200,13,21,-8
27,9,201,10,26,-16
27,9,202,8,17,-9
27,9,203,2,9,-7
27,9,204,11,12,-1
27,9,205,13,29,-16
27,9,206,10,19,-9
27,9,207,7,40,-33
27,9,208,9,32,-23
27,9,209,4,14,-10
27,9,210,22,25,-3
27,9,211,3,15,-12
27,9,212,12,12,0
27,9,213,18,44,-26
27,9,214,1,15,-14
27,9,215,14,27,-13
27,9,216,8,20,-12
27,9,217,18,35,-17
27,9,218,9,21,-12
27,9,219,2,18,-16
27,9,220,16,18,-2
27,9,221,5,14,-9
27,9,222,8,31,-23
27,9,223,11,15,-4
27,9,224,25,23,2
27,9,225,6,30,-24
27,9,226,13,29,-16
27,9,227,2,18,-16
27,9,228,7,13,-6
27,9,229,7,13,-6
27,9,230,13,14,-1
27,9,231,9,20,-11
27,9,232,7,9,-2
27,9,233,8,21,-13
27,9,234,10,29,-19
27,9,235,10,18,-8
27,9,236,10,13,-3
27,9,237,11,18,-7
27,9,238,21,26,-5
27,9,239,13,26,-13
27,9,240,10,28,-18
27,9,241,3,23,-20
27,9,242,4,27,-23
27,9,243,8,27,-19
27,9,244,19,23,-4
27,9,245,14,30,-16
27,9,246,8,13,-5
27,9,247,8,14,-6
27,9,248,15,27,-12
27,9,249,14,25,-11
27,9,250,8,11,-3
27,9,251,7,16,-9
27,9,252,11,18,-7
27,9,253,6,10,-4
27,9,254,3,33,-30
27,9,255,5,20,-15
27,9,256,9,18,-9
27,9,257,10,28,-18
27,9,258,11,18,-7
27,9,259,4,7,-3
27,9,260,8,7,1
27,9,261,2,20,-18
27,9,262,12,12,0
27,9,263,13,12,1
27,9,264,18,21,-3
27,9,265,17,26,-9
27,9,266,11,12,-1
27,9,267,7,22,-15
27,9,268,9,32,-23
27,9,269,8,27,-19
27,9,270,17,24,-7
27,9,271,11,16,-5
27,9,272,10,9,1
27,9,273,9,14,-5
27,9,274,8,31,-23
27,9,275,4,22,-18
27,9,276,16,14,2
27,9,277,7,18,-11
27,9,278,7,23,-16
27,9,279,15,23,-8
27,9,280,16,38,-22
27,9,281,9,19,-10
27,9,282,19,21,-2
27,9,283,2,37,-35
27,9,284,6,9,-3
27,9,285,9,7,2
27,9,286,10,25,-15
27,9,287,5,15,-10
27,9,288,14,14,0
27,9,289,17,15,2
27,9,290,17,11,6
27,9,291,12,26,-14
27,9,292,16,21,-5
27,9,293,16,26,-10
27,9,294,13,20,-7
27,9,295,6,27,-21
27,9,296,2,16,-14
27,9,297,15,26,-11
27,9,298,4,1,3
27,9,299,13,40,-27
27,10,0,18,29,-11
27,10,1,9,17,-8
27,10,2,6,47,-41
27,10,3,9,18,-9
27,10,4,18,25,-7
27,10,5,5,16,-11
27,10,6,6,24,-18
27,10,7,8,24,-16
27,10,8,6,30,-24
27,10,9,12,25,-13
27,10,10,10,21,-11
27,10,11,21,39,-18
27,10,12,11,21,-10
27,10,13,16,12,4
27,10,14,10,20,-10
27,10,15,3,14,-11
27,10,16,7,24,-17
27,10,17,18,24,-6
27,10,18,7,20,-13
27,10,19,1,16,-15
27,10,20,8,21,-13
27,10,21,10,17,-7
27,10,22,9,14,-5
27,10,23,14,21,-7
27,10,24,4,23,-19
27,10,25,17,31,-14
27,10,26,10,13,-3
27,10,27,13,20,-7
27,10,28,8,15,-7
27,10,29,10,19,-9
27,10,30,6,17,-11
27,10,31,16,23,-7
27,10,32,8,11,-3
27,10,33,10,21,-11
27,10,34,9,11,-2
27,10,35,9,16,-7
27,10,36,19,41,-22
27,10,37,5,9,-4
27,10,38,6,11,-5
27,10,39,6,17,-11
27,10,40,10,20,-10
27,10,41,5,10,-5
27,10,42,10,11,-1
27,10,43,14,21,-7
27,10,44,8,16,-8
27,10,45,6,22,-16
27,10,46,18,37,-19
27,10,47,18,26,-8
27,10,48,15,11,4
27,10,49,10,10,0
27,10,50,15,14,1
27,10,51,9,19,-10
27,10,52,8,31,-23
27,10,53,11,22,-11
27,10,54,8,11,-3
27,10,55,4,19,-15
27,10,56,3,20,-17
27,10,57,5,19,-14
27,10,58,14,17,-3
27,10,59,15,17,-2
27,10,60,25,28,-3
27,10,61,8,27,-19
27,10,62,19,27,-8
27,10,63,13,32,-19
27,10,64,5,7,-2
27,10,65,11,20,-9
27,10,66,12,23,-11
27,10,67,10,28,-18
27,10,68,14,20,-6
27,10,69,10,17,-7
27,10,70,5,19,-14
27,10,71,2,17,-15
27,10,72,12,31,-19
27,10,73,17,19,-2
27,10,74,7,20,-13
27,10,75,6,8,-2
27,10,76,9,18,-9
27,10,77,3,11,-8
27,10,78,8,20,-12
27,10,79,17,13,4
27,10,80,8,24,-16
27,10,81,6,24,-18
27,10,82,16,25,-9
27,10,83,14,12,2
27,10,84,12,29,-17
27,10,85,7,27,-20
27,10,86,13,27,-14
27,10,87,15,26,-11
27,10,88,9,25,-16
27,10,89,4,17,-13
27,10,90,12,25,-13
27,10,91,10,27,-17
27,10,92,6,19,-13
27,10,93,18,22,-4
27,10,94,20,22,-2
27,10,95,11,15,-4
27,10,96,7,25,-18
27,10,97,16,12,4
27,10,98,15,31,-16
27,10,99,15,20,-5
27,10,100,5,16,-11
27,10,101,9,26,-17
27,10,102,10,20,-10
27,10,103,11,12,-1
27,10,104,10,14,-4
27,10,105,3,15,-12
27,10,106,13,13,0
27,10,107,5,13,-8
27,10,108,7,11,-4
27,10,109,8,18,-10
27,10,110,9,19,-10
27,10,111,4,9,-5
27,10,112,3,19,-16
27,10,113,11,23,-12
27,10,114,12,14,-2
27,10,115,14,9,5
27,10,116,8,24,-16
27,10,117,11,28,-17
27,10,118,8,20,-12
27,10,119,15,35,-20
27,10,120,5,26,-21
27,10,121,12,17,-5
27,10,122,5,21,-16
27,10,123,9,26,-17
27,10,124,13,22,-9
27,10,125,3,12,-9
27,10,126,5,20,-15
27,10,127,11,18,-7
27,10,128,15,25,-10
27,10,129,14,29,-15
27,10,130,12,13,-1
27,10,131,12,21,-9
27,10,132,12,29,-17
27,10,133,16,23,-7
27,10,134,9,33,-24
27,10,135,11,22,-11
27,10,136,3,12,-9
27,10,137,17,21,-4
27,10,138,7,10,-3
27,10,139,7,32,-25
27,10,140,19,16,3
27,10,141,19,15,4
27,10,142,13,17,-4
27,10,143,9,21,-12
27,10,144,9,13,-4
27,10,145,8,14,-6
27,10,146,8,20,-12
27,10,147,19,20,-1
27,10,148,5,11,-6
27,10,149,11,14,-3
27,10,150,15,17,-2
27,10,151,2,13,-11
27,10,152,6,13,-7
27,10,153,10,14,-4
27,10,154,10,14,-4
27,10,155,10,10,0
27,10,156,10,23,-13
27,10,157,9,20,-11
27,10,158,11,10,1
27,10,159,11,15,-4
27,10,160,7,18,-11
27,10,161,9,24,-15
27,10,162,12,17,-5
27,10,163,12,22,-10
27,10,164,5,11,-6
27,10,165,10,13,-3
27,10,166,16,14,2
27,10,167,8,23,-15
27,10,168,10,15,-5
27,10,169,3,18,-15
27,10,170,9,21,-12
27,10,171,10,19,-9
27,10,172,11,25,-14
27,10,173,10,26,-16
27,10,174,4,11,-7
27,10,175,18,23,-5
27,10,176,13,14,-1
27,10,177,15,31,-16
27,10,178,14,6,8
27,10,179,9,10,-1
27,10,180,6,13,-7
27,10,181,10,6,4
27,10,182,16,32,-16
27,10,183,14,25,-11
27,10,184,13,24,-11
27,10,185,7,35,-28
27,10,186,8,21,-13
27,10,187,9,21,-12
27,10,188,11,13,-2
27,10,189,11,29,-18
27,10,190,9,31,-22
27,10,191,17,12,5
27,10,192,10,20,-10
27,10,193,14,23,-9
27,10,194,14,19,-5
27,10,195,10,13,-3
27,10,196,7,12,-5
27,10,197,18,19,-1
27,10,198,17,24,-7
27,10,199,17,31,-14
27,10,200,6,30,-24
27,10,201,1,6,-5
27,10,202,14,24,-10
27,10,203,11,20,-9
27,10,204,4,20,-16
27,10,205,12,21,-9
27,10,206,1,6,-5
27,10,207,29,31,-2
27,10,208,9,10,-1
27,10,209,12,9,3
27,10,210,20,17,3
27,10,211,15,15,0
27,10,212,5,18,-13
27,10,213,15,23,-8
27,10,214,15,16,-1
27,10,215,22,30,-8
27,10,216,3,19,-16
27,10,217,8,22,-14
27,10,218,14,13,1
27,10,219,9,11,-2
27,10,220,9,27,-18
27,10,221,11,26,-15
27,10,222,9,8,1
27,10,223,16,24,-8
27,10,224,11,16,-5
27,10,225,20,21,-1
27,10,226,8,17,-9
27,10,227,8,9,-1
27,10,228,11,9,2
27,10,229,14,26,-12
27,10,230,11,23,-12
27,10,231,19,25,-6
27,10,232,22,25,-3
27,10,233,10,16,-6
27,10,234,8,46,-38
27,10,235,17,24,-7
27,10,236,6,25,-19
27,10,237,10,19,-9
27,10,238,9,30,-21
27,10,239,8,29,-21
27,10,240,4,22,-18
27,10,241,4,22,-18
27,10,242,17,26,-9
27,10,243,19,20,-1
27,10,244,7,28,-21
27,10,245,11,18,-7
27,10,246,11,12,-1
27,10,247,0,8,-8
27,10,248,17,10,7
27,10,249,3,28,-25
27,10,250,8,17,-9
27,10,251,11,16,-5
27,10,252,5,19,-14
27,10,253,11,15,-4
27,10,254,12,29,-17
27,10,255,9,15,-6
27,10,256,10,21,-11
27,10,257,7,17,-10
27,10,258,10,24,-14
27,10,259,8,18,-10
27,10,260,17,20,-3
27,10,261,4,13,-9
27,10,262,5,13,-8
27,10,263,16,23,-7
27,10,264,9,11,-2
27,10,265,14,28,-14
27,10,266,9,18,-9
27,10,267,9,19,-10
27,10,268,16,24,-8
27,10,269,17,27,-10
27,10,270,16,19,-3
27,10,271,12,18,-6
27,10,272,8,16,-8
27,10,273,15,20,-5
27,10,274,4,21,-17
27,10,275,11,26,-15
27,10,276,15,25,-10
27,10,277,6,9,-3
27,10,278,13,27,-14
27,10,279,6,11,-5
27,10,280,12,36,-24
27,10,281,18,25,-7
27,10,282,9,24,-15
27,10,283,4,28,-24
27,10,284,4,28,-24
27,10,285,9,11,-2
27,10,286,5,11,-6
27,10,287,12,25,-13
27,10,288,11,18,-7
27,10,289,9,17,-8
27,10,290,5,15,-10
27,10,291,8,28,-20
27,10,292,9,11,-2
27,10,293,15,36,-21
27,10,294,11,17,-6
27,10,295,14,24,-10
27,10,296,6,7,-1
27,10,297,8,18,-10
27,10,298,12,11,1
27,10,299,17,38,-21
27,11,0,12,17,-5
27,11,1,16,28,-12
27,11,2,8,25,-17
27,11,3,11,9,2
27,11,4,12,24,-12
27,11,5,10,14,-4
27,11,6,8,21,-13
27,11,7,17,23,-6
27,11,8,8,18,-10
27,11,9,9,24,-15
27,11,10,9,10,-1
27,11,11,10,15,-5
27,11,12,3,9,-6
27,11,13,2,24,-22
27,11,14,16,20,-4
27,11,15,12,19,-7
27,11,16,15,11,4
27,11,17,16,13,3
27,11,18,18,27,-9
27,11,19,9,22,-13
27,11,20,15,15,0
27,11,21,14,25,-11
27,11,22,5,22,-17
27,11,23,19,21,-2
27,11,24,12,18,-6
27,11,25,9,13,-4
27,11,26,15,25,-10
27,11,27,3,15,-12
27,11,28,14,24,-10
27,11,29,14,28,-14
27,11,30,8,17,-9
27,11,31,16,18,-2
27,11,32,5,16,-11
27,11,33,14,25,-11
27,11,34,12,24,-12
27,11,35,11,30,-19
27,11,36,16,20,-4
27,11,37,5,15,-10
27,11,38,5,10,-5
27,11,39,3,12,-9
27,11,40,7,15,-8
27,11,41,5,8,-3
27,11,42,5,11,-6
27,11,43,16,23,-7
27,11,44,8,5,3
27,11,45,15,28,-13
27,11,46,13,18,-5
27,11,47,8,23,-15
27,11,48,8,22,-14
27,11,49,15,25,-10
27,11,50,11,22,-11
27,11,51,16,21,-5
27,11,52,10,20,-10
27,11,53,14,26,-12
27,11,54,4,9,-5
27,11,55,8,21,-13
27,11,56,9,27,-18
27,11,57,4,22,-18
27,11,58,10,37,-27
27,11,59,12,25,-13
27,11,60,9,28,-19
27,11,61,15,34,-19
27,11,62,14,28,-14
27,11,63,3,22,-19
27,11,64,5,37,-32
27,11,65,13,41,-28
27,11,66,13,21,-8
27,11,67,16,24,-8
27,11,68,5,30,-25
27,11,69,20,14,6
27,11,70,12,24,-12
27,11,71,7,15,-8
27,11,72,6,19,-13
27,11,73,10,10,0
27,11,74,22,26,-4
27,11,75,15,19,-4
27,11,76,20,14,6
27,11,77,11,39,-28
27,11,78,10,28,-18
27,11,79,10,18,-8
27,11,80,4,24,-20
27,11,81,9,21,-12
27,11,82,20,19,1
27,11,83,8,8,0
27,11,84,11,15,-4
27,11,85,13,15,-2
27,11,86,16,15,1
27,11,87,15,16,-1
27,11,88,12,16,-4
27,11,89,6,22,-16
27,11,90,4,16,-12
27,11,91,11,7,4
27,11,92,14,31,-17
27,11,93,7,16,-9
27,11,94,8,27,-19
27,11,95,16,16,0
27,11,96,15,19,-4
27,11,97,10,29,-19
27,11,98,13,30,-17
27,11,99,7,11,-4
27,11,100,13,25,-12
27,11,101,8,16,-8
27,11,102,6,21,-15
27,11,103,17,16,1
27,11,104,8,17,-9
27,11,105,8,19,-11
27,11,106,13,38,-25
27,11,107,23,25,-2
27,11,108,4,28,-24
27,11,109,15,43,-28
27,11,110,18,35,-17
27,11,111,9,12,-3
27,11,112,12,19,-7
27,11,113,14,25,-11
27,11,114,13,22,-9
27,11,115,6,11,-5
27,11,116,3,23,-20
27,11,117,11,19,-8
27,11,118,8,24,-16
27,11,119,17,34,-17
27,11,120,2,11,-9
27,11,121,13,25,-12
27,11,122,7,8,-1
27,11,123,5,8,-3
27,11,124,16,28,-12
27,11,125,7,19,-12
27,11,126,13,27,-14
27,11,127,6,15,-9
27,11,128,3,22,-19
27,11,129,4,12,-8
27,11,130,18,26,-8
27,11,131,8,15,-7
27,11,132,8,13,-5
27,11,133,9,15,-6
27,11,134,8,32,-24
27,11,135,5,13,-8
27,11,136,8,15,-7
27,11,137,15,8,7
27,11,138,17,17,0
27,11,139,8,15,-7
27,11,140,7,22,-15
27,11,141,13,14,-1
27,11,142,7,11,-4
27,11,143,14,29,-15
27,11,144,14,34,-20
27,11,145,13,9,4
27,11,146,14,20,-6
27,11,147,17,25,-8
27,11,148,6,15,-9
27,11,149,1,12,-11
27,11,150,10,14,-4
27,11,151,20,17,3
27,11,152,15,21,-6
27,11,153,8,11,-3
27,11,154,4,14,-10
27,11,155,11,16,-5
27,11,156,18,21,-3
27,11,157,8,17,-9
27,11,158,14,18,-4
27,11,159,12,7,5
27,11,160,5,5,0
27,11,161,16,17,-1
27,11,162,13,26,-13
27,11,163,8,24,-16
27,11,164,1,14,-13
27,11,165,19,28,-9
27,11,166,15,22,-7
27,11,167,5,18,-13
27,11,168,11,9,2
27,11,169,14,14,0
27,11,170,15,27,-12
27,11,171,13,17,-4
27,11,172,10,29,-19
27,11,173,15,16,-1
27,11,174,11,17,-6
27,11,175,17,24,-7
27,11,176,10,15,-5
27,11,177,3,16,-13
27,11,178,7,19,-12
27,11,179,10,13,-3
27,11,180,10,12,-2
27,11,181,8,27,-19
27,11,182,9,11,-2
27,11,183,17,18,-1
27,11,184,10,14,-4
27,11,185,13,22,-9
27,11,186,5,11,-6
27,11,187,8,19,-11
27,11,188,13,16,-3
27,11,189,16,8,8
27,11,190,10,15,-5
27,11,191,4,22,-18
27,11,192,10,20,-10
27,11,193,9,19,-10
27,11,194,8,10,-2
27,11,195,12,20,-8
27,11,196,1,30,-29
27,11,197,8,17,-9
27,11,198,13,11,2
27,11,199,15,21,-6
27,11,200,15,12,3
27,11,201,12,19,-7
27,11,202,11,19,-8
27,11,203,9,16,-7
27,11,204,11,18,-7
27,11,205,24,35,-11
27,11,206,7,25,-18
27,11,207,9,17,-8
27,11,208,6,23,-17
27,11,209,9,19,-10
27,11,210,10,25,-15
27,11,211,4,20,-16
27,11,212,7,30,-23
27,11,213,16,12,4
27,11,214,7,14,-7
27,11,215,12,10,2
27,11,216,9,11,-2
27,11,217,9,27,-18
27,11,218,9,16,-7
27,11,219,15,14,1
27,11,220,8,27,-19
27,11,221,15,16,-1
27,11,222,8,18,-10
27,11,223,7,16,-9
27,11,224,13,25,-12
27,11,225,7,21,-14
27,11,226,13,25,-12
27,11,227,10,31,-21
27,11,228,12,19,-7
27,11,229,8,15,-7
27,11,230,15,26,-11
27,11,231,9,23,-14
27,11,232,4,23,-19
27,11,233,12,23,-11
27,11,234,11,27,-16
27,11,235,15,24,-9
27,11,236,9,22,-13
27,11,237,9,14,-5
27,11,238,11,13,-2
27,11,239,13,9,4
27,11,240,5,20,-15
27,11,241,9,19,-10
27,11,242,2,15,-13
27,11,243,4,11,-7
27,11,244,11,18,-7
27,11,245,8,20,-12
27,11,246,11,22,-11
27,11,247,8,10,-2
27,11,248,17,25,-8
27,11,249,17,21,-4
27,11,250,16,25,-9
27,11,251,6,8,-2
27,11,252,7,16,-9
27,11,253,17,35,-18
27,11,254,6,27,-21
27,11,255,6,26,-20
27,11,256,3,13,-10
27,11,257,8,6,2
27,11,258,0,19,-19
27,11,259,17,19,-2
27,11,260,6,22,-16
27,11,261,15,24,-9
27,11,262,7,11,-4
27,11,263,12,12,0
27,11,264,23,23,0
27,11,265,10,13,-3
27,11,266,7,23,-16
27,11,267,10,17,-7
27,11,268,13,20,-7
27,11,269,5,12,-7
27,11,270,7,12,-5
27,11,271,12,37,-25
27,11,272,5,19,-14
27,11,273,2,17,-15
27,11,274,10,27,-17
27,11,275,8,24,-16
27,11,276,10,18,-8
27,11,277,13,33,-20
27,11,278,11,31,-20
27,11,279,11,11,0
27,11,280,10,13,-3
27,11,281,6,10,-4
27,11,282,8,11,-3
27,11,283,17,21,-4
27,11,284,12,17,-5
27,11,285,9,28,-19
27,11,286,15,17,-2
27,11,287,3,23,-20
27,11,288,14,12,2
27,11,289,6,19,-13
27,11,290,8,20,-12
27,11,291,8,14,-6
27,11,292,16,29,-13
27,11,293,4,22,-18
27,11,294,4,24,-20
27,11,295,12,15,-3
27,11,296,5,25,-20
27,11,297,13,24,-11
27,11,298,12,18,-6
27,11,299,10,22,-12
27,12,0,6,14,-8
27,12,1,9,14,-5
27,12,2,16,15,1
27,12,3,9,5,4
27,12,4,16,11,5
27,12,5,11,10,1
27,12,6,8,12,-4
27,12,7,3,23,-20
27,12,8,9,13,-4
27,12,9,4,15,-11
27,12,10,16,24,-8
27,12,11,12,22,-10
27,12,12,19,24,-5
27,12,13,10,15,-5
27,12,14,5,23,-18
27,12,15,11,11,0
27,12,16,16,19,-3
27,12,17,2,16,-14
27,12,18,15,21,-6
27,12,19,13,31,-18
27,12,20,8,14,-6
27,12,21,12,21,-9
27,12,22,11,13,-2
27,12,23,12,27,-15
27,12,24,21,19,2
27,12,25,5,15,-10
27,12,26,16,19,-3
27,12,27,8,10,-2
27,12,28,9,24,-15
27,12,29,7,14,-7
27,12,30,8,29,-21
27,12,31,13,26,-13
27,12,32,6,20,-14
27,12,33,17,22,-5
27,12,34,13,14,-1
27,12,35,14,30,-16
27,12,36,8,18,-10
27,12,37,6,13,-7
27,12,38,8,19,-11
27,12,39,11,13,-2
27,12,40,4,9,-5
27,12,41,16,15,1
27,12,42,2,8,-6
27,12,43,7,15,-8
27,12,44,14,12,2
27,12,45,13,17,-4
27,12,46,9,19,-10
27,12,47,2,6,-4
27,12,48,10,30,-20
27,12,49,8,27,-19
27,12,50,9,13,-4
27,12,51,13,23,-10
27,12,52,23,20,3
27,12,53,9,23,-14
27,12,54,5,11,-6
27,12,55,8,11,-3
27,12,56,17,20,-3
27,12,57,10,11,-1
27,12,58,8,18,-10
27,12,59,6,20,-14
27,12,60,16,21,-5
27,12,61,14,13,1
27,12,62,14,15,-1
27,12,63,5,10,-5
27,12,64,16,11,5
27,12,65,2,1,1
27,12,66,5,12,-7
27,12,67,9,15,-6
27,12,68,12,34,-22
27,12,69,16,17,-1
27,12,70,14,41,-27
27,12,71,9,21,-12
27,12,72,5,12,-7
27,12,73,8,14,-6
27,12,74,4,18,-14
27,12,75,10,17,-7
27,12,76,12,14,-2
27,12,77,18,15,3
27,12,78,4,15,-11
27,12,79,10,26,-16
27,12,80,12,24,-12
27,12,81,16,17,-1
27,12,82,20,18,2
27,12,83,5,10,-5
27,12,84,11,6,5
27,12,85,12,17,-5
27,12,86,6,38,-32
27,12,87,14,26,-12
27,12,88,12,22,-10
27,12,89,18,19,-1
27,12,90,13,29,-16
27,12,91,15,28,-13
27,12,92,8,19,-11
27,12,93,15,15,0
27,12,94,9,12,-3
27,12,95,20,22,-2
27,12,96,2,25,-23
27,12,97,14,25,-11
27,12,98,15,37,-22
27,12,99,9,23,-14
27,12,100,1,19,-18
27,12,101,8,33,-25
27,12,102,6,11,-5
27,12,103,14,17,-3
27,12,104,17,27,-10
27,12,105,6,30,-24
27,12,106,10,20,-10
27,12,107,10,20,-10
27,12,108,12,24,-12
27,12,109,15,24,-9
27,12,110,7,7,0
27,12,111,8,25,-17
27,12,112,12,28,-16
27,12,113,10,12,-2
27,12,114,11,26,-15
27,12,115,9,20,-11
27,12,116,23,32,-9
27,12,117,6,21,-15
27,12,118,12,16,-4
27,12,119,8,26,-18
27,12,120,7,19,-12
27,12,121,12,17,-5
27,12,122,14,19,-5
27,12,123,14,15,-1
27,12,124,10,13,-3
27,12,125,2,13,-11
27,12,126,11,22,-11
27,12,127,10,22,-12
27,12,128,9,21,-12
27,12,129,9,27,-18
27,12,130,5,22,-17
27,12,131,14,24,-10
27,12,132,7,23,-16
27,12,133,10,18,-8
27,12,134,12,16,-4
27,12,135,11,28,-17
27,12,136,11,18,-7
27,12,137,6,20,-14
27,12,138,11,34,-23
27,12,139,10,8,2
27,12,140,12,19,-7
27,12,141,6,13,-7
27,12,142,20,23,-3
27,12,143,15,27,-12
27,12,144,12,19,-7
27,12,145,10,17,-7
27,12,146,10,19,-9
27,12,147,10,27,-17
27,12,148,8,6,2
27,12,149,16,23,-7
27,12,150,9,11,-2
27,12,151,10,23,-13
27,12,152,19,24,-5
27,12,153,6,24,-18
27,12,154,7,26,-19
27,12,155,6,15,-9
27,12,156,11,24,-13
27,12,157,10,15,-5
27,12,158,5,30,-25
27,12,159,7,14,-7
27,12,160,22,16,6
27,12,161,3,21,-18
27,12,162,10,23,-13
27,12,163,10,17,-7
27,12,164,11,14,-3
27,12,165,9,22,-13
27,12,166,10,14,-4
27,12,167,8,23,-15
27,12,168,10,22,-12
27,12,169,6,7,-1
27,12,170,7,12,-5
27,12,171,7,10,-3
27,12,172,12,26,-14
27,12,173,7,14,-7
27,12,174,10,22,-12
27,12,175,20,20,0
27,12,176,12,25,-13
27,12,177,14,16,-2
27,12,178,17,22,-5
27,12,179,10,30,-20
27,12,180,5,16,-11
27,12,181,13,29,-16
27,12,182,17,30,-13
27,12,183,19,11,8
27,12,184,4,13,-9
27,12,185,14,20,-6
27,12,186,11,16,-5
27,12,187,4,20,-16
27,12,188,7,31,-24
27,12,189,13,20,-7
27,12,190,10,25,-15
27,12,191,12,30,-18
27,12,192,10,29,-19
27,12,193,14,18,-4
27,12,194,5,10,-5
27,12,195,10,13,-3
27,12,196,5,16,-11
27,12,197,9,24,-15
27,12,198,21,12,9
27,12,199,10,22,-12
27,12,200,10,17,-7
27,12,201,14,10,4
27,12,202,15,28,-13
27,12,203,11,8,3
27,12,204,10,23,-13
27,12,205,8,9,-1
27,12,206,13,9,4
27,12,207,12,39,-27
27,12,208,12,22,-10
27,12,209,6,15,-9
27,12,210,15,34,-19
27,12,211,10,18,-8
27,12,212,5,13,-8
27,12,213,6,29,-23
27,12,214,12,31,-19
27,12,215,8,34,-26
27,12,216,6,9,-3
27,12,217,10,25,-15
27,12,218,6,16,-10
27,12,219,6,26,-20
27,12,220,6,20,-14
27,12,221,13,16,-3
27,12,222,10,16,-6
27,12,223,15,20,-5
27,12,224,8,22,-14
27,12,225,9,17,-8
27,12,226,11,18,-7
27,12,227,11,27,-16
27,12,228,9,6,3
27,12,229,17,23,-6
27,12,230,16,29,-13
27,12,231,21,11,10
27,12,232,16,17,-1
27,12,233,13,19,-6
27,12,234,10,21,-11
27,12,235,6,20,-14
27,12,236,10,25,-15
27,12,237,9,20,-11
27,12,238,21,9,12
27,12,239,9,32,-23
27,12,240,15,14,1
27,12,241,4,11,-7
27,12,242,9,23,-14
27,12,243,12,12,0
27,12,244,12,19,-7
27,12,245,3,9,-6
27,12,246,9,14,-5
27,12,247,8,6,2
27,12,248,19,25,-6
27,12,249,22,17,5
27,12,250,11,4,7
27,12,251,11,24,-13
27,12,252,20,13,7
27,12,253,9,16,-7
27,12,254,6,6,0
27,12,255,10,9,1
27,12,256,14,19,-5
27,12,257,2,17,-15
27,12,258,7,17,-10
27,12,259,11,10,1
27,12,260,14,10,4
27,12,261,10,12,-2
27,12,262,8,17,-9
27,12,263,12,14,-2
27,12,264,4,22,-18
27,12,265,15,16,-1
27,12,266,13,22,-9
27,12,267,9,21,-12
27,12,268,15,14,1
27,12,269,11,7,4
27,12,270,4,6,-2
27,12,271,9,13,-4
27,12,272,10,14,-4
27,12,273,7,7,0
27,12,274,16,18,-2
27,12,275,8,19,-11
27,12,276,14,13,1
27,12,277,11,21,-10
27,12,278,7,21,-14
27,12,279,16,25,-9
27,12,280,16,24,-8
27,12,281,6,20,-14
27,12,282,7,13,-6
27,12,283,25,29,-4
27,12,284,11,13,-2
27,12,285,18,8,10
27,12,286,7,14,-7
27,12,287,7,9,-2
27,12,288,1,22,-21
27,12,289,13,28,-15
27,12,290,6,2,4
27,12,291,10,17,-7
27,12,292,7,17,-10
27,12,293,10,25,-15
27,12,294,15,17,-2
27,12,295,22,26,-4
27,12,296,4,18,-14
27,12,297,10,20,-10
27,12,298,20,17,3
27,12,299,18,14,4
27,13,0,16,17,-1
27,13,1,5,28,-23
27,13,2,6,13,-7
27,13,3,8,14,-6
27,13,4,21,23,-2
27,13,5,13,22,-9
27,13,6,8,17,-9
27,13,7,19,26,-7
27,13,8,9,31,-22
27,13,9,5,17,-12
27,13,10,5,16,-11
27,13,11,9,8,1
27,13,12,9,26,-17
27,13,13,18,17,1
27,13,14,13,18,-5
27,13,15,6,14,-8
27,13,16,13,17,-4
27,13,17,3,8,-5
27,13,18,2,25,-23
27,13,19,2,19,-17
27,13,20,12,10,2
27,13,21,15,21,-6
27,13,22,11,11,0
27,13,23,19,18,1
27,13,24,18,20,-2
27,13,25,11,12,-1
27,13,26,18,16,2
27,13,27,9,29,-20
27,13,28,8,22,-14
27,13,29,5,9,-4
27,13,30,12,13,-1
27,13,31,6,15,-9
27,13,32,16,7,9
27,13,33,9,17,-8
27,13,34,18,29,-11
27,13,35,18,17,1
27,13,36,16,32,-16
27,13,37,11,23,-12
27,13,38,11,14,-3
27,13,39,15,32,-17
27,13,40,20,24,-4
27,13,41,8,7,1
27,13,42,7,8,-1
27,13,43,4,11,-7
27,13,44,11,13,-2
27,13,45,18,29,-11
27,13,46,7,18,-11
27,13,47,8,9,-1
27,13,48,7,14,-7
27,13,49,15,11,4
27,13,50,4,21,-17
27,13,51,10,16,-6
27,13,52,6,19,-13
27,13,53,5,16,-11
27,13,54,18,26,-8
27,13,55,13,11,2
27,13,56,11,13,-2
27,13,57,11,29,-18
27,13,58,6,15,-9
27,13,59,8,18,-10
27,13,60,8,14,-6
27,13,61,14,15,-1
27,13,62,5,13,-8
27,13,63,10,20,-10
27,13,64,17,20,-3
27,13,65,12,19,-7
27,13,66,15,21,-6
27,13,67,11,23,-12
27,13,68,8,23,-15
27,13,69,12,11,1
27,13,70,12,20,-8
27,13,71,9,20,-11
27,13,72,16,34,-18
27,13,73,14,15,-1
27,13,74,19,47,-28
27,13,75,6,24,-18
27,13,76,8,8,0
27,13,77,13,21,-8
27,13,78,10,23,-13
27,13,79,10,27,-17
27,13,80,9,18,-9
27,13,81,17,27,-10
27,13,82,15,32,-17
27,13,83,11,20,-9
27,13,84,11,15,-4
27,13,85,11,22,-11
27,13,86,17,19,-2
27,13,87,3,22,-19
27,13,88,16,17,-1
27,13,89,11,27,-16
27,13,90,14,27,-13
27,13,91,1,13,-12
27,13,92,8,11,-3
27,13,93,15,18,-3
27,13,94,5,5,0
27,13,95,4,26,-22
27,13,96,9,11,-2
27,13,97,17,17,0
27,13,98,17,19,-2
27,13,99,11,21,-10
27,13,100,14,11,3
27,13,101,28,31,-3
27,13,102,9,17,-8
27,13,103,9,21,-12
27,13,104,16,37,-21
27,13,105,9,17,-8
27,13,106,10,18,-8
27,13,107,19,21,-2
27,13,108,5,11,-6
27,13,109,5,18,-13
27,13,110,6,4,2
27,13,111,8,14,-6
27,13,112,16,19,-3
27,13,113,11,14,-3
27,13,114,14,13,1
27,13,115,9,10,-1
27,13,116,9,5,4
27,13,117,16,22,-6
27,13,118,12,13,-1
27,13,119,8,16,-8
27,13,120,13,11,2
27,13,121,14,17,-3
27,13,122,17,23,-6
27,13,123,6,9,-3
27,13,124,10,33,-23
27,13,125,16,17,-1
27,13,126,11,25,-14
27,13,127,4,12,-8
27,13,128,14,18,-4
27,13,129,7,18,-11
27,13,130,8,18,-10
27,13,131,15,12,3
27,13,132,14,15,-1
27,13,133,5,21,-16
27,13,134,12,16,-4
27,13,135,7,19,-12
27,13,136,13,18,-5
27,13,137,9,20,-11
27,13,138,9,16,-7
27,13,139,23,19,4
27,13,140,13,28,-15
27,13,141,4,14,-10
27,13,142,6,14,-8
27,13,143,4,26,-22
27,13,144,10,20,-10
27,13,145,12,16,-4
27,13,146,18,15,3
27,13,147,18,20,-2
27,13,148,16,10,6
27,13,149,17,21,-4
27,13,150,19,13,6
27,13,151,10,18,-8
27,13,152,13,12,1
27,13,153,2,26,-24
27,13,154,8,21,-13
27,13,155,6,17,-11
27,13,156,13,17,-4
27,13,157,13,22,-9
27,13,158,7,12,-5
27,13,159,17,36,-19
27,13,160,4,20,-16
27,13,161,17,23,-6
27,13,162,16,13,3
27,13,163,11,16,-5
27,13,164,9,19,-10
27,13,165,17,21,-4
27,13,166,9,21,-12
27,13,167,8,12,-4
27,13,168,4,10,-6
27,13,169,16,22,-6
27,13,170,4,13,-9
27,13,171,14,18,-4
27,13,172,4,12,-8
27,13,173,9,20,-11
27,13,174,11,13,-2
27,13,175,6,12,-6
27,13,176,16,25,-9
27,13,177,10,29,-19
27,13,178,14,11,3
27,13,179,17,22,-5
27,13,180,9,22,-13
27,13,181,15,8,7
27,13,182,9,13,-4
27,13,183,4,17,-13
27,13,184,17,21,-4
27,13,185,21,6,15
27,13,186,8,17,-9
27,13,187,12,19,-7
27,13,188,9,6,3
27,13,189,8,16,-8
27,13,190,9,20,-11
27,13,191,10,16,-6
27,13,192,11,13,-2
27,13,193,13,19,-6
27,13,194,10,15,-5
27,13,195,7,8,-1
27,13,196,14,15,-1
27,13,197,16,20,-4
27,13,198,7,13,-6
27,13,199,12,15,-3
27,13,200,8,17,-9
27,13,201,12,25,-13
27,13,202,17,15,2
27,13,203,11,40,-29
27,13,204,10,20,-10
27,13,205,14,14,0
27,13,206,5,11,-6
27,13,207,6,9,-3
27,13,208,15,22,-7
27,13,209,5,19,-14
27,13,210,10,16,-6
27,13,211,6,12,-6
27,13,212,10,21,-11
27,13,213,14,22,-8
27,13,214,6,23,-17
27,13,215,10,15,-5
27,13,216,8,27,-19
27,13,217,10,7,3
27,13,218,9,15,-6
27,13,219,10,21,-11
27,13,220,7,6,1
27,13,221,13,14,-1
27,13,222,6,12,-6
27,13,223,21,28,-7
27,13,224,15,17,-2
27,13,225,16,17,-1
27,13,226,16,24,-8
27,13,227,5,21,-16
27,13,228,10,10,0
27,13,229,15,21,-6
27,13,230,5,9,-4
27,13,231,5,19,-14
27,13,232,16,18,-2
27,13,233,8,25,-17
27,13,234,12,9,3
27,13,235,11,10,1
27,13,236,17,16,1
27,13,237,12,19,-7
27,13,238,12,20,-8
27,13,239,7,8,-1
27,13,240,9,17,-8
27,13,241,3,21,-18
27,13,242,15,26,-11
27,13,243,8,10,-2
27,13,244,5,9,-4
27,13,245,3,11,-8
27,13,246,7,23,-16
27,13,247,18,26,-8
27,13,248,18,19,-1
27,13,249,12,33,-21
27,13,250,11,18,-7
27,13,251,9,13,-4
27,13,252,19,21,-2
27,13,253,19,20,-1
27,13,254,8,27,-19
27,13,255,12,19,-7
27,13,256,19,32,-13
27,13,257,9,16,-7
27,13,258,13,13,0
27,13,259,15,15,0
27,13,260,12,23,-11
27,13,261,13,23,-10
27,13,262,7,16,-9
27,13,263,18,21,-3
27,13,264,17,20,-3
27,13,265,6,7,-1
27,13,266,12,9,3
27,13,267,14,27,-13
27,13,268,14,21,-7
27,13,269,16,23,-7
27,13,270,13,18,-5
27,13,271,5,20,-15
27,13,272,5,17,-12
27,13,273,15,47,-32
27,13,274,14,18,-4
27,13,275,12,26,-14
27,13,276,11,19,-8
27,13,277,8,8,0
27,13,278,17,21,-4
27,13,279,9,23,-14
27,13,280,7,24,-17
27,13,281,9,25,-16
27,13,282,2,19,-17
27,13,283,15,18,-3
27,13,284,15,18,-3
27,13,285,10,17,-7
27,13,286,3,20,-17
27,13,287,8,11,-3
27,13,288,14,26,-12
27,13,289,6,17,-11
27,13,290,3,19,-16
27,13,291,8,14,-6
27,13,292,7,13,-6
27,13,293,9,15,-6
27,13,294,10,6,4
27,13,295,35,32,3
27,13,296,12,18,-6
27,13,297,6,7,-1
27,13,298,13,25,-12
27,13,299,14,20,-6
27,14,0,6,17,-11
27,14,1,20,21,-1
27,14,2,14,17,-3
27,14,3,9,12,-3
27,14,4,12,18,-6
27,14,5,6,16,-10
27,14,6,11,13,-2
27,14,7,12,17,-5
27,14,8,10,28,-18
27,14,9,8,16,-8
27,14,10,10,20,-10
27,14,11,6,20,-14
27,14,12,10,16,-6
27,14,13,9,38,-29
27,14,14,12,27,-15
27,14,15,13,17,-4
27,14,16,10,20,-10
27,14,17,11,24,-13
27,14,18,6,24,-18
27,14,19,9,15,-6
27,14,20,8,17,-9
27,14,21,13,30,-17
27,14,22,18,17,1
27,14,23,24,29,-5
27,14,24,13,18,-5
27,14,25,11,22,-11
27,14,26,9,10,-1
27,14,27,24,24,0
27,14,28,11,20,-9
27,14,29,18,27,-9
27,14,30,9,18,-9
27,14,31,8,18,-10
27,14,32,15,10,5
27,14,33,8,9,-1
27,14,34,12,21,-9
27,14,35,22,20,2
27,14,36,8,23,-15
27,14,37,11,7,4
27,14,38,13,23,-10
27,14,39,12,11,1
27,14,40,13,22,-9
27,14,41,16,18,-2
27,14,42,7,3,4
27,14,43,8,20,-12
27,14,44,13,19,-6
27,14,45,5,8,-3
27,14,46,7,22,-15
27,14,47,11,12,-1
27,14,48,8,16,-8
27,14,49,14,20,-6
27,14,50,19,28,-9
27,14,51,11,21,-10
27,14,52,12,22,-10
27,14,53,12,20,-8
27,14,54,7,19,-12
27,14,55,7,15,-8
27,14,56,13,17,-4
27,14,57,5,7,-2
27,14,58,11,29,-18
27,14,59,9,20,-11
27,14,60,10,17,-7
27,14,61,8,13,-5
27,14,62,12,16,-4
27,14,63,14,16,-2
27,14,64,7,19,-12
27,14,65,15,21,-6
27,14,66,14,15,-1
27,14,67,12,10,2
27,14,68,18,14,4
27,14,69,14,22,-8
27,14,70,12,17,-5
27,14,71,14,13,1
27,14,72,14,27,-13
27,14,73,9,11,-2
27,14,74,7,22,-15
27,14,75,25,11,14
27,14,76,13,26,-13
27,14,77,6,11,-5
27,14,78,15,21,-6
27,14,79,17,26,-9
27,14,80,12,29,-17
27,14,81,10,3,7
27,14,82,15,15,0
27,14,83,22,22,0
27,14,84,18,15,3
27,14,85,12,19,-7
27,14,86,7,13,-6
27,14,87,13,25,-12
27,14,88,17,29,-12
27,14,89,9,14,-5
27,14,90,10,17,-7
27,14,91,8,21,-13
27,14,92,8,29,-21
27,14,93,10,19,-9
27,14,94,11,21,-10
27,14,95,9,12,-3
27,14,96,23,28,-5
27,14,97,3,26,-23
27,14,98,11,7,4
27,14,99,14,20,-6
27,14,100,10,16,-6
27,14,101,5,8,-3
27,14,102,11,2,9
27,14,103,21,18,3
27,14,104,12,20,-8
27,14,105,9,11,-2
27,14,106,19,21,-2
27,14,107,12,14,-2
27,14,108,12,11,1
27,14,109,0,6,-6
27,14,110,10,23,-13
27,14,111,11,13,-2
27,14,112,12,20,-8
27,14,113,9,22,-13
27,14,114,20,25,-5
27,14,115,12,19,-7
27,14,116,6,9,-3
27,14,117,7,23,-16
27,14,118,8,24,-16
27,14,119,6,12,-6
27,14,120,12,21,-9
27,14,121,18,35,-17
27,14,122,5,20,-15
27,14,123,8,12,-4
27,14,124,6,10,-4
27,14,125,12,28,-16
27,14,126,14,24,-10
27,14,127,10,22,-12
27,14,128,24,27,-3
27,14,129,13,14,-1
27,14,130,12,26,-14
27,14,131,2,14,-12
27,14,132,13,13,0
27,14,133,9,18,-9
27,14,134,17,18,-1
27,14,135,14,12,2
27,14,136,25,12,13
27,14,137,9,22,-13
27,14,138,25,20,5
27,14,139,9,14,-5
27,14,140,11,25,-14
27,14,141,20,19,1
27,14,142,12,14,-2
27,14,143,11,25,-14
27,14,144,8,18,-10
27,14,145,4,11,-7
27,14,146,10,29,-19
27,14,147,12,21,-9
27,14,148,6,17,-11
27,14,149,15,17,-2
27,14,150,21,28,-7
27,14,151,8,23,-15
27,14,152,12,37,-25
27,14,153,13,33,-20
27,14,154,20,24,-4
27,14,155,11,24,-13
27,14,156,14,23,-9
27,14,157,14,30,-16
27,14,158,15,19,-4
27,14,159,17,15,2
27,14,160,4,19,-15
27,14,161,8,24,-16
27,14,162,7,14,-7
27,14,163,13,16,-3
27,14,164,4,15,-11
27,14,165,18,18,0
27,14,166,12,25,-13
27,14,167,14,37,-23
27,14,168,17,23,-6
27,14,169,16,25,-9
27,14,170,13,25,-12
27,14,171,26,13,13
27,14,172,18,12,6
27,14,173,17,17,0
27,14,174,9,15,-6
27,14,175,11,15,-4
27,14,176,16,23,-7
27,14,177,5,19,-14
27,14,178,15,22,-7
27,14,179,9,17,-8
27,14,180,19,22,-3
27,14,181,6,12,-6
27,14,182,13,18,-5
27,14,183,11,19,-8
27,14,184,11,30,-19
27,14,185,12,17,-5
27,14,186,5,27,-22
27,14,187,14,23,-9
27,14,188,0,15,-15
27,14,189,13,9,4
27,14,190,7,18,-11
27,14,191,11,21,-10
27,14,192,10,10,0
27,14,193,22,32,-10
27,14,194,10,14,-4
27,14,195,12,18,-6
27,14,196,12,24,-12
27,14,197,17,34,-17
27,14,198,13,24,-11
27,14,199,3,4,-1
27,14,200,18,20,-2
27,14,201,18,37,-19
27,14,202,12,26,-14
27,14,203,11,18,-7
27,14,204,4,14,-10
27,14,205,10,10,0
27,14,206,7,15,-8
27,14,207,10,12,-2
27,14,208,16,26,-10
27,14,209,10,16,-6
27,14,210,13,12,1
27,14,211,5,14,-9
27,14,212,7,11,-4
27,14,213,10,11,-1
27,14,214,13,13,0
27,14,215,19,15,4
27,14,216,11,17,-6
27,14,217,9,24,-15
27,14,218,10,18,-8
27,14,219,21,12,9
27,14,220,7,11,-4
27,14,221,10,23,-13
27,14,222,20,27,-7
27,14,223,7,20,-13
27,14,224,3,13,-10
27,14,225,7,18,-11
27,14,226,8,9,-1
27,14,227,16,16,0
27,14,228,5,27,-22
27,14,229,8,18,-10
27,14,230,17,12,5
27,14,231,10,24,-14
27,14,232,10,15,-5
27,14,233,4,15,-11
27,14,234,4,14,-10
27,14,235,4,7,-3
27,14,236,16,12,4
27,14,237,1,12,-11
27,14,238,2,6,-4
27,14,239,7,17,-10
27,14,240,9,8,1
27,14,241,5,12,-7
27,14,242,9,29,-20
27,14,243,14,15,-1
27,14,244,21,19,2
27,14,245,5,23,-18
27,14,246,7,28,-21
27,14,247,25,27,-2
27,14,248,14,23,-9
27,14,249,11,10,1
27,14,250,12,34,-22
27,14,251,1,10,-9
27,14,252,6,10,-4
27,14,253,8,25,-17
27,14,254,7,31,-24
27,14,255,31,33,-2
27,14,256,10,23,-13
27,14,257,12,14,-2
27,14,258,25,33,-8
27,14,259,13,12,1
27,14,260,14,13,1
27,14,261,7,23,-16
27,14,262,17,22,-5
27,14,263,8,18,-10
27,14,264,14,20,-6
27,14,265,18,45,-27
27,14,266,8,17,-9
27,14,267,17,24,-7
27,14,268,11,21,-10
27,14,269,6,17,-11
27,14,270,20,25,-5
27,14,271,9,26,-17
27,14,272,13,19,-6
27,14,273,7,13,-6
27,14,274,23,13,10
27,14,275,7,12,-5
27,14,276,7,6,1
27,14,277,11,7,4
27,14,278,12,26,-14
27,14,279,10,16,-6
27,14,280,14,19,-5
27,14,281,9,8,1
27,14,282,7,13,-6
27,14,283,10,20,-10
27,14,284,17,8,9
27,14,285,23,25,-2
27,14,286,6,19,-13
27,14,287,16,20,-4
27,14,288,11,21,-10
27,14,289,15,21,-6
27,14,290,9,15,-6
27,14,291,15,19,-4
27,14,292,17,21,-4
27,14,293,15,30,-15
27,14,294,14,25,-11
27,14,295,17,19,-2
27,14,296,13,9,4
27,14,297,15,19,-4
27,14,298,8,23,-15
27,14,299,14,15,-1
27,15,0,18,20,-2
27,15,1,5,14,-9
27,15,2,4,17,-13
27,15,3,7,19,-12
27,15,4,13,25,-12
27,15,5,5,4,1
27,15,6,16,32,-16
27,15,7,3,5,-2
27,15,8,10,18,-8
27,15,9,16,22,-6
27,15,10,13,15,-2
27,15,11,10,20,-10
27,15,12,6,14,-8
27,15,13,20,21,-1
27,15,14,2,11,-9
27,15,15,8,17,-9
27,15,16,15,20,-5
27,15,17,13,15,-2
27,15,18,8,9,-1
27,15,19,14,31,-17
27,15,20,12,17,-5
27,15,21,10,11,-1
27,15,22,12,34,-22
27,15,23,7,22,-15
27,15,24,13,16,-3
27,15,25,15,18,-3
27,15,26,8,18,-10
27,15,27,14,19,-5
27,15,28,11,14,-3
27,15,29,19,26,-7
27,15,30,16,20,-4
27,15,31,8,9,-1
27,15,32,9,13,-4
27,15,33,12,10,2
27,15,34,7,14,-7
27,15,35,12,25,-13
27,15,36,10,10,0
27,15,37,13,27,-14
27,15,38,17,17,0
27,15,39,8,12,-4
27,15,40,15,24,-9
27,15,41,10,23,-13
27,15,42,6,15,-9
27,15,43,16,15,1
27,15,44,13,19,-6
27,15,45,11,5,6
27,15,46,23,23,0
27,15,47,14,17,-3
27,15,48,18,21,-3
27,15,49,18,20,-2
27,15,50,21,20,1
27,15,51,16,13,3
27,15,52,14,19,-5
27,15,53,11,10,1
27,15,54,20,20,0
27,15,55,6,3,3
27,15,56,1,9,-8
27,15,57,12,19,-7
27,15,58,16,34,-18
27,15,59,12,14,-2
27,15,60,12,14,-2
27,15,61,7,17,-10
27,15,62,5,16,-11
27,15,63,12,24,-12
27,15,64,10,32,-22
27,15,65,1,24,-23
27,15,66,2,14,-12
27,15,67,7,22,-15
27,15,68,18,31,-13
27,15,69,21,30,-9
27,15,70,8,16,-8
27,15,71,18,14,4
27,15,72,11,9,2
27,15,73,11,9,2
27,15,74,12,17,-5
27,15,75,11,22,-11
27,15,76,7,10,-3
27,15,77,10,22,-12
27,15,78,15,18,-3
27,15,79,9,15,-6
27,15,80,17,22,-5
27,15,81,12,22,-10
27,15,82,5,13,-8
27,15,83,20,25,-5
27,15,84,10,24,-14
27,15,85,20,26,-6
27,15,86,10,23,-13
27,15,87,12,12,0
27,15,88,5,18,-13
27,15,89,2,15,-13
27,15,90,13,13,0
27,15,91,2,24,-22
27,15,92,17,19,-2
27,15,93,10,22,-12
27,15,94,12,10,2
27,15,95,13,28,-15
27,15,96,11,15,-4
27,15,97,12,28,-16
27,15,98,9,28,-19
27,15,99,8,12,-4
27,15,100,21,17,4
27,15,101,13,15,-2
27,15,102,10,11,-1
27,15,103,12,18,-6
27,15,104,10,25,-15
27,15,105,15,16,-1
27,15,106,5,14,-9
27,15,107,12,21,-9
27,15,108,12,28,-16
27,15,109,0,13,-13
27,15,110,10,14,-4
27,15,111,9,6,3
27,15,112,13,16,-3
27,15,113,13,24,-11
27,15,114,14,8,6
27,15,115,7,10,-3
27,15,116,7,13,-6
27,15,117,6,10,-4
27,15,118,22,14,8
27,15,119,8,22,-14
27,15,120,6,9,-3
27,15,121,11,23,-12
27,15,122,14,16,-2
27,15,123,19,20,-1
27,15,124,6,14,-8
27,15,125,15,19,-4
27,15,126,8,8,0
27,15,127,15,16,-1
27,15,128,12,9,3
27,15,129,10,11,-1
27,15,130,22,23,-1
27,15,131,11,34,-23
27,15,132,14,16,-2
27,15,133,10,19,-9
27,15,134,0,15,-15
27,15,135,7,14,-7
27,15,136,8,13,-5
27,15,137,8,19,-11
27,15,138,11,30,-19
27,15,139,6,17,-11
27,15,140,13,13,0
27,15,141,11,23,-12
27,15,142,17,23,-6
27,15,143,11,19,-8
27,15,144,16,20,-4
27,15,145,15,21,-6
27,15,146,9,25,-16
27,15,147,12,38,-26
27,15,148,11,18,-7
27,15,149,2,12,-10
27,15,150,6,28,-22
27,15,151,13,19,-6
27,15,152,11,21,-10
27,15,153,5,8,-3
27,15,154,11,9,2
27,15,155,9,15,-6
27,15,156,16,17,-1
27,15,157,10,16,-6
27,15,158,22,16,6
27,15,159,12,19,-7
27,15,160,15,14,1
27,15,161,12,15,-3
27,15,162,13,19,-6
27,15,163,18,13,5
27,15,164,9,11,-2
27,15,165,15,16,-1
27,15,166,10,19,-9
27,15,167,12,15,-3
27,15,168,10,10,0
27,15,169,18,14,4
27,15,170,12,27,-15
27,15,171,14,19,-5
27,15,172,6,21,-15
27,15,173,19,17,2
27,15,174,17,12,5
27,15,175,12,21,-9
27,15,176,7,18,-11
27,15,177,10,19,-9
27,15,178,9,11,-2
27,15,179,14,10,4
27,15,180,3,6,-3
27,15,181,14,25,-11
27,15,182,12,17,-5
27,15,183,12,26,-14
27,15,184,18,25,-7
27,15,185,6,22,-16
27,15,186,3,12,-9
27,15,187,13,30,-17
27,15,188,5,18,-13
27,15,189,8,5,3
27,15,190,6,11,-5
27,15,191,25,21,4
27,15,192,20,15,5
27,15,193,6,15,-9
27,15,194,13,22,-9
27,15,195,17,13,4
27,15,196,20,18,2
27,15,197,8,9,-1
27,15,198,8,4,4
27,15,199,13,12,1
27,15,200,7,12,-5
27,15,201,5,2,3
27,15,202,6,20,-14
27,15,203,20,15,5
27,15,204,12,19,-7
27,15,205,8,13,-5
27,15,206,13,18,-5
27,15,207,5,11,-6
27,15,208,14,17,-3
27,15,209,15,26,-11
27,15,210,15,24,-9
27,15,211,14,24,-10
27,15,212,5,21,-16
27,15,213,8,14,-6
27,15,214,6,13,-7
27,15,215,12,23,-11
27,15,216,11,14,-3
27,15,217,12,8,4
27,15,218,10,16,-6
27,15,219,7,15,-8
27,15,220,16,19,-3
27,15,221,6,17,-11
27,15,222,12,14,-2
27,15,223,3,27,-24
27,15,224,15,21,-6
27,15,225,1,14,-13
27,15,226,14,16,-2
27,15,227,14,14,0
27,15,228,7,23,-16
27,15,229,15,17,-2
27,15,230,11,18,-7
27,15,231,15,19,-4
27,15,232,13,30,-17
27,15,233,6,24,-18
27,15,234,7,25,-18
27,15,235,6,14,-8
27,15,236,11,15,-4
27,15,237,12,16,-4
27,15,238,7,6,1
27,15,239,7,13,-6
27,15,240,7,7,0
27,15,241,3,9,-6
27,15,242,6,23,-17
27,15,243,10,19,-9
27,15,244,6,17,-11
27,15,245,15,17,-2
27,15,246,9,20,-11
27,15,247,7,8,-1
27,15,248,7,18,-11
27,15,249,11,23,-12
27,15,250,11,13,-2
27,15,251,12,20,-8
27,15,252,20,18,2
27,15,253,5,15,-10
27,15,254,16,30,-14
27,15,255,10,17,-7
27,15,256,5,16,-11
27,15,257,21,23,-2
27,15,258,9,18,-9
27,15,259,12,18,-6
27,15,260,7,9,-2
27,15,261,11,18,-7
27,15,262,12,29,-17
27,15,263,15,21,-6
27,15,264,9,17,-8
27,15,265,11,19,-8
27,15,266,13,20,-7
27,15,267,7,7,0
27,15,268,5,10,-5
27,15,269,14,24,-10
27,15,270,15,10,5
27,15,271,12,11,1
27,15,272,9,12,-3
27,15,273,5,10,-5
27,15,274,15,21,-6
27,15,275,8,16,-8
27,15,276,5,13,-8
27,15,277,8,14,-6
27,15,278,7,21,-14
27,15,279,12,20,-8
27,15,280,4,12,-8
27,15,281,15,25,-10
27,15,282,14,23,-9
27,15,283,8,16,-8
27,15,284,9,17,-8
27,15,285,12,27,-15
27,15,286,14,11,3
27,15,287,5,20,-15
27,15,288,23,11,12
27,15,289,10,16,-6
27,15,290,10,16,-6
27,15,291,6,22,-16
27,15,292,8,6,2
27,15,293,21,16,5
27,15,294,13,17,-4
27,15,295,4,13,-9
27,15,296,7,12,-5
27,15,297,12,15,-3
27,15,298,4,15,-11
27,15,299,3,19,-16
27,16,0,10,10,0
27,16,1,9,14,-5
27,16,2,17,18,-1
27,16,3,12,26,-14
27,16,4,6,16,-10
27,16,5,15,16,-1
27,16,6,6,10,-4
27,16,7,11,21,-10
27,16,8,15,17,-2
27,16,9,2,15,-13
27,16,10,15,13,2
27,16,11,15,23,-8
27,16,12,13,28,-15
27,16,13,12,6,6
27,16,14,9,19,-10
27,16,15,16,28,-12
27,16,16,12,14,-2
27,16,17,14,25,-11
27,16,18,16,27,-11
27,16,19,11,0,11
27,16,20,8,13,-5
27,16,21,22,15,7
27,16,22,15,29,-14
27,16,23,12,13,-1
27,16,24,13,11,2
27,16,25,21,23,-2
27,16,26,13,22,-9
27,16,27,10,13,-3
27,16,28,7,7,0
27,16,29,2,23,-21
27,16,30,1,14,-13
27,16,31,6,12,-6
27,16,32,12,26,-14
27,16,33,3,20,-17
27,16,34,8,26,-18
27,16,35,17,22,-5
27,16,36,10,25,-15
27,16,37,8,29,-21
27,16,38,8,18,-10
27,16,39,20,23,-3
27,16,40,11,23,-12
27,16,41,8,30,-22
27,16,42,27,38,-11
27,16,43,13,21,-8
27,16,44,2,9,-7
27,16,45,3,15,-12
27,16,46,6,24,-18
27,16,47,9,12,-3
27,16,48,6,13,-7
27,16,49,14,16,-2
27,16,50,10,15,-5
27,16,51,8,19,-11
27,16,52,3,4,-1
27,16,53,15,23,-8
27,16,54,15,11,4
27,16,55,15,23,-8
27,16,56,15,16,-1
27,16,57,13,34,-21
27,16,58,11,8,3
27,16,59,7,14,-7
27,16,60,6,11,-5
27,16,61,16,13,3
27,16,62,11,22,-11
27,16,63,4,9,-5
27,16,64,14,22,-8
27,16,65,12,11,1
27,16,66,13,17,-4
27,16,67,6,13,-7
27,16,68,13,13,0
27,16,69,8,17,-9
27,16,70,6,11,-5
27,16,71,17,16,1
27,16,72,9,23,-14
27,16,73,11,21,-10
27,16,74,21,18,3
27,16,75,19,15,4
27,16,76,14,26,-12
27,16,77,12,27,-15
27,16,78,6,8,-2
27,16,79,12,24,-12
27,16,80,12,27,-15
27,16,81,15,5,10
27,16,82,14,13,1
27,16,83,7,5,2
27,16,84,6,15,-9
27,16,85,10,13,-3
27,16,86,11,15,-4
27,16,87,10,19,-9
27,16,88,9,17,-8
27,16,89,7,14,-7
27,16,90,10,7,3
27,16,91,14,22,-8
27,16,92,11,14,-3
27,16,93,12,18,-6
27,16,94,11,14,-3
27,16,95,7,13,-6
27,16,96,18,13,5
27,16,97,23,33,-10
27,16,98,7,11,-4
27,16,99,10,12,-2
27,16,100,9,12,-3
27,16,101,13,14,-1
27,16,102,11,18,-7
27,16,103,18,25,-7
27,16,104,16,27,-11
27,16,105,13,15,-2
27,16,106,6,9,-3
27,16,107,8,19,-11
27,16,108,12,14,-2
27,16,109,10,18,-8
27,16,110,5,20,-15
27,16,111,10,17,-7
27,16,112,14,25,-11
27,16,113,2,16,-14
27,16,114,6,12,-6
27,16,115,9,14,-5
27,16,116,10,12,-2
27,16,117,10,20,-10
27,16,118,16,13,3
27,16,119,13,22,-9
27,16,120,16,27,-11
27,16,121,17,22,-5
27,16,122,8,11,-3
27,16,123,9,20,-11
27,16,124,7,15,-8
27,16,125,13,27,-14
27,16,126,12,26,-14
27,16,127,12,7,5
27,16,128,12,11,1
27,16,129,8,6,2
27,16,130,10,21,-11
27,16,131,13,25,-12
27,16,132,3,17,-14
27,16,133,17,3,14
27,16,134,19,21,-2
27,16,135,15,8,7
27,16,136,6,13,-7
27,16,137,14,18,-4
27,16,138,17,17,0
27,16,139,17,22,-5
27,16,140,11,24,-13
27,16,141,8,11,-3
27,16,142,12,30,-18
27,16,143,23,28,-5
27,16,144,4,24,-20
27,16,145,8,10,-2
27,16,146,7,15,-8
27,16,147,3,7,-4
27,16,148,12,7,5
27,16,149,12,13,-1
27,16,150,12,19,-7
27,16,151,10,11,-1
27,16,152,14,9,5
27,16,153,10,9,1
27,16,154,6,9,-3
27,16,155,18,18,0
27,16,156,6,33,-27
27,16,157,9,15,-6
27,16,158,9,17,-8
27,16,159,7,24,-17
27,16,160,8,15,-7
27,16,161,4,17,-13
27,16,162,22,18,4
27,16,163,15,16,-1
27,16,164,22,30,-8
27,16,165,7,11,-4
27,16,166,14,13,1
27,16,167,7,13,-6
27,16,168,6,10,-4
27,16,169,11,3,8
27,16,170,15,36,-21
27,16,171,7,26,-19
27,16,172,28,18,10
27,16,173,20,10,10
27,16,174,13,14,-1
27,16,175,12,19,-7
27,16,176,14,23,-9
27,16,177,7,15,-8
27,16,178,6,23,-17
27,16,179,13,17,-4
27,16,180,6,19,-13
27,16,181,11,12,-1
27,16,182,8,17,-9
27,16,183,14,20,-6
27,16,184,9,23,-14
27,16,185,6,17,-11
27,16,186,11,20,-9
27,16,187,12,21,-9
27,16,188,7,23,-16
27,16,189,10,5,5
27,16,190,11,15,-4
27,16,191,17,27,-10
27,16,192,11,19,-8
27,16,193,7,6,1
27,16,194,10,19,-9
27,16,195,8,15,-7
27,16,196,7,10,-3
27,16,197,22,23,-1
27,16,198,10,17,-7
27,16,199,0,21,-21
27,16,200,12,15,-3
27,16,201,11,20,-9
27,16,202,14,21,-7
27,16,203,7,20,-13
27,16,204,20,26,-6
27,16,205,8,12,-4
27,16,206,9,9,0
27,16,207,13,6,7
27,16,208,13,16,-3
27,16,209,5,8,-3
27,16,210,12,16,-4
27,16,211,5,13,-8
27,16,212,6,14,-8
27,16,213,12,23,-11
27,16,214,11,17,-6
27,16,215,10,27,-17
27,16,216,5,10,-5
27,16,217,7,25,-18
27,16,218,4,13,-9
27,16,219,17,20,-3
27,16,220,13,16,-3
27,16,221,21,26,-5
27,16,222,15,22,-7
27,16,223,9,20,-11
27,16,224,11,30,-19
27,16,225,10,32,-22
27,16,226,10,12,-2
27,16,227,11,22,-11
27,16,228,10,18,-8
27,16,229,6,14,-8
27,16,230,16,22,-6
27,16,231,4,13,-9
27,16,232,5,21,-16
27,16,233,16,12,4
27,16,234,8,17,-9
27,16,235,11,22,-11
27,16,236,14,15,-1
27,16,237,21,16,5
27,16,238,19,25,-6
27,16,239,17,16,1
27,16,240,22,21,1
27,16,241,27,12,15
27,16,242,21,18,3
27,16,243,9,16,-7
27,16,244,11,12,-1
27,16,245,5,22,-17
27,16,246,8,25,-17
27,16,247,10,8,2
27,16,248,16,22,-6
27,16,249,7,11,-4
27,16,250,11,14,-3
27,16,251,9,8,1
27,16,252,18,24,-6
27,16,253,15,24,-9
27,16,254,11,28,-17
27,16,255,3,16,-13
27,16,256,13,19,-6
27,16,257,13,10,3
27,16,258,6,14,-8
27,16,259,14,18,-4
27,16,260,8,27,-19
27,16,261,3,12,-9
27,16,262,11,8,3
27,16,263,12,19,-7
27,16,264,7,7,0
27,16,265,8,7,1
27,16,266,12,12,0
27,16,267,4,15,-11
27,16,268,6,9,-3
27,16,269,3,16,-13
27,16,270,12,19,-7
27,16,271,14,15,-1
27,16,272,3,11,-8
27,16,273,16,24,-8
27,16,274,22,15,7
27,16,275,20,25,-5
27,16,276,4,15,-11
27,16,277,11,22,-11
27,16,278,14,25,-11
27,16,279,21,18,3
27,16,280,9,17,-8
27,16,281,11,17,-6
27,16,282,5,20,-15
27,16,283,19,15,4
27,16,284,11,28,-17
27,16,285,19,24,-5
27,16,286,15,16,-1
27,16,287,12,17,-5
27,16,288,17,18,-1
27,16,289,9,12,-3
27,16,290,9,9,0
27,16,291,14,17,-3
27,16,292,7,21,-14
27,16,293,6,9,-3
27,16,294,5,20,-15
27,16,295,7,5,2
27,16,296,16,24,-8
27,16,297,8,8,0
27,16,298,8,21,-13
27,16,299,13,13,0
27,17,0,10,16,-6
27,17,1,7,20,-13
27,17,2,15,25,-10
27,17,3,12,17,-5
27,17,4,8,20,-12
27,17,5,9,14,-5
27,17,6,1,10,-9
27,17,7,11,22,-11
27,17,8,13,5,8
27,17,9,11,15,-4
27,17,10,7,22,-15
27,17,11,15,21,-6
27,17,12,15,14,1
27,17,13,8,14,-6
27,17,14,6,11,-5
27,17,15,15,24,-9
27,17,16,9,16,-7
27,17,17,14,22,-8
27,17,18,12,9,3
27,17,19,15,17,-2
27,17,20,6,10,-4
27,17,21,10,7,3
27,17,22,5,11,-6
27,17,23,10,9,1
27,17,24,14,18,-4
27,17,25,15,5,10
27,17,26,10,16,-6
27,17,27,13,11,2
27,17,28,20,12,8
27,17,29,16,24,-8
27,17,30,6,12,-6
27,17,31,15,27,-12
27,17,32,4,8,-4
27,17,33,10,12,-2
27,17,34,19,20,-1
27,17,35,13,14,-1
27,17,36,10,17,-7
27,17,37,10,23,-13
27,17,38,5,16,-11
27,17,39,12,16,-4
27,17,40,3,14,-11
27,17,41,13,16,-3
27,17,42,14,14,0
27,17,43,9,11,-2
27,17,44,15,36,-21
27,17,45,15,22,-7
27,17,46,19,24,-5
27,17,47,4,12,-8
27,17,48,22,32,-10
27,17,49,5,22,-17
27,17,50,10,20,-10
27,17,51,7,8,-1
27,17,52,8,15,-7
27,17,53,14,24,-10
27,17,54,6,12,-6
27,17,55,1,14,-13
27,17,56,17,23,-6
27,17,57,16,20,-4
27,17,58,10,7,3
27,17,59,16,22,-6
27,17,60,3,15,-12
27,17,61,7,15,-8
27,17,62,9,30,-21
27,17,63,5,5,0
27,17,64,21,36,-15
27,17,65,22,15,7
27,17,66,16,14,2
27,17,67,8,15,-7
27,17,68,11,16,-5
27,17,69,10,13,-3
27,17,70,10,16,-6
27,17,71,6,18,-12
27,17,72,17,20,-3
27,17,73,9,14,-5
27,17,74,15,33,-18
27,17,75,2,9,-7
27,17,76,10,16,-6
27,17,77,9,7,2
27,17,78,3,11,-8
27,17,79,12,19,-7
27,17,80,7,21,-14
27,17,81,17,11,6
27,17,82,10,29,-19
27,17,83,6,4,2
27,17,84,11,21,-10
27,17,85,21,20,1
27,17,86,24,17,7
27,17,87,5,9,-4
27,17,88,9,9,0
27,17,89,14,21,-7
27,17,90,14,13,1
27,17,91,11,14,-3
27,17,92,9,13,-4
27,17,93,13,16,-3
27,17,94,14,13,1
27,17,95,19,15,4
27,17,96,17,9,8
27,17,97,9,16,-7
27,17,98,9,7,2
27,17,99,20,15,5
27,17,100,6,18,-12
27,17,101,10,11,-1
27,17,102,18,15,3
27,17,103,13,27,-14
27,17,104,17,27,-10
27,17,105,10,12,-2
27,17,106,8,13,-5
27,17,107,27,13,14
27,17,108,11,26,-15
27,17,109,15,20,-5
27,17,110,10,14,-4
27,17,111,21,11,10
27,17,112,15,18,-3
27,17,113,17,17,0
27,17,114,10,25,-15
27,17,115,6,22,-16
27,17,116,9,18,-9
27,17,117,6,27,-21
27,17,118,6,4,2
27,17,119,10,17,-7
27,17,120,10,5,5
27,17,121,17,14,3
27,17,122,7,41,-34
27,17,123,5,9,-4
27,17,124,7,9,-2
27,17,125,13,15,-2
27,17,126,20,13,7
27,17,127,11,20,-9
27,17,128,18,14,4
27,17,129,9,13,-4
27,17,130,5,9,-4
27,17,131,15,19,-4
27,17,132,6,6,0
27,17,133,7,12,-5
27,17,134,13,12,1
27,17,135,5,10,-5
27,17,136,14,27,-13
27,17,137,10,20,-10
27,17,138,7,13,-6
27,17,139,4,17,-13
27,17,140,9,10,-1
27,17,141,14,20,-6
27,17,142,12,11,1
27,17,143,9,16,-7
27,17,144,11,19,-8
27,17,145,20,30,-10
27,17,146,7,11,-4
27,17,147,8,17,-9
27,17,148,12,22,-10
27,17,149,8,11,-3
27,17,150,15,18,-3
27,17,151,10,18,-8
27,17,152,19,27,-8
27,17,153,16,26,-10
27,17,154,16,7,9
27,17,155,14,25,-11
27,17,156,4,26,-22
27,17,157,9,17,-8
27,17,158,10,9,1
27,17,159,7,16,-9
27,17,160,13,11,2
27,17,161,15,22,-7
27,17,162,6,12,-6
27,17,163,11,32,-21
27,17,164,13,18,-5
27,17,165,10,12,-2
27,17,166,17,12,5
27,17,167,7,14,-7
27,17,168,6,25,-19
27,17,169,5,18,-13
27,17,170,12,23,-11
27,17,171,17,12,5
27,17,172,17,22,-5
27,17,173,18,8,10
27,17,174,2,12,-10
27,17,175,7,14,-7
27,17,176,6,6,0
27,17,177,7,9,-2
27,17,178,10,18,-8
27,17,179,11,19,-8
27,17,180,10,20,-10
27,17,181,14,15,-1
27,17,182,13,11,2
27,17,183,10,9,1
27,17,184,5,7,-2
27,17,185,4,14,-10
27,17,186,11,18,-7
27,17,187,15,31,-16
27,17,188,15,14,1
27,17,189,17,28,-11
27,17,190,13,22,-9
27,17,191,12,29,-17
27,17,192,17,14,3
27,17,193,9,19,-10
27,17,194,10,19,-9
27,17,195,7,14,-7
27,17,196,12,5,7
27,17,197,13,22,-9
27,17,198,10,20,-10
27,17,199,13,14,-1
27,17,200,8,19,-11
27,17,201,15,16,-1
27,17,202,20,35,-15
27,17,203,18,23,-5
27,17,204,8,15,-7
27,17,205,7,14,-7
27,17,206,17,26,-9
27,17,207,21,20,1
27,17,208,8,14,-6
27,17,209,16,22,-6
27,17,210,22,24,-2
27,17,211,10,19,-9
27,17,212,4,22,-18
27,17,213,8,27,-19
27,17,214,7,5,2
27,17,215,10,26,-16
27,17,216,15,20,-5
27,17,217,18,20,-2
27,17,218,15,22,-7
27,17,219,4,23,-19
27,17,220,13,18,-5
27,17,221,10,13,-3
27,17,222,8,10,-2
27,17,223,9,19,-10
27,17,224,6,18,-12
27,17,225,7,11,-4
27,17,226,13,13,0
27,17,227,12,7,5
27,17,228,10,32,-22
27,17,229,9,14,-5
27,17,230,14,7,7
27,17,231,25,10,15
27,17,232,10,17,-7
27,17,233,12,20,-8
27,17,234,12,19,-7
27,17,235,8,17,-9
27,17,236,25,23,2
27,17,237,4,17,-13
27,17,238,17,24,-7
27,17,239,30,35,-5
27,17,240,12,18,-6
27,17,241,12,10,2
27,17,242,4,12,-8
27,17,243,4,8,-4
27,17,244,11,17,-6
27,17,245,12,9,3
27,17,246,10,19,-9
27,17,247,17,14,3
27,17,248,8,13,-5
27,17,249,3,26,-23
27,17,250,14,8,6
27,17,251,17,23,-6
27,17,252,9,14,-5
27,17,253,19,27,-8
27,17,254,18,3,15
27,17,255,11,6,5
27,17,256,23,31,-8
27,17,257,21,26,-5
27,17,258,9,9,0
27,17,259,9,13,-4
27,17,260,17,19,-2
27,17,261,13,23,-10
27,17,262,12,25,-13
27,17,263,5,20,-15
27,17,264,5,15,-10
27,17,265,8,13,-5
27,17,266,6,23,-17
27,17,267,15,6,9
27,17,268,7,22,-15
27,17,269,12,20,-8
27,17,270,7,20,-13
27,17,271,6,15,-9
27,17,272,14,22,-8
27,17,273,13,12,1
27,17,274,17,14,3
27,17,275,17,11,6
27,17,276,13,14,-1
27,17,277,7,18,-11
27,17,278,5,12,-7
27,17,279,12,25,-13
27,17,280,10,12,-2
27,17,281,5,13,-8
27,17,282,13,20,-7
27,17,283,21,17,4
27,17,284,18,15,3
27,17,285,8,10,-2
27,17,286,6,19,-13
27,17,287,13,25,-12
27,17,288,2,4,-2
27,17,289,9,14,-5
27,17,290,20,15,5
27,17,291,8,19,-11
27,17,292,19,26,-7
27,17,293,22,32,-10
27,17,294,15,23,-8
27,17,295,11,7,4
27,17,296,7,20,-13
27,17,297,6,17,-11
27,17,298,12,8,4
27,17,299,7,20,-13
27,18,0,6,13,-7
27,18,1,9,18,-9
27,18,2,3,6,-3
27,18,3,12,5,7
27,18,4,13,20,-7
27,18,5,20,20,0
27,18,6,13,20,-7
27,18,7,21,24,-3
27,18,8,12,24,-12
27,18,9,20,13,7
27,18,10,14,9,5
27,18,11,13,9,4
27,18,12,18,14,4
27,18,13,11,12,-1
27,18,14,3,10,-7
27,18,15,11,14,-3
27,18,16,5,11,-6
27,18,17,7,19,-12
27,18,18,4,16,-12
27,18,19,11,16,-5
27,18,20,2,18,-16
27,18,21,21,22,-1
27,18,22,11,16,-5
27,18,23,14,20,-6
27,18,24,18,23,-5
27,18,25,5,12,-7
27,18,26,3,23,-20
27,18,27,11,27,-16
27,18,28,14,12,2
27,18,29,10,21,-11
27,18,30,10,12,-2
27,18,31,18,15,3
27,18,32,7,15,-8
27,18,33,13,20,-7
27,18,34,2,21,-19
27,18,35,13,11,2
27,18,36,14,11,3
27,18,37,15,17,-2
27,18,38,11,13,-2
27,18,39,6,18,-12
27,18,40,10,8,2
27,18,41,14,23,-9
27,18,42,13,13,0
27,18,43,14,16,-2
27,18,44,10,6,4
27,18,45,8,14,-6
27,18,46,18,15,3
27,18,47,10,19,-9
27,18,48,13,19,-6
27,18,49,6,18,-12
27,18,50,11,23,-12
27,18,51,4,7,-3
27,18,52,10,17,-7
27,18,53,3,7,-4
27,18,54,12,19,-7
27,18,55,12,15,-3
27,18,56,7,10,-3
27,18,57,9,10,-1
27,18,58,10,12,-2
27,18,59,31,12,19
27,18,60,8,19,-11
27,18,61,8,16,-8
27,18,62,13,17,-4
27,18,63,12,19,-7
27,18,64,8,15,-7
27,18,65,8,4,4
27,18,66,14,22,-8
27,18,67,6,6,0
27,18,68,2,15,-13
27,18,69,19,27,-8
27,18,70,8,15,-7
27,18,71,13,22,-9
27,18,72,18,18,0
27,18,73,7,12,-5
27,18,74,10,16,-6
27,18,75,12,16,-4
27,18,76,23,14,9
27,18,77,8,13,-5
27,18,78,17,28,-11
27,18,79,8,11,-3
27,18,80,12,15,-3
27,18,81,12,8,4
27,18,82,13,12,1
27,18,83,9,11,-2
27,18,84,13,10,3
27,18,85,11,10,1
27,18,86,13,13,0
27,18,87,7,10,-3
27,18,88,11,12,-1
27,18,89,6,20,-14
27,18,90,15,18,-3
27,18,91,12,9,3
27,18,92,7,16,-9
27,18,93,15,16,-1
27,18,94,17,22,-5
27,18,95,11,13,-2
27,18,96,5,6,-1
27,18,97,13,12,1
27,18,98,21,18,3
27,18,99,8,17,-9
27,18,100,9,16,-7
27,18,101,11,12,-1
27,18,102,4,14,-10
27,18,103,14,13,1
27,18,104,12,19,-7
27,18,105,11,7,4
27,18,106,15,39,-24
27,18,107,6,12,-6
27,18,108,9,19,-10
27,18,109,13,17,-4
27,18,110,6,27,-21
27,18,111,6,3,3
27,18,112,5,3,2
27,18,113,12,21,-9
27,18,114,19,6,13
27,18,115,13,19,-6
27,18,116,12,14,-2
27,18,117,7,5,2
27,18,118,13,27,-14
27,18,119,9,16,-7
27,18,120,11,14,-3
27,18,121,19,19,0
27,18,122,12,12,0
27,18,123,8,4,4
27,18,124,8,14,-6
27,18,125,9,19,-10
27,18,126,10,16,-6
27,18,127,12,12,0
27,18,128,9,16,-7
27,18,129,16,7,9
27,18,130,9,11,-2
27,18,131,10,23,-13
27,18,132,22,20,2
27,18,133,9,16,-7
27,18,134,15,17,-2
27,18,135,14,24,-10
27,18,136,7,24,-17
27,18,137,7,15,-8
27,18,138,14,21,-7
27,18,139,10,16,-6
27,18,140,8,16,-8
27,18,141,2,14,-12
27,18,142,14,26,-12
27,18,143,10,14,-4
27,18,144,14,18,-4
27,18,145,15,16,-1
27,18,146,11,14,-3
27,18,147,13,14,-1
27,18,148,17,31,-14
27,18,149,7,16,-9
27,18,150,14,15,-1
27,18,151,8,14,-6
27,18,152,10,21,-11
27,18,153,11,20,-9
27,18,154,13,25,-12
27,18,155,10,13,-3
27,18,156,6,20,-14
27,18,157,10,18,-8
27,18,158,8,4,4
27,18,159,12,14,-2
27,18,160,5,18,-13
27,18,161,12,18,-6
27,18,162,18,15,3
27,18,163,20,27,-7
27,18,164,7,8,-1
27,18,165,16,26,-10
27,18,166,7,15,-8
27,18,167,17,25,-8
27,18,168,6,10,-4
27,18,169,6,3,3
27,18,170,11,27,-16
27,18,171,20,13,7
27,18,172,12,29,-17
27,18,173,3,9,-6
27,18,174,14,16,-2
27,18,175,6,14,-8
27,18,176,7,22,-15
27,18,177,5,12,-7
27,18,178,12,14,-2
27,18,179,21,21,0
27,18,180,4,15,-11
27,18,181,13,20,-7
27,18,182,11,16,-5
27,18,183,7,20,-13
27,18,184,8,15,-7
27,18,185,4,12,-8
27,18,186,21,22,-1
27,18,187,7,16,-9
27,18,188,17,17,0
27,18,189,16,19,-3
27,18,190,3,2,1
27,18,191,22,21,1
27,18,192,14,15,-1
27,18,193,13,23,-10
27,18,194,7,12,-5
27,18,195,17,15,2
27,18,196,5,19,-14
27,18,197,18,17,1
27,18,198,11,16,-5
27,18,199,10,23,-13
27,18,200,14,8,6
27,18,201,13,15,-2
27,18,202,13,23,-10
27,18,203,14,17,-3
27,18,204,12,10,2
27,18,205,11,11,0
27,18,206,10,20,-10
27,18,207,3,7,-4
27,18,208,13,24,-11
27,18,209,13,25,-12
27,18,210,18,17,1
27,18,211,9,14,-5
27,18,212,9,16,-7
27,18,213,3,8,-5
27,18,214,16,10,6
27,18,215,6,15,-9
27,18,216,14,20,-6
27,18,217,11,11,0
27,18,218,8,8,0
27,18,219,25,24,1
27,18,220,17,10,7
27,18,221,14,30,-16
27,18,222,13,12,1
27,18,223,8,11,-3
27,18,224,10,19,-9
27,18,225,12,18,-6
27,18,226,10,18,-8
27,18,227,9,22,-13
27,18,228,4,7,-3
27,18,229,8,14,-6
27,18,230,7,7,0
27,18,231,8,23,-15
27,18,232,9,19,-10
27,18,233,9,17,-8
27,18,234,8,7,1
27,18,235,4,24,-20
27,18,236,8,2,6
27,18,237,14,18,-4
27,18,238,6,9,-3
27,18,239,9,3,6
27,18,240,7,16,-9
27,18,241,8,18,-10
27,18,242,19,23,-4
27,18,243,10,18,-8
27,18,244,18,24,-6
27,18,245,12,9,3
27,18,246,13,14,-1
27,18,247,17,16,1
27,18,248,8,15,-7
27,18,249,9,24,-15
27,18,250,10,10,0
27,18,251,34,27,7
27,18,252,8,25,-17
27,18,253,8,24,-16
27,18,254,18,27,-9
27,18,255,10,9,1
27,18,256,11,24,-13
27,18,257,14,17,-3
27,18,258,15,10,5
27,18,259,12,12,0
27,18,260,6,19,-13
27,18,261,11,27,-16
27,18,262,10,9,1
27,18,263,6,15,-9
27,18,264,15,17,-2
27,18,265,7,23,-16
27,18,266,11,15,-4
27,18,267,13,20,-7
27,18,268,17,18,-1
27,18,269,20,12,8
27,18,270,19,18,1
27,18,271,22,10,12
27,18,272,16,16,0
27,18,273,3,24,-21
27,18,274,5,13,-8
27,18,275,13,15,-2
27,18,276,7,24,-17
27,18,277,18,20,-2
27,18,278,13,25,-12
27,18,279,20,17,3
27,18,280,5,9,-4
27,18,281,18,19,-1
27,18,282,11,17,-6
27,18,283,10,9,1
27,18,284,17,16,1
27,18,285,7,22,-15
27,18,286,4,21,-17
27,18,287,7,15,-8
27,18,288,15,23,-8
27,18,289,19,19,0
27,18,290,6,18,-12
27,18,291,8,14,-6
27,18,292,7,12,-5
27,18,293,8,18,-10
27,18,294,6,13,-7
27,18,295,6,15,-9
27,18,296,6,6,0
27,18,297,22,24,-2
27,18,298,6,9,-3
27,18,299,12,12,0
27,19,0,32,16,16
27,19,1,25,17,8
27,19,2,4,7,-3
27,19,3,19,12,7
27,19,4,13,26,-13
27,19,5,12,19,-7
27,19,6,17,19,-2
27,19,7,7,15,-8
27,19,8,16,31,-15
27,19,9,13,16,-3
27,19,10,4,6,-2
27,19,11,7,8,-1
27,19,12,18,19,-1
27,19,13,16,12,4
27,19,14,16,13,3
27,19,15,6,16,-10
27,19,16,6,10,-4
27,19,17,13,13,0
27,19,18,10,22,-12
27,19,19,7,19,-12
27,19,20,16,8,8
27,19,21,17,19,-2
27,19,22,11,21,-10
27,19,23,10,18,-8
27,19,24,12,19,-7
27,19,25,14,20,-6
27,19,26,11,19,-8
27,19,27,16,14,2
27,19,28,15,26,-11
27,19,29,4,17,-13
27,19,30,10,9,1
27,19,31,13,21,-8
27,19,32,9,32,-23
27,19,33,7,15,-8
27,19,34,11,10,1
27,19,35,4,12,-8
27,19,36,19,38,-19
27,19,37,9,16,-7
27,19,38,6,21,-15
27,19,39,2,16,-14
27,19,40,14,11,3
27,19,41,9,14,-5
27,19,42,12,24,-12
27,19,43,7,15,-8
27,19,44,25,20,5
27,19,45,7,15,-8
27,19,46,7,22,-15
27,19,47,15,11,4
27,19,48,9,19,-10
27,19,49,11,21,-10
27,19,50,7,22,-15
27,19,51,18,16,2
27,19,52,13,17,-4
27,19,53,6,13,-7
27,19,54,12,13,-1
27,19,55,17,19,-2
27,19,56,10,10,0
27,19,57,14,12,2
27,19,58,11,19,-8
27,19,59,4,17,-13
27,19,60,9,9,0
27,19,61,3,8,-5
27,19,62,14,15,-1
27,19,63,17,15,2
27,19,64,14,20,-6
27,19,65,11,16,-5
27,19,66,12,25,-13
27,19,67,8,20,-12
27,19,68,12,22,-10
27,19,69,11,18,-7
27,19,70,10,18,-8
27,19,71,27,22,5
27,19,72,7,12,-5
27,19,73,11,21,-10
27,19,74,10,17,-7
27,19,75,7,5,2
27,19,76,9,11,-2
27,19,77,19,16,3
27,19,78,11,19,-8
27,19,79,23,27,-4
27,19,80,5,13,-8
27,19,81,11,14,-3
27,19,82,18,7,11
27,19,83,17,32,-15
27,19,84,10,16,-6
27,19,85,21,15,6
27,19,86,8,18,-10
27,19,87,7,6,1
27,19,88,11,16,-5
27,19,89,14,10,4
27,19,90,13,7,6
27,19,91,8,10,-2
27,19,92,8,6,2
27,19,93,12,14,-2
27,19,94,13,16,-3
27,19,95,14,28,-14
27,19,96,9,4,5
27,19,97,17,20,-3
27,19,98,7,11,-4
27,19,99,17,28,-11
27,19,100,15,32,-17
27,19,101,20,27,-7
27,19,102,13,6,7
27,19,103,7,8,-1
27,19,104,20,17,3
27,19,105,15,25,-10
27,19,106,5,12,-7
27,19,107,4,28,-24
27,19,108,7,28,-21
27,19,109,6,17,-11
27,19,110,13,6,7
27,19,111,9,14,-5
27,19,112,17,16,1
27,19,113,12,24,-12
27,19,114,7,10,-3
27,19,115,20,20,0
27,19,116,17,20,-3
27,19,117,11,25,-14
27,19,118,16,9,7
27,19,119,9,8,1
27,19,120,8,17,-9
27,19,121,17,14,3
27,19,122,16,16,0
27,19,123,13,24,-11
27,19,124,13,17,-4
27,19,125,12,19,-7
27,19,126,13,15,-2
27,19,127,5,10,-5
27,19,128,8,4,4
27,19,129,14,23,-9
27,19,130,4,5,-1
27,19,131,10,21,-11
27,19,132,22,19,3
27,19,133,18,20,-2
27,19,134,24,30,-6
27,19,135,13,13,0
27,19,136,18,18,0
27,19,137,17,10,7
27,19,138,11,21,-10
27,19,139,11,14,-3
27,19,140,13,17,-4
27,19,141,11,23,-12
27,19,142,2,23,-21
27,19,143,10,10,0
27,19,144,10,15,-5
27,19,145,11,10,1
27,19,146,15,39,-24
27,19,147,11,17,-6
27,19,148,12,10,2
27,19,149,6,23,-17
27,19,150,6,16,-10
27,19,151,18,23,-5
27,19,152,12,19,-7
27,19,153,10,12,-2
27,19,154,7,14,-7
27,19,155,5,13,-8
27,19,156,11,22,-11
27,19,157,7,9,-2
27,19,158,16,24,-8
27,19,159,2,9,-7
27,19,160,6,8,-2
27,19,161,7,17,-10
27,19,162,19,36,-17
27,19,163,1,14,-13
27,19,164,13,25,-12
27,19,165,15,29,-14
27,19,166,17,30,-13
27,19,167,8,18,-10
27,19,168,14,19,-5
27,19,169,10,15,-5
27,19,170,6,6,0
27,19,171,9,16,-7
27,19,172,12,13,-1
27,19,173,14,19,-5
27,19,174,9,5,4
27,19,175,9,32,-23
27,19,176,14,28,-14
27,19,177,16,30,-14
27,19,178,16,17,-1
27,19,179,4,27,-23
27,19,180,6,26,-20
27,19,181,10,22,-12
27,19,182,10,15,-5
27,19,183,5,12,-7
27,19,184,7,16,-9
27,19,185,8,25,-17
27,19,186,10,6,4
27,19,187,24,6,18
27,19,188,6,12,-6
27,19,189,20,30,-10
27,19,190,13,21,-8
27,19,191,13,10,3
27,19,192,14,35,-21
27,19,193,8,7,1
27,19,194,19,28,-9
27,19,195,19,29,-10
27,19,196,11,13,-2
27,19,197,9,27,-18
27,19,198,12,40,-28
27,19,199,5,18,-13
27,19,200,4,22,-18
27,19,201,16,25,-9
27,19,202,6,14,-8
27,19,203,9,14,-5
27,19,204,13,19,-6
27,19,205,10,13,-3
27,19,206,13,24,-11
27,19,207,7,20,-13
27,19,208,3,12,-9
27,19,209,14,16,-2
27,19,210,7,17,-10
27,19,211,5,6,-1
27,19,212,11,25,-14
27,19,213,6,18,-12
27,19,214,22,19,3
27,19,215,8,10,-2
27,19,216,4,14,-10
27,19,217,11,9,2
27,19,218,11,17,-6
27,19,219,8,11,-3
27,19,220,8,11,-3
27,19,221,19,24,-5
27,19,222,7,21,-14
27,19,223,10,10,0
27,19,224,14,23,-9
27,19,225,5,23,-18
27,19,226,18,26,-8
27,19,227,12,17,-5
27,19,228,14,16,-2
27,19,229,19,13,6
27,19,230,13,16,-3
27,19,231,11,11,0
27,19,232,6,4,2
27,19,233,8,12,-4
27,19,234,11,27,-16
27,19,235,20,29,-9
27,19,236,6,10,-4
27,19,237,7,13,-6
27,19,238,17,13,4
27,19,239,11,13,-2
27,19,240,9,15,-6
27,19,241,9,11,-2
27,19,242,15,23,-8
27,19,243,4,8,-4
27,19,244,10,21,-11
27,19,245,12,15,-3
27,19,246,10,26,-16
27,19,247,17,10,7
27,19,248,11,2,9
27,19,249,14,20,-6
27,19,250,11,30,-19
27,19,251,13,12,1
27,19,252,10,23,-13
27,19,253,12,17,-5
27,19,254,12,19,-7
27,19,255,2,6,-4
27,19,256,14,13,1
27,19,257,25,22,3
27,19,258,4,9,-5
27,19,259,10,7,3
27,19,260,12,13,-1
27,19,261,20,6,14
27,19,262,21,19,2
27,19,263,14,22,-8
27,19,264,10,21,-11
27,19,265,8,11,-3
27,19,266,12,20,-8
27,19,267,13,19,-6
27,19,268,3,9,-6
27,19,269,12,23,-11
27,19,270,12,13,-1
27,19,271,11,10,1
27,19,272,4,21,-17
27,19,273,11,7,4
27,19,274,7,10,-3
27,19,275,7,6,1
27,19,276,14,23,-9
27,19,277,18,16,2
27,19,278,7,12,-5
27,19,279,11,22,-11
27,19,280,15,20,-5
27,19,281,15,20,-5
27,19,282,14,11,3
27,19,283,11,8,3
27,19,284,13,11,2
27,19,285,12,17,-5
27,19,286,7,16,-9
27,19,287,4,5,-1
27,19,288,17,18,-1
27,19,289,12,11,1
27,19,290,8,17,-9
27,19,291,11,18,-7
27,19,292,18,22,-4
27,19,293,13,10,3
27,19,294,21,16,5
27,19,295,9,18,-9
27,19,296,11,16,-5
27,19,297,16,17,-1
27,19,298,14,15,-1
27,19,299,2,7,-5
27,20,0,15,20,-5
27,20,1,18,11,7
27,20,2,5,11,-6
27,20,3,8,6,2
27,20,4,15,11,4
27,20,5,12,23,-11
27,20,6,15,21,-6
27,20,7,9,14,-5
27,20,8,14,19,-5
27,20,9,22,21,1
27,20,10,21,22,-1
27,20,11,8,25,-17
27,20,12,16,7,9
27,20,13,12,15,-3
27,20,14,21,22,-1
27,20,15,10,28,-18
27,20,16,12,19,-7
27,20,17,14,23,-9
27,20,18,16,16,0
27,20,19,17,20,-3
27,20,20,16,19,-3
27,20,21,19,17,2
27,20,22,30,17,13
27,20,23,11,27,-16
27,20,24,18,24,-6
27,20,25,8,14,-6
27,20,26,14,9,5
27,20,27,12,19,-7
27,20,28,6,12,-6
27,20,29,5,11,-6
27,20,30,15,19,-4
27,20,31,19,13,6
27,20,32,20,9,11
27,20,33,7,7,0
27,20,34,13,24,-11
27,20,35,8,20,-12
27,20,36,9,10,-1
27,20,37,9,21,-12
27,20,38,16,22,-6
27,20,39,12,22,-10
27,20,40,17,10,7
27,20,41,27,32,-5
27,20,42,15,23,-8
27,20,43,16,24,-8
27,20,44,24,25,-1
27,20,45,9,15,-6
27,20,46,9,18,-9
27,20,47,12,15,-3
27,20,48,5,10,-5
27,20,49,9,19,-10
27,20,50,16,9,7
27,20,51,20,15,5
27,20,52,9,28,-19
27,20,53,13,15,-2
27,20,54,9,14,-5
27,20,55,14,25,-11
27,20,56,8,8,0
27,20,57,14,17,-3
27,20,58,12,21,-9
27,20,59,9,14,-5
27,20,60,15,21,-6
27,20,61,14,21,-7
27,20,62,6,8,-2
27,20,63,5,13,-8
27,20,64,17,19,-2
27,20,65,10,17,-7
27,20,66,2,7,-5
27,20,67,15,19,-4
27,20,68,17,16,1
27,20,69,6,11,-5
27,20,70,8,6,2
27,20,71,13,10,3
27,20,72,6,15,-9
27,20,73,8,23,-15
27,20,74,17,25,-8
27,20,75,25,3,22
27,20,76,12,7,5
27,20,77,14,10,4
27,20,78,15,18,-3
27,20,79,14,20,-6
27,20,80,7,7,0
27,20,81,10,12,-2
27,20,82,16,19,-3
27,20,83,4,10,-6
27,20,84,11,11,0
27,20,85,11,12,-1
27,20,86,9,11,-2
27,20,87,12,28,-16
27,20,88,0,6,-6
27,20,89,11,10,1
27,20,90,11,23,-12
27,20,91,14,15,-1
27,20,92,8,19,-11
27,20,93,18,14,4
27,20,94,11,16,-5
27,20,95,8,7,1
27,20,96,13,22,-9
27,20,97,14,25,-11
27,20,98,2,16,-14
27,20,99,12,14,-2
27,20,100,7,9,-2
27,20,101,13,24,-11
27,20,102,9,14,-5
27,20,103,13,9,4
27,20,104,7,18,-11
27,20,105,17,23,-6
27,20,106,23,7,16
27,20,107,7,27,-20
27,20,108,24,11,13
27,20,109,18,26,-8
27,20,110,10,13,-3
27,20,111,7,16,-9
27,20,112,14,19,-5
27,20,113,12,12,0
27,20,114,8,23,-15
27,20,115,21,36,-15
27,20,116,3,21,-18
27,20,117,10,7,3
27,20,118,12,15,-3
27,20,119,15,17,-2
27,20,120,4,17,-13
27,20,121,9,18,-9
27,20,122,11,26,-15
27,20,123,7,7,0
27,20,124,16,15,1
27,20,125,8,16,-8
27,20,126,27,22,5
27,20,127,20,27,-7
27,20,128,13,19,-6
27,20,129,12,17,-5
27,20,130,15,28,-13
27,20,131,5,7,-2
27,20,132,8,17,-9
27,20,133,15,16,-1
27,20,134,15,21,-6
27,20,135,20,13,7
27,20,136,3,9,-6
27,20,137,13,8,5
27,20,138,14,10,4
27,20,139,9,7,2
27,20,140,16,21,-5
27,20,141,17,31,-14
27,20,142,14,21,-7
27,20,143,11,17,-6
27,20,144,15,25,-10
27,20,145,18,11,7
27,20,146,3,17,-14
27,20,147,5,21,-16
27,20,148,15,18,-3
27,20,149,6,14,-8
27,20,150,19,24,-5
27,20,151,19,16,3
27,20,152,15,22,-7
27,20,153,21,20,1
27,20,154,11,23,-12
27,20,155,10,10,0
27,20,156,12,18,-6
27,20,157,8,10,-2
27,20,158,16,33,-17
27,20,159,21,28,-7
27,20,160,14,22,-8
27,20,161,16,20,-4
27,20,162,16,11,5
27,20,163,8,26,-18
27,20,164,13,19,-6
27,20,165,11,16,-5
27,20,166,4,7,-3
27,20,167,11,23,-12
27,20,168,21,16,5
27,20,169,9,16,-7
27,20,170,22,23,-1
27,20,171,6,18,-12
27,20,172,17,15,2
27,20,173,20,39,-19
27,20,174,20,19,1
27,20,175,7,15,-8
27,20,176,14,19,-5
27,20,177,5,31,-26
27,20,178,8,29,-21
27,20,179,22,28,-6
27,20,180,10,9,1
27,20,181,11,8,3
27,20,182,7,6,1
27,20,183,6,18,-12
27,20,184,10,19,-9
27,20,185,11,20,-9
27,20,186,10,14,-4
27,20,187,3,13,-10
27,20,188,20,16,4
27,20,189,16,21,-5
27,20,190,9,18,-9
27,20,191,12,16,-4
27,20,192,11,20,-9
27,20,193,20,12,8
27,20,194,9,14,-5
27,20,195,10,10,0
27,20,196,9,11,-2
27,20,197,11,16,-5
27,20,198,12,15,-3
27,20,199,5,16,-11
27,20,200,11,18,-7
27,20,201,7,7,0
27,20,202,17,16,1
27,20,203,7,16,-9
27,20,204,12,12,0
27,20,205,6,9,-3
27,20,206,15,11,4
27,20,207,13,14,-1
27,20,208,14,27,-13
27,20,209,9,11,-2
27,20,210,12,15,-3
27,20,211,17,28,-11
27,20,212,11,23,-12
27,20,213,14,18,-4
27,20,214,7,14,-7
27,20,215,10,17,-7
27,20,216,9,20,-11
27,20,217,12,15,-3
27,20,218,14,18,-4
27,20,219,5,14,-9
27,20,220,20,21,-1
27,20,221,13,13,0
27,20,222,10,12,-2
27,20,223,13,21,-8
27,20,224,14,11,3
27,20,225,7,21,-14
27,20,226,9,8,1
27,20,227,6,29,-23
27,20,228,19,17,2
27,20,229,28,22,6
27,20,230,7,13,-6
27,20,231,11,15,-4
27,20,232,18,22,-4
27,20,233,9,14,-5
27,20,234,7,14,-7
27,20,235,12,17,-5
27,20,236,15,18,-3
27,20,237,12,26,-14
27,20,238,21,22,-1
27,20,239,22,29,-7
27,20,240,9,17,-8
27,20,241,12,4,8
27,20,242,5,23,-18
27,20,243,17,16,1
27,20,244,11,13,-2
27,20,245,9,6,3
27,20,246,15,14,1
27,20,247,14,20,-6
27,20,248,12,20,-8
27,20,249,12,18,-6
27,20,250,10,13,-3
27,20,251,13,17,-4
27,20,252,9,7,2
27,20,253,17,18,-1
27,20,254,8,13,-5
27,20,255,12,4,8
27,20,256,4,16,-12
27,20,257,6,20,-14
27,20,258,3,26,-23
27,20,259,6,17,-11
27,20,260,8,20,-12
27,20,261,11,21,-10
27,20,262,7,15,-8
27,20,263,10,15,-5
27,20,264,16,26,-10
27,20,265,11,24,-13
27,20,266,2,13,-11
27,20,267,6,10,-4
27,20,268,13,23,-10
27,20,269,14,28,-14
27,20,270,13,13,0
27,20,271,17,18,-1
27,20,272,9,12,-3
27,20,273,12,21,-9
27,20,274,9,5,4
27,20,275,7,26,-19
27,20,276,8,18,-10
27,20,277,3,15,-12
27,20,278,8,10,-2
27,20,279,10,13,-3
27,20,280,10,18,-8
27,20,281,10,19,-9
27,20,282,18,13,5
27,20,283,6,16,-10
27,20,284,9,20,-11
27,20,285,15,11,4
27,20,286,9,18,-9
27,20,287,5,23,-18
27,20,288,16,24,-8
27,20,289,6,12,-6
27,20,290,8,24,-16
27,20,291,15,30,-15
27,20,292,8,16,-8
27,20,293,6,20,-14
27,20,294,12,23,-11
27,20,295,11,15,-4
27,20,296,10,11,-1
27,20,297,9,11,-2
27,20,298,8,20,-12
27,20,299,12,21,-9
27,21,0,9,24,-15
27,21,1,7,12,-5
27,21,2,23,8,15
27,21,3,19,12,7
27,21,4,5,10,-5
27,21,5,13,8,5
27,21,6,19,20,-1
27,21,7,19,21,-2
27,21,8,23,15,8
27,21,9,15,14,1
27,21,10,11,20,-9
27,21,11,15,15,0
27,21,12,12,16,-4
27,21,13,16,21,-5
27,21,14,11,15,-4
27,21,15,15,21,-6
27,21,16,8,13,-5
27,21,17,20,14,6
27,21,18,24,36,-12
27,21,19,18,27,-9
27,21,20,12,21,-9
27,21,21,13,11,2
27,21,22,12,22,-10
27,21,23,13,21,-8
27,21,24,21,10,11
27,21,25,16,16,0
27,21,26,12,25,-13
27,21,27,24,10,14
27,21,28,19,11,8
27,21,29,17,30,-13
27,21,30,8,16,-8
27,21,31,7,12,-5
27,21,32,9,24,-15
27,21,33,17,15,2
27,21,34,11,22,-11
27,21,35,14,16,-2
27,21,36,7,11,-4
27,21,37,12,25,-13
27,21,38,5,7,-2
27,21,39,5,8,-3
27,21,40,5,18,-13
27,21,41,14,16,-2
27,21,42,20,10,10
27,21,43,16,13,3
27,21,44,19,20,-1
27,21,45,15,12,3
27,21,46,11,14,-3
27,21,47,21,33,-12
27,21,48,10,13,-3
27,21,49,14,17,-3
27,21,50,13,9,4
27,21,51,8,8,0
27,21,52,4,14,-10
27,21,53,12,30,-18
27,21,54,14,14,0
27,21,55,14,21,-7
27,21,56,15,12,3
27,21,57,10,7,3
27,21,58,12,18,-6
27,21,59,7,15,-8
27,21,60,5,8,-3
27,21,61,20,19,1
27,21,62,16,16,0
27,21,63,17,7,10
27,21,64,13,29,-16
27,21,65,7,14,-7
27,21,66,5,6,-1
27,21,67,7,19,-12
27,21,68,13,17,-4
27,21,69,21,10,11
27,21,70,6,20,-14
27,21,71,9,14,-5
27,21,72,18,18,0
27,21,73,15,23,-8
27,21,74,15,21,-6
27,21,75,8,27,-19
27,21,76,10,28,-18
27,21,77,15,26,-11
27,21,78,7,7,0
27,21,79,13,10,3
27,21,80,18,18,0
27,21,81,10,4,6
27,21,82,15,18,-3
27,21,83,17,18,-1
27,21,84,19,17,2
27,21,85,5,9,-4
27,21,86,3,13,-10
27,21,87,12,17,-5
27,21,88,23,12,11
27,21,89,7,16,-9
27,21,90,8,17,-9
27,21,91,12,13,-1
27,21,92,18,18,0
27,21,93,9,16,-7
27,21,94,26,21,5
27,21,95,13,22,-9
27,21,96,10,11,-1
27,21,97,6,16,-10
27,21,98,13,15,-2
27,21,99,13,18,-5
27,21,100,16,13,3
27,21,101,7,15,-8
27,21,102,4,8,-4
27,21,103,16,20,-4
27,21,104,15,10,5
27,21,105,12,23,-11
27,21,106,16,17,-1
27,21,107,2,21,-19
27,21,108,8,11,-3
27,21,109,12,15,-3
27,21,110,7,19,-12
27,21,111,11,18,-7
27,21,112,4,11,-7
27,21,113,12,9,3
27,21,114,11,8,3
27,21,115,14,12,2
27,21,116,13,14,-1
27,21,117,9,20,-11
27,21,118,9,23,-14
27,21,119,8,7,1
27,21,120,6,14,-8
27,21,121,14,9,5
27,21,122,21,29,-8
27,21,123,7,10,-3
27,21,124,8,28,-20
27,21,125,28,19,9
27,21,126,11,15,-4
27,21,127,7,17,-10
27,21,128,8,11,-3
27,21,129,8,12,-4
27,21,130,3,13,-10
27,21,131,17,17,0
27,21,132,19,23,-4
27,21,133,17,10,7
27,21,134,5,9,-4
27,21,135,15,10,5
27,21,136,11,24,-13
27,21,137,9,13,-4
27,21,138,7,8,-1
27,21,139,18,24,-6
27,21,140,12,28,-16
27,21,141,6,9,-3
27,21,142,7,13,-6
27,21,143,5,10,-5
27,21,144,9,10,-1
27,21,145,6,7,-1
27,21,146,15,20,-5
27,21,147,12,15,-3
27,21,148,17,13,4
27,21,149,18,16,2
27,21,150,10,14,-4
27,21,151,14,17,-3
27,21,152,8,18,-10
27,21,153,6,17,-11
27,21,154,15,13,2
27,21,155,18,14,4
27,21,156,9,13,-4
27,21,157,13,15,-2
27,21,158,12,11,1
27,21,159,8,21,-13
27,21,160,5,18,-13
27,21,161,16,15,1
27,21,162,7,11,-4
27,21,163,10,23,-13
27,21,164,18,28,-10
27,21,165,8,17,-9
27,21,166,18,13,5
27,21,167,9,20,-11
27,21,168,14,20,-6
27,21,169,13,12,1
27,21,170,4,18,-14
27,21,171,8,19,-11
27,21,172,3,19,-16
27,21,173,17,15,2
27,21,174,6,3,3
27,21,175,8,14,-6
27,21,176,7,9,-2
27,21,177,11,12,-1
27,21,178,9,11,-2
27,21,179,15,7,8
27,21,180,12,14,-2
27,21,181,12,10,2
27,21,182,2,19,-17
27,21,183,8,20,-12
27,21,184,13,5,8
27,21,185,5,6,-1
27,21,186,7,16,-9
27,21,187,21,16,5
27,21,188,6,18,-12
27,21,189,12,17,-5
27,21,190,10,13,-3
27,21,191,21,13,8
27,21,192,25,17,8
27,21,193,6,5,1
27,21,194,11,8,3
27,21,195,16,29,-13
27,21,196,9,11,-2
27,21,197,14,24,-10
27,21,198,12,15,-3
27,21,199,17,15,2
27,21,200,15,27,-12
27,21,201,6,13,-7
27,21,202,18,6,12
27,21,203,10,15,-5
27,21,204,16,26,-10
27,21,205,6,7,-1
27,21,206,11,17,-6
27,21,207,16,17,-1
27,21,208,12,21,-9
27,21,209,14,20,-6
27,21,210,7,16,-9
27,21,211,14,17,-3
27,21,212,8,20,-12
27,21,213,11,15,-4
27,21,214,13,18,-5
27,21,215,16,13,3
27,21,216,4,7,-3
27,21,217,14,13,1
27,21,218,7,20,-13
27,21,219,14,20,-6
27,21,220,13,14,-1
27,21,221,11,9,2
27,21,222,22,13,9
27,21,223,21,26,-5
27,21,224,19,21,-2
27,21,225,9,25,-16
27,21,226,8,10,-2
27,21,227,21,21,0
27,21,228,3,10,-7
27,21,229,18,29,-11
27,21,230,9,11,-2
27,21,231,10,16,-6
27,21,232,14,17,-3
27,21,233,6,5,1
27,21,234,4,17,-13
27,21,235,15,17,-2
27,21,236,16,8,8
27,21,237,15,10,5
27,21,238,14,11,3
27,21,239,1,15,-14
27,21,240,16,17,-1
27,21,241,12,15,-3
27,21,242,11,10,1
27,21,243,21,12,9
27,21,244,5,20,-15
27,21,245,3,7,-4
27,21,246,8,6,2
27,21,247,17,11,6
27,21,248,6,17,-11
27,21,249,7,29,-22
27,21,250,6,7,-1
27,21,251,11,10,1
27,21,252,7,13,-6
27,21,253,7,10,-3
27,21,254,17,22,-5
27,21,255,14,16,-2
27,21,256,17,19,-2
27,21,257,5,11,-6
27,21,258,8,12,-4
27,21,259,5,16,-11
27,21,260,3,16,-13
27,21,261,6,11,-5
27,21,262,11,11,0
27,21,263,10,15,-5
27,21,264,4,18,-14
27,21,265,19,10,9
27,21,266,13,25,-12
27,21,267,6,5,1
27,21,268,8,17,-9
27,21,269,20,14,6
27,21,270,6,14,-8
27,21,271,5,11,-6
27,21,272,16,2,14
27,21,273,7,7,0
27,21,274,5,5,0
27,21,275,6,17,-11
27,21,276,13,20,-7
27,21,277,13,20,-7
27,21,278,20,20,0
27,21,279,19,10,9
27,21,280,4,6,-2
27,21,281,14,36,-22
27,21,282,11,13,-2
27,21,283,6,21,-15
27,21,284,4,15,-11
27,21,285,15,10,5
27,21,286,17,12,5
27,21,287,17,14,3
27,21,288,9,6,3
27,21,289,13,24,-11
27,21,290,9,10,-1
27,21,291,14,23,-9
27,21,292,17,9,8
27,21,293,9,7,2
27,21,294,19,22,-3
27,21,295,10,9,1
27,21,296,15,19,-4
27,21,297,12,12,0
27,21,298,11,12,-1
27,21,299,12,23,-11
27,22,0,6,12,-6
27,22,1,15,15,0
27,22,2,12,20,-8
27,22,3,16,19,-3
27,22,4,4,17,-13
27,22,5,9,8,1
27,22,6,14,21,-7
27,22,7,4,9,-5
27,22,8,12,8,4
27,22,9,6,11,-5
27,22,10,8,24,-16
27,22,11,5,16,-11
27,22,12,7,18,-11
27,22,13,17,5,12
27,22,14,18,22,-4
27,22,15,8,13,-5
27,22,16,13,19,-6
27,22,17,19,24,-5
27,22,18,19,18,1
27,22,19,9,10,-1
27,22,20,14,21,-7
27,22,21,7,9,-2
27,22,22,18,16,2
27,22,23,14,10,4
27,22,24,11,17,-6
27,22,25,15,15,0
27,22,26,17,12,5
27,22,27,12,19,-7
27,22,28,15,9,6
27,22,29,10,29,-19
27,22,30,16,10,6
27,22,31,11,14,-3
27,22,32,11,15,-4
27,22,33,10,23,-13
27,22,34,22,9,13
27,22,35,16,23,-7
27,22,36,13,23,-10
27,22,37,13,20,-7
27,22,38,17,18,-1
27,22,39,9,7,2
27,22,40,17,16,1
27,22,41,13,18,-5
27,22,42,11,16,-5
27,22,43,8,16,-8
27,22,44,18,12,6
27,22,45,16,17,-1
27,22,46,7,22,-15
27,22,47,18,28,-10
27,22,48,19,32,-13
27,22,49,6,8,-2
27,22,50,5,14,-9
27,22,51,13,13,0
27,22,52,14,11,3
27,22,53,7,8,-1
27,22,54,23,24,-1
27,22,55,13,14,-1
27,22,56,9,5,4
27,22,57,10,15,-5
27,22,58,14,18,-4
27,22,59,14,21,-7
27,22,60,23,20,3
27,22,61,7,16,-9
27,22,62,10,25,-15
27,22,63,17,13,4
27,22,64,21,21,0
27,22,65,16,26,-10
27,22,66,6,10,-4
27,22,67,12,17,-5
27,22,68,8,23,-15
27,22,69,20,9,11
27,22,70,6,7,-1
27,22,71,5,5,0
27,22,72,12,27,-15
27,22,73,15,10,5
27,22,74,11,20,-9
27,22,75,11,11,0
27,22,76,4,10,-6
27,22,77,27,19,8
27,22,78,14,17,-3
27,22,79,8,14,-6
27,22,80,20,15,5
27,22,81,11,18,-7
27,22,82,6,19,-13
27,22,83,8,20,-12
27,22,84,9,22,-13
27,22,85,12,14,-2
27,22,86,8,19,-11
27,22,87,10,22,-12
27,22,88,16,20,-4
27,22,89,15,11,4
27,22,90,11,8,3
27,22,91,7,9,-2
27,22,92,18,29,-11
27,22,93,6,12,-6
27,22,94,9,15,-6
27,22,95,8,19,-11
27,22,96,8,15,-7
27,22,97,11,14,-3
27,22,98,9,13,-4
27,22,99,11,15,-4
27,22,100,15,29,-14
27,22,101,9,7,2
27,22,102,13,17,-4
27,22,103,15,16,-1
27,22,104,4,24,-20
27,22,105,7,13,-6
27,22,106,22,26,-4
27,22,107,4,0,4
27,22,108,8,15,-7
27,22,109,15,13,2
27,22,110,8,8,0
27,22,111,7,22,-15
27,22,112,11,12,-1
27,22,113,15,14,1
27,22,114,2,16,-14
27,22,115,22,13,9
27,22,116,23,26,-3
27,22,117,11,15,-4
27,22,118,10,14,-4
27,22,119,1,7,-6
27,22,120,3,10,-7
27,22,121,10,19,-9
27,22,122,11,21,-10
27,22,123,14,11,3
27,22,124,22,26,-4
27,22,125,7,11,-4
27,22,126,11,10,1
27,22,127,11,23,-12
27,22,128,22,26,-4
27,22,129,12,10,2
27,22,130,11,13,-2
27,22,131,9,15,-6
27,22,132,11,15,-4
27,22,133,10,19,-9
27,22,134,7,14,-7
27,22,135,14,17,-3
27,22,136,8,11,-3
27,22,137,7,3,4
27,22,138,11,18,-7
27,22,139,26,16,10
27,22,140,21,13,8
27,22,141,8,18,-10
27,22,142,8,10,-2
27,22,143,10,17,-7
27,22,144,17,14,3
27,22,145,26,18,8
27,22,146,5,27,-22
27,22,147,13,21,-8
27,22,148,8,7,1
27,22,149,8,15,-7
27,22,150,17,20,-3
27,22,151,9,20,-11
27,22,152,21,6,15
27,22,153,10,8,2
27,22,154,15,12,3
27,22,155,6,22,-16
27,22,156,21,20,1
27,22,157,9,8,1
27,22,158,19,33,-14
27,22,159,4,4,0
27,22,160,4,16,-12
27,22,161,17,11,6
27,22,162,14,13,1
27,22,163,10,24,-14
27,22,164,15,19,-4
27,22,165,9,19,-10
27,22,166,9,25,-16
27,22,167,19,23,-4
27,22,168,17,14,3
27,22,169,4,23,-19
27,22,170,4,18,-14
27,22,171,6,13,-7
27,22,172,10,11,-1
27,22,173,15,17,-2
27,22,174,14,20,-6
27,22,175,7,17,-10
27,22,176,7,7,0
27,22,177,9,11,-2
27,22,178,13,15,-2
27,22,179,4,12,-8
27,22,180,12,17,-5
27,22,181,6,7,-1
27,22,182,15,16,-1
27,22,183,11,15,-4
27,22,184,20,11,9
27,22,185,8,9,-1
27,22,186,4,5,-1
27,22,187,15,15,0
27,22,188,13,20,-7
27,22,189,14,20,-6
27,22,190,10,6,4
27,22,191,10,11,-1
27,22,192,8,10,-2
27,22,193,8,15,-7
27,22,194,11,5,6
27,22,195,8,11,-3
27,22,196,21,26,-5
27,22,197,14,16,-2
27,22,198,15,34,-19
27,22,199,13,19,-6
27,22,200,15,11,4
27,22,201,4,11,-7
27,22,202,11,26,-15
27,22,203,6,10,-4
27,22,204,22,22,0
27,22,205,7,15,-8
27,22,206,5,6,-1
27,22,207,9,19,-10
27,22,208,16,19,-3
27,22,209,19,26,-7
27,22,210,11,9,2
27,22,211,12,18,-6
27,22,212,5,10,-5
27,22,213,5,23,-18
27,22,214,19,9,10
27,22,215,14,17,-3
27,22,216,12,18,-6
27,22,217,12,11,1
27,22,218,8,15,-7
27,22,219,10,7,3
27,22,220,26,25,1
27,22,221,12,13,-1
27,22,222,8,13,-5
27,22,223,12,20,-8
27,22,224,9,7,2
27,22,225,11,11,0
27,22,226,9,17,-8
27,22,227,10,16,-6
27,22,228,10,18,-8
27,22,229,14,17,-3
27,22,230,9,29,-20
27,22,231,8,7,1
27,22,232,13,7,6
27,22,233,8,8,0
27,22,234,24,26,-2
27,22,235,5,17,-12
27,22,236,9,19,-10
27,22,237,6,24,-18
27,22,238,7,24,-17
27,22,239,10,10,0
27,22,240,13,8,5
27,22,241,7,14,-7
27,22,242,12,9,3
27,22,243,14,20,-6
27,22,244,12,16,-4
27,22,245,22,15,7
27,22,246,5,16,-11
27,22,247,9,16,-7
27,22,248,17,20,-3
27,22,249,12,12,0
27,22,250,13,24,-11
27,22,251,6,18,-12
27,22,252,6,2,4
27,22,253,13,7,6
27,22,254,10,22,-12
27,22,255,7,14,-7
27,22,256,19,16,3
27,22,257,10,12,-2
27,22,258,7,3,4
27,22,259,8,11,-3
27,22,260,9,5,4
27,22,261,14,21,-7
27,22,262,18,21,-3
27,22,263,11,15,-4
27,22,264,21,18,3
27,22,265,13,14,-1
27,22,266,12,16,-4
27,22,267,10,29,-19
27,22,268,23,25,-2
27,22,269,10,17,-7
27,22,270,3,7,-4
27,22,271,25,30,-5
27,22,272,10,17,-7
27,22,273,7,9,-2
27,22,274,10,12,-2
27,22,275,16,14,2
27,22,276,18,17,1
27,22,277,13,20,-7
27,22,278,8,12,-4
27,22,279,17,9,8
27,22,280,12,22,-10
27,22,281,11,24,-13
27,22,282,6,7,-1
27,22,283,11,12,-1
27,22,284,20,19,1
27,22,285,9,21,-12
27,22,286,4,13,-9
27,22,287,3,6,-3
27,22,288,11,24,-13
27,22,289,9,16,-7
27,22,290,6,15,-9
27,22,291,13,20,-7
27,22,292,6,13,-7
27,22,293,6,32,-26
27,22,294,8,5,3
27,22,295,11,18,-7
27,22,296,16,12,4
27,22,297,12,14,-2
27,22,298,7,11,-4
27,22,299,22,32,-10
27,23,0,24,28,-4
27,23,1,20,14,6
27,23,2,18,16,2
27,23,3,13,28,-15
27,23,4,7,10,-3
27,23,5,9,15,-6
27,23,6,8,10,-2
27,23,7,14,14,0
27,23,8,13,7,6
27,23,9,13,12,1
27,23,10,9,14,-5
27,23,11,13,10,3
27,23,12,2,13,-11
27,23,13,9,13,-4
27,23,14,22,25,-3
27,23,15,8,8,0
27,23,16,13,18,-5
27,23,17,8,9,-1
27,23,18,11,1,10
27,23,19,8,9,-1
27,23,20,15,12,3
27,23,21,7,8,-1
27,23,22,13,7,6
27,23,23,21,12,9
27,23,24,11,21,-10
27,23,25,10,23,-13
27,23,26,11,14,-3
27,23,27,9,16,-7
27,23,28,6,11,-5
27,23,29,8,23,-15
27,23,30,8,7,1
27,23,31,7,9,-2
27,23,32,24,11,13
27,23,33,12,23,-11
27,23,34,16,21,-5
27,23,35,9,5,4
27,23,36,22,14,8
27,23,37,7,7,0
27,23,38,9,22,-13
27,23,39,12,26,-14
27,23,40,9,30,-21
27,23,41,14,24,-10
27,23,42,15,9,6
27,23,43,16,10,6
27,23,44,5,8,-3
27,23,45,16,9,7
27,23,46,12,14,-2
27,23,47,9,5,4
27,23,48,21,18,3
27,23,49,7,12,-5
27,23,50,8,13,-5
27,23,51,18,11,7
27,23,52,18,14,4
27,23,53,8,32,-24
27,23,54,13,15,-2
27,23,55,6,15,-9
27,23,56,4,18,-14
27,23,57,15,3,12
27,23,58,12,17,-5
27,23,59,12,13,-1
27,23,60,5,15,-10
27,23,61,7,21,-14
27,23,62,11,20,-9
27,23,63,9,23,-14
27,23,64,20,18,2
27,23,65,8,12,-4
27,23,66,10,7,3
27,23,67,15,18,-3
27,23,68,6,10,-4
27,23,69,6,12,-6
27,23,70,19,19,0
27,23,71,18,25,-7
27,23,72,19,19,0
27,23,73,18,18,0
27,23,74,7,15,-8
27,23,75,14,23,-9
27,23,76,16,8,8
27,23,77,10,9,1
27,23,78,1,7,-6
27,23,79,11,29,-18
27,23,80,5,14,-9
27,23,81,16,14,2
27,23,82,18,12,6
27,23,83,11,22,-11
27,23,84,6,10,-4
27,23,85,12,6,6
27,23,86,16,12,4
27,23,87,15,15,0
27,23,88,15,10,5
27,23,89,12,7,5
27,23,90,9,18,-9
27,23,91,11,30,-19
27,23,92,27,19,8
27,23,93,7,8,-1
27,23,94,7,7,0
27,23,95,4,7,-3
27,23,96,18,14,4
27,23,97,10,14,-4
27,23,98,6,13,-7
27,23,99,11,15,-4
27,23,100,20,16,4
27,23,101,19,22,-3
27,23,102,16,13,3
27,23,103,4,3,1
27,23,104,11,8,3
27,23,105,14,20,-6
27,23,106,17,22,-5
27,23,107,10,15,-5
27,23,108,16,13,3
27,23,109,9,11,-2
27,23,110,25,12,13
27,23,111,7,12,-5
27,23,112,9,19,-10
27,23,113,10,17,-7
27,23,114,13,18,-5
27,23,115,18,19,-1
27,23,116,11,20,-9
27,23,117,12,16,-4
27,23,118,7,4,3
27,23,119,11,14,-3
27,23,120,18,13,5
27,23,121,13,23,-10
27,23,122,13,2,11
27,23,123,15,15,0
27,23,124,13,17,-4
27,23,125,12,20,-8
27,23,126,12,11,1
27,23,127,12,23,-11
27,23,128,9,13,-4
27,23,129,17,17,0
27,23,130,1,13,-12
27,23,131,9,17,-8
27,23,132,17,19,-2
27,23,133,16,12,4
27,23,134,9,18,-9
27,23,135,14,18,-4
27,23,136,6,13,-7
27,23,137,20,9,11
27,23,138,12,12,0
27,23,139,9,11,-2
27,23,140,16,18,-2
27,23,141,10,22,-12
27,23,142,12,9,3
27,23,143,7,17,-10
27,23,144,7,12,-5
27,23,145,9,14,-5
27,23,146,5,6,-1
27,23,147,12,16,-4
27,23,148,11,16,-5
27,23,149,9,18,-9
27,23,150,14,12,2
27,23,151,12,16,-4
27,23,152,13,10,3
27,23,153,8,14,-6
27,23,154,2,4,-2
27,23,155,12,16,-4
27,23,156,10,13,-3
27,23,157,9,19,-10
27,23,158,25,14,11
27,23,159,12,14,-2
27,23,160,20,25,-5
27,23,161,15,14,1
27,23,162,15,18,-3
27,23,163,11,13,-2
27,23,164,9,16,-7
27,23,165,9,14,-5
27,23,166,15,10,5
27,23,167,7,11,-4
27,23,168,14,23,-9
27,23,169,14,10,4
27,23,170,5,9,-4
27,23,171,16,17,-1
27,23,172,9,14,-5
27,23,173,8,15,-7
27,23,174,16,12,4
27,23,175,14,13,1
27,23,176,19,11,8
27,23,177,16,16,0
27,23,178,8,13,-5
27,23,179,4,9,-5
27,23,180,13,19,-6
27,23,181,8,17,-9
27,23,182,14,14,0
27,23,183,22,22,0
27,23,184,8,13,-5
27,23,185,12,9,3
27,23,186,15,8,7
27,23,187,7,28,-21
27,23,188,21,10,11
27,23,189,7,14,-7
27,23,190,9,16,-7
27,23,191,15,33,-18
27,23,192,12,12,0
27,23,193,9,21,-12
27,23,194,17,19,-2
27,23,195,5,9,-4
27,23,196,15,15,0
27,23,197,15,16,-1
27,23,198,14,14,0
27,23,199,11,6,5
27,23,200,15,19,-4
27,23,201,8,6,2
27,23,202,6,19,-13
27,23,203,24,8,16
27,23,204,9,7,2
27,23,205,20,14,6
27,23,206,12,7,5
27,23,207,15,20,-5
27,23,208,3,8,-5
27,23,209,7,17,-10
27,23,210,13,14,-1
27,23,211,18,11,7
27,23,212,22,15,7
27,23,213,15,19,-4
27,23,214,13,11,2
27,23,215,16,15,1
27,23,216,21,20,1
27,23,217,8,13,-5
27,23,218,10,12,-2
27,23,219,12,14,-2
27,23,220,9,17,-8
27,23,221,9,4,5
27,23,222,10,8,2
27,23,223,15,12,3
27,23,224,9,14,-5
27,23,225,15,17,-2
27,23,226,10,9,1
27,23,227,13,7,6
27,23,228,10,8,2
27,23,229,14,18,-4
27,23,230,13,24,-11
27,23,231,9,14,-5
27,23,232,5,19,-14
27,23,233,22,17,5
27,23,234,7,13,-6
27,23,235,22,11,11
27,23,236,9,33,-24
27,23,237,10,13,-3
27,23,238,27,16,11
27,23,239,20,11,9
27,23,240,13,13,0
27,23,241,10,15,-5
27,23,242,13,10,3
27,23,243,5,9,-4
27,23,244,16,18,-2
27,23,245,6,7,-1
27,23,246,19,16,3
27,23,247,12,9,3
27,23,248,18,15,3
27,23,249,15,12,3
27,23,250,16,6,10
27,23,251,5,10,-5
27,23,252,10,11,-1
27,23,253,3,15,-12
27,23,254,13,12,1
27,23,255,13,10,3
27,23,256,19,22,-3
27,23,257,12,19,-7
27,23,258,21,17,4
27,23,259,4,9,-5
27,23,260,13,12,1
27,23,261,11,8,3
27,23,262,14,22,-8
27,23,263,5,11,-6
27,23,264,15,28,-13
27,23,265,7,9,-2
27,23,266,12,12,0
27,23,267,16,14,2
27,23,268,7,11,-4
27,23,269,5,7,-2
27,23,270,18,27,-9
27,23,271,18,10,8
27,23,272,17,11,6
27,23,273,17,17,0
27,23,274,9,21,-12
27,23,275,11,8,3
27,23,276,3,9,-6
27,23,277,21,14,7
27,23,278,20,16,4
27,23,279,5,10,-5
27,23,280,9,21,-12
27,23,281,18,21,-3
27,23,282,13,13,0
27,23,283,12,13,-1
27,23,284,13,22,-9
27,23,285,15,11,4
27,23,286,6,16,-10
27,23,287,18,16,2
27,23,288,19,10,9
27,23,289,20,18,2
27,23,290,12,28,-16
27,23,291,13,11,2
27,23,292,14,23,-9
27,23,293,11,7,4
27,23,294,11,10,1
27,23,295,9,5,4
27,23,296,5,15,-10
27,23,297,11,21,-10
27,23,298,8,10,-2
27,23,299,15,22,-7
27,24,0,5,24,-19
27,24,1,6,18,-12
27,24,2,8,15,-7
27,24,3,14,16,-2
27,24,4,12,17,-5
27,24,5,14,10,4
27,24,6,12,30,-18
27,24,7,19,13,6
27,24,8,15,24,-9
27,24,9,14,15,-1
27,24,10,16,24,-8
27,24,11,5,10,-5
27,24,12,14,11,3
27,24,13,7,9,-2
27,24,14,19,12,7
27,24,15,12,18,-6
27,24,16,7,6,1
27,24,17,10,16,-6
27,24,18,14,13,1
27,24,19,15,8,7
27,24,20,19,25,-6
27,24,21,18,18,0
27,24,22,11,26,-15
27,24,23,7,17,-10
27,24,24,11,12,-1
27,24,25,18,9,9
27,24,26,10,14,-4
27,24,27,10,19,-9
27,24,28,16,12,4
27,24,29,9,10,-1
27,24,30,6,18,-12
27,24,31,26,22,4
27,24,32,3,13,-10
27,24,33,11,16,-5
27,24,34,10,11,-1
27,24,35,8,17,-9
27,24,36,9,15,-6
27,24,37,20,14,6
27,24,38,10,9,1
27,24,39,3,14,-11
27,24,40,12,17,-5
27,24,41,13,30,-17
27,24,42,7,9,-2
27,24,43,9,32,-23
27,24,44,5,13,-8
27,24,45,12,22,-10
27,24,46,12,11,1
27,24,47,16,22,-6
27,24,48,18,22,-4
27,24,49,7,24,-17
27,24,50,10,10,0
27,24,51,10,14,-4
27,24,52,11,10,1
27,24,53,10,13,-3
27,24,54,12,18,-6
27,24,55,9,21,-12
27,24,56,7,13,-6
27,24,57,10,13,-3
27,24,58,5,13,-8
27,24,59,5,26,-21
27,24,60,8,13,-5
27,24,61,11,17,-6
27,24,62,3,7,-4
27,24,63,14,18,-4
27,24,64,15,11,4
27,24,65,17,11,6
27,24,66,6,29,-23
27,24,67,8,11,-3
27,24,68,10,25,-15
27,24,69,15,27,-12
27,24,70,8,18,-10
27,24,71,15,22,-7
27,24,72,6,9,-3
27,24,73,8,17,-9
27,24,74,22,17,5
27,24,75,4,10,-6
27,24,76,11,5,6
27,24,77,20,26,-6
27,24,78,12,11,1
27,24,79,12,23,-11
27,24,80,13,17,-4
27,24,81,9,13,-4
27,24,82,8,14,-6
27,24,83,12,12,0
27,24,84,14,18,-4
27,24,85,9,19,-10
27,24,86,12,8,4
27,24,87,10,15,-5
27,24,88,6,12,-6
27,24,89,16,6,10
27,24,90,14,9,5
27,24,91,10,16,-6
27,24,92,5,15,-10
27,24,93,9,30,-21
27,24,94,10,12,-2
27,24,95,3,7,-4
27,24,96,15,10,5
27,24,97,12,20,-8
27,24,98,31,14,17
27,24,99,15,13,2
27,24,100,11,5,6
27,24,101,18,8,10
27,24,102,8,6,2
27,24,103,13,14,-1
27,24,104,3,9,-6
27,24,105,18,19,-1
27,24,106,8,16,-8
27,24,107,13,24,-11
27,24,108,9,16,-7
27,24,109,14,18,-4
27,24,110,9,11,-2
27,24,111,5,8,-3
27,24,112,11,18,-7
27,24,113,19,10,9
27,24,114,11,9,2
27,24,115,14,10,4
27,24,116,11,14,-3
27,24,117,17,20,-3
27,24,118,13,10,3
27,24,119,8,11,-3
27,24,120,7,9,-2
27,24,121,14,18,-4
27,24,122,12,20,-8
27,24,123,10,16,-6
27,24,124,13,17,-4
27,24,125,13,14,-1
27,24,126,13,4,9
27,24,127,14,15,-1
27,24,128,9,16,-7
27,24,129,6,10,-4
27,24,130,7,18,-11
27,24,131,12,21,-9
27,24,132,11,9,2
27,24,133,15,9,6
27,24,134,8,32,-24
27,24,135,12,15,-3
27,24,136,8,16,-8
27,24,137,7,14,-7
27,24,138,11,10,1
27,24,139,7,14,-7
27,24,140,13,7,6
27,24,141,12,14,-2
27,24,142,7,17,-10
27,24,143,13,10,3
27,24,144,13,19,-6
27,24,145,8,17,-9
27,24,146,8,14,-6
27,24,147,12,15,-3
27,24,148,16,12,4
27,24,149,15,14,1
27,24,150,12,6,6
27,24,151,5,15,-10
27,24,152,14,17,-3
27,24,153,10,6,4
27,24,154,11,10,1
27,24,155,7,2,5
27,24,156,9,8,1
27,24,157,16,25,-9
27,24,158,16,11,5
27,24,159,16,18,-2
27,24,160,8,14,-6
27,24,161,10,12,-2
27,24,162,8,21,-13
27,24,163,22,19,3
27,24,164,9,16,-7
27,24,165,12,18,-6
27,24,166,12,13,-1
27,24,167,20,12,8
27,24,168,19,18,1
27,24,169,8,16,-8
27,24,170,10,18,-8
27,24,171,6,6,0
27,24,172,4,0,4
27,24,173,5,12,-7
27,24,174,8,15,-7
27,24,175,13,17,-4
27,24,176,9,14,-5
27,24,177,15,15,0
27,24,178,17,17,0
27,24,179,16,8,8
27,24,180,13,9,4
27,24,181,4,14,-10
27,24,182,11,15,-4
27,24,183,10,17,-7
27,24,184,12,22,-10
27,24,185,10,17,-7
27,24,186,12,12,0
27,24,187,10,13,-3
27,24,188,12,8,4
27,24,189,10,17,-7
27,24,190,14,17,-3
27,24,191,9,13,-4
27,24,192,14,14,0
27,24,193,11,23,-12
27,24,194,6,13,-7
27,24,195,6,20,-14
27,24,196,15,16,-1
27,24,197,22,14,8
27,24,198,11,8,3
27,24,199,13,17,-4
27,24,200,4,17,-13
27,24,201,11,11,0
27,24,202,6,16,-10
27,24,203,8,15,-7
27,24,204,11,8,3
27,24,205,14,24,-10
27,24,206,10,15,-5
27,24,207,6,11,-5
27,24,208,22,13,9
27,24,209,10,14,-4
27,24,210,14,18,-4
27,24,211,3,11,-8
27,24,212,10,15,-5
27,24,213,4,14,-10
27,24,214,21,39,-18
27,24,215,15,16,-1
27,24,216,15,14,1
27,24,217,20,22,-2
27,24,218,13,5,8
27,24,219,11,16,-5
27,24,220,19,19,0
27,24,221,7,9,-2
27,24,222,10,7,3
27,24,223,8,12,-4
27,24,224,7,9,-2
27,24,225,13,12,1
27,24,226,8,14,-6
27,24,227,12,16,-4
27,24,228,27,13,14
27,24,229,9,13,-4
27,24,230,12,12,0
27,24,231,10,27,-17
27,24,232,6,7,-1
27,24,233,11,12,-1
27,24,234,10,15,-5
27,24,235,22,15,7
27,24,236,7,4,3
27,24,237,10,7,3
27,24,238,10,13,-3
27,24,239,13,20,-7
27,24,240,8,11,-3
27,24,241,12,10,2
27,24,242,14,24,-10
27,24,243,12,8,4
27,24,244,9,11,-2
27,24,245,7,13,-6
27,24,246,28,15,13
27,24,247,12,9,3
27,24,248,21,15,6
27,24,249,10,3,7
27,24,250,15,20,-5
27,24,251,8,20,-12
27,24,252,20,26,-6
27,24,253,15,5,10
27,24,254,8,14,-6
27,24,255,12,20,-8
27,24,256,9,20,-11
27,24,257,10,9,1
27,24,258,4,6,-2
27,24,259,12,11,1
27,24,260,10,11,-1
27,24,261,9,17,-8
27,24,262,7,9,-2
27,24,263,8,14,-6
27,24,264,4,14,-10
27,24,265,7,6,1
27,24,266,17,19,-2
27,24,267,11,12,-1
27,24,268,19,30,-11
27,24,269,7,3,4
27,24,270,12,13,-1
27,24,271,10,13,-3
27,24,272,12,19,-7
27,24,273,14,11,3
27,24,274,14,19,-5
27,24,275,5,7,-2
27,24,276,15,23,-8
27,24,277,18,28,-10
27,24,278,9,10,-1
27,24,279,25,25,0
27,24,280,17,41,-24
27,24,281,2,22,-20
27,24,282,16,17,-1
27,24,283,14,28,-14
27,24,284,13,20,-7
27,24,285,20,6,14
27,24,286,3,10,-7
27,24,287,23,17,6
27,24,288,12,17,-5
27,24,289,16,15,1
27,24,290,14,24,-10
27,24,291,8,10,-2
27,24,292,4,7,-3
27,24,293,8,5,3
27,24,294,10,6,4
27,24,295,5,17,-12
27,24,296,11,20,-9
27,24,297,19,16,3
27,24,298,20,20,0
27,24,299,20,20,0
27,25,0,11,17,-6
27,25,1,2,13,-11
27,25,2,11,9,2
27,25,3,14,12,2
27,25,4,14,15,-1
27,25,5,9,16,-7
27,25,6,30,28,2
27,25,7,23,14,9
27,25,8,7,10,-3
27,25,9,11,11,0
27,25,10,10,15,-5
27,25,11,13,28,-15
27,25,12,11,19,-8
27,25,13,20,9,11
27,25,14,8,14,-6
27,25,15,13,15,-2
27,25,16,29,17,12
27,25,17,13,24,-11
27,25,18,19,10,9
27,25,19,11,16,-5
27,25,20,14,10,4
27,25,21,14,14,0
27,25,22,10,16,-6
27,25,23,15,13,2
27,25,24,9,19,-10
27,25,25,3,7,-4
27,25,26,11,14,-3
27,25,27,10,21,-11
27,25,28,16,16,0
27,25,29,4,11,-7
27,25,30,13,12,1
27,25,31,5,14,-9
27,25,32,8,14,-6
27,25,33,9,10,-1
27,25,34,10,8,2
27,25,35,20,13,7
27,25,36,8,9,-1
27,25,37,14,5,9
27,25,38,17,13,4
27,25,39,12,7,5
27,25,40,21,26,-5
27,25,41,7,17,-10
27,25,42,7,16,-9
27,25,43,9,10,-1
27,25,44,9,7,2
27,25,45,6,14,-8
27,25,46,12,18,-6
27,25,47,11,7,4
27,25,48,13,8,5
27,25,49,19,29,-10
27,25,50,6,12,-6
27,25,51,21,10,11
27,25,52,16,14,2
27,25,53,5,12,-7
27,25,54,15,15,0
27,25,55,11,14,-3
27,25,56,18,15,3
27,25,57,11,19,-8
27,25,58,7,24,-17
27,25,59,26,31,-5
27,25,60,12,9,3
27,25,61,12,25,-13
27,25,62,21,14,7
27,25,63,24,28,-4
27,25,64,20,9,11
27,25,65,13,10,3
27,25,66,15,17,-2
27,25,67,9,19,-10
27,25,68,12,14,-2
27,25,69,10,19,-9
27,25,70,17,2,15
27,25,71,4,6,-2
27,25,72,7,11,-4
27,25,73,16,14,2
27,25,74,17,14,3
27,25,75,11,12,-1
27,25,76,10,12,-2
27,25,77,11,19,-8
27,25,78,9,17,-8
27,25,79,5,18,-13
27,25,80,14,3,11
27,25,81,18,17,1
27,25,82,9,11,-2
27,25,83,11,15,-4
27,25,84,6,11,-5
27,25,85,8,8,0
27,25,86,9,23,-14
27,25,87,4,14,-10
27,25,88,13,10,3
27,25,89,11,12,-1
27,25,90,13,13,0
27,25,91,15,12,3
27,25,92,14,21,-7
27,25,93,14,13,1
27,25,94,15,12,3
27,25,95,18,10,8
27,25,96,17,13,4
27,25,97,5,13,-8
27,25,98,18,31,-13
27,25,99,24,13,11
27,25,100,10,13,-3
27,25,101,22,18,4
27,25,102,20,21,-1
27,25,103,8,6,2
27,25,104,14,14,0
27,25,105,8,16,-8
27,25,106,6,10,-4
27,25,107,6,10,-4
27,25,108,3,9,-6
27,25,109,17,17,0
27,25,110,5,21,-16
27,25,111,7,13,-6
27,25,112,16,10,6
27,25,113,6,12,-6
27,25,114,7,7,0
27,25,115,10,25,-15
27,25,116,12,12,0
27,25,117,9,11,-2
27,25,118,17,23,-6
27,25,119,7,3,4
27,25,120,16,4,12
27,25,121,13,8,5
27,25,122,17,17,0
27,25,123,11,9,2
27,25,124,8,8,0
27,25,125,11,9,2
27,25,126,18,14,4
27,25,127,10,15,-5
27,25,128,5,10,-5
27,25,129,4,13,-9
27,25,130,16,15,1
27,25,131,15,9,6
27,25,132,18,13,5
27,25,133,10,15,-5
27,25,134,13,11,2
27,25,135,9,18,-9
27,25,136,10,19,-9
27,25,137,11,18,-7
27,25,138,9,18,-9
27,25,139,14,22,-8
27,25,140,12,18,-6
27,25,141,14,3,11
27,25,142,9,11,-2
27,25,143,14,12,2
27,25,144,9,8,1
27,25,145,25,10,15
27,25,146,6,10,-4
27,25,147,17,17,0
27,25,148,13,10,3
27,25,149,16,15,1
27,25,150,7,14,-7
27,25,151,17,5,12
27,25,152,16,15,1
27,25,153,17,9,8
27,25,154,13,13,0
27,25,155,14,17,-3
27,25,156,11,10,1
27,25,157,23,11,12
27,25,158,12,25,-13
27,25,159,11,10,1
27,25,160,15,12,3
27,25,161,11,9,2
27,25,162,12,14,-2
27,25,163,13,9,4
27,25,164,7,13,-6
27,25,165,11,14,-3
27,25,166,10,9,1
27,25,167,13,14,-1
27,25,168,11,3,8
27,25,169,7,5,2
27,25,170,17,26,-9
27,25,171,8,19,-11
27,25,172,4,7,-3
27,25,173,4,11,-7
27,25,174,24,16,8
27,25,175,10,8,2
27,25,176,16,8,8
27,25,177,18,12,6
27,25,178,15,18,-3
27,25,179,15,9,6
27,25,180,24,22,2
27,25,181,7,5,2
27,25,182,15,12,3
27,25,183,6,7,-1
27,25,184,3,15,-12
27,25,185,12,9,3
27,25,186,7,11,-4
27,25,187,11,13,-2
27,25,188,20,7,13
27,25,189,7,16,-9
27,25,190,8,10,-2
27,25,191,19,11,8
27,25,192,9,9,0
27,25,193,12,17,-5
27,25,194,23,7,16
27,25,195,8,14,-6
27,25,196,17,15,2
27,25,197,26,19,7
27,25,198,12,10,2
27,25,199,13,16,-3
27,25,200,6,13,-7
27,25,201,5,16,-11
27,25,202,30,18,12
27,25,203,7,13,-6
27,25,204,15,22,-7
27,25,205,14,13,1
27,25,206,10,14,-4
27,25,207,7,7,0
27,25,208,7,25,-18
27,25,209,19,17,2
27,25,210,18,20,-2
27,25,211,12,9,3
27,25,212,16,10,6
27,25,213,6,10,-4
27,25,214,6,5,1
27,25,215,15,10,5
27,25,216,14,13,1
27,25,217,13,20,-7
27,25,218,15,12,3
27,25,219,11,14,-3
27,25,220,4,5,-1
27,25,221,3,11,-8
27,25,222,2,14,-12
27,25,223,10,12,-2
27,25,224,4,15,-11
27,25,225,9,10,-1
27,25,226,13,14,-1
27,25,227,8,7,1
27,25,228,15,24,-9
27,25,229,13,17,-4
27,25,230,17,3,14
27,25,231,13,12,1
27,25,232,12,20,-8
27,25,233,6,8,-2
27,25,234,2,3,-1
27,25,235,15,19,-4
27,25,236,10,7,3
27,25,237,11,16,-5
27,25,238,4,14,-10
27,25,239,15,17,-2
27,25,240,11,12,-1
27,25,241,11,19,-8
27,25,242,6,16,-10
27,25,243,11,5,6
27,25,244,12,10,2
27,25,245,10,11,-1
27,25,246,16,24,-8
27,25,247,8,14,-6
27,25,248,6,17,-11
27,25,249,10,7,3
27,25,250,5,19,-14
27,25,251,9,14,-5
27,25,252,3,8,-5
27,25,253,14,14,0
27,25,254,8,10,-2
27,25,255,11,14,-3
27,25,256,19,13,6
27,25,257,8,13,-5
27,25,258,19,28,-9
27,25,259,13,13,0
27,25,260,21,15,6
27,25,261,16,12,4
27,25,262,6,12,-6
27,25,263,12,6,6
27,25,264,13,9,4
27,25,265,5,6,-1
27,25,266,17,16,1
27,25,267,9,15,-6
27,25,268,8,12,-4
27,25,269,21,5,16
27,25,270,7,15,-8
27,25,271,15,8,7
27,25,272,20,13,7
27,25,273,17,15,2
27,25,274,11,9,2
27,25,275,7,13,-6
27,25,276,18,22,-4
27,25,277,5,7,-2
27,25,278,9,9,0
27,25,279,16,20,-4
27,25,280,17,13,4
27,25,281,7,10,-3
27,25,282,12,19,-7
27,25,283,18,14,4
27,25,284,14,19,-5
27,25,285,8,9,-1
27,25,286,9,20,-11
27,25,287,12,19,-7
27,25,288,15,13,2
27,25,289,6,15,-9
27,25,290,11,13,-2
27,25,291,15,22,-7
27,25,292,15,13,2
27,25,293,14,15,-1
27,25,294,10,8,2
27,25,295,7,24,-17
27,25,296,11,10,1
27,25,297,10,18,-8
27,25,298,11,12,-1
27,25,299,8,7,1
27,26,0,16,10,6
27,26,1,26,10,16
27,26,2,9,9,0
27,26,3,13,16,-3
27,26,4,6,5,1
27,26,5,11,7,4
27,26,6,11,20,-9
27,26,7,16,26,-10
27,26,8,9,9,0
27,26,9,20,12,8
27,26,10,14,6,8
27,26,11,18,5,13
27,26,12,7,13,-6
27,26,13,9,14,-5
27,26,14,11,18,-7
27,26,15,4,15,-11
27,26,16,11,30,-19
27,26,17,13,9,4
27,26,18,13,12,1
27,26,19,13,10,3
27,26,20,15,19,-4
27,26,21,16,11,5
27,26,22,20,28,-8
27,26,23,11,19,-8
27,26,24,16,5,11
27,26,25,13,11,2
27,26,26,14,22,-8
27,26,27,8,10,-2
27,26,28,20,15,5
27,26,29,14,10,4
27,26,30,8,20,-12
27,26,31,10,21,-11
27,26,32,7,8,-1
27,26,33,19,8,11
27,26,34,14,11,3
27,26,35,10,12,-2
27,26,36,9,10,-1
27,26,37,19,7,12
27,26,38,11,2,9
27,26,39,20,12,8
27,26,40,9,21,-12
27,26,41,10,16,-6
27,26,42,9,15,-6
27,26,43,9,9,0
27,26,44,12,6,6
27,26,45,13,18,-5
27,26,46,2,8,-6
27,26,47,20,15,5
27,26,48,13,15,-2
27,26,49,11,15,-4
27,26,50,11,17,-6
27,26,51,10,11,-1
27,26,52,22,27,-5
27,26,53,16,9,7
27,26,54,19,17,2
27,26,55,9,13,-4
27,26,56,14,12,2
27,26,57,23,17,6
27,26,58,17,19,-2
27,26,59,11,25,-14
27,26,60,25,18,7
27,26,61,11,13,-2
27,26,62,9,0,9
27,26,63,12,16,-4
27,26,64,8,22,-14
27,26,65,13,14,-1
27,26,66,6,10,-4
27,26,67,12,13,-1
27,26,68,16,13,3
27,26,69,16,7,9
27,26,70,15,1,14
27,26,71,27,14,13
27,26,72,16,11,5
27,26,73,5,11,-6
27,26,74,10,19,-9
27,26,75,11,21,-10
27,26,76,20,10,10
27,26,77,21,8,13
27,26,78,13,6,7
27,26,79,11,21,-10
27,26,80,17,11,6
27,26,81,14,6,8
27,26,82,11,13,-2
27,26,83,4,10,-6
27,26,84,12,9,3
27,26,85,15,3,12
27,26,86,10,9,1
27,26,87,10,18,-8
27,26,88,12,11,1
27,26,89,12,11,1
27,26,90,10,16,-6
27,26,91,6,4,2
27,26,92,20,11,9
27,26,93,23,17,6
27,26,94,16,9,7
27,26,95,12,12,0
27,26,96,13,28,-15
27,26,97,11,14,-3
27,26,98,8,10,-2
27,26,99,8,12,-4
27,26,100,10,13,-3
27,26,101,20,20,0
27,26,102,13,12,1
27,26,103,16,10,6
27,26,104,10,11,-1
27,26,105,14,14,0
27,26,106,6,11,-5
27,26,107,9,11,-2
27,26,108,18,7,11
27,26,109,17,12,5
27,26,110,15,21,-6
27,26,111,10,8,2
27,26,112,20,19,1
27,26,113,18,16,2
27,26,114,12,16,-4
27,26,115,16,17,-1
27,26,116,14,18,-4
27,26,117,10,20,-10
27,26,118,19,11,8
27,26,119,12,7,5
27,26,120,2,20,-18
27,26,121,17,22,-5
27,26,122,7,6,1
27,26,123,15,28,-13
27,26,124,10,10,0
27,26,125,11,15,-4
27,26,126,10,7,3
27,26,127,10,8,2
27,26,128,2,14,-12
27,26,129,13,12,1
27,26,130,9,10,-1
27,26,131,10,9,1
27,26,132,10,18,-8
27,26,133,9,32,-23
27,26,134,13,20,-7
27,26,135,13,17,-4
27,26,136,8,18,-10
27,26,137,14,9,5
27,26,138,9,13,-4
27,26,139,11,26,-15
27,26,140,17,13,4
27,26,141,8,22,-14
27,26,142,17,13,4
27,26,143,16,19,-3
27,26,144,10,23,-13
27,26,145,15,16,-1
27,26,146,19,15,4
27,26,147,5,10,-5
27,26,148,21,12,9
27,26,149,15,15,0
27,26,150,7,15,-8
27,26,151,10,21,-11
27,26,152,12,14,-2
27,26,153,9,15,-6
27,26,154,7,13,-6
27,26,155,10,14,-4
27,26,156,7,6,1
27,26,157,12,5,7
27,26,158,14,24,-10
27,26,159,23,17,6
27,26,160,10,7,3
27,26,161,5,11,-6
27,26,162,15,6,9
27,26,163,3,10,-7
27,26,164,12,15,-3
27,26,165,3,10,-7
27,26,166,11,14,-3
27,26,167,16,17,-1
27,26,168,6,23,-17
27,26,169,9,17,-8
27,26,170,10,12,-2
27,26,171,8,16,-8
27,26,172,3,9,-6
27,26,173,17,11,6
27,26,174,21,6,15
27,26,175,16,18,-2
27,26,176,4,6,-2
27,26,177,12,10,2
27,26,178,18,18,0
27,26,179,18,13,5
27,26,180,11,12,-1
27,26,181,13,15,-2
27,26,182,14,12,2
27,26,183,17,14,3
27,26,184,7,13,-6
27,26,185,17,12,5
27,26,186,13,14,-1
27,26,187,11,17,-6
27,26,188,16,13,3
27,26,189,24,31,-7
27,26,190,16,11,5
27,26,191,16,14,2
27,26,192,4,10,-6
27,26,193,6,14,-8
27,26,194,14,14,0
27,26,195,24,10,14
27,26,196,15,5,10
27,26,197,10,6,4
27,26,198,18,21,-3
27,26,199,2,7,-5
27,26,200,9,11,-2
27,26,201,10,12,-2
27,26,202,17,29,-12
27,26,203,28,22,6
27,26,204,7,19,-12
27,26,205,11,21,-10
27,26,206,10,9,1
27,26,207,25,18,7
27,26,208,14,14,0
27,26,209,10,15,-5
27,26,210,18,24,-6
27,26,211,13,14,-1
27,26,212,11,13,-2
27,26,213,12,19,-7
27,26,214,11,15,-4
27,26,215,14,14,0
27,26,216,15,17,-2
27,26,217,9,8,1
27,26,218,10,9,1
27,26,219,13,12,1
27,26,220,10,17,-7
27,26,221,11,15,-4
27,26,222,4,8,-4
27,26,223,6,11,-5
27,26,224,14,9,5
27,26,225,15,6,9
27,26,226,4,7,-3
27,26,227,5,15,-10
27,26,228,14,15,-1
27,26,229,12,21,-9
27,26,230,11,17,-6
27,26,231,12,5,7
27,26,232,13,14,-1
27,26,233,14,12,2
27,26,234,12,8,4
27,26,235,12,14,-2
27,26,236,11,13,-2
27,26,237,18,9,9
27,26,238,15,12,3
27,26,239,11,20,-9
27,26,240,10,13,-3
27,26,241,12,18,-6
27,26,242,20,13,7
27,26,243,14,17,-3
27,26,244,8,15,-7
27,26,245,6,15,-9
27,26,246,15,11,4
27,26,247,14,13,1
27,26,248,12,7,5
27,26,249,15,12,3
27,26,250,12,8,4
27,26,251,12,21,-9
27,26,252,6,18,-12
27,26,253,14,9,5
27,26,254,16,21,-5
27,26,255,11,6,5
27,26,256,6,23,-17
27,26,257,13,10,3
27,26,258,18,16,2
27,26,259,7,10,-3
27,26,260,16,22,-6
27,26,261,10,25,-15
27,26,262,12,17,-5
27,26,263,12,16,-4
27,26,264,17,19,-2
27,26,265,30,12,18
27,26,266,13,14,-1
27,26,267,10,17,-7
27,26,268,13,20,-7
27,26,269,15,4,11
27,26,270,10,11,-1
27,26,271,14,10,4
27,26,272,17,9,8
27,26,273,13,23,-10
27,26,274,14,17,-3
27,26,275,14,16,-2
27,26,276,2,5,-3
27,26,277,3,16,-13
27,26,278,13,10,3
27,26,279,13,12,1
27,26,280,8,8,0
27,26,281,13,12,1
27,26,282,14,20,-6
27,26,283,14,11,3
27,26,284,7,12,-5
27,26,285,12,10,2
27,26,286,20,24,-4
27,26,287,9,14,-5
27,26,288,11,21,-10
27,26,289,7,15,-8
27,26,290,10,8,2
27,26,291,24,19,5
27,26,292,12,12,0
27,26,293,11,24,-13
27,26,294,18,25,-7
27,26,295,2,13,-11
27,26,296,9,11,-2
27,26,297,14,10,4
27,26,298,12,22,-10
27,26,299,10,9,1
27,27,0,13,23,-10
27,27,1,12,23,-11
27,27,2,9,12,-3
27,27,3,2,12,-10
27,27,4,21,19,2
27,27,5,10,15,-5
27,27,6,6,6,0
27,27,7,13,7,6
27,27,8,7,12,-5
27,27,9,7,15,-8
27,27,10,11,16,-5
27,27,11,19,8,11
27,27,12,14,19,-5
27,27,13,19,17,2
27,27,14,13,21,-8
27,27,15,10,16,-6
27,27,16,10,17,-7
27,27,17,9,11,-2
27,27,18,10,9,1
27,27,19,11,11,0
27,27,20,18,11,7
27,27,21,9,11,-2
27,27,22,9,6,3
27,27,23,4,10,-6
27,27,24,17,23,-6
27,27,25,11,10,1
27,27,26,16,8,8
27,27,27,4,10,-6
27,27,28,17,10,7
27,27,29,12,13,-1
27,27,30,11,12,-1
27,27,31,6,14,-8
27,27,32,10,20,-10
27,27,33,16,8,8
27,27,34,12,8,4
27,27,35,5,4,1
27,27,36,9,9,0
27,27,37,10,10,0
27,27,38,11,19,-8
27,27,39,7,6,1
27,27,40,7,8,-1
27,27,41,25,18,7
27,27,42,15,14,1
27,27,43,15,15,0
27,27,44,13,12,1
27,27,45,10,11,-1
27,27,46,2,12,-10
27,27,47,2,24,-22
27,27,48,20,14,6
27,27,49,7,31,-24
27,27,50,15,13,2
27,27,51,10,13,-3
27,27,52,12,10,2
27,27,53,4,7,-3
27,27,54,11,10,1
27,27,55,8,19,-11
27,27,56,14,7,7
27,27,57,10,21,-11
27,27,58,6,16,-10
27,27,59,9,15,-6
27,27,60,13,13,0
27,27,61,14,12,2
27,27,62,18,7,11
27,27,63,11,20,-9
27,27,64,14,21,-7
27,27,65,12,10,2
27,27,66,29,12,17
27,27,67,20,21,-1
27,27,68,22,13,9
27,27,69,7,9,-2
27,27,70,6,4,2
27,27,71,7,14,-7
27,27,72,13,15,-2
27,27,73,10,9,1
27,27,74,9,9,0
27,27,75,13,8,5
27,27,76,9,20,-11
27,27,77,7,15,-8
27,27,78,4,13,-9
27,27,79,7,17,-10
27,27,80,15,16,-1
27,27,81,5,6,-1
27,27,82,2,4,-2
27,27,83,11,10,1
27,27,84,10,5,5
27,27,85,13,23,-10
27,27,86,5,4,1
27,27,87,14,12,2
27,27,88,1,6,-5
27,27,89,12,8,4
27,27,90,11,7,4
27,27,91,13,16,-3
27,27,92,20,17,3
27,27,93,11,11,0
27,27,94,26,15,11
27,27,95,8,11,-3
27,27,96,16,23,-7
27,27,97,16,26,-10
27,27,98,15,17,-2
27,27,99,17,28,-11
27,27,100,13,15,-2
27,27,101,10,12,-2
27,27,102,5,7,-2
27,27,103,10,9,1
27,27,104,13,13,0
27,27,105,13,15,-2
27,27,106,9,13,-4
27,27,107,11,8,3
27,27,108,9,7,2
27,27,109,8,2,6
27,27,110,16,18,-2
27,27,111,20,12,8
27,27,112,12,13,-1
27,27,113,5,11,-6
27,27,114,18,10,8
27,27,115,6,12,-6
27,27,116,4,6,-2
27,27,117,17,23,-6
27,27,118,8,13,-5
27,27,119,13,13,0
27,27,120,3,15,-12
27,27,121,11,8,3
27,27,122,14,10,4
27,27,123,12,16,-4
27,27,124,14,10,4
27,27,125,13,16,-3
27,27,126,6,15,-9
27,27,127,10,4,6
27,27,128,13,12,1
27,27,129,15,7,8
27,27,130,14,13,1
27,27,131,18,11,7
27,27,132,4,10,-6
27,27,133,7,15,-8
27,27,134,9,22,-13
27,27,135,5,12,-7
27,27,136,6,12,-6
27,27,137,11,8,3
27,27,138,11,10,1
27,27,139,10,18,-8
27,27,140,5,13,-8
27,27,141,17,28,-11
27,27,142,9,9,0
27,27,143,8,9,-1
27,27,144,15,7,8
27,27,145,6,10,-4
27,27,146,7,13,-6
27,27,147,4,9,-5
27,27,148,13,16,-3
27,27,149,10,15,-5
27,27,150,7,7,0
27,27,151,6,17,-11
27,27,152,12,13,-1
27,27,153,5,20,-15
27,27,154,7,11,-4
27,27,155,17,21,-4
27,27,156,0,8,-8
27,27,157,22,15,7
27,27,158,9,7,2
27,27,159,14,6,8
27,27,160,20,19,1
27,27,161,19,9,10
27,27,162,13,14,-1
27,27,163,7,6,1
27,27,164,8,9,-1
27,27,165,4,21,-17
27,27,166,12,8,4
27,27,167,28,22,6
27,27,168,17,11,6
27,27,169,23,21,2
27,27,170,13,10,3
27,27,171,12,16,-4
27,27,172,12,7,5
27,27,173,6,5,1
27,27,174,10,7,3
27,27,175,7,9,-2
27,27,176,8,20,-12
27,27,177,10,11,-1
27,27,178,8,16,-8
27,27,179,9,14,-5
27,27,180,8,7,1
27,27,181,23,14,9
27,27,182,14,8,6
27,27,183,5,14,-9
27,27,184,19,5,14
27,27,185,5,9,-4
27,27,186,12,17,-5
27,27,187,27,13,14
27,27,188,12,30,-18
27,27,189,6,16,-10
27,27,190,7,16,-9
27,27,191,10,6,4
27,27,192,10,5,5
27,27,193,20,5,15
27,27,194,17,8,9
27,27,195,14,7,7
27,27,196,5,7,-2
27,27,197,15,17,-2
27,27,198,17,29,-12
27,27,199,10,10,0
27,27,200,6,13,-7
27,27,201,8,17,-9
27,27,202,10,9,1
27,27,203,8,3,5
27,27,204,12,31,-19
27,27,205,21,17,4
27,27,206,17,15,2
27,27,207,12,19,-7
27,27,208,18,19,-1
27,27,209,8,20,-12
27,27,210,10,14,-4
27,27,211,6,9,-3
27,27,212,13,23,-10
27,27,213,9,15,-6
27,27,214,12,15,-3
27,27,215,5,12,-7
27,27,216,15,18,-3
27,27,217,10,14,-4
27,27,218,18,15,3
27,27,219,10,7,3
27,27,220,9,13,-4
27,27,221,17,18,-1
27,27,222,7,4,3
27,27,223,13,3,10
27,27,224,17,7,10
27,27,225,6,15,-9
27,27,226,7,14,-7
27,27,227,8,16,-8
27,27,228,9,10,-1
27,27,229,8,28,-20
27,27,230,4,19,-15
27,27,231,9,14,-5
27,27,232,5,21,-16
27,27,233,12,19,-7
27,27,234,13,8,5
27,27,235,13,19,-6
27,27,236,10,18,-8
27,27,237,12,17,-5
27,27,238,16,15,1
27,27,239,11,6,5
27,27,240,10,14,-4
27,27,241,12,10,2
27,27,242,20,17,3
27,27,243,12,19,-7
27,27,244,7,12,-5
27,27,245,14,7,7
27,27,246,9,13,-4
27,27,247,9,21,-12
27,27,248,5,6,-1
27,27,249,12,4,8
27,27,250,5,19,-14
27,27,251,12,15,-3
27,27,252,9,13,-4
27,27,253,9,16,-7
27,27,254,12,18,-6
27,27,255,12,14,-2
27,27,256,7,11,-4
27,27,257,9,21,-12
27,27,258,14,19,-5
27,27,259,8,17,-9
27,27,260,22,19,3
27,27,261,24,14,10
27,27,262,10,7,3
27,27,263,8,18,-10
27,27,264,14,16,-2
27,27,265,18,20,-2
27,27,266,5,5,0
27,27,267,16,11,5
27,27,268,13,9,4
27,27,269,3,17,-14
27,27,270,9,15,-6
27,27,271,12,3,9
27,27,272,9,13,-4
27,27,273,14,7,7
27,27,274,11,23,-12
27,27,275,2,7,-5
27,27,276,4,10,-6
27,27,277,24,15,9
27,27,278,16,18,-2
27,27,279,15,15,0
27,27,280,1,11,-10
27,27,281,12,19,-7
27,27,282,8,16,-8
27,27,283,7,11,-4
27,27,284,4,9,-5
27,27,285,23,8,15
27,27,286,14,15,-1
27,27,287,12,10,2
27,27,288,12,17,-5
27,27,289,25,13,12
27,27,290,21,14,7
27,27,291,9,19,-10
27,27,292,6,11,-5
27,27,293,12,15,-3
27,27,294,6,4,2
27,27,295,9,10,-1
27,27,296,8,21,-13
27,27,297,13,22,-9
27,27,298,1,1,0
27,27,299,8,16,-8
27,28,0,9,18,-9
27,28,1,10,5,5
27,28,2,11,8,3
27,28,3,8,18,-10
27,28,4,17,13,4
27,28,5,8,11,-3
27,28,6,5,10,-5
27,28,7,16,17,-1
27,28,8,15,17,-2
27,28,9,11,13,-2
27,28,10,19,12,7
27,28,11,4,17,-13
27,28,12,16,16,0
27,28,13,15,13,2
27,28,14,11,6,5
27,28,15,13,14,-1
27,28,16,13,12,1
27,28,17,21,23,-2
27,28,18,6,6,0
27,28,19,19,11,8
27,28,20,13,13,0
27,28,21,19,21,-2
27,28,22,13,12,1
27,28,23,7,12,-5
27,28,24,13,17,-4
27,28,25,9,4,5
27,28,26,21,7,14
27,28,27,6,10,-4
27,28,28,5,4,1
27,28,29,16,8,8
27,28,30,12,15,-3
27,28,31,10,7,3
27,28,32,19,12,7
27,28,33,8,10,-2
27,28,34,7,16,-9
27,28,35,9,11,-2
27,28,36,13,3,10
27,28,37,11,13,-2
27,28,38,14,13,1
27,28,39,12,21,-9
27,28,40,5,9,-4
27,28,41,11,13,-2
27,28,42,7,6,1
27,28,43,2,7,-5
27,28,44,13,19,-6
27,28,45,6,16,-10
27,28,46,9,7,2
27,28,47,15,9,6
27,28,48,20,15,5
27,28,49,18,6,12
27,28,50,13,11,2
27,28,51,12,13,-1
27,28,52,3,13,-10
27,28,53,11,23,-12
27,28,54,10,9,1
27,28,55,10,11,-1
27,28,56,3,6,-3
27,28,57,7,10,-3
27,28,58,10,17,-7
27,28,59,8,8,0
27,28,60,8,8,0
27,28,61,20,15,5
27,28,62,18,9,9
27,28,63,16,19,-3
27,28,64,16,11,5
27,28,65,15,12,3
27,28,66,28,7,21
27,28,67,8,9,-1
27,28,68,11,12,-1
27,28,69,12,10,2
27,28,70,20,28,-8
27,28,71,11,17,-6
27,28,72,13,10,3
27,28,73,9,6,3
27,28,74,11,12,-1
27,28,75,13,13,0
27,28,76,19,18,1
27,28,77,18,13,5
27,28,78,19,20,-1
27,28,79,10,7,3
27,28,80,8,7,1
27,28,81,7,13,-6
27,28,82,8,5,3
27,28,83,10,11,-1
27,28,84,16,11,5
27,28,85,20,9,11
27,28,86,15,12,3
27,28,87,5,4,1
27,28,88,8,16,-8
27,28,89,9,7,2
27,28,90,18,12,6
27,28,91,0,6,-6
27,28,92,13,11,2
27,28,93,18,11,7
27,28,94,15,10,5
27,28,95,14,23,-9
27,28,96,1,5,-4
27,28,97,14,10,4
27,28,98,7,15,-8
27,28,99,13,9,4
27,28,100,6,13,-7
27,28,101,10,6,4
27,28,102,14,2,12
27,28,103,14,10,4
27,28,104,16,9,7
27,28,105,2,6,-4
27,28,106,23,9,14
27,28,107,6,13,-7
27,28,108,13,13,0
27,28,109,15,21,-6
27,28,110,7,14,-7
27,28,111,9,15,-6
27,28,112,15,28,-13
27,28,113,10,15,-5
27,28,114,15,18,-3
27,28,115,16,25,-9
27,28,116,10,10,0
27,28,117,5,10,-5
27,28,118,16,10,6
27,28,119,13,15,-2
27,28,120,12,17,-5
27,28,121,7,6,1
27,28,122,16,13,3
27,28,123,16,12,4
27,28,124,10,20,-10
27,28,125,16,13,3
27,28,126,12,16,-4
27,28,127,15,11,4
27,28,128,9,18,-9
27,28,129,12,10,2
27,28,130,19,12,7
27,28,131,11,10,1
27,28,132,6,18,-12
27,28,133,14,13,1
27,28,134,7,13,-6
27,28,135,2,12,-10
27,28,136,11,16,-5
27,28,137,12,16,-4
27,28,138,16,18,-2
27,28,139,11,13,-2
27,28,140,8,11,-3
27,28,141,10,10,0
27,28,142,24,10,14
27,28,143,8,12,-4
27,28,144,14,5,9
27,28,145,6,14,-8
27,28,146,19,26,-7
27,28,147,20,11,9
27,28,148,13,24,-11
27,28,149,4,8,-4
27,28,150,14,16,-2
27,28,151,12,14,-2
27,28,152,11,18,-7
27,28,153,10,16,-6
27,28,154,8,8,0
27,28,155,14,13,1
27,28,156,11,22,-11
27,28,157,7,4,3
27,28,158,23,13,10
27,28,159,17,10,7
27,28,160,9,3,6
27,28,161,9,7,2
27,28,162,16,8,8
27,28,163,10,13,-3
27,28,164,12,11,1
27,28,165,11,10,1
27,28,166,8,7,1
27,28,167,7,5,2
27,28,168,10,12,-2
27,28,169,7,11,-4
27,28,170,13,19,-6
27,28,171,15,13,2
27,28,172,16,13,3
27,28,173,13,16,-3
27,28,174,7,8,-1
27,28,175,6,16,-10
27,28,176,9,6,3
27,28,177,9,11,-2
27,28,178,10,5,5
27,28,179,24,18,6
27,28,180,10,8,2
27,28,181,11,8,3
27,28,182,4,14,-10
27,28,183,8,16,-8
27,28,184,5,15,-10
27,28,185,14,18,-4
27,28,186,5,6,-1
27,28,187,12,12,0
27,28,188,6,8,-2
27,28,189,10,9,1
27,28,190,15,11,4
27,28,191,11,14,-3
27,28,192,7,11,-4
27,28,193,30,8,22
27,28,194,8,8,0
27,28,195,10,3,7
27,28,196,8,13,-5
27,28,197,7,11,-4
27,28,198,14,13,1
27,28,199,12,15,-3
27,28,200,14,11,3
27,28,201,11,7,4
27,28,202,12,15,-3
27,28,203,16,18,-2
27,28,204,4,17,-13
27,28,205,5,16,-11
27,28,206,2,10,-8
27,28,207,8,10,-2
27,28,208,8,21,-13
27,28,209,10,18,-8
27,28,210,19,27,-8
27,28,211,17,12,5
27,28,212,6,4,2
27,28,213,13,13,0
27,28,214,9,16,-7
27,28,215,7,21,-14
27,28,216,10,5,5
27,28,217,6,4,2
27,28,218,15,14,1
27,28,219,12,16,-4
27,28,220,22,23,-1
27,28,221,13,10,3
27,28,222,17,21,-4
27,28,223,15,24,-9
27,28,224,12,8,4
27,28,225,5,7,-2
27,28,226,10,3,7
27,28,227,9,14,-5
27,28,228,10,7,3
27,28,229,7,13,-6
27,28,230,6,10,-4
27,28,231,17,26,-9
27,28,232,11,1,10
27,28,233,12,10,2
27,28,234,15,16,-1
27,28,235,3,12,-9
27,28,236,14,17,-3
27,28,237,10,15,-5
27,28,238,13,17,-4
27,28,239,26,14,12
27,28,240,15,13,2
27,28,241,11,16,-5
27,28,242,10,7,3
27,28,243,16,9,7
27,28,244,10,2,8
27,28,245,21,23,-2
27,28,246,10,6,4
27,28,247,15,9,6
27,28,248,14,12,2
27,28,249,11,22,-11
27,28,250,16,6,10
27,28,251,4,13,-9
27,28,252,16,18,-2
27,28,253,11,12,-1
27,28,254,14,15,-1
27,28,255,20,8,12
27,28,256,19,15,4
27,28,257,11,18,-7
27,28,258,10,13,-3
27,28,259,11,10,1
27,28,260,12,7,5
27,28,261,21,17,4
27,28,262,13,5,8
27,28,263,6,9,-3
27,28,264,21,12,9
27,28,265,9,5,4
27,28,266,9,11,-2
27,28,267,19,11,8
27,28,268,13,6,7
27,28,269,23,9,14
27,28,270,10,14,-4
27,28,271,11,9,2
27,28,272,14,7,7
27,28,273,11,15,-4
27,28,274,12,20,-8
27,28,275,11,9,2
27,28,276,11,6,5
27,28,277,16,6,10
27,28,278,13,21,-8
27,28,279,14,4,10
27,28,280,16,20,-4
27,28,281,5,7,-2
27,28,282,13,14,-1
27,28,283,26,9,17
27,28,284,12,7,5
27,28,285,6,17,-11
27,28,286,14,3,11
27,28,287,19,21,-2
27,28,288,7,9,-2
27,28,289,10,18,-8
27,28,290,6,8,-2
27,28,291,18,14,4
27,28,292,3,12,-9
27,28,293,10,19,-9
27,28,294,7,28,-21
27,28,295,4,9,-5
27,28,296,8,3,5
27,28,297,19,8,11
27,28,298,11,14,-3
27,28,299,14,14,0
27,29,0,10,17,-7
27,29,1,16,16,0
27,29,2,22,18,4
27,29,3,8,11,-3
27,29,4,25,11,14
27,29,5,15,7,8
27,29,6,17,23,-6
27,29,7,11,5,6
27,29,8,10,5,5
27,29,9,7,15,-8
27,29,10,4,21,-17
27,29,11,14,8,6
27,29,12,15,12,3
27,29,13,7,13,-6
27,29,14,7,6,1
27,29,15,5,10,-5
27,29,16,7,10,-3
27,29,17,11,16,-5
27,29,18,12,10,2
27,29,19,10,11,-1
27,29,20,12,15,-3
27,29,21,3,8,-5
27,29,22,25,15,10
27,29,23,9,13,-4
27,29,24,12,5,7
27,29,25,8,21,-13
27,29,26,9,12,-3
27,29,27,17,20,-3
27,29,28,19,19,0
27,29,29,9,9,0
27,29,30,17,24,-7
27,29,31,11,14,-3
27,29,32,16,22,-6
27,29,33,19,15,4
27,29,34,17,22,-5
27,29,35,22,17,5
27,29,36,12,7,5
27,29,37,2,18,-16
27,29,38,6,6,0
27,29,39,9,11,-2
27,29,40,25,15,10
27,29,41,12,11,1
27,29,42,6,4,2
27,29,43,2,6,-4
27,29,44,6,12,-6
27,29,45,10,8,2
27,29,46,11,20,-9
27,29,47,19,20,-1
27,29,48,13,7,6
27,29,49,16,7,9
27,29,50,8,20,-12
27,29,51,14,18,-4
27,29,52,4,8,-4
27,29,53,17,13,4
27,29,54,13,10,3
27,29,55,11,11,0
27,29,56,13,10,3
27,29,57,15,30,-15
27,29,58,29,18,11
27,29,59,3,18,-15
27,29,60,17,7,10
27,29,61,17,6,11
27,29,62,8,11,-3
27,29,63,7,11,-4
27,29,64,16,18,-2
27,29,65,12,22,-10
27,29,66,13,4,9
27,29,67,7,17,-10
27,29,68,3,9,-6
27,29,69,19,22,-3
27,29,70,14,20,-6
27,29,71,13,8,5
27,29,72,11,16,-5
27,29,73,17,7,10
27,29,74,23,25,-2
27,29,75,19,13,6
27,29,76,11,14,-3
27,29,77,8,5,3
27,29,78,7,15,-8
27,29,79,7,8,-1
27,29,80,21,15,6
27,29,81,17,7,10
27,29,82,4,5,-1
27,29,83,9,11,-2
27,29,84,7,11,-4
27,29,85,14,7,7
27,29,86,15,9,6
27,29,87,18,13,5
27,29,88,4,11,-7
27,29,89,7,14,-7
27,29,90,17,13,4
27,29,91,11,16,-5
27,29,92,11,18,-7
27,29,93,8,11,-3
27,29,94,12,16,-4
27,29,95,5,10,-5
27,29,96,3,6,-3
27,29,97,7,10,-3
27,29,98,5,16,-11
27,29,99,8,15,-7
27,29,100,27,16,11
27,29,101,10,10,0
27,29,102,12,7,5
27,29,103,9,12,-3
27,29,104,7,11,-4
27,29,105,8,11,-3
27,29,106,12,10,2
27,29,107,13,11,2
27,29,108,15,11,4
27,29,109,16,25,-9
27,29,110,12,15,-3
27,29,111,16,5,11
27,29,112,16,12,4
27,29,113,12,19,-7
27,29,114,12,14,-2
27,29,115,15,11,4
27,29,116,9,20,-11
27,29,117,11,16,-5
27,29,118,9,13,-4
27,29,119,4,7,-3
27,29,120,7,7,0
27,29,121,14,9,5
27,29,122,12,10,2
27,29,123,12,8,4
27,29,124,7,16,-9
27,29,125,20,14,6
27,29,126,22,11,11
27,29,127,13,18,-5
27,29,128,13,5,8
27,29,129,5,12,-7
27,29,130,8,13,-5
27,29,131,14,10,4
27,29,132,15,17,-2
27,29,133,6,10,-4
27,29,134,19,17,2
27,29,135,6,7,-1
27,29,136,7,14,-7
27,29,137,20,19,1
27,29,138,10,6,4
27,29,139,10,20,-10
27,29,140,1,1,0
27,29,141,13,7,6
27,29,142,9,12,-3
27,29,143,12,6,6
27,29,144,5,7,-2
27,29,145,19,16,3
27,29,146,8,13,-5
27,29,147,9,8,1
27,29,148,11,12,-1
27,29,149,7,8,-1
27,29,150,14,19,-5
27,29,151,13,12,1
27,29,152,10,11,-1
27,29,153,16,24,-8
27,29,154,14,13,1
27,29,155,16,8,8
27,29,156,11,7,4
27,29,157,15,8,7
27,29,158,18,6,12
27,29,159,19,10,9
27,29,160,9,12,-3
27,29,161,4,10,-6
27,29,162,11,8,3
27,29,163,17,16,1
27,29,164,9,4,5
27,29,165,15,16,-1
27,29,166,11,13,-2
27,29,167,6,3,3
27,29,168,17,10,7
27,29,169,15,13,2
27,29,170,13,17,-4
27,29,171,9,7,2
27,29,172,12,14,-2
27,29,173,13,18,-5
27,29,174,13,17,-4
27,29,175,4,11,-7
27,29,176,17,16,1
27,29,177,14,15,-1
27,29,178,13,17,-4
27,29,179,14,13,1
27,29,180,14,21,-7
27,29,181,10,8,2
27,29,182,13,20,-7
27,29,183,10,13,-3
27,29,184,6,14,-8
27,29,185,13,18,-5
27,29,186,17,9,8
27,29,187,10,6,4
27,29,188,16,9,7
27,29,189,14,11,3
27,29,190,4,7,-3
27,29,191,14,9,5
27,29,192,14,14,0
27,29,193,17,8,9
27,29,194,21,19,2
27,29,195,9,10,-1
27,29,196,12,22,-10
27,29,197,11,19,-8
27,29,198,8,28,-20
27,29,199,10,3,7
27,29,200,4,15,-11
27,29,201,4,11,-7
27,29,202,3,9,-6
27,29,203,11,12,-1
27,29,204,20,17,3
27,29,205,15,20,-5
27,29,206,16,23,-7
27,29,207,14,18,-4
27,29,208,0,10,-10
27,29,209,9,11,-2
27,29,210,14,14,0
27,29,211,9,8,1
27,29,212,16,11,5
27,29,213,11,7,4
27,29,214,21,13,8
27,29,215,18,7,11
27,29,216,7,13,-6
27,29,217,16,19,-3
27,29,218,11,13,-2
27,29,219,13,9,4
27,29,220,13,10,3
27,29,221,14,11,3
27,29,222,4,15,-11
27,29,223,6,10,-4
27,29,224,8,12,-4
27,29,225,13,19,-6
27,29,226,13,9,4
27,29,227,6,17,-11
27,29,228,16,10,6
27,29,229,16,18,-2
27,29,230,13,14,-1
27,29,231,8,2,6
27,29,232,14,23,-9
27,29,233,11,4,7
27,29,234,1,7,-6
27,29,235,8,16,-8
27,29,236,15,8,7
27,29,237,21,9,12
27,29,238,9,10,-1
27,29,239,11,23,-12
27,29,240,20,20,0
27,29,241,8,13,-5
27,29,242,15,9,6
27,29,243,9,16,-7
27,29,244,16,7,9
27,29,245,11,5,6
27,29,246,10,7,3
27,29,247,6,17,-11
27,29,248,13,7,6
27,29,249,13,5,8
27,29,250,11,8,3
27,29,251,5,8,-3
27,29,252,8,4,4
27,29,253,17,10,7
27,29,254,15,14,1
27,29,255,15,9,6
27,29,256,13,13,0
27,29,257,10,11,-1
27,29,258,22,16,6
27,29,259,13,9,4
27,29,260,11,11,0
27,29,261,9,16,-7
27,29,262,6,8,-2
27,29,263,10,7,3
27,29,264,19,5,14
27,29,265,19,10,9
27,29,266,10,10,0
27,29,267,7,11,-4
27,29,268,7,7,0
27,29,269,18,18,0
27,29,270,5,19,-14
27,29,271,9,14,-5
27,29,272,9,8,1
27,29,273,11,13,-2
27,29,274,3,3,0
27,29,275,10,15,-5
27,29,276,16,15,1
27,29,277,8,9,-1
27,29,278,9,11,-2
27,29,279,15,23,-8
27,29,280,24,14,10
27,29,281,25,23,2
27,29,282,13,3,10
27,29,283,8,10,-2
27,29,284,17,14,3
27,29,285,10,14,-4
27,29,286,17,22,-5
27,29,287,4,14,-10
27,29,288,18,12,6
27,29,289,13,16,-3
27,29,290,14,5,9
27,29,291,5,14,-9
27,29,292,8,15,-7
27,29,293,17,13,4
27,29,294,14,13,1
27,29,295,11,17,-6
27,29,296,7,13,-6
27,29,297,7,8,-1
27,29,298,8,0,8
27,29,299,6,6,0
27,30,0,23,2,21
27,30,1,27,14,13
27,30,2,18,7,11
27,30,3,12,15,-3
27,30,4,12,5,7
27,30,5,16,13,3
27,30,6,9,2,7
27,30,7,14,13,1
27,30,8,6,6,0
27,30,9,24,11,13
27,30,10,11,16,-5
27,30,11,23,13,10
27,30,12,4,7,-3
27,30,13,8,13,-5
27,30,14,21,22,-1
27,30,15,9,11,-2
27,30,16,9,7,2
27,30,17,21,11,10
27,30,18,13,23,-10
27,30,19,20,9,11
27,30,20,9,10,-1
27,30,21,5,10,-5
27,30,22,15,9,6
27,30,23,5,13,-8
27,30,24,20,8,12
27,30,25,10,11,-1
27,30,26,15,18,-3
27,30,27,8,8,0
27,30,28,11,9,2
27,30,29,9,13,-4
27,30,30,8,11,-3
27,30,31,6,14,-8
27,30,32,12,23,-11
27,30,33,13,10,3
27,30,34,16,1,15
27,30,35,2,11,-9
27,30,36,14,14,0
27,30,37,9,9,0
27,30,38,9,9,0
27,30,39,5,8,-3
27,30,40,19,16,3
27,30,41,11,7,4
27,30,42,4,8,-4
27,30,43,15,11,4
27,30,44,19,13,6
27,30,45,8,12,-4
27,30,46,9,24,-15
27,30,47,11,9,2
27,30,48,17,0,17
27,30,49,13,11,2
27,30,50,17,11,6
27,30,51,8,21,-13
27,30,52,3,11,-8
27,30,53,18,13,5
27,30,54,13,8,5
27,30,55,10,6,4
27,30,56,15,12,3
27,30,57,12,6,6
27,30,58,15,9,6
27,30,59,24,20,4
27,30,60,13,9,4
27,30,61,12,5,7
27,30,62,12,28,-16
27,30,63,13,12,1
27,30,64,4,6,-2
27,30,65,9,14,-5
27,30,66,8,5,3
27,30,67,9,9,0
27,30,68,12,8,4
27,30,69,19,20,-1
27,30,70,9,12,-3
27,30,71,13,19,-6
27,30,72,17,14,3
27,30,73,15,16,-1
27,30,74,15,15,0
27,30,75,13,21,-8
27,30,76,14,16,-2
27,30,77,7,11,-4
27,30,78,14,11,3
27,30,79,17,12,5
27,30,80,14,11,3
27,30,81,28,12,16
27,30,82,7,14,-7
27,30,83,9,6,3
27,30,84,3,2,1
27,30,85,14,8,6
27,30,86,7,17,-10
27,30,87,11,13,-2
27,30,88,16,15,1
27,30,89,17,19,-2
27,30,90,7,10,-3
27,30,91,13,19,-6
27,30,92,10,12,-2
27,30,93,15,14,1
27,30,94,5,7,-2
27,30,95,13,6,7
27,30,96,10,12,-2
27,30,97,11,11,0
27,30,98,16,18,-2
27,30,99,13,10,3
27,30,100,12,18,-6
27,30,101,12,6,6
27,30,102,13,9,4
27,30,103,19,12,7
27,30,104,21,16,5
27,30,105,6,10,-4
27,30,106,13,12,1
27,30,107,12,14,-2
27,30,108,2,2,0
27,30,109,17,11,6
27,30,110,16,25,-9
27,30,111,23,5,18
27,30,112,9,15,-6
27,30,113,16,16,0
27,30,114,8,11,-3
27,30,115,13,16,-3
27,30,116,12,16,-4
27,30,117,5,12,-7
27,30,118,11,15,-4
27,30,119,7,17,-10
27,30,120,20,5,15
27,30,121,14,16,-2
27,30,122,13,10,3
27,30,123,2,3,-1
27,30,124,13,22,-9
27,30,125,10,6,4
27,30,126,16,9,7
27,30,127,12,10,2
27,30,128,18,5,13
27,30,129,18,22,-4
27,30,130,15,22,-7
27,30,131,15,4,11
27,30,132,4,9,-5
27,30,133,20,17,3
27,30,134,6,12,-6
27,30,135,11,19,-8
27,30,136,11,10,1
27,30,137,12,9,3
27,30,138,9,15,-6
27,30,139,12,12,0
27,30,140,21,10,11
27,30,141,21,23,-2
27,30,142,20,10,10
27,30,143,13,9,4
27,30,144,6,10,-4
27,30,145,15,17,-2
27,30,146,8,12,-4
27,30,147,7,9,-2
27,30,148,13,5,8
27,30,149,12,19,-7
27,30,150,7,6,1
27,30,151,8,9,-1
27,30,152,4,15,-11
27,30,153,10,13,-3
27,30,154,7,10,-3
27,30,155,12,10,2
27,30,156,9,17,-8
27,30,157,6,10,-4
27,30,158,16,12,4
27,30,159,8,9,-1
27,30,160,18,9,9
27,30,161,26,21,5
27,30,162,16,13,3
27,30,163,11,14,-3
27,30,164,14,33,-19
27,30,165,11,7,4
27,30,166,8,22,-14
27,30,167,10,13,-3
27,30,168,9,5,4
27,30,169,21,17,4
27,30,170,7,11,-4
27,30,171,5,17,-12
27,30,172,10,13,-3
27,30,173,11,9,2
27,30,174,16,15,1
27,30,175,10,14,-4
27,30,176,14,20,-6
27,30,177,18,30,-12
27,30,178,15,14,1
27,30,179,5,13,-8
27,30,180,5,22,-17
27,30,181,9,11,-2
27,30,182,18,13,5
27,30,183,16,11,5
27,30,184,19,8,11
27,30,185,11,8,3
27,30,186,13,15,-2
27,30,187,20,8,12
27,30,188,7,17,-10
27,30,189,5,10,-5
27,30,190,7,10,-3
27,30,191,13,11,2
27,30,192,12,16,-4
27,30,193,11,16,-5
27,30,194,20,17,3
27,30,195,10,7,3
27,30,196,11,8,3
27,30,197,12,7,5
27,30,198,12,4,8
27,30,199,7,11,-4
27,30,200,9,14,-5
27,30,201,8,11,-3
27,30,202,7,9,-2
27,30,203,17,8,9
27,30,204,15,4,11
27,30,205,19,17,2
27,30,206,9,12,-3
27,30,207,12,9,3
27,30,208,17,8,9
27,30,209,11,3,8
27,30,210,8,9,-1
27,30,211,8,10,-2
27,30,212,7,13,-6
27,30,213,21,16,5
27,30,214,18,11,7
27,30,215,11,17,-6
27,30,216,11,16,-5
27,30,217,16,12,4
27,30,218,16,29,-13
27,30,219,22,5,17
27,30,220,19,8,11
27,30,221,9,19,-10
27,30,222,14,16,-2
27,30,223,8,10,-2
27,30,224,24,6,18
27,30,225,14,9,5
27,30,226,30,19,11
27,30,227,9,13,-4
27,30,228,9,8,1
27,30,229,16,11,5
27,30,230,12,10,2
27,30,231,13,14,-1
27,30,232,3,3,0
27,30,233,10,15,-5
27,30,234,9,13,-4
27,30,235,15,10,5
27,30,236,9,5,4
27,30,237,15,11,4
27,30,238,15,11,4
27,30,239,11,8,3
27,30,240,15,13,2
27,30,241,4,7,-3
27,30,242,16,12,4
27,30,243,19,21,-2
27,30,244,29,16,13
27,30,245,13,16,-3
27,30,246,9,7,2
27,30,247,9,6,3
27,30,248,13,7,6
27,30,249,8,2,6
27,30,250,7,7,0
27,30,251,8,2,6
27,30,252,15,18,-3
27,30,253,7,5,2
27,30,254,7,7,0
27,30,255,7,12,-5
27,30,256,11,22,-11
27,30,257,13,12,1
27,30,258,10,23,-13
27,30,259,12,17,-5
27,30,260,11,9,2
27,30,261,7,14,-7
27,30,262,14,11,3
27,30,263,7,11,-4
27,30,264,13,13,0
27,30,265,11,8,3
27,30,266,6,10,-4
27,30,267,12,9,3
27,30,268,13,18,-5
27,30,269,10,17,-7
27,30,270,6,12,-6
27,30,271,10,13,-3
27,30,272,21,16,5
27,30,273,4,11,-7
27,30,274,9,13,-4
27,30,275,18,17,1
27,30,276,16,13,3
27,30,277,9,7,2
27,30,278,22,19,3
27,30,279,9,10,-1
27,30,280,18,11,7
27,30,281,19,8,11
27,30,282,8,3,5
27,30,283,4,11,-7
27,30,284,6,6,0
27,30,285,17,7,10
27,30,286,23,17,6
27,30,287,21,11,10
27,30,288,12,9,3
27,30,289,16,11,5
27,30,290,15,9,6
27,30,291,15,5,10
27,30,292,14,10,4
27,30,293,5,5,0
27,30,294,10,6,4
27,30,295,9,16,-7
27,30,296,12,11,1
27,30,297,11,9,2
27,30,298,11,20,-9
27,30,299,9,10,-1
28,1,0,10,25,-15
28,1,1,9,12,-3
28,1,2,8,26,-18
28,1,3,4,10,-6
28,1,4,9,20,-11
28,1,5,8,11,-3
28,1,6,5,18,-13
28,1,7,7,13,-6
28,1,8,11,21,-10
28,1,9,2,7,-5
28,1,10,16,17,-1
28,1,11,2,27,-25
28,1,12,4,6,-2
28,1,13,11,14,-3
28,1,14,5,10,-5
28,1,15,6,10,-4
28,1,16,13,32,-19
28,1,17,8,25,-17
28,1,18,8,24,-16
28,1,19,14,29,-15
28,1,20,8,8,0
28,1,21,3,15,-12
28,1,22,4,19,-15
28,1,23,5,25,-20
28,1,24,5,14,-9
28,1,25,15,26,-11
28,1,26,7,12,-5
28,1,27,8,11,-3
28,1,28,9,23,-14
28,1,29,9,24,-15
28,1,30,12,23,-11
28,1,31,1,12,-11
28,1,32,13,31,-18
28,1,33,6,8,-2
28,1,34,9,13,-4
28,1,35,6,26,-20
28,1,36,7,13,-6
28,1,37,8,16,-8
28,1,38,5,22,-17
28,1,39,5,18,-13
28,1,40,10,12,-2
28,1,41,6,10,-4
28,1,42,10,30,-20
28,1,43,12,25,-13
28,1,44,8,26,-18
28,1,45,6,27,-21
28,1,46,6,11,-5
28,1,47,13,15,-2
28,1,48,12,16,-4
28,1,49,5,25,-20
28,1,50,3,20,-17
28,1,51,2,12,-10
28,1,52,8,23,-15
28,1,53,11,9,2
28,1,54,9,13,-4
28,1,55,3,16,-13
28,1,56,10,28,-18
28,1,57,6,13,-7
28,1,58,4,6,-2
28,1,59,6,14,-8
28,1,60,5,15,-10
28,1,61,11,21,-10
28,1,62,6,20,-14
28,1,63,5,24,-19
28,1,64,14,19,-5
28,1,65,8,31,-23
28,1,66,9,31,-22
28,1,67,3,19,-16
28,1,68,6,32,-26
28,1,69,12,7,5
28,1,70,7,20,-13
28,1,71,9,14,-5
28,1,72,16,22,-6
28,1,73,8,16,-8
28,1,74,2,14,-12
28,1,75,6,20,-14
28,1,76,3,10,-7
28,1,77,10,14,-4
28,1,78,17,25,-8
28,1,79,6,9,-3
28,1,80,8,7,1
28,1,81,6,13,-7
28,1,82,2,10,-8
28,1,83,2,20,-18
28,1,84,3,10,-7
28,1,85,7,14,-7
28,1,86,17,26,-9
28,1,87,11,8,3
28,1,88,6,19,-13
28,1,89,9,20,-11
28,1,90,4,22,-18
28,1,91,6,13,-7
28,1,92,11,27,-16
28,1,93,9,17,-8
28,1,94,6,24,-18
28,1,95,6,10,-4
28,1,96,5,17,-12
28,1,97,4,22,-18
28,1,98,4,26,-22
28,1,99,2,19,-17
28,1,100,9,31,-22
28,1,101,3,26,-23
28,1,102,15,17,-2
28,1,103,4,22,-18
28,1,104,8,21,-13
28,1,105,6,18,-12
28,1,106,2,13,-11
28,1,107,12,32,-20
28,1,108,8,13,-5
28,1,109,7,18,-11
28,1,110,4,16,-12
28,1,111,6,25,-19
28,1,112,8,15,-7
28,1,113,7,20,-13
28,1,114,11,20,-9
28,1,115,8,23,-15
28,1,116,3,13,-10
28,1,117,12,21,-9
28,1,118,13,27,-14
28,1,119,5,16,-11
28,1,120,0,3,-3
28,1,121,5,4,1
28,1,122,8,16,-8
28,1,123,8,16,-8
28,1,124,9,11,-2
28,1,125,14,18,-4
28,1,126,5,25,-20
28,1,127,19,12,7
28,1,128,13,11,2
28,1,129,23,21,2
28,1,130,7,6,1
28,1,131,7,21,-14
28,1,132,9,4,5
28,1,133,15,9,6
28,1,134,8,12,-4
28,1,135,6,21,-15
28,1,136,4,8,-4
28,1,137,1,23,-22
28,1,138,20,28,-8
28,1,139,12,16,-4
28,1,140,8,23,-15
28,1,141,3,9,-6
28,1,142,9,12,-3
28,1,143,6,14,-8
28,1,144,11,25,-14
28,1,145,7,28,-21
28,1,146,12,16,-4
28,1,147,2,17,-15
28,1,148,10,19,-9
28,1,149,14,13,1
28,1,150,17,21,-4
28,1,151,6,18,-12
28,1,152,9,10,-1
28,1,153,6,20,-14
28,1,154,10,11,-1
28,1,155,6,24,-18
28,1,156,3,17,-14
28,1,157,4,21,-17
28,1,158,10,24,-14
28,1,159,9,17,-8
28,1,160,4,30,-26
28,1,161,8,25,-17
28,1,162,6,9,-3
28,1,163,2,6,-4
28,1,164,4,9,-5
28,1,165,8,22,-14
28,1,166,12,21,-9
28,1,167,4,22,-18
28,1,168,5,15,-10
28,1,169,1,12,-11
28,1,170,6,10,-4
28,1,171,5,9,-4
28,1,172,12,22,-10
28,1,173,5,15,-10
28,1,174,2,15,-13
28,1,175,9,15,-6
28,1,176,16,24,-8
28,1,177,1,23,-22
28,1,178,5,17,-12
28,1,179,9,10,-1
28,1,180,11,24,-13
28,1,181,6,12,-6
28,1,182,2,11,-9
28,1,183,6,20,-14
28,1,184,8,21,-13
28,1,185,13,33,-20
28,1,186,3,16,-13
28,1,187,3,24,-21
28,1,188,1,11,-10
28,1,189,6,10,-4
28,1,190,2,9,-7
28,1,191,6,14,-8
28,1,192,5,12,-7
28,1,193,8,19,-11
28,1,194,6,29,-23
28,1,195,12,17,-5
28,1,196,4,14,-10
28,1,197,9,16,-7
28,1,198,9,18,-9
28,1,199,9,14,-5
28,1,200,1,11,-10
28,1,201,10,14,-4
28,1,202,9,8,1
28,1,203,4,4,0
28,1,204,4,18,-14
28,1,205,14,18,-4
28,1,206,3,10,-7
28,1,207,5,31,-26
28,1,208,11,16,-5
28,1,209,9,20,-11
28,1,210,3,19,-16
28,1,211,7,26,-19
28,1,212,7,12,-5
28,1,213,9,19,-10
28,1,214,4,7,-3
28,1,215,1,14,-13
28,1,216,6,9,-3
28,1,217,7,15,-8
28,1,218,3,7,-4
28,1,219,6,27,-21
28,1,220,5,15,-10
28,1,221,14,19,-5
28,1,222,7,11,-4
28,1,223,2,23,-21
28,1,224,6,24,-18
28,1,225,1,17,-16
28,1,226,5,17,-12
28,1,227,6,9,-3
28,1,228,3,18,-15
28,1,229,6,21,-15
28,1,230,9,19,-10
28,1,231,8,18,-10
28,1,232,2,19,-17
28,1,233,5,9,-4
28,1,234,1,19,-18
28,1,235,5,18,-13
28,1,236,3,22,-19
28,1,237,10,9,1
28,1,238,2,7,-5
28,1,239,8,17,-9
28,1,240,12,24,-12
28,1,241,2,16,-14
28,1,242,5,6,-1
28,1,243,2,11,-9
28,1,244,4,12,-8
28,1,245,1,19,-18
28,1,246,11,42,-31
28,1,247,11,14,-3
28,1,248,8,22,-14
28,1,249,6,26,-20
28,1,250,7,22,-15
28,1,251,1,8,-7
28,1,252,1,20,-19
28,1,253,5,22,-17
28,1,254,5,11,-6
28,1,255,8,18,-10
28,1,256,10,27,-17
28,1,257,4,14,-10
28,1,258,16,20,-4
28,1,259,6,10,-4
28,1,260,7,20,-13
28,1,261,6,16,-10
28,1,262,4,16,-12
28,1,263,8,12,-4
28,1,264,3,11,-8
28,1,265,8,3,5
28,1,266,6,14,-8
28,1,267,2,6,-4
28,1,268,7,16,-9
28,1,269,7,24,-17
28,1,270,8,33,-25
28,1,271,8,14,-6
28,1,272,12,23,-11
28,1,273,8,18,-10
28,1,274,8,39,-31
28,1,275,11,31,-20
28,1,276,8,12,-4
28,1,277,9,16,-7
28,1,278,7,16,-9
28,1,279,2,10,-8
28,1,280,14,11,3
28,1,281,8,16,-8
28,1,282,6,31,-25
28,1,283,5,18,-13
28,1,284,9,16,-7
28,1,285,8,27,-19
28,1,286,13,50,-37
28,1,287,6,27,-21
28,1,288,4,14,-10
28,1,289,1,23,-22
28,1,290,1,11,-10
28,1,291,3,4,-1
28,1,292,4,14,-10
28,1,293,6,11,-5
28,1,294,10,18,-8
28,1,295,6,23,-17
28,1,296,5,14,-9
28,1,297,12,28,-16
28,1,298,9,21,-12
28,1,299,4,10,-6
28,2,0,5,21,-16
28,2,1,9,27,-18
28,2,2,0,27,-27
28,2,3,7,30,-23
28,2,4,9,18,-9
28,2,5,8,13,-5
28,2,6,8,26,-18
28,2,7,5,10,-5
28,2,8,3,14,-11
28,2,9,7,8,-1
28,2,10,6,18,-12
28,2,11,2,16,-14
28,2,12,11,21,-10
28,2,13,8,28,-20
28,2,14,3,17,-14
28,2,15,8,22,-14
28,2,16,12,20,-8
28,2,17,5,20,-15
28,2,18,10,16,-6
28,2,19,8,21,-13
28,2,20,6,16,-10
28,2,21,6,18,-12
28,2,22,10,13,-3
28,2,23,16,16,0
28,2,24,5,34,-29
28,2,25,6,18,-12
28,2,26,15,17,-2
28,2,27,11,13,-2
28,2,28,0,11,-11
28,2,29,9,22,-13
28,2,30,8,24,-16
28,2,31,6,14,-8
28,2,32,3,37,-34
28,2,33,7,16,-9
28,2,34,3,9,-6
28,2,35,15,32,-17
28,2,36,12,19,-7
28,2,37,11,26,-15
28,2,38,6,20,-14
28,2,39,11,46,-35
28,2,40,16,21,-5
28,2,41,8,25,-17
28,2,42,10,20,-10
28,2,43,9,22,-13
28,2,44,10,26,-16
28,2,45,3,23,-20
28,2,46,3,14,-11
28,2,47,3,12,-9
28,2,48,10,14,-4
28,2,49,9,22,-13
28,2,50,3,17,-14
28,2,51,8,26,-18
28,2,52,10,25,-15
28,2,53,1,10,-9
28,2,54,3,23,-20
28,2,55,9,38,-29
28,2,56,0,19,-19
28,2,57,7,29,-22
28,2,58,9,28,-19
28,2,59,6,22,-16
28,2,60,12,20,-8
28,2,61,5,11,-6
28,2,62,6,17,-11
28,2,63,3,13,-10
28,2,64,17,19,-2
28,2,65,13,26,-13
28,2,66,4,19,-15
28,2,67,6,17,-11
28,2,68,4,12,-8
28,2,69,8,12,-4
28,2,70,8,20,-12
28,2,71,3,4,-1
28,2,72,3,17,-14
28,2,73,7,28,-21
28,2,74,2,25,-23
28,2,75,12,16,-4
28,2,76,13,22,-9
28,2,77,7,9,-2
28,2,78,8,26,-18
28,2,79,21,40,-19
28,2,80,9,22,-13
28,2,81,2,14,-12
28,2,82,4,22,-18
28,2,83,8,44,-36
28,2,84,5,22,-17
28,2,85,6,12,-6
28,2,86,7,12,-5
28,2,87,10,8,2
28,2,88,5,11,-6
28,2,89,8,22,-14
28,2,90,3,3,0
28,2,91,3,9,-6
28,2,92,3,20,-17
28,2,93,9,23,-14
28,2,94,4,17,-13
28,2,95,7,36,-29
28,2,96,1,18,-17
28,2,97,2,14,-12
28,2,98,4,34,-30
28,2,99,7,23,-16
28,2,100,4,24,-20
28,2,101,5,26,-21
28,2,102,9,22,-13
28,2,103,8,29,-21
28,2,104,9,29,-20
28,2,105,9,26,-17
28,2,106,7,19,-12
28,2,107,8,22,-14
28,2,108,7,11,-4
28,2,109,3,8,-5
28,2,110,7,19,-12
28,2,111,3,19,-16
28,2,112,7,20,-13
28,2,113,6,17,-11
28,2,114,7,21,-14
28,2,115,6,11,-5
28,2,116,9,21,-12
28,2,117,9,13,-4
28,2,118,4,21,-17
28,2,119,3,19,-16
28,2,120,7,18,-11
28,2,121,2,15,-13
28,2,122,3,20,-17
28,2,123,2,10,-8
28,2,124,2,9,-7
28,2,125,5,32,-27
28,2,126,5,16,-11
28,2,127,7,18,-11
28,2,128,7,21,-14
28,2,129,2,20,-18
28,2,130,14,12,2
28,2,131,8,17,-9
28,2,132,3,8,-5
28,2,133,9,26,-17
28,2,134,6,6,0
28,2,135,3,8,-5
28,2,136,11,25,-14
28,2,137,14,20,-6
28,2,138,7,21,-14
28,2,139,12,23,-11
28,2,140,8,15,-7
28,2,141,5,17,-12
28,2,142,11,18,-7
28,2,143,5,13,-8
28,2,144,15,16,-1
28,2,145,12,15,-3
28,2,146,11,33,-22
28,2,147,7,17,-10
28,2,148,5,19,-14
28,2,149,4,19,-15
28,2,150,11,23,-12
28,2,151,9,16,-7
28,2,152,5,17,-12
28,2,153,1,11,-10
28,2,154,4,8,-4
28,2,155,5,12,-7
28,2,156,2,16,-14
28,2,157,5,10,-5
28,2,158,11,25,-14
28,2,159,7,22,-15
28,2,160,7,15,-8
28,2,161,1,7,-6
28,2,162,3,8,-5
28,2,163,4,12,-8
28,2,164,12,16,-4
28,2,165,1,11,-10
28,2,166,11,19,-8
28,2,167,13,16,-3
28,2,168,7,12,-5
28,2,169,5,21,-16
28,2,170,1,7,-6
28,2,171,13,12,1
28,2,172,3,11,-8
28,2,173,3,11,-8
28,2,174,15,23,-8
28,2,175,13,24,-11
28,2,176,7,17,-10
28,2,177,25,26,-1
28,2,178,4,7,-3
28,2,179,5,18,-13
28,2,180,6,35,-29
28,2,181,4,11,-7
28,2,182,4,17,-13
28,2,183,10,25,-15
28,2,184,7,33,-26
28,2,185,9,31,-22
28,2,186,10,25,-15
28,2,187,13,28,-15
28,2,188,6,23,-17
28,2,189,4,11,-7
28,2,190,10,21,-11
28,2,191,9,38,-29
28,2,192,10,21,-11
28,2,193,8,30,-22
28,2,194,15,26,-11
28,2,195,9,16,-7
28,2,196,9,35,-26
28,2,197,6,19,-13
28,2,198,13,18,-5
28,2,199,15,12,3
28,2,200,9,28,-19
28,2,201,9,23,-14
28,2,202,8,19,-11
28,2,203,5,13,-8
28,2,204,5,30,-25
28,2,205,6,16,-10
28,2,206,5,20,-15
28,2,207,7,13,-6
28,2,208,5,24,-19
28,2,209,2,16,-14
28,2,210,9,9,0
28,2,211,6,15,-9
28,2,212,3,23,-20
28,2,213,7,8,-1
28,2,214,14,14,0
28,2,215,9,22,-13
28,2,216,10,19,-9
28,2,217,8,15,-7
28,2,218,15,13,2
28,2,219,9,21,-12
28,2,220,17,36,-19
28,2,221,5,15,-10
28,2,222,6,34,-28
28,2,223,6,13,-7
28,2,224,2,8,-6
28,2,225,6,14,-8
28,2,226,3,20,-17
28,2,227,10,22,-12
28,2,228,9,14,-5
28,2,229,3,9,-6
28,2,230,9,22,-13
28,2,231,19,23,-4
28,2,232,6,18,-12
28,2,233,15,35,-20
28,2,234,3,10,-7
28,2,235,1,13,-12
28,2,236,4,20,-16
28,2,237,3,6,-3
28,2,238,2,22,-20
28,2,239,11,12,-1
28,2,240,9,11,-2
28,2,241,8,20,-12
28,2,242,7,9,-2
28,2,243,2,46,-44
28,2,244,13,27,-14
28,2,245,12,27,-15
28,2,246,3,7,-4
28,2,247,17,32,-15
28,2,248,4,13,-9
28,2,249,8,27,-19
28,2,250,12,25,-13
28,2,251,14,34,-20
28,2,252,5,15,-10
28,2,253,7,12,-5
28,2,254,12,14,-2
28,2,255,20,17,3
28,2,256,9,15,-6
28,2,257,8,10,-2
28,2,258,4,27,-23
28,2,259,12,22,-10
28,2,260,4,16,-12
28,2,261,5,15,-10
28,2,262,6,14,-8
28,2,263,12,22,-10
28,2,264,5,9,-4
28,2,265,16,19,-3
28,2,266,2,13,-11
28,2,267,2,12,-10
28,2,268,10,32,-22
28,2,269,10,25,-15
28,2,270,10,9,1
28,2,271,2,18,-16
28,2,272,6,20,-14
28,2,273,2,16,-14
28,2,274,4,23,-19
28,2,275,8,13,-5
28,2,276,9,21,-12
28,2,277,9,31,-22
28,2,278,11,23,-12
28,2,279,12,22,-10
28,2,280,9,31,-22
28,2,281,13,23,-10
28,2,282,16,22,-6
28,2,283,4,12,-8
28,2,284,0,7,-7
28,2,285,3,9,-6
28,2,286,2,8,-6
28,2,287,8,33,-25
28,2,288,4,9,-5
28,2,289,11,17,-6
28,2,290,13,22,-9
28,2,291,2,19,-17
28,2,292,2,28,-26
28,2,293,6,6,0
28,2,294,12,32,-20
28,2,295,1,16,-15
28,2,296,10,18,-8
28,2,297,8,28,-20
28,2,298,10,18,-8
28,2,299,13,8,5
28,3,0,7,17,-10
28,3,1,13,15,-2
28,3,2,2,20,-18
28,3,3,10,24,-14
28,3,4,14,10,4
28,3,5,5,12,-7
28,3,6,6,30,-24
28,3,7,7,23,-16
28,3,8,5,23,-18
28,3,9,9,22,-13
28,3,10,6,15,-9
28,3,11,12,31,-19
28,3,12,5,15,-10
28,3,13,1,15,-14
28,3,14,15,21,-6
28,3,15,7,22,-15
28,3,16,10,10,0
28,3,17,6,22,-16
28,3,18,16,35,-19
28,3,19,10,14,-4
28,3,20,8,13,-5
28,3,21,4,31,-27
28,3,22,3,17,-14
28,3,23,5,7,-2
28,3,24,5,10,-5
28,3,25,6,26,-20
28,3,26,4,16,-12
28,3,27,6,28,-22
28,3,28,9,14,-5
28,3,29,7,17,-10
28,3,30,5,20,-15
28,3,31,16,19,-3
28,3,32,11,48,-37
28,3,33,6,13,-7
28,3,34,3,13,-10
28,3,35,11,16,-5
28,3,36,6,29,-23
28,3,37,10,28,-18
28,3,38,7,21,-14
28,3,39,7,16,-9
28,3,40,1,13,-12
28,3,41,5,6,-1
28,3,42,7,21,-14
28,3,43,2,33,-31
28,3,44,3,12,-9
28,3,45,14,22,-8
28,3,46,5,23,-18
28,3,47,13,10,3
28,3,48,4,16,-12
28,3,49,6,26,-20
28,3,50,16,25,-9
28,3,51,6,20,-14
28,3,52,10,22,-12
28,3,53,4,22,-18
28,3,54,10,31,-21
28,3,55,9,4,5
28,3,56,9,28,-19
28,3,57,12,25,-13
28,3,58,9,16,-7
28,3,59,5,29,-24
28,3,60,7,25,-18
28,3,61,4,15,-11
28,3,62,9,21,-12
28,3,63,9,20,-11
28,3,64,15,25,-10
28,3,65,12,30,-18
28,3,66,8,25,-17
28,3,67,2,19,-17
28,3,68,5,12,-7
28,3,69,15,25,-10
28,3,70,12,9,3
28,3,71,6,1,5
28,3,72,12,35,-23
28,3,73,8,18,-10
28,3,74,8,11,-3
28,3,75,10,31,-21
28,3,76,13,33,-20
28,3,77,6,16,-10
28,3,78,11,15,-4
28,3,79,12,8,4
28,3,80,9,28,-19
28,3,81,3,14,-11
28,3,82,20,24,-4
28,3,83,8,14,-6
28,3,84,12,32,-20
28,3,85,8,5,3
28,3,86,3,8,-5
28,3,87,8,18,-10
28,3,88,6,17,-11
28,3,89,12,26,-14
28,3,90,10,23,-13
28,3,91,9,19,-10
28,3,92,4,10,-6
28,3,93,5,4,1
28,3,94,6,27,-21
28,3,95,7,9,-2
28,3,96,13,13,0
28,3,97,11,18,-7
28,3,98,1,18,-17
28,3,99,5,18,-13
28,3,100,12,20,-8
28,3,101,8,22,-14
28,3,102,17,26,-9
28,3,103,3,8,-5
28,3,104,7,17,-10
28,3,105,5,22,-17
28,3,106,3,17,-14
28,3,107,6,13,-7
28,3,108,1,16,-15
28,3,109,8,24,-16
28,3,110,4,8,-4
28,3,111,4,18,-14
28,3,112,6,26,-20
28,3,113,14,36,-22
28,3,114,8,16,-8
28,3,115,9,35,-26
28,3,116,8,26,-18
28,3,117,3,19,-16
28,3,118,2,24,-22
28,3,119,8,35,-27
28,3,120,7,29,-22
28,3,121,1,7,-6
28,3,122,11,19,-8
28,3,123,7,33,-26
28,3,124,5,19,-14
28,3,125,5,17,-12
28,3,126,6,13,-7
28,3,127,10,20,-10
28,3,128,7,21,-14
28,3,129,6,18,-12
28,3,130,3,16,-13
28,3,131,7,12,-5
28,3,132,11,16,-5
28,3,133,11,27,-16
28,3,134,1,21,-20
28,3,135,8,29,-21
28,3,136,19,18,1
28,3,137,7,33,-26
28,3,138,14,15,-1
28,3,139,6,10,-4
28,3,140,11,45,-34
28,3,141,10,24,-14
28,3,142,8,27,-19
28,3,143,6,12,-6
28,3,144,4,20,-16
28,3,145,3,12,-9
28,3,146,5,17,-12
28,3,147,5,14,-9
28,3,148,9,16,-7
28,3,149,7,25,-18
28,3,150,3,17,-14
28,3,151,6,14,-8
28,3,152,17,10,7
28,3,153,7,15,-8
28,3,154,13,45,-32
28,3,155,8,21,-13
28,3,156,4,17,-13
28,3,157,8,17,-9
28,3,158,6,11,-5
28,3,159,9,36,-27
28,3,160,6,24,-18
28,3,161,8,20,-12
28,3,162,0,13,-13
28,3,163,5,33,-28
28,3,164,3,11,-8
28,3,165,5,15,-10
28,3,166,11,18,-7
28,3,167,9,25,-16
28,3,168,10,18,-8
28,3,169,7,13,-6
28,3,170,10,22,-12
28,3,171,7,26,-19
28,3,172,3,14,-11
28,3,173,9,9,0
28,3,174,5,20,-15
28,3,175,7,19,-12
28,3,176,5,36,-31
28,3,177,9,17,-8
28,3,178,11,16,-5
28,3,179,9,26,-17
28,3,180,10,22,-12
28,3,181,9,14,-5
28,3,182,5,20,-15
28,3,183,4,5,-1
28,3,184,7,9,-2
28,3,185,8,28,-20
28,3,186,2,9,-7
28,3,187,13,25,-12
28,3,188,5,8,-3
28,3,189,13,24,-11
28,3,190,6,14,-8
28,3,191,14,23,-9
28,3,192,5,14,-9
28,3,193,9,12,-3
28,3,194,6,10,-4
28,3,195,6,14,-8
28,3,196,7,25,-18
28,3,197,6,19,-13
28,3,198,6,20,-14
28,3,199,5,26,-21
28,3,200,5,13,-8
28,3,201,5,22,-17
28,3,202,11,14,-3
28,3,203,6,11,-5
28,3,204,9,12,-3
28,3,205,5,18,-13
28,3,206,6,21,-15
28,3,207,3,17,-14
28,3,208,8,22,-14
28,3,209,9,10,-1
28,3,210,22,24,-2
28,3,211,11,34,-23
28,3,212,5,27,-22
28,3,213,3,20,-17
28,3,214,6,18,-12
28,3,215,2,7,-5
28,3,216,6,28,-22
28,3,217,10,24,-14
28,3,218,10,13,-3
28,3,219,8,8,0
28,3,220,10,25,-15
28,3,221,4,9,-5
28,3,222,5,19,-14
28,3,223,12,26,-14
28,3,224,9,21,-12
28,3,225,12,30,-18
28,3,226,2,9,-7
28,3,227,3,19,-16
28,3,228,6,26,-20
28,3,229,6,19,-13
28,3,230,2,9,-7
28,3,231,4,8,-4
28,3,232,6,10,-4
28,3,233,4,27,-23
28,3,234,13,25,-12
28,3,235,6,18,-12
28,3,236,15,30,-15
28,3,237,10,17,-7
28,3,238,1,24,-23
28,3,239,15,31,-16
28,3,240,8,17,-9
28,3,241,4,17,-13
28,3,242,11,30,-19
28,3,243,9,25,-16
28,3,244,5,24,-19
28,3,245,7,32,-25
28,3,246,10,16,-6
28,3,247,8,23,-15
28,3,248,5,13,-8
28,3,249,4,9,-5
28,3,250,12,26,-14
28,3,251,3,12,-9
28,3,252,16,23,-7
28,3,253,6,23,-17
28,3,254,17,16,1
28,3,255,15,15,0
28,3,256,3,19,-16
28,3,257,6,12,-6
28,3,258,3,29,-26
28,3,259,10,16,-6
28,3,260,1,28,-27
28,3,261,8,28,-20
28,3,262,8,22,-14
28,3,263,9,18,-9
28,3,264,9,11,-2
28,3,265,10,9,1
28,3,266,3,17,-14
28,3,267,12,26,-14
28,3,268,4,15,-11
28,3,269,14,12,2
28,3,270,11,26,-15
28,3,271,4,23,-19
28,3,272,12,28,-16
28,3,273,5,7,-2
28,3,274,8,11,-3
28,3,275,8,21,-13
28,3,276,14,17,-3
28,3,277,10,16,-6
28,3,278,6,22,-16
28,3,279,8,22,-14
28,3,280,8,21,-13
28,3,281,11,24,-13
28,3,282,11,30,-19
28,3,283,24,44,-20
28,3,284,10,27,-17
28,3,285,11,9,2
28,3,286,6,19,-13
28,3,287,1,12,-11
28,3,288,12,31,-19
28,3,289,8,14,-6
28,3,290,8,6,2
28,3,291,7,17,-10
28,3,292,6,28,-22
28,3,293,7,17,-10
28,3,294,9,14,-5
28,3,295,8,24,-16
28,3,296,14,27,-13
28,3,297,11,31,-20
28,3,298,12,18,-6
28,3,299,12,19,-7
28,4,0,12,26,-14
28,4,1,4,15,-11
28,4,2,11,20,-9
28,4,3,14,28,-14
28,4,4,4,20,-16
28,4,5,6,19,-13
28,4,6,15,33,-18
28,4,7,10,14,-4
28,4,8,6,13,-7
28,4,9,12,18,-6
28,4,10,9,25,-16
28,4,11,5,18,-13
28,4,12,12,19,-7
28,4,13,18,23,-5
28,4,14,5,17,-12
28,4,15,8,15,-7
28,4,16,8,21,-13
28,4,17,5,18,-13
28,4,18,14,19,-5
28,4,19,3,13,-10
28,4,20,9,15,-6
28,4,21,13,21,-8
28,4,22,7,17,-10
28,4,23,12,21,-9
28,4,24,3,21,-18
28,4,25,6,7,-1
28,4,26,8,17,-9
28,4,27,5,5,0
28,4,28,12,24,-12
28,4,29,11,22,-11
28,4,30,7,25,-18
28,4,31,3,17,-14
28,4,32,10,21,-11
28,4,33,7,30,-23
28,4,34,9,19,-10
28,4,35,13,31,-18
28,4,36,6,22,-16
28,4,37,11,19,-8
28,4,38,14,13,1
28,4,39,6,19,-13
28,4,40,11,8,3
28,4,41,6,31,-25
28,4,42,8,25,-17
28,4,43,9,33,-24
28,4,44,5,12,-7
28,4,45,16,37,-21
28,4,46,10,21,-11
28,4,47,12,31,-19
28,4,48,8,26,-18
28,4,49,13,22,-9
28,4,50,7,23,-16
28,4,51,11,30,-19
28,4,52,7,22,-15
28,4,53,7,19,-12
28,4,54,8,16,-8
28,4,55,1,13,-12
28,4,56,7,8,-1
28,4,57,8,16,-8
28,4,58,8,14,-6
28,4,59,9,19,-10
28,4,60,0,5,-5
28,4,61,9,24,-15
28,4,62,5,12,-7
28,4,63,5,10,-5
28,4,64,7,25,-18
28,4,65,5,26,-21
28,4,66,9,22,-13
28,4,67,9,23,-14
28,4,68,9,21,-12
28,4,69,6,22,-16
28,4,70,19,24,-5
28,4,71,8,13,-5
28,4,72,7,13,-6
28,4,73,12,26,-14
28,4,74,22,27,-5
28,4,75,10,30,-20
28,4,76,6,16,-10
28,4,77,13,18,-5
28,4,78,10,24,-14
28,4,79,9,19,-10
28,4,80,10,29,-19
28,4,81,14,17,-3
28,4,82,4,16,-12
28,4,83,6,23,-17
28,4,84,10,6,4
28,4,85,11,12,-1
28,4,86,12,21,-9
28,4,87,3,22,-19
28,4,88,11,12,-1
28,4,89,9,22,-13
28,4,90,8,12,-4
28,4,91,10,25,-15
28,4,92,8,27,-19
28,4,93,4,19,-15
28,4,94,10,10,0
28,4,95,9,18,-9
28,4,96,5,14,-9
28,4,97,12,16,-4
28,4,98,10,24,-14
28,4,99,10,10,0
28,4,100,16,16,0
28,4,101,5,9,-4
28,4,102,9,28,-19
28,4,103,4,36,-32
28,4,104,9,17,-8
28,4,105,9,30,-21
28,4,106,7,32,-25
28,4,107,10,18,-8
28,4,108,6,20,-14
28,4,109,4,14,-10
28,4,110,13,31,-18
28,4,111,15,18,-3
28,4,112,7,14,-7
28,4,113,8,13,-5
28,4,114,17,18,-1
28,4,115,2,7,-5
28,4,116,7,6,1
28,4,117,12,29,-17
28,4,118,6,27,-21
28,4,119,13,23,-10
28,4,120,14,42,-28
28,4,121,11,18,-7
28,4,122,4,3,1
28,4,123,5,10,-5
28,4,124,5,20,-15
28,4,125,8,13,-5
28,4,126,15,20,-5
28,4,127,4,12,-8
28,4,128,7,19,-12
28,4,129,9,17,-8
28,4,130,4,8,-4
28,4,131,8,15,-7
28,4,132,3,31,-28
28,4,133,2,12,-10
28,4,134,7,11,-4
28,4,135,6,14,-8
28,4,136,6,22,-16
28,4,137,11,20,-9
28,4,138,4,11,-7
28,4,139,5,27,-22
28,4,140,6,17,-11
28,4,141,11,30,-19
28,4,142,11,41,-30
28,4,143,9,12,-3
28,4,144,14,24,-10
28,4,145,10,22,-12
28,4,146,5,9,-4
28,4,147,14,26,-12
28,4,148,12,25,-13
28,4,149,3,26,-23
28,4,150,8,26,-18
28,4,151,9,14,-5
28,4,152,22,23,-1
28,4,153,14,17,-3
28,4,154,10,20,-10
28,4,155,14,31,-17
28,4,156,3,15,-12
28,4,157,1,10,-9
28,4,158,14,18,-4
28,4,159,9,15,-6
28,4,160,12,24,-12
28,4,161,8,12,-4
28,4,162,5,27,-22
28,4,163,13,16,-3
28,4,164,11,26,-15
28,4,165,5,22,-17
28,4,166,17,18,-1
28,4,167,8,8,0
28,4,168,8,31,-23
28,4,169,16,26,-10
28,4,170,19,14,5
28,4,171,1,5,-4
28,4,172,7,17,-10
28,4,173,5,16,-11
28,4,174,15,16,-1
28,4,175,8,15,-7
28,4,176,10,33,-23
28,4,177,14,16,-2
28,4,178,14,19,-5
28,4,179,15,28,-13
28,4,180,13,46,-33
28,4,181,7,21,-14
28,4,182,7,22,-15
28,4,183,14,32,-18
28,4,184,12,23,-11
28,4,185,9,24,-15
28,4,186,12,21,-9
28,4,187,22,19,3
28,4,188,9,28,-19
28,4,189,9,23,-14
28,4,190,5,13,-8
28,4,191,13,23,-10
28,4,192,7,27,-20
28,4,193,6,14,-8
28,4,194,8,26,-18
28,4,195,0,6,-6
28,4,196,13,12,1
28,4,197,3,23,-20
28,4,198,3,25,-22
28,4,199,9,15,-6
28,4,200,1,18,-17
28,4,201,9,30,-21
28,4,202,1,19,-18
28,4,203,11,14,-3
28,4,204,4,9,-5
28,4,205,5,15,-10
28,4,206,4,22,-18
28,4,207,9,5,4
28,4,208,11,22,-11
28,4,209,4,16,-12
28,4,210,10,34,-24
28,4,211,10,23,-13
28,4,212,10,27,-17
28,4,213,5,30,-25
28,4,214,18,29,-11
28,4,215,8,23,-15
28,4,216,7,10,-3
28,4,217,6,30,-24
28,4,218,16,25,-9
28,4,219,8,20,-12
28,4,220,4,13,-9
28,4,221,13,27,-14
28,4,222,12,19,-7
28,4,223,7,25,-18
28,4,224,7,20,-13
28,4,225,1,15,-14
28,4,226,1,24,-23
28,4,227,4,14,-10
28,4,228,6,21,-15
28,4,229,8,14,-6
28,4,230,4,10,-6
28,4,231,15,16,-1
28,4,232,3,15,-12
28,4,233,4,16,-12
28,4,234,8,15,-7
28,4,235,10,17,-7
28,4,236,9,24,-15
28,4,237,13,7,6
28,4,238,10,16,-6
28,4,239,5,16,-11
28,4,240,15,18,-3
28,4,241,7,22,-15
28,4,242,6,25,-19
28,4,243,12,22,-10
28,4,244,5,23,-18
28,4,245,6,14,-8
28,4,246,8,12,-4
28,4,247,8,21,-13
28,4,248,15,21,-6
28,4,249,11,21,-10
28,4,250,8,18,-10
28,4,251,6,26,-20
28,4,252,6,26,-20
28,4,253,2,11,-9
28,4,254,6,11,-5
28,4,255,5,13,-8
28,4,256,9,25,-16
28,4,257,4,33,-29
28,4,258,13,23,-10
28,4,259,4,19,-15
28,4,260,10,10,0
28,4,261,5,28,-23
28,4,262,7,13,-6
28,4,263,8,11,-3
28,4,264,10,12,-2
28,4,265,18,26,-8
28,4,266,5,24,-19
28,4,267,11,20,-9
28,4,268,7,15,-8
28,4,269,8,9,-1
28,4,270,13,23,-10
28,4,271,3,7,-4
28,4,272,6,35,-29
28,4,273,5,18,-13
28,4,274,11,22,-11
28,4,275,9,19,-10
28,4,276,12,21,-9
28,4,277,4,24,-20
28,4,278,12,20,-8
28,4,279,9,23,-14
28,4,280,5,11,-6
28,4,281,9,28,-19
28,4,282,9,31,-22
28,4,283,2,19,-17
28,4,284,5,33,-28
28,4,285,11,24,-13
28,4,286,9,29,-20
28,4,287,2,19,-17
28,4,288,12,33,-21
28,4,289,12,14,-2
28,4,290,8,10,-2
28,4,291,10,17,-7
28,4,292,10,19,-9
28,4,293,14,9,5
28,4,294,10,28,-18
28,4,295,15,25,-10
28,4,296,8,17,-9
28,4,297,14,32,-18
28,4,298,5,5,0
28,4,299,9,18,-9
28,5,0,8,16,-8
28,5,1,7,15,-8
28,5,2,10,11,-1
28,5,3,19,18,1
28,5,4,12,18,-6
28,5,5,9,32,-23
28,5,6,2,10,-8
28,5,7,1,19,-18
28,5,8,11,38,-27
28,5,9,8,20,-12
28,5,10,10,14,-4
28,5,11,19,34,-15
28,5,12,7,8,-1
28,5,13,4,24,-20
28,5,14,4,20,-16
28,5,15,10,20,-10
28,5,16,3,13,-10
28,5,17,11,17,-6
28,5,18,5,19,-14
28,5,19,7,16,-9
28,5,20,9,46,-37
28,5,21,12,21,-9
28,5,22,8,22,-14
28,5,23,7,9,-2
28,5,24,1,22,-21
28,5,25,16,22,-6
28,5,26,8,25,-17
28,5,27,7,11,-4
28,5,28,13,29,-16
28,5,29,4,20,-16
28,5,30,9,12,-3
28,5,31,11,35,-24
28,5,32,4,12,-8
28,5,33,5,28,-23
28,5,34,9,30,-21
28,5,35,10,20,-10
28,5,36,11,22,-11
28,5,37,14,22,-8
28,5,38,12,24,-12
28,5,39,12,12,0
28,5,40,1,11,-10
28,5,41,13,16,-3
28,5,42,10,29,-19
28,5,43,11,13,-2
28,5,44,21,30,-9
28,5,45,10,19,-9
28,5,46,19,33,-14
28,5,47,7,54,-47
28,5,48,8,21,-13
28,5,49,2,13,-11
28,5,50,4,22,-18
28,5,51,6,25,-19
28,5,52,7,20,-13
28,5,53,11,19,-8
28,5,54,10,20,-10
28,5,55,11,19,-8
28,5,56,18,32,-14
28,5,57,6,10,-4
28,5,58,5,21,-16
28,5,59,2,14,-12
28,5,60,4,9,-5
28,5,61,7,21,-14
28,5,62,16,19,-3
28,5,63,7,11,-4
28,5,64,10,28,-18
28,5,65,1,16,-15
28,5,66,17,27,-10
28,5,67,7,16,-9
28,5,68,7,20,-13
28,5,69,3,8,-5
28,5,70,6,16,-10
28,5,71,10,25,-15
28,5,72,11,18,-7
28,5,73,16,17,-1
28,5,74,10,21,-11
28,5,75,10,31,-21
28,5,76,11,14,-3
28,5,77,7,36,-29
28,5,78,15,22,-7
28,5,79,9,18,-9
28,5,80,8,15,-7
28,5,81,8,26,-18
28,5,82,11,31,-20
28,5,83,9,22,-13
28,5,84,9,19,-10
28,5,85,3,8,-5
28,5,86,5,17,-12
28,5,87,6,24,-18
28,5,88,11,19,-8
28,5,89,8,21,-13
28,5,90,4,18,-14
28,5,91,6,9,-3
28,5,92,3,20,-17
28,5,93,4,15,-11
28,5,94,8,7,1
28,5,95,9,29,-20
28,5,96,7,18,-11
28,5,97,7,23,-16
28,5,98,8,13,-5
28,5,99,8,23,-15
28,5,100,17,14,3
28,5,101,10,22,-12
28,5,102,5,23,-18
28,5,103,16,22,-6
28,5,104,10,21,-11
28,5,105,9,40,-31
28,5,106,8,19,-11
28,5,107,11,30,-19
28,5,108,7,18,-11
28,5,109,15,37,-22
28,5,110,11,22,-11
28,5,111,10,24,-14
28,5,112,6,31,-25
28,5,113,1,17,-16
28,5,114,12,24,-12
28,5,115,9,22,-13
28,5,116,11,19,-8
28,5,117,6,20,-14
28,5,118,12,11,1
28,5,119,4,22,-18
28,5,120,0,24,-24
28,5,121,10,24,-14
28,5,122,6,20,-14
28,5,123,9,11,-2
28,5,124,6,15,-9
28,5,125,11,15,-4
28,5,126,13,45,-32
28,5,127,7,14,-7
28,5,128,6,17,-11
28,5,129,15,20,-5
28,5,130,5,9,-4
28,5,131,9,23,-14
28,5,132,5,23,-18
28,5,133,8,17,-9
28,5,134,15,23,-8
28,5,135,11,26,-15
28,5,136,8,19,-11
28,5,137,5,19,-14
28,5,138,6,21,-15
28,5,139,4,25,-21
28,5,140,18,32,-14
28,5,141,9,14,-5
28,5,142,2,15,-13
28,5,143,13,28,-15
28,5,144,7,18,-11
28,5,145,7,32,-25
28,5,146,4,17,-13
28,5,147,12,15,-3
28,5,148,15,16,-1
28,5,149,16,27,-11
28,5,150,9,25,-16
28,5,151,1,19,-18
28,5,152,6,12,-6
28,5,153,17,32,-15
28,5,154,12,21,-9
28,5,155,11,14,-3
28,5,156,3,11,-8
28,5,157,5,20,-15
28,5,158,9,18,-9
28,5,159,8,22,-14
28,5,160,14,18,-4
28,5,161,11,28,-17
28,5,162,5,15,-10
28,5,163,6,8,-2
28,5,164,9,24,-15
28,5,165,13,19,-6
28,5,166,4,20,-16
28,5,167,18,28,-10
28,5,168,19,23,-4
28,5,169,7,29,-22
28,5,170,9,23,-14
28,5,171,9,31,-22
28,5,172,8,23,-15
28,5,173,11,27,-16
28,5,174,6,22,-16
28,5,175,2,11,-9
28,5,176,17,28,-11
28,5,177,15,25,-10
28,5,178,8,15,-7
28,5,179,7,18,-11
28,5,180,6,22,-16
28,5,181,6,31,-25
28,5,182,6,7,-1
28,5,183,17,27,-10
28,5,184,11,35,-24
28,5,185,5,15,-10
28,5,186,4,26,-22
28,5,187,14,17,-3
28,5,188,10,19,-9
28,5,189,5,18,-13
28,5,190,4,10,-6
28,5,191,9,22,-13
28,5,192,12,19,-7
28,5,193,9,11,-2
28,5,194,11,19,-8
28,5,195,15,28,-13
28,5,196,6,18,-12
28,5,197,14,28,-14
28,5,198,15,22,-7
28,5,199,14,22,-8
28,5,200,1,17,-16
28,5,201,2,12,-10
28,5,202,4,17,-13
28,5,203,6,18,-12
28,5,204,16,28,-12
28,5,205,9,28,-19
28,5,206,16,25,-9
28,5,207,12,11,1
28,5,208,13,15,-2
28,5,209,5,22,-17
28,5,210,6,32,-26
28,5,211,16,24,-8
28,5,212,8,30,-22
28,5,213,3,20,-17
28,5,214,7,14,-7
28,5,215,6,27,-21
28,5,216,6,39,-33
28,5,217,10,22,-12
28,5,218,10,18,-8
28,5,219,8,17,-9
28,5,220,12,18,-6
28,5,221,5,9,-4
28,5,222,15,16,-1
28,5,223,8,17,-9
28,5,224,5,12,-7
28,5,225,8,24,-16
28,5,226,5,36,-31
28,5,227,5,20,-15
28,5,228,13,14,-1
28,5,229,5,18,-13
28,5,230,6,16,-10
28,5,231,7,11,-4
28,5,232,5,20,-15
28,5,233,13,20,-7
28,5,234,2,16,-14
28,5,235,13,33,-20
28,5,236,14,18,-4
28,5,237,11,27,-16
28,5,238,6,16,-10
28,5,239,4,28,-24
28,5,240,11,21,-10
28,5,241,4,18,-14
28,5,242,10,26,-16
28,5,243,7,32,-25
28,5,244,15,27,-12
28,5,245,5,23,-18
28,5,246,7,20,-13
28,5,247,23,13,10
28,5,248,9,33,-24
28,5,249,17,25,-8
28,5,250,3,13,-10
28,5,251,10,15,-5
28,5,252,3,22,-19
28,5,253,6,19,-13
28,5,254,14,20,-6
28,5,255,12,19,-7
28,5,256,9,32,-23
28,5,257,17,22,-5
28,5,258,12,24,-12
28,5,259,6,24,-18
28,5,260,10,25,-15
28,5,261,8,22,-14
28,5,262,5,33,-28
28,5,263,6,15,-9
28,5,264,5,29,-24
28,5,265,10,19,-9
28,5,266,4,26,-22
28,5,267,16,27,-11
28,5,268,6,17,-11
28,5,269,4,17,-13
28,5,270,12,32,-20
28,5,271,5,20,-15
28,5,272,14,13,1
28,5,273,3,21,-18
28,5,274,3,18,-15
28,5,275,8,9,-1
28,5,276,5,13,-8
28,5,277,8,20,-12
28,5,278,11,22,-11
28,5,279,13,30,-17
28,5,280,9,24,-15
28,5,281,6,31,-25
28,5,282,4,19,-15
28,5,283,8,17,-9
28,5,284,10,13,-3
28,5,285,3,14,-11
28,5,286,4,17,-13
28,5,287,10,21,-11
28,5,288,15,20,-5
28,5,289,16,23,-7
28,5,290,2,13,-11
28,5,291,9,22,-13
28,5,292,9,19,-10
28,5,293,7,34,-27
28,5,294,7,32,-25
28,5,295,4,22,-18
28,5,296,10,24,-14
28,5,297,5,17,-12
28,5,298,11,22,-11
28,5,299,3,15,-12
28,6,0,14,33,-19
28,6,1,2,13,-11
28,6,2,9,24,-15
28,6,3,22,34,-12
28,6,4,6,25,-19
28,6,5,6,16,-10
28,6,6,10,17,-7
28,6,7,13,32,-19
28,6,8,17,15,2
28,6,9,7,19,-12
28,6,10,7,24,-17
28,6,11,12,20,-8
28,6,12,10,20,-10
28,6,13,20,21,-1
28,6,14,14,25,-11
28,6,15,5,24,-19
28,6,16,6,17,-11
28,6,17,12,23,-11
28,6,18,13,10,3
28,6,19,5,16,-11
28,6,20,14,24,-10
28,6,21,10,20,-10
28,6,22,4,7,-3
28,6,23,7,7,0
28,6,24,8,25,-17
28,6,25,12,12,0
28,6,26,16,22,-6
28,6,27,6,13,-7
28,6,28,4,11,-7
28,6,29,16,26,-10
28,6,30,4,19,-15
28,6,31,12,29,-17
28,6,32,15,20,-5
28,6,33,8,19,-11
28,6,34,5,25,-20
28,6,35,4,16,-12
28,6,36,7,24,-17
28,6,37,2,10,-8
28,6,38,15,24,-9
28,6,39,13,25,-12
28,6,40,5,22,-17
28,6,41,11,22,-11
28,6,42,13,38,-25
28,6,43,6,13,-7
28,6,44,15,8,7
28,6,45,14,25,-11
28,6,46,4,16,-12
28,6,47,5,30,-25
28,6,48,8,13,-5
28,6,49,9,20,-11
28,6,50,1,14,-13
28,6,51,14,25,-11
28,6,52,26,31,-5
28,6,53,16,16,0
28,6,54,5,16,-11
28,6,55,6,16,-10
28,6,56,11,12,-1
28,6,57,7,21,-14
28,6,58,10,10,0
28,6,59,3,18,-15
28,6,60,7,21,-14
28,6,61,3,18,-15
28,6,62,11,38,-27
28,6,63,5,21,-16
28,6,64,14,6,8
28,6,65,5,7,-2
28,6,66,11,14,-3
28,6,67,13,35,-22
28,6,68,9,10,-1
28,6,69,5,12,-7
28,6,70,9,14,-5
28,6,71,6,13,-7
28,6,72,8,10,-2
28,6,73,6,14,-8
28,6,74,18,25,-7
28,6,75,11,11,0
28,6,76,17,18,-1
28,6,77,6,22,-16
28,6,78,8,25,-17
28,6,79,13,10,3
28,6,80,10,12,-2
28,6,81,5,16,-11
28,6,82,9,19,-10
28,6,83,10,26,-16
28,6,84,11,15,-4
28,6,85,5,6,-1
28,6,86,9,30,-21
28,6,87,2,36,-34
28,6,88,8,31,-23
28,6,89,7,26,-19
28,6,90,19,16,3
28,6,91,6,22,-16
28,6,92,6,19,-13
28,6,93,7,22,-15
28,6,94,11,36,-25
28,6,95,12,32,-20
28,6,96,3,9,-6
28,6,97,3,15,-12
28,6,98,6,23,-17
28,6,99,5,29,-24
28,6,100,18,34,-16
28,6,101,9,21,-12
28,6,102,16,10,6
28,6,103,7,13,-6
28,6,104,13,24,-11
28,6,105,11,19,-8
28,6,106,13,39,-26
28,6,107,7,7,0
28,6,108,9,18,-9
28,6,109,5,12,-7
28,6,110,15,28,-13
28,6,111,6,23,-17
28,6,112,20,32,-12
28,6,113,12,10,2
28,6,114,19,32,-13
28,6,115,8,12,-4
28,6,116,5,19,-14
28,6,117,5,18,-13
28,6,118,9,32,-23
28,6,119,10,15,-5
28,6,120,9,31,-22
28,6,121,3,28,-25
28,6,122,9,28,-19
28,6,123,9,14,-5
28,6,124,12,25,-13
28,6,125,5,16,-11
28,6,126,8,31,-23
28,6,127,4,9,-5
28,6,128,7,16,-9
28,6,129,6,35,-29
28,6,130,11,17,-6
28,6,131,4,13,-9
28,6,132,9,10,-1
28,6,133,13,21,-8
28,6,134,2,13,-11
28,6,135,16,18,-2
28,6,136,12,34,-22
28,6,137,11,18,-7
28,6,138,9,28,-19
28,6,139,11,20,-9
28,6,140,7,17,-10
28,6,141,4,15,-11
28,6,142,13,15,-2
28,6,143,2,35,-33
28,6,144,9,14,-5
28,6,145,26,24,2
28,6,146,1,11,-10
28,6,147,19,19,0
28,6,148,10,20,-10
28,6,149,7,30,-23
28,6,150,11,22,-11
28,6,151,10,22,-12
28,6,152,13,25,-12
28,6,153,11,16,-5
28,6,154,6,32,-26
28,6,155,11,21,-10
28,6,156,5,14,-9
28,6,157,7,31,-24
28,6,158,11,27,-16
28,6,159,7,23,-16
28,6,160,14,37,-23
28,6,161,10,25,-15
28,6,162,9,24,-15
28,6,163,6,25,-19
28,6,164,13,17,-4
28,6,165,10,24,-14
28,6,166,12,32,-20
28,6,167,16,43,-27
28,6,168,18,33,-15
28,6,169,11,26,-15
28,6,170,11,25,-14
28,6,171,5,36,-31
28,6,172,3,20,-17
28,6,173,6,22,-16
28,6,174,11,27,-16
28,6,175,6,11,-5
28,6,176,4,13,-9
28,6,177,6,17,-11
28,6,178,7,17,-10
28,6,179,12,32,-20
28,6,180,4,16,-12
28,6,181,10,8,2
28,6,182,11,31,-20
28,6,183,14,19,-5
28,6,184,6,23,-17
28,6,185,6,8,-2
28,6,186,11,14,-3
28,6,187,4,16,-12
28,6,188,15,19,-4
28,6,189,10,35,-25
28,6,190,10,23,-13
28,6,191,6,23,-17
28,6,192,3,19,-16
28,6,193,19,29,-10
28,6,194,12,20,-8
28,6,195,13,21,-8
28,6,196,17,27,-10
28,6,197,16,35,-19
28,6,198,4,15,-11
28,6,199,6,11,-5
28,6,200,10,17,-7
28,6,201,5,20,-15
28,6,202,11,11,0
28,6,203,17,21,-4
28,6,204,5,18,-13
28,6,205,7,26,-19
28,6,206,16,22,-6
28,6,207,10,17,-7
28,6,208,15,16,-1
28,6,209,11,20,-9
28,6,210,12,22,-10
28,6,211,7,11,-4
28,6,212,14,31,-17
28,6,213,2,14,-12
28,6,214,15,25,-10
28,6,215,5,20,-15
28,6,216,11,25,-14
28,6,217,11,27,-16
28,6,218,13,23,-10
28,6,219,13,25,-12
28,6,220,8,13,-5
28,6,221,6,20,-14
28,6,222,10,20,-10
28,6,223,3,24,-21
28,6,224,17,14,3
28,6,225,16,21,-5
28,6,226,15,9,6
28,6,227,6,30,-24
28,6,228,7,25,-18
28,6,229,12,8,4
28,6,230,4,28,-24
28,6,231,2,12,-10
28,6,232,23,45,-22
28,6,233,4,15,-11
28,6,234,11,32,-21
28,6,235,7,37,-30
28,6,236,15,19,-4
28,6,237,4,18,-14
28,6,238,15,25,-10
28,6,239,3,12,-9
28,6,240,10,24,-14
28,6,241,7,29,-22
28,6,242,2,29,-27
28,6,243,6,25,-19
28,6,244,2,9,-7
28,6,245,8,24,-16
28,6,246,4,14,-10
28,6,247,16,29,-13
28,6,248,13,43,-30
28,6,249,7,23,-16
28,6,250,7,16,-9
28,6,251,4,21,-17
28,6,252,6,23,-17
28,6,253,2,5,-3
28,6,254,7,15,-8
28,6,255,18,16,2
28,6,256,10,9,1
28,6,257,9,31,-22
28,6,258,15,24,-9
28,6,259,2,12,-10
28,6,260,16,15,1
28,6,261,10,15,-5
28,6,262,13,26,-13
28,6,263,9,28,-19
28,6,264,10,30,-20
28,6,265,7,21,-14
28,6,266,4,23,-19
28,6,267,8,22,-14
28,6,268,8,26,-18
28,6,269,9,25,-16
28,6,270,13,46,-33
28,6,271,5,7,-2
28,6,272,3,16,-13
28,6,273,15,13,2
28,6,274,11,23,-12
28,6,275,11,15,-4
28,6,276,9,33,-24
28,6,277,9,17,-8
28,6,278,13,25,-12
28,6,279,3,16,-13
28,6,280,4,17,-13
28,6,281,9,32,-23
28,6,282,13,29,-16
28,6,283,24,33,-9
28,6,284,12,11,1
28,6,285,9,13,-4
28,6,286,2,17,-15
28,6,287,14,23,-9
28,6,288,6,13,-7
28,6,289,11,22,-11
28,6,290,8,19,-11
28,6,291,10,18,-8
28,6,292,14,26,-12
28,6,293,4,17,-13
28,6,294,12,25,-13
28,6,295,4,17,-13
28,6,296,6,35,-29
28,6,297,4,24,-20
28,6,298,12,27,-15
28,6,299,1,19,-18
28,7,0,11,23,-12
28,7,1,16,37,-21
28,7,2,11,20,-9
28,7,3,6,30,-24
28,7,4,8,31,-23
28,7,5,16,25,-9
28,7,6,14,38,-24
28,7,7,8,22,-14
28,7,8,13,23,-10
28,7,9,15,22,-7
28,7,10,17,23,-6
28,7,11,15,19,-4
28,7,12,5,19,-14
28,7,13,5,18,-13
28,7,14,6,27,-21
28,7,15,12,34,-22
28,7,16,14,30,-16
28,7,17,6,28,-22
28,7,18,8,24,-16
28,7,19,15,33,-18
28,7,20,7,15,-8
28,7,21,5,30,-25
28,7,22,14,35,-21
28,7,23,9,33,-24
28,7,24,6,19,-13
28,7,25,5,23,-18
28,7,26,7,22,-15
28,7,27,8,10,-2
28,7,28,5,36,-31
28,7,29,8,11,-3
28,7,30,9,31,-22
28,7,31,11,15,-4
28,7,32,10,28,-18
28,7,33,8,19,-11
28,7,34,6,17,-11
28,7,35,9,22,-13
28,7,36,6,26,-20
28,7,37,8,18,-10
28,7,38,6,19,-13
28,7,39,5,13,-8
28,7,40,11,11,0
28,7,41,11,12,-1
28,7,42,16,24,-8
28,7,43,14,25,-11
28,7,44,6,9,-3
28,7,45,9,21,-12
28,7,46,12,17,-5
28,7,47,20,23,-3
28,7,48,10,21,-11
28,7,49,4,21,-17
28,7,50,6,9,-3
28,7,51,16,34,-18
28,7,52,8,15,-7
28,7,53,11,18,-7
28,7,54,2,16,-14
28,7,55,7,24,-17
28,7,56,15,23,-8
28,7,57,6,19,-13
28,7,58,4,18,-14
28,7,59,1,17,-16
28,7,60,9,16,-7
28,7,61,10,24,-14
28,7,62,10,31,-21
28,7,63,5,19,-14
28,7,64,12,35,-23
28,7,65,10,20,-10
28,7,66,6,25,-19
28,7,67,3,27,-24
28,7,68,3,14,-11
28,7,69,10,13,-3
28,7,70,11,25,-14
28,7,71,5,23,-18
28,7,72,11,24,-13
28,7,73,12,16,-4
28,7,74,6,23,-17
28,7,75,11,29,-18
28,7,76,8,15,-7
28,7,77,14,19,-5
28,7,78,9,12,-3
28,7,79,10,19,-9
28,7,80,10,16,-6
28,7,81,4,13,-9
28,7,82,16,17,-1
28,7,83,13,25,-12
28,7,84,11,16,-5
28,7,85,15,22,-7
28,7,86,16,29,-13
28,7,87,6,35,-29
28,7,88,2,10,-8
28,7,89,5,24,-19
28,7,90,7,29,-22
28,7,91,8,15,-7
28,7,92,7,21,-14
28,7,93,10,9,1
28,7,94,10,21,-11
28,7,95,7,16,-9
28,7,96,8,9,-1
28,7,97,8,19,-11
28,7,98,7,10,-3
28,7,99,6,17,-11
28,7,100,5,24,-19
28,7,101,9,34,-25
28,7,102,7,10,-3
28,7,103,22,27,-5
28,7,104,6,10,-4
28,7,105,19,16,3
28,7,106,6,25,-19
28,7,107,6,33,-27
28,7,108,6,31,-25
28,7,109,7,13,-6
28,7,110,16,32,-16
28,7,111,10,21,-11
28,7,112,12,30,-18
28,7,113,3,22,-19
28,7,114,15,19,-4
28,7,115,3,13,-10
28,7,116,8,17,-9
28,7,117,8,25,-17
28,7,118,13,13,0
28,7,119,5,5,0
28,7,120,5,22,-17
28,7,121,8,21,-13
28,7,122,5,21,-16
28,7,123,24,23,1
28,7,124,12,21,-9
28,7,125,9,16,-7
28,7,126,14,22,-8
28,7,127,12,24,-12
28,7,128,4,18,-14
28,7,129,2,5,-3
28,7,130,9,14,-5
28,7,131,8,17,-9
28,7,132,14,31,-17
28,7,133,8,12,-4
28,7,134,11,34,-23
28,7,135,9,27,-18
28,7,136,6,13,-7
28,7,137,5,6,-1
28,7,138,9,18,-9
28,7,139,14,16,-2
28,7,140,16,6,10
28,7,141,9,13,-4
28,7,142,14,15,-1
28,7,143,9,26,-17
28,7,144,2,10,-8
28,7,145,6,21,-15
28,7,146,6,15,-9
28,7,147,10,19,-9
28,7,148,2,24,-22
28,7,149,5,18,-13
28,7,150,15,14,1
28,7,151,4,25,-21
28,7,152,11,19,-8
28,7,153,18,23,-5
28,7,154,5,11,-6
28,7,155,5,15,-10
28,7,156,7,16,-9
28,7,157,10,26,-16
28,7,158,3,24,-21
28,7,159,11,16,-5
28,7,160,8,28,-20
28,7,161,5,6,-1
28,7,162,7,11,-4
28,7,163,9,19,-10
28,7,164,4,27,-23
28,7,165,10,19,-9
28,7,166,7,30,-23
28,7,167,13,28,-15
28,7,168,8,33,-25
28,7,169,5,25,-20
28,7,170,3,12,-9
28,7,171,14,33,-19
28,7,172,8,34,-26
28,7,173,20,29,-9
28,7,174,7,29,-22
28,7,175,3,18,-15
28,7,176,11,27,-16
28,7,177,7,17,-10
28,7,178,15,30,-15
28,7,179,1,16,-15
28,7,180,5,12,-7
28,7,181,6,18,-12
28,7,182,9,13,-4
28,7,183,7,16,-9
28,7,184,9,29,-20
28,7,185,7,21,-14
28,7,186,7,17,-10
28,7,187,9,20,-11
28,7,188,10,7,3
28,7,189,21,37,-16
28,7,190,4,8,-4
28,7,191,7,23,-16
28,7,192,9,23,-14
28,7,193,8,18,-10
28,7,194,13,22,-9
28,7,195,10,33,-23
28,7,196,6,23,-17
28,7,197,16,25,-9
28,7,198,8,12,-4
28,7,199,7,15,-8
28,7,200,12,22,-10
28,7,201,11,16,-5
28,7,202,13,12,1
28,7,203,4,22,-18
28,7,204,6,16,-10
28,7,205,3,22,-19
28,7,206,5,11,-6
28,7,207,13,11,2
28,7,208,9,28,-19
28,7,209,11,20,-9
28,7,210,8,16,-8
28,7,211,10,9,1
28,7,212,19,18,1
28,7,213,3,14,-11
28,7,214,14,30,-16
28,7,215,3,12,-9
28,7,216,4,13,-9
28,7,217,10,12,-2
28,7,218,11,21,-10
28,7,219,6,26,-20
28,7,220,11,15,-4
28,7,221,9,25,-16
28,7,222,14,14,0
28,7,223,11,21,-10
28,7,224,5,23,-18
28,7,225,14,36,-22
28,7,226,17,32,-15
28,7,227,13,20,-7
28,7,228,3,3,0
28,7,229,15,14,1
28,7,230,26,26,0
28,7,231,16,18,-2
28,7,232,4,37,-33
28,7,233,5,25,-20
28,7,234,17,20,-3
28,7,235,9,31,-22
28,7,236,7,21,-14
28,7,237,13,19,-6
28,7,238,13,40,-27
28,7,239,12,28,-16
28,7,240,11,25,-14
28,7,241,7,34,-27
28,7,242,28,35,-7
28,7,243,7,26,-19
28,7,244,15,26,-11
28,7,245,6,24,-18
28,7,246,8,21,-13
28,7,247,21,24,-3
28,7,248,5,7,-2
28,7,249,13,33,-20
28,7,250,3,15,-12
28,7,251,9,29,-20
28,7,252,12,24,-12
28,7,253,4,8,-4
28,7,254,16,23,-7
28,7,255,13,43,-30
28,7,256,17,33,-16
28,7,257,9,29,-20
28,7,258,8,10,-2
28,7,259,7,16,-9
28,7,260,7,12,-5
28,7,261,14,25,-11
28,7,262,2,23,-21
28,7,263,5,14,-9
28,7,264,8,20,-12
28,7,265,2,25,-23
28,7,266,13,16,-3
28,7,267,17,23,-6
28,7,268,5,13,-8
28,7,269,7,22,-15
28,7,270,18,41,-23
28,7,271,8,11,-3
28,7,272,6,13,-7
28,7,273,8,15,-7
28,7,274,13,21,-8
28,7,275,8,20,-12
28,7,276,9,16,-7
28,7,277,6,10,-4
28,7,278,11,31,-20
28,7,279,9,24,-15
28,7,280,3,21,-18
28,7,281,14,22,-8
28,7,282,5,23,-18
28,7,283,10,26,-16
28,7,284,6,28,-22
28,7,285,11,15,-4
28,7,286,10,35,-25
28,7,287,4,29,-25
28,7,288,11,27,-16
28,7,289,11,29,-18
28,7,290,13,28,-15
28,7,291,12,27,-15
28,7,292,4,20,-16
28,7,293,0,10,-10
28,7,294,5,15,-10
28,7,295,7,20,-13
28,7,296,4,21,-17
28,7,297,11,22,-11
28,7,298,7,12,-5
28,7,299,4,9,-5
28,8,0,7,21,-14
28,8,1,11,15,-4
28,8,2,2,9,-7
28,8,3,8,18,-10
28,8,4,11,26,-15
28,8,5,9,23,-14
28,8,6,11,22,-11
28,8,7,10,20,-10
28,8,8,25,35,-10
28,8,9,2,16,-14
28,8,10,6,17,-11
28,8,11,2,14,-12
28,8,12,15,27,-12
28,8,13,3,14,-11
28,8,14,9,23,-14
28,8,15,18,30,-12
28,8,16,15,31,-16
28,8,17,6,25,-19
28,8,18,9,25,-16
28,8,19,4,20,-16
28,8,20,13,17,-4
28,8,21,3,10,-7
28,8,22,10,22,-12
28,8,23,7,24,-17
28,8,24,8,21,-13
28,8,25,10,16,-6
28,8,26,6,22,-16
28,8,27,11,28,-17
28,8,28,11,13,-2
28,8,29,11,17,-6
28,8,30,8,16,-8
28,8,31,8,28,-20
28,8,32,3,28,-25
28,8,33,8,12,-4
28,8,34,7,21,-14
28,8,35,14,20,-6
28,8,36,6,41,-35
28,8,37,18,22,-4
28,8,38,12,20,-8
28,8,39,9,10,-1
28,8,40,12,36,-24
28,8,41,16,16,0
28,8,42,4,28,-24
28,8,43,16,16,0
28,8,44,8,7,1
28,8,45,12,22,-10
28,8,46,12,22,-10
28,8,47,2,6,-4
28,8,48,3,15,-12
28,8,49,4,10,-6
28,8,50,11,18,-7
28,8,51,1,10,-9
28,8,52,12,25,-13
28,8,53,4,12,-8
28,8,54,10,26,-16
28,8,55,2,16,-14
28,8,56,13,32,-19
28,8,57,4,20,-16
28,8,58,7,31,-24
28,8,59,7,28,-21
28,8,60,18,22,-4
28,8,61,4,16,-12
28,8,62,15,29,-14
28,8,63,7,22,-15
28,8,64,6,18,-12
28,8,65,9,17,-8
28,8,66,7,21,-14
28,8,67,12,19,-7
28,8,68,13,32,-19
28,8,69,15,29,-14
28,8,70,8,19,-11
28,8,71,9,20,-11
28,8,72,9,21,-12
28,8,73,11,25,-14
28,8,74,5,13,-8
28,8,75,8,25,-17
28,8,76,11,21,-10
28,8,77,6,14,-8
28,8,78,5,16,-11
28,8,79,6,12,-6
28,8,80,10,23,-13
28,8,81,13,19,-6
28,8,82,11,28,-17
28,8,83,8,15,-7
28,8,84,8,32,-24
28,8,85,5,16,-11
28,8,86,10,25,-15
28,8,87,12,24,-12
28,8,88,5,14,-9
28,8,89,5,20,-15
28,8,90,6,27,-21
28,8,91,6,22,-16
28,8,92,8,12,-4
28,8,93,11,17,-6
28,8,94,18,23,-5
28,8,95,7,14,-7
28,8,96,7,19,-12
28,8,97,12,22,-10
28,8,98,5,21,-16
28,8,99,9,13,-4
28,8,100,5,19,-14
28,8,101,8,18,-10
28,8,102,15,26,-11
28,8,103,10,17,-7
28,8,104,9,23,-14
28,8,105,5,31,-26
28,8,106,6,28,-22
28,8,107,28,29,-1
28,8,108,4,25,-21
28,8,109,21,37,-16
28,8,110,2,23,-21
28,8,111,13,15,-2
28,8,112,11,16,-5
28,8,113,12,22,-10
28,8,114,15,31,-16
28,8,115,7,16,-9
28,8,116,8,17,-9
28,8,117,5,21,-16
28,8,118,4,4,0
28,8,119,13,28,-15
28,8,120,9,22,-13
28,8,121,14,28,-14
28,8,122,6,11,-5
28,8,123,7,18,-11
28,8,124,9,37,-28
28,8,125,5,14,-9
28,8,126,14,26,-12
28,8,127,8,9,-1
28,8,128,8,14,-6
28,8,129,9,14,-5
28,8,130,2,29,-27
28,8,131,17,19,-2
28,8,132,15,25,-10
28,8,133,12,20,-8
28,8,134,12,17,-5
28,8,135,9,7,2
28,8,136,10,29,-19
28,8,137,6,23,-17
28,8,138,5,13,-8
28,8,139,8,13,-5
28,8,140,11,33,-22
28,8,141,6,14,-8
28,8,142,10,21,-11
28,8,143,6,30,-24
28,8,144,6,17,-11
28,8,145,11,17,-6
28,8,146,7,9,-2
28,8,147,10,34,-24
28,8,148,1,30,-29
28,8,149,7,26,-19
28,8,150,14,33,-19
28,8,151,17,18,-1
28,8,152,4,17,-13
28,8,153,11,11,0
28,8,154,12,19,-7
28,8,155,4,23,-19
28,8,156,8,38,-30
28,8,157,7,23,-16
28,8,158,2,19,-17
28,8,159,2,14,-12
28,8,160,7,20,-13
28,8,161,7,21,-14
28,8,162,11,33,-22
28,8,163,10,16,-6
28,8,164,16,26,-10
28,8,165,7,21,-14
28,8,166,9,18,-9
28,8,167,16,49,-33
28,8,168,11,21,-10
28,8,169,8,19,-11
28,8,170,10,14,-4
28,8,171,11,25,-14
28,8,172,19,23,-4
28,8,173,10,26,-16
28,8,174,7,29,-22
28,8,175,9,15,-6
28,8,176,13,13,0
28,8,177,7,14,-7
28,8,178,9,21,-12
28,8,179,4,23,-19
28,8,180,13,30,-17
28,8,181,9,12,-3
28,8,182,6,27,-21
28,8,183,23,15,8
28,8,184,7,25,-18
28,8,185,9,18,-9
28,8,186,9,27,-18
28,8,187,16,21,-5
28,8,188,6,12,-6
28,8,189,5,18,-13
28,8,190,9,28,-19
28,8,191,6,15,-9
28,8,192,10,18,-8
28,8,193,7,20,-13
28,8,194,10,30,-20
28,8,195,3,14,-11
28,8,196,7,27,-20
28,8,197,3,7,-4
28,8,198,0,7,-7
28,8,199,13,42,-29
28,8,200,5,19,-14
28,8,201,10,15,-5
28,8,202,13,18,-5
28,8,203,15,12,3
28,8,204,13,24,-11
28,8,205,8,15,-7
28,8,206,14,17,-3
28,8,207,10,14,-4
28,8,208,13,32,-19
28,8,209,5,14,-9
28,8,210,14,16,-2
28,8,211,19,14,5
28,8,212,12,21,-9
28,8,213,11,32,-21
28,8,214,11,12,-1
28,8,215,18,27,-9
28,8,216,11,25,-14
28,8,217,7,24,-17
28,8,218,11,19,-8
28,8,219,7,12,-5
28,8,220,6,15,-9
28,8,221,9,23,-14
28,8,222,9,31,-22
28,8,223,9,21,-12
28,8,224,1,14,-13
28,8,225,19,17,2
28,8,226,10,29,-19
28,8,227,11,25,-14
28,8,228,13,26,-13
28,8,229,9,13,-4
28,8,230,14,43,-29
28,8,231,22,39,-17
28,8,232,7,32,-25
28,8,233,18,26,-8
28,8,234,9,28,-19
28,8,235,14,23,-9
28,8,236,4,5,-1
28,8,237,10,20,-10
28,8,238,8,13,-5
28,8,239,10,18,-8
28,8,240,11,27,-16
28,8,241,9,22,-13
28,8,242,5,11,-6
28,8,243,8,19,-11
28,8,244,2,18,-16
28,8,245,10,18,-8
28,8,246,9,16,-7
28,8,247,17,25,-8
28,8,248,18,16,2
28,8,249,14,25,-11
28,8,250,12,20,-8
28,8,251,12,26,-14
28,8,252,13,24,-11
28,8,253,12,20,-8
28,8,254,4,5,-1
28,8,255,7,20,-13
28,8,256,12,8,4
28,8,257,8,26,-18
28,8,258,14,16,-2
28,8,259,1,17,-16
28,8,260,9,21,-12
28,8,261,7,38,-31
28,8,262,8,18,-10
28,8,263,4,18,-14
28,8,264,17,25,-8
28,8,265,6,19,-13
28,8,266,6,21,-15
28,8,267,12,15,-3
28,8,268,9,12,-3
28,8,269,7,28,-21
28,8,270,7,22,-15
28,8,271,6,26,-20
28,8,272,8,16,-8
28,8,273,11,29,-18
28,8,274,15,21,-6
28,8,275,12,16,-4
28,8,276,2,14,-12
28,8,277,9,24,-15
28,8,278,5,9,-4
28,8,279,15,25,-10
28,8,280,13,12,1
28,8,281,17,44,-27
28,8,282,6,15,-9
28,8,283,16,12,4
28,8,284,18,35,-17
28,8,285,9,23,-14
28,8,286,4,9,-5
28,8,287,9,30,-21
28,8,288,4,31,-27
28,8,289,14,25,-11
28,8,290,15,23,-8
28,8,291,14,24,-10
28,8,292,15,31,-16
28,8,293,5,19,-14
28,8,294,12,16,-4
28,8,295,10,29,-19
28,8,296,4,20,-16
28,8,297,14,13,1
28,8,298,11,28,-17
28,8,299,9,37,-28
28,9,0,12,32,-20
28,9,1,12,15,-3
28,9,2,15,25,-10
28,9,3,11,21,-10
28,9,4,14,20,-6
28,9,5,7,10,-3
28,9,6,1,32,-31
28,9,7,11,21,-10
28,9,8,21,27,-6
28,9,9,13,33,-20
28,9,10,4,24,-20
28,9,11,5,19,-14
28,9,12,8,9,-1
28,9,13,5,23,-18
28,9,14,12,27,-15
28,9,15,12,14,-2
28,9,16,9,26,-17
28,9,17,7,21,-14
28,9,18,5,25,-20
28,9,19,10,18,-8
28,9,20,5,14,-9
28,9,21,7,27,-20
28,9,22,13,16,-3
28,9,23,12,14,-2
28,9,24,3,23,-20
28,9,25,12,21,-9
28,9,26,7,22,-15
28,9,27,9,26,-17
28,9,28,11,35,-24
28,9,29,8,18,-10
28,9,30,14,15,-1
28,9,31,12,19,-7
28,9,32,9,32,-23
28,9,33,2,19,-17
28,9,34,9,21,-12
28,9,35,2,26,-24
28,9,36,9,20,-11
28,9,37,12,22,-10
28,9,38,5,34,-29
28,9,39,5,20,-15
28,9,40,6,19,-13
28,9,41,8,16,-8
28,9,42,14,18,-4
28,9,43,6,10,-4
28,9,44,10,17,-7
28,9,45,5,23,-18
28,9,46,15,23,-8
28,9,47,18,24,-6
28,9,48,9,25,-16
28,9,49,13,16,-3
28,9,50,13,18,-5
28,9,51,9,12,-3
28,9,52,10,34,-24
28,9,53,9,15,-6
28,9,54,3,13,-10
28,9,55,9,15,-6
28,9,56,11,19,-8
28,9,57,7,17,-10
28,9,58,14,22,-8
28,9,59,11,17,-6
28,9,60,7,18,-11
28,9,61,3,33,-30
28,9,62,5,22,-17
28,9,63,7,24,-17
28,9,64,8,16,-8
28,9,65,19,20,-1
28,9,66,5,16,-11
28,9,67,9,17,-8
28,9,68,9,17,-8
28,9,69,5,26,-21
28,9,70,10,13,-3
28,9,71,12,16,-4
28,9,72,10,34,-24
28,9,73,4,15,-11
28,9,74,9,23,-14
28,9,75,9,21,-12
28,9,76,5,11,-6
28,9,77,11,20,-9
28,9,78,6,13,-7
28,9,79,18,21,-3
28,9,80,5,25,-20
28,9,81,5,15,-10
28,9,82,3,13,-10
28,9,83,9,16,-7
28,9,84,7,14,-7
28,9,85,16,30,-14
28,9,86,5,18,-13
28,9,87,15,9,6
28,9,88,22,31,-9
28,9,89,4,37,-33
28,9,90,9,15,-6
28,9,91,14,37,-23
28,9,92,14,16,-2
28,9,93,15,26,-11
28,9,94,15,18,-3
28,9,95,18,13,5
28,9,96,7,14,-7
28,9,97,8,21,-13
28,9,98,11,13,-2
28,9,99,17,19,-2
28,9,100,10,15,-5
28,9,101,10,13,-3
28,9,102,5,21,-16
28,9,103,6,29,-23
28,9,104,4,12,-8
28,9,105,11,14,-3
28,9,106,6,18,-12
28,9,107,6,16,-10
28,9,108,6,13,-7
28,9,109,8,26,-18
28,9,110,5,38,-33
28,9,111,12,18,-6
28,9,112,9,34,-25
28,9,113,15,36,-21
28,9,114,7,25,-18
28,9,115,5,15,-10
28,9,116,11,22,-11
28,9,117,3,6,-3
28,9,118,8,11,-3
28,9,119,12,20,-8
28,9,120,11,25,-14
28,9,121,8,11,-3
28,9,122,12,29,-17
28,9,123,13,21,-8
28,9,124,9,20,-11
28,9,125,6,14,-8
28,9,126,6,13,-7
28,9,127,11,14,-3
28,9,128,9,16,-7
28,9,129,8,11,-3
28,9,130,17,29,-12
28,9,131,9,16,-7
28,9,132,8,16,-8
28,9,133,11,20,-9
28,9,134,9,27,-18
28,9,135,14,14,0
28,9,136,7,16,-9
28,9,137,11,17,-6
28,9,138,9,18,-9
28,9,139,11,26,-15
28,9,140,1,5,-4
28,9,141,7,31,-24
28,9,142,5,17,-12
28,9,143,13,25,-12
28,9,144,8,26,-18
28,9,145,4,28,-24
28,9,146,9,14,-5
28,9,147,7,25,-18
28,9,148,16,29,-13
28,9,149,13,20,-7
28,9,150,9,15,-6
28,9,151,11,21,-10
28,9,152,10,25,-15
28,9,153,3,16,-13
28,9,154,7,5,2
28,9,155,12,24,-12
28,9,156,8,16,-8
28,9,157,7,21,-14
28,9,158,13,5,8
28,9,159,8,17,-9
28,9,160,8,19,-11
28,9,161,9,19,-10
28,9,162,18,15,3
28,9,163,23,22,1
28,9,164,14,33,-19
28,9,165,6,19,-13
28,9,166,4,25,-21
28,9,167,15,37,-22
28,9,168,18,29,-11
28,9,169,9,35,-26
28,9,170,7,11,-4
28,9,171,3,34,-31
28,9,172,6,19,-13
28,9,173,5,27,-22
28,9,174,12,29,-17
28,9,175,12,13,-1
28,9,176,7,22,-15
28,9,177,6,14,-8
28,9,178,9,24,-15
28,9,179,8,14,-6
28,9,180,10,25,-15
28,9,181,7,13,-6
28,9,182,20,5,15
28,9,183,7,19,-12
28,9,184,6,31,-25
28,9,185,13,24,-11
28,9,186,10,20,-10
28,9,187,5,6,-1
28,9,188,18,16,2
28,9,189,13,15,-2
28,9,190,7,8,-1
28,9,191,16,27,-11
28,9,192,10,23,-13
28,9,193,13,16,-3
28,9,194,15,27,-12
28,9,195,10,23,-13
28,9,196,13,27,-14
28,9,197,9,18,-9
28,9,198,25,18,7
28,9,199,6,35,-29
28,9,200,20,53,-33
28,9,201,16,16,0
28,9,202,1,12,-11
28,9,203,21,26,-5
28,9,204,13,20,-7
28,9,205,16,48,-32
28,9,206,7,34,-27
28,9,207,6,20,-14
28,9,208,6,14,-8
28,9,209,7,19,-12
28,9,210,4,27,-23
28,9,211,9,24,-15
28,9,212,4,27,-23
28,9,213,11,26,-15
28,9,214,18,28,-10
28,9,215,10,25,-15
28,9,216,10,11,-1
28,9,217,12,26,-14
28,9,218,9,9,0
28,9,219,10,12,-2
28,9,220,9,7,2
28,9,221,11,22,-11
28,9,222,6,12,-6
28,9,223,10,18,-8
28,9,224,16,14,2
28,9,225,9,18,-9
28,9,226,6,24,-18
28,9,227,5,12,-7
28,9,228,16,16,0
28,9,229,11,18,-7
28,9,230,20,25,-5
28,9,231,6,11,-5
28,9,232,17,11,6
28,9,233,11,26,-15
28,9,234,6,22,-16
28,9,235,5,16,-11
28,9,236,10,21,-11
28,9,237,7,6,1
28,9,238,6,16,-10
28,9,239,8,24,-16
28,9,240,2,19,-17
28,9,241,6,32,-26
28,9,242,12,28,-16
28,9,243,9,24,-15
28,9,244,10,16,-6
28,9,245,3,18,-15
28,9,246,16,11,5
28,9,247,7,16,-9
28,9,248,2,9,-7
28,9,249,6,25,-19
28,9,250,14,16,-2
28,9,251,11,27,-16
28,9,252,8,18,-10
28,9,253,10,11,-1
28,9,254,13,30,-17
28,9,255,2,18,-16
28,9,256,4,21,-17
28,9,257,3,17,-14
28,9,258,11,15,-4
28,9,259,15,27,-12
28,9,260,16,18,-2
28,9,261,9,10,-1
28,9,262,12,19,-7
28,9,263,16,27,-11
28,9,264,16,23,-7
28,9,265,2,23,-21
28,9,266,15,18,-3
28,9,267,12,22,-10
28,9,268,7,13,-6
28,9,269,13,22,-9
28,9,270,4,27,-23
28,9,271,3,12,-9
28,9,272,11,28,-17
28,9,273,3,8,-5
28,9,274,7,13,-6
28,9,275,10,25,-15
28,9,276,13,17,-4
28,9,277,17,12,5
28,9,278,3,14,-11
28,9,279,15,35,-20
28,9,280,8,13,-5
28,9,281,12,31,-19
28,9,282,6,11,-5
28,9,283,16,38,-22
28,9,284,7,21,-14
28,9,285,10,24,-14
28,9,286,12,38,-26
28,9,287,14,26,-12
28,9,288,4,20,-16
28,9,289,10,25,-15
28,9,290,8,4,4
28,9,291,13,18,-5
28,9,292,7,34,-27
28,9,293,7,13,-6
28,9,294,17,22,-5
28,9,295,12,17,-5
28,9,296,15,25,-10
28,9,297,16,33,-17
28,9,298,8,20,-12
28,9,299,11,23,-12
28,10,0,5,14,-9
28,10,1,9,26,-17
28,10,2,10,24,-14
28,10,3,18,28,-10
28,10,4,15,11,4
28,10,5,9,14,-5
28,10,6,4,20,-16
28,10,7,17,26,-9
28,10,8,4,7,-3
28,10,9,10,19,-9
28,10,10,12,33,-21
28,10,11,10,19,-9
28,10,12,10,14,-4
28,10,13,5,13,-8
28,10,14,9,17,-8
28,10,15,21,27,-6
28,10,16,5,12,-7
28,10,17,5,21,-16
28,10,18,10,16,-6
28,10,19,6,15,-9
28,10,20,2,9,-7
28,10,21,5,11,-6
28,10,22,9,16,-7
28,10,23,7,9,-2
28,10,24,4,12,-8
28,10,25,10,14,-4
28,10,26,2,8,-6
28,10,27,10,18,-8
28,10,28,9,25,-16
28,10,29,10,12,-2
28,10,30,2,16,-14
28,10,31,5,9,-4
28,10,32,12,30,-18
28,10,33,18,26,-8
28,10,34,12,24,-12
28,10,35,8,23,-15
28,10,36,13,27,-14
28,10,37,20,31,-11
28,10,38,8,12,-4
28,10,39,11,12,-1
28,10,40,11,14,-3
28,10,41,11,19,-8
28,10,42,0,10,-10
28,10,43,15,35,-20
28,10,44,2,9,-7
28,10,45,7,13,-6
28,10,46,1,27,-26
28,10,47,7,13,-6
28,10,48,6,14,-8
28,10,49,17,18,-1
28,10,50,12,37,-25
28,10,51,8,15,-7
28,10,52,8,20,-12
28,10,53,4,20,-16
28,10,54,19,9,10
28,10,55,9,43,-34
28,10,56,10,8,2
28,10,57,8,28,-20
28,10,58,6,13,-7
28,10,59,8,10,-2
28,10,60,9,33,-24
28,10,61,14,24,-10
28,10,62,5,22,-17
28,10,63,7,21,-14
28,10,64,11,22,-11
28,10,65,9,15,-6
28,10,66,11,21,-10
28,10,67,2,22,-20
28,10,68,14,15,-1
28,10,69,14,24,-10
28,10,70,6,15,-9
28,10,71,12,17,-5
28,10,72,9,23,-14
28,10,73,12,27,-15
28,10,74,19,12,7
28,10,75,9,26,-17
28,10,76,13,13,0
28,10,77,6,19,-13
28,10,78,12,27,-15
28,10,79,16,27,-11
28,10,80,13,9,4
28,10,81,21,15,6
28,10,82,14,21,-7
28,10,83,8,24,-16
28,10,84,12,17,-5
28,10,85,9,26,-17
28,10,86,13,22,-9
28,10,87,16,19,-3
28,10,88,7,10,-3
28,10,89,11,12,-1
28,10,90,11,12,-1
28,10,91,7,22,-15
28,10,92,8,25,-17
28,10,93,7,25,-18
28,10,94,14,6,8
28,10,95,16,22,-6
28,10,96,13,13,0
28,10,97,18,32,-14
28,10,98,8,20,-12
28,10,99,13,23,-10
28,10,100,9,22,-13
28,10,101,11,16,-5
28,10,102,14,16,-2
28,10,103,10,24,-14
28,10,104,9,20,-11
28,10,105,17,32,-15
28,10,106,9,22,-13
28,10,107,18,25,-7
28,10,108,10,34,-24
28,10,109,9,12,-3
28,10,110,15,23,-8
28,10,111,12,28,-16
28,10,112,10,15,-5
28,10,113,15,15,0
28,10,114,11,13,-2
28,10,115,11,21,-10
28,10,116,14,23,-9
28,10,117,2,10,-8
28,10,118,9,31,-22
28,10,119,14,17,-3
28,10,120,14,26,-12
28,10,121,8,17,-9
28,10,122,7,15,-8
28,10,123,16,22,-6
28,10,124,14,18,-4
28,10,125,11,28,-17
28,10,126,2,11,-9
28,10,127,12,16,-4
28,10,128,21,35,-14
28,10,129,9,29,-20
28,10,130,4,18,-14
28,10,131,9,12,-3
28,10,132,7,9,-2
28,10,133,8,27,-19
28,10,134,13,24,-11
28,10,135,9,8,1
28,10,136,10,24,-14
28,10,137,11,12,-1
28,10,138,15,16,-1
28,10,139,5,11,-6
28,10,140,18,28,-10
28,10,141,8,15,-7
28,10,142,11,25,-14
28,10,143,13,22,-9
28,10,144,13,19,-6
28,10,145,21,27,-6
28,10,146,9,22,-13
28,10,147,13,33,-20
28,10,148,11,23,-12
28,10,149,16,24,-8
28,10,150,6,12,-6
28,10,151,7,8,-1
28,10,152,11,21,-10
28,10,153,8,19,-11
28,10,154,17,20,-3
28,10,155,14,34,-20
28,10,156,2,7,-5
28,10,157,6,18,-12
28,10,158,11,18,-7
28,10,159,9,13,-4
28,10,160,12,25,-13
28,10,161,10,14,-4
28,10,162,14,25,-11
28,10,163,4,12,-8
28,10,164,12,24,-12
28,10,165,9,15,-6
28,10,166,7,15,-8
28,10,167,12,15,-3
28,10,168,14,23,-9
28,10,169,11,29,-18
28,10,170,17,35,-18
28,10,171,19,23,-4
28,10,172,10,13,-3
28,10,173,3,8,-5
28,10,174,13,33,-20
28,10,175,9,5,4
28,10,176,8,24,-16
28,10,177,18,11,7
28,10,178,5,9,-4
28,10,179,8,41,-33
28,10,180,12,23,-11
28,10,181,19,26,-7
28,10,182,9,17,-8
28,10,183,11,19,-8
28,10,184,19,17,2
28,10,185,9,22,-13
28,10,186,17,23,-6
28,10,187,9,24,-15
28,10,188,11,28,-17
28,10,189,17,32,-15
28,10,190,7,15,-8
28,10,191,6,9,-3
28,10,192,8,9,-1
28,10,193,3,8,-5
28,10,194,6,15,-9
28,10,195,10,17,-7
28,10,196,2,16,-14
28,10,197,4,15,-11
28,10,198,5,26,-21
28,10,199,7,12,-5
28,10,200,9,26,-17
28,10,201,11,26,-15
28,10,202,7,24,-17
28,10,203,4,8,-4
28,10,204,14,20,-6
28,10,205,7,18,-11
28,10,206,6,10,-4
28,10,207,11,24,-13
28,10,208,9,30,-21
28,10,209,7,22,-15
28,10,210,11,23,-12
28,10,211,12,20,-8
28,10,212,4,40,-36
28,10,213,2,27,-25
28,10,214,15,45,-30
28,10,215,15,19,-4
28,10,216,14,16,-2
28,10,217,7,13,-6
28,10,218,9,14,-5
28,10,219,20,19,1
28,10,220,9,23,-14
28,10,221,11,18,-7
28,10,222,4,25,-21
28,10,223,15,18,-3
28,10,224,11,26,-15
28,10,225,27,22,5
28,10,226,13,24,-11
28,10,227,11,6,5
28,10,228,2,12,-10
28,10,229,5,16,-11
28,10,230,16,23,-7
28,10,231,13,21,-8
28,10,232,8,16,-8
28,10,233,7,13,-6
28,10,234,7,17,-10
28,10,235,10,9,1
28,10,236,9,19,-10
28,10,237,9,26,-17
28,10,238,6,16,-10
28,10,239,10,15,-5
28,10,240,6,7,-1
28,10,241,3,15,-12
28,10,242,24,29,-5
28,10,243,5,21,-16
28,10,244,7,16,-9
28,10,245,20,27,-7
28,10,246,10,17,-7
28,10,247,15,37,-22
28,10,248,7,21,-14
28,10,249,21,17,4
28,10,250,20,21,-1
28,10,251,12,15,-3
28,10,252,10,15,-5
28,10,253,9,25,-16
28,10,254,6,20,-14
28,10,255,7,15,-8
28,10,256,4,21,-17
28,10,257,8,16,-8
28,10,258,11,11,0
28,10,259,6,25,-19
28,10,260,5,32,-27
28,10,261,11,15,-4
28,10,262,6,26,-20
28,10,263,8,11,-3
28,10,264,1,17,-16
28,10,265,15,7,8
28,10,266,11,20,-9
28,10,267,8,20,-12
28,10,268,13,27,-14
28,10,269,15,26,-11
28,10,270,13,29,-16
28,10,271,7,23,-16
28,10,272,16,32,-16
28,10,273,9,16,-7
28,10,274,11,27,-16
28,10,275,3,11,-8
28,10,276,10,17,-7
28,10,277,11,17,-6
28,10,278,9,27,-18
28,10,279,28,18,10
28,10,280,10,18,-8
28,10,281,15,27,-12
28,10,282,12,10,2
28,10,283,11,19,-8
28,10,284,12,15,-3
28,10,285,11,27,-16
28,10,286,17,31,-14
28,10,287,18,30,-12
28,10,288,15,14,1
28,10,289,13,29,-16
28,10,290,16,16,0
28,10,291,5,26,-21
28,10,292,14,32,-18
28,10,293,7,27,-20
28,10,294,1,11,-10
28,10,295,11,26,-15
28,10,296,22,12,10
28,10,297,20,13,7
28,10,298,10,29,-19
28,10,299,8,22,-14
28,11,0,18,24,-6
28,11,1,21,29,-8
28,11,2,6,16,-10
28,11,3,3,8,-5
28,11,4,12,16,-4
28,11,5,12,9,3
28,11,6,9,28,-19
28,11,7,7,38,-31
28,11,8,7,12,-5
28,11,9,15,17,-2
28,11,10,9,17,-8
28,11,11,13,27,-14
28,11,12,11,28,-17
28,11,13,7,19,-12
28,11,14,13,20,-7
28,11,15,6,18,-12
28,11,16,2,10,-8
28,11,17,8,12,-4
28,11,18,6,15,-9
28,11,19,7,26,-19
28,11,20,7,15,-8
28,11,21,2,7,-5
28,11,22,12,14,-2
28,11,23,16,18,-2
28,11,24,13,13,0
28,11,25,18,21,-3
28,11,26,5,20,-15
28,11,27,15,26,-11
28,11,28,17,14,3
28,11,29,10,29,-19
28,11,30,4,21,-17
28,11,31,10,15,-5
28,11,32,17,15,2
28,11,33,8,17,-9
28,11,34,5,25,-20
28,11,35,8,23,-15
28,11,36,15,31,-16
28,11,37,6,13,-7
28,11,38,2,17,-15
28,11,39,15,21,-6
28,11,40,9,38,-29
28,11,41,5,31,-26
28,11,42,4,9,-5
28,11,43,8,26,-18
28,11,44,17,22,-5
28,11,45,20,19,1
28,11,46,9,20,-11
28,11,47,12,16,-4
28,11,48,5,20,-15
28,11,49,8,9,-1
28,11,50,7,16,-9
28,11,51,7,17,-10
28,11,52,14,16,-2
28,11,53,11,19,-8
28,11,54,4,9,-5
28,11,55,14,10,4
28,11,56,7,15,-8
28,11,57,14,24,-10
28,11,58,12,9,3
28,11,59,8,14,-6
28,11,60,10,21,-11
28,11,61,13,27,-14
28,11,62,9,16,-7
28,11,63,7,12,-5
28,11,64,8,13,-5
28,11,65,12,24,-12
28,11,66,14,15,-1
28,11,67,8,6,2
28,11,68,5,16,-11
28,11,69,6,13,-7
28,11,70,9,21,-12
28,11,71,7,23,-16
28,11,72,5,17,-12
28,11,73,4,11,-7
28,11,74,17,30,-13
28,11,75,14,30,-16
28,11,76,7,7,0
28,11,77,18,31,-13
28,11,78,15,23,-8
28,11,79,5,17,-12
28,11,80,13,19,-6
28,11,81,3,18,-15
28,11,82,8,15,-7
28,11,83,6,18,-12
28,11,84,13,7,6
28,11,85,5,8,-3
28,11,86,9,10,-1
28,11,87,16,21,-5
28,11,88,14,9,5
28,11,89,9,18,-9
28,11,90,14,13,1
28,11,91,10,38,-28
28,11,92,7,28,-21
28,11,93,16,14,2
28,11,94,11,34,-23
28,11,95,12,28,-16
28,11,96,17,10,7
28,11,97,4,27,-23
28,11,98,18,10,8
28,11,99,7,8,-1
28,11,100,12,33,-21
28,11,101,8,8,0
28,11,102,13,13,0
28,11,103,11,14,-3
28,11,104,9,20,-11
28,11,105,19,24,-5
28,11,106,10,14,-4
28,11,107,8,16,-8
28,11,108,15,21,-6
28,11,109,15,21,-6
28,11,110,8,23,-15
28,11,111,24,21,3
28,11,112,22,23,-1
28,11,113,5,21,-16
28,11,114,20,27,-7
28,11,115,10,24,-14
28,11,116,16,17,-1
28,11,117,7,20,-13
28,11,118,22,14,8
28,11,119,7,28,-21
28,11,120,20,27,-7
28,11,121,15,17,-2
28,11,122,7,24,-17
28,11,123,20,17,3
28,11,124,18,41,-23
28,11,125,2,24,-22
28,11,126,8,18,-10
28,11,127,6,16,-10
28,11,128,3,16,-13
28,11,129,8,19,-11
28,11,130,8,21,-13
28,11,131,13,22,-9
28,11,132,9,40,-31
28,11,133,11,23,-12
28,11,134,20,20,0
28,11,135,8,19,-11
28,11,136,16,9,7
28,11,137,11,14,-3
28,11,138,9,12,-3
28,11,139,12,25,-13
28,11,140,24,27,-3
28,11,141,11,12,-1
28,11,142,14,19,-5
28,11,143,10,18,-8
28,11,144,6,12,-6
28,11,145,15,30,-15
28,11,146,17,28,-11
28,11,147,22,19,3
28,11,148,13,30,-17
28,11,149,13,22,-9
28,11,150,7,24,-17
28,11,151,6,24,-18
28,11,152,14,22,-8
28,11,153,12,32,-20
28,11,154,9,17,-8
28,11,155,20,29,-9
28,11,156,11,20,-9
28,11,157,8,12,-4
28,11,158,13,19,-6
28,11,159,8,13,-5
28,11,160,1,3,-2
28,11,161,10,28,-18
28,11,162,8,22,-14
28,11,163,12,25,-13
28,11,164,15,16,-1
28,11,165,16,27,-11
28,11,166,14,31,-17
28,11,167,13,20,-7
28,11,168,6,18,-12
28,11,169,22,20,2
28,11,170,14,25,-11
28,11,171,9,21,-12
28,11,172,10,17,-7
28,11,173,11,17,-6
28,11,174,12,16,-4
28,11,175,5,23,-18
28,11,176,7,11,-4
28,11,177,10,11,-1
28,11,178,1,12,-11
28,11,179,5,32,-27
28,11,180,9,19,-10
28,11,181,12,11,1
28,11,182,7,23,-16
28,11,183,5,10,-5
28,11,184,8,11,-3
28,11,185,13,18,-5
28,11,186,8,23,-15
28,11,187,5,6,-1
28,11,188,14,18,-4
28,11,189,14,41,-27
28,11,190,13,35,-22
28,11,191,10,9,1
28,11,192,5,17,-12
28,11,193,5,22,-17
28,11,194,3,32,-29
28,11,195,12,35,-23
28,11,196,9,17,-8
28,11,197,10,17,-7
28,11,198,12,31,-19
28,11,199,20,19,1
28,11,200,3,8,-5
28,11,201,11,23,-12
28,11,202,9,21,-12
28,11,203,12,15,-3
28,11,204,8,17,-9
28,11,205,8,26,-18
28,11,206,10,21,-11
28,11,207,8,23,-15
28,11,208,12,20,-8
28,11,209,12,10,2
28,11,210,7,13,-6
28,11,211,7,19,-12
28,11,212,11,13,-2
28,11,213,6,17,-11
28,11,214,15,24,-9
28,11,215,12,6,6
28,11,216,4,23,-19
28,11,217,6,10,-4
28,11,218,2,23,-21
28,11,219,15,27,-12
28,11,220,17,26,-9
28,11,221,10,9,1
28,11,222,12,22,-10
28,11,223,4,23,-19
28,11,224,8,12,-4
28,11,225,4,12,-8
28,11,226,8,17,-9
28,11,227,10,22,-12
28,11,228,15,31,-16
28,11,229,10,16,-6
28,11,230,15,38,-23
28,11,231,16,25,-9
28,11,232,10,19,-9
28,11,233,9,21,-12
28,11,234,13,39,-26
28,11,235,8,21,-13
28,11,236,12,15,-3
28,11,237,14,13,1
28,11,238,8,14,-6
28,11,239,12,17,-5
28,11,240,11,15,-4
28,11,241,13,25,-12
28,11,242,8,16,-8
28,11,243,14,19,-5
28,11,244,7,17,-10
28,11,245,9,35,-26
28,11,246,15,14,1
28,11,247,20,9,11
28,11,248,17,23,-6
28,11,249,4,20,-16
28,11,250,6,20,-14
28,11,251,12,15,-3
28,11,252,6,9,-3
28,11,253,17,21,-4
28,11,254,15,18,-3
28,11,255,13,18,-5
28,11,256,4,32,-28
28,11,257,7,32,-25
28,11,258,10,16,-6
28,11,259,7,27,-20
28,11,260,14,14,0
28,11,261,12,19,-7
28,11,262,10,15,-5
28,11,263,13,17,-4
28,11,264,9,19,-10
28,11,265,8,18,-10
28,11,266,7,21,-14
28,11,267,9,18,-9
28,11,268,6,14,-8
28,11,269,16,22,-6
28,11,270,6,15,-9
28,11,271,6,18,-12
28,11,272,13,12,1
28,11,273,8,31,-23
28,11,274,10,14,-4
28,11,275,3,34,-31
28,11,276,11,25,-14
28,11,277,17,11,6
28,11,278,9,17,-8
28,11,279,21,20,1
28,11,280,6,5,1
28,11,281,8,15,-7
28,11,282,11,20,-9
28,11,283,12,13,-1
28,11,284,11,20,-9
28,11,285,8,9,-1
28,11,286,8,17,-9
28,11,287,9,30,-21
28,11,288,9,18,-9
28,11,289,25,35,-10
28,11,290,5,12,-7
28,11,291,9,15,-6
28,11,292,12,19,-7
28,11,293,13,31,-18
28,11,294,9,17,-8
28,11,295,7,7,0
28,11,296,8,16,-8
28,11,297,11,22,-11
28,11,298,13,7,6
28,11,299,9,28,-19
28,12,0,10,11,-1
28,12,1,12,12,0
28,12,2,10,15,-5
28,12,3,8,13,-5
28,12,4,16,32,-16
28,12,5,23,22,1
28,12,6,13,15,-2
28,12,7,23,6,17
28,12,8,12,13,-1
28,12,9,8,20,-12
28,12,10,16,25,-9
28,12,11,10,22,-12
28,12,12,13,4,9
28,12,13,16,29,-13
28,12,14,11,15,-4
28,12,15,7,34,-27
28,12,16,8,13,-5
28,12,17,13,23,-10
28,12,18,17,18,-1
28,12,19,8,24,-16
28,12,20,18,14,4
28,12,21,10,20,-10
28,12,22,11,11,0
28,12,23,22,40,-18
28,12,24,16,18,-2
28,12,25,15,18,-3
28,12,26,12,18,-6
28,12,27,7,17,-10
28,12,28,9,25,-16
28,12,29,16,18,-2
28,12,30,9,14,-5
28,12,31,3,18,-15
28,12,32,11,22,-11
28,12,33,11,18,-7
28,12,34,6,16,-10
28,12,35,9,25,-16
28,12,36,18,31,-13
28,12,37,13,20,-7
28,12,38,28,27,1
28,12,39,5,29,-24
28,12,40,16,21,-5
28,12,41,7,17,-10
28,12,42,6,10,-4
28,12,43,9,17,-8
28,12,44,8,14,-6
28,12,45,16,23,-7
28,12,46,4,16,-12
28,12,47,12,16,-4
28,12,48,3,10,-7
28,12,49,8,3,5
28,12,50,12,20,-8
28,12,51,21,24,-3
28,12,52,14,23,-9
28,12,53,14,28,-14
28,12,54,9,24,-15
28,12,55,6,15,-9
28,12,56,7,16,-9
28,12,57,0,13,-13
28,12,58,9,22,-13
28,12,59,10,11,-1
28,12,60,17,28,-11
28,12,61,19,33,-14
28,12,62,16,23,-7
28,12,63,12,8,4
28,12,64,16,26,-10
28,12,65,12,15,-3
28,12,66,13,9,4
28,12,67,9,19,-10
28,12,68,6,14,-8
28,12,69,9,17,-8
28,12,70,11,15,-4
28,12,71,11,23,-12
28,12,72,15,18,-3
28,12,73,14,37,-23
28,12,74,7,23,-16
28,12,75,13,19,-6
28,12,76,13,20,-7
28,12,77,12,27,-15
28,12,78,7,12,-5
28,12,79,10,16,-6
28,12,80,10,24,-14
28,12,81,17,11,6
28,12,82,11,24,-13
28,12,83,11,21,-10
28,12,84,2,14,-12
28,12,85,6,12,-6
28,12,86,14,11,3
28,12,87,20,11,9
28,12,88,11,16,-5
28,12,89,12,17,-5
28,12,90,18,20,-2
28,12,91,9,21,-12
28,12,92,14,21,-7
28,12,93,11,21,-10
28,12,94,17,23,-6
28,12,95,11,19,-8
28,12,96,10,26,-16
28,12,97,10,17,-7
28,12,98,6,23,-17
28,12,99,3,6,-3
28,12,100,9,17,-8
28,12,101,10,16,-6
28,12,102,8,26,-18
28,12,103,9,29,-20
28,12,104,9,14,-5
28,12,105,10,24,-14
28,12,106,10,17,-7
28,12,107,13,21,-8
28,12,108,5,15,-10
28,12,109,5,9,-4
28,12,110,4,38,-34
28,12,111,14,31,-17
28,12,112,3,6,-3
28,12,113,7,16,-9
28,12,114,12,33,-21
28,12,115,4,13,-9
28,12,116,10,36,-26
28,12,117,10,16,-6
28,12,118,8,23,-15
28,12,119,7,19,-12
28,12,120,11,9,2
28,12,121,21,39,-18
28,12,122,10,29,-19
28,12,123,8,24,-16
28,12,124,11,22,-11
28,12,125,14,20,-6
28,12,126,6,21,-15
28,12,127,20,22,-2
28,12,128,8,19,-11
28,12,129,15,24,-9
28,12,130,4,17,-13
28,12,131,6,22,-16
28,12,132,16,26,-10
28,12,133,8,11,-3
28,12,134,14,21,-7
28,12,135,13,10,3
28,12,136,16,29,-13
28,12,137,7,9,-2
28,12,138,5,15,-10
28,12,139,35,20,15
28,12,140,12,24,-12
28,12,141,7,14,-7
28,12,142,13,19,-6
28,12,143,4,7,-3
28,12,144,4,11,-7
28,12,145,11,15,-4
28,12,146,11,28,-17
28,12,147,8,16,-8
28,12,148,14,10,4
28,12,149,13,24,-11
28,12,150,9,10,-1
28,12,151,7,15,-8
28,12,152,7,12,-5
28,12,153,13,18,-5
28,12,154,8,14,-6
28,12,155,20,27,-7
28,12,156,15,14,1
28,12,157,6,13,-7
28,12,158,16,19,-3
28,12,159,15,33,-18
28,12,160,10,22,-12
28,12,161,12,10,2
28,12,162,9,26,-17
28,12,163,7,9,-2
28,12,164,1,10,-9
28,12,165,12,16,-4
28,12,166,15,21,-6
28,12,167,9,35,-26
28,12,168,9,10,-1
28,12,169,8,26,-18
28,12,170,12,19,-7
28,12,171,9,13,-4
28,12,172,12,27,-15
28,12,173,13,25,-12
28,12,174,11,18,-7
28,12,175,8,21,-13
28,12,176,8,40,-32
28,12,177,7,12,-5
28,12,178,11,26,-15
28,12,179,10,15,-5
28,12,180,8,15,-7
28,12,181,10,18,-8
28,12,182,15,20,-5
28,12,183,8,14,-6
28,12,184,12,20,-8
28,12,185,12,11,1
28,12,186,12,22,-10
28,12,187,14,9,5
28,12,188,16,11,5
28,12,189,5,8,-3
28,12,190,3,12,-9
28,12,191,12,29,-17
28,12,192,12,16,-4
28,12,193,13,11,2
28,12,194,15,25,-10
28,12,195,13,27,-14
28,12,196,4,13,-9
28,12,197,10,17,-7
28,12,198,12,13,-1
28,12,199,7,22,-15
28,12,200,20,27,-7
28,12,201,23,37,-14
28,12,202,7,22,-15
28,12,203,4,17,-13
28,12,204,16,13,3
28,12,205,7,24,-17
28,12,206,6,35,-29
28,12,207,18,20,-2
28,12,208,19,19,0
28,12,209,5,24,-19
28,12,210,2,12,-10
28,12,211,3,23,-20
28,12,212,8,27,-19
28,12,213,15,20,-5
28,12,214,6,12,-6
28,12,215,10,12,-2
28,12,216,9,26,-17
28,12,217,7,13,-6
28,12,218,11,25,-14
28,12,219,8,25,-17
28,12,220,1,12,-11
28,12,221,11,12,-1
28,12,222,6,12,-6
28,12,223,8,13,-5
28,12,224,12,18,-6
28,12,225,5,12,-7
28,12,226,12,10,2
28,12,227,12,15,-3
28,12,228,7,24,-17
28,12,229,4,25,-21
28,12,230,11,31,-20
28,12,231,3,16,-13
28,12,232,11,19,-8
28,12,233,19,20,-1
28,12,234,12,31,-19
28,12,235,12,22,-10
28,12,236,8,24,-16
28,12,237,4,12,-8
28,12,238,10,21,-11
28,12,239,6,15,-9
28,12,240,10,15,-5
28,12,241,3,12,-9
28,12,242,11,14,-3
28,12,243,10,27,-17
28,12,244,10,19,-9
28,12,245,12,14,-2
28,12,246,9,20,-11
28,12,247,17,25,-8
28,12,248,28,29,-1
28,12,249,3,17,-14
28,12,250,7,21,-14
28,12,251,10,5,5
28,12,252,9,18,-9
28,12,253,15,17,-2
28,12,254,15,18,-3
28,12,255,11,23,-12
28,12,256,12,19,-7
28,12,257,5,5,0
28,12,258,15,29,-14
28,12,259,10,13,-3
28,12,260,19,29,-10
28,12,261,8,21,-13
28,12,262,12,23,-11
28,12,263,11,27,-16
28,12,264,13,25,-12
28,12,265,13,4,9
28,12,266,7,22,-15
28,12,267,13,28,-15
28,12,268,15,33,-18
28,12,269,10,27,-17
28,12,270,13,15,-2
28,12,271,14,14,0
28,12,272,11,13,-2
28,12,273,6,9,-3
28,12,274,3,16,-13
28,12,275,12,14,-2
28,12,276,13,23,-10
28,12,277,17,19,-2
28,12,278,5,28,-23
28,12,279,11,30,-19
28,12,280,7,20,-13
28,12,281,7,18,-11
28,12,282,15,19,-4
28,12,283,6,15,-9
28,12,284,6,22,-16
28,12,285,18,34,-16
28,12,286,7,12,-5
28,12,287,13,26,-13
28,12,288,21,27,-6
28,12,289,13,32,-19
28,12,290,11,8,3
28,12,291,11,14,-3
28,12,292,17,13,4
28,12,293,6,13,-7
28,12,294,9,10,-1
28,12,295,7,16,-9
28,12,296,7,15,-8
28,12,297,9,16,-7
28,12,298,10,14,-4
28,12,299,20,19,1
28,13,0,6,12,-6
28,13,1,5,23,-18
28,13,2,5,15,-10
28,13,3,9,19,-10
28,13,4,10,28,-18
28,13,5,11,27,-16
28,13,6,11,38,-27
28,13,7,12,35,-23
28,13,8,7,16,-9
28,13,9,11,20,-9
28,13,10,12,23,-11
28,13,11,7,28,-21
28,13,12,9,28,-19
28,13,13,16,7,9
28,13,14,18,17,1
28,13,15,8,25,-17
28,13,16,11,18,-7
28,13,17,4,18,-14
28,13,18,6,16,-10
28,13,19,12,15,-3
28,13,20,9,25,-16
28,13,21,6,14,-8
28,13,22,6,13,-7
28,13,23,7,24,-17
28,13,24,8,21,-13
28,13,25,12,19,-7
28,13,26,3,23,-20
28,13,27,14,29,-15
28,13,28,8,30,-22
28,13,29,12,16,-4
28,13,30,12,16,-4
28,13,31,7,20,-13
28,13,32,9,22,-13
28,13,33,5,15,-10
28,13,34,7,19,-12
28,13,35,14,24,-10
28,13,36,15,10,5
28,13,37,20,19,1
28,13,38,3,7,-4
28,13,39,13,10,3
28,13,40,11,20,-9
28,13,41,9,15,-6
28,13,42,13,12,1
28,13,43,13,22,-9
28,13,44,13,23,-10
28,13,45,9,33,-24
28,13,46,19,18,1
28,13,47,21,24,-3
28,13,48,3,12,-9
28,13,49,14,15,-1
28,13,50,5,11,-6
28,13,51,9,14,-5
28,13,52,12,14,-2
28,13,53,18,11,7
28,13,54,9,11,-2
28,13,55,10,15,-5
28,13,56,15,13,2
28,13,57,8,18,-10
28,13,58,7,20,-13
28,13,59,6,9,-3
28,13,60,13,18,-5
28,13,61,7,11,-4
28,13,62,25,25,0
28,13,63,11,24,-13
28,13,64,8,13,-5
28,13,65,7,15,-8
28,13,66,9,21,-12
28,13,67,16,18,-2
28,13,68,8,26,-18
28,13,69,7,31,-24
28,13,70,10,8,2
28,13,71,10,23,-13
28,13,72,13,25,-12
28,13,73,7,11,-4
28,13,74,14,20,-6
28,13,75,19,34,-15
28,13,76,10,25,-15
28,13,77,12,9,3
28,13,78,5,15,-10
28,13,79,4,5,-1
28,13,80,8,27,-19
28,13,81,9,26,-17
28,13,82,15,28,-13
28,13,83,5,16,-11
28,13,84,10,23,-13
28,13,85,10,21,-11
28,13,86,9,14,-5
28,13,87,6,24,-18
28,13,88,28,35,-7
28,13,89,11,16,-5
28,13,90,14,16,-2
28,13,91,11,10,1
28,13,92,17,21,-4
28,13,93,15,28,-13
28,13,94,4,22,-18
28,13,95,12,20,-8
28,13,96,13,38,-25
28,13,97,10,34,-24
28,13,98,23,19,4
28,13,99,15,19,-4
28,13,100,12,28,-16
28,13,101,9,21,-12
28,13,102,7,29,-22
28,13,103,5,8,-3
28,13,104,3,19,-16
28,13,105,9,15,-6
28,13,106,16,23,-7
28,13,107,10,18,-8
28,13,108,6,22,-16
28,13,109,9,22,-13
28,13,110,4,5,-1
28,13,111,9,22,-13
28,13,112,1,19,-18
28,13,113,8,22,-14
28,13,114,11,21,-10
28,13,115,5,13,-8
28,13,116,13,20,-7
28,13,117,8,10,-2
28,13,118,11,18,-7
28,13,119,16,25,-9
28,13,120,21,15,6
28,13,121,13,18,-5
28,13,122,20,33,-13
28,13,123,5,15,-10
28,13,124,16,21,-5
28,13,125,13,13,0
28,13,126,3,14,-11
28,13,127,5,19,-14
28,13,128,17,19,-2
28,13,129,9,5,4
28,13,130,9,19,-10
28,13,131,25,26,-1
28,13,132,12,29,-17
28,13,133,11,17,-6
28,13,134,16,23,-7
28,13,135,11,25,-14
28,13,136,11,34,-23
28,13,137,10,32,-22
28,13,138,7,10,-3
28,13,139,15,17,-2
28,13,140,3,24,-21
28,13,141,5,22,-17
28,13,142,4,19,-15
28,13,143,3,17,-14
28,13,144,8,14,-6
28,13,145,20,16,4
28,13,146,25,23,2
28,13,147,6,15,-9
28,13,148,13,14,-1
28,13,149,9,19,-10
28,13,150,5,15,-10
28,13,151,3,20,-17
28,13,152,7,5,2
28,13,153,11,12,-1
28,13,154,10,13,-3
28,13,155,9,9,0
28,13,156,7,12,-5
28,13,157,6,17,-11
28,13,158,12,21,-9
28,13,159,11,16,-5
28,13,160,3,1,2
28,13,161,10,26,-16
28,13,162,4,12,-8
28,13,163,9,27,-18
28,13,164,12,16,-4
28,13,165,17,21,-4
28,13,166,9,11,-2
28,13,167,11,12,-1
28,13,168,11,17,-6
28,13,169,14,18,-4
28,13,170,8,24,-16
28,13,171,3,12,-9
28,13,172,6,27,-21
28,13,173,14,10,4
28,13,174,7,6,1
28,13,175,14,19,-5
28,13,176,8,26,-18
28,13,177,7,14,-7
28,13,178,8,22,-14
28,13,179,4,16,-12
28,13,180,8,19,-11
28,13,181,11,23,-12
28,13,182,11,17,-6
28,13,183,9,23,-14
28,13,184,16,28,-12
28,13,185,16,15,1
28,13,186,8,20,-12
28,13,187,6,34,-28
28,13,188,10,14,-4
28,13,189,13,14,-1
28,13,190,20,15,5
28,13,191,11,25,-14
28,13,192,14,14,0
28,13,193,12,32,-20
28,13,194,14,26,-12
28,13,195,8,20,-12
28,13,196,11,10,1
28,13,197,13,17,-4
28,13,198,5,15,-10
28,13,199,11,28,-17
28,13,200,11,14,-3
28,13,201,14,16,-2
28,13,202,9,13,-4
28,13,203,19,26,-7
28,13,204,16,16,0
28,13,205,18,33,-15
28,13,206,18,34,-16
28,13,207,4,25,-21
28,13,208,4,25,-21
28,13,209,10,22,-12
28,13,210,14,14,0
28,13,211,13,24,-11
28,13,212,7,24,-17
28,13,213,13,28,-15
28,13,214,7,8,-1
28,13,215,9,20,-11
28,13,216,11,19,-8
28,13,217,3,27,-24
28,13,218,15,9,6
28,13,219,7,23,-16
28,13,220,11,21,-10
28,13,221,12,16,-4
28,13,222,19,25,-6
28,13,223,13,24,-11
28,13,224,9,17,-8
28,13,225,23,17,6
28,13,226,12,24,-12
28,13,227,11,16,-5
28,13,228,15,17,-2
28,13,229,17,7,10
28,13,230,8,9,-1
28,13,231,14,10,4
28,13,232,13,26,-13
28,13,233,1,19,-18
28,13,234,10,15,-5
28,13,235,19,26,-7
28,13,236,20,18,2
28,13,237,13,14,-1
28,13,238,16,29,-13
28,13,239,16,29,-13
28,13,240,10,18,-8
28,13,241,8,16,-8
28,13,242,1,13,-12
28,13,243,2,21,-19
28,13,244,7,22,-15
28,13,245,14,20,-6
28,13,246,17,33,-16
28,13,247,6,20,-14
28,13,248,7,12,-5
28,13,249,7,23,-16
28,13,250,8,14,-6
28,13,251,18,19,-1
28,13,252,2,6,-4
28,13,253,6,12,-6
28,13,254,14,32,-18
28,13,255,2,20,-18
28,13,256,9,23,-14
28,13,257,10,28,-18
28,13,258,6,18,-12
28,13,259,5,7,-2
28,13,260,15,14,1
28,13,261,6,13,-7
28,13,262,20,18,2
28,13,263,21,22,-1
28,13,264,6,21,-15
28,13,265,14,24,-10
28,13,266,14,30,-16
28,13,267,14,19,-5
28,13,268,8,16,-8
28,13,269,12,4,8
28,13,270,5,21,-16
28,13,271,9,14,-5
28,13,272,11,14,-3
28,13,273,3,15,-12
28,13,274,7,6,1
28,13,275,5,15,-10
28,13,276,9,15,-6
28,13,277,9,27,-18
28,13,278,9,26,-17
28,13,279,5,20,-15
28,13,280,7,14,-7
28,13,281,3,12,-9
28,13,282,10,14,-4
28,13,283,9,17,-8
28,13,284,7,16,-9
28,13,285,16,22,-6
28,13,286,5,10,-5
28,13,287,16,24,-8
28,13,288,13,36,-23
28,13,289,8,22,-14
28,13,290,7,12,-5
28,13,291,15,31,-16
28,13,292,10,24,-14
28,13,293,8,19,-11
28,13,294,11,16,-5
28,13,295,5,17,-12
28,13,296,12,21,-9
28,13,297,11,10,1
28,13,298,7,14,-7
28,13,299,6,22,-16
28,14,0,15,11,4
28,14,1,10,6,4
28,14,2,6,25,-19
28,14,3,5,16,-11
28,14,4,3,14,-11
28,14,5,6,18,-12
28,14,6,16,14,2
28,14,7,15,19,-4
28,14,8,10,29,-19
28,14,9,11,20,-9
28,14,10,5,23,-18
28,14,11,5,13,-8
28,14,12,11,17,-6
28,14,13,12,30,-18
28,14,14,8,12,-4
28,14,15,17,28,-11
28,14,16,10,24,-14
28,14,17,6,21,-15
28,14,18,11,7,4
28,14,19,9,28,-19
28,14,20,19,32,-13
28,14,21,11,19,-8
28,14,22,10,23,-13
28,14,23,11,14,-3
28,14,24,9,14,-5
28,14,25,16,19,-3
28,14,26,10,46,-36
28,14,27,20,28,-8
28,14,28,18,25,-7
28,14,29,3,13,-10
28,14,30,6,28,-22
28,14,31,15,24,-9
28,14,32,0,21,-21
28,14,33,4,8,-4
28,14,34,7,19,-12
28,14,35,15,16,-1
28,14,36,12,15,-3
28,14,37,12,26,-14
28,14,38,11,19,-8
28,14,39,9,24,-15
28,14,40,7,20,-13
28,14,41,15,10,5
28,14,42,3,12,-9
28,14,43,8,25,-17
28,14,44,11,15,-4
28,14,45,2,13,-11
28,14,46,12,39,-27
28,14,47,15,21,-6
28,14,48,10,19,-9
28,14,49,4,11,-7
28,14,50,14,26,-12
28,14,51,18,21,-3
28,14,52,5,29,-24
28,14,53,10,15,-5
28,14,54,17,15,2
28,14,55,7,17,-10
28,14,56,14,13,1
28,14,57,12,21,-9
28,14,58,16,11,5
28,14,59,1,19,-18
28,14,60,11,17,-6
28,14,61,6,13,-7
28,14,62,2,11,-9
28,14,63,17,15,2
28,14,64,6,19,-13
28,14,65,14,21,-7
28,14,66,3,20,-17
28,14,67,6,25,-19
28,14,68,9,19,-10
28,14,69,10,32,-22
28,14,70,4,19,-15
28,14,71,13,16,-3
28,14,72,8,32,-24
28,14,73,14,13,1
28,14,74,7,17,-10
28,14,75,14,7,7
28,14,76,10,7,3
28,14,77,10,26,-16
28,14,78,19,23,-4
28,14,79,7,14,-7
28,14,80,10,14,-4
28,14,81,8,18,-10
28,14,82,19,16,3
28,14,83,5,20,-15
28,14,84,4,25,-21
28,14,85,5,23,-18
28,14,86,16,18,-2
28,14,87,23,20,3
28,14,88,5,11,-6
28,14,89,11,19,-8
28,14,90,7,16,-9
28,14,91,4,13,-9
28,14,92,18,19,-1
28,14,93,16,19,-3
28,14,94,20,30,-10
28,14,95,6,32,-26
28,14,96,13,9,4
28,14,97,7,9,-2
28,14,98,31,27,4
28,14,99,17,19,-2
28,14,100,13,11,2
28,14,101,11,9,2
28,14,102,16,28,-12
28,14,103,2,15,-13
28,14,104,7,21,-14
28,14,105,8,12,-4
28,14,106,9,15,-6
28,14,107,5,10,-5
28,14,108,12,13,-1
28,14,109,6,23,-17
28,14,110,27,12,15
28,14,111,4,9,-5
28,14,112,10,12,-2
28,14,113,9,16,-7
28,14,114,8,18,-10
28,14,115,8,14,-6
28,14,116,7,26,-19
28,14,117,9,17,-8
28,14,118,13,14,-1
28,14,119,10,15,-5
28,14,120,19,10,9
28,14,121,14,14,0
28,14,122,18,21,-3
28,14,123,16,19,-3
28,14,124,9,14,-5
28,14,125,18,24,-6
28,14,126,8,18,-10
28,14,127,9,12,-3
28,14,128,9,16,-7
28,14,129,12,22,-10
28,14,130,22,21,1
28,14,131,8,23,-15
28,14,132,5,8,-3
28,14,133,18,20,-2
28,14,134,12,27,-15
28,14,135,14,17,-3
28,14,136,14,16,-2
28,14,137,15,10,5
28,14,138,2,7,-5
28,14,139,21,24,-3
28,14,140,5,10,-5
28,14,141,9,30,-21
28,14,142,10,23,-13
28,14,143,11,18,-7
28,14,144,15,13,2
28,14,145,5,7,-2
28,14,146,11,12,-1
28,14,147,12,12,0
28,14,148,17,22,-5
28,14,149,10,22,-12
28,14,150,7,14,-7
28,14,151,14,26,-12
28,14,152,8,9,-1
28,14,153,15,18,-3
28,14,154,8,24,-16
28,14,155,11,10,1
28,14,156,7,13,-6
28,14,157,13,13,0
28,14,158,5,19,-14
28,14,159,7,19,-12
28,14,160,11,26,-15
28,14,161,14,38,-24
28,14,162,22,22,0
28,14,163,12,29,-17
28,14,164,12,14,-2
28,14,165,14,21,-7
28,14,166,7,15,-8
28,14,167,7,18,-11
28,14,168,20,25,-5
28,14,169,6,23,-17
28,14,170,18,28,-10
28,14,171,14,29,-15
28,14,172,7,18,-11
28,14,173,10,30,-20
28,14,174,10,15,-5
28,14,175,3,26,-23
28,14,176,9,18,-9
28,14,177,7,12,-5
28,14,178,12,13,-1
28,14,179,18,27,-9
28,14,180,7,13,-6
28,14,181,3,17,-14
28,14,182,8,11,-3
28,14,183,7,17,-10
28,14,184,13,10,3
28,14,185,9,16,-7
28,14,186,11,21,-10
28,14,187,8,14,-6
28,14,188,11,14,-3
28,14,189,11,18,-7
28,14,190,6,30,-24
28,14,191,7,20,-13
28,14,192,11,19,-8
28,14,193,16,43,-27
28,14,194,4,24,-20
28,14,195,13,25,-12
28,14,196,8,22,-14
28,14,197,10,11,-1
28,14,198,9,18,-9
28,14,199,8,18,-10
28,14,200,10,13,-3
28,14,201,20,16,4
28,14,202,15,20,-5
28,14,203,13,26,-13
28,14,204,11,19,-8
28,14,205,2,20,-18
28,14,206,5,13,-8
28,14,207,13,20,-7
28,14,208,6,13,-7
28,14,209,18,17,1
28,14,210,9,16,-7
28,14,211,9,2,7
28,14,212,5,5,0
28,14,213,17,23,-6
28,14,214,12,7,5
28,14,215,3,15,-12
28,14,216,11,16,-5
28,14,217,17,24,-7
28,14,218,10,17,-7
28,14,219,3,16,-13
28,14,220,2,29,-27
28,14,221,14,16,-2
28,14,222,6,12,-6
28,14,223,7,15,-8
28,14,224,9,22,-13
28,14,225,7,11,-4
28,14,226,15,19,-4
28,14,227,8,18,-10
28,14,228,10,14,-4
28,14,229,17,17,0
28,14,230,15,20,-5
28,14,231,5,16,-11
28,14,232,15,36,-21
28,14,233,6,19,-13
28,14,234,22,26,-4
28,14,235,12,23,-11
28,14,236,9,22,-13
28,14,237,12,17,-5
28,14,238,4,16,-12
28,14,239,15,12,3
28,14,240,10,16,-6
28,14,241,14,14,0
28,14,242,25,21,4
28,14,243,8,25,-17
28,14,244,15,18,-3
28,14,245,9,22,-13
28,14,246,7,27,-20
28,14,247,11,18,-7
28,14,248,6,10,-4
28,14,249,19,29,-10
28,14,250,19,22,-3
28,14,251,11,14,-3
28,14,252,3,16,-13
28,14,253,12,31,-19
28,14,254,11,12,-1
28,14,255,3,14,-11
28,14,256,9,28,-19
28,14,257,11,22,-11
28,14,258,10,31,-21
28,14,259,16,21,-5
28,14,260,9,27,-18
28,14,261,14,15,-1
28,14,262,11,15,-4
28,14,263,9,14,-5
28,14,264,16,17,-1
28,14,265,10,22,-12
28,14,266,7,19,-12
28,14,267,5,21,-16
28,14,268,7,11,-4
28,14,269,11,13,-2
28,14,270,3,27,-24
28,14,271,10,23,-13
28,14,272,8,16,-8
28,14,273,7,17,-10
28,14,274,12,22,-10
28,14,275,7,22,-15
28,14,276,15,22,-7
28,14,277,21,17,4
28,14,278,7,9,-2
28,14,279,18,14,4
28,14,280,5,12,-7
28,14,281,6,13,-7
28,14,282,8,25,-17
28,14,283,17,17,0
28,14,284,7,19,-12
28,14,285,15,20,-5
28,14,286,6,9,-3
28,14,287,8,33,-25
28,14,288,13,23,-10
28,14,289,14,14,0
28,14,290,8,16,-8
28,14,291,17,32,-15
28,14,292,10,18,-8
28,14,293,5,6,-1
28,14,294,7,17,-10
28,14,295,10,19,-9
28,14,296,5,18,-13
28,14,297,10,19,-9
28,14,298,5,27,-22
28,14,299,18,32,-14
28,15,0,16,23,-7
28,15,1,9,12,-3
28,15,2,17,21,-4
28,15,3,4,15,-11
28,15,4,18,10,8
28,15,5,19,22,-3
28,15,6,6,18,-12
28,15,7,9,19,-10
28,15,8,13,9,4
28,15,9,15,27,-12
28,15,10,4,19,-15
28,15,11,12,22,-10
28,15,12,14,11,3
28,15,13,9,12,-3
28,15,14,9,19,-10
28,15,15,10,21,-11
28,15,16,13,34,-21
28,15,17,9,17,-8
28,15,18,9,19,-10
28,15,19,10,22,-12
28,15,20,11,24,-13
28,15,21,8,18,-10
28,15,22,10,18,-8
28,15,23,14,13,1
28,15,24,14,16,-2
28,15,25,18,23,-5
28,15,26,10,11,-1
28,15,27,6,12,-6
28,15,28,9,25,-16
28,15,29,18,17,1
28,15,30,10,19,-9
28,15,31,10,14,-4
28,15,32,7,22,-15
28,15,33,21,18,3
28,15,34,6,21,-15
28,15,35,11,37,-26
28,15,36,6,13,-7
28,15,37,2,20,-18
28,15,38,10,23,-13
28,15,39,18,19,-1
28,15,40,12,23,-11
28,15,41,11,16,-5
28,15,42,12,27,-15
28,15,43,12,10,2
28,15,44,15,31,-16
28,15,45,9,10,-1
28,15,46,13,23,-10
28,15,47,6,19,-13
28,15,48,21,28,-7
28,15,49,10,20,-10
28,15,50,9,12,-3
28,15,51,8,13,-5
28,15,52,13,25,-12
28,15,53,6,13,-7
28,15,54,8,3,5
28,15,55,17,23,-6
28,15,56,9,9,0
28,15,57,19,16,3
28,15,58,16,13,3
28,15,59,9,9,0
28,15,60,15,11,4
28,15,61,13,24,-11
28,15,62,10,16,-6
28,15,63,12,23,-11
28,15,64,15,4,11
28,15,65,12,20,-8
28,15,66,5,26,-21
28,15,67,7,5,2
28,15,68,14,7,7
28,15,69,25,21,4
28,15,70,21,26,-5
28,15,71,14,17,-3
28,15,72,5,22,-17
28,15,73,12,20,-8
28,15,74,12,14,-2
28,15,75,16,15,1
28,15,76,11,25,-14
28,15,77,9,14,-5
28,15,78,9,30,-21
28,15,79,6,17,-11
28,15,80,9,16,-7
28,15,81,8,6,2
28,15,82,17,13,4
28,15,83,16,18,-2
28,15,84,16,14,2
28,15,85,15,18,-3
28,15,86,15,23,-8
28,15,87,6,8,-2
28,15,88,7,11,-4
28,15,89,4,23,-19
28,15,90,14,17,-3
28,15,91,11,18,-7
28,15,92,10,8,2
28,15,93,20,14,6
28,15,94,7,12,-5
28,15,95,6,14,-8
28,15,96,10,22,-12
28,15,97,8,9,-1
28,15,98,5,12,-7
28,15,99,14,16,-2
28,15,100,13,21,-8
28,15,101,6,24,-18
28,15,102,20,24,-4
28,15,103,8,6,2
28,15,104,17,32,-15
28,15,105,5,25,-20
28,15,106,15,13,2
28,15,107,11,20,-9
28,15,108,18,11,7
28,15,109,7,24,-17
28,15,110,9,13,-4
28,15,111,14,27,-13
28,15,112,9,21,-12
28,15,113,7,22,-15
28,15,114,4,8,-4
28,15,115,12,26,-14
28,15,116,7,17,-10
28,15,117,27,27,0
28,15,118,16,24,-8
28,15,119,3,15,-12
28,15,120,10,14,-4
28,15,121,6,16,-10
28,15,122,12,9,3
28,15,123,18,26,-8
28,15,124,10,11,-1
28,15,125,18,27,-9
28,15,126,11,12,-1
28,15,127,14,19,-5
28,15,128,5,16,-11
28,15,129,8,23,-15
28,15,130,19,29,-10
28,15,131,20,31,-11
28,15,132,16,20,-4
28,15,133,13,24,-11
28,15,134,13,23,-10
28,15,135,10,14,-4
28,15,136,11,28,-17
28,15,137,7,6,1
28,15,138,17,20,-3
28,15,139,10,13,-3
28,15,140,9,21,-12
28,15,141,9,18,-9
28,15,142,12,27,-15
28,15,143,9,14,-5
28,15,144,13,12,1
28,15,145,5,4,1
28,15,146,18,17,1
28,15,147,5,16,-11
28,15,148,22,25,-3
28,15,149,10,29,-19
28,15,150,10,35,-25
28,15,151,10,22,-12
28,15,152,9,17,-8
28,15,153,13,23,-10
28,15,154,16,32,-16
28,15,155,2,15,-13
28,15,156,12,23,-11
28,15,157,10,10,0
28,15,158,7,18,-11
28,15,159,4,4,0
28,15,160,11,19,-8
28,15,161,18,26,-8
28,15,162,10,22,-12
28,15,163,15,21,-6
28,15,164,7,18,-11
28,15,165,10,17,-7
28,15,166,6,12,-6
28,15,167,1,14,-13
28,15,168,15,13,2
28,15,169,11,18,-7
28,15,170,11,12,-1
28,15,171,7,20,-13
28,15,172,8,22,-14
28,15,173,5,7,-2
28,15,174,15,23,-8
28,15,175,7,22,-15
28,15,176,17,13,4
28,15,177,20,24,-4
28,15,178,18,16,2
28,15,179,13,15,-2
28,15,180,14,19,-5
28,15,181,10,21,-11
28,15,182,11,9,2
28,15,183,10,15,-5
28,15,184,8,15,-7
28,15,185,7,19,-12
28,15,186,13,24,-11
28,15,187,20,16,4
28,15,188,20,27,-7
28,15,189,10,16,-6
28,15,190,14,21,-7
28,15,191,13,15,-2
28,15,192,11,29,-18
28,15,193,12,25,-13
28,15,194,17,16,1
28,15,195,11,13,-2
28,15,196,7,30,-23
28,15,197,12,16,-4
28,15,198,9,16,-7
28,15,199,17,20,-3
28,15,200,3,10,-7
28,15,201,9,17,-8
28,15,202,6,16,-10
28,15,203,22,18,4
28,15,204,11,11,0
28,15,205,9,13,-4
28,15,206,11,14,-3
28,15,207,0,18,-18
28,15,208,5,10,-5
28,15,209,8,13,-5
28,15,210,12,16,-4
28,15,211,7,24,-17
28,15,212,8,19,-11
28,15,213,14,21,-7
28,15,214,15,22,-7
28,15,215,16,22,-6
28,15,216,8,17,-9
28,15,217,18,24,-6
28,15,218,10,14,-4
28,15,219,2,20,-18
28,15,220,9,11,-2
28,15,221,8,16,-8
28,15,222,6,17,-11
28,15,223,14,22,-8
28,15,224,11,16,-5
28,15,225,5,19,-14
28,15,226,0,13,-13
28,15,227,12,25,-13
28,15,228,10,17,-7
28,15,229,11,21,-10
28,15,230,23,15,8
28,15,231,8,14,-6
28,15,232,11,12,-1
28,15,233,8,20,-12
28,15,234,13,20,-7
28,15,235,13,18,-5
28,15,236,12,8,4
28,15,237,5,11,-6
28,15,238,12,21,-9
28,15,239,3,8,-5
28,15,240,10,16,-6
28,15,241,10,27,-17
28,15,242,15,23,-8
28,15,243,13,13,0
28,15,244,10,15,-5
28,15,245,11,25,-14
28,15,246,7,19,-12
28,15,247,6,2,4
28,15,248,9,33,-24
28,15,249,14,27,-13
28,15,250,15,18,-3
28,15,251,9,19,-10
28,15,252,10,8,2
28,15,253,20,19,1
28,15,254,12,17,-5
28,15,255,14,15,-1
28,15,256,5,5,0
28,15,257,9,20,-11
28,15,258,16,20,-4
28,15,259,17,22,-5
28,15,260,11,26,-15
28,15,261,16,23,-7
28,15,262,16,27,-11
28,15,263,12,9,3
28,15,264,12,21,-9
28,15,265,12,18,-6
28,15,266,20,27,-7
28,15,267,10,18,-8
28,15,268,16,15,1
28,15,269,9,17,-8
28,15,270,8,21,-13
28,15,271,11,6,5
28,15,272,12,15,-3
28,15,273,10,9,1
28,15,274,12,28,-16
28,15,275,13,32,-19
28,15,276,13,8,5
28,15,277,9,12,-3
28,15,278,9,17,-8
28,15,279,8,31,-23
28,15,280,7,16,-9
28,15,281,9,8,1
28,15,282,18,36,-18
28,15,283,11,24,-13
28,15,284,12,16,-4
28,15,285,15,18,-3
28,15,286,8,27,-19
28,15,287,12,10,2
28,15,288,11,17,-6
28,15,289,11,22,-11
28,15,290,11,18,-7
28,15,291,12,18,-6
28,15,292,0,8,-8
28,15,293,6,12,-6
28,15,294,10,12,-2
28,15,295,8,8,0
28,15,296,17,24,-7
28,15,297,9,25,-16
28,15,298,19,19,0
28,15,299,2,17,-15
28,16,0,12,21,-9
28,16,1,15,29,-14
28,16,2,5,23,-18
28,16,3,18,24,-6
28,16,4,7,17,-10
28,16,5,16,18,-2
28,16,6,9,15,-6
28,16,7,9,15,-6
28,16,8,13,21,-8
28,16,9,10,8,2
28,16,10,8,16,-8
28,16,11,11,14,-3
28,16,12,4,10,-6
28,16,13,7,17,-10
28,16,14,6,22,-16
28,16,15,12,20,-8
28,16,16,10,20,-10
28,16,17,13,21,-8
28,16,18,18,4,14
28,16,19,20,10,10
28,16,20,13,19,-6
28,16,21,5,16,-11
28,16,22,2,5,-3
28,16,23,14,11,3
28,16,24,5,12,-7
28,16,25,4,6,-2
28,16,26,15,24,-9
28,16,27,16,24,-8
28,16,28,19,20,-1
28,16,29,11,26,-15
28,16,30,4,16,-12
28,16,31,12,17,-5
28,16,32,8,8,0
28,16,33,9,7,2
28,16,34,12,29,-17
28,16,35,8,12,-4
28,16,36,16,30,-14
28,16,37,14,25,-11
28,16,38,12,27,-15
28,16,39,6,11,-5
28,16,40,11,16,-5
28,16,41,14,21,-7
28,16,42,10,16,-6
28,16,43,10,8,2
28,16,44,13,25,-12
28,16,45,11,40,-29
28,16,46,4,12,-8
28,16,47,8,21,-13
28,16,48,11,24,-13
28,16,49,13,25,-12
28,16,50,18,23,-5
28,16,51,5,23,-18
28,16,52,18,34,-16
28,16,53,13,22,-9
28,16,54,9,11,-2
28,16,55,12,10,2
28,16,56,2,15,-13
28,16,57,7,19,-12
28,16,58,14,20,-6
28,16,59,9,17,-8
28,16,60,6,21,-15
28,16,61,11,25,-14
28,16,62,10,12,-2
28,16,63,5,20,-15
28,16,64,11,7,4
28,16,65,10,14,-4
28,16,66,2,9,-7
28,16,67,19,12,7
28,16,68,11,14,-3
28,16,69,12,21,-9
28,16,70,15,19,-4
28,16,71,6,17,-11
28,16,72,8,8,0
28,16,73,18,21,-3
28,16,74,6,21,-15
28,16,75,11,15,-4
28,16,76,24,16,8
28,16,77,11,12,-1
28,16,78,10,18,-8
28,16,79,11,15,-4
28,16,80,19,12,7
28,16,81,4,9,-5
28,16,82,11,4,7
28,16,83,19,17,2
28,16,84,11,17,-6
28,16,85,10,12,-2
28,16,86,17,34,-17
28,16,87,12,19,-7
28,16,88,9,21,-12
28,16,89,7,14,-7
28,16,90,25,24,1
28,16,91,15,14,1
28,16,92,15,24,-9
28,16,93,10,12,-2
28,16,94,0,8,-8
28,16,95,13,25,-12
28,16,96,13,33,-20
28,16,97,1,9,-8
28,16,98,19,16,3
28,16,99,10,19,-9
28,16,100,13,24,-11
28,16,101,13,11,2
28,16,102,10,15,-5
28,16,103,10,24,-14
28,16,104,11,18,-7
28,16,105,10,22,-12
28,16,106,17,18,-1
28,16,107,14,19,-5
28,16,108,5,14,-9
28,16,109,10,9,1
28,16,110,10,19,-9
28,16,111,8,16,-8
28,16,112,14,4,10
28,16,113,23,16,7
28,16,114,9,19,-10
28,16,115,14,37,-23
28,16,116,9,24,-15
28,16,117,11,15,-4
28,16,118,3,6,-3
28,16,119,9,22,-13
28,16,120,9,10,-1
28,16,121,12,16,-4
28,16,122,12,11,1
28,16,123,14,20,-6
28,16,124,10,5,5
28,16,125,13,17,-4
28,16,126,12,18,-6
28,16,127,19,26,-7
28,16,128,6,19,-13
28,16,129,7,11,-4
28,16,130,5,14,-9
28,16,131,11,24,-13
28,16,132,12,12,0
28,16,133,8,14,-6
28,16,134,7,24,-17
28,16,135,16,26,-10
28,16,136,21,27,-6
28,16,137,14,27,-13
28,16,138,11,18,-7
28,16,139,2,9,-7
28,16,140,11,19,-8
28,16,141,11,11,0
28,16,142,12,18,-6
28,16,143,10,16,-6
28,16,144,20,11,9
28,16,145,5,14,-9
28,16,146,11,17,-6
28,16,147,11,19,-8
28,16,148,12,22,-10
28,16,149,8,13,-5
28,16,150,7,14,-7
28,16,151,10,14,-4
28,16,152,6,13,-7
28,16,153,11,25,-14
28,16,154,7,14,-7
28,16,155,15,22,-7
28,16,156,12,14,-2
28,16,157,14,18,-4
28,16,158,10,21,-11
28,16,159,8,14,-6
28,16,160,8,12,-4
28,16,161,10,17,-7
28,16,162,5,17,-12
28,16,163,20,14,6
28,16,164,8,17,-9
28,16,165,11,21,-10
28,16,166,16,19,-3
28,16,167,9,22,-13
28,16,168,13,18,-5
28,16,169,8,11,-3
28,16,170,9,17,-8
28,16,171,23,23,0
28,16,172,11,27,-16
28,16,173,5,14,-9
28,16,174,15,19,-4
28,16,175,4,4,0
28,16,176,13,33,-20
28,16,177,11,14,-3
28,16,178,5,16,-11
28,16,179,3,18,-15
28,16,180,2,10,-8
28,16,181,10,21,-11
28,16,182,7,13,-6
28,16,183,6,22,-16
28,16,184,6,12,-6
28,16,185,19,18,1
28,16,186,8,35,-27
28,16,187,10,8,2
28,16,188,18,33,-15
28,16,189,12,26,-14
28,16,190,8,16,-8
28,16,191,11,19,-8
28,16,192,24,21,3
28,16,193,13,14,-1
28,16,194,16,8,8
28,16,195,9,12,-3
28,16,196,8,20,-12
28,16,197,7,20,-13
28,16,198,8,11,-3
28,16,199,14,20,-6
28,16,200,20,15,5
28,16,201,20,12,8
28,16,202,9,26,-17
28,16,203,7,23,-16
28,16,204,0,15,-15
28,16,205,5,15,-10
28,16,206,11,21,-10
28,16,207,14,24,-10
28,16,208,5,5,0
28,16,209,11,25,-14
28,16,210,4,12,-8
28,16,211,7,12,-5
28,16,212,9,3,6
28,16,213,13,20,-7
28,16,214,7,7,0
28,16,215,10,30,-20
28,16,216,7,23,-16
28,16,217,9,14,-5
28,16,218,5,23,-18
28,16,219,15,21,-6
28,16,220,11,11,0
28,16,221,0,13,-13
28,16,222,3,14,-11
28,16,223,18,17,1
28,16,224,8,9,-1
28,16,225,15,28,-13
28,16,226,13,18,-5
28,16,227,10,10,0
28,16,228,10,15,-5
28,16,229,3,7,-4
28,16,230,10,22,-12
28,16,231,17,28,-11
28,16,232,9,7,2
28,16,233,11,21,-10
28,16,234,14,23,-9
28,16,235,4,15,-11
28,16,236,13,14,-1
28,16,237,8,18,-10
28,16,238,3,20,-17
28,16,239,4,14,-10
28,16,240,7,12,-5
28,16,241,15,24,-9
28,16,242,17,10,7
28,16,243,15,14,1
28,16,244,7,14,-7
28,16,245,12,24,-12
28,16,246,5,14,-9
28,16,247,14,28,-14
28,16,248,9,15,-6
28,16,249,12,23,-11
28,16,250,13,16,-3
28,16,251,3,13,-10
28,16,252,9,18,-9
28,16,253,10,20,-10
28,16,254,2,24,-22
28,16,255,13,11,2
28,16,256,8,6,2
28,16,257,15,12,3
28,16,258,12,30,-18
28,16,259,8,27,-19
28,16,260,4,10,-6
28,16,261,9,23,-14
28,16,262,10,20,-10
28,16,263,13,9,4
28,16,264,7,15,-8
28,16,265,16,21,-5
28,16,266,9,11,-2
28,16,267,3,7,-4
28,16,268,10,25,-15
28,16,269,14,19,-5
28,16,270,8,20,-12
28,16,271,4,9,-5
28,16,272,25,20,5
28,16,273,13,14,-1
28,16,274,16,15,1
28,16,275,21,12,9
28,16,276,3,17,-14
28,16,277,10,21,-11
28,16,278,14,22,-8
28,16,279,11,23,-12
28,16,280,9,19,-10
28,16,281,10,20,-10
28,16,282,9,9,0
28,16,283,12,13,-1
28,16,284,0,14,-14
28,16,285,23,18,5
28,16,286,9,23,-14
28,16,287,5,5,0
28,16,288,2,17,-15
28,16,289,11,21,-10
28,16,290,10,27,-17
28,16,291,12,24,-12
28,16,292,15,23,-8
28,16,293,14,22,-8
28,16,294,8,16,-8
28,16,295,9,14,-5
28,16,296,13,15,-2
28,16,297,8,5,3
28,16,298,3,17,-14
28,16,299,16,9,7
28,17,0,16,21,-5
28,17,1,6,19,-13
28,17,2,15,21,-6
28,17,3,6,17,-11
28,17,4,11,12,-1
28,17,5,9,17,-8
28,17,6,7,10,-3
28,17,7,4,25,-21
28,17,8,15,20,-5
28,17,9,8,12,-4
28,17,10,13,18,-5
28,17,11,21,16,5
28,17,12,11,23,-12
28,17,13,13,17,-4
28,17,14,6,26,-20
28,17,15,9,30,-21
28,17,16,19,15,4
28,17,17,17,32,-15
28,17,18,20,22,-2
28,17,19,20,20,0
28,17,20,7,19,-12
28,17,21,4,10,-6
28,17,22,7,11,-4
28,17,23,4,8,-4
28,17,24,18,15,3
28,17,25,9,21,-12
28,17,26,12,22,-10
28,17,27,12,18,-6
28,17,28,13,14,-1
28,17,29,9,13,-4
28,17,30,13,15,-2
28,17,31,15,17,-2
28,17,32,11,17,-6
28,17,33,14,20,-6
28,17,34,9,9,0
28,17,35,7,15,-8
28,17,36,16,27,-11
28,17,37,16,19,-3
28,17,38,13,12,1
28,17,39,25,19,6
28,17,40,25,12,13
28,17,41,11,16,-5
28,17,42,14,15,-1
28,17,43,18,12,6
28,17,44,15,14,1
28,17,45,12,21,-9
28,17,46,5,10,-5
28,17,47,12,12,0
28,17,48,14,18,-4
28,17,49,20,19,1
28,17,50,18,25,-7
28,17,51,11,19,-8
28,17,52,13,21,-8
28,17,53,11,15,-4
28,17,54,19,18,1
28,17,55,6,10,-4
28,17,56,9,17,-8
28,17,57,8,18,-10
28,17,58,3,24,-21
28,17,59,11,20,-9
28,17,60,17,12,5
28,17,61,13,22,-9
28,17,62,17,31,-14
28,17,63,5,15,-10
28,17,64,8,25,-17
28,17,65,19,15,4
28,17,66,7,9,-2
28,17,67,12,16,-4
28,17,68,7,22,-15
28,17,69,8,16,-8
28,17,70,20,15,5
28,17,71,4,7,-3
28,17,72,15,26,-11
28,17,73,11,21,-10
28,17,74,14,15,-1
28,17,75,9,17,-8
28,17,76,4,16,-12
28,17,77,7,8,-1
28,17,78,15,9,6
28,17,79,21,19,2
28,17,80,12,11,1
28,17,81,12,20,-8
28,17,82,14,17,-3
28,17,83,14,17,-3
28,17,84,10,7,3
28,17,85,13,21,-8
28,17,86,10,4,6
28,17,87,7,14,-7
28,17,88,10,10,0
28,17,89,4,24,-20
28,17,90,6,12,-6
28,17,91,14,9,5
28,17,92,12,20,-8
28,17,93,10,23,-13
28,17,94,12,15,-3
28,17,95,22,16,6
28,17,96,19,32,-13
28,17,97,15,15,0
28,17,98,7,14,-7
28,17,99,9,26,-17
28,17,100,5,4,1
28,17,101,12,19,-7
28,17,102,16,26,-10
28,17,103,14,20,-6
28,17,104,11,16,-5
28,17,105,9,22,-13
28,17,106,11,21,-10
28,17,107,13,22,-9
28,17,108,11,10,1
28,17,109,18,28,-10
28,17,110,11,14,-3
28,17,111,11,20,-9
28,17,112,10,14,-4
28,17,113,9,20,-11
28,17,114,10,12,-2
28,17,115,7,17,-10
28,17,116,9,7,2
28,17,117,9,6,3
28,17,118,6,10,-4
28,17,119,9,26,-17
28,17,120,18,16,2
28,17,121,23,23,0
28,17,122,9,4,5
28,17,123,14,15,-1
28,17,124,15,20,-5
28,17,125,18,8,10
28,17,126,1,14,-13
28,17,127,4,11,-7
28,17,128,4,9,-5
28,17,129,7,22,-15
28,17,130,9,17,-8
28,17,131,12,23,-11
28,17,132,12,16,-4
28,17,133,14,21,-7
28,17,134,9,19,-10
28,17,135,14,10,4
28,17,136,9,16,-7
28,17,137,7,24,-17
28,17,138,5,23,-18
28,17,139,6,13,-7
28,17,140,15,19,-4
28,17,141,15,16,-1
28,17,142,2,6,-4
28,17,143,19,20,-1
28,17,144,12,19,-7
28,17,145,11,20,-9
28,17,146,12,17,-5
28,17,147,8,11,-3
28,17,148,14,10,4
28,17,149,8,22,-14
28,17,150,11,20,-9
28,17,151,10,13,-3
28,17,152,4,18,-14
28,17,153,11,15,-4
28,17,154,9,17,-8
28,17,155,15,29,-14
28,17,156,7,8,-1
28,17,157,10,18,-8
28,17,158,10,27,-17
28,17,159,16,22,-6
28,17,160,7,14,-7
28,17,161,13,10,3
28,17,162,7,14,-7
28,17,163,14,11,3
28,17,164,1,25,-24
28,17,165,8,20,-12
28,17,166,16,8,8
28,17,167,14,16,-2
28,17,168,19,29,-10
28,17,169,22,30,-8
28,17,170,7,18,-11
28,17,171,10,22,-12
28,17,172,4,11,-7
28,17,173,5,18,-13
28,17,174,12,24,-12
28,17,175,7,11,-4
28,17,176,10,14,-4
28,17,177,3,11,-8
28,17,178,14,24,-10
28,17,179,14,23,-9
28,17,180,14,14,0
28,17,181,8,26,-18
28,17,182,19,24,-5
28,17,183,4,12,-8
28,17,184,15,14,1
28,17,185,13,22,-9
28,17,186,17,25,-8
28,17,187,11,20,-9
28,17,188,8,15,-7
28,17,189,17,24,-7
28,17,190,7,10,-3
28,17,191,6,10,-4
28,17,192,17,19,-2
28,17,193,8,18,-10
28,17,194,5,19,-14
28,17,195,22,14,8
28,17,196,4,12,-8
28,17,197,4,11,-7
28,17,198,8,17,-9
28,17,199,13,17,-4
28,17,200,8,7,1
28,17,201,7,22,-15
28,17,202,8,10,-2
28,17,203,11,25,-14
28,17,204,14,10,4
28,17,205,5,20,-15
28,17,206,17,23,-6
28,17,207,9,28,-19
28,17,208,12,27,-15
28,17,209,8,14,-6
28,17,210,15,25,-10
28,17,211,2,10,-8
28,17,212,21,21,0
28,17,213,7,13,-6
28,17,214,5,12,-7
28,17,215,4,8,-4
28,17,216,10,11,-1
28,17,217,16,26,-10
28,17,218,8,23,-15
28,17,219,11,30,-19
28,17,220,4,14,-10
28,17,221,21,21,0
28,17,222,9,15,-6
28,17,223,8,14,-6
28,17,224,4,14,-10
28,17,225,19,12,7
28,17,226,13,40,-27
28,17,227,12,26,-14
28,17,228,6,18,-12
28,17,229,16,13,3
28,17,230,20,20,0
28,17,231,17,11,6
28,17,232,9,24,-15
28,17,233,10,20,-10
28,17,234,10,13,-3
28,17,235,15,25,-10
28,17,236,2,18,-16
28,17,237,13,10,3
28,17,238,17,25,-8
28,17,239,5,17,-12
28,17,240,9,12,-3
28,17,241,3,10,-7
28,17,242,13,28,-15
28,17,243,11,15,-4
28,17,244,8,17,-9
28,17,245,2,14,-12
28,17,246,6,24,-18
28,17,247,12,28,-16
28,17,248,12,13,-1
28,17,249,14,15,-1
28,17,250,8,22,-14
28,17,251,12,19,-7
28,17,252,22,23,-1
28,17,253,13,13,0
28,17,254,11,4,7
28,17,255,12,24,-12
28,17,256,16,14,2
28,17,257,11,11,0
28,17,258,6,19,-13
28,17,259,10,5,5
28,17,260,8,23,-15
28,17,261,8,17,-9
28,17,262,14,12,2
28,17,263,20,23,-3
28,17,264,8,23,-15
28,17,265,9,15,-6
28,17,266,5,21,-16
28,17,267,14,18,-4
28,17,268,13,3,10
28,17,269,13,17,-4
28,17,270,9,19,-10
28,17,271,9,9,0
28,17,272,11,11,0
28,17,273,9,12,-3
28,17,274,3,17,-14
28,17,275,11,14,-3
28,17,276,11,16,-5
28,17,277,12,8,4
28,17,278,9,11,-2
28,17,279,10,22,-12
28,17,280,11,17,-6
28,17,281,4,17,-13
28,17,282,7,8,-1
28,17,283,26,23,3
28,17,284,15,17,-2
28,17,285,5,16,-11
28,17,286,14,16,-2
28,17,287,22,20,2
28,17,288,6,17,-11
28,17,289,5,14,-9
28,17,290,11,11,0
28,17,291,8,9,-1
28,17,292,14,14,0
28,17,293,13,18,-5
28,17,294,12,13,-1
28,17,295,18,16,2
28,17,296,16,13,3
28,17,297,7,26,-19
28,17,298,5,8,-3
28,17,299,9,10,-1
28,18,0,14,17,-3
28,18,1,14,12,2
28,18,2,14,6,8
28,18,3,22,17,5
28,18,4,10,24,-14
28,18,5,17,30,-13
28,18,6,6,7,-1
28,18,7,11,18,-7
28,18,8,13,13,0
28,18,9,11,13,-2
28,18,10,16,10,6
28,18,11,7,13,-6
28,18,12,4,7,-3
28,18,13,11,17,-6
28,18,14,5,17,-12
28,18,15,10,8,2
28,18,16,17,27,-10
28,18,17,9,24,-15
28,18,18,13,19,-6
28,18,19,11,11,0
28,18,20,7,28,-21
28,18,21,6,20,-14
28,18,22,18,28,-10
28,18,23,12,24,-12
28,18,24,6,14,-8
28,18,25,12,23,-11
28,18,26,15,30,-15
28,18,27,12,13,-1
28,18,28,9,13,-4
28,18,29,19,13,6
28,18,30,5,11,-6
28,18,31,32,36,-4
28,18,32,10,19,-9
28,18,33,5,11,-6
28,18,34,15,8,7
28,18,35,10,15,-5
28,18,36,6,8,-2
28,18,37,9,20,-11
28,18,38,12,6,6
28,18,39,8,9,-1
28,18,40,13,22,-9
28,18,41,17,17,0
28,18,42,11,11,0
28,18,43,16,27,-11
28,18,44,3,21,-18
28,18,45,8,14,-6
28,18,46,14,13,1
28,18,47,9,13,-4
28,18,48,19,23,-4
28,18,49,8,16,-8
28,18,50,13,24,-11
28,18,51,11,19,-8
28,18,52,11,12,-1
28,18,53,1,10,-9
28,18,54,8,11,-3
28,18,55,3,16,-13
28,18,56,25,22,3
28,18,57,10,16,-6
28,18,58,5,16,-11
28,18,59,11,13,-2
28,18,60,9,13,-4
28,18,61,11,14,-3
28,18,62,7,25,-18
28,18,63,10,14,-4
28,18,64,14,27,-13
28,18,65,10,14,-4
28,18,66,27,20,7
28,18,67,11,9,2
28,18,68,19,14,5
28,18,69,11,12,-1
28,18,70,13,13,0
28,18,71,16,13,3
28,18,72,7,5,2
28,18,73,7,10,-3
28,18,74,9,19,-10
28,18,75,6,16,-10
28,18,76,7,17,-10
28,18,77,7,23,-16
28,18,78,10,10,0
28,18,79,10,18,-8
28,18,80,17,23,-6
28,18,81,10,11,-1
28,18,82,18,19,-1
28,18,83,16,26,-10
28,18,84,12,15,-3
28,18,85,9,20,-11
28,18,86,12,15,-3
28,18,87,5,24,-19
28,18,88,10,11,-1
28,18,89,11,25,-14
28,18,90,11,12,-1
28,18,91,15,21,-6
28,18,92,7,19,-12
28,18,93,17,20,-3
28,18,94,6,18,-12
28,18,95,11,14,-3
28,18,96,12,18,-6
28,18,97,13,18,-5
28,18,98,10,9,1
28,18,99,15,21,-6
28,18,100,11,13,-2
28,18,101,10,25,-15
28,18,102,12,9,3
28,18,103,12,16,-4
28,18,104,4,11,-7
28,18,105,5,10,-5
28,18,106,8,16,-8
28,18,107,8,12,-4
28,18,108,22,19,3
28,18,109,8,18,-10
28,18,110,18,22,-4
28,18,111,20,12,8
28,18,112,4,14,-10
28,18,113,8,19,-11
28,18,114,9,32,-23
28,18,115,14,9,5
28,18,116,12,28,-16
28,18,117,11,16,-5
28,18,118,16,11,5
28,18,119,14,22,-8
28,18,120,17,11,6
28,18,121,6,15,-9
28,18,122,17,21,-4
28,18,123,5,20,-15
28,18,124,13,18,-5
28,18,125,15,17,-2
28,18,126,10,17,-7
28,18,127,25,19,6
28,18,128,10,21,-11
28,18,129,7,3,4
28,18,130,10,15,-5
28,18,131,11,28,-17
28,18,132,28,19,9
28,18,133,17,20,-3
28,18,134,13,18,-5
28,18,135,21,11,10
28,18,136,20,29,-9
28,18,137,12,17,-5
28,18,138,10,11,-1
28,18,139,26,9,17
28,18,140,15,21,-6
28,18,141,6,8,-2
28,18,142,7,16,-9
28,18,143,19,18,1
28,18,144,5,14,-9
28,18,145,20,18,2
28,18,146,13,13,0
28,18,147,7,8,-1
28,18,148,11,27,-16
28,18,149,12,25,-13
28,18,150,9,28,-19
28,18,151,5,23,-18
28,18,152,5,3,2
28,18,153,10,19,-9
28,18,154,13,11,2
28,18,155,12,13,-1
28,18,156,10,18,-8
28,18,157,14,16,-2
28,18,158,11,12,-1
28,18,159,15,11,4
28,18,160,20,8,12
28,18,161,15,14,1
28,18,162,17,12,5
28,18,163,17,21,-4
28,18,164,7,6,1
28,18,165,4,16,-12
28,18,166,9,16,-7
28,18,167,14,25,-11
28,18,168,7,19,-12
28,18,169,13,12,1
28,18,170,17,25,-8
28,18,171,3,8,-5
28,18,172,9,11,-2
28,18,173,14,14,0
28,18,174,16,9,7
28,18,175,10,11,-1
28,18,176,18,15,3
28,18,177,16,29,-13
28,18,178,3,14,-11
28,18,179,8,9,-1
28,18,180,15,16,-1
28,18,181,13,19,-6
28,18,182,4,9,-5
28,18,183,6,10,-4
28,18,184,18,23,-5
28,18,185,11,19,-8
28,18,186,8,21,-13
28,18,187,14,18,-4
28,18,188,14,15,-1
28,18,189,18,19,-1
28,18,190,11,16,-5
28,18,191,10,40,-30
28,18,192,12,11,1
28,18,193,18,9,9
28,18,194,6,17,-11
28,18,195,11,14,-3
28,18,196,3,10,-7
28,18,197,14,18,-4
28,18,198,11,10,1
28,18,199,14,15,-1
28,18,200,12,19,-7
28,18,201,7,11,-4
28,18,202,16,29,-13
28,18,203,14,21,-7
28,18,204,16,26,-10
28,18,205,12,16,-4
28,18,206,22,24,-2
28,18,207,12,16,-4
28,18,208,16,27,-11
28,18,209,9,13,-4
28,18,210,2,11,-9
28,18,211,14,14,0
28,18,212,20,20,0
28,18,213,7,11,-4
28,18,214,4,21,-17
28,18,215,17,15,2
28,18,216,7,14,-7
28,18,217,6,15,-9
28,18,218,7,14,-7
28,18,219,11,10,1
28,18,220,11,18,-7
28,18,221,16,24,-8
28,18,222,9,22,-13
28,18,223,8,9,-1
28,18,224,8,14,-6
28,18,225,12,21,-9
28,18,226,13,27,-14
28,18,227,18,29,-11
28,18,228,10,18,-8
28,18,229,11,21,-10
28,18,230,5,7,-2
28,18,231,9,25,-16
28,18,232,11,8,3
28,18,233,11,18,-7
28,18,234,2,13,-11
28,18,235,10,20,-10
28,18,236,14,29,-15
28,18,237,6,6,0
28,18,238,16,19,-3
28,18,239,11,14,-3
28,18,240,14,17,-3
28,18,241,11,13,-2
28,18,242,4,12,-8
28,18,243,26,22,4
28,18,244,9,13,-4
28,18,245,10,18,-8
28,18,246,13,34,-21
28,18,247,9,7,2
28,18,248,2,10,-8
28,18,249,7,8,-1
28,18,250,8,13,-5
28,18,251,5,32,-27
28,18,252,15,15,0
28,18,253,10,10,0
28,18,254,17,33,-16
28,18,255,8,24,-16
28,18,256,18,25,-7
28,18,257,25,22,3
28,18,258,9,12,-3
28,18,259,10,7,3
28,18,260,5,10,-5
28,18,261,14,21,-7
28,18,262,13,9,4
28,18,263,13,12,1
28,18,264,17,21,-4
28,18,265,18,27,-9
28,18,266,8,13,-5
28,18,267,8,12,-4
28,18,268,15,19,-4
28,18,269,11,18,-7
28,18,270,21,23,-2
28,18,271,4,19,-15
28,18,272,12,18,-6
28,18,273,5,26,-21
28,18,274,15,18,-3
28,18,275,10,2,8
28,18,276,15,19,-4
28,18,277,17,25,-8
28,18,278,6,10,-4
28,18,279,8,13,-5
28,18,280,22,23,-1
28,18,281,3,14,-11
28,18,282,9,9,0
28,18,283,18,18,0
28,18,284,12,15,-3
28,18,285,6,12,-6
28,18,286,15,9,6
28,18,287,5,12,-7
28,18,288,11,12,-1
28,18,289,7,15,-8
28,18,290,7,19,-12
28,18,291,11,15,-4
28,18,292,3,11,-8
28,18,293,11,11,0
28,18,294,9,23,-14
28,18,295,9,10,-1
28,18,296,18,18,0
28,18,297,15,27,-12
28,18,298,13,30,-17
28,18,299,10,21,-11
28,19,0,7,21,-14
28,19,1,11,23,-12
28,19,2,18,23,-5
28,19,3,11,19,-8
28,19,4,8,12,-4
28,19,5,13,13,0
28,19,6,18,20,-2
28,19,7,15,27,-12
28,19,8,9,29,-20
28,19,9,9,20,-11
28,19,10,21,17,4
28,19,11,6,9,-3
28,19,12,17,18,-1
28,19,13,11,16,-5
28,19,14,13,14,-1
28,19,15,16,14,2
28,19,16,3,7,-4
28,19,17,16,11,5
28,19,18,6,13,-7
28,19,19,8,16,-8
28,19,20,9,24,-15
28,19,21,12,17,-5
28,19,22,3,11,-8
28,19,23,5,12,-7
28,19,24,4,6,-2
28,19,25,26,33,-7
28,19,26,11,21,-10
28,19,27,16,21,-5
28,19,28,15,28,-13
28,19,29,13,24,-11
28,19,30,7,21,-14
28,19,31,13,24,-11
28,19,32,12,19,-7
28,19,33,7,12,-5
28,19,34,5,24,-19
28,19,35,13,11,2
28,19,36,7,10,-3
28,19,37,20,15,5
28,19,38,6,14,-8
28,19,39,5,12,-7
28,19,40,11,20,-9
28,19,41,13,23,-10
28,19,42,9,12,-3
28,19,43,11,16,-5
28,19,44,12,11,1
28,19,45,16,23,-7
28,19,46,8,19,-11
28,19,47,8,14,-6
28,19,48,11,13,-2
28,19,49,8,12,-4
28,19,50,7,16,-9
28,19,51,8,10,-2
28,19,52,8,23,-15
28,19,53,14,37,-23
28,19,54,7,18,-11
28,19,55,17,12,5
28,19,56,21,24,-3
28,19,57,10,12,-2
28,19,58,7,11,-4
28,19,59,21,15,6
28,19,60,9,24,-15
28,19,61,18,14,4
28,19,62,7,14,-7
28,19,63,3,18,-15
28,19,64,9,15,-6
28,19,65,7,8,-1
28,19,66,12,10,2
28,19,67,10,22,-12
28,19,68,6,5,1
28,19,69,14,13,1
28,19,70,11,16,-5
28,19,71,15,22,-7
28,19,72,10,15,-5
28,19,73,11,16,-5
28,19,74,8,11,-3
28,19,75,6,11,-5
28,19,76,10,17,-7
28,19,77,11,10,1
28,19,78,12,13,-1
28,19,79,9,14,-5
28,19,80,18,23,-5
28,19,81,11,13,-2
28,19,82,6,21,-15
28,19,83,8,20,-12
28,19,84,14,27,-13
28,19,85,15,21,-6
28,19,86,9,27,-18
28,19,87,14,14,0
28,19,88,8,11,-3
28,19,89,5,5,0
28,19,90,6,9,-3
28,19,91,17,25,-8
28,19,92,3,10,-7
28,19,93,6,15,-9
28,19,94,8,15,-7
28,19,95,12,17,-5
28,19,96,3,16,-13
28,19,97,1,23,-22
28,19,98,9,13,-4
28,19,99,8,18,-10
28,19,100,13,10,3
28,19,101,4,3,1
28,19,102,11,21,-10
28,19,103,15,25,-10
28,19,104,10,23,-13
28,19,105,12,17,-5
28,19,106,15,15,0
28,19,107,15,11,4
28,19,108,4,13,-9
28,19,109,11,18,-7
28,19,110,19,20,-1
28,19,111,12,31,-19
28,19,112,7,17,-10
28,19,113,4,22,-18
28,19,114,16,32,-16
28,19,115,8,22,-14
28,19,116,7,7,0
28,19,117,16,18,-2
28,19,118,7,10,-3
28,19,119,7,18,-11
28,19,120,9,14,-5
28,19,121,9,12,-3
28,19,122,11,18,-7
28,19,123,8,8,0
28,19,124,11,13,-2
28,19,125,19,13,6
28,19,126,12,9,3
28,19,127,14,17,-3
28,19,128,22,20,2
28,19,129,16,14,2
28,19,130,15,39,-24
28,19,131,15,28,-13
28,19,132,7,19,-12
28,19,133,7,25,-18
28,19,134,15,19,-4
28,19,135,13,10,3
28,19,136,9,16,-7
28,19,137,11,25,-14
28,19,138,9,13,-4
28,19,139,11,12,-1
28,19,140,10,17,-7
28,19,141,21,26,-5
28,19,142,10,20,-10
28,19,143,14,12,2
28,19,144,12,19,-7
28,19,145,12,16,-4
28,19,146,14,28,-14
28,19,147,9,13,-4
28,19,148,6,19,-13
28,19,149,16,36,-20
28,19,150,14,17,-3
28,19,151,10,6,4
28,19,152,14,18,-4
28,19,153,11,31,-20
28,19,154,8,26,-18
28,19,155,15,19,-4
28,19,156,13,43,-30
28,19,157,10,17,-7
28,19,158,7,19,-12
28,19,159,18,18,0
28,19,160,4,8,-4
28,19,161,13,17,-4
28,19,162,6,17,-11
28,19,163,8,21,-13
28,19,164,13,15,-2
28,19,165,18,25,-7
28,19,166,8,17,-9
28,19,167,15,18,-3
28,19,168,15,13,2
28,19,169,14,24,-10
28,19,170,6,8,-2
28,19,171,14,19,-5
28,19,172,18,24,-6
28,19,173,8,22,-14
28,19,174,4,17,-13
28,19,175,11,16,-5
28,19,176,13,20,-7
28,19,177,10,16,-6
28,19,178,12,17,-5
28,19,179,16,14,2
28,19,180,10,20,-10
28,19,181,10,20,-10
28,19,182,14,11,3
28,19,183,15,10,5
28,19,184,10,10,0
28,19,185,12,4,8
28,19,186,13,28,-15
28,19,187,17,27,-10
28,19,188,8,14,-6
28,19,189,12,23,-11
28,19,190,24,19,5
28,19,191,22,12,10
28,19,192,9,21,-12
28,19,193,13,9,4
28,19,194,7,19,-12
28,19,195,9,15,-6
28,19,196,2,19,-17
28,19,197,9,12,-3
28,19,198,2,14,-12
28,19,199,5,17,-12
28,19,200,12,19,-7
28,19,201,5,12,-7
28,19,202,16,13,3
28,19,203,12,19,-7
28,19,204,11,16,-5
28,19,205,16,21,-5
28,19,206,23,24,-1
28,19,207,16,29,-13
28,19,208,7,21,-14
28,19,209,3,15,-12
28,19,210,15,25,-10
28,19,211,22,25,-3
28,19,212,11,24,-13
28,19,213,18,19,-1
28,19,214,13,20,-7
28,19,215,9,17,-8
28,19,216,11,29,-18
28,19,217,9,16,-7
28,19,218,9,14,-5
28,19,219,17,13,4
28,19,220,8,16,-8
28,19,221,7,19,-12
28,19,222,13,27,-14
28,19,223,16,27,-11
28,19,224,12,25,-13
28,19,225,11,7,4
28,19,226,8,12,-4
28,19,227,21,14,7
28,19,228,18,21,-3
28,19,229,14,20,-6
28,19,230,10,15,-5
28,19,231,10,15,-5
28,19,232,11,23,-12
28,19,233,4,19,-15
28,19,234,5,14,-9
28,19,235,7,10,-3
28,19,236,9,17,-8
28,19,237,14,4,10
28,19,238,13,32,-19
28,19,239,14,19,-5
28,19,240,19,9,10
28,19,241,5,10,-5
28,19,242,9,16,-7
28,19,243,6,11,-5
28,19,244,14,16,-2
28,19,245,11,12,-1
28,19,246,7,12,-5
28,19,247,13,11,2
28,19,248,8,7,1
28,19,249,7,15,-8
28,19,250,8,17,-9
28,19,251,16,24,-8
28,19,252,10,18,-8
28,19,253,9,11,-2
28,19,254,13,20,-7
28,19,255,13,21,-8
28,19,256,13,20,-7
28,19,257,10,13,-3
28,19,258,14,22,-8
28,19,259,8,10,-2
28,19,260,14,17,-3
28,19,261,12,11,1
28,19,262,14,11,3
28,19,263,23,33,-10
28,19,264,12,11,1
28,19,265,13,23,-10
28,19,266,5,24,-19
28,19,267,12,19,-7
28,19,268,14,23,-9
28,19,269,7,10,-3
28,19,270,7,13,-6
28,19,271,13,8,5
28,19,272,10,11,-1
28,19,273,13,12,1
28,19,274,9,15,-6
28,19,275,8,5,3
28,19,276,16,15,1
28,19,277,6,12,-6
28,19,278,12,24,-12
28,19,279,10,12,-2
28,19,280,19,20,-1
28,19,281,6,19,-13
28,19,282,19,16,3
28,19,283,13,13,0
28,19,284,12,10,2
28,19,285,16,24,-8
28,19,286,13,18,-5
28,19,287,6,23,-17
28,19,288,8,7,1
28,19,289,13,5,8
28,19,290,10,23,-13
28,19,291,4,5,-1
28,19,292,7,22,-15
28,19,293,4,13,-9
28,19,294,6,12,-6
28,19,295,3,16,-13
28,19,296,15,13,2
28,19,297,17,5,12
28,19,298,8,23,-15
28,19,299,5,16,-11
28,20,0,10,15,-5
28,20,1,7,7,0
28,20,2,22,19,3
28,20,3,10,9,1
28,20,4,14,15,-1
28,20,5,12,15,-3
28,20,6,7,9,-2
28,20,7,16,37,-21
28,20,8,27,22,5
28,20,9,6,21,-15
28,20,10,8,12,-4
28,20,11,26,17,9
28,20,12,10,18,-8
28,20,13,3,10,-7
28,20,14,16,41,-25
28,20,15,9,16,-7
28,20,16,3,14,-11
28,20,17,13,8,5
28,20,18,13,18,-5
28,20,19,13,14,-1
28,20,20,14,17,-3
28,20,21,16,22,-6
28,20,22,14,19,-5
28,20,23,15,18,-3
28,20,24,14,15,-1
28,20,25,22,16,6
28,20,26,20,12,8
28,20,27,14,13,1
28,20,28,3,10,-7
28,20,29,14,19,-5
28,20,30,8,15,-7
28,20,31,13,15,-2
28,20,32,9,8,1
28,20,33,13,23,-10
28,20,34,22,18,4
28,20,35,9,13,-4
28,20,36,19,13,6
28,20,37,7,21,-14
28,20,38,20,24,-4
28,20,39,9,5,4
28,20,40,6,18,-12
28,20,41,11,31,-20
28,20,42,13,17,-4
28,20,43,8,34,-26
28,20,44,14,17,-3
28,20,45,11,22,-11
28,20,46,15,12,3
28,20,47,12,18,-6
28,20,48,6,14,-8
28,20,49,13,28,-15
28,20,50,15,17,-2
28,20,51,8,28,-20
28,20,52,13,15,-2
28,20,53,10,22,-12
28,20,54,10,25,-15
28,20,55,12,11,1
28,20,56,10,32,-22
28,20,57,9,12,-3
28,20,58,2,16,-14
28,20,59,4,10,-6
28,20,60,8,12,-4
28,20,61,18,17,1
28,20,62,2,7,-5
28,20,63,16,18,-2
28,20,64,11,9,2
28,20,65,11,16,-5
28,20,66,15,14,1
28,20,67,14,17,-3
28,20,68,21,16,5
28,20,69,6,15,-9
28,20,70,4,7,-3
28,20,71,6,11,-5
28,20,72,11,21,-10
28,20,73,13,13,0
28,20,74,8,9,-1
28,20,75,10,14,-4
28,20,76,7,13,-6
28,20,77,12,5,7
28,20,78,13,10,3
28,20,79,11,18,-7
28,20,80,17,11,6
28,20,81,8,18,-10
28,20,82,16,21,-5
28,20,83,3,22,-19
28,20,84,20,12,8
28,20,85,8,10,-2
28,20,86,16,14,2
28,20,87,9,14,-5
28,20,88,5,17,-12
28,20,89,7,16,-9
28,20,90,2,7,-5
28,20,91,12,28,-16
28,20,92,5,14,-9
28,20,93,14,10,4
28,20,94,11,14,-3
28,20,95,9,14,-5
28,20,96,12,15,-3
28,20,97,21,20,1
28,20,98,16,10,6
28,20,99,9,22,-13
28,20,100,12,21,-9
28,20,101,9,13,-4
28,20,102,4,18,-14
28,20,103,20,11,9
28,20,104,10,12,-2
28,20,105,9,11,-2
28,20,106,6,28,-22
28,20,107,3,7,-4
28,20,108,15,17,-2
28,20,109,21,10,11
28,20,110,14,15,-1
28,20,111,10,15,-5
28,20,112,7,14,-7
28,20,113,12,17,-5
28,20,114,18,17,1
28,20,115,8,5,3
28,20,116,18,31,-13
28,20,117,3,8,-5
28,20,118,21,14,7
28,20,119,9,21,-12
28,20,120,9,18,-9
28,20,121,16,25,-9
28,20,122,4,13,-9
28,20,123,7,13,-6
28,20,124,13,20,-7
28,20,125,8,11,-3
28,20,126,9,12,-3
28,20,127,12,9,3
28,20,128,15,29,-14
28,20,129,15,19,-4
28,20,130,9,25,-16
28,20,131,5,19,-14
28,20,132,20,12,8
28,20,133,7,33,-26
28,20,134,7,17,-10
28,20,135,15,20,-5
28,20,136,1,7,-6
28,20,137,9,19,-10
28,20,138,19,26,-7
28,20,139,5,8,-3
28,20,140,13,23,-10
28,20,141,15,15,0
28,20,142,4,6,-2
28,20,143,12,21,-9
28,20,144,10,12,-2
28,20,145,15,28,-13
28,20,146,6,30,-24
28,20,147,12,17,-5
28,20,148,12,22,-10
28,20,149,6,12,-6
28,20,150,10,15,-5
28,20,151,17,12,5
28,20,152,14,31,-17
28,20,153,12,18,-6
28,20,154,8,21,-13
28,20,155,15,24,-9
28,20,156,10,4,6
28,20,157,19,7,12
28,20,158,15,20,-5
28,20,159,9,18,-9
28,20,160,16,36,-20
28,20,161,8,14,-6
28,20,162,15,13,2
28,20,163,10,19,-9
28,20,164,12,10,2
28,20,165,15,15,0
28,20,166,15,12,3
28,20,167,19,23,-4
28,20,168,14,22,-8
28,20,169,9,19,-10
28,20,170,13,17,-4
28,20,171,20,25,-5
28,20,172,15,33,-18
28,20,173,7,24,-17
28,20,174,8,12,-4
28,20,175,3,5,-2
28,20,176,5,18,-13
28,20,177,13,27,-14
28,20,178,11,25,-14
28,20,179,7,8,-1
28,20,180,8,12,-4
28,20,181,17,16,1
28,20,182,13,29,-16
28,20,183,7,8,-1
28,20,184,7,11,-4
28,20,185,14,12,2
28,20,186,19,14,5
28,20,187,8,21,-13
28,20,188,14,19,-5
28,20,189,7,32,-25
28,20,190,7,13,-6
28,20,191,17,20,-3
28,20,192,8,21,-13
28,20,193,7,22,-15
28,20,194,10,11,-1
28,20,195,21,29,-8
28,20,196,14,11,3
28,20,197,7,15,-8
28,20,198,2,14,-12
28,20,199,11,18,-7
28,20,200,4,4,0
28,20,201,6,24,-18
28,20,202,11,13,-2
28,20,203,9,23,-14
28,20,204,2,18,-16
28,20,205,11,11,0
28,20,206,10,17,-7
28,20,207,12,8,4
28,20,208,4,16,-12
28,20,209,10,11,-1
28,20,210,12,4,8
28,20,211,9,11,-2
28,20,212,6,21,-15
28,20,213,5,12,-7
28,20,214,12,17,-5
28,20,215,5,22,-17
28,20,216,11,12,-1
28,20,217,8,24,-16
28,20,218,18,31,-13
28,20,219,5,17,-12
28,20,220,6,11,-5
28,20,221,19,22,-3
28,20,222,9,16,-7
28,20,223,17,14,3
28,20,224,9,20,-11
28,20,225,17,24,-7
28,20,226,14,21,-7
28,20,227,6,15,-9
28,20,228,18,19,-1
28,20,229,14,30,-16
28,20,230,22,17,5
28,20,231,5,19,-14
28,20,232,11,13,-2
28,20,233,17,28,-11
28,20,234,20,18,2
28,20,235,15,8,7
28,20,236,9,15,-6
28,20,237,9,18,-9
28,20,238,9,13,-4
28,20,239,15,21,-6
28,20,240,2,17,-15
28,20,241,14,20,-6
28,20,242,12,23,-11
28,20,243,11,12,-1
28,20,244,27,26,1
28,20,245,12,21,-9
28,20,246,11,28,-17
28,20,247,23,21,2
28,20,248,10,26,-16
28,20,249,19,18,1
28,20,250,7,16,-9
28,20,251,19,33,-14
28,20,252,14,9,5
28,20,253,11,21,-10
28,20,254,11,13,-2
28,20,255,11,21,-10
28,20,256,12,25,-13
28,20,257,16,7,9
28,20,258,8,6,2
28,20,259,8,14,-6
28,20,260,14,25,-11
28,20,261,3,13,-10
28,20,262,3,10,-7
28,20,263,9,8,1
28,20,264,6,25,-19
28,20,265,8,18,-10
28,20,266,14,8,6
28,20,267,8,20,-12
28,20,268,18,17,1
28,20,269,21,20,1
28,20,270,13,16,-3
28,20,271,14,12,2
28,20,272,13,11,2
28,20,273,12,11,1
28,20,274,4,22,-18
28,20,275,7,16,-9
28,20,276,12,21,-9
28,20,277,21,21,0
28,20,278,14,25,-11
28,20,279,16,15,1
28,20,280,16,14,2
28,20,281,7,13,-6
28,20,282,16,14,2
28,20,283,11,15,-4
28,20,284,15,14,1
28,20,285,9,15,-6
28,20,286,15,15,0
28,20,287,10,10,0
28,20,288,16,20,-4
28,20,289,26,14,12
28,20,290,11,14,-3
28,20,291,22,29,-7
28,20,292,9,22,-13
28,20,293,2,12,-10
28,20,294,11,6,5
28,20,295,20,9,11
28,20,296,10,11,-1
28,20,297,9,9,0
28,20,298,10,17,-7
28,20,299,12,8,4
28,21,0,1,10,-9
28,21,1,8,13,-5
28,21,2,16,11,5
28,21,3,9,16,-7
28,21,4,9,20,-11
28,21,5,2,18,-16
28,21,6,9,12,-3
28,21,7,5,11,-6
28,21,8,17,15,2
28,21,9,10,30,-20
28,21,10,20,25,-5
28,21,11,3,10,-7
28,21,12,8,11,-3
28,21,13,8,27,-19
28,21,14,8,17,-9
28,21,15,17,14,3
28,21,16,19,18,1
28,21,17,19,21,-2
28,21,18,8,16,-8
28,21,19,8,13,-5
28,21,20,12,24,-12
28,21,21,19,31,-12
28,21,22,18,11,7
28,21,23,13,14,-1
28,21,24,9,11,-2
28,21,25,17,11,6
28,21,26,16,20,-4
28,21,27,12,18,-6
28,21,28,14,15,-1
28,21,29,9,12,-3
28,21,30,17,12,5
28,21,31,8,21,-13
28,21,32,17,22,-5
28,21,33,15,20,-5
28,21,34,6,11,-5
28,21,35,15,15,0
28,21,36,8,22,-14
28,21,37,7,7,0
28,21,38,18,23,-5
28,21,39,19,26,-7
28,21,40,15,17,-2
28,21,41,9,21,-12
28,21,42,10,7,3
28,21,43,19,27,-8
28,21,44,12,10,2
28,21,45,11,19,-8
28,21,46,13,9,4
28,21,47,13,40,-27
28,21,48,14,14,0
28,21,49,6,21,-15
28,21,50,11,16,-5
28,21,51,13,18,-5
28,21,52,8,23,-15
28,21,53,17,14,3
28,21,54,8,4,4
28,21,55,7,20,-13
28,21,56,14,25,-11
28,21,57,18,14,4
28,21,58,22,17,5
28,21,59,7,23,-16
28,21,60,9,11,-2
28,21,61,5,19,-14
28,21,62,14,25,-11
28,21,63,16,17,-1
28,21,64,18,21,-3
28,21,65,11,8,3
28,21,66,15,11,4
28,21,67,11,13,-2
28,21,68,5,8,-3
28,21,69,11,7,4
28,21,70,6,15,-9
28,21,71,6,10,-4
28,21,72,9,18,-9
28,21,73,7,5,2
28,21,74,12,12,0
28,21,75,12,16,-4
28,21,76,16,12,4
28,21,77,11,10,1
28,21,78,21,23,-2
28,21,79,10,12,-2
28,21,80,7,20,-13
28,21,81,11,19,-8
28,21,82,15,15,0
28,21,83,17,11,6
28,21,84,4,15,-11
28,21,85,24,34,-10
28,21,86,19,23,-4
28,21,87,12,26,-14
28,21,88,9,17,-8
28,21,89,6,9,-3
28,21,90,12,14,-2
28,21,91,8,4,4
28,21,92,8,25,-17
28,21,93,24,24,0
28,21,94,6,13,-7
28,21,95,22,20,2
28,21,96,7,16,-9
28,21,97,11,21,-10
28,21,98,10,21,-11
28,21,99,11,6,5
28,21,100,10,27,-17
28,21,101,17,20,-3
28,21,102,10,16,-6
28,21,103,8,15,-7
28,21,104,6,9,-3
28,21,105,18,23,-5
28,21,106,7,10,-3
28,21,107,13,26,-13
28,21,108,11,24,-13
28,21,109,4,6,-2
28,21,110,16,21,-5
28,21,111,5,7,-2
28,21,112,12,28,-16
28,21,113,8,15,-7
28,21,114,10,25,-15
28,21,115,9,14,-5
28,21,116,5,17,-12
28,21,117,8,19,-11
28,21,118,14,10,4
28,21,119,14,21,-7
28,21,120,19,13,6
28,21,121,17,10,7
28,21,122,14,22,-8
28,21,123,4,13,-9
28,21,124,8,12,-4
28,21,125,11,29,-18
28,21,126,17,29,-12
28,21,127,16,24,-8
28,21,128,9,10,-1
28,21,129,11,23,-12
28,21,130,12,14,-2
28,21,131,10,12,-2
28,21,132,8,17,-9
28,21,133,6,15,-9
28,21,134,5,17,-12
28,21,135,16,12,4
28,21,136,19,22,-3
28,21,137,12,12,0
28,21,138,4,16,-12
28,21,139,6,19,-13
28,21,140,9,11,-2
28,21,141,8,17,-9
28,21,142,19,17,2
28,21,143,6,11,-5
28,21,144,6,5,1
28,21,145,1,4,-3
28,21,146,13,20,-7
28,21,147,18,20,-2
28,21,148,17,14,3
28,21,149,15,18,-3
28,21,150,15,32,-17
28,21,151,8,14,-6
28,21,152,15,25,-10
28,21,153,15,18,-3
28,21,154,18,9,9
28,21,155,7,20,-13
28,21,156,11,14,-3
28,21,157,8,26,-18
28,21,158,16,22,-6
28,21,159,17,8,9
28,21,160,13,23,-10
28,21,161,6,15,-9
28,21,162,6,14,-8
28,21,163,17,27,-10
28,21,164,8,14,-6
28,21,165,13,9,4
28,21,166,8,22,-14
28,21,167,19,21,-2
28,21,168,12,22,-10
28,21,169,19,22,-3
28,21,170,16,16,0
28,21,171,15,16,-1
28,21,172,5,22,-17
28,21,173,11,11,0
28,21,174,16,16,0
28,21,175,16,15,1
28,21,176,11,10,1
28,21,177,14,17,-3
28,21,178,4,31,-27
28,21,179,13,18,-5
28,21,180,5,23,-18
28,21,181,7,6,1
28,21,182,23,24,-1
28,21,183,4,17,-13
28,21,184,9,18,-9
28,21,185,12,19,-7
28,21,186,15,23,-8
28,21,187,10,12,-2
28,21,188,12,30,-18
28,21,189,8,15,-7
28,21,190,11,21,-10
28,21,191,7,17,-10
28,21,192,14,11,3
28,21,193,9,16,-7
28,21,194,15,12,3
28,21,195,13,15,-2
28,21,196,11,15,-4
28,21,197,5,18,-13
28,21,198,25,13,12
28,21,199,8,11,-3
28,21,200,15,8,7
28,21,201,10,19,-9
28,21,202,11,14,-3
28,21,203,5,10,-5
28,21,204,9,21,-12
28,21,205,15,29,-14
28,21,206,13,13,0
28,21,207,8,21,-13
28,21,208,15,13,2
28,21,209,10,9,1
28,21,210,8,8,0
28,21,211,3,17,-14
28,21,212,8,12,-4
28,21,213,22,38,-16
28,21,214,15,10,5
28,21,215,16,15,1
28,21,216,12,6,6
28,21,217,7,7,0
28,21,218,11,8,3
28,21,219,19,24,-5
28,21,220,19,21,-2
28,21,221,5,14,-9
28,21,222,3,13,-10
28,21,223,12,15,-3
28,21,224,16,19,-3
28,21,225,11,9,2
28,21,226,6,19,-13
28,21,227,7,13,-6
28,21,228,9,8,1
28,21,229,5,13,-8
28,21,230,9,8,1
28,21,231,16,22,-6
28,21,232,6,5,1
28,21,233,14,21,-7
28,21,234,6,13,-7
28,21,235,11,11,0
28,21,236,16,6,10
28,21,237,13,17,-4
28,21,238,12,12,0
28,21,239,10,11,-1
28,21,240,13,18,-5
28,21,241,7,11,-4
28,21,242,10,4,6
28,21,243,2,18,-16
28,21,244,10,10,0
28,21,245,11,23,-12
28,21,246,9,9,0
28,21,247,15,11,4
28,21,248,6,12,-6
28,21,249,20,13,7
28,21,250,11,22,-11
28,21,251,8,4,4
28,21,252,17,7,10
28,21,253,14,17,-3
28,21,254,13,7,6
28,21,255,8,15,-7
28,21,256,14,14,0
28,21,257,10,12,-2
28,21,258,11,20,-9
28,21,259,12,20,-8
28,21,260,8,12,-4
28,21,261,21,15,6
28,21,262,5,15,-10
28,21,263,7,8,-1
28,21,264,23,10,13
28,21,265,5,8,-3
28,21,266,13,22,-9
28,21,267,12,22,-10
28,21,268,7,4,3
28,21,269,7,11,-4
28,21,270,8,17,-9
28,21,271,18,17,1
28,21,272,17,25,-8
28,21,273,7,9,-2
28,21,274,8,6,2
28,21,275,17,20,-3
28,21,276,22,28,-6
28,21,277,1,14,-13
28,21,278,4,18,-14
28,21,279,6,13,-7
28,21,280,16,7,9
28,21,281,18,17,1
28,21,282,12,11,1
28,21,283,11,28,-17
28,21,284,12,27,-15
28,21,285,6,12,-6
28,21,286,13,12,1
28,21,287,13,26,-13
28,21,288,13,13,0
28,21,289,16,10,6
28,21,290,18,26,-8
28,21,291,3,17,-14
28,21,292,27,21,6
28,21,293,7,22,-15
28,21,294,14,10,4
28,21,295,11,32,-21
28,21,296,9,13,-4
28,21,297,6,6,0
28,21,298,8,14,-6
28,21,299,6,17,-11
28,22,0,10,12,-2
28,22,1,17,13,4
28,22,2,6,10,-4
28,22,3,12,6,6
28,22,4,13,11,2
28,22,5,7,8,-1
28,22,6,7,8,-1
28,22,7,28,18,10
28,22,8,3,10,-7
28,22,9,14,14,0
28,22,10,8,8,0
28,22,11,23,19,4
28,22,12,19,21,-2
28,22,13,15,21,-6
28,22,14,9,20,-11
28,22,15,16,16,0
28,22,16,17,20,-3
28,22,17,21,10,11
28,22,18,6,10,-4
28,22,19,12,15,-3
28,22,20,13,12,1
28,22,21,13,14,-1
28,22,22,8,17,-9
28,22,23,8,13,-5
28,22,24,6,7,-1
28,22,25,14,10,4
28,22,26,15,17,-2
28,22,27,7,17,-10
28,22,28,13,8,5
28,22,29,6,22,-16
28,22,30,4,3,1
28,22,31,11,26,-15
28,22,32,15,17,-2
28,22,33,12,10,2
28,22,34,18,27,-9
28,22,35,16,18,-2
28,22,36,17,25,-8
28,22,37,13,19,-6
28,22,38,7,9,-2
28,22,39,12,28,-16
28,22,40,3,19,-16
28,22,41,17,28,-11
28,22,42,19,10,9
28,22,43,8,16,-8
28,22,44,3,9,-6
28,22,45,21,28,-7
28,22,46,12,10,2
28,22,47,22,21,1
28,22,48,13,10,3
28,22,49,14,13,1
28,22,50,10,16,-6
28,22,51,17,16,1
28,22,52,11,19,-8
28,22,53,10,7,3
28,22,54,12,15,-3
28,22,55,12,15,-3
28,22,56,16,14,2
28,22,57,17,18,-1
28,22,58,12,14,-2
28,22,59,9,18,-9
28,22,60,17,15,2
28,22,61,13,12,1
28,22,62,8,18,-10
28,22,63,11,11,0
28,22,64,10,12,-2
28,22,65,9,15,-6
28,22,66,10,5,5
28,22,67,13,14,-1
28,22,68,17,29,-12
28,22,69,17,13,4
28,22,70,4,4,0
28,22,71,17,34,-17
28,22,72,13,33,-20
28,22,73,11,15,-4
28,22,74,5,14,-9
28,22,75,18,34,-16
28,22,76,10,12,-2
28,22,77,12,14,-2
28,22,78,1,8,-7
28,22,79,17,25,-8
28,22,80,7,14,-7
28,22,81,19,12,7
28,22,82,12,27,-15
28,22,83,8,13,-5
28,22,84,24,17,7
28,22,85,15,19,-4
28,22,86,7,9,-2
28,22,87,13,20,-7
28,22,88,2,18,-16
28,22,89,10,15,-5
28,22,90,12,9,3
28,22,91,12,14,-2
28,22,92,19,19,0
28,22,93,15,18,-3
28,22,94,13,14,-1
28,22,95,18,21,-3
28,22,96,6,6,0
28,22,97,25,19,6
28,22,98,9,24,-15
28,22,99,18,23,-5
28,22,100,6,14,-8
28,22,101,12,14,-2
28,22,102,11,20,-9
28,22,103,16,21,-5
28,22,104,9,17,-8
28,22,105,9,17,-8
28,22,106,10,22,-12
28,22,107,9,21,-12
28,22,108,13,20,-7
28,22,109,17,9,8
28,22,110,9,10,-1
28,22,111,8,13,-5
28,22,112,16,22,-6
28,22,113,23,24,-1
28,22,114,10,18,-8
28,22,115,12,17,-5
28,22,116,6,25,-19
28,22,117,10,16,-6
28,22,118,2,8,-6
28,22,119,5,5,0
28,22,120,16,24,-8
28,22,121,17,24,-7
28,22,122,14,20,-6
28,22,123,21,14,7
28,22,124,11,14,-3
28,22,125,9,12,-3
28,22,126,12,18,-6
28,22,127,7,18,-11
28,22,128,10,11,-1
28,22,129,14,14,0
28,22,130,11,22,-11
28,22,131,15,17,-2
28,22,132,20,18,2
28,22,133,11,19,-8
28,22,134,19,13,6
28,22,135,15,17,-2
28,22,136,14,16,-2
28,22,137,18,10,8
28,22,138,24,17,7
28,22,139,11,15,-4
28,22,140,17,24,-7
28,22,141,11,12,-1
28,22,142,11,8,3
28,22,143,18,12,6
28,22,144,2,14,-12
28,22,145,17,5,12
28,22,146,5,17,-12
28,22,147,12,31,-19
28,22,148,13,25,-12
28,22,149,31,14,17
28,22,150,11,14,-3
28,22,151,12,9,3
28,22,152,17,16,1
28,22,153,12,17,-5
28,22,154,4,10,-6
28,22,155,15,24,-9
28,22,156,15,31,-16
28,22,157,16,17,-1
28,22,158,9,13,-4
28,22,159,11,7,4
28,22,160,8,21,-13
28,22,161,18,21,-3
28,22,162,4,19,-15
28,22,163,15,18,-3
28,22,164,14,13,1
28,22,165,11,10,1
28,22,166,11,22,-11
28,22,167,22,16,6
28,22,168,10,8,2
28,22,169,9,29,-20
28,22,170,21,19,2
28,22,171,8,18,-10
28,22,172,16,14,2
28,22,173,12,20,-8
28,22,174,10,20,-10
28,22,175,16,24,-8
28,22,176,15,21,-6
28,22,177,15,17,-2
28,22,178,7,10,-3
28,22,179,3,22,-19
28,22,180,17,5,12
28,22,181,10,25,-15
28,22,182,6,15,-9
28,22,183,9,10,-1
28,22,184,6,21,-15
28,22,185,11,34,-23
28,22,186,6,9,-3
28,22,187,9,10,-1
28,22,188,14,18,-4
28,22,189,20,23,-3
28,22,190,20,28,-8
28,22,191,15,18,-3
28,22,192,16,26,-10
28,22,193,22,20,2
28,22,194,12,24,-12
28,22,195,12,25,-13
28,22,196,11,17,-6
28,22,197,18,13,5
28,22,198,6,24,-18
28,22,199,3,8,-5
28,22,200,5,11,-6
28,22,201,15,6,9
28,22,202,4,17,-13
28,22,203,21,17,4
28,22,204,10,22,-12
28,22,205,15,8,7
28,22,206,13,15,-2
28,22,207,4,29,-25
28,22,208,8,19,-11
28,22,209,22,14,8
28,22,210,8,19,-11
28,22,211,12,29,-17
28,22,212,7,8,-1
28,22,213,7,20,-13
28,22,214,8,9,-1
28,22,215,3,17,-14
28,22,216,2,13,-11
28,22,217,11,15,-4
28,22,218,4,17,-13
28,22,219,8,11,-3
28,22,220,12,10,2
28,22,221,5,5,0
28,22,222,9,15,-6
28,22,223,12,4,8
28,22,224,25,17,8
28,22,225,11,26,-15
28,22,226,10,16,-6
28,22,227,5,10,-5
28,22,228,21,28,-7
28,22,229,21,17,4
28,22,230,8,23,-15
28,22,231,4,11,-7
28,22,232,9,23,-14
28,22,233,13,19,-6
28,22,234,13,14,-1
28,22,235,11,25,-14
28,22,236,7,21,-14
28,22,237,17,22,-5
28,22,238,10,17,-7
28,22,239,16,14,2
28,22,240,6,2,4
28,22,241,13,13,0
28,22,242,6,9,-3
28,22,243,16,20,-4
28,22,244,9,22,-13
28,22,245,17,8,9
28,22,246,5,9,-4
28,22,247,7,10,-3
28,22,248,20,21,-1
28,22,249,4,21,-17
28,22,250,17,18,-1
28,22,251,10,13,-3
28,22,252,8,11,-3
28,22,253,20,9,11
28,22,254,10,14,-4
28,22,255,21,20,1
28,22,256,13,19,-6
28,22,257,17,20,-3
28,22,258,6,13,-7
28,22,259,17,26,-9
28,22,260,7,9,-2
28,22,261,8,16,-8
28,22,262,11,14,-3
28,22,263,15,11,4
28,22,264,7,10,-3
28,22,265,7,14,-7
28,22,266,14,16,-2
28,22,267,17,19,-2
28,22,268,14,27,-13
28,22,269,6,8,-2
28,22,270,18,15,3
28,22,271,8,5,3
28,22,272,6,19,-13
28,22,273,6,12,-6
28,22,274,3,6,-3
28,22,275,19,21,-2
28,22,276,6,8,-2
28,22,277,11,18,-7
28,22,278,12,21,-9
28,22,279,13,19,-6
28,22,280,14,21,-7
28,22,281,6,19,-13
28,22,282,9,12,-3
28,22,283,13,17,-4
28,22,284,12,13,-1
28,22,285,2,4,-2
28,22,286,23,16,7
28,22,287,13,13,0
28,22,288,7,6,1
28,22,289,14,12,2
28,22,290,6,13,-7
28,22,291,11,22,-11
28,22,292,1,8,-7
28,22,293,6,15,-9
28,22,294,9,12,-3
28,22,295,9,14,-5
28,22,296,11,14,-3
28,22,297,9,21,-12
28,22,298,24,22,2
28,22,299,8,15,-7
28,23,0,12,15,-3
28,23,1,14,24,-10
28,23,2,11,20,-9
28,23,3,7,11,-4
28,23,4,6,16,-10
28,23,5,6,8,-2
28,23,6,14,12,2
28,23,7,14,11,3
28,23,8,2,10,-8
28,23,9,18,23,-5
28,23,10,15,17,-2
28,23,11,7,13,-6
28,23,12,17,15,2
28,23,13,13,30,-17
28,23,14,13,19,-6
28,23,15,9,16,-7
28,23,16,10,12,-2
28,23,17,5,13,-8
28,23,18,15,20,-5
28,23,19,25,22,3
28,23,20,15,17,-2
28,23,21,6,8,-2
28,23,22,23,15,8
28,23,23,5,7,-2
28,23,24,10,12,-2
28,23,25,10,31,-21
28,23,26,10,25,-15
28,23,27,13,14,-1
28,23,28,5,10,-5
28,23,29,5,8,-3
28,23,30,9,15,-6
28,23,31,13,14,-1
28,23,32,4,12,-8
28,23,33,12,12,0
28,23,34,15,21,-6
28,23,35,18,30,-12
28,23,36,4,21,-17
28,23,37,14,8,6
28,23,38,25,28,-3
28,23,39,12,16,-4
28,23,40,9,14,-5
28,23,41,4,15,-11
28,23,42,10,16,-6
28,23,43,18,12,6
28,23,44,8,28,-20
28,23,45,12,17,-5
28,23,46,11,22,-11
28,23,47,7,8,-1
28,23,48,19,13,6
28,23,49,10,22,-12
28,23,50,9,16,-7
28,23,51,7,12,-5
28,23,52,8,14,-6
28,23,53,5,19,-14
28,23,54,4,16,-12
28,23,55,15,24,-9
28,23,56,18,23,-5
28,23,57,6,16,-10
28,23,58,11,18,-7
28,23,59,3,4,-1
28,23,60,16,14,2
28,23,61,8,27,-19
28,23,62,21,22,-1
28,23,63,10,13,-3
28,23,64,8,12,-4
28,23,65,14,14,0
28,23,66,13,18,-5
28,23,67,16,23,-7
28,23,68,10,36,-26
28,23,69,11,10,1
28,23,70,28,24,4
28,23,71,2,17,-15
28,23,72,17,20,-3
28,23,73,7,8,-1
28,23,74,10,18,-8
28,23,75,17,9,8
28,23,76,9,16,-7
28,23,77,4,12,-8
28,23,78,13,23,-10
28,23,79,13,12,1
28,23,80,5,15,-10
28,23,81,23,9,14
28,23,82,9,11,-2
28,23,83,5,19,-14
28,23,84,12,10,2
28,23,85,15,14,1
28,23,86,13,26,-13
28,23,87,12,27,-15
28,23,88,16,19,-3
28,23,89,11,20,-9
28,23,90,8,7,1
28,23,91,10,12,-2
28,23,92,11,26,-15
28,23,93,22,26,-4
28,23,94,15,18,-3
28,23,95,11,11,0
28,23,96,5,5,0
28,23,97,20,15,5
28,23,98,12,23,-11
28,23,99,9,8,1
28,23,100,8,12,-4
28,23,101,8,23,-15
28,23,102,8,15,-7
28,23,103,5,8,-3
28,23,104,10,17,-7
28,23,105,11,19,-8
28,23,106,6,7,-1
28,23,107,11,19,-8
28,23,108,19,11,8
28,23,109,17,16,1
28,23,110,21,18,3
28,23,111,15,12,3
28,23,112,21,19,2
28,23,113,16,14,2
28,23,114,7,19,-12
28,23,115,11,12,-1
28,23,116,8,19,-11
28,23,117,14,21,-7
28,23,118,10,8,2
28,23,119,6,15,-9
28,23,120,13,19,-6
28,23,121,6,27,-21
28,23,122,8,15,-7
28,23,123,13,15,-2
28,23,124,21,11,10
28,23,125,15,21,-6
28,23,126,31,23,8
28,23,127,14,25,-11
28,23,128,17,13,4
28,23,129,16,13,3
28,23,130,11,24,-13
28,23,131,9,25,-16
28,23,132,9,13,-4
28,23,133,12,15,-3
28,23,134,10,18,-8
28,23,135,2,9,-7
28,23,136,11,13,-2
28,23,137,17,27,-10
28,23,138,17,33,-16
28,23,139,6,9,-3
28,23,140,12,14,-2
28,23,141,10,10,0
28,23,142,2,26,-24
28,23,143,17,19,-2
28,23,144,13,17,-4
28,23,145,18,8,10
28,23,146,5,17,-12
28,23,147,10,15,-5
28,23,148,13,12,1
28,23,149,6,11,-5
28,23,150,6,15,-9
28,23,151,10,10,0
28,23,152,11,14,-3
28,23,153,9,21,-12
28,23,154,10,6,4
28,23,155,4,10,-6
28,23,156,12,10,2
28,23,157,11,17,-6
28,23,158,9,34,-25
28,23,159,10,17,-7
28,23,160,6,10,-4
28,23,161,22,23,-1
28,23,162,18,23,-5
28,23,163,6,26,-20
28,23,164,17,8,9
28,23,165,20,20,0
28,23,166,17,23,-6
28,23,167,16,15,1
28,23,168,17,26,-9
28,23,169,7,18,-11
28,23,170,17,22,-5
28,23,171,18,31,-13
28,23,172,6,13,-7
28,23,173,10,20,-10
28,23,174,17,16,1
28,23,175,18,16,2
28,23,176,23,18,5
28,23,177,9,6,3
28,23,178,5,17,-12
28,23,179,7,11,-4
28,23,180,24,16,8
28,23,181,6,14,-8
28,23,182,22,20,2
28,23,183,4,24,-20
28,23,184,14,20,-6
28,23,185,13,14,-1
28,23,186,26,19,7
28,23,187,8,16,-8
28,23,188,12,7,5
28,23,189,6,16,-10
28,23,190,7,18,-11
28,23,191,15,12,3
28,23,192,27,14,13
28,23,193,13,13,0
28,23,194,17,13,4
28,23,195,7,17,-10
28,23,196,8,11,-3
28,23,197,14,17,-3
28,23,198,11,12,-1
28,23,199,10,12,-2
28,23,200,2,4,-2
28,23,201,11,22,-11
28,23,202,17,9,8
28,23,203,12,13,-1
28,23,204,8,13,-5
28,23,205,4,20,-16
28,23,206,30,14,16
28,23,207,14,20,-6
28,23,208,13,8,5
28,23,209,17,14,3
28,23,210,9,14,-5
28,23,211,8,8,0
28,23,212,16,25,-9
28,23,213,8,16,-8
28,23,214,16,24,-8
28,23,215,14,15,-1
28,23,216,27,21,6
28,23,217,13,24,-11
28,23,218,7,8,-1
28,23,219,16,20,-4
28,23,220,15,8,7
28,23,221,12,7,5
28,23,222,10,18,-8
28,23,223,15,19,-4
28,23,224,9,22,-13
28,23,225,8,19,-11
28,23,226,24,21,3
28,23,227,7,15,-8
28,23,228,13,22,-9
28,23,229,18,8,10
28,23,230,10,11,-1
28,23,231,3,13,-10
28,23,232,9,16,-7
28,23,233,14,14,0
28,23,234,3,14,-11
28,23,235,8,15,-7
28,23,236,3,16,-13
28,23,237,9,9,0
28,23,238,18,28,-10
28,23,239,8,11,-3
28,23,240,8,9,-1
28,23,241,15,14,1
28,23,242,12,26,-14
28,23,243,2,7,-5
28,23,244,6,14,-8
28,23,245,20,18,2
28,23,246,11,11,0
28,23,247,23,23,0
28,23,248,22,24,-2
28,23,249,17,20,-3
28,23,250,9,12,-3
28,23,251,12,14,-2
28,23,252,10,14,-4
28,23,253,15,17,-2
28,23,254,10,18,-8
28,23,255,12,9,3
28,23,256,7,24,-17
28,23,257,5,11,-6
28,23,258,8,21,-13
28,23,259,6,10,-4
28,23,260,21,41,-20
28,23,261,18,17,1
28,23,262,19,12,7
28,23,263,18,17,1
28,23,264,9,12,-3
28,23,265,8,14,-6
28,23,266,14,14,0
28,23,267,13,6,7
28,23,268,11,4,7
28,23,269,13,10,3
28,23,270,10,9,1
28,23,271,14,23,-9
28,23,272,10,25,-15
28,23,273,12,11,1
28,23,274,8,20,-12
28,23,275,3,17,-14
28,23,276,6,12,-6
28,23,277,6,5,1
28,23,278,13,12,1
28,23,279,23,18,5
28,23,280,14,14,0
28,23,281,10,19,-9
28,23,282,21,44,-23
28,23,283,12,8,4
28,23,284,0,7,-7
28,23,285,2,15,-13
28,23,286,17,14,3
28,23,287,10,12,-2
28,23,288,12,16,-4
28,23,289,15,13,2
28,23,290,14,19,-5
28,23,291,20,14,6
28,23,292,12,17,-5
28,23,293,10,13,-3
28,23,294,9,13,-4
28,23,295,15,15,0
28,23,296,14,10,4
28,23,297,15,17,-2
28,23,298,13,10,3
28,23,299,8,6,2
28,24,0,15,14,1
28,24,1,7,11,-4
28,24,2,4,14,-10
28,24,3,8,10,-2
28,24,4,13,13,0
28,24,5,3,16,-13
28,24,6,10,12,-2
28,24,7,21,22,-1
28,24,8,8,14,-6
28,24,9,9,20,-11
28,24,10,5,19,-14
28,24,11,14,14,0
28,24,12,9,19,-10
28,24,13,11,24,-13
28,24,14,5,14,-9
28,24,15,9,11,-2
28,24,16,7,14,-7
28,24,17,9,17,-8
28,24,18,17,22,-5
28,24,19,7,5,2
28,24,20,13,9,4
28,24,21,2,12,-10
28,24,22,19,10,9
28,24,23,5,10,-5
28,24,24,11,18,-7
28,24,25,18,10,8
28,24,26,13,16,-3
28,24,27,21,11,10
28,24,28,13,11,2
28,24,29,13,9,4
28,24,30,18,14,4
28,24,31,8,8,0
28,24,32,4,9,-5
28,24,33,18,20,-2
28,24,34,12,21,-9
28,24,35,10,19,-9
28,24,36,19,20,-1
28,24,37,5,16,-11
28,24,38,13,3,10
28,24,39,12,19,-7
28,24,40,15,15,0
28,24,41,22,19,3
28,24,42,14,27,-13
28,24,43,11,23,-12
28,24,44,18,22,-4
28,24,45,2,17,-15
28,24,46,19,19,0
28,24,47,12,12,0
28,24,48,9,12,-3
28,24,49,6,9,-3
28,24,50,10,23,-13
28,24,51,2,13,-11
28,24,52,15,7,8
28,24,53,15,16,-1
28,24,54,20,15,5
28,24,55,15,11,4
28,24,56,16,7,9
28,24,57,8,14,-6
28,24,58,15,17,-2
28,24,59,10,18,-8
28,24,60,19,11,8
28,24,61,5,11,-6
28,24,62,6,17,-11
28,24,63,10,10,0
28,24,64,7,13,-6
28,24,65,11,13,-2
28,24,66,13,9,4
28,24,67,5,5,0
28,24,68,10,7,3
28,24,69,9,7,2
28,24,70,8,8,0
28,24,71,10,11,-1
28,24,72,8,22,-14
28,24,73,25,17,8
28,24,74,18,34,-16
28,24,75,13,13,0
28,24,76,10,17,-7
28,24,77,16,12,4
28,24,78,18,15,3
28,24,79,2,3,-1
28,24,80,19,9,10
28,24,81,12,19,-7
28,24,82,23,15,8
28,24,83,10,27,-17
28,24,84,8,20,-12
28,24,85,11,12,-1
28,24,86,17,17,0
28,24,87,4,13,-9
28,24,88,11,17,-6
28,24,89,14,24,-10
28,24,90,12,16,-4
28,24,91,17,20,-3
28,24,92,7,8,-1
28,24,93,28,31,-3
28,24,94,5,13,-8
28,24,95,16,6,10
28,24,96,17,24,-7
28,24,97,6,15,-9
28,24,98,8,25,-17
28,24,99,11,18,-7
28,24,100,17,15,2
28,24,101,5,13,-8
28,24,102,3,19,-16
28,24,103,14,16,-2
28,24,104,18,18,0
28,24,105,2,6,-4
28,24,106,15,7,8
28,24,107,23,20,3
28,24,108,8,10,-2
28,24,109,15,18,-3
28,24,110,12,11,1
28,24,111,13,16,-3
28,24,112,14,9,5
28,24,113,6,12,-6
28,24,114,23,22,1
28,24,115,16,22,-6
28,24,116,12,17,-5
28,24,117,22,10,12
28,24,118,11,17,-6
28,24,119,15,8,7
28,24,120,15,13,2
28,24,121,7,19,-12
28,24,122,8,9,-1
28,24,123,11,20,-9
28,24,124,15,9,6
28,24,125,25,14,11
28,24,126,18,20,-2
28,24,127,13,16,-3
28,24,128,18,27,-9
28,24,129,8,20,-12
28,24,130,16,15,1
28,24,131,5,8,-3
28,24,132,12,18,-6
28,24,133,9,14,-5
28,24,134,10,20,-10
28,24,135,10,16,-6
28,24,136,23,17,6
28,24,137,9,8,1
28,24,138,16,30,-14
28,24,139,8,13,-5
28,24,140,11,19,-8
28,24,141,18,14,4
28,24,142,13,17,-4
28,24,143,8,15,-7
28,24,144,17,14,3
28,24,145,11,12,-1
28,24,146,8,13,-5
28,24,147,7,13,-6
28,24,148,9,11,-2
28,24,149,9,14,-5
28,24,150,9,18,-9
28,24,151,15,19,-4
28,24,152,11,8,3
28,24,153,13,15,-2
28,24,154,13,14,-1
28,24,155,12,11,1
28,24,156,4,7,-3
28,24,157,8,12,-4
28,24,158,8,2,6
28,24,159,15,17,-2
28,24,160,8,20,-12
28,24,161,16,18,-2
28,24,162,8,10,-2
28,24,163,7,7,0
28,24,164,20,29,-9
28,24,165,6,24,-18
28,24,166,13,11,2
28,24,167,15,7,8
28,24,168,9,9,0
28,24,169,11,16,-5
28,24,170,11,13,-2
28,24,171,6,9,-3
28,24,172,6,7,-1
28,24,173,7,7,0
28,24,174,3,15,-12
28,24,175,20,13,7
28,24,176,15,15,0
28,24,177,19,6,13
28,24,178,12,9,3
28,24,179,10,16,-6
28,24,180,12,15,-3
28,24,181,9,15,-6
28,24,182,18,21,-3
28,24,183,30,13,17
28,24,184,10,8,2
28,24,185,6,9,-3
28,24,186,14,7,7
28,24,187,15,21,-6
28,24,188,11,19,-8
28,24,189,8,15,-7
28,24,190,15,14,1
28,24,191,4,7,-3
28,24,192,4,8,-4
28,24,193,8,16,-8
28,24,194,13,27,-14
28,24,195,12,19,-7
28,24,196,8,15,-7
28,24,197,19,18,1
28,24,198,8,7,1
28,24,199,22,18,4
28,24,200,13,15,-2
28,24,201,9,17,-8
28,24,202,3,9,-6
28,24,203,11,11,0
28,24,204,12,22,-10
28,24,205,6,8,-2
28,24,206,15,6,9
28,24,207,12,22,-10
28,24,208,11,9,2
28,24,209,14,21,-7
28,24,210,16,19,-3
28,24,211,11,12,-1
28,24,212,11,5,6
28,24,213,21,18,3
28,24,214,11,4,7
28,24,215,9,7,2
28,24,216,6,18,-12
28,24,217,7,6,1
28,24,218,24,18,6
28,24,219,12,6,6
28,24,220,14,11,3
28,24,221,3,13,-10
28,24,222,11,6,5
28,24,223,3,6,-3
28,24,224,12,16,-4
28,24,225,12,19,-7
28,24,226,7,12,-5
28,24,227,20,17,3
28,24,228,9,11,-2
28,24,229,5,18,-13
28,24,230,18,25,-7
28,24,231,5,12,-7
28,24,232,9,15,-6
28,24,233,16,17,-1
28,24,234,10,7,3
28,24,235,14,6,8
28,24,236,8,11,-3
28,24,237,10,13,-3
28,24,238,12,12,0
28,24,239,15,14,1
28,24,240,12,6,6
28,24,241,10,10,0
28,24,242,5,10,-5
28,24,243,14,21,-7
28,24,244,21,16,5
28,24,245,16,16,0
28,24,246,6,10,-4
28,24,247,7,14,-7
28,24,248,12,21,-9
28,24,249,16,18,-2
28,24,250,16,19,-3
28,24,251,10,18,-8
28,24,252,11,18,-7
28,24,253,12,18,-6
28,24,254,8,9,-1
28,24,255,12,20,-8
28,24,256,11,18,-7
28,24,257,6,3,3
28,24,258,12,16,-4
28,24,259,8,11,-3
28,24,260,12,20,-8
28,24,261,16,16,0
28,24,262,9,15,-6
28,24,263,8,16,-8
28,24,264,5,9,-4
28,24,265,9,9,0
28,24,266,11,15,-4
28,24,267,4,11,-7
28,24,268,8,13,-5
28,24,269,8,18,-10
28,24,270,11,12,-1
28,24,271,12,13,-1
28,24,272,13,8,5
28,24,273,5,7,-2
28,24,274,12,17,-5
28,24,275,16,23,-7
28,24,276,17,9,8
28,24,277,17,14,3
28,24,278,12,22,-10
28,24,279,4,19,-15
28,24,280,7,10,-3
28,24,281,9,10,-1
28,24,282,15,15,0
28,24,283,17,7,10
28,24,284,5,8,-3
28,24,285,16,21,-5
28,24,286,2,5,-3
28,24,287,6,17,-11
28,24,288,9,12,-3
28,24,289,12,22,-10
28,24,290,14,15,-1
28,24,291,13,10,3
28,24,292,9,11,-2
28,24,293,17,12,5
28,24,294,9,11,-2
28,24,295,8,4,4
28,24,296,12,10,2
28,24,297,16,16,0
28,24,298,9,7,2
28,24,299,13,11,2
28,25,0,6,11,-5
28,25,1,7,19,-12
28,25,2,19,15,4
28,25,3,18,3,15
28,25,4,12,3,9
28,25,5,11,6,5
28,25,6,7,6,1
28,25,7,5,2,3
28,25,8,14,22,-8
28,25,9,10,17,-7
28,25,10,12,18,-6
28,25,11,7,8,-1
28,25,12,11,23,-12
28,25,13,8,26,-18
28,25,14,17,6,11
28,25,15,6,13,-7
28,25,16,15,17,-2
28,25,17,8,20,-12
28,25,18,18,20,-2
28,25,19,4,6,-2
28,25,20,13,11,2
28,25,21,8,16,-8
28,25,22,12,15,-3
28,25,23,12,8,4
28,25,24,19,10,9
28,25,25,8,21,-13
28,25,26,15,19,-4
28,25,27,9,20,-11
28,25,28,2,14,-12
28,25,29,17,19,-2
28,25,30,14,12,2
28,25,31,21,14,7
28,25,32,3,17,-14
28,25,33,15,13,2
28,25,34,6,13,-7
28,25,35,8,12,-4
28,25,36,6,9,-3
28,25,37,13,13,0
28,25,38,9,13,-4
28,25,39,15,15,0
28,25,40,11,17,-6
28,25,41,6,13,-7
28,25,42,12,7,5
28,25,43,16,18,-2
28,25,44,10,21,-11
28,25,45,8,20,-12
28,25,46,12,6,6
28,25,47,8,12,-4
28,25,48,7,13,-6
28,25,49,12,8,4
28,25,50,5,4,1
28,25,51,10,8,2
28,25,52,18,24,-6
28,25,53,13,18,-5
28,25,54,10,9,1
28,25,55,6,17,-11
28,25,56,11,14,-3
28,25,57,10,9,1
28,25,58,16,12,4
28,25,59,5,18,-13
28,25,60,12,8,4
28,25,61,9,18,-9
28,25,62,11,15,-4
28,25,63,24,18,6
28,25,64,11,19,-8
28,25,65,4,13,-9
28,25,66,11,18,-7
28,25,67,23,21,2
28,25,68,8,14,-6
28,25,69,9,10,-1
28,25,70,17,20,-3
28,25,71,7,7,0
28,25,72,15,14,1
28,25,73,5,1,4
28,25,74,7,13,-6
28,25,75,5,19,-14
28,25,76,6,9,-3
28,25,77,11,7,4
28,25,78,4,18,-14
28,25,79,5,9,-4
28,25,80,10,9,1
28,25,81,21,14,7
28,25,82,17,15,2
28,25,83,10,23,-13
28,25,84,18,24,-6
28,25,85,3,16,-13
28,25,86,15,17,-2
28,25,87,8,8,0
28,25,88,6,11,-5
28,25,89,5,13,-8
28,25,90,18,10,8
28,25,91,11,12,-1
28,25,92,19,14,5
28,25,93,11,10,1
28,25,94,6,4,2
28,25,95,10,13,-3
28,25,96,7,6,1
28,25,97,26,18,8
28,25,98,17,16,1
28,25,99,7,9,-2
28,25,100,6,6,0
28,25,101,16,12,4
28,25,102,28,18,10
28,25,103,10,12,-2
28,25,104,11,20,-9
28,25,105,20,22,-2
28,25,106,7,20,-13
28,25,107,15,10,5
28,25,108,3,4,-1
28,25,109,15,13,2
28,25,110,8,6,2
28,25,111,12,12,0
28,25,112,5,10,-5
28,25,113,6,12,-6
28,25,114,7,11,-4
28,25,115,14,16,-2
28,25,116,8,10,-2
28,25,117,6,12,-6
28,25,118,10,16,-6
28,25,119,9,9,0
28,25,120,8,16,-8
28,25,121,15,17,-2
28,25,122,7,8,-1
28,25,123,14,8,6
28,25,124,23,19,4
28,25,125,13,13,0
28,25,126,4,12,-8
28,25,127,17,9,8
28,25,128,10,24,-14
28,25,129,6,6,0
28,25,130,16,18,-2
28,25,131,7,13,-6
28,25,132,14,19,-5
28,25,133,10,16,-6
28,25,134,16,14,2
28,25,135,21,15,6
28,25,136,4,3,1
28,25,137,10,7,3
28,25,138,11,13,-2
28,25,139,5,11,-6
28,25,140,3,11,-8
28,25,141,17,21,-4
28,25,142,10,15,-5
28,25,143,8,16,-8
28,25,144,10,15,-5
28,25,145,26,22,4
28,25,146,14,2,12
28,25,147,23,21,2
28,25,148,9,14,-5
28,25,149,15,10,5
28,25,150,16,20,-4
28,25,151,12,16,-4
28,25,152,13,16,-3
28,25,153,17,19,-2
28,25,154,25,23,2
28,25,155,9,17,-8
28,25,156,13,36,-23
28,25,157,11,9,2
28,25,158,12,7,5
28,25,159,7,10,-3
28,25,160,8,3,5
28,25,161,11,7,4
28,25,162,17,15,2
28,25,163,17,16,1
28,25,164,10,17,-7
28,25,165,12,15,-3
28,25,166,11,16,-5
28,25,167,16,20,-4
28,25,168,12,12,0
28,25,169,9,14,-5
28,25,170,3,10,-7
28,25,171,7,12,-5
28,25,172,30,15,15
28,25,173,8,16,-8
28,25,174,19,13,6
28,25,175,21,11,10
28,25,176,16,16,0
28,25,177,25,33,-8
28,25,178,23,17,6
28,25,179,19,24,-5
28,25,180,9,11,-2
28,25,181,6,9,-3
28,25,182,11,30,-19
28,25,183,24,17,7
28,25,184,11,14,-3
28,25,185,9,13,-4
28,25,186,11,11,0
28,25,187,16,13,3
28,25,188,14,9,5
28,25,189,18,11,7
28,25,190,11,10,1
28,25,191,8,18,-10
28,25,192,12,10,2
28,25,193,10,22,-12
28,25,194,24,19,5
28,25,195,7,12,-5
28,25,196,13,20,-7
28,25,197,15,13,2
28,25,198,26,25,1
28,25,199,16,17,-1
28,25,200,12,16,-4
28,25,201,20,16,4
28,25,202,9,13,-4
28,25,203,16,13,3
28,25,204,18,4,14
28,25,205,7,10,-3
28,25,206,9,27,-18
28,25,207,9,14,-5
28,25,208,24,21,3
28,25,209,9,14,-5
28,25,210,20,15,5
28,25,211,11,14,-3
28,25,212,8,9,-1
28,25,213,9,16,-7
28,25,214,14,14,0
28,25,215,7,13,-6
28,25,216,19,14,5
28,25,217,10,17,-7
28,25,218,9,12,-3
28,25,219,12,16,-4
28,25,220,8,14,-6
28,25,221,13,19,-6
28,25,222,16,21,-5
28,25,223,6,17,-11
28,25,224,16,5,11
28,25,225,6,22,-16
28,25,226,11,16,-5
28,25,227,5,8,-3
28,25,228,17,26,-9
28,25,229,12,13,-1
28,25,230,27,28,-1
28,25,231,18,20,-2
28,25,232,6,6,0
28,25,233,8,8,0
28,25,234,4,7,-3
28,25,235,15,19,-4
28,25,236,2,14,-12
28,25,237,16,14,2
28,25,238,7,13,-6
28,25,239,13,11,2
28,25,240,17,20,-3
28,25,241,6,11,-5
28,25,242,15,13,2
28,25,243,17,18,-1
28,25,244,19,14,5
28,25,245,12,10,2
28,25,246,13,14,-1
28,25,247,10,10,0
28,25,248,9,15,-6
28,25,249,6,14,-8
28,25,250,5,11,-6
28,25,251,19,9,10
28,25,252,12,9,3
28,25,253,7,5,2
28,25,254,6,13,-7
28,25,255,8,20,-12
28,25,256,5,9,-4
28,25,257,20,18,2
28,25,258,11,23,-12
28,25,259,3,9,-6
28,25,260,13,19,-6
28,25,261,12,9,3
28,25,262,15,13,2
28,25,263,8,12,-4
28,25,264,5,15,-10
28,25,265,13,8,5
28,25,266,8,8,0
28,25,267,4,21,-17
28,25,268,15,19,-4
28,25,269,8,23,-15
28,25,270,11,15,-4
28,25,271,5,16,-11
28,25,272,9,13,-4
28,25,273,17,30,-13
28,25,274,11,17,-6
28,25,275,8,10,-2
28,25,276,11,19,-8
28,25,277,19,19,0
28,25,278,8,12,-4
28,25,279,19,13,6
28,25,280,16,11,5
28,25,281,12,14,-2
28,25,282,6,23,-17
28,25,283,19,18,1
28,25,284,7,12,-5
28,25,285,6,5,1
28,25,286,11,10,1
28,25,287,3,19,-16
28,25,288,16,11,5
28,25,289,17,18,-1
28,25,290,14,24,-10
28,25,291,17,12,5
28,25,292,10,3,7
28,25,293,12,10,2
28,25,294,9,10,-1
28,25,295,16,13,3
28,25,296,9,18,-9
28,25,297,10,11,-1
28,25,298,12,23,-11
28,25,299,8,20,-12
28,26,0,7,12,-5
28,26,1,10,13,-3
28,26,2,18,18,0
28,26,3,4,25,-21
28,26,4,12,13,-1
28,26,5,5,9,-4
28,26,6,10,23,-13
28,26,7,9,17,-8
28,26,8,4,8,-4
28,26,9,7,18,-11
28,26,10,15,12,3
28,26,11,11,18,-7
28,26,12,16,14,2
28,26,13,16,13,3
28,26,14,13,10,3
28,26,15,9,17,-8
28,26,16,17,11,6
28,26,17,17,26,-9
28,26,18,19,17,2
28,26,19,7,14,-7
28,26,20,18,20,-2
28,26,21,12,14,-2
28,26,22,20,15,5
28,26,23,11,18,-7
28,26,24,17,24,-7
28,26,25,6,15,-9
28,26,26,8,7,1
28,26,27,16,18,-2
28,26,28,21,10,11
28,26,29,4,9,-5
28,26,30,5,3,2
28,26,31,9,9,0
28,26,32,25,16,9
28,26,33,11,14,-3
28,26,34,15,23,-8
28,26,35,21,19,2
28,26,36,11,16,-5
28,26,37,9,13,-4
28,26,38,7,22,-15
28,26,39,6,10,-4
28,26,40,10,19,-9
28,26,41,20,12,8
28,26,42,16,7,9
28,26,43,19,14,5
28,26,44,6,4,2
28,26,45,15,8,7
28,26,46,6,16,-10
28,26,47,4,11,-7
28,26,48,21,12,9
28,26,49,11,11,0
28,26,50,15,11,4
28,26,51,20,27,-7
28,26,52,24,11,13
28,26,53,5,6,-1
28,26,54,10,15,-5
28,26,55,4,13,-9
28,26,56,11,9,2
28,26,57,8,7,1
28,26,58,13,14,-1
28,26,59,20,13,7
28,26,60,9,16,-7
28,26,61,11,14,-3
28,26,62,9,20,-11
28,26,63,9,11,-2
28,26,64,10,13,-3
28,26,65,12,15,-3
28,26,66,2,14,-12
28,26,67,7,19,-12
28,26,68,10,6,4
28,26,69,19,20,-1
28,26,70,12,10,2
28,26,71,8,8,0
28,26,72,6,9,-3
28,26,73,8,6,2
28,26,74,10,7,3
28,26,75,20,23,-3
28,26,76,16,12,4
28,26,77,9,9,0
28,26,78,14,27,-13
28,26,79,21,15,6
28,26,80,12,6,6
28,26,81,2,9,-7
28,26,82,3,10,-7
28,26,83,11,13,-2
28,26,84,24,19,5
28,26,85,10,10,0
28,26,86,17,15,2
28,26,87,17,15,2
28,26,88,18,9,9
28,26,89,14,12,2
28,26,90,14,15,-1
28,26,91,5,8,-3
28,26,92,6,10,-4
28,26,93,15,19,-4
28,26,94,10,7,3
28,26,95,12,16,-4
28,26,96,7,8,-1
28,26,97,6,19,-13
28,26,98,12,11,1
28,26,99,19,10,9
28,26,100,3,6,-3
28,26,101,17,16,1
28,26,102,15,18,-3
28,26,103,23,18,5
28,26,104,11,13,-2
28,26,105,8,16,-8
28,26,106,12,18,-6
28,26,107,28,34,-6
28,26,108,12,16,-4
28,26,109,8,9,-1
28,26,110,12,14,-2
28,26,111,13,10,3
28,26,112,9,6,3
28,26,113,9,8,1
28,26,114,22,5,17
28,26,115,7,18,-11
28,26,116,15,16,-1
28,26,117,11,19,-8
28,26,118,11,23,-12
28,26,119,11,20,-9
28,26,120,3,10,-7
28,26,121,11,16,-5
28,26,122,18,3,15
28,26,123,12,11,1
28,26,124,7,7,0
28,26,125,9,20,-11
28,26,126,5,4,1
28,26,127,12,15,-3
28,26,128,10,7,3
28,26,129,17,9,8
28,26,130,10,8,2
28,26,131,20,17,3
28,26,132,12,12,0
28,26,133,21,15,6
28,26,134,8,19,-11
28,26,135,11,18,-7
28,26,136,16,23,-7
28,26,137,11,17,-6
28,26,138,10,11,-1
28,26,139,15,28,-13
28,26,140,20,17,3
28,26,141,9,24,-15
28,26,142,13,14,-1
28,26,143,7,8,-1
28,26,144,11,11,0
28,26,145,13,21,-8
28,26,146,9,14,-5
28,26,147,14,20,-6
28,26,148,13,10,3
28,26,149,2,12,-10
28,26,150,22,21,1
28,26,151,20,15,5
28,26,152,13,11,2
28,26,153,23,18,5
28,26,154,9,29,-20
28,26,155,13,18,-5
28,26,156,15,14,1
28,26,157,14,23,-9
28,26,158,14,14,0
28,26,159,6,8,-2
28,26,160,10,14,-4
28,26,161,19,12,7
28,26,162,20,18,2
28,26,163,3,25,-22
28,26,164,10,17,-7
28,26,165,6,3,3
28,26,166,21,5,16
28,26,167,14,14,0
28,26,168,8,16,-8
28,26,169,14,9,5
28,26,170,11,14,-3
28,26,171,16,9,7
28,26,172,23,17,6
28,26,173,14,4,10
28,26,174,10,19,-9
28,26,175,6,9,-3
28,26,176,18,14,4
28,26,177,28,18,10
28,26,178,14,17,-3
28,26,179,9,13,-4
28,26,180,19,22,-3
28,26,181,9,14,-5
28,26,182,19,21,-2
28,26,183,17,14,3
28,26,184,25,19,6
28,26,185,17,21,-4
28,26,186,14,8,6
28,26,187,10,18,-8
28,26,188,10,11,-1
28,26,189,12,14,-2
28,26,190,14,13,1
28,26,191,12,10,2
28,26,192,6,12,-6
28,26,193,15,12,3
28,26,194,10,5,5
28,26,195,8,18,-10
28,26,196,10,12,-2
28,26,197,10,5,5
28,26,198,10,14,-4
28,26,199,13,10,3
28,26,200,8,7,1
28,26,201,10,19,-9
28,26,202,11,18,-7
28,26,203,13,14,-1
28,26,204,4,13,-9
28,26,205,12,9,3
28,26,206,30,15,15
28,26,207,12,10,2
28,26,208,16,12,4
28,26,209,10,18,-8
28,26,210,5,11,-6
28,26,211,9,12,-3
28,26,212,14,11,3
28,26,213,2,8,-6
28,26,214,7,14,-7
28,26,215,11,8,3
28,26,216,22,18,4
28,26,217,5,24,-19
28,26,218,8,9,-1
28,26,219,16,19,-3
28,26,220,22,21,1
28,26,221,9,15,-6
28,26,222,10,15,-5
28,26,223,12,10,2
28,26,224,10,12,-2
28,26,225,6,13,-7
28,26,226,20,12,8
28,26,227,15,22,-7
28,26,228,16,9,7
28,26,229,8,32,-24
28,26,230,8,6,2
28,26,231,19,13,6
28,26,232,11,7,4
28,26,233,4,6,-2
28,26,234,13,17,-4
28,26,235,20,11,9
28,26,236,7,14,-7
28,26,237,9,14,-5
28,26,238,9,10,-1
28,26,239,8,11,-3
28,26,240,7,5,2
28,26,241,11,24,-13
28,26,242,13,18,-5
28,26,243,20,11,9
28,26,244,10,14,-4
28,26,245,14,15,-1
28,26,246,14,12,2
28,26,247,13,15,-2
28,26,248,8,12,-4
28,26,249,11,6,5
28,26,250,20,13,7
28,26,251,13,23,-10
28,26,252,10,13,-3
28,26,253,8,16,-8
28,26,254,2,10,-8
28,26,255,10,13,-3
28,26,256,10,6,4
28,26,257,11,11,0
28,26,258,6,9,-3
28,26,259,4,15,-11
28,26,260,11,13,-2
28,26,261,10,9,1
28,26,262,12,24,-12
28,26,263,14,8,6
28,26,264,13,13,0
28,26,265,22,26,-4
28,26,266,8,12,-4
28,26,267,8,4,4
28,26,268,14,20,-6
28,26,269,13,9,4
28,26,270,16,8,8
28,26,271,8,11,-3
28,26,272,6,17,-11
28,26,273,13,5,8
28,26,274,18,13,5
28,26,275,15,10,5
28,26,276,12,14,-2
28,26,277,9,13,-4
28,26,278,4,15,-11
28,26,279,9,13,-4
28,26,280,1,11,-10
28,26,281,8,6,2
28,26,282,5,12,-7
28,26,283,11,20,-9
28,26,284,12,3,9
28,26,285,15,11,4
28,26,286,7,20,-13
28,26,287,11,13,-2
28,26,288,10,18,-8
28,26,289,7,14,-7
28,26,290,8,14,-6
28,26,291,17,21,-4
28,26,292,7,9,-2
28,26,293,12,8,4
28,26,294,7,14,-7
28,26,295,3,6,-3
28,26,296,5,23,-18
28,26,297,17,20,-3
28,26,298,8,6,2
28,26,299,15,8,7
28,27,0,9,17,-8
28,27,1,3,17,-14
28,27,2,5,10,-5
28,27,3,8,13,-5
28,27,4,16,9,7
28,27,5,18,23,-5
28,27,6,16,4,12
28,27,7,5,14,-9
28,27,8,5,10,-5
28,27,9,9,13,-4
28,27,10,19,18,1
28,27,11,11,10,1
28,27,12,15,9,6
28,27,13,10,8,2
28,27,14,19,13,6
28,27,15,8,11,-3
28,27,16,6,23,-17
28,27,17,5,11,-6
28,27,18,6,15,-9
28,27,19,10,9,1
28,27,20,10,11,-1
28,27,21,18,23,-5
28,27,22,10,16,-6
28,27,23,6,16,-10
28,27,24,10,10,0
28,27,25,13,14,-1
28,27,26,9,13,-4
28,27,27,22,11,11
28,27,28,7,17,-10
28,27,29,13,9,4
28,27,30,6,4,2
28,27,31,15,17,-2
28,27,32,9,12,-3
28,27,33,10,5,5
28,27,34,5,14,-9
28,27,35,18,9,9
28,27,36,23,8,15
28,27,37,12,16,-4
28,27,38,13,17,-4
28,27,39,20,17,3
28,27,40,15,15,0
28,27,41,19,28,-9
28,27,42,21,11,10
28,27,43,11,20,-9
28,27,44,6,11,-5
28,27,45,18,10,8
28,27,46,16,9,7
28,27,47,12,19,-7
28,27,48,16,11,5
28,27,49,14,9,5
28,27,50,12,17,-5
28,27,51,4,10,-6
28,27,52,8,20,-12
28,27,53,7,10,-3
28,27,54,9,16,-7
28,27,55,7,21,-14
28,27,56,11,9,2
28,27,57,12,7,5
28,27,58,27,20,7
28,27,59,3,12,-9
28,27,60,0,7,-7
28,27,61,16,9,7
28,27,62,15,15,0
28,27,63,11,9,2
28,27,64,9,13,-4
28,27,65,18,6,12
28,27,66,13,20,-7
28,27,67,15,6,9
28,27,68,14,20,-6
28,27,69,8,16,-8
28,27,70,17,16,1
28,27,71,8,5,3
28,27,72,9,7,2
28,27,73,8,7,1
28,27,74,10,6,4
28,27,75,11,13,-2
28,27,76,3,6,-3
28,27,77,8,7,1
28,27,78,9,10,-1
28,27,79,11,13,-2
28,27,80,8,9,-1
28,27,81,7,21,-14
28,27,82,15,17,-2
28,27,83,19,12,7
28,27,84,8,12,-4
28,27,85,9,10,-1
28,27,86,7,3,4
28,27,87,11,16,-5
28,27,88,15,6,9
28,27,89,18,11,7
28,27,90,9,12,-3
28,27,91,11,14,-3
28,27,92,7,5,2
28,27,93,12,13,-1
28,27,94,21,17,4
28,27,95,6,7,-1
28,27,96,10,13,-3
28,27,97,8,13,-5
28,27,98,5,12,-7
28,27,99,5,0,5
28,27,100,9,3,6
28,27,101,11,7,4
28,27,102,11,17,-6
28,27,103,21,14,7
28,27,104,17,17,0
28,27,105,14,13,1
28,27,106,11,13,-2
28,27,107,12,9,3
28,27,108,9,10,-1
28,27,109,15,15,0
28,27,110,6,6,0
28,27,111,5,12,-7
28,27,112,13,19,-6
28,27,113,18,21,-3
28,27,114,9,14,-5
28,27,115,6,21,-15
28,27,116,16,14,2
28,27,117,8,8,0
28,27,118,11,9,2
28,27,119,14,12,2
28,27,120,6,12,-6
28,27,121,18,13,5
28,27,122,23,8,15
28,27,123,7,11,-4
28,27,124,6,11,-5
28,27,125,12,13,-1
28,27,126,13,10,3
28,27,127,2,9,-7
28,27,128,11,6,5
28,27,129,4,10,-6
28,27,130,10,22,-12
28,27,131,5,8,-3
28,27,132,8,6,2
28,27,133,12,9,3
28,27,134,8,11,-3
28,27,135,4,7,-3
28,27,136,13,8,5
28,27,137,14,4,10
28,27,138,5,17,-12
28,27,139,19,10,9
28,27,140,19,20,-1
28,27,141,4,11,-7
28,27,142,9,19,-10
28,27,143,12,21,-9
28,27,144,11,15,-4
28,27,145,9,4,5
28,27,146,17,10,7
28,27,147,15,9,6
28,27,148,9,13,-4
28,27,149,11,19,-8
28,27,150,12,15,-3
28,27,151,0,5,-5
28,27,152,7,13,-6
28,27,153,3,10,-7
28,27,154,12,19,-7
28,27,155,9,3,6
28,27,156,16,18,-2
28,27,157,13,10,3
28,27,158,9,9,0
28,27,159,9,19,-10
28,27,160,17,13,4
28,27,161,10,11,-1
28,27,162,14,7,7
28,27,163,22,23,-1
28,27,164,13,4,9
28,27,165,7,6,1
28,27,166,18,17,1
28,27,167,16,20,-4
28,27,168,16,10,6
28,27,169,21,8,13
28,27,170,13,16,-3
28,27,171,8,22,-14
28,27,172,14,17,-3
28,27,173,14,12,2
28,27,174,19,25,-6
28,27,175,17,15,2
28,27,176,17,28,-11
28,27,177,10,21,-11
28,27,178,22,11,11
28,27,179,11,17,-6
28,27,180,2,10,-8
28,27,181,5,14,-9
28,27,182,12,17,-5
28,27,183,13,6,7
28,27,184,16,18,-2
28,27,185,8,22,-14
28,27,186,7,16,-9
28,27,187,11,10,1
28,27,188,17,8,9
28,27,189,7,8,-1
28,27,190,13,19,-6
28,27,191,18,17,1
28,27,192,8,9,-1
28,27,193,14,22,-8
28,27,194,17,17,0
28,27,195,11,2,9
28,27,196,8,17,-9
28,27,197,18,15,3
28,27,198,11,19,-8
28,27,199,4,12,-8
28,27,200,9,12,-3
28,27,201,11,10,1
28,27,202,18,10,8
28,27,203,15,15,0
28,27,204,9,5,4
28,27,205,20,12,8
28,27,206,8,9,-1
28,27,207,7,6,1
28,27,208,27,9,18
28,27,209,13,17,-4
28,27,210,10,7,3
28,27,211,16,9,7
28,27,212,12,8,4
28,27,213,17,5,12
28,27,214,9,7,2
28,27,215,10,20,-10
28,27,216,16,18,-2
28,27,217,12,21,-9
28,27,218,11,10,1
28,27,219,9,13,-4
28,27,220,10,12,-2
28,27,221,13,13,0
28,27,222,9,14,-5
28,27,223,11,16,-5
28,27,224,8,13,-5
28,27,225,6,7,-1
28,27,226,1,13,-12
28,27,227,22,24,-2
28,27,228,8,18,-10
28,27,229,21,12,9
28,27,230,8,11,-3
28,27,231,8,6,2
28,27,232,12,11,1
28,27,233,11,12,-1
28,27,234,12,7,5
28,27,235,11,16,-5
28,27,236,10,17,-7
28,27,237,13,27,-14
28,27,238,5,18,-13
28,27,239,14,13,1
28,27,240,11,12,-1
28,27,241,2,10,-8
28,27,242,18,13,5
28,27,243,15,10,5
28,27,244,3,13,-10
28,27,245,16,13,3
28,27,246,10,9,1
28,27,247,20,10,10
28,27,248,3,11,-8
28,27,249,11,9,2
28,27,250,4,6,-2
28,27,251,10,8,2
28,27,252,11,7,4
28,27,253,16,13,3
28,27,254,6,13,-7
28,27,255,11,14,-3
28,27,256,6,18,-12
28,27,257,15,14,1
28,27,258,9,17,-8
28,27,259,13,10,3
28,27,260,9,21,-12
28,27,261,15,7,8
28,27,262,15,12,3
28,27,263,11,13,-2
28,27,264,6,11,-5
28,27,265,17,14,3
28,27,266,15,25,-10
28,27,267,14,7,7
28,27,268,6,10,-4
28,27,269,14,16,-2
28,27,270,6,12,-6
28,27,271,11,16,-5
28,27,272,10,14,-4
28,27,273,11,13,-2
28,27,274,12,9,3
28,27,275,11,19,-8
28,27,276,13,14,-1
28,27,277,9,6,3
28,27,278,16,19,-3
28,27,279,17,17,0
28,27,280,15,11,4
28,27,281,13,15,-2
28,27,282,10,17,-7
28,27,283,4,1,3
28,27,284,8,18,-10
28,27,285,5,6,-1
28,27,286,12,14,-2
28,27,287,19,16,3
28,27,288,13,16,-3
28,27,289,10,14,-4
28,27,290,9,10,-1
28,27,291,8,14,-6
28,27,292,6,17,-11
28,27,293,11,3,8
28,27,294,17,13,4
28,27,295,5,4,1
28,27,296,10,24,-14
28,27,297,11,4,7
28,27,298,15,5,10
28,27,299,25,9,16
28,28,0,25,13,12
28,28,1,6,12,-6
28,28,2,11,23,-12
28,28,3,7,14,-7
28,28,4,18,10,8
28,28,5,21,22,-1
28,28,6,17,15,2
28,28,7,8,9,-1
28,28,8,6,16,-10
28,28,9,19,12,7
28,28,10,4,8,-4
28,28,11,8,11,-3
28,28,12,3,8,-5
28,28,13,12,16,-4
28,28,14,7,10,-3
28,28,15,11,12,-1
28,28,16,7,10,-3
28,28,17,4,21,-17
28,28,18,3,6,-3
28,28,19,7,7,0
28,28,20,7,6,1
28,28,21,6,14,-8
28,28,22,11,19,-8
28,28,23,2,16,-14
28,28,24,13,14,-1
28,28,25,3,18,-15
28,28,26,5,11,-6
28,28,27,2,6,-4
28,28,28,3,11,-8
28,28,29,7,13,-6
28,28,30,10,13,-3
28,28,31,10,6,4
28,28,32,22,10,12
28,28,33,10,19,-9
28,28,34,4,10,-6
28,28,35,7,9,-2
28,28,36,3,23,-20
28,28,37,14,16,-2
28,28,38,13,11,2
28,28,39,6,12,-6
28,28,40,9,14,-5
28,28,41,6,5,1
28,28,42,17,12,5
28,28,43,5,16,-11
28,28,44,17,16,1
28,28,45,13,11,2
28,28,46,12,20,-8
28,28,47,13,15,-2
28,28,48,16,35,-19
28,28,49,11,8,3
28,28,50,20,24,-4
28,28,51,7,11,-4
28,28,52,4,11,-7
28,28,53,8,6,2
28,28,54,12,18,-6
28,28,55,7,13,-6
28,28,56,10,10,0
28,28,57,10,12,-2
28,28,58,5,4,1
28,28,59,13,14,-1
28,28,60,14,4,10
28,28,61,9,12,-3
28,28,62,11,18,-7
28,28,63,7,18,-11
28,28,64,7,9,-2
28,28,65,20,11,9
28,28,66,6,17,-11
28,28,67,8,12,-4
28,28,68,4,13,-9
28,28,69,13,4,9
28,28,70,11,18,-7
28,28,71,20,23,-3
28,28,72,13,12,1
28,28,73,20,16,4
28,28,74,6,7,-1
28,28,75,16,12,4
28,28,76,7,12,-5
28,28,77,12,6,6
28,28,78,12,7,5
28,28,79,21,11,10
28,28,80,12,8,4
28,28,81,11,11,0
28,28,82,4,9,-5
28,28,83,18,16,2
28,28,84,13,20,-7
28,28,85,12,16,-4
28,28,86,9,9,0
28,28,87,10,8,2
28,28,88,4,22,-18
28,28,89,14,11,3
28,28,90,8,17,-9
28,28,91,4,11,-7
28,28,92,16,7,9
28,28,93,2,20,-18
28,28,94,8,11,-3
28,28,95,16,18,-2
28,28,96,5,11,-6
28,28,97,7,15,-8
28,28,98,17,11,6
28,28,99,9,10,-1
28,28,100,5,15,-10
28,28,101,10,11,-1
28,28,102,6,14,-8
28,28,103,14,25,-11
28,28,104,17,14,3
28,28,105,15,9,6
28,28,106,15,5,10
28,28,107,8,26,-18
28,28,108,8,3,5
28,28,109,14,11,3
28,28,110,13,18,-5
28,28,111,4,0,4
28,28,112,11,9,2
28,28,113,11,19,-8
28,28,114,4,16,-12
28,28,115,8,5,3
28,28,116,8,10,-2
28,28,117,14,8,6
28,28,118,10,5,5
28,28,119,10,16,-6
28,28,120,8,19,-11
28,28,121,8,8,0
28,28,122,10,10,0
28,28,123,7,13,-6
28,28,124,10,11,-1
28,28,125,14,15,-1
28,28,126,6,27,-21
28,28,127,11,7,4
28,28,128,12,10,2
28,28,129,7,6,1
28,28,130,8,13,-5
28,28,131,14,9,5
28,28,132,15,17,-2
28,28,133,9,15,-6
28,28,134,13,16,-3
28,28,135,16,17,-1
28,28,136,15,6,9
28,28,137,3,22,-19
28,28,138,13,16,-3
28,28,139,12,11,1
28,28,140,8,10,-2
28,28,141,10,14,-4
28,28,142,17,13,4
28,28,143,4,12,-8
28,28,144,16,12,4
28,28,145,26,14,12
28,28,146,9,14,-5
28,28,147,18,19,-1
28,28,148,5,10,-5
28,28,149,6,9,-3
28,28,150,12,20,-8
28,28,151,5,11,-6
28,28,152,14,10,4
28,28,153,10,13,-3
28,28,154,6,4,2
28,28,155,11,15,-4
28,28,156,17,17,0
28,28,157,5,10,-5
28,28,158,9,6,3
28,28,159,15,6,9
28,28,160,7,16,-9
28,28,161,10,4,6
28,28,162,13,21,-8
28,28,163,6,14,-8
28,28,164,19,25,-6
28,28,165,9,20,-11
28,28,166,11,16,-5
28,28,167,15,14,1
28,28,168,17,12,5
28,28,169,14,6,8
28,28,170,2,6,-4
28,28,171,5,17,-12
28,28,172,10,10,0
28,28,173,19,20,-1
28,28,174,15,9,6
28,28,175,10,13,-3
28,28,176,9,16,-7
28,28,177,10,31,-21
28,28,178,11,17,-6
28,28,179,13,3,10
28,28,180,6,14,-8
28,28,181,13,12,1
28,28,182,5,12,-7
28,28,183,16,7,9
28,28,184,14,17,-3
28,28,185,9,16,-7
28,28,186,9,10,-1
28,28,187,5,18,-13
28,28,188,10,17,-7
28,28,189,12,5,7
28,28,190,13,11,2
28,28,191,10,10,0
28,28,192,2,18,-16
28,28,193,13,9,4
28,28,194,7,17,-10
28,28,195,11,15,-4
28,28,196,8,14,-6
28,28,197,21,17,4
28,28,198,11,14,-3
28,28,199,6,13,-7
28,28,200,10,11,-1
28,28,201,7,11,-4
28,28,202,7,15,-8
28,28,203,16,13,3
28,28,204,12,13,-1
28,28,205,10,25,-15
28,28,206,5,10,-5
28,28,207,13,9,4
28,28,208,10,12,-2
28,28,209,8,25,-17
28,28,210,1,3,-2
28,28,211,3,11,-8
28,28,212,10,13,-3
28,28,213,11,11,0
28,28,214,23,14,9
28,28,215,12,15,-3
28,28,216,17,17,0
28,28,217,6,9,-3
28,28,218,13,4,9
28,28,219,8,16,-8
28,28,220,14,19,-5
28,28,221,5,3,2
28,28,222,8,7,1
28,28,223,7,8,-1
28,28,224,8,6,2
28,28,225,17,10,7
28,28,226,13,6,7
28,28,227,9,14,-5
28,28,228,17,13,4
28,28,229,19,15,4
28,28,230,10,10,0
28,28,231,7,10,-3
28,28,232,19,4,15
28,28,233,12,22,-10
28,28,234,14,8,6
28,28,235,9,11,-2
28,28,236,12,18,-6
28,28,237,9,8,1
28,28,238,9,12,-3
28,28,239,9,13,-4
28,28,240,7,10,-3
28,28,241,9,10,-1
28,28,242,12,5,7
28,28,243,7,7,0
28,28,244,6,14,-8
28,28,245,7,18,-11
28,28,246,11,6,5
28,28,247,9,7,2
28,28,248,13,11,2
28,28,249,9,12,-3
28,28,250,9,7,2
28,28,251,16,20,-4
28,28,252,11,10,1
28,28,253,10,7,3
28,28,254,6,8,-2
28,28,255,18,9,9
28,28,256,13,12,1
28,28,257,5,15,-10
28,28,258,14,19,-5
28,28,259,9,6,3
28,28,260,17,16,1
28,28,261,10,4,6
28,28,262,10,9,1
28,28,263,8,19,-11
28,28,264,10,9,1
28,28,265,9,9,0
28,28,266,5,9,-4
28,28,267,8,11,-3
28,28,268,13,12,1
28,28,269,7,13,-6
28,28,270,15,20,-5
28,28,271,3,12,-9
28,28,272,16,11,5
28,28,273,14,16,-2
28,28,274,8,5,3
28,28,275,5,12,-7
28,28,276,8,8,0
28,28,277,8,16,-8
28,28,278,6,11,-5
28,28,279,15,14,1
28,28,280,10,2,8
28,28,281,11,18,-7
28,28,282,10,21,-11
28,28,283,12,16,-4
28,28,284,8,11,-3
28,28,285,10,12,-2
28,28,286,14,14,0
28,28,287,8,15,-7
28,28,288,9,7,2
28,28,289,9,10,-1
28,28,290,12,10,2
28,28,291,10,21,-11
28,28,292,8,15,-7
28,28,293,5,22,-17
28,28,294,19,10,9
28,28,295,6,9,-3
28,28,296,5,8,-3
28,28,297,15,15,0
28,28,298,14,18,-4
28,28,299,7,11,-4
28,29,0,6,12,-6
28,29,1,9,6,3
28,29,2,13,11,2
28,29,3,9,6,3
28,29,4,12,12,0
28,29,5,14,20,-6
28,29,6,15,12,3
28,29,7,13,15,-2
28,29,8,13,8,5
28,29,9,9,9,0
28,29,10,14,13,1
28,29,11,19,9,10
28,29,12,9,11,-2
28,29,13,7,9,-2
28,29,14,8,9,-1
28,29,15,14,9,5
28,29,16,6,7,-1
28,29,17,21,6,15
28,29,18,9,11,-2
28,29,19,10,17,-7
28,29,20,6,2,4
28,29,21,15,17,-2
28,29,22,12,12,0
28,29,23,16,27,-11
28,29,24,10,10,0
28,29,25,2,9,-7
28,29,26,6,12,-6
28,29,27,24,13,11
28,29,28,14,8,6
28,29,29,12,8,4
28,29,30,18,7,11
28,29,31,5,8,-3
28,29,32,21,14,7
28,29,33,7,6,1
28,29,34,9,13,-4
28,29,35,14,19,-5
28,29,36,20,13,7
28,29,37,16,8,8
28,29,38,10,9,1
28,29,39,17,29,-12
28,29,40,6,3,3
28,29,41,10,5,5
28,29,42,19,11,8
28,29,43,18,10,8
28,29,44,21,11,10
28,29,45,11,13,-2
28,29,46,15,16,-1
28,29,47,12,15,-3
28,29,48,15,18,-3
28,29,49,10,17,-7
28,29,50,20,17,3
28,29,51,16,9,7
28,29,52,12,9,3
28,29,53,5,12,-7
28,29,54,6,12,-6
28,29,55,14,10,4
28,29,56,6,10,-4
28,29,57,7,9,-2
28,29,58,10,19,-9
28,29,59,30,13,17
28,29,60,18,10,8
28,29,61,11,9,2
28,29,62,11,10,1
28,29,63,13,13,0
28,29,64,7,14,-7
28,29,65,8,7,1
28,29,66,12,10,2
28,29,67,7,13,-6
28,29,68,14,13,1
28,29,69,14,23,-9
28,29,70,8,19,-11
28,29,71,2,8,-6
28,29,72,13,13,0
28,29,73,13,11,2
28,29,74,8,12,-4
28,29,75,8,9,-1
28,29,76,12,12,0
28,29,77,12,23,-11
28,29,78,24,10,14
28,29,79,15,10,5
28,29,80,21,17,4
28,29,81,12,14,-2
28,29,82,5,6,-1
28,29,83,7,11,-4
28,29,84,15,13,2
28,29,85,12,20,-8
28,29,86,3,8,-5
28,29,87,14,11,3
28,29,88,14,16,-2
28,29,89,9,13,-4
28,29,90,12,19,-7
28,29,91,14,7,7
28,29,92,10,13,-3
28,29,93,22,13,9
28,29,94,9,12,-3
28,29,95,13,12,1
28,29,96,24,10,14
28,29,97,13,15,-2
28,29,98,9,10,-1
28,29,99,17,4,13
28,29,100,9,13,-4
28,29,101,10,4,6
28,29,102,18,12,6
28,29,103,10,12,-2
28,29,104,15,8,7
28,29,105,18,19,-1
28,29,106,5,17,-12
28,29,107,13,5,8
28,29,108,15,20,-5
28,29,109,8,11,-3
28,29,110,10,14,-4
28,29,111,10,9,1
28,29,112,11,6,5
28,29,113,14,16,-2
28,29,114,15,20,-5
28,29,115,19,24,-5
28,29,116,9,18,-9
28,29,117,11,27,-16
28,29,118,12,11,1
28,29,119,14,5,9
28,29,120,10,9,1
28,29,121,7,17,-10
28,29,122,16,13,3
28,29,123,9,24,-15
28,29,124,12,13,-1
28,29,125,9,9,0
28,29,126,6,20,-14
28,29,127,8,9,-1
28,29,128,10,2,8
28,29,129,17,11,6
28,29,130,6,3,3
28,29,131,17,14,3
28,29,132,19,5,14
28,29,133,0,2,-2
28,29,134,9,8,1
28,29,135,17,8,9
28,29,136,20,6,14
28,29,137,5,12,-7
28,29,138,14,14,0
28,29,139,7,16,-9
28,29,140,17,6,11
28,29,141,8,15,-7
28,29,142,14,12,2
28,29,143,28,16,12
28,29,144,15,6,9
28,29,145,10,10,0
28,29,146,10,17,-7
28,29,147,10,11,-1
28,29,148,10,11,-1
28,29,149,17,11,6
28,29,150,24,28,-4
28,29,151,4,4,0
28,29,152,12,6,6
28,29,153,13,8,5
28,29,154,24,12,12
28,29,155,9,12,-3
28,29,156,12,20,-8
28,29,157,11,12,-1
28,29,158,6,6,0
28,29,159,7,10,-3
28,29,160,16,12,4
28,29,161,5,13,-8
28,29,162,15,4,11
28,29,163,12,18,-6
28,29,164,11,5,6
28,29,165,10,7,3
28,29,166,5,5,0
28,29,167,10,12,-2
28,29,168,8,9,-1
28,29,169,15,14,1
28,29,170,9,2,7
28,29,171,14,10,4
28,29,172,4,8,-4
28,29,173,9,15,-6
28,29,174,15,11,4
28,29,175,10,13,-3
28,29,176,14,13,1
28,29,177,16,13,3
28,29,178,11,23,-12
28,29,179,3,6,-3
28,29,180,7,14,-7
28,29,181,8,13,-5
28,29,182,19,14,5
28,29,183,10,8,2
28,29,184,14,13,1
28,29,185,17,11,6
28,29,186,4,26,-22
28,29,187,7,11,-4
28,29,188,11,11,0
28,29,189,4,8,-4
28,29,190,7,19,-12
28,29,191,6,8,-2
28,29,192,10,4,6
28,29,193,11,6,5
28,29,194,11,12,-1
28,29,195,17,5,12
28,29,196,9,10,-1
28,29,197,12,12,0
28,29,198,12,14,-2
28,29,199,8,12,-4
28,29,200,14,12,2
28,29,201,15,16,-1
28,29,202,15,6,9
28,29,203,5,7,-2
28,29,204,15,15,0
28,29,205,24,9,15
28,29,206,7,10,-3
28,29,207,9,8,1
28,29,208,8,7,1
28,29,209,6,10,-4
28,29,210,12,10,2
28,29,211,15,12,3
28,29,212,2,10,-8
28,29,213,8,22,-14
28,29,214,23,19,4
28,29,215,9,13,-4
28,29,216,12,13,-1
28,29,217,17,17,0
28,29,218,8,9,-1
28,29,219,11,18,-7
28,29,220,8,10,-2
28,29,221,7,7,0
28,29,222,4,10,-6
28,29,223,8,8,0
28,29,224,5,16,-11
28,29,225,9,14,-5
28,29,226,5,6,-1
28,29,227,16,16,0
28,29,228,13,10,3
28,29,229,11,7,4
28,29,230,20,21,-1
28,29,231,12,16,-4
28,29,232,29,8,21
28,29,233,7,11,-4
28,29,234,10,6,4
28,29,235,15,24,-9
28,29,236,15,8,7
28,29,237,7,14,-7
28,29,238,15,18,-3
28,29,239,12,7,5
28,29,240,17,12,5
28,29,241,7,17,-10
28,29,242,12,11,1
28,29,243,10,13,-3
28,29,244,21,10,11
28,29,245,23,16,7
28,29,246,8,15,-7
28,29,247,27,22,5
28,29,248,8,9,-1
28,29,249,8,7,1
28,29,250,10,13,-3
28,29,251,10,12,-2
28,29,252,17,2,15
28,29,253,9,13,-4
28,29,254,7,10,-3
28,29,255,12,20,-8
28,29,256,13,10,3
28,29,257,15,3,12
28,29,258,9,7,2
28,29,259,15,9,6
28,29,260,9,11,-2
28,29,261,15,24,-9
28,29,262,10,4,6
28,29,263,10,9,1
28,29,264,23,16,7
28,29,265,13,16,-3
28,29,266,2,17,-15
28,29,267,18,25,-7
28,29,268,8,10,-2
28,29,269,14,3,11
28,29,270,9,11,-2
28,29,271,6,20,-14
28,29,272,14,6,8
28,29,273,5,7,-2
28,29,274,10,18,-8
28,29,275,19,14,5
28,29,276,8,11,-3
28,29,277,7,6,1
28,29,278,6,14,-8
28,29,279,7,25,-18
28,29,280,12,10,2
28,29,281,11,9,2
28,29,282,11,15,-4
28,29,283,14,12,2
28,29,284,6,10,-4
28,29,285,10,6,4
28,29,286,8,10,-2
28,29,287,6,8,-2
28,29,288,15,9,6
28,29,289,15,23,-8
28,29,290,15,7,8
28,29,291,16,13,3
28,29,292,14,13,1
28,29,293,5,11,-6
28,29,294,6,12,-6
28,29,295,6,19,-13
28,29,296,4,7,-3
28,29,297,9,8,1
28,29,298,12,6,6
28,29,299,17,15,2
28,30,0,7,17,-10
28,30,1,18,12,6
28,30,2,5,24,-19
28,30,3,16,9,7
28,30,4,11,11,0
28,30,5,6,5,1
28,30,6,13,17,-4
28,30,7,17,18,-1
28,30,8,9,15,-6
28,30,9,13,21,-8
28,30,10,8,14,-6
28,30,11,16,11,5
28,30,12,9,15,-6
28,30,13,24,11,13
28,30,14,5,14,-9
28,30,15,6,18,-12
28,30,16,6,4,2
28,30,17,25,10,15
28,30,18,14,8,6
28,30,19,10,11,-1
28,30,20,24,11,13
28,30,21,13,12,1
28,30,22,9,16,-7
28,30,23,12,21,-9
28,30,24,7,9,-2
28,30,25,5,20,-15
28,30,26,19,15,4
28,30,27,7,7,0
28,30,28,19,14,5
28,30,29,16,13,3
28,30,30,11,23,-12
28,30,31,11,14,-3
28,30,32,9,13,-4
28,30,33,10,9,1
28,30,34,7,7,0
28,30,35,9,14,-5
28,30,36,4,14,-10
28,30,37,11,21,-10
28,30,38,7,14,-7
28,30,39,11,2,9
28,30,40,4,14,-10
28,30,41,10,4,6
28,30,42,23,11,12
28,30,43,7,10,-3
28,30,44,6,7,-1
28,30,45,8,20,-12
28,30,46,11,3,8
28,30,47,16,8,8
28,30,48,12,15,-3
28,30,49,15,11,4
28,30,50,13,12,1
28,30,51,15,15,0
28,30,52,14,15,-1
28,30,53,15,9,6
28,30,54,3,13,-10
28,30,55,11,14,-3
28,30,56,5,8,-3
28,30,57,9,12,-3
28,30,58,12,17,-5
28,30,59,22,19,3
28,30,60,11,6,5
28,30,61,11,5,6
28,30,62,13,17,-4
28,30,63,11,18,-7
28,30,64,15,13,2
28,30,65,10,17,-7
28,30,66,8,7,1
28,30,67,1,10,-9
28,30,68,11,19,-8
28,30,69,16,17,-1
28,30,70,14,16,-2
28,30,71,11,11,0
28,30,72,19,18,1
28,30,73,18,16,2
28,30,74,5,8,-3
28,30,75,5,12,-7
28,30,76,16,10,6
28,30,77,9,15,-6
28,30,78,5,8,-3
28,30,79,6,9,-3
28,30,80,19,19,0
28,30,81,16,20,-4
28,30,82,18,19,-1
28,30,83,13,16,-3
28,30,84,19,19,0
28,30,85,15,7,8
28,30,86,12,13,-1
28,30,87,12,9,3
28,30,88,7,7,0
28,30,89,6,7,-1
28,30,90,12,13,-1
28,30,91,15,9,6
28,30,92,17,14,3
28,30,93,7,9,-2
28,30,94,2,6,-4
28,30,95,7,12,-5
28,30,96,5,7,-2
28,30,97,5,14,-9
28,30,98,11,6,5
28,30,99,8,18,-10
28,30,100,15,28,-13
28,30,101,11,16,-5
28,30,102,9,15,-6
28,30,103,15,9,6
28,30,104,5,11,-6
28,30,105,18,27,-9
28,30,106,7,3,4
28,30,107,19,8,11
28,30,108,7,6,1
28,30,109,12,7,5
28,30,110,5,5,0
28,30,111,13,12,1
28,30,112,8,7,1
28,30,113,8,3,5
28,30,114,16,15,1
28,30,115,14,11,3
28,30,116,10,14,-4
28,30,117,9,4,5
28,30,118,13,16,-3
28,30,119,8,12,-4
28,30,120,21,12,9
28,30,121,0,12,-12
28,30,122,8,12,-4
28,30,123,18,8,10
28,30,124,4,6,-2
28,30,125,10,7,3
28,30,126,10,7,3
28,30,127,8,11,-3
28,30,128,14,17,-3
28,30,129,8,5,3
28,30,130,16,16,0
28,30,131,16,13,3
28,30,132,9,9,0
28,30,133,12,19,-7
28,30,134,4,7,-3
28,30,135,13,10,3
28,30,136,6,9,-3
28,30,137,17,22,-5
28,30,138,13,13,0
28,30,139,15,14,1
28,30,140,7,22,-15
28,30,141,16,16,0
28,30,142,11,5,6
28,30,143,26,29,-3
28,30,144,9,8,1
28,30,145,15,7,8
28,30,146,7,5,2
28,30,147,14,15,-1
28,30,148,24,10,14
28,30,149,12,6,6
28,30,150,7,9,-2
28,30,151,10,11,-1
28,30,152,13,12,1
28,30,153,18,16,2
28,30,154,12,9,3
28,30,155,11,13,-2
28,30,156,13,14,-1
28,30,157,13,17,-4
28,30,158,5,5,0
28,30,159,13,10,3
28,30,160,17,15,2
28,30,161,12,19,-7
28,30,162,15,15,0
28,30,163,12,14,-2
28,30,164,8,17,-9
28,30,165,16,15,1
28,30,166,9,16,-7
28,30,167,13,6,7
28,30,168,11,7,4
28,30,169,11,14,-3
28,30,170,13,15,-2
28,30,171,7,6,1
28,30,172,4,9,-5
28,30,173,12,18,-6
28,30,174,12,18,-6
28,30,175,11,5,6
28,30,176,14,6,8
28,30,177,6,7,-1
28,30,178,8,15,-7
28,30,179,9,1,8
28,30,180,12,4,8
28,30,181,12,10,2
28,30,182,25,7,18
28,30,183,15,12,3
28,30,184,25,15,10
28,30,185,14,18,-4
28,30,186,8,13,-5
28,30,187,12,12,0
28,30,188,13,15,-2
28,30,189,13,5,8
28,30,190,19,25,-6
28,30,191,9,20,-11
28,30,192,9,10,-1
28,30,193,8,10,-2
28,30,194,10,10,0
28,30,195,19,21,-2
28,30,196,9,6,3
28,30,197,9,9,0
28,30,198,9,7,2
28,30,199,10,17,-7
28,30,200,6,10,-4
28,30,201,19,27,-8
28,30,202,12,14,-2
28,30,203,3,9,-6
28,30,204,23,10,13
28,30,205,11,10,1
28,30,206,12,13,-1
28,30,207,8,13,-5
28,30,208,12,18,-6
28,30,209,11,20,-9
28,30,210,4,8,-4
28,30,211,12,31,-19
28,30,212,8,14,-6
28,30,213,13,12,1
28,30,214,15,7,8
28,30,215,11,10,1
28,30,216,13,7,6
28,30,217,7,4,3
28,30,218,6,15,-9
28,30,219,15,16,-1
28,30,220,15,17,-2
28,30,221,3,4,-1
28,30,222,5,10,-5
28,30,223,5,23,-18
28,30,224,22,8,14
28,30,225,6,6,0
28,30,226,7,10,-3
28,30,227,8,12,-4
28,30,228,5,11,-6
28,30,229,12,8,4
28,30,230,9,12,-3
28,30,231,8,9,-1
28,30,232,16,11,5
28,30,233,14,3,11
28,30,234,6,6,0
28,30,235,3,8,-5
28,30,236,11,7,4
28,30,237,16,6,10
28,30,238,12,10,2
28,30,239,12,8,4
28,30,240,9,8,1
28,30,241,6,7,-1
28,30,242,18,17,1
28,30,243,18,19,-1
28,30,244,18,23,-5
28,30,245,11,13,-2
28,30,246,15,19,-4
28,30,247,16,15,1
28,30,248,12,10,2
28,30,249,9,16,-7
28,30,250,11,21,-10
28,30,251,19,13,6
28,30,252,13,7,6
28,30,253,13,11,2
28,30,254,24,8,16
28,30,255,7,5,2
28,30,256,10,15,-5
28,30,257,11,8,3
28,30,258,5,8,-3
28,30,259,17,11,6
28,30,260,14,7,7
28,30,261,14,25,-11
28,30,262,16,0,16
28,30,263,6,14,-8
28,30,264,18,10,8
28,30,265,15,10,5
28,30,266,13,4,9
28,30,267,9,16,-7
28,30,268,3,2,1
28,30,269,9,10,-1
28,30,270,15,15,0
28,30,271,10,13,-3
28,30,272,22,24,-2
28,30,273,3,12,-9
28,30,274,17,12,5
28,30,275,9,6,3
28,30,276,16,9,7
28,30,277,23,13,10
28,30,278,8,8,0
28,30,279,8,9,-1
28,30,280,11,11,0
28,30,281,13,15,-2
28,30,282,11,6,5
28,30,283,6,6,0
28,30,284,14,10,4
28,30,285,14,12,2
28,30,286,6,10,-4
28,30,287,15,23,-8
28,30,288,19,9,10
28,30,289,14,18,-4
28,30,290,9,14,-5
28,30,291,6,20,-14
28,30,292,2,9,-7
28,30,293,16,4,12
28,30,294,4,7,-3
28,30,295,11,8,3
28,30,296,17,17,0
28,30,297,15,13,2
28,30,298,16,7,9
28,30,299,10,16,-6
29,1,0,0,17,-17
29,1,1,6,7,-1
29,1,2,6,12,-6
29,1,3,7,24,-17
29,1,4,6,20,-14
29,1,5,2,10,-8
29,1,6,4,14,-10
29,1,7,5,21,-16
29,1,8,2,16,-14
29,1,9,4,24,-20
29,1,10,3,10,-7
29,1,11,9,9,0
29,1,12,4,22,-18
29,1,13,5,13,-8
29,1,14,12,7,5
29,1,15,7,30,-23
29,1,16,5,20,-15
29,1,17,7,15,-8
29,1,18,9,24,-15
29,1,19,6,19,-13
29,1,20,7,21,-14
29,1,21,10,19,-9
29,1,22,4,16,-12
29,1,23,4,11,-7
29,1,24,6,21,-15
29,1,25,7,25,-18
29,1,26,6,22,-16
29,1,27,6,13,-7
29,1,28,10,32,-22
29,1,29,1,6,-5
29,1,30,7,28,-21
29,1,31,14,28,-14
29,1,32,9,20,-11
29,1,33,6,17,-11
29,1,34,8,23,-15
29,1,35,4,24,-20
29,1,36,9,16,-7
29,1,37,10,20,-10
29,1,38,13,26,-13
29,1,39,9,12,-3
29,1,40,4,20,-16
29,1,41,7,8,-1
29,1,42,7,13,-6
29,1,43,4,26,-22
29,1,44,3,18,-15
29,1,45,3,18,-15
29,1,46,10,18,-8
29,1,47,9,20,-11
29,1,48,5,12,-7
29,1,49,10,7,3
29,1,50,4,16,-12
29,1,51,7,15,-8
29,1,52,4,15,-11
29,1,53,8,13,-5
29,1,54,5,15,-10
29,1,55,5,20,-15
29,1,56,6,23,-17
29,1,57,4,12,-8
29,1,58,4,15,-11
29,1,59,6,17,-11
29,1,60,5,6,-1
29,1,61,5,17,-12
29,1,62,9,21,-12
29,1,63,8,16,-8
29,1,64,4,9,-5
29,1,65,8,16,-8
29,1,66,3,20,-17
29,1,67,4,19,-15
29,1,68,8,13,-5
29,1,69,3,8,-5
29,1,70,9,19,-10
29,1,71,18,10,8
29,1,72,1,17,-16
29,1,73,9,10,-1
29,1,74,10,25,-15
29,1,75,13,13,0
29,1,76,6,35,-29
29,1,77,14,28,-14
29,1,78,5,15,-10
29,1,79,9,26,-17
29,1,80,8,12,-4
29,1,81,2,24,-22
29,1,82,6,18,-12
29,1,83,6,22,-16
29,1,84,7,10,-3
29,1,85,5,15,-10
29,1,86,10,16,-6
29,1,87,10,22,-12
29,1,88,9,14,-5
29,1,89,11,28,-17
29,1,90,4,13,-9
29,1,91,3,12,-9
29,1,92,13,24,-11
29,1,93,9,10,-1
29,1,94,7,11,-4
29,1,95,7,21,-14
29,1,96,2,26,-24
29,1,97,13,35,-22
29,1,98,7,18,-11
29,1,99,3,21,-18
29,1,100,9,11,-2
29,1,101,2,12,-10
29,1,102,2,9,-7
29,1,103,19,21,-2
29,1,104,5,12,-7
29,1,105,6,8,-2
29,1,106,4,15,-11
29,1,107,12,18,-6
29,1,108,4,13,-9
29,1,109,3,19,-16
29,1,110,9,14,-5
29,1,111,4,11,-7
29,1,112,2,18,-16
29,1,113,5,23,-18
29,1,114,4,15,-11
29,1,115,10,10,0
29,1,116,2,5,-3
29,1,117,4,13,-9
29,1,118,6,16,-10
29,1,119,10,19,-9
29,1,120,4,8,-4
29,1,121,8,17,-9
29,1,122,8,10,-2
29,1,123,13,16,-3
29,1,124,7,23,-16
29,1,125,9,29,-20
29,1,126,7,10,-3
29,1,127,5,8,-3
29,1,128,3,20,-17
29,1,129,4,19,-15
29,1,130,2,2,0
29,1,131,12,18,-6
29,1,132,6,16,-10
29,1,133,2,17,-15
29,1,134,12,10,2
29,1,135,4,24,-20
29,1,136,10,12,-2
29,1,137,7,22,-15
29,1,138,5,12,-7
29,1,139,12,8,4
29,1,140,1,9,-8
29,1,141,6,17,-11
29,1,142,11,6,5
29,1,143,4,19,-15
29,1,144,4,16,-12
29,1,145,4,4,0
29,1,146,1,12,-11
29,1,147,10,16,-6
29,1,148,5,13,-8
29,1,149,7,12,-5
29,1,150,13,30,-17
29,1,151,4,9,-5
29,1,152,10,18,-8
29,1,153,5,33,-28
29,1,154,4,20,-16
29,1,155,12,15,-3
29,1,156,7,9,-2
29,1,157,10,12,-2
29,1,158,4,7,-3
29,1,159,5,20,-15
29,1,160,3,7,-4
29,1,161,6,11,-5
29,1,162,16,20,-4
29,1,163,7,7,0
29,1,164,12,9,3
29,1,165,12,18,-6
29,1,166,10,23,-13
29,1,167,1,15,-14
29,1,168,8,26,-18
29,1,169,6,9,-3
29,1,170,6,22,-16
29,1,171,3,17,-14
29,1,172,8,13,-5
29,1,173,12,18,-6
29,1,174,11,22,-11
29,1,175,18,33,-15
29,1,176,13,23,-10
29,1,177,9,30,-21
29,1,178,4,14,-10
29,1,179,6,7,-1
29,1,180,1,15,-14
29,1,181,5,13,-8
29,1,182,6,7,-1
29,1,183,10,22,-12
29,1,184,3,13,-10
29,1,185,9,22,-13
29,1,186,11,18,-7
29,1,187,4,20,-16
29,1,188,8,19,-11
29,1,189,5,14,-9
29,1,190,0,11,-11
29,1,191,7,25,-18
29,1,192,12,15,-3
29,1,193,6,19,-13
29,1,194,2,13,-11
29,1,195,7,15,-8
29,1,196,5,10,-5
29,1,197,6,3,3
29,1,198,10,27,-17
29,1,199,10,12,-2
29,1,200,6,16,-10
29,1,201,5,8,-3
29,1,202,4,27,-23
29,1,203,10,7,3
29,1,204,8,4,4
29,1,205,7,26,-19
29,1,206,11,11,0
29,1,207,7,22,-15
29,1,208,13,11,2
29,1,209,18,33,-15
29,1,210,6,22,-16
29,1,211,7,15,-8
29,1,212,6,25,-19
29,1,213,0,12,-12
29,1,214,3,18,-15
29,1,215,10,9,1
29,1,216,10,22,-12
29,1,217,9,27,-18
29,1,218,5,16,-11
29,1,219,16,23,-7
29,1,220,15,29,-14
29,1,221,8,22,-14
29,1,222,9,7,2
29,1,223,6,15,-9
29,1,224,12,16,-4
29,1,225,6,23,-17
29,1,226,11,19,-8
29,1,227,14,23,-9
29,1,228,6,6,0
29,1,229,11,18,-7
29,1,230,8,13,-5
29,1,231,5,22,-17
29,1,232,6,9,-3
29,1,233,10,19,-9
29,1,234,3,14,-11
29,1,235,6,31,-25
29,1,236,2,22,-20
29,1,237,12,19,-7
29,1,238,12,20,-8
29,1,239,4,15,-11
29,1,240,19,14,5
29,1,241,4,12,-8
29,1,242,9,12,-3
29,1,243,6,17,-11
29,1,244,4,14,-10
29,1,245,2,7,-5
29,1,246,9,17,-8
29,1,247,8,9,-1
29,1,248,13,14,-1
29,1,249,8,30,-22
29,1,250,9,22,-13
29,1,251,6,12,-6
29,1,252,4,19,-15
29,1,253,4,14,-10
29,1,254,4,10,-6
29,1,255,15,17,-2
29,1,256,10,16,-6
29,1,257,3,7,-4
29,1,258,5,15,-10
29,1,259,12,19,-7
29,1,260,8,30,-22
29,1,261,6,25,-19
29,1,262,12,18,-6
29,1,263,0,9,-9
29,1,264,8,15,-7
29,1,265,17,30,-13
29,1,266,2,13,-11
29,1,267,9,11,-2
29,1,268,8,22,-14
29,1,269,4,17,-13
29,1,270,4,10,-6
29,1,271,2,12,-10
29,1,272,10,18,-8
29,1,273,12,23,-11
29,1,274,8,15,-7
29,1,275,7,15,-8
29,1,276,8,13,-5
29,1,277,10,26,-16
29,1,278,10,16,-6
29,1,279,10,8,2
29,1,280,8,34,-26
29,1,281,8,26,-18
29,1,282,15,21,-6
29,1,283,14,20,-6
29,1,284,8,8,0
29,1,285,7,16,-9
29,1,286,6,12,-6
29,1,287,4,22,-18
29,1,288,5,25,-20
29,1,289,3,2,1
29,1,290,5,20,-15
29,1,291,7,17,-10
29,1,292,9,13,-4
29,1,293,6,29,-23
29,1,294,2,10,-8
29,1,295,0,7,-7
29,1,296,9,23,-14
29,1,297,10,14,-4
29,1,298,2,10,-8
29,1,299,3,18,-15
29,2,0,7,37,-30
29,2,1,4,19,-15
29,2,2,7,17,-10
29,2,3,7,19,-12
29,2,4,14,42,-28
29,2,5,9,16,-7
29,2,6,5,19,-14
29,2,7,0,14,-14
29,2,8,5,8,-3
29,2,9,5,17,-12
29,2,10,7,17,-10
29,2,11,2,31,-29
29,2,12,9,21,-12
29,2,13,5,12,-7
29,2,14,10,14,-4
29,2,15,3,8,-5
29,2,16,3,10,-7
29,2,17,6,16,-10
29,2,18,7,8,-1
29,2,19,3,23,-20
29,2,20,12,16,-4
29,2,21,8,15,-7
29,2,22,5,13,-8
29,2,23,7,17,-10
29,2,24,7,24,-17
29,2,25,2,17,-15
29,2,26,4,13,-9
29,2,27,7,19,-12
29,2,28,5,14,-9
29,2,29,7,15,-8
29,2,30,6,13,-7
29,2,31,0,6,-6
29,2,32,5,21,-16
29,2,33,7,14,-7
29,2,34,3,10,-7
29,2,35,11,13,-2
29,2,36,11,20,-9
29,2,37,9,3,6
29,2,38,4,27,-23
29,2,39,3,10,-7
29,2,40,8,26,-18
29,2,41,3,21,-18
29,2,42,10,25,-15
29,2,43,8,29,-21
29,2,44,15,31,-16
29,2,45,15,13,2
29,2,46,9,23,-14
29,2,47,7,24,-17
29,2,48,6,19,-13
29,2,49,2,37,-35
29,2,50,11,33,-22
29,2,51,12,23,-11
29,2,52,6,23,-17
29,2,53,14,21,-7
29,2,54,7,16,-9
29,2,55,6,17,-11
29,2,56,9,21,-12
29,2,57,2,14,-12
29,2,58,5,20,-15
29,2,59,8,21,-13
29,2,60,16,22,-6
29,2,61,3,7,-4
29,2,62,4,25,-21
29,2,63,2,20,-18
29,2,64,6,20,-14
29,2,65,8,16,-8
29,2,66,11,18,-7
29,2,67,10,15,-5
29,2,68,3,24,-21
29,2,69,11,28,-17
29,2,70,17,20,-3
29,2,71,8,22,-14
29,2,72,5,21,-16
29,2,73,10,20,-10
29,2,74,14,18,-4
29,2,75,8,32,-24
29,2,76,5,30,-25
29,2,77,11,14,-3
29,2,78,15,31,-16
29,2,79,0,5,-5
29,2,80,2,19,-17
29,2,81,7,8,-1
29,2,82,7,11,-4
29,2,83,11,19,-8
29,2,84,5,11,-6
29,2,85,8,23,-15
29,2,86,2,14,-12
29,2,87,13,17,-4
29,2,88,5,22,-17
29,2,89,3,17,-14
29,2,90,5,13,-8
29,2,91,8,13,-5
29,2,92,2,16,-14
29,2,93,1,21,-20
29,2,94,6,18,-12
29,2,95,6,19,-13
29,2,96,10,14,-4
29,2,97,10,9,1
29,2,98,8,19,-11
29,2,99,7,17,-10
29,2,100,7,19,-12
29,2,101,7,37,-30
29,2,102,4,24,-20
29,2,103,8,27,-19
29,2,104,8,24,-16
29,2,105,5,24,-19
29,2,106,6,27,-21
29,2,107,3,22,-19
29,2,108,4,13,-9
29,2,109,13,35,-22
29,2,110,1,11,-10
29,2,111,5,23,-18
29,2,112,6,17,-11
29,2,113,6,16,-10
29,2,114,6,23,-17
29,2,115,5,7,-2
29,2,116,1,9,-8
29,2,117,3,8,-5
29,2,118,4,22,-18
29,2,119,15,19,-4
29,2,120,8,12,-4
29,2,121,4,20,-16
29,2,122,14,25,-11
29,2,123,11,12,-1
29,2,124,3,24,-21
29,2,125,7,30,-23
29,2,126,9,31,-22
29,2,127,12,27,-15
29,2,128,9,34,-25
29,2,129,5,13,-8
29,2,130,10,12,-2
29,2,131,5,25,-20
29,2,132,10,17,-7
29,2,133,12,21,-9
29,2,134,6,6,0
29,2,135,6,19,-13
29,2,136,9,11,-2
29,2,137,6,24,-18
29,2,138,7,22,-15
29,2,139,9,22,-13
29,2,140,8,26,-18
29,2,141,9,26,-17
29,2,142,3,20,-17
29,2,143,7,12,-5
29,2,144,10,18,-8
29,2,145,5,9,-4
29,2,146,1,7,-6
29,2,147,8,9,-1
29,2,148,8,16,-8
29,2,149,7,20,-13
29,2,150,8,34,-26
29,2,151,9,22,-13
29,2,152,8,31,-23
29,2,153,5,27,-22
29,2,154,3,9,-6
29,2,155,13,25,-12
29,2,156,18,16,2
29,2,157,6,14,-8
29,2,158,9,12,-3
29,2,159,5,15,-10
29,2,160,11,27,-16
29,2,161,8,16,-8
29,2,162,9,21,-12
29,2,163,9,32,-23
29,2,164,7,15,-8
29,2,165,7,16,-9
29,2,166,13,26,-13
29,2,167,5,17,-12
29,2,168,6,15,-9
29,2,169,2,20,-18
29,2,170,15,16,-1
29,2,171,12,26,-14
29,2,172,7,15,-8
29,2,173,7,18,-11
29,2,174,7,20,-13
29,2,175,3,23,-20
29,2,176,9,14,-5
29,2,177,1,8,-7
29,2,178,9,34,-25
29,2,179,3,24,-21
29,2,180,6,15,-9
29,2,181,3,16,-13
29,2,182,2,16,-14
29,2,183,5,9,-4
29,2,184,6,29,-23
29,2,185,2,11,-9
29,2,186,4,10,-6
29,2,187,9,32,-23
29,2,188,3,19,-16
29,2,189,14,45,-31
29,2,190,10,19,-9
29,2,191,7,18,-11
29,2,192,21,22,-1
29,2,193,11,21,-10
29,2,194,6,25,-19
29,2,195,4,12,-8
29,2,196,7,13,-6
29,2,197,2,17,-15
29,2,198,3,7,-4
29,2,199,13,31,-18
29,2,200,13,32,-19
29,2,201,5,17,-12
29,2,202,18,13,5
29,2,203,4,15,-11
29,2,204,14,23,-9
29,2,205,9,25,-16
29,2,206,4,21,-17
29,2,207,4,15,-11
29,2,208,6,12,-6
29,2,209,6,10,-4
29,2,210,3,18,-15
29,2,211,15,28,-13
29,2,212,2,15,-13
29,2,213,25,22,3
29,2,214,9,22,-13
29,2,215,8,17,-9
29,2,216,13,28,-15
29,2,217,5,17,-12
29,2,218,12,14,-2
29,2,219,9,14,-5
29,2,220,5,4,1
29,2,221,18,20,-2
29,2,222,5,8,-3
29,2,223,1,13,-12
29,2,224,4,31,-27
29,2,225,6,21,-15
29,2,226,2,14,-12
29,2,227,5,15,-10
29,2,228,7,30,-23
29,2,229,11,23,-12
29,2,230,9,25,-16
29,2,231,11,6,5
29,2,232,1,8,-7
29,2,233,7,22,-15
29,2,234,2,7,-5
29,2,235,5,34,-29
29,2,236,12,22,-10
29,2,237,7,19,-12
29,2,238,9,23,-14
29,2,239,13,15,-2
29,2,240,2,13,-11
29,2,241,8,16,-8
29,2,242,5,7,-2
29,2,243,6,14,-8
29,2,244,11,21,-10
29,2,245,5,28,-23
29,2,246,7,12,-5
29,2,247,6,11,-5
29,2,248,7,21,-14
29,2,249,11,9,2
29,2,250,6,4,2
29,2,251,6,17,-11
29,2,252,6,26,-20
29,2,253,4,17,-13
29,2,254,5,13,-8
29,2,255,8,21,-13
29,2,256,12,25,-13
29,2,257,2,16,-14
29,2,258,4,20,-16
29,2,259,11,21,-10
29,2,260,8,16,-8
29,2,261,2,17,-15
29,2,262,10,20,-10
29,2,263,5,19,-14
29,2,264,10,33,-23
29,2,265,7,20,-13
29,2,266,2,11,-9
29,2,267,4,15,-11
29,2,268,12,20,-8
29,2,269,10,32,-22
29,2,270,5,20,-15
29,2,271,7,16,-9
29,2,272,11,24,-13
29,2,273,5,11,-6
29,2,274,10,27,-17
29,2,275,8,23,-15
29,2,276,6,9,-3
29,2,277,13,15,-2
29,2,278,13,16,-3
29,2,279,2,23,-21
29,2,280,10,16,-6
29,2,281,3,28,-25
29,2,282,4,8,-4
29,2,283,5,26,-21
29,2,284,11,36,-25
29,2,285,6,12,-6
29,2,286,2,26,-24
29,2,287,4,11,-7
29,2,288,16,40,-24
29,2,289,18,25,-7
29,2,290,4,12,-8
29,2,291,6,23,-17
29,2,292,9,29,-20
29,2,293,6,29,-23
29,2,294,8,24,-16
29,2,295,2,8,-6
29,2,296,11,14,-3
29,2,297,5,15,-10
29,2,298,9,19,-10
29,2,299,7,10,-3
29,3,0,6,12,-6
29,3,1,9,19,-10
29,3,2,6,37,-31
29,3,3,9,20,-11
29,3,4,4,4,0
29,3,5,7,9,-2
29,3,6,6,13,-7
29,3,7,13,24,-11
29,3,8,5,24,-19
29,3,9,6,22,-16
29,3,10,6,21,-15
29,3,11,10,20,-10
29,3,12,10,18,-8
29,3,13,13,10,3
29,3,14,7,15,-8
29,3,15,10,22,-12
29,3,16,6,21,-15
29,3,17,6,28,-22
29,3,18,13,35,-22
29,3,19,4,34,-30
29,3,20,9,16,-7
29,3,21,13,17,-4
29,3,22,12,8,4
29,3,23,14,28,-14
29,3,24,10,25,-15
29,3,25,4,9,-5
29,3,26,6,22,-16
29,3,27,12,20,-8
29,3,28,9,33,-24
29,3,29,16,27,-11
29,3,30,16,23,-7
29,3,31,9,15,-6
29,3,32,4,21,-17
29,3,33,20,20,0
29,3,34,7,12,-5
29,3,35,6,19,-13
29,3,36,10,12,-2
29,3,37,7,31,-24
29,3,38,13,18,-5
29,3,39,9,20,-11
29,3,40,6,23,-17
29,3,41,5,4,1
29,3,42,4,16,-12
29,3,43,11,20,-9
29,3,44,4,23,-19
29,3,45,11,20,-9
29,3,46,7,29,-22
29,3,47,8,17,-9
29,3,48,9,25,-16
29,3,49,9,13,-4
29,3,50,7,10,-3
29,3,51,8,29,-21
29,3,52,8,32,-24
29,3,53,9,20,-11
29,3,54,8,16,-8
29,3,55,10,38,-28
29,3,56,10,19,-9
29,3,57,5,10,-5
29,3,58,14,28,-14
29,3,59,4,19,-15
29,3,60,6,20,-14
29,3,61,11,10,1
29,3,62,9,25,-16
29,3,63,12,23,-11
29,3,64,6,12,-6
29,3,65,13,13,0
29,3,66,13,38,-25
29,3,67,12,30,-18
29,3,68,9,20,-11
29,3,69,9,28,-19
29,3,70,11,24,-13
29,3,71,6,16,-10
29,3,72,9,12,-3
29,3,73,13,17,-4
29,3,74,2,6,-4
29,3,75,2,35,-33
29,3,76,11,22,-11
29,3,77,6,13,-7
29,3,78,5,10,-5
29,3,79,11,20,-9
29,3,80,3,18,-15
29,3,81,6,37,-31
29,3,82,10,20,-10
29,3,83,2,21,-19
29,3,84,6,20,-14
29,3,85,5,12,-7
29,3,86,14,27,-13
29,3,87,10,18,-8
29,3,88,6,18,-12
29,3,89,19,29,-10
29,3,90,22,15,7
29,3,91,14,17,-3
29,3,92,5,25,-20
29,3,93,9,15,-6
29,3,94,2,27,-25
29,3,95,7,21,-14
29,3,96,6,27,-21
29,3,97,6,15,-9
29,3,98,7,19,-12
29,3,99,5,15,-10
29,3,100,5,12,-7
29,3,101,7,21,-14
29,3,102,6,27,-21
29,3,103,11,26,-15
29,3,104,7,13,-6
29,3,105,2,15,-13
29,3,106,6,19,-13
29,3,107,12,16,-4
29,3,108,9,23,-14
29,3,109,9,27,-18
29,3,110,5,21,-16
29,3,111,4,16,-12
29,3,112,9,13,-4
29,3,113,5,20,-15
29,3,114,7,12,-5
29,3,115,9,33,-24
29,3,116,6,31,-25
29,3,117,8,22,-14
29,3,118,8,20,-12
29,3,119,6,12,-6
29,3,120,9,19,-10
29,3,121,9,7,2
29,3,122,7,17,-10
29,3,123,11,8,3
29,3,124,5,13,-8
29,3,125,12,18,-6
29,3,126,16,21,-5
29,3,127,4,15,-11
29,3,128,5,13,-8
29,3,129,6,15,-9
29,3,130,17,21,-4
29,3,131,15,25,-10
29,3,132,4,10,-6
29,3,133,2,30,-28
29,3,134,8,20,-12
29,3,135,9,24,-15
29,3,136,11,27,-16
29,3,137,13,21,-8
29,3,138,11,18,-7
29,3,139,15,19,-4
29,3,140,12,22,-10
29,3,141,10,13,-3
29,3,142,13,35,-22
29,3,143,3,7,-4
29,3,144,7,13,-6
29,3,145,12,27,-15
29,3,146,14,20,-6
29,3,147,6,13,-7
29,3,148,6,27,-21
29,3,149,10,23,-13
29,3,150,8,15,-7
29,3,151,16,36,-20
29,3,152,9,17,-8
29,3,153,9,27,-18
29,3,154,6,16,-10
29,3,155,8,17,-9
29,3,156,13,22,-9
29,3,157,8,3,5
29,3,158,4,29,-25
29,3,159,10,27,-17
29,3,160,14,30,-16
29,3,161,6,23,-17
29,3,162,14,17,-3
29,3,163,8,20,-12
29,3,164,11,21,-10
29,3,165,12,6,6
29,3,166,4,23,-19
29,3,167,7,22,-15
29,3,168,14,15,-1
29,3,169,6,9,-3
29,3,170,16,23,-7
29,3,171,7,19,-12
29,3,172,9,11,-2
29,3,173,7,16,-9
29,3,174,13,13,0
29,3,175,6,11,-5
29,3,176,7,11,-4
29,3,177,10,15,-5
29,3,178,11,22,-11
29,3,179,9,13,-4
29,3,180,16,20,-4
29,3,181,7,20,-13
29,3,182,5,11,-6
29,3,183,6,12,-6
29,3,184,5,28,-23
29,3,185,4,8,-4
29,3,186,10,21,-11
29,3,187,16,24,-8
29,3,188,10,27,-17
29,3,189,15,29,-14
29,3,190,4,23,-19
29,3,191,16,14,2
29,3,192,2,26,-24
29,3,193,14,21,-7
29,3,194,5,16,-11
29,3,195,1,7,-6
29,3,196,4,7,-3
29,3,197,1,12,-11
29,3,198,13,22,-9
29,3,199,3,10,-7
29,3,200,10,14,-4
29,3,201,3,12,-9
29,3,202,6,8,-2
29,3,203,7,14,-7
29,3,204,9,22,-13
29,3,205,5,27,-22
29,3,206,4,29,-25
29,3,207,8,34,-26
29,3,208,6,31,-25
29,3,209,6,17,-11
29,3,210,10,34,-24
29,3,211,1,11,-10
29,3,212,10,25,-15
29,3,213,8,10,-2
29,3,214,17,36,-19
29,3,215,11,23,-12
29,3,216,12,31,-19
29,3,217,6,12,-6
29,3,218,5,17,-12
29,3,219,6,6,0
29,3,220,19,44,-25
29,3,221,1,8,-7
29,3,222,3,15,-12
29,3,223,9,16,-7
29,3,224,12,36,-24
29,3,225,5,6,-1
29,3,226,8,13,-5
29,3,227,1,14,-13
29,3,228,3,17,-14
29,3,229,7,15,-8
29,3,230,5,14,-9
29,3,231,11,22,-11
29,3,232,10,26,-16
29,3,233,2,23,-21
29,3,234,2,15,-13
29,3,235,15,29,-14
29,3,236,13,24,-11
29,3,237,16,31,-15
29,3,238,11,22,-11
29,3,239,9,15,-6
29,3,240,19,24,-5
29,3,241,2,20,-18
29,3,242,13,26,-13
29,3,243,6,15,-9
29,3,244,1,5,-4
29,3,245,8,17,-9
29,3,246,10,11,-1
29,3,247,14,22,-8
29,3,248,6,20,-14
29,3,249,8,26,-18
29,3,250,10,13,-3
29,3,251,3,11,-8
29,3,252,10,25,-15
29,3,253,5,13,-8
29,3,254,5,26,-21
29,3,255,13,27,-14
29,3,256,9,23,-14
29,3,257,11,23,-12
29,3,258,16,13,3
29,3,259,6,7,-1
29,3,260,5,13,-8
29,3,261,14,39,-25
29,3,262,1,18,-17
29,3,263,13,23,-10
29,3,264,9,17,-8
29,3,265,10,13,-3
29,3,266,9,33,-24
29,3,267,6,29,-23
29,3,268,8,19,-11
29,3,269,9,30,-21
29,3,270,2,8,-6
29,3,271,7,15,-8
29,3,272,3,18,-15
29,3,273,9,28,-19
29,3,274,9,18,-9
29,3,275,4,19,-15
29,3,276,2,12,-10
29,3,277,3,18,-15
29,3,278,10,24,-14
29,3,279,8,6,2
29,3,280,15,21,-6
29,3,281,5,23,-18
29,3,282,4,15,-11
29,3,283,2,23,-21
29,3,284,5,15,-10
29,3,285,4,20,-16
29,3,286,2,32,-30
29,3,287,6,34,-28
29,3,288,4,18,-14
29,3,289,6,16,-10
29,3,290,5,14,-9
29,3,291,8,36,-28
29,3,292,5,11,-6
29,3,293,6,23,-17
29,3,294,11,26,-15
29,3,295,2,17,-15
29,3,296,1,27,-26
29,3,297,10,33,-23
29,3,298,6,19,-13
29,3,299,10,14,-4
29,4,0,5,11,-6
29,4,1,19,15,4
29,4,2,3,16,-13
29,4,3,12,20,-8
29,4,4,7,28,-21
29,4,5,3,9,-6
29,4,6,5,26,-21
29,4,7,12,29,-17
29,4,8,1,9,-8
29,4,9,2,28,-26
29,4,10,6,16,-10
29,4,11,9,12,-3
29,4,12,16,21,-5
29,4,13,16,25,-9
29,4,14,4,18,-14
29,4,15,6,29,-23
29,4,16,6,17,-11
29,4,17,3,22,-19
29,4,18,2,28,-26
29,4,19,13,21,-8
29,4,20,10,23,-13
29,4,21,16,18,-2
29,4,22,13,27,-14
29,4,23,2,12,-10
29,4,24,7,28,-21
29,4,25,5,24,-19
29,4,26,9,14,-5
29,4,27,5,18,-13
29,4,28,5,4,1
29,4,29,6,20,-14
29,4,30,5,9,-4
29,4,31,15,31,-16
29,4,32,17,19,-2
29,4,33,18,26,-8
29,4,34,12,27,-15
29,4,35,1,11,-10
29,4,36,4,11,-7
29,4,37,12,22,-10
29,4,38,7,21,-14
29,4,39,10,12,-2
29,4,40,3,14,-11
29,4,41,13,20,-7
29,4,42,7,19,-12
29,4,43,2,14,-12
29,4,44,8,32,-24
29,4,45,10,11,-1
29,4,46,8,28,-20
29,4,47,6,16,-10
29,4,48,13,15,-2
29,4,49,9,14,-5
29,4,50,11,18,-7
29,4,51,3,12,-9
29,4,52,5,17,-12
29,4,53,6,21,-15
29,4,54,8,14,-6
29,4,55,4,13,-9
29,4,56,7,19,-12
29,4,57,11,29,-18
29,4,58,17,22,-5
29,4,59,5,26,-21
29,4,60,9,17,-8
29,4,61,11,14,-3
29,4,62,8,16,-8
29,4,63,6,22,-16
29,4,64,10,26,-16
29,4,65,6,26,-20
29,4,66,10,36,-26
29,4,67,7,14,-7
29,4,68,20,27,-7
29,4,69,6,33,-27
29,4,70,4,20,-16
29,4,71,6,11,-5
29,4,72,9,18,-9
29,4,73,11,34,-23
29,4,74,12,22,-10
29,4,75,4,23,-19
29,4,76,5,25,-20
29,4,77,7,23,-16
29,4,78,13,33,-20
29,4,79,7,12,-5
29,4,80,12,34,-22
29,4,81,7,18,-11
29,4,82,7,14,-7
29,4,83,7,18,-11
29,4,84,10,22,-12
29,4,85,7,24,-17
29,4,86,3,32,-29
29,4,87,3,12,-9
29,4,88,10,22,-12
29,4,89,4,20,-16
29,4,90,1,9,-8
29,4,91,7,34,-27
29,4,92,5,21,-16
29,4,93,7,14,-7
29,4,94,18,21,-3
29,4,95,7,26,-19
29,4,96,18,27,-9
29,4,97,3,16,-13
29,4,98,5,13,-8
29,4,99,4,12,-8
29,4,100,11,40,-29
29,4,101,7,17,-10
29,4,102,3,12,-9
29,4,103,11,17,-6
29,4,104,5,20,-15
29,4,105,8,30,-22
29,4,106,6,11,-5
29,4,107,11,24,-13
29,4,108,7,12,-5
29,4,109,10,19,-9
29,4,110,2,15,-13
29,4,111,6,15,-9
29,4,112,11,22,-11
29,4,113,8,20,-12
29,4,114,5,21,-16
29,4,115,14,23,-9
29,4,116,7,32,-25
29,4,117,11,20,-9
29,4,118,12,25,-13
29,4,119,5,32,-27
29,4,120,12,27,-15
29,4,121,13,22,-9
29,4,122,8,23,-15
29,4,123,9,15,-6
29,4,124,3,15,-12
29,4,125,8,15,-7
29,4,126,6,25,-19
29,4,127,10,22,-12
29,4,128,5,10,-5
29,4,129,9,20,-11
29,4,130,8,26,-18
29,4,131,5,21,-16
29,4,132,3,9,-6
29,4,133,14,42,-28
29,4,134,10,24,-14
29,4,135,11,25,-14
29,4,136,5,10,-5
29,4,137,3,14,-11
29,4,138,10,18,-8
29,4,139,6,25,-19
29,4,140,5,17,-12
29,4,141,10,17,-7
29,4,142,18,28,-10
29,4,143,6,21,-15
29,4,144,13,38,-25
29,4,145,8,13,-5
29,4,146,9,13,-4
29,4,147,15,27,-12
29,4,148,12,20,-8
29,4,149,12,15,-3
29,4,150,4,19,-15
29,4,151,9,36,-27
29,4,152,5,16,-11
29,4,153,0,15,-15
29,4,154,9,18,-9
29,4,155,10,26,-16
29,4,156,8,23,-15
29,4,157,8,14,-6
29,4,158,7,20,-13
29,4,159,7,28,-21
29,4,160,11,14,-3
29,4,161,15,36,-21
29,4,162,10,9,1
29,4,163,8,21,-13
29,4,164,7,34,-27
29,4,165,11,28,-17
29,4,166,5,21,-16
29,4,167,9,16,-7
29,4,168,6,12,-6
29,4,169,9,29,-20
29,4,170,10,28,-18
29,4,171,4,28,-24
29,4,172,11,13,-2
29,4,173,7,14,-7
29,4,174,4,11,-7
29,4,175,11,31,-20
29,4,176,3,15,-12
29,4,177,7,10,-3
29,4,178,11,20,-9
29,4,179,3,17,-14
29,4,180,15,29,-14
29,4,181,7,30,-23
29,4,182,8,16,-8
29,4,183,11,12,-1
29,4,184,6,10,-4
29,4,185,8,20,-12
29,4,186,5,28,-23
29,4,187,10,25,-15
29,4,188,9,30,-21
29,4,189,4,18,-14
29,4,190,8,15,-7
29,4,191,12,18,-6
29,4,192,10,20,-10
29,4,193,10,12,-2
29,4,194,8,11,-3
29,4,195,7,17,-10
29,4,196,4,19,-15
29,4,197,5,12,-7
29,4,198,5,24,-19
29,4,199,7,20,-13
29,4,200,10,22,-12
29,4,201,14,13,1
29,4,202,5,26,-21
29,4,203,11,17,-6
29,4,204,11,16,-5
29,4,205,6,24,-18
29,4,206,6,25,-19
29,4,207,10,18,-8
29,4,208,10,20,-10
29,4,209,14,33,-19
29,4,210,5,14,-9
29,4,211,6,7,-1
29,4,212,10,32,-22
29,4,213,8,14,-6
29,4,214,9,10,-1
29,4,215,4,16,-12
29,4,216,9,32,-23
29,4,217,11,18,-7
29,4,218,6,21,-15
29,4,219,6,20,-14
29,4,220,3,26,-23
29,4,221,3,14,-11
29,4,222,3,20,-17
29,4,223,8,29,-21
29,4,224,3,9,-6
29,4,225,5,20,-15
29,4,226,2,14,-12
29,4,227,7,16,-9
29,4,228,10,30,-20
29,4,229,13,16,-3
29,4,230,2,16,-14
29,4,231,6,13,-7
29,4,232,7,24,-17
29,4,233,16,35,-19
29,4,234,10,20,-10
29,4,235,2,20,-18
29,4,236,6,28,-22
29,4,237,5,26,-21
29,4,238,11,30,-19
29,4,239,11,31,-20
29,4,240,11,20,-9
29,4,241,4,6,-2
29,4,242,6,21,-15
29,4,243,13,28,-15
29,4,244,1,10,-9
29,4,245,17,28,-11
29,4,246,4,14,-10
29,4,247,9,11,-2
29,4,248,8,19,-11
29,4,249,9,10,-1
29,4,250,5,21,-16
29,4,251,7,15,-8
29,4,252,10,24,-14
29,4,253,7,13,-6
29,4,254,1,19,-18
29,4,255,8,10,-2
29,4,256,9,18,-9
29,4,257,13,22,-9
29,4,258,7,30,-23
29,4,259,4,27,-23
29,4,260,3,25,-22
29,4,261,15,41,-26
29,4,262,13,26,-13
29,4,263,7,16,-9
29,4,264,7,15,-8
29,4,265,8,21,-13
29,4,266,9,24,-15
29,4,267,4,24,-20
29,4,268,5,27,-22
29,4,269,7,17,-10
29,4,270,4,10,-6
29,4,271,11,31,-20
29,4,272,6,18,-12
29,4,273,10,23,-13
29,4,274,12,27,-15
29,4,275,8,26,-18
29,4,276,5,8,-3
29,4,277,8,12,-4
29,4,278,3,14,-11
29,4,279,18,29,-11
29,4,280,1,22,-21
29,4,281,7,18,-11
29,4,282,9,14,-5
29,4,283,9,21,-12
29,4,284,7,12,-5
29,4,285,12,19,-7
29,4,286,2,12,-10
29,4,287,9,21,-12
29,4,288,1,21,-20
29,4,289,16,32,-16
29,4,290,6,20,-14
29,4,291,15,26,-11
29,4,292,8,30,-22
29,4,293,8,36,-28
29,4,294,7,18,-11
29,4,295,4,18,-14
29,4,296,3,10,-7
29,4,297,8,17,-9
29,4,298,16,12,4
29,4,299,13,32,-19
29,5,0,15,20,-5
29,5,1,8,25,-17
29,5,2,10,20,-10
29,5,3,17,41,-24
29,5,4,5,29,-24
29,5,5,6,15,-9
29,5,6,4,16,-12
29,5,7,8,24,-16
29,5,8,8,38,-30
29,5,9,23,32,-9
29,5,10,4,15,-11
29,5,11,8,19,-11
29,5,12,20,24,-4
29,5,13,8,17,-9
29,5,14,6,26,-20
29,5,15,14,23,-9
29,5,16,5,19,-14
29,5,17,9,24,-15
29,5,18,8,8,0
29,5,19,13,36,-23
29,5,20,8,35,-27
29,5,21,8,8,0
29,5,22,11,22,-11
29,5,23,8,24,-16
29,5,24,8,28,-20
29,5,25,5,28,-23
29,5,26,7,14,-7
29,5,27,2,20,-18
29,5,28,5,35,-30
29,5,29,14,21,-7
29,5,30,6,19,-13
29,5,31,14,29,-15
29,5,32,7,12,-5
29,5,33,6,15,-9
29,5,34,15,44,-29
29,5,35,9,22,-13
29,5,36,4,8,-4
29,5,37,5,20,-15
29,5,38,4,7,-3
29,5,39,7,21,-14
29,5,40,8,21,-13
29,5,41,2,21,-19
29,5,42,9,12,-3
29,5,43,11,20,-9
29,5,44,7,9,-2
29,5,45,5,9,-4
29,5,46,9,13,-4
29,5,47,9,16,-7
29,5,48,8,21,-13
29,5,49,13,26,-13
29,5,50,5,19,-14
29,5,51,13,24,-11
29,5,52,4,17,-13
29,5,53,5,14,-9
29,5,54,16,36,-20
29,5,55,2,30,-28
29,5,56,8,18,-10
29,5,57,10,17,-7
29,5,58,2,17,-15
29,5,59,8,18,-10
29,5,60,14,30,-16
29,5,61,11,19,-8
29,5,62,3,7,-4
29,5,63,16,33,-17
29,5,64,11,30,-19
29,5,65,7,26,-19
29,5,66,5,24,-19
29,5,67,10,15,-5
29,5,68,11,21,-10
29,5,69,5,13,-8
29,5,70,9,15,-6
29,5,71,12,27,-15
29,5,72,3,6,-3
29,5,73,12,29,-17
29,5,74,3,17,-14
29,5,75,4,19,-15
29,5,76,14,20,-6
29,5,77,5,12,-7
29,5,78,8,25,-17
29,5,79,16,22,-6
29,5,80,7,22,-15
29,5,81,4,12,-8
29,5,82,4,19,-15
29,5,83,19,27,-8
29,5,84,14,31,-17
29,5,85,5,10,-5
29,5,86,0,7,-7
29,5,87,7,22,-15
29,5,88,7,19,-12
29,5,89,5,30,-25
29,5,90,8,25,-17
29,5,91,7,23,-16
29,5,92,6,16,-10
29,5,93,5,17,-12
29,5,94,12,19,-7
29,5,95,5,24,-19
29,5,96,12,28,-16
29,5,97,18,23,-5
29,5,98,9,13,-4
29,5,99,5,33,-28
29,5,100,7,15,-8
29,5,101,5,19,-14
29,5,102,5,18,-13
29,5,103,3,9,-6
29,5,104,7,17,-10
29,5,105,7,29,-22
29,5,106,15,9,6
29,5,107,9,12,-3
29,5,108,10,20,-10
29,5,109,9,14,-5
29,5,110,9,18,-9
29,5,111,9,12,-3
29,5,112,11,20,-9
29,5,113,12,16,-4
29,5,114,11,17,-6
29,5,115,11,28,-17
29,5,116,13,35,-22
29,5,117,10,19,-9
29,5,118,8,26,-18
29,5,119,9,24,-15
29,5,120,7,19,-12
29,5,121,13,21,-8
29,5,122,0,15,-15
29,5,123,9,10,-1
29,5,124,3,13,-10
29,5,125,14,22,-8
29,5,126,9,19,-10
29,5,127,11,22,-11
29,5,128,0,8,-8
29,5,129,14,24,-10
29,5,130,5,10,-5
29,5,131,7,13,-6
29,5,132,5,15,-10
29,5,133,5,26,-21
29,5,134,8,32,-24
29,5,135,11,18,-7
29,5,136,7,28,-21
29,5,137,8,8,0
29,5,138,12,27,-15
29,5,139,13,20,-7
29,5,140,10,31,-21
29,5,141,4,28,-24
29,5,142,1,8,-7
29,5,143,12,34,-22
29,5,144,18,36,-18
29,5,145,7,19,-12
29,5,146,10,19,-9
29,5,147,4,10,-6
29,5,148,9,16,-7
29,5,149,10,20,-10
29,5,150,7,27,-20
29,5,151,7,17,-10
29,5,152,5,18,-13
29,5,153,10,25,-15
29,5,154,14,30,-16
29,5,155,6,20,-14
29,5,156,8,12,-4
29,5,157,15,31,-16
29,5,158,5,33,-28
29,5,159,11,28,-17
29,5,160,8,37,-29
29,5,161,10,22,-12
29,5,162,13,23,-10
29,5,163,5,15,-10
29,5,164,3,17,-14
29,5,165,7,21,-14
29,5,166,2,12,-10
29,5,167,6,6,0
29,5,168,9,29,-20
29,5,169,9,21,-12
29,5,170,9,13,-4
29,5,171,11,21,-10
29,5,172,19,24,-5
29,5,173,2,43,-41
29,5,174,3,8,-5
29,5,175,10,21,-11
29,5,176,17,19,-2
29,5,177,4,11,-7
29,5,178,14,27,-13
29,5,179,16,16,0
29,5,180,17,42,-25
29,5,181,4,21,-17
29,5,182,10,20,-10
29,5,183,10,46,-36
29,5,184,5,23,-18
29,5,185,14,32,-18
29,5,186,5,20,-15
29,5,187,6,18,-12
29,5,188,7,20,-13
29,5,189,5,9,-4
29,5,190,0,12,-12
29,5,191,5,19,-14
29,5,192,7,22,-15
29,5,193,12,36,-24
29,5,194,18,33,-15
29,5,195,3,26,-23
29,5,196,7,12,-5
29,5,197,5,15,-10
29,5,198,6,28,-22
29,5,199,16,38,-22
29,5,200,5,14,-9
29,5,201,13,14,-1
29,5,202,3,15,-12
29,5,203,3,11,-8
29,5,204,10,19,-9
29,5,205,3,10,-7
29,5,206,8,18,-10
29,5,207,6,14,-8
29,5,208,10,19,-9
29,5,209,3,18,-15
29,5,210,23,23,0
29,5,211,13,27,-14
29,5,212,8,14,-6
29,5,213,9,19,-10
29,5,214,10,22,-12
29,5,215,20,30,-10
29,5,216,8,14,-6
29,5,217,6,14,-8
29,5,218,12,14,-2
29,5,219,11,29,-18
29,5,220,4,22,-18
29,5,221,12,18,-6
29,5,222,13,22,-9
29,5,223,7,19,-12
29,5,224,10,14,-4
29,5,225,6,20,-14
29,5,226,13,11,2
29,5,227,16,16,0
29,5,228,10,13,-3
29,5,229,2,15,-13
29,5,230,13,24,-11
29,5,231,6,22,-16
29,5,232,8,21,-13
29,5,233,6,26,-20
29,5,234,5,20,-15
29,5,235,9,32,-23
29,5,236,3,19,-16
29,5,237,11,10,1
29,5,238,4,24,-20
29,5,239,12,30,-18
29,5,240,13,21,-8
29,5,241,5,14,-9
29,5,242,11,28,-17
29,5,243,3,27,-24
29,5,244,9,22,-13
29,5,245,7,23,-16
29,5,246,8,18,-10
29,5,247,9,9,0
29,5,248,6,34,-28
29,5,249,7,21,-14
29,5,250,2,11,-9
29,5,251,6,15,-9
29,5,252,2,14,-12
29,5,253,8,26,-18
29,5,254,22,27,-5
29,5,255,13,20,-7
29,5,256,7,20,-13
29,5,257,13,24,-11
29,5,258,12,27,-15
29,5,259,6,18,-12
29,5,260,5,40,-35
29,5,261,5,15,-10
29,5,262,18,33,-15
29,5,263,4,17,-13
29,5,264,9,30,-21
29,5,265,7,17,-10
29,5,266,8,25,-17
29,5,267,7,17,-10
29,5,268,8,20,-12
29,5,269,2,21,-19
29,5,270,10,24,-14
29,5,271,14,15,-1
29,5,272,2,15,-13
29,5,273,14,20,-6
29,5,274,3,28,-25
29,5,275,11,15,-4
29,5,276,16,28,-12
29,5,277,14,36,-22
29,5,278,8,25,-17
29,5,279,7,22,-15
29,5,280,9,25,-16
29,5,281,7,4,3
29,5,282,2,14,-12
29,5,283,4,36,-32
29,5,284,9,20,-11
29,5,285,11,17,-6
29,5,286,10,16,-6
29,5,287,19,21,-2
29,5,288,5,20,-15
29,5,289,8,14,-6
29,5,290,10,18,-8
29,5,291,3,20,-17
29,5,292,11,17,-6
29,5,293,5,17,-12
29,5,294,6,27,-21
29,5,295,8,35,-27
29,5,296,6,12,-6
29,5,297,7,17,-10
29,5,298,11,13,-2
29,5,299,6,15,-9
29,6,0,11,19,-8
29,6,1,2,16,-14
29,6,2,6,23,-17
29,6,3,2,22,-20
29,6,4,8,22,-14
29,6,5,1,26,-25
29,6,6,5,9,-4
29,6,7,3,14,-11
29,6,8,12,21,-9
29,6,9,9,12,-3
29,6,10,8,30,-22
29,6,11,14,35,-21
29,6,12,7,25,-18
29,6,13,7,20,-13
29,6,14,18,16,2
29,6,15,2,26,-24
29,6,16,7,5,2
29,6,17,6,13,-7
29,6,18,5,12,-7
29,6,19,9,20,-11
29,6,20,10,32,-22
29,6,21,9,22,-13
29,6,22,15,13,2
29,6,23,17,22,-5
29,6,24,13,32,-19
29,6,25,10,11,-1
29,6,26,9,47,-38
29,6,27,6,12,-6
29,6,28,16,13,3
29,6,29,1,8,-7
29,6,30,11,16,-5
29,6,31,9,16,-7
29,6,32,13,31,-18
29,6,33,5,20,-15
29,6,34,7,16,-9
29,6,35,16,19,-3
29,6,36,8,19,-11
29,6,37,14,16,-2
29,6,38,15,29,-14
29,6,39,6,29,-23
29,6,40,10,14,-4
29,6,41,9,23,-14
29,6,42,15,16,-1
29,6,43,7,14,-7
29,6,44,4,30,-26
29,6,45,14,22,-8
29,6,46,11,24,-13
29,6,47,11,16,-5
29,6,48,4,27,-23
29,6,49,15,25,-10
29,6,50,9,18,-9
29,6,51,6,25,-19
29,6,52,10,17,-7
29,6,53,3,16,-13
29,6,54,5,17,-12
29,6,55,8,18,-10
29,6,56,9,24,-15
29,6,57,0,17,-17
29,6,58,3,13,-10
29,6,59,5,13,-8
29,6,60,6,31,-25
29,6,61,6,24,-18
29,6,62,11,38,-27
29,6,63,11,27,-16
29,6,64,6,18,-12
29,6,65,6,15,-9
29,6,66,7,13,-6
29,6,67,18,25,-7
29,6,68,3,6,-3
29,6,69,8,19,-11
29,6,70,10,35,-25
29,6,71,12,20,-8
29,6,72,8,14,-6
29,6,73,6,19,-13
29,6,74,8,22,-14
29,6,75,11,22,-11
29,6,76,11,23,-12
29,6,77,5,20,-15
29,6,78,8,10,-2
29,6,79,8,22,-14
29,6,80,5,24,-19
29,6,81,10,16,-6
29,6,82,10,16,-6
29,6,83,16,24,-8
29,6,84,10,28,-18
29,6,85,12,27,-15
29,6,86,2,29,-27
29,6,87,9,12,-3
29,6,88,1,13,-12
29,6,89,7,19,-12
29,6,90,9,19,-10
29,6,91,9,25,-16
29,6,92,8,13,-5
29,6,93,7,20,-13
29,6,94,9,12,-3
29,6,95,7,29,-22
29,6,96,5,10,-5
29,6,97,10,27,-17
29,6,98,13,24,-11
29,6,99,18,18,0
29,6,100,8,20,-12
29,6,101,6,16,-10
29,6,102,1,13,-12
29,6,103,10,25,-15
29,6,104,17,25,-8
29,6,105,14,35,-21
29,6,106,12,27,-15
29,6,107,13,14,-1
29,6,108,2,31,-29
29,6,109,10,20,-10
29,6,110,8,36,-28
29,6,111,13,22,-9
29,6,112,9,27,-18
29,6,113,13,23,-10
29,6,114,4,12,-8
29,6,115,5,21,-16
29,6,116,15,26,-11
29,6,117,9,46,-37
29,6,118,12,18,-6
29,6,119,14,24,-10
29,6,120,21,25,-4
29,6,121,9,19,-10
29,6,122,9,15,-6
29,6,123,4,5,-1
29,6,124,10,30,-20
29,6,125,16,27,-11
29,6,126,7,15,-8
29,6,127,4,24,-20
29,6,128,4,13,-9
29,6,129,6,38,-32
29,6,130,11,24,-13
29,6,131,9,42,-33
29,6,132,5,31,-26
29,6,133,11,20,-9
29,6,134,14,10,4
29,6,135,22,30,-8
29,6,136,13,39,-26
29,6,137,10,35,-25
29,6,138,5,8,-3
29,6,139,8,20,-12
29,6,140,4,23,-19
29,6,141,8,18,-10
29,6,142,4,11,-7
29,6,143,12,25,-13
29,6,144,5,17,-12
29,6,145,10,26,-16
29,6,146,8,22,-14
29,6,147,16,20,-4
29,6,148,7,15,-8
29,6,149,8,18,-10
29,6,150,6,20,-14
29,6,151,4,17,-13
29,6,152,7,11,-4
29,6,153,13,23,-10
29,6,154,12,35,-23
29,6,155,9,22,-13
29,6,156,3,25,-22
29,6,157,13,19,-6
29,6,158,3,18,-15
29,6,159,3,10,-7
29,6,160,8,23,-15
29,6,161,3,25,-22
29,6,162,13,13,0
29,6,163,10,35,-25
29,6,164,7,37,-30
29,6,165,9,16,-7
29,6,166,3,13,-10
29,6,167,7,10,-3
29,6,168,5,19,-14
29,6,169,10,10,0
29,6,170,9,23,-14
29,6,171,9,18,-9
29,6,172,11,36,-25
29,6,173,8,39,-31
29,6,174,10,7,3
29,6,175,14,15,-1
29,6,176,13,22,-9
29,6,177,7,13,-6
29,6,178,10,11,-1
29,6,179,7,32,-25
29,6,180,12,24,-12
29,6,181,10,11,-1
29,6,182,7,13,-6
29,6,183,1,18,-17
29,6,184,2,9,-7
29,6,185,14,18,-4
29,6,186,1,11,-10
29,6,187,7,22,-15
29,6,188,17,35,-18
29,6,189,16,21,-5
29,6,190,5,15,-10
29,6,191,5,30,-25
29,6,192,6,19,-13
29,6,193,23,17,6
29,6,194,7,17,-10
29,6,195,14,24,-10
29,6,196,7,21,-14
29,6,197,4,1,3
29,6,198,15,18,-3
29,6,199,6,19,-13
29,6,200,21,29,-8
29,6,201,5,29,-24
29,6,202,6,27,-21
29,6,203,13,27,-14
29,6,204,8,13,-5
29,6,205,6,25,-19
29,6,206,9,23,-14
29,6,207,14,19,-5
29,6,208,13,29,-16
29,6,209,6,28,-22
29,6,210,10,22,-12
29,6,211,3,11,-8
29,6,212,5,17,-12
29,6,213,6,23,-17
29,6,214,3,14,-11
29,6,215,13,26,-13
29,6,216,12,19,-7
29,6,217,4,21,-17
29,6,218,14,28,-14
29,6,219,12,11,1
29,6,220,6,23,-17
29,6,221,4,15,-11
29,6,222,7,23,-16
29,6,223,7,23,-16
29,6,224,10,15,-5
29,6,225,21,19,2
29,6,226,10,18,-8
29,6,227,6,17,-11
29,6,228,5,16,-11
29,6,229,17,28,-11
29,6,230,7,17,-10
29,6,231,4,18,-14
29,6,232,9,39,-30
29,6,233,2,9,-7
29,6,234,6,9,-3
29,6,235,11,14,-3
29,6,236,11,28,-17
29,6,237,2,16,-14
29,6,238,12,30,-18
29,6,239,10,26,-16
29,6,240,3,13,-10
29,6,241,2,11,-9
29,6,242,8,21,-13
29,6,243,7,18,-11
29,6,244,13,14,-1
29,6,245,13,36,-23
29,6,246,4,21,-17
29,6,247,7,23,-16
29,6,248,12,24,-12
29,6,249,8,25,-17
29,6,250,5,11,-6
29,6,251,11,10,1
29,6,252,4,11,-7
29,6,253,10,14,-4
29,6,254,6,18,-12
29,6,255,14,15,-1
29,6,256,6,18,-12
29,6,257,15,29,-14
29,6,258,17,22,-5
29,6,259,14,25,-11
29,6,260,4,25,-21
29,6,261,14,19,-5
29,6,262,8,30,-22
29,6,263,9,6,3
29,6,264,5,21,-16
29,6,265,8,17,-9
29,6,266,8,18,-10
29,6,267,20,21,-1
29,6,268,5,12,-7
29,6,269,9,7,2
29,6,270,9,37,-28
29,6,271,6,13,-7
29,6,272,16,17,-1
29,6,273,6,16,-10
29,6,274,13,22,-9
29,6,275,20,28,-8
29,6,276,8,11,-3
29,6,277,5,11,-6
29,6,278,9,14,-5
29,6,279,11,24,-13
29,6,280,8,16,-8
29,6,281,4,34,-30
29,6,282,7,22,-15
29,6,283,14,22,-8
29,6,284,10,19,-9
29,6,285,15,21,-6
29,6,286,7,19,-12
29,6,287,7,17,-10
29,6,288,4,33,-29
29,6,289,13,14,-1
29,6,290,10,26,-16
29,6,291,3,23,-20
29,6,292,11,18,-7
29,6,293,13,15,-2
29,6,294,11,16,-5
29,6,295,2,13,-11
29,6,296,8,12,-4
29,6,297,15,21,-6
29,6,298,14,18,-4
29,6,299,6,12,-6
29,7,0,7,21,-14
29,7,1,5,9,-4
29,7,2,5,34,-29
29,7,3,7,18,-11
29,7,4,7,14,-7
29,7,5,7,24,-17
29,7,6,8,20,-12
29,7,7,9,14,-5
29,7,8,17,27,-10
29,7,9,7,10,-3
29,7,10,8,18,-10
29,7,11,5,16,-11
29,7,12,8,27,-19
29,7,13,8,19,-11
29,7,14,7,16,-9
29,7,15,9,26,-17
29,7,16,5,13,-8
29,7,17,19,14,5
29,7,18,10,20,-10
29,7,19,5,10,-5
29,7,20,8,9,-1
29,7,21,11,23,-12
29,7,22,9,20,-11
29,7,23,11,38,-27
29,7,24,9,16,-7
29,7,25,10,17,-7
29,7,26,10,33,-23
29,7,27,9,29,-20
29,7,28,6,25,-19
29,7,29,3,18,-15
29,7,30,12,16,-4
29,7,31,15,25,-10
29,7,32,12,33,-21
29,7,33,16,25,-9
29,7,34,5,30,-25
29,7,35,3,18,-15
29,7,36,6,8,-2
29,7,37,16,30,-14
29,7,38,5,13,-8
29,7,39,10,19,-9
29,7,40,13,8,5
29,7,41,6,8,-2
29,7,42,8,9,-1
29,7,43,13,18,-5
29,7,44,10,16,-6
29,7,45,2,25,-23
29,7,46,10,29,-19
29,7,47,5,12,-7
29,7,48,12,14,-2
29,7,49,7,22,-15
29,7,50,9,29,-20
29,7,51,22,20,2
29,7,52,8,23,-15
29,7,53,8,7,1
29,7,54,9,27,-18
29,7,55,14,28,-14
29,7,56,10,27,-17
29,7,57,7,31,-24
29,7,58,15,24,-9
29,7,59,8,18,-10
29,7,60,16,28,-12
29,7,61,5,15,-10
29,7,62,4,19,-15
29,7,63,0,5,-5
29,7,64,8,18,-10
29,7,65,0,19,-19
29,7,66,1,12,-11
29,7,67,2,16,-14
29,7,68,1,12,-11
29,7,69,15,20,-5
29,7,70,13,17,-4
29,7,71,5,8,-3
29,7,72,10,17,-7
29,7,73,10,18,-8
29,7,74,5,17,-12
29,7,75,8,18,-10
29,7,76,13,10,3
29,7,77,7,13,-6
29,7,78,11,26,-15
29,7,79,10,17,-7
29,7,80,9,17,-8
29,7,81,16,23,-7
29,7,82,9,23,-14
29,7,83,13,23,-10
29,7,84,9,16,-7
29,7,85,8,13,-5
29,7,86,15,17,-2
29,7,87,4,28,-24
29,7,88,12,20,-8
29,7,89,9,27,-18
29,7,90,11,29,-18
29,7,91,8,11,-3
29,7,92,18,20,-2
29,7,93,6,6,0
29,7,94,5,16,-11
29,7,95,10,12,-2
29,7,96,10,14,-4
29,7,97,10,20,-10
29,7,98,8,16,-8
29,7,99,8,19,-11
29,7,100,11,25,-14
29,7,101,7,19,-12
29,7,102,11,20,-9
29,7,103,14,15,-1
29,7,104,12,28,-16
29,7,105,12,18,-6
29,7,106,15,15,0
29,7,107,15,31,-16
29,7,108,9,17,-8
29,7,109,11,18,-7
29,7,110,13,34,-21
29,7,111,7,23,-16
29,7,112,3,21,-18
29,7,113,3,14,-11
29,7,114,12,14,-2
29,7,115,12,17,-5
29,7,116,17,32,-15
29,7,117,12,15,-3
29,7,118,8,29,-21
29,7,119,5,16,-11
29,7,120,15,33,-18
29,7,121,12,23,-11
29,7,122,4,20,-16
29,7,123,7,15,-8
29,7,124,11,13,-2
29,7,125,8,21,-13
29,7,126,16,16,0
29,7,127,11,34,-23
29,7,128,1,13,-12
29,7,129,15,31,-16
29,7,130,11,13,-2
29,7,131,7,17,-10
29,7,132,9,44,-35
29,7,133,15,25,-10
29,7,134,7,20,-13
29,7,135,15,14,1
29,7,136,14,19,-5
29,7,137,11,16,-5
29,7,138,9,33,-24
29,7,139,6,14,-8
29,7,140,14,17,-3
29,7,141,11,30,-19
29,7,142,14,25,-11
29,7,143,16,30,-14
29,7,144,5,12,-7
29,7,145,12,23,-11
29,7,146,14,28,-14
29,7,147,8,22,-14
29,7,148,4,15,-11
29,7,149,4,21,-17
29,7,150,8,32,-24
29,7,151,2,21,-19
29,7,152,6,14,-8
29,7,153,14,9,5
29,7,154,4,19,-15
29,7,155,14,36,-22
29,7,156,12,24,-12
29,7,157,5,27,-22
29,7,158,2,14,-12
29,7,159,5,18,-13
29,7,160,14,24,-10
29,7,161,15,16,-1
29,7,162,12,25,-13
29,7,163,8,38,-30
29,7,164,11,29,-18
29,7,165,8,56,-48
29,7,166,6,13,-7
29,7,167,14,17,-3
29,7,168,9,18,-9
29,7,169,7,37,-30
29,7,170,10,28,-18
29,7,171,2,11,-9
29,7,172,13,17,-4
29,7,173,9,13,-4
29,7,174,6,15,-9
29,7,175,3,10,-7
29,7,176,5,9,-4
29,7,177,4,17,-13
29,7,178,8,33,-25
29,7,179,14,28,-14
29,7,180,6,8,-2
29,7,181,6,25,-19
29,7,182,3,17,-14
29,7,183,11,32,-21
29,7,184,7,23,-16
29,7,185,6,22,-16
29,7,186,11,25,-14
29,7,187,18,10,8
29,7,188,8,24,-16
29,7,189,12,5,7
29,7,190,16,21,-5
29,7,191,2,11,-9
29,7,192,5,13,-8
29,7,193,9,25,-16
29,7,194,7,18,-11
29,7,195,3,13,-10
29,7,196,11,34,-23
29,7,197,26,27,-1
29,7,198,10,25,-15
29,7,199,14,23,-9
29,7,200,6,12,-6
29,7,201,11,27,-16
29,7,202,8,20,-12
29,7,203,7,10,-3
29,7,204,7,14,-7
29,7,205,14,30,-16
29,7,206,15,20,-5
29,7,207,6,17,-11
29,7,208,9,18,-9
29,7,209,7,27,-20
29,7,210,5,25,-20
29,7,211,7,16,-9
29,7,212,8,25,-17
29,7,213,10,9,1
29,7,214,9,18,-9
29,7,215,11,34,-23
29,7,216,11,27,-16
29,7,217,9,29,-20
29,7,218,21,26,-5
29,7,219,6,13,-7
29,7,220,12,11,1
29,7,221,7,18,-11
29,7,222,10,16,-6
29,7,223,10,20,-10
29,7,224,11,35,-24
29,7,225,7,11,-4
29,7,226,3,18,-15
29,7,227,1,39,-38
29,7,228,9,15,-6
29,7,229,15,25,-10
29,7,230,8,16,-8
29,7,231,13,19,-6
29,7,232,10,18,-8
29,7,233,8,16,-8
29,7,234,6,22,-16
29,7,235,6,15,-9
29,7,236,9,23,-14
29,7,237,19,28,-9
29,7,238,14,20,-6
29,7,239,10,23,-13
29,7,240,6,17,-11
29,7,241,0,16,-16
29,7,242,13,19,-6
29,7,243,14,18,-4
29,7,244,10,11,-1
29,7,245,15,35,-20
29,7,246,1,15,-14
29,7,247,12,37,-25
29,7,248,10,14,-4
29,7,249,7,24,-17
29,7,250,11,35,-24
29,7,251,17,28,-11
29,7,252,8,17,-9
29,7,253,4,9,-5
29,7,254,7,24,-17
29,7,255,11,24,-13
29,7,256,10,33,-23
29,7,257,10,19,-9
29,7,258,6,43,-37
29,7,259,5,23,-18
29,7,260,4,14,-10
29,7,261,5,21,-16
29,7,262,15,40,-25
29,7,263,5,23,-18
29,7,264,9,25,-16
29,7,265,7,15,-8
29,7,266,5,18,-13
29,7,267,7,22,-15
29,7,268,6,11,-5
29,7,269,19,18,1
29,7,270,15,37,-22
29,7,271,10,44,-34
29,7,272,7,16,-9
29,7,273,6,16,-10
29,7,274,7,21,-14
29,7,275,6,18,-12
29,7,276,11,14,-3
29,7,277,12,30,-18
29,7,278,22,31,-9
29,7,279,5,11,-6
29,7,280,15,17,-2
29,7,281,10,18,-8
29,7,282,14,22,-8
29,7,283,6,18,-12
29,7,284,12,19,-7
29,7,285,10,18,-8
29,7,286,6,34,-28
29,7,287,6,17,-11
29,7,288,9,16,-7
29,7,289,9,38,-29
29,7,290,11,39,-28
29,7,291,10,24,-14
29,7,292,8,22,-14
29,7,293,5,10,-5
29,7,294,9,20,-11
29,7,295,9,20,-11
29,7,296,9,26,-17
29,7,297,4,9,-5
29,7,298,7,26,-19
29,7,299,10,30,-20
29,8,0,4,36,-32
29,8,1,10,10,0
29,8,2,8,18,-10
29,8,3,19,14,5
29,8,4,4,29,-25
29,8,5,14,18,-4
29,8,6,7,27,-20
29,8,7,12,16,-4
29,8,8,14,16,-2
29,8,9,9,15,-6
29,8,10,15,18,-3
29,8,11,4,20,-16
29,8,12,17,11,6
29,8,13,8,29,-21
29,8,14,3,16,-13
29,8,15,5,30,-25
29,8,16,11,44,-33
29,8,17,13,24,-11
29,8,18,4,26,-22
29,8,19,13,28,-15
29,8,20,11,12,-1
29,8,21,11,14,-3
29,8,22,4,19,-15
29,8,23,15,10,5
29,8,24,14,14,0
29,8,25,14,24,-10
29,8,26,9,14,-5
29,8,27,12,29,-17
29,8,28,7,23,-16
29,8,29,8,19,-11
29,8,30,7,22,-15
29,8,31,15,25,-10
29,8,32,5,18,-13
29,8,33,9,18,-9
29,8,34,8,24,-16
29,8,35,9,17,-8
29,8,36,7,22,-15
29,8,37,5,14,-9
29,8,38,10,13,-3
29,8,39,17,27,-10
29,8,40,7,18,-11
29,8,41,9,33,-24
29,8,42,8,21,-13
29,8,43,8,20,-12
29,8,44,15,29,-14
29,8,45,13,22,-9
29,8,46,5,17,-12
29,8,47,13,33,-20
29,8,48,9,20,-11
29,8,49,17,52,-35
29,8,50,5,12,-7
29,8,51,5,37,-32
29,8,52,5,11,-6
29,8,53,12,24,-12
29,8,54,3,23,-20
29,8,55,17,14,3
29,8,56,5,19,-14
29,8,57,2,27,-25
29,8,58,16,23,-7
29,8,59,7,21,-14
29,8,60,7,34,-27
29,8,61,10,18,-8
29,8,62,10,8,2
29,8,63,12,40,-28
29,8,64,3,10,-7
29,8,65,7,24,-17
29,8,66,17,18,-1
29,8,67,5,17,-12
29,8,68,4,26,-22
29,8,69,5,15,-10
29,8,70,9,19,-10
29,8,71,19,12,7
29,8,72,13,51,-38
29,8,73,7,14,-7
29,8,74,5,23,-18
29,8,75,5,26,-21
29,8,76,5,23,-18
29,8,77,5,20,-15
29,8,78,9,25,-16
29,8,79,9,12,-3
29,8,80,9,40,-31
29,8,81,2,9,-7
29,8,82,9,28,-19
29,8,83,15,22,-7
29,8,84,13,16,-3
29,8,85,4,21,-17
29,8,86,13,30,-17
29,8,87,12,25,-13
29,8,88,21,32,-11
29,8,89,4,20,-16
29,8,90,5,23,-18
29,8,91,4,18,-14
29,8,92,14,23,-9
29,8,93,6,11,-5
29,8,94,9,29,-20
29,8,95,11,24,-13
29,8,96,5,30,-25
29,8,97,12,21,-9
29,8,98,7,30,-23
29,8,99,17,29,-12
29,8,100,14,23,-9
29,8,101,13,21,-8
29,8,102,9,15,-6
29,8,103,10,45,-35
29,8,104,3,12,-9
29,8,105,4,31,-27
29,8,106,14,28,-14
29,8,107,13,24,-11
29,8,108,15,19,-4
29,8,109,18,25,-7
29,8,110,5,27,-22
29,8,111,4,23,-19
29,8,112,8,22,-14
29,8,113,8,25,-17
29,8,114,12,13,-1
29,8,115,11,29,-18
29,8,116,12,19,-7
29,8,117,14,21,-7
29,8,118,10,12,-2
29,8,119,5,29,-24
29,8,120,4,16,-12
29,8,121,14,28,-14
29,8,122,10,33,-23
29,8,123,13,23,-10
29,8,124,9,20,-11
29,8,125,9,33,-24
29,8,126,5,23,-18
29,8,127,9,19,-10
29,8,128,17,14,3
29,8,129,14,33,-19
29,8,130,11,14,-3
29,8,131,18,23,-5
29,8,132,2,17,-15
29,8,133,7,24,-17
29,8,134,8,16,-8
29,8,135,9,16,-7
29,8,136,9,28,-19
29,8,137,20,12,8
29,8,138,8,16,-8
29,8,139,1,16,-15
29,8,140,4,7,-3
29,8,141,8,16,-8
29,8,142,10,14,-4
29,8,143,6,21,-15
29,8,144,6,21,-15
29,8,145,6,31,-25
29,8,146,7,14,-7
29,8,147,13,21,-8
29,8,148,3,28,-25
29,8,149,11,30,-19
29,8,150,17,47,-30
29,8,151,11,8,3
29,8,152,11,23,-12
29,8,153,2,24,-22
29,8,154,4,15,-11
29,8,155,6,23,-17
29,8,156,7,20,-13
29,8,157,4,8,-4
29,8,158,7,14,-7
29,8,159,4,20,-16
29,8,160,5,21,-16
29,8,161,11,26,-15
29,8,162,11,24,-13
29,8,163,9,27,-18
29,8,164,9,27,-18
29,8,165,2,21,-19
29,8,166,5,20,-15
29,8,167,12,18,-6
29,8,168,14,15,-1
29,8,169,3,19,-16
29,8,170,2,11,-9
29,8,171,8,5,3
29,8,172,13,18,-5
29,8,173,11,9,2
29,8,174,4,17,-13
29,8,175,9,22,-13
29,8,176,19,36,-17
29,8,177,5,29,-24
29,8,178,8,12,-4
29,8,179,11,13,-2
29,8,180,6,20,-14
29,8,181,3,17,-14
29,8,182,14,24,-10
29,8,183,14,35,-21
29,8,184,10,24,-14
29,8,185,7,20,-13
29,8,186,11,18,-7
29,8,187,11,28,-17
29,8,188,20,24,-4
29,8,189,21,29,-8
29,8,190,12,29,-17
29,8,191,9,41,-32
29,8,192,5,18,-13
29,8,193,2,22,-20
29,8,194,12,21,-9
29,8,195,9,23,-14
29,8,196,4,21,-17
29,8,197,5,14,-9
29,8,198,7,12,-5
29,8,199,9,21,-12
29,8,200,16,23,-7
29,8,201,7,22,-15
29,8,202,4,23,-19
29,8,203,7,24,-17
29,8,204,11,19,-8
29,8,205,9,33,-24
29,8,206,13,23,-10
29,8,207,8,6,2
29,8,208,15,13,2
29,8,209,10,27,-17
29,8,210,4,15,-11
29,8,211,13,26,-13
29,8,212,7,15,-8
29,8,213,12,27,-15
29,8,214,8,16,-8
29,8,215,4,23,-19
29,8,216,9,34,-25
29,8,217,5,25,-20
29,8,218,13,38,-25
29,8,219,7,26,-19
29,8,220,9,22,-13
29,8,221,3,25,-22
29,8,222,14,20,-6
29,8,223,4,8,-4
29,8,224,15,20,-5
29,8,225,4,12,-8
29,8,226,12,30,-18
29,8,227,5,20,-15
29,8,228,16,32,-16
29,8,229,13,15,-2
29,8,230,8,19,-11
29,8,231,8,20,-12
29,8,232,10,29,-19
29,8,233,11,26,-15
29,8,234,12,14,-2
29,8,235,7,28,-21
29,8,236,7,21,-14
29,8,237,6,26,-20
29,8,238,8,13,-5
29,8,239,12,21,-9
29,8,240,11,11,0
29,8,241,11,17,-6
29,8,242,15,18,-3
29,8,243,8,19,-11
29,8,244,5,14,-9
29,8,245,12,19,-7
29,8,246,7,16,-9
29,8,247,10,31,-21
29,8,248,5,15,-10
29,8,249,15,18,-3
29,8,250,8,18,-10
29,8,251,9,19,-10
29,8,252,7,31,-24
29,8,253,12,8,4
29,8,254,15,24,-9
29,8,255,5,13,-8
29,8,256,4,17,-13
29,8,257,8,12,-4
29,8,258,4,12,-8
29,8,259,2,10,-8
29,8,260,10,24,-14
29,8,261,6,19,-13
29,8,262,1,6,-5
29,8,263,12,20,-8
29,8,264,5,14,-9
29,8,265,9,13,-4
29,8,266,6,33,-27
29,8,267,0,26,-26
29,8,268,10,23,-13
29,8,269,13,39,-26
29,8,270,1,12,-11
29,8,271,7,32,-25
29,8,272,19,28,-9
29,8,273,24,22,2
29,8,274,13,33,-20
29,8,275,14,30,-16
29,8,276,13,27,-14
29,8,277,12,8,4
29,8,278,15,40,-25
29,8,279,9,26,-17
29,8,280,10,27,-17
29,8,281,17,23,-6
29,8,282,10,32,-22
29,8,283,17,20,-3
29,8,284,10,10,0
29,8,285,9,23,-14
29,8,286,6,36,-30
29,8,287,13,16,-3
29,8,288,9,14,-5
29,8,289,0,13,-13
29,8,290,11,9,2
29,8,291,16,29,-13
29,8,292,7,51,-44
29,8,293,16,32,-16
29,8,294,2,23,-21
29,8,295,9,23,-14
29,8,296,9,18,-9
29,8,297,9,23,-14
29,8,298,3,18,-15
29,8,299,4,14,-10
29,9,0,18,15,3
29,9,1,8,22,-14
29,9,2,9,21,-12
29,9,3,12,9,3
29,9,4,19,18,1
29,9,5,5,26,-21
29,9,6,13,31,-18
29,9,7,8,15,-7
29,9,8,9,15,-6
29,9,9,17,19,-2
29,9,10,17,24,-7
29,9,11,8,9,-1
29,9,12,5,22,-17
29,9,13,7,29,-22
29,9,14,11,19,-8
29,9,15,7,10,-3
29,9,16,6,16,-10
29,9,17,12,17,-5
29,9,18,5,8,-3
29,9,19,12,13,-1
29,9,20,14,37,-23
29,9,21,15,24,-9
29,9,22,16,25,-9
29,9,23,10,20,-10
29,9,24,9,8,1
29,9,25,4,13,-9
29,9,26,6,17,-11
29,9,27,4,16,-12
29,9,28,4,14,-10
29,9,29,13,21,-8
29,9,30,6,17,-11
29,9,31,13,22,-9
29,9,32,6,21,-15
29,9,33,15,34,-19
29,9,34,4,8,-4
29,9,35,13,20,-7
29,9,36,6,22,-16
29,9,37,11,19,-8
29,9,38,14,23,-9
29,9,39,1,13,-12
29,9,40,5,14,-9
29,9,41,21,17,4
29,9,42,12,17,-5
29,9,43,5,11,-6
29,9,44,7,19,-12
29,9,45,10,10,0
29,9,46,3,16,-13
29,9,47,12,5,7
29,9,48,13,36,-23
29,9,49,21,31,-10
29,9,50,4,26,-22
29,9,51,10,29,-19
29,9,52,9,10,-1
29,9,53,16,24,-8
29,9,54,7,16,-9
29,9,55,10,26,-16
29,9,56,9,8,1
29,9,57,13,21,-8
29,9,58,10,16,-6
29,9,59,12,26,-14
29,9,60,7,10,-3
29,9,61,13,33,-20
29,9,62,12,13,-1
29,9,63,3,19,-16
29,9,64,3,14,-11
29,9,65,9,13,-4
29,9,66,6,12,-6
29,9,67,8,30,-22
29,9,68,8,4,4
29,9,69,11,45,-34
29,9,70,11,10,1
29,9,71,5,7,-2
29,9,72,11,19,-8
29,9,73,6,14,-8
29,9,74,5,21,-16
29,9,75,14,20,-6
29,9,76,10,13,-3
29,9,77,28,18,10
29,9,78,3,32,-29
29,9,79,11,21,-10
29,9,80,6,22,-16
29,9,81,13,31,-18
29,9,82,9,32,-23
29,9,83,8,12,-4
29,9,84,7,17,-10
29,9,85,7,22,-15
29,9,86,13,38,-25
29,9,87,9,15,-6
29,9,88,9,15,-6
29,9,89,11,16,-5
29,9,90,10,38,-28
29,9,91,17,17,0
29,9,92,5,8,-3
29,9,93,7,18,-11
29,9,94,10,23,-13
29,9,95,6,11,-5
29,9,96,17,48,-31
29,9,97,5,19,-14
29,9,98,12,19,-7
29,9,99,9,15,-6
29,9,100,6,23,-17
29,9,101,13,15,-2
29,9,102,20,24,-4
29,9,103,9,23,-14
29,9,104,3,13,-10
29,9,105,9,30,-21
29,9,106,1,14,-13
29,9,107,6,18,-12
29,9,108,20,26,-6
29,9,109,11,13,-2
29,9,110,5,26,-21
29,9,111,16,22,-6
29,9,112,19,26,-7
29,9,113,9,16,-7
29,9,114,7,12,-5
29,9,115,6,8,-2
29,9,116,5,17,-12
29,9,117,2,16,-14
29,9,118,18,26,-8
29,9,119,17,15,2
29,9,120,15,31,-16
29,9,121,9,33,-24
29,9,122,16,31,-15
29,9,123,8,29,-21
29,9,124,9,29,-20
29,9,125,14,20,-6
29,9,126,9,10,-1
29,9,127,9,12,-3
29,9,128,10,27,-17
29,9,129,15,27,-12
29,9,130,15,17,-2
29,9,131,13,20,-7
29,9,132,13,40,-27
29,9,133,18,25,-7
29,9,134,8,17,-9
29,9,135,16,5,11
29,9,136,7,12,-5
29,9,137,9,19,-10
29,9,138,10,28,-18
29,9,139,24,43,-19
29,9,140,16,17,-1
29,9,141,4,23,-19
29,9,142,6,26,-20
29,9,143,6,14,-8
29,9,144,9,15,-6
29,9,145,15,21,-6
29,9,146,8,26,-18
29,9,147,6,32,-26
29,9,148,11,12,-1
29,9,149,7,27,-20
29,9,150,7,8,-1
29,9,151,7,16,-9
29,9,152,11,11,0
29,9,153,4,17,-13
29,9,154,6,10,-4
29,9,155,11,19,-8
29,9,156,1,19,-18
29,9,157,8,19,-11
29,9,158,16,31,-15
29,9,159,20,24,-4
29,9,160,9,43,-34
29,9,161,3,17,-14
29,9,162,12,23,-11
29,9,163,6,10,-4
29,9,164,7,21,-14
29,9,165,17,19,-2
29,9,166,6,18,-12
29,9,167,19,18,1
29,9,168,8,18,-10
29,9,169,6,6,0
29,9,170,7,15,-8
29,9,171,9,24,-15
29,9,172,6,23,-17
29,9,173,15,20,-5
29,9,174,7,12,-5
29,9,175,14,18,-4
29,9,176,21,20,1
29,9,177,10,21,-11
29,9,178,5,32,-27
29,9,179,7,35,-28
29,9,180,11,17,-6
29,9,181,9,22,-13
29,9,182,13,19,-6
29,9,183,9,32,-23
29,9,184,10,33,-23
29,9,185,7,13,-6
29,9,186,18,17,1
29,9,187,12,20,-8
29,9,188,5,21,-16
29,9,189,4,17,-13
29,9,190,18,10,8
29,9,191,12,33,-21
29,9,192,4,11,-7
29,9,193,9,31,-22
29,9,194,11,35,-24
29,9,195,4,15,-11
29,9,196,4,20,-16
29,9,197,7,16,-9
29,9,198,7,38,-31
29,9,199,8,18,-10
29,9,200,9,24,-15
29,9,201,11,9,2
29,9,202,8,26,-18
29,9,203,21,22,-1
29,9,204,14,24,-10
29,9,205,4,9,-5
29,9,206,7,15,-8
29,9,207,8,17,-9
29,9,208,9,9,0
29,9,209,0,24,-24
29,9,210,5,33,-28
29,9,211,18,20,-2
29,9,212,8,20,-12
29,9,213,2,8,-6
29,9,214,5,23,-18
29,9,215,7,25,-18
29,9,216,10,18,-8
29,9,217,20,37,-17
29,9,218,8,22,-14
29,9,219,10,32,-22
29,9,220,15,23,-8
29,9,221,12,16,-4
29,9,222,4,12,-8
29,9,223,8,39,-31
29,9,224,12,28,-16
29,9,225,8,28,-20
29,9,226,7,20,-13
29,9,227,2,6,-4
29,9,228,5,21,-16
29,9,229,8,16,-8
29,9,230,11,21,-10
29,9,231,9,18,-9
29,9,232,5,9,-4
29,9,233,9,25,-16
29,9,234,12,18,-6
29,9,235,14,11,3
29,9,236,7,32,-25
29,9,237,17,32,-15
29,9,238,10,20,-10
29,9,239,10,20,-10
29,9,240,10,26,-16
29,9,241,9,17,-8
29,9,242,11,23,-12
29,9,243,9,28,-19
29,9,244,14,32,-18
29,9,245,6,7,-1
29,9,246,17,31,-14
29,9,247,15,24,-9
29,9,248,8,18,-10
29,9,249,7,25,-18
29,9,250,5,18,-13
29,9,251,15,13,2
29,9,252,9,29,-20
29,9,253,8,46,-38
29,9,254,13,27,-14
29,9,255,10,15,-5
29,9,256,9,27,-18
29,9,257,18,24,-6
29,9,258,7,18,-11
29,9,259,12,8,4
29,9,260,8,27,-19
29,9,261,11,18,-7
29,9,262,18,29,-11
29,9,263,4,23,-19
29,9,264,9,25,-16
29,9,265,2,15,-13
29,9,266,13,18,-5
29,9,267,14,21,-7
29,9,268,7,28,-21
29,9,269,7,25,-18
29,9,270,6,10,-4
29,9,271,4,14,-10
29,9,272,8,19,-11
29,9,273,3,20,-17
29,9,274,15,20,-5
29,9,275,14,12,2
29,9,276,13,20,-7
29,9,277,10,18,-8
29,9,278,10,31,-21
29,9,279,4,19,-15
29,9,280,11,25,-14
29,9,281,3,6,-3
29,9,282,2,19,-17
29,9,283,10,36,-26
29,9,284,15,33,-18
29,9,285,11,18,-7
29,9,286,7,22,-15
29,9,287,10,23,-13
29,9,288,18,32,-14
29,9,289,17,16,1
29,9,290,7,22,-15
29,9,291,10,16,-6
29,9,292,10,11,-1
29,9,293,11,18,-7
29,9,294,14,17,-3
29,9,295,4,11,-7
29,9,296,5,46,-41
29,9,297,6,20,-14
29,9,298,7,14,-7
29,9,299,15,15,0
29,10,0,10,15,-5
29,10,1,11,18,-7
29,10,2,15,34,-19
29,10,3,4,20,-16
29,10,4,7,18,-11
29,10,5,3,6,-3
29,10,6,13,12,1
29,10,7,21,18,3
29,10,8,10,16,-6
29,10,9,3,12,-9
29,10,10,8,23,-15
29,10,11,8,15,-7
29,10,12,11,22,-11
29,10,13,12,18,-6
29,10,14,7,25,-18
29,10,15,6,13,-7
29,10,16,9,27,-18
29,10,17,14,17,-3
29,10,18,7,17,-10
29,10,19,6,10,-4
29,10,20,12,31,-19
29,10,21,6,8,-2
29,10,22,6,24,-18
29,10,23,14,24,-10
29,10,24,26,22,4
29,10,25,12,20,-8
29,10,26,12,13,-1
29,10,27,13,19,-6
29,10,28,12,27,-15
29,10,29,13,30,-17
29,10,30,5,25,-20
29,10,31,11,15,-4
29,10,32,15,18,-3
29,10,33,7,22,-15
29,10,34,9,27,-18
29,10,35,2,22,-20
29,10,36,13,24,-11
29,10,37,9,15,-6
29,10,38,7,28,-21
29,10,39,6,15,-9
29,10,40,8,20,-12
29,10,41,13,23,-10
29,10,42,10,19,-9
29,10,43,5,18,-13
29,10,44,9,19,-10
29,10,45,4,11,-7
29,10,46,11,18,-7
29,10,47,13,28,-15
29,10,48,10,25,-15
29,10,49,4,16,-12
29,10,50,8,18,-10
29,10,51,11,20,-9
29,10,52,7,14,-7
29,10,53,10,11,-1
29,10,54,18,16,2
29,10,55,3,25,-22
29,10,56,20,32,-12
29,10,57,12,35,-23
29,10,58,13,16,-3
29,10,59,10,16,-6
29,10,60,3,13,-10
29,10,61,10,26,-16
29,10,62,17,18,-1
29,10,63,25,33,-8
29,10,64,8,21,-13
29,10,65,12,26,-14
29,10,66,13,20,-7
29,10,67,7,21,-14
29,10,68,9,33,-24
29,10,69,14,34,-20
29,10,70,5,10,-5
29,10,71,25,27,-2
29,10,72,8,15,-7
29,10,73,15,25,-10
29,10,74,11,33,-22
29,10,75,4,21,-17
29,10,76,10,20,-10
29,10,77,11,15,-4
29,10,78,9,19,-10
29,10,79,21,30,-9
29,10,80,2,21,-19
29,10,81,13,27,-14
29,10,82,13,22,-9
29,10,83,7,17,-10
29,10,84,3,14,-11
29,10,85,9,27,-18
29,10,86,9,22,-13
29,10,87,5,21,-16
29,10,88,7,14,-7
29,10,89,25,30,-5
29,10,90,9,8,1
29,10,91,7,23,-16
29,10,92,6,14,-8
29,10,93,10,17,-7
29,10,94,8,21,-13
29,10,95,2,8,-6
29,10,96,19,21,-2
29,10,97,5,7,-2
29,10,98,16,31,-15
29,10,99,30,18,12
29,10,100,3,9,-6
29,10,101,11,15,-4
29,10,102,12,14,-2
29,10,103,9,12,-3
29,10,104,10,18,-8
29,10,105,8,20,-12
29,10,106,17,31,-14
29,10,107,10,11,-1
29,10,108,10,23,-13
29,10,109,12,10,2
29,10,110,8,26,-18
29,10,111,7,18,-11
29,10,112,14,18,-4
29,10,113,10,13,-3
29,10,114,10,19,-9
29,10,115,8,23,-15
29,10,116,6,15,-9
29,10,117,7,17,-10
29,10,118,4,15,-11
29,10,119,10,7,3
29,10,120,10,31,-21
29,10,121,7,12,-5
29,10,122,12,21,-9
29,10,123,7,24,-17
29,10,124,9,29,-20
29,10,125,8,32,-24
29,10,126,8,18,-10
29,10,127,9,18,-9
29,10,128,18,29,-11
29,10,129,12,23,-11
29,10,130,8,18,-10
29,10,131,25,12,13
29,10,132,4,12,-8
29,10,133,14,32,-18
29,10,134,9,21,-12
29,10,135,15,14,1
29,10,136,13,15,-2
29,10,137,1,10,-9
29,10,138,8,15,-7
29,10,139,13,5,8
29,10,140,8,13,-5
29,10,141,14,22,-8
29,10,142,7,23,-16
29,10,143,10,11,-1
29,10,144,11,16,-5
29,10,145,11,23,-12
29,10,146,1,25,-24
29,10,147,8,26,-18
29,10,148,7,36,-29
29,10,149,3,23,-20
29,10,150,14,26,-12
29,10,151,12,27,-15
29,10,152,11,16,-5
29,10,153,8,11,-3
29,10,154,16,36,-20
29,10,155,9,11,-2
29,10,156,16,18,-2
29,10,157,2,22,-20
29,10,158,2,12,-10
29,10,159,7,22,-15
29,10,160,14,31,-17
29,10,161,5,18,-13
29,10,162,6,19,-13
29,10,163,13,9,4
29,10,164,11,26,-15
29,10,165,12,10,2
29,10,166,14,40,-26
29,10,167,11,11,0
29,10,168,1,16,-15
29,10,169,7,10,-3
29,10,170,12,33,-21
29,10,171,5,13,-8
29,10,172,6,25,-19
29,10,173,17,16,1
29,10,174,19,32,-13
29,10,175,10,11,-1
29,10,176,13,19,-6
29,10,177,6,19,-13
29,10,178,10,22,-12
29,10,179,7,23,-16
29,10,180,9,19,-10
29,10,181,14,25,-11
29,10,182,10,33,-23
29,10,183,13,24,-11
29,10,184,3,9,-6
29,10,185,13,16,-3
29,10,186,14,25,-11
29,10,187,8,18,-10
29,10,188,11,15,-4
29,10,189,16,46,-30
29,10,190,13,18,-5
29,10,191,20,34,-14
29,10,192,10,27,-17
29,10,193,6,29,-23
29,10,194,10,27,-17
29,10,195,14,19,-5
29,10,196,25,12,13
29,10,197,8,17,-9
29,10,198,18,32,-14
29,10,199,7,22,-15
29,10,200,9,12,-3
29,10,201,14,25,-11
29,10,202,5,32,-27
29,10,203,6,20,-14
29,10,204,7,11,-4
29,10,205,11,22,-11
29,10,206,11,15,-4
29,10,207,5,24,-19
29,10,208,14,4,10
29,10,209,9,23,-14
29,10,210,20,28,-8
29,10,211,10,24,-14
29,10,212,10,23,-13
29,10,213,11,18,-7
29,10,214,5,13,-8
29,10,215,14,27,-13
29,10,216,1,10,-9
29,10,217,8,17,-9
29,10,218,3,21,-18
29,10,219,10,15,-5
29,10,220,12,20,-8
29,10,221,13,28,-15
29,10,222,13,19,-6
29,10,223,4,12,-8
29,10,224,6,16,-10
29,10,225,14,22,-8
29,10,226,8,28,-20
29,10,227,2,3,-1
29,10,228,8,35,-27
29,10,229,11,13,-2
29,10,230,10,18,-8
29,10,231,5,7,-2
29,10,232,1,24,-23
29,10,233,11,15,-4
29,10,234,12,18,-6
29,10,235,8,25,-17
29,10,236,2,10,-8
29,10,237,6,22,-16
29,10,238,13,17,-4
29,10,239,15,14,1
29,10,240,11,22,-11
29,10,241,7,11,-4
29,10,242,7,24,-17
29,10,243,3,36,-33
29,10,244,24,16,8
29,10,245,7,26,-19
29,10,246,13,12,1
29,10,247,14,27,-13
29,10,248,7,22,-15
29,10,249,12,35,-23
29,10,250,8,18,-10
29,10,251,8,25,-17
29,10,252,7,11,-4
29,10,253,11,17,-6
29,10,254,4,28,-24
29,10,255,13,11,2
29,10,256,8,26,-18
29,10,257,6,19,-13
29,10,258,13,24,-11
29,10,259,9,23,-14
29,10,260,11,20,-9
29,10,261,8,14,-6
29,10,262,10,9,1
29,10,263,5,29,-24
29,10,264,14,13,1
29,10,265,6,22,-16
29,10,266,13,13,0
29,10,267,10,18,-8
29,10,268,12,19,-7
29,10,269,7,17,-10
29,10,270,16,15,1
29,10,271,10,28,-18
29,10,272,11,20,-9
29,10,273,10,23,-13
29,10,274,6,13,-7
29,10,275,15,21,-6
29,10,276,11,18,-7
29,10,277,9,23,-14
29,10,278,8,33,-25
29,10,279,9,9,0
29,10,280,6,30,-24
29,10,281,22,23,-1
29,10,282,8,10,-2
29,10,283,20,36,-16
29,10,284,3,12,-9
29,10,285,9,22,-13
29,10,286,5,37,-32
29,10,287,5,33,-28
29,10,288,6,19,-13
29,10,289,2,21,-19
29,10,290,10,23,-13
29,10,291,16,15,1
29,10,292,22,20,2
29,10,293,6,28,-22
29,10,294,12,19,-7
29,10,295,4,15,-11
29,10,296,5,26,-21
29,10,297,15,17,-2
29,10,298,11,30,-19
29,10,299,16,30,-14
29,11,0,7,15,-8
29,11,1,5,16,-11
29,11,2,13,18,-5
29,11,3,20,26,-6
29,11,4,6,7,-1
29,11,5,10,18,-8
29,11,6,15,26,-11
29,11,7,12,14,-2
29,11,8,7,15,-8
29,11,9,21,27,-6
29,11,10,10,21,-11
29,11,11,9,20,-11
29,11,12,17,18,-1
29,11,13,8,15,-7
29,11,14,7,24,-17
29,11,15,6,10,-4
29,11,16,7,19,-12
29,11,17,12,29,-17
29,11,18,12,16,-4
29,11,19,17,23,-6
29,11,20,16,19,-3
29,11,21,6,20,-14
29,11,22,12,17,-5
29,11,23,10,20,-10
29,11,24,7,20,-13
29,11,25,19,20,-1
29,11,26,3,17,-14
29,11,27,15,11,4
29,11,28,16,24,-8
29,11,29,9,9,0
29,11,30,10,19,-9
29,11,31,0,25,-25
29,11,32,10,20,-10
29,11,33,8,23,-15
29,11,34,10,12,-2
29,11,35,6,16,-10
29,11,36,7,26,-19
29,11,37,8,13,-5
29,11,38,5,22,-17
29,11,39,18,37,-19
29,11,40,7,18,-11
29,11,41,14,31,-17
29,11,42,4,18,-14
29,11,43,8,26,-18
29,11,44,10,10,0
29,11,45,10,25,-15
29,11,46,10,31,-21
29,11,47,10,14,-4
29,11,48,8,27,-19
29,11,49,7,22,-15
29,11,50,14,17,-3
29,11,51,11,17,-6
29,11,52,13,17,-4
29,11,53,9,14,-5
29,11,54,15,27,-12
29,11,55,5,11,-6
29,11,56,10,45,-35
29,11,57,9,23,-14
29,11,58,5,11,-6
29,11,59,4,16,-12
29,11,60,7,8,-1
29,11,61,7,29,-22
29,11,62,15,20,-5
29,11,63,7,21,-14
29,11,64,6,19,-13
29,11,65,2,14,-12
29,11,66,16,31,-15
29,11,67,10,13,-3
29,11,68,4,28,-24
29,11,69,6,5,1
29,11,70,12,27,-15
29,11,71,12,24,-12
29,11,72,18,26,-8
29,11,73,14,16,-2
29,11,74,13,22,-9
29,11,75,14,12,2
29,11,76,9,18,-9
29,11,77,9,20,-11
29,11,78,17,17,0
29,11,79,15,14,1
29,11,80,10,25,-15
29,11,81,6,20,-14
29,11,82,13,24,-11
29,11,83,13,18,-5
29,11,84,17,31,-14
29,11,85,6,13,-7
29,11,86,9,18,-9
29,11,87,4,11,-7
29,11,88,7,19,-12
29,11,89,9,8,1
29,11,90,2,6,-4
29,11,91,12,15,-3
29,11,92,8,13,-5
29,11,93,13,24,-11
29,11,94,12,25,-13
29,11,95,19,20,-1
29,11,96,7,19,-12
29,11,97,9,21,-12
29,11,98,11,15,-4
29,11,99,17,26,-9
29,11,100,8,3,5
29,11,101,13,16,-3
29,11,102,9,26,-17
29,11,103,13,25,-12
29,11,104,14,20,-6
29,11,105,4,14,-10
29,11,106,14,22,-8
29,11,107,9,11,-2
29,11,108,14,28,-14
29,11,109,3,24,-21
29,11,110,9,20,-11
29,11,111,9,25,-16
29,11,112,7,13,-6
29,11,113,7,25,-18
29,11,114,9,20,-11
29,11,115,8,17,-9
29,11,116,1,14,-13
29,11,117,5,20,-15
29,11,118,10,23,-13
29,11,119,11,34,-23
29,11,120,16,18,-2
29,11,121,6,27,-21
29,11,122,21,26,-5
29,11,123,8,40,-32
29,11,124,14,17,-3
29,11,125,10,23,-13
29,11,126,16,30,-14
29,11,127,6,22,-16
29,11,128,15,13,2
29,11,129,2,13,-11
29,11,130,6,23,-17
29,11,131,11,13,-2
29,11,132,20,22,-2
29,11,133,13,18,-5
29,11,134,10,33,-23
29,11,135,13,33,-20
29,11,136,16,20,-4
29,11,137,18,22,-4
29,11,138,18,21,-3
29,11,139,8,23,-15
29,11,140,8,15,-7
29,11,141,15,19,-4
29,11,142,10,24,-14
29,11,143,8,7,1
29,11,144,12,29,-17
29,11,145,18,27,-9
29,11,146,9,13,-4
29,11,147,7,14,-7
29,11,148,6,16,-10
29,11,149,4,18,-14
29,11,150,11,25,-14
29,11,151,5,13,-8
29,11,152,5,11,-6
29,11,153,9,25,-16
29,11,154,16,34,-18
29,11,155,3,14,-11
29,11,156,9,11,-2
29,11,157,8,21,-13
29,11,158,11,27,-16
29,11,159,3,19,-16
29,11,160,17,18,-1
29,11,161,20,7,13
29,11,162,12,26,-14
29,11,163,11,22,-11
29,11,164,3,10,-7
29,11,165,9,17,-8
29,11,166,9,14,-5
29,11,167,6,19,-13
29,11,168,7,18,-11
29,11,169,8,19,-11
29,11,170,12,27,-15
29,11,171,9,28,-19
29,11,172,11,13,-2
29,11,173,4,21,-17
29,11,174,19,16,3
29,11,175,12,22,-10
29,11,176,5,8,-3
29,11,177,8,17,-9
29,11,178,10,11,-1
29,11,179,3,32,-29
29,11,180,7,11,-4
29,11,181,12,18,-6
29,11,182,8,16,-8
29,11,183,10,9,1
29,11,184,12,17,-5
29,11,185,12,24,-12
29,11,186,11,13,-2
29,11,187,15,21,-6
29,11,188,8,19,-11
29,11,189,16,7,9
29,11,190,12,21,-9
29,11,191,11,9,2
29,11,192,12,23,-11
29,11,193,17,19,-2
29,11,194,5,20,-15
29,11,195,4,16,-12
29,11,196,11,25,-14
29,11,197,9,15,-6
29,11,198,14,26,-12
29,11,199,10,18,-8
29,11,200,11,20,-9
29,11,201,15,27,-12
29,11,202,15,23,-8
29,11,203,10,15,-5
29,11,204,9,16,-7
29,11,205,8,18,-10
29,11,206,5,15,-10
29,11,207,11,20,-9
29,11,208,17,16,1
29,11,209,6,2,4
29,11,210,5,18,-13
29,11,211,3,16,-13
29,11,212,8,23,-15
29,11,213,8,18,-10
29,11,214,3,18,-15
29,11,215,12,24,-12
29,11,216,13,36,-23
29,11,217,12,21,-9
29,11,218,6,27,-21
29,11,219,9,21,-12
29,11,220,9,18,-9
29,11,221,8,22,-14
29,11,222,17,28,-11
29,11,223,5,10,-5
29,11,224,11,20,-9
29,11,225,11,35,-24
29,11,226,9,18,-9
29,11,227,22,23,-1
29,11,228,7,10,-3
29,11,229,13,14,-1
29,11,230,13,17,-4
29,11,231,7,18,-11
29,11,232,3,13,-10
29,11,233,6,20,-14
29,11,234,13,24,-11
29,11,235,20,20,0
29,11,236,13,6,7
29,11,237,17,23,-6
29,11,238,12,23,-11
29,11,239,10,24,-14
29,11,240,6,18,-12
29,11,241,17,25,-8
29,11,242,14,18,-4
29,11,243,4,22,-18
29,11,244,11,24,-13
29,11,245,16,17,-1
29,11,246,8,23,-15
29,11,247,12,22,-10
29,11,248,21,22,-1
29,11,249,8,25,-17
29,11,250,16,23,-7
29,11,251,15,23,-8
29,11,252,7,17,-10
29,11,253,9,22,-13
29,11,254,8,23,-15
29,11,255,5,30,-25
29,11,256,5,20,-15
29,11,257,12,18,-6
29,11,258,10,11,-1
29,11,259,10,8,2
29,11,260,6,15,-9
29,11,261,9,18,-9
29,11,262,15,18,-3
29,11,263,2,17,-15
29,11,264,6,16,-10
29,11,265,15,21,-6
29,11,266,10,12,-2
29,11,267,4,13,-9
29,11,268,6,25,-19
29,11,269,5,11,-6
29,11,270,0,15,-15
29,11,271,10,19,-9
29,11,272,5,21,-16
29,11,273,9,26,-17
29,11,274,14,6,8
29,11,275,13,14,-1
29,11,276,16,14,2
29,11,277,2,12,-10
29,11,278,14,29,-15
29,11,279,13,19,-6
29,11,280,16,15,1
29,11,281,17,13,4
29,11,282,9,28,-19
29,11,283,6,22,-16
29,11,284,9,28,-19
29,11,285,4,17,-13
29,11,286,11,28,-17
29,11,287,6,25,-19
29,11,288,11,15,-4
29,11,289,4,15,-11
29,11,290,18,42,-24
29,11,291,8,7,1
29,11,292,6,34,-28
29,11,293,12,24,-12
29,11,294,4,22,-18
29,11,295,9,18,-9
29,11,296,5,14,-9
29,11,297,7,11,-4
29,11,298,5,15,-10
29,11,299,8,15,-7
29,12,0,8,24,-16
29,12,1,7,23,-16
29,12,2,12,18,-6
29,12,3,9,17,-8
29,12,4,7,20,-13
29,12,5,2,9,-7
29,12,6,5,21,-16
29,12,7,6,0,6
29,12,8,11,15,-4
29,12,9,8,9,-1
29,12,10,11,15,-4
29,12,11,13,28,-15
29,12,12,1,19,-18
29,12,13,6,14,-8
29,12,14,13,27,-14
29,12,15,13,20,-7
29,12,16,9,16,-7
29,12,17,12,8,4
29,12,18,1,8,-7
29,12,19,14,13,1
29,12,20,4,16,-12
29,12,21,3,16,-13
29,12,22,12,17,-5
29,12,23,6,10,-4
29,12,24,21,36,-15
29,12,25,20,25,-5
29,12,26,8,24,-16
29,12,27,9,21,-12
29,12,28,3,23,-20
29,12,29,15,15,0
29,12,30,11,20,-9
29,12,31,7,13,-6
29,12,32,19,20,-1
29,12,33,11,21,-10
29,12,34,12,25,-13
29,12,35,20,24,-4
29,12,36,13,20,-7
29,12,37,2,10,-8
29,12,38,6,20,-14
29,12,39,10,15,-5
29,12,40,9,19,-10
29,12,41,12,27,-15
29,12,42,11,23,-12
29,12,43,13,23,-10
29,12,44,16,15,1
29,12,45,4,18,-14
29,12,46,20,25,-5
29,12,47,14,16,-2
29,12,48,5,15,-10
29,12,49,8,13,-5
29,12,50,13,18,-5
29,12,51,8,24,-16
29,12,52,9,18,-9
29,12,53,6,3,3
29,12,54,2,17,-15
29,12,55,7,11,-4
29,12,56,16,40,-24
29,12,57,17,16,1
29,12,58,11,12,-1
29,12,59,4,13,-9
29,12,60,8,17,-9
29,12,61,3,23,-20
29,12,62,17,11,6
29,12,63,14,17,-3
29,12,64,9,9,0
29,12,65,17,20,-3
29,12,66,16,18,-2
29,12,67,6,15,-9
29,12,68,16,17,-1
29,12,69,11,39,-28
29,12,70,8,21,-13
29,12,71,9,23,-14
29,12,72,14,24,-10
29,12,73,14,14,0
29,12,74,6,12,-6
29,12,75,7,15,-8
29,12,76,15,26,-11
29,12,77,6,14,-8
29,12,78,8,19,-11
29,12,79,8,7,1
29,12,80,5,18,-13
29,12,81,11,14,-3
29,12,82,9,10,-1
29,12,83,5,9,-4
29,12,84,8,14,-6
29,12,85,10,17,-7
29,12,86,10,8,2
29,12,87,12,11,1
29,12,88,8,19,-11
29,12,89,5,21,-16
29,12,90,7,19,-12
29,12,91,11,12,-1
29,12,92,17,13,4
29,12,93,16,20,-4
29,12,94,10,10,0
29,12,95,16,25,-9
29,12,96,11,23,-12
29,12,97,2,10,-8
29,12,98,5,5,0
29,12,99,5,19,-14
29,12,100,10,21,-11
29,12,101,16,18,-2
29,12,102,3,15,-12
29,12,103,14,7,7
29,12,104,12,25,-13
29,12,105,8,21,-13
29,12,106,11,24,-13
29,12,107,6,10,-4
29,12,108,11,20,-9
29,12,109,11,20,-9
29,12,110,6,10,-4
29,12,111,26,25,1
29,12,112,18,27,-9
29,12,113,10,11,-1
29,12,114,4,15,-11
29,12,115,9,26,-17
29,12,116,13,33,-20
29,12,117,8,18,-10
29,12,118,12,20,-8
29,12,119,2,11,-9
29,12,120,5,5,0
29,12,121,6,21,-15
29,12,122,26,18,8
29,12,123,10,23,-13
29,12,124,10,8,2
29,12,125,17,20,-3
29,12,126,7,22,-15
29,12,127,3,10,-7
29,12,128,11,19,-8
29,12,129,8,16,-8
29,12,130,8,12,-4
29,12,131,10,29,-19
29,12,132,14,21,-7
29,12,133,7,9,-2
29,12,134,14,18,-4
29,12,135,13,28,-15
29,12,136,15,29,-14
29,12,137,12,8,4
29,12,138,9,5,4
29,12,139,9,27,-18
29,12,140,10,22,-12
29,12,141,11,11,0
29,12,142,14,12,2
29,12,143,9,10,-1
29,12,144,6,13,-7
29,12,145,5,18,-13
29,12,146,7,20,-13
29,12,147,14,14,0
29,12,148,9,32,-23
29,12,149,5,17,-12
29,12,150,12,14,-2
29,12,151,19,19,0
29,12,152,9,35,-26
29,12,153,12,16,-4
29,12,154,6,13,-7
29,12,155,15,14,1
29,12,156,10,19,-9
29,12,157,1,13,-12
29,12,158,14,19,-5
29,12,159,14,28,-14
29,12,160,4,16,-12
29,12,161,4,20,-16
29,12,162,2,20,-18
29,12,163,9,16,-7
29,12,164,23,12,11
29,12,165,14,11,3
29,12,166,6,12,-6
29,12,167,15,12,3
29,12,168,8,23,-15
29,12,169,8,18,-10
29,12,170,10,21,-11
29,12,171,10,18,-8
29,12,172,15,26,-11
29,12,173,10,16,-6
29,12,174,8,22,-14
29,12,175,9,22,-13
29,12,176,10,17,-7
29,12,177,5,21,-16
29,12,178,10,14,-4
29,12,179,11,25,-14
29,12,180,5,15,-10
29,12,181,9,6,3
29,12,182,6,10,-4
29,12,183,16,29,-13
29,12,184,4,14,-10
29,12,185,8,12,-4
29,12,186,27,20,7
29,12,187,14,14,0
29,12,188,6,18,-12
29,12,189,6,10,-4
29,12,190,9,22,-13
29,12,191,13,17,-4
29,12,192,12,23,-11
29,12,193,7,23,-16
29,12,194,8,36,-28
29,12,195,14,27,-13
29,12,196,6,27,-21
29,12,197,6,13,-7
29,12,198,12,24,-12
29,12,199,13,26,-13
29,12,200,9,20,-11
29,12,201,17,31,-14
29,12,202,17,22,-5
29,12,203,2,15,-13
29,12,204,12,25,-13
29,12,205,10,18,-8
29,12,206,15,14,1
29,12,207,11,23,-12
29,12,208,7,17,-10
29,12,209,13,19,-6
29,12,210,12,30,-18
29,12,211,17,19,-2
29,12,212,14,14,0
29,12,213,16,28,-12
29,12,214,12,18,-6
29,12,215,19,23,-4
29,12,216,6,25,-19
29,12,217,4,19,-15
29,12,218,4,11,-7
29,12,219,2,17,-15
29,12,220,6,12,-6
29,12,221,15,15,0
29,12,222,7,23,-16
29,12,223,7,24,-17
29,12,224,11,22,-11
29,12,225,9,38,-29
29,12,226,10,28,-18
29,12,227,16,27,-11
29,12,228,14,18,-4
29,12,229,15,17,-2
29,12,230,9,12,-3
29,12,231,18,23,-5
29,12,232,5,16,-11
29,12,233,11,26,-15
29,12,234,5,12,-7
29,12,235,13,16,-3
29,12,236,9,19,-10
29,12,237,9,15,-6
29,12,238,10,23,-13
29,12,239,16,21,-5
29,12,240,11,45,-34
29,12,241,5,13,-8
29,12,242,5,11,-6
29,12,243,6,13,-7
29,12,244,4,9,-5
29,12,245,19,25,-6
29,12,246,7,15,-8
29,12,247,7,17,-10
29,12,248,13,16,-3
29,12,249,8,23,-15
29,12,250,18,14,4
29,12,251,4,20,-16
29,12,252,7,10,-3
29,12,253,13,10,3
29,12,254,13,9,4
29,12,255,7,14,-7
29,12,256,18,22,-4
29,12,257,4,23,-19
29,12,258,9,20,-11
29,12,259,10,13,-3
29,12,260,5,17,-12
29,12,261,3,11,-8
29,12,262,5,21,-16
29,12,263,4,23,-19
29,12,264,8,23,-15
29,12,265,8,16,-8
29,12,266,9,18,-9
29,12,267,17,14,3
29,12,268,15,23,-8
29,12,269,6,10,-4
29,12,270,12,16,-4
29,12,271,5,20,-15
29,12,272,6,9,-3
29,12,273,4,7,-3
29,12,274,23,28,-5
29,12,275,8,10,-2
29,12,276,10,20,-10
29,12,277,6,22,-16
29,12,278,11,19,-8
29,12,279,25,32,-7
29,12,280,8,25,-17
29,12,281,7,12,-5
29,12,282,16,20,-4
29,12,283,12,17,-5
29,12,284,20,34,-14
29,12,285,6,18,-12
29,12,286,11,18,-7
29,12,287,18,25,-7
29,12,288,5,13,-8
29,12,289,9,31,-22
29,12,290,7,25,-18
29,12,291,12,23,-11
29,12,292,9,16,-7
29,12,293,16,26,-10
29,12,294,8,10,-2
29,12,295,6,25,-19
29,12,296,9,5,4
29,12,297,19,7,12
29,12,298,11,19,-8
29,12,299,9,16,-7
29,13,0,6,25,-19
29,13,1,9,17,-8
29,13,2,4,10,-6
29,13,3,14,25,-11
29,13,4,4,10,-6
29,13,5,7,14,-7
29,13,6,5,13,-8
29,13,7,12,16,-4
29,13,8,10,25,-15
29,13,9,19,20,-1
29,13,10,11,24,-13
29,13,11,15,24,-9
29,13,12,12,17,-5
29,13,13,17,18,-1
29,13,14,13,31,-18
29,13,15,4,12,-8
29,13,16,11,15,-4
29,13,17,15,15,0
29,13,18,14,27,-13
29,13,19,8,19,-11
29,13,20,26,25,1
29,13,21,16,24,-8
29,13,22,5,20,-15
29,13,23,3,8,-5
29,13,24,12,20,-8
29,13,25,9,8,1
29,13,26,13,25,-12
29,13,27,7,20,-13
29,13,28,8,17,-9
29,13,29,9,26,-17
29,13,30,4,33,-29
29,13,31,4,19,-15
29,13,32,5,26,-21
29,13,33,5,8,-3
29,13,34,6,19,-13
29,13,35,3,26,-23
29,13,36,7,26,-19
29,13,37,12,24,-12
29,13,38,11,26,-15
29,13,39,11,21,-10
29,13,40,5,13,-8
29,13,41,12,17,-5
29,13,42,5,14,-9
29,13,43,7,13,-6
29,13,44,12,16,-4
29,13,45,7,30,-23
29,13,46,7,11,-4
29,13,47,10,24,-14
29,13,48,10,24,-14
29,13,49,10,23,-13
29,13,50,12,31,-19
29,13,51,16,21,-5
29,13,52,28,21,7
29,13,53,6,18,-12
29,13,54,6,14,-8
29,13,55,10,30,-20
29,13,56,9,19,-10
29,13,57,15,17,-2
29,13,58,3,17,-14
29,13,59,16,11,5
29,13,60,2,6,-4
29,13,61,11,22,-11
29,13,62,1,18,-17
29,13,63,9,23,-14
29,13,64,7,13,-6
29,13,65,9,16,-7
29,13,66,7,17,-10
29,13,67,11,17,-6
29,13,68,2,8,-6
29,13,69,14,18,-4
29,13,70,9,20,-11
29,13,71,14,10,4
29,13,72,11,12,-1
29,13,73,5,5,0
29,13,74,7,11,-4
29,13,75,13,17,-4
29,13,76,15,10,5
29,13,77,10,9,1
29,13,78,11,15,-4
29,13,79,9,21,-12
29,13,80,11,15,-4
29,13,81,12,29,-17
29,13,82,9,10,-1
29,13,83,14,23,-9
29,13,84,12,33,-21
29,13,85,14,18,-4
29,13,86,10,22,-12
29,13,87,16,23,-7
29,13,88,9,7,2
29,13,89,5,7,-2
29,13,90,13,31,-18
29,13,91,6,19,-13
29,13,92,19,35,-16
29,13,93,12,19,-7
29,13,94,24,29,-5
29,13,95,8,23,-15
29,13,96,7,13,-6
29,13,97,15,25,-10
29,13,98,13,25,-12
29,13,99,16,18,-2
29,13,100,9,15,-6
29,13,101,7,9,-2
29,13,102,5,17,-12
29,13,103,6,18,-12
29,13,104,6,34,-28
29,13,105,8,19,-11
29,13,106,10,11,-1
29,13,107,0,18,-18
29,13,108,9,20,-11
29,13,109,4,20,-16
29,13,110,15,17,-2
29,13,111,11,15,-4
29,13,112,6,8,-2
29,13,113,7,13,-6
29,13,114,11,21,-10
29,13,115,20,11,9
29,13,116,8,16,-8
29,13,117,12,21,-9
29,13,118,8,9,-1
29,13,119,20,29,-9
29,13,120,9,25,-16
29,13,121,8,13,-5
29,13,122,7,11,-4
29,13,123,8,20,-12
29,13,124,13,21,-8
29,13,125,17,20,-3
29,13,126,11,14,-3
29,13,127,11,18,-7
29,13,128,10,14,-4
29,13,129,11,18,-7
29,13,130,9,15,-6
29,13,131,13,24,-11
29,13,132,6,21,-15
29,13,133,12,17,-5
29,13,134,11,27,-16
29,13,135,24,31,-7
29,13,136,6,25,-19
29,13,137,13,18,-5
29,13,138,13,17,-4
29,13,139,9,12,-3
29,13,140,5,17,-12
29,13,141,17,44,-27
29,13,142,12,25,-13
29,13,143,9,26,-17
29,13,144,9,25,-16
29,13,145,7,11,-4
29,13,146,8,20,-12
29,13,147,9,21,-12
29,13,148,7,25,-18
29,13,149,8,20,-12
29,13,150,13,35,-22
29,13,151,4,24,-20
29,13,152,10,14,-4
29,13,153,3,7,-4
29,13,154,11,18,-7
29,13,155,10,22,-12
29,13,156,5,17,-12
29,13,157,7,21,-14
29,13,158,11,22,-11
29,13,159,7,27,-20
29,13,160,9,11,-2
29,13,161,14,15,-1
29,13,162,8,15,-7
29,13,163,8,8,0
29,13,164,7,21,-14
29,13,165,10,11,-1
29,13,166,15,12,3
29,13,167,9,4,5
29,13,168,11,17,-6
29,13,169,16,32,-16
29,13,170,13,12,1
29,13,171,14,17,-3
29,13,172,11,17,-6
29,13,173,10,10,0
29,13,174,11,20,-9
29,13,175,10,25,-15
29,13,176,3,12,-9
29,13,177,12,15,-3
29,13,178,6,9,-3
29,13,179,15,11,4
29,13,180,5,9,-4
29,13,181,9,17,-8
29,13,182,14,28,-14
29,13,183,12,13,-1
29,13,184,12,12,0
29,13,185,9,11,-2
29,13,186,9,16,-7
29,13,187,11,23,-12
29,13,188,9,11,-2
29,13,189,14,15,-1
29,13,190,9,18,-9
29,13,191,16,16,0
29,13,192,10,15,-5
29,13,193,1,12,-11
29,13,194,13,20,-7
29,13,195,15,15,0
29,13,196,3,21,-18
29,13,197,4,12,-8
29,13,198,6,23,-17
29,13,199,12,26,-14
29,13,200,12,8,4
29,13,201,11,14,-3
29,13,202,19,37,-18
29,13,203,5,17,-12
29,13,204,15,23,-8
29,13,205,14,21,-7
29,13,206,10,22,-12
29,13,207,10,17,-7
29,13,208,16,22,-6
29,13,209,7,10,-3
29,13,210,13,18,-5
29,13,211,8,12,-4
29,13,212,17,14,3
29,13,213,8,16,-8
29,13,214,5,11,-6
29,13,215,6,21,-15
29,13,216,4,4,0
29,13,217,5,24,-19
29,13,218,8,21,-13
29,13,219,15,9,6
29,13,220,2,15,-13
29,13,221,18,43,-25
29,13,222,15,22,-7
29,13,223,9,17,-8
29,13,224,9,11,-2
29,13,225,21,22,-1
29,13,226,7,28,-21
29,13,227,12,19,-7
29,13,228,13,25,-12
29,13,229,13,25,-12
29,13,230,8,17,-9
29,13,231,4,19,-15
29,13,232,12,18,-6
29,13,233,5,19,-14
29,13,234,10,16,-6
29,13,235,5,24,-19
29,13,236,10,17,-7
29,13,237,6,6,0
29,13,238,4,20,-16
29,13,239,6,31,-25
29,13,240,8,26,-18
29,13,241,9,23,-14
29,13,242,7,28,-21
29,13,243,3,26,-23
29,13,244,12,28,-16
29,13,245,8,12,-4
29,13,246,13,23,-10
29,13,247,13,10,3
29,13,248,16,30,-14
29,13,249,8,20,-12
29,13,250,12,26,-14
29,13,251,12,24,-12
29,13,252,15,11,4
29,13,253,3,20,-17
29,13,254,21,21,0
29,13,255,13,33,-20
29,13,256,6,24,-18
29,13,257,8,14,-6
29,13,258,7,26,-19
29,13,259,5,32,-27
29,13,260,14,9,5
29,13,261,6,16,-10
29,13,262,14,29,-15
29,13,263,11,24,-13
29,13,264,15,18,-3
29,13,265,5,10,-5
29,13,266,3,16,-13
29,13,267,11,12,-1
29,13,268,2,5,-3
29,13,269,10,19,-9
29,13,270,5,14,-9
29,13,271,14,29,-15
29,13,272,11,29,-18
29,13,273,18,41,-23
29,13,274,12,15,-3
29,13,275,9,12,-3
29,13,276,9,25,-16
29,13,277,14,27,-13
29,13,278,10,22,-12
29,13,279,10,10,0
29,13,280,12,24,-12
29,13,281,9,18,-9
29,13,282,8,25,-17
29,13,283,10,23,-13
29,13,284,10,11,-1
29,13,285,2,15,-13
29,13,286,8,20,-12
29,13,287,6,22,-16
29,13,288,12,29,-17
29,13,289,7,13,-6
29,13,290,7,24,-17
29,13,291,5,19,-14
29,13,292,3,19,-16
29,13,293,9,20,-11
29,13,294,11,18,-7
29,13,295,3,14,-11
29,13,296,12,23,-11
29,13,297,7,8,-1
29,13,298,19,19,0
29,13,299,8,4,4
29,14,0,15,27,-12
29,14,1,4,13,-9
29,14,2,8,13,-5
29,14,3,15,8,7
29,14,4,7,9,-2
29,14,5,9,32,-23
29,14,6,10,26,-16
29,14,7,6,13,-7
29,14,8,16,18,-2
29,14,9,14,18,-4
29,14,10,9,10,-1
29,14,11,4,14,-10
29,14,12,6,15,-9
29,14,13,12,25,-13
29,14,14,7,20,-13
29,14,15,7,20,-13
29,14,16,13,20,-7
29,14,17,9,17,-8
29,14,18,12,27,-15
29,14,19,4,5,-1
29,14,20,8,25,-17
29,14,21,13,11,2
29,14,22,1,9,-8
29,14,23,13,15,-2
29,14,24,16,21,-5
29,14,25,12,10,2
29,14,26,8,22,-14
29,14,27,9,15,-6
29,14,28,15,15,0
29,14,29,6,14,-8
29,14,30,12,19,-7
29,14,31,5,20,-15
29,14,32,16,22,-6
29,14,33,8,9,-1
29,14,34,6,12,-6
29,14,35,4,17,-13
29,14,36,8,21,-13
29,14,37,8,19,-11
29,14,38,8,10,-2
29,14,39,6,19,-13
29,14,40,16,30,-14
29,14,41,8,22,-14
29,14,42,11,19,-8
29,14,43,18,19,-1
29,14,44,10,9,1
29,14,45,9,3,6
29,14,46,15,27,-12
29,14,47,8,15,-7
29,14,48,9,17,-8
29,14,49,12,9,3
29,14,50,18,19,-1
29,14,51,8,16,-8
29,14,52,12,11,1
29,14,53,2,13,-11
29,14,54,8,13,-5
29,14,55,16,27,-11
29,14,56,11,16,-5
29,14,57,15,25,-10
29,14,58,5,11,-6
29,14,59,12,35,-23
29,14,60,2,22,-20
29,14,61,15,18,-3
29,14,62,8,21,-13
29,14,63,15,19,-4
29,14,64,8,7,1
29,14,65,3,20,-17
29,14,66,14,23,-9
29,14,67,12,30,-18
29,14,68,18,27,-9
29,14,69,11,13,-2
29,14,70,13,21,-8
29,14,71,8,13,-5
29,14,72,11,27,-16
29,14,73,13,17,-4
29,14,74,10,20,-10
29,14,75,8,19,-11
29,14,76,8,14,-6
29,14,77,20,40,-20
29,14,78,2,17,-15
29,14,79,13,18,-5
29,14,80,10,8,2
29,14,81,21,31,-10
29,14,82,6,21,-15
29,14,83,5,17,-12
29,14,84,11,15,-4
29,14,85,7,31,-24
29,14,86,7,25,-18
29,14,87,5,15,-10
29,14,88,14,16,-2
29,14,89,20,19,1
29,14,90,7,18,-11
29,14,91,8,6,2
29,14,92,18,21,-3
29,14,93,10,16,-6
29,14,94,15,29,-14
29,14,95,16,36,-20
29,14,96,17,30,-13
29,14,97,4,22,-18
29,14,98,11,19,-8
29,14,99,5,22,-17
29,14,100,17,20,-3
29,14,101,11,16,-5
29,14,102,11,13,-2
29,14,103,16,24,-8
29,14,104,12,21,-9
29,14,105,8,9,-1
29,14,106,3,19,-16
29,14,107,10,14,-4
29,14,108,9,25,-16
29,14,109,5,8,-3
29,14,110,15,21,-6
29,14,111,6,17,-11
29,14,112,17,38,-21
29,14,113,7,13,-6
29,14,114,6,22,-16
29,14,115,9,11,-2
29,14,116,16,21,-5
29,14,117,8,17,-9
29,14,118,11,24,-13
29,14,119,14,8,6
29,14,120,9,16,-7
29,14,121,9,7,2
29,14,122,13,17,-4
29,14,123,17,9,8
29,14,124,4,18,-14
29,14,125,9,18,-9
29,14,126,11,18,-7
29,14,127,8,28,-20
29,14,128,8,23,-15
29,14,129,12,26,-14
29,14,130,10,7,3
29,14,131,16,17,-1
29,14,132,18,27,-9
29,14,133,16,19,-3
29,14,134,8,12,-4
29,14,135,6,20,-14
29,14,136,11,8,3
29,14,137,15,31,-16
29,14,138,6,18,-12
29,14,139,9,24,-15
29,14,140,8,11,-3
29,14,141,10,9,1
29,14,142,9,16,-7
29,14,143,4,18,-14
29,14,144,5,15,-10
29,14,145,7,21,-14
29,14,146,7,26,-19
29,14,147,11,21,-10
29,14,148,13,22,-9
29,14,149,8,11,-3
29,14,150,17,24,-7
29,14,151,9,18,-9
29,14,152,15,19,-4
29,14,153,9,20,-11
29,14,154,5,18,-13
29,14,155,13,27,-14
29,14,156,4,13,-9
29,14,157,11,26,-15
29,14,158,17,17,0
29,14,159,6,24,-18
29,14,160,17,18,-1
29,14,161,7,4,3
29,14,162,12,12,0
29,14,163,9,23,-14
29,14,164,4,15,-11
29,14,165,5,18,-13
29,14,166,11,9,2
29,14,167,9,21,-12
29,14,168,12,10,2
29,14,169,24,17,7
29,14,170,13,19,-6
29,14,171,9,26,-17
29,14,172,13,9,4
29,14,173,14,22,-8
29,14,174,3,20,-17
29,14,175,19,29,-10
29,14,176,9,15,-6
29,14,177,18,31,-13
29,14,178,4,22,-18
29,14,179,9,15,-6
29,14,180,9,15,-6
29,14,181,17,17,0
29,14,182,9,10,-1
29,14,183,11,24,-13
29,14,184,9,28,-19
29,14,185,9,31,-22
29,14,186,12,26,-14
29,14,187,5,7,-2
29,14,188,6,14,-8
29,14,189,3,11,-8
29,14,190,19,15,4
29,14,191,12,19,-7
29,14,192,12,27,-15
29,14,193,15,16,-1
29,14,194,13,22,-9
29,14,195,17,29,-12
29,14,196,18,31,-13
29,14,197,10,19,-9
29,14,198,9,23,-14
29,14,199,20,11,9
29,14,200,7,27,-20
29,14,201,10,18,-8
29,14,202,16,13,3
29,14,203,5,13,-8
29,14,204,7,12,-5
29,14,205,6,17,-11
29,14,206,13,28,-15
29,14,207,8,10,-2
29,14,208,13,29,-16
29,14,209,11,29,-18
29,14,210,1,10,-9
29,14,211,15,29,-14
29,14,212,5,18,-13
29,14,213,8,7,1
29,14,214,17,14,3
29,14,215,12,34,-22
29,14,216,16,28,-12
29,14,217,15,34,-19
29,14,218,11,24,-13
29,14,219,5,13,-8
29,14,220,15,13,2
29,14,221,3,12,-9
29,14,222,21,18,3
29,14,223,9,19,-10
29,14,224,10,16,-6
29,14,225,12,18,-6
29,14,226,9,22,-13
29,14,227,11,32,-21
29,14,228,8,21,-13
29,14,229,0,12,-12
29,14,230,16,29,-13
29,14,231,11,30,-19
29,14,232,0,17,-17
29,14,233,14,17,-3
29,14,234,11,21,-10
29,14,235,12,15,-3
29,14,236,14,24,-10
29,14,237,6,10,-4
29,14,238,16,10,6
29,14,239,18,22,-4
29,14,240,5,11,-6
29,14,241,13,14,-1
29,14,242,7,10,-3
29,14,243,17,19,-2
29,14,244,11,28,-17
29,14,245,9,10,-1
29,14,246,11,21,-10
29,14,247,11,22,-11
29,14,248,10,15,-5
29,14,249,14,26,-12
29,14,250,11,21,-10
29,14,251,9,17,-8
29,14,252,14,34,-20
29,14,253,14,17,-3
29,14,254,25,13,12
29,14,255,15,21,-6
29,14,256,20,33,-13
29,14,257,5,17,-12
29,14,258,16,29,-13
29,14,259,6,14,-8
29,14,260,20,21,-1
29,14,261,8,19,-11
29,14,262,7,19,-12
29,14,263,7,14,-7
29,14,264,1,15,-14
29,14,265,10,22,-12
29,14,266,14,19,-5
29,14,267,5,11,-6
29,14,268,16,19,-3
29,14,269,22,26,-4
29,14,270,11,15,-4
29,14,271,13,20,-7
29,14,272,0,11,-11
29,14,273,23,16,7
29,14,274,9,12,-3
29,14,275,19,18,1
29,14,276,9,19,-10
29,14,277,21,21,0
29,14,278,10,18,-8
29,14,279,6,12,-6
29,14,280,5,7,-2
29,14,281,14,28,-14
29,14,282,12,23,-11
29,14,283,8,19,-11
29,14,284,2,28,-26
29,14,285,8,14,-6
29,14,286,10,6,4
29,14,287,16,19,-3
29,14,288,15,27,-12
29,14,289,5,11,-6
29,14,290,8,17,-9
29,14,291,16,19,-3
29,14,292,9,16,-7
29,14,293,17,29,-12
29,14,294,26,29,-3
29,14,295,17,19,-2
29,14,296,20,18,2
29,14,297,14,28,-14
29,14,298,13,15,-2
29,14,299,10,12,-2
29,15,0,11,13,-2
29,15,1,18,29,-11
29,15,2,17,11,6
29,15,3,9,15,-6
29,15,4,17,23,-6
29,15,5,11,16,-5
29,15,6,5,15,-10
29,15,7,6,22,-16
29,15,8,11,15,-4
29,15,9,4,15,-11
29,15,10,14,6,8
29,15,11,7,14,-7
29,15,12,10,16,-6
29,15,13,7,22,-15
29,15,14,11,37,-26
29,15,15,14,19,-5
29,15,16,20,12,8
29,15,17,10,19,-9
29,15,18,12,19,-7
29,15,19,18,38,-20
29,15,20,11,34,-23
29,15,21,14,17,-3
29,15,22,15,12,3
29,15,23,14,26,-12
29,15,24,10,13,-3
29,15,25,8,21,-13
29,15,26,17,16,1
29,15,27,24,32,-8
29,15,28,7,18,-11
29,15,29,15,14,1
29,15,30,12,6,6
29,15,31,12,21,-9
29,15,32,9,18,-9
29,15,33,12,15,-3
29,15,34,8,19,-11
29,15,35,13,20,-7
29,15,36,15,19,-4
29,15,37,13,13,0
29,15,38,6,9,-3
29,15,39,16,27,-11
29,15,40,12,24,-12
29,15,41,10,14,-4
29,15,42,6,13,-7
29,15,43,8,19,-11
29,15,44,10,8,2
29,15,45,15,25,-10
29,15,46,15,14,1
29,15,47,7,20,-13
29,15,48,10,19,-9
29,15,49,11,19,-8
29,15,50,11,29,-18
29,15,51,7,20,-13
29,15,52,3,9,-6
29,15,53,14,21,-7
29,15,54,10,19,-9
29,15,55,12,7,5
29,15,56,4,18,-14
29,15,57,9,19,-10
29,15,58,12,20,-8
29,15,59,4,19,-15
29,15,60,16,30,-14
29,15,61,15,16,-1
29,15,62,8,18,-10
29,15,63,17,12,5
29,15,64,7,23,-16
29,15,65,9,20,-11
29,15,66,11,16,-5
29,15,67,16,27,-11
29,15,68,19,18,1
29,15,69,15,27,-12
29,15,70,16,20,-4
29,15,71,8,21,-13
29,15,72,10,15,-5
29,15,73,7,12,-5
29,15,74,3,10,-7
29,15,75,5,13,-8
29,15,76,8,28,-20
29,15,77,9,18,-9
29,15,78,6,21,-15
29,15,79,8,21,-13
29,15,80,13,10,3
29,15,81,13,21,-8
29,15,82,6,23,-17
29,15,83,4,14,-10
29,15,84,7,15,-8
29,15,85,13,12,1
29,15,86,10,22,-12
29,15,87,11,27,-16
29,15,88,6,20,-14
29,15,89,10,30,-20
29,15,90,8,25,-17
29,15,91,14,25,-11
29,15,92,10,23,-13
29,15,93,10,25,-15
29,15,94,8,25,-17
29,15,95,18,22,-4
29,15,96,9,14,-5
29,15,97,15,12,3
29,15,98,12,18,-6
29,15,99,4,14,-10
29,15,100,24,26,-2
29,15,101,12,9,3
29,15,102,6,4,2
29,15,103,11,25,-14
29,15,104,15,26,-11
29,15,105,15,20,-5
29,15,106,10,25,-15
29,15,107,6,14,-8
29,15,108,9,11,-2
29,15,109,7,11,-4
29,15,110,9,10,-1
29,15,111,8,22,-14
29,15,112,7,18,-11
29,15,113,10,23,-13
29,15,114,7,10,-3
29,15,115,6,16,-10
29,15,116,7,34,-27
29,15,117,16,24,-8
29,15,118,6,8,-2
29,15,119,10,25,-15
29,15,120,21,21,0
29,15,121,12,10,2
29,15,122,9,7,2
29,15,123,7,16,-9
29,15,124,12,14,-2
29,15,125,6,6,0
29,15,126,0,20,-20
29,15,127,2,7,-5
29,15,128,12,25,-13
29,15,129,9,10,-1
29,15,130,15,24,-9
29,15,131,13,26,-13
29,15,132,15,33,-18
29,15,133,16,25,-9
29,15,134,9,12,-3
29,15,135,12,19,-7
29,15,136,4,9,-5
29,15,137,5,26,-21
29,15,138,16,22,-6
29,15,139,4,17,-13
29,15,140,15,17,-2
29,15,141,12,33,-21
29,15,142,10,21,-11
29,15,143,6,7,-1
29,15,144,16,21,-5
29,15,145,7,13,-6
29,15,146,12,16,-4
29,15,147,19,19,0
29,15,148,11,24,-13
29,15,149,8,12,-4
29,15,150,23,16,7
29,15,151,6,10,-4
29,15,152,21,26,-5
29,15,153,5,15,-10
29,15,154,17,35,-18
29,15,155,6,24,-18
29,15,156,11,12,-1
29,15,157,11,20,-9
29,15,158,9,25,-16
29,15,159,4,9,-5
29,15,160,10,18,-8
29,15,161,20,38,-18
29,15,162,13,18,-5
29,15,163,11,17,-6
29,15,164,15,34,-19
29,15,165,13,24,-11
29,15,166,7,19,-12
29,15,167,8,13,-5
29,15,168,8,11,-3
29,15,169,10,23,-13
29,15,170,16,10,6
29,15,171,14,22,-8
29,15,172,13,22,-9
29,15,173,7,17,-10
29,15,174,19,18,1
29,15,175,5,12,-7
29,15,176,7,18,-11
29,15,177,7,22,-15
29,15,178,8,15,-7
29,15,179,6,22,-16
29,15,180,12,30,-18
29,15,181,4,22,-18
29,15,182,13,22,-9
29,15,183,11,20,-9
29,15,184,18,18,0
29,15,185,6,8,-2
29,15,186,18,29,-11
29,15,187,12,24,-12
29,15,188,6,13,-7
29,15,189,10,20,-10
29,15,190,10,19,-9
29,15,191,4,18,-14
29,15,192,11,18,-7
29,15,193,3,14,-11
29,15,194,14,11,3
29,15,195,23,27,-4
29,15,196,12,24,-12
29,15,197,7,5,2
29,15,198,7,21,-14
29,15,199,12,13,-1
29,15,200,12,17,-5
29,15,201,14,31,-17
29,15,202,9,14,-5
29,15,203,4,17,-13
29,15,204,7,10,-3
29,15,205,13,18,-5
29,15,206,17,15,2
29,15,207,8,8,0
29,15,208,10,19,-9
29,15,209,19,30,-11
29,15,210,6,16,-10
29,15,211,10,30,-20
29,15,212,13,21,-8
29,15,213,7,15,-8
29,15,214,8,15,-7
29,15,215,11,21,-10
29,15,216,11,16,-5
29,15,217,11,18,-7
29,15,218,7,22,-15
29,15,219,3,15,-12
29,15,220,13,26,-13
29,15,221,7,23,-16
29,15,222,14,22,-8
29,15,223,8,29,-21
29,15,224,9,12,-3
29,15,225,12,26,-14
29,15,226,10,22,-12
29,15,227,11,20,-9
29,15,228,8,22,-14
29,15,229,5,19,-14
29,15,230,10,15,-5
29,15,231,13,22,-9
29,15,232,7,11,-4
29,15,233,7,15,-8
29,15,234,23,23,0
29,15,235,11,15,-4
29,15,236,7,19,-12
29,15,237,8,7,1
29,15,238,5,6,-1
29,15,239,10,29,-19
29,15,240,8,10,-2
29,15,241,6,18,-12
29,15,242,11,21,-10
29,15,243,8,27,-19
29,15,244,12,26,-14
29,15,245,17,25,-8
29,15,246,9,16,-7
29,15,247,10,19,-9
29,15,248,7,20,-13
29,15,249,14,16,-2
29,15,250,11,18,-7
29,15,251,8,25,-17
29,15,252,10,24,-14
29,15,253,11,9,2
29,15,254,15,19,-4
29,15,255,18,26,-8
29,15,256,11,24,-13
29,15,257,10,33,-23
29,15,258,17,15,2
29,15,259,2,16,-14
29,15,260,11,19,-8
29,15,261,14,15,-1
29,15,262,8,21,-13
29,15,263,16,26,-10
29,15,264,5,28,-23
29,15,265,10,16,-6
29,15,266,4,10,-6
29,15,267,10,25,-15
29,15,268,10,6,4
29,15,269,11,8,3
29,15,270,10,19,-9
29,15,271,8,13,-5
29,15,272,5,24,-19
29,15,273,16,22,-6
29,15,274,13,16,-3
29,15,275,7,14,-7
29,15,276,7,20,-13
29,15,277,15,15,0
29,15,278,23,17,6
29,15,279,10,18,-8
29,15,280,8,10,-2
29,15,281,19,10,9
29,15,282,9,29,-20
29,15,283,9,20,-11
29,15,284,7,13,-6
29,15,285,11,24,-13
29,15,286,9,30,-21
29,15,287,10,13,-3
29,15,288,7,13,-6
29,15,289,19,27,-8
29,15,290,9,17,-8
29,15,291,0,13,-13
29,15,292,4,13,-9
29,15,293,17,25,-8
29,15,294,11,8,3
29,15,295,11,14,-3
29,15,296,10,16,-6
29,15,297,12,24,-12
29,15,298,13,13,0
29,15,299,11,8,3
29,16,0,11,14,-3
29,16,1,9,16,-7
29,16,2,6,10,-4
29,16,3,7,10,-3
29,16,4,11,14,-3
29,16,5,12,44,-32
29,16,6,3,18,-15
29,16,7,11,10,1
29,16,8,11,20,-9
29,16,9,17,14,3
29,16,10,15,27,-12
29,16,11,13,17,-4
29,16,12,8,5,3
29,16,13,11,30,-19
29,16,14,9,17,-8
29,16,15,3,15,-12
29,16,16,11,24,-13
29,16,17,13,20,-7
29,16,18,11,9,2
29,16,19,11,18,-7
29,16,20,2,9,-7
29,16,21,16,11,5
29,16,22,2,6,-4
29,16,23,17,26,-9
29,16,24,14,7,7
29,16,25,8,23,-15
29,16,26,10,14,-4
29,16,27,8,15,-7
29,16,28,15,14,1
29,16,29,12,17,-5
29,16,30,12,19,-7
29,16,31,16,20,-4
29,16,32,20,25,-5
29,16,33,13,30,-17
29,16,34,28,17,11
29,16,35,15,20,-5
29,16,36,10,20,-10
29,16,37,12,12,0
29,16,38,13,15,-2
29,16,39,6,16,-10
29,16,40,9,10,-1
29,16,41,10,8,2
29,16,42,17,15,2
29,16,43,5,16,-11
29,16,44,14,15,-1
29,16,45,4,11,-7
29,16,46,24,21,3
29,16,47,5,9,-4
29,16,48,6,18,-12
29,16,49,20,38,-18
29,16,50,17,18,-1
29,16,51,11,26,-15
29,16,52,6,21,-15
29,16,53,11,23,-12
29,16,54,13,17,-4
29,16,55,7,19,-12
29,16,56,2,10,-8
29,16,57,16,13,3
29,16,58,6,20,-14
29,16,59,7,14,-7
29,16,60,11,21,-10
29,16,61,10,7,3
29,16,62,14,19,-5
29,16,63,8,15,-7
29,16,64,7,10,-3
29,16,65,6,16,-10
29,16,66,15,14,1
29,16,67,18,17,1
29,16,68,16,24,-8
29,16,69,14,12,2
29,16,70,17,13,4
29,16,71,14,11,3
29,16,72,11,34,-23
29,16,73,8,27,-19
29,16,74,8,18,-10
29,16,75,5,19,-14
29,16,76,12,16,-4
29,16,77,9,19,-10
29,16,78,12,13,-1
29,16,79,5,21,-16
29,16,80,5,19,-14
29,16,81,8,6,2
29,16,82,11,24,-13
29,16,83,3,16,-13
29,16,84,10,12,-2
29,16,85,12,8,4
29,16,86,11,13,-2
29,16,87,7,19,-12
29,16,88,10,16,-6
29,16,89,6,25,-19
29,16,90,11,15,-4
29,16,91,9,21,-12
29,16,92,14,18,-4
29,16,93,10,11,-1
29,16,94,17,15,2
29,16,95,13,11,2
29,16,96,7,19,-12
29,16,97,8,13,-5
29,16,98,12,18,-6
29,16,99,11,15,-4
29,16,100,8,11,-3
29,16,101,8,33,-25
29,16,102,9,9,0
29,16,103,11,25,-14
29,16,104,10,12,-2
29,16,105,12,13,-1
29,16,106,10,12,-2
29,16,107,8,18,-10
29,16,108,20,26,-6
29,16,109,7,4,3
29,16,110,8,13,-5
29,16,111,5,11,-6
29,16,112,7,11,-4
29,16,113,16,29,-13
29,16,114,15,17,-2
29,16,115,5,11,-6
29,16,116,17,25,-8
29,16,117,4,32,-28
29,16,118,13,28,-15
29,16,119,9,16,-7
29,16,120,1,11,-10
29,16,121,7,16,-9
29,16,122,10,14,-4
29,16,123,4,32,-28
29,16,124,16,14,2
29,16,125,12,19,-7
29,16,126,6,16,-10
29,16,127,10,25,-15
29,16,128,6,8,-2
29,16,129,18,22,-4
29,16,130,7,22,-15
29,16,131,17,24,-7
29,16,132,10,18,-8
29,16,133,3,17,-14
29,16,134,10,17,-7
29,16,135,5,8,-3
29,16,136,12,12,0
29,16,137,11,18,-7
29,16,138,20,25,-5
29,16,139,8,6,2
29,16,140,9,24,-15
29,16,141,14,29,-15
29,16,142,5,10,-5
29,16,143,14,23,-9
29,16,144,8,18,-10
29,16,145,5,12,-7
29,16,146,11,11,0
29,16,147,20,27,-7
29,16,148,5,22,-17
29,16,149,6,19,-13
29,16,150,1,21,-20
29,16,151,14,27,-13
29,16,152,9,16,-7
29,16,153,5,11,-6
29,16,154,13,28,-15
29,16,155,4,16,-12
29,16,156,8,21,-13
29,16,157,6,21,-15
29,16,158,10,18,-8
29,16,159,12,26,-14
29,16,160,6,16,-10
29,16,161,14,18,-4
29,16,162,16,28,-12
29,16,163,13,20,-7
29,16,164,7,18,-11
29,16,165,12,28,-16
29,16,166,16,16,0
29,16,167,24,14,10
29,16,168,19,24,-5
29,16,169,8,15,-7
29,16,170,18,16,2
29,16,171,12,14,-2
29,16,172,17,20,-3
29,16,173,14,12,2
29,16,174,11,26,-15
29,16,175,11,13,-2
29,16,176,10,12,-2
29,16,177,9,31,-22
29,16,178,16,20,-4
29,16,179,3,23,-20
29,16,180,15,16,-1
29,16,181,10,9,1
29,16,182,12,18,-6
29,16,183,15,20,-5
29,16,184,15,24,-9
29,16,185,7,15,-8
29,16,186,9,17,-8
29,16,187,13,16,-3
29,16,188,11,8,3
29,16,189,14,20,-6
29,16,190,10,19,-9
29,16,191,10,31,-21
29,16,192,12,13,-1
29,16,193,11,17,-6
29,16,194,12,16,-4
29,16,195,10,14,-4
29,16,196,25,23,2
29,16,197,7,9,-2
29,16,198,3,12,-9
29,16,199,22,11,11
29,16,200,11,13,-2
29,16,201,11,33,-22
29,16,202,20,27,-7
29,16,203,6,15,-9
29,16,204,5,29,-24
29,16,205,19,12,7
29,16,206,16,16,0
29,16,207,12,15,-3
29,16,208,6,18,-12
29,16,209,19,30,-11
29,16,210,13,20,-7
29,16,211,11,15,-4
29,16,212,13,13,0
29,16,213,11,26,-15
29,16,214,13,22,-9
29,16,215,26,17,9
29,16,216,7,22,-15
29,16,217,16,34,-18
29,16,218,19,23,-4
29,16,219,13,15,-2
29,16,220,23,12,11
29,16,221,19,26,-7
29,16,222,15,20,-5
29,16,223,10,28,-18
29,16,224,6,28,-22
29,16,225,12,12,0
29,16,226,5,17,-12
29,16,227,9,19,-10
29,16,228,17,26,-9
29,16,229,10,17,-7
29,16,230,6,20,-14
29,16,231,6,17,-11
29,16,232,4,14,-10
29,16,233,4,29,-25
29,16,234,16,20,-4
29,16,235,9,18,-9
29,16,236,13,20,-7
29,16,237,15,19,-4
29,16,238,2,25,-23
29,16,239,5,21,-16
29,16,240,7,15,-8
29,16,241,12,8,4
29,16,242,7,11,-4
29,16,243,15,16,-1
29,16,244,3,8,-5
29,16,245,18,14,4
29,16,246,13,32,-19
29,16,247,10,16,-6
29,16,248,9,18,-9
29,16,249,10,21,-11
29,16,250,11,18,-7
29,16,251,12,16,-4
29,16,252,7,12,-5
29,16,253,10,12,-2
29,16,254,7,13,-6
29,16,255,7,15,-8
29,16,256,11,16,-5
29,16,257,9,17,-8
29,16,258,8,17,-9
29,16,259,8,24,-16
29,16,260,24,29,-5
29,16,261,11,23,-12
29,16,262,9,16,-7
29,16,263,10,10,0
29,16,264,9,11,-2
29,16,265,11,22,-11
29,16,266,3,17,-14
29,16,267,9,16,-7
29,16,268,10,14,-4
29,16,269,14,27,-13
29,16,270,8,18,-10
29,16,271,9,12,-3
29,16,272,1,8,-7
29,16,273,6,13,-7
29,16,274,12,19,-7
29,16,275,4,26,-22
29,16,276,6,2,4
29,16,277,18,28,-10
29,16,278,8,28,-20
29,16,279,13,22,-9
29,16,280,6,15,-9
29,16,281,11,12,-1
29,16,282,11,12,-1
29,16,283,17,26,-9
29,16,284,7,22,-15
29,16,285,5,13,-8
29,16,286,25,16,9
29,16,287,11,16,-5
29,16,288,12,23,-11
29,16,289,14,20,-6
29,16,290,7,16,-9
29,16,291,20,8,12
29,16,292,11,18,-7
29,16,293,10,14,-4
29,16,294,11,13,-2
29,16,295,6,18,-12
29,16,296,11,3,8
29,16,297,14,25,-11
29,16,298,8,16,-8
29,16,299,17,17,0
29,17,0,15,26,-11
29,17,1,15,25,-10
29,17,2,11,19,-8
29,17,3,7,13,-6
29,17,4,2,14,-12
29,17,5,7,16,-9
29,17,6,13,15,-2
29,17,7,11,17,-6
29,17,8,9,6,3
29,17,9,13,17,-4
29,17,10,14,12,2
29,17,11,11,22,-11
29,17,12,10,13,-3
29,17,13,7,6,1
29,17,14,26,9,17
29,17,15,14,13,1
29,17,16,10,20,-10
29,17,17,6,15,-9
29,17,18,12,22,-10
29,17,19,19,23,-4
29,17,20,18,21,-3
29,17,21,3,13,-10
29,17,22,12,16,-4
29,17,23,17,30,-13
29,17,24,7,13,-6
29,17,25,6,15,-9
29,17,26,6,22,-16
29,17,27,13,19,-6
29,17,28,8,9,-1
29,17,29,10,15,-5
29,17,30,5,21,-16
29,17,31,17,23,-6
29,17,32,15,19,-4
29,17,33,14,20,-6
29,17,34,14,20,-6
29,17,35,7,19,-12
29,17,36,16,20,-4
29,17,37,16,17,-1
29,17,38,14,29,-15
29,17,39,4,9,-5
29,17,40,9,13,-4
29,17,41,13,16,-3
29,17,42,10,22,-12
29,17,43,13,13,0
29,17,44,10,10,0
29,17,45,8,22,-14
29,17,46,6,16,-10
29,17,47,7,12,-5
29,17,48,10,16,-6
29,17,49,16,24,-8
29,17,50,18,14,4
29,17,51,11,15,-4
29,17,52,16,37,-21
29,17,53,6,15,-9
29,17,54,6,3,3
29,17,55,6,9,-3
29,17,56,5,9,-4
29,17,57,22,23,-1
29,17,58,12,18,-6
29,17,59,13,6,7
29,17,60,5,15,-10
29,17,61,19,36,-17
29,17,62,7,10,-3
29,17,63,8,14,-6
29,17,64,12,11,1
29,17,65,8,16,-8
29,17,66,20,13,7
29,17,67,7,18,-11
29,17,68,10,10,0
29,17,69,15,15,0
29,17,70,23,14,9
29,17,71,11,10,1
29,17,72,8,12,-4
29,17,73,15,20,-5
29,17,74,15,15,0
29,17,75,14,9,5
29,17,76,6,17,-11
29,17,77,10,17,-7
29,17,78,5,7,-2
29,17,79,10,18,-8
29,17,80,7,24,-17
29,17,81,10,13,-3
29,17,82,0,7,-7
29,17,83,12,8,4
29,17,84,16,23,-7
29,17,85,15,22,-7
29,17,86,4,21,-17
29,17,87,4,37,-33
29,17,88,12,25,-13
29,17,89,3,11,-8
29,17,90,3,19,-16
29,17,91,11,29,-18
29,17,92,11,26,-15
29,17,93,14,10,4
29,17,94,5,12,-7
29,17,95,9,14,-5
29,17,96,7,8,-1
29,17,97,0,11,-11
29,17,98,12,18,-6
29,17,99,7,20,-13
29,17,100,17,6,11
29,17,101,9,24,-15
29,17,102,21,23,-2
29,17,103,11,13,-2
29,17,104,4,9,-5
29,17,105,11,26,-15
29,17,106,9,0,9
29,17,107,3,6,-3
29,17,108,14,13,1
29,17,109,12,13,-1
29,17,110,8,28,-20
29,17,111,7,9,-2
29,17,112,7,20,-13
29,17,113,9,7,2
29,17,114,10,12,-2
29,17,115,14,18,-4
29,17,116,9,28,-19
29,17,117,16,22,-6
29,17,118,12,22,-10
29,17,119,12,16,-4
29,17,120,6,5,1
29,17,121,9,11,-2
29,17,122,17,17,0
29,17,123,4,21,-17
29,17,124,16,5,11
29,17,125,10,26,-16
29,17,126,11,14,-3
29,17,127,17,19,-2
29,17,128,14,17,-3
29,17,129,5,19,-14
29,17,130,14,14,0
29,17,131,13,7,6
29,17,132,16,22,-6
29,17,133,16,14,2
29,17,134,9,16,-7
29,17,135,7,13,-6
29,17,136,13,21,-8
29,17,137,4,10,-6
29,17,138,17,32,-15
29,17,139,10,14,-4
29,17,140,10,15,-5
29,17,141,5,6,-1
29,17,142,19,13,6
29,17,143,8,10,-2
29,17,144,8,11,-3
29,17,145,8,11,-3
29,17,146,17,23,-6
29,17,147,8,18,-10
29,17,148,16,30,-14
29,17,149,12,8,4
29,17,150,8,31,-23
29,17,151,13,17,-4
29,17,152,7,18,-11
29,17,153,13,22,-9
29,17,154,4,26,-22
29,17,155,13,25,-12
29,17,156,13,23,-10
29,17,157,13,14,-1
29,17,158,3,8,-5
29,17,159,3,18,-15
29,17,160,10,11,-1
29,17,161,11,23,-12
29,17,162,8,21,-13
29,17,163,15,26,-11
29,17,164,1,7,-6
29,17,165,10,16,-6
29,17,166,14,19,-5
29,17,167,1,8,-7
29,17,168,4,13,-9
29,17,169,11,20,-9
29,17,170,8,15,-7
29,17,171,14,22,-8
29,17,172,16,22,-6
29,17,173,2,18,-16
29,17,174,8,10,-2
29,17,175,6,30,-24
29,17,176,29,18,11
29,17,177,7,13,-6
29,17,178,17,27,-10
29,17,179,15,30,-15
29,17,180,8,21,-13
29,17,181,13,32,-19
29,17,182,15,26,-11
29,17,183,6,40,-34
29,17,184,20,23,-3
29,17,185,8,11,-3
29,17,186,10,19,-9
29,17,187,10,15,-5
29,17,188,14,14,0
29,17,189,14,20,-6
29,17,190,2,15,-13
29,17,191,9,17,-8
29,17,192,17,18,-1
29,17,193,27,24,3
29,17,194,16,16,0
29,17,195,19,15,4
29,17,196,17,23,-6
29,17,197,13,22,-9
29,17,198,8,18,-10
29,17,199,11,19,-8
29,17,200,24,14,10
29,17,201,13,21,-8
29,17,202,13,17,-4
29,17,203,7,7,0
29,17,204,12,15,-3
29,17,205,15,3,12
29,17,206,10,19,-9
29,17,207,17,17,0
29,17,208,12,24,-12
29,17,209,17,19,-2
29,17,210,22,27,-5
29,17,211,2,12,-10
29,17,212,24,21,3
29,17,213,7,8,-1
29,17,214,4,14,-10
29,17,215,15,17,-2
29,17,216,8,29,-21
29,17,217,13,13,0
29,17,218,2,9,-7
29,17,219,6,6,0
29,17,220,7,14,-7
29,17,221,30,22,8
29,17,222,8,16,-8
29,17,223,7,24,-17
29,17,224,12,6,6
29,17,225,4,17,-13
29,17,226,14,16,-2
29,17,227,14,18,-4
29,17,228,13,19,-6
29,17,229,7,24,-17
29,17,230,10,12,-2
29,17,231,9,16,-7
29,17,232,11,13,-2
29,17,233,4,2,2
29,17,234,11,22,-11
29,17,235,9,11,-2
29,17,236,19,17,2
29,17,237,14,25,-11
29,17,238,7,15,-8
29,17,239,23,32,-9
29,17,240,13,17,-4
29,17,241,12,26,-14
29,17,242,8,18,-10
29,17,243,4,11,-7
29,17,244,12,19,-7
29,17,245,11,16,-5
29,17,246,10,15,-5
29,17,247,6,6,0
29,17,248,7,24,-17
29,17,249,11,10,1
29,17,250,7,23,-16
29,17,251,7,11,-4
29,17,252,14,11,3
29,17,253,11,10,1
29,17,254,16,31,-15
29,17,255,8,15,-7
29,17,256,13,24,-11
29,17,257,13,14,-1
29,17,258,5,13,-8
29,17,259,9,14,-5
29,17,260,12,14,-2
29,17,261,9,18,-9
29,17,262,18,15,3
29,17,263,5,12,-7
29,17,264,19,20,-1
29,17,265,14,18,-4
29,17,266,16,15,1
29,17,267,4,11,-7
29,17,268,8,19,-11
29,17,269,19,15,4
29,17,270,9,10,-1
29,17,271,15,19,-4
29,17,272,9,14,-5
29,17,273,19,15,4
29,17,274,13,15,-2
29,17,275,7,7,0
29,17,276,8,36,-28
29,17,277,11,15,-4
29,17,278,10,19,-9
29,17,279,13,12,1
29,17,280,5,15,-10
29,17,281,3,11,-8
29,17,282,8,14,-6
29,17,283,7,12,-5
29,17,284,8,14,-6
29,17,285,6,9,-3
29,17,286,15,18,-3
29,17,287,18,19,-1
29,17,288,1,9,-8
29,17,289,10,27,-17
29,17,290,7,28,-21
29,17,291,14,21,-7
29,17,292,5,8,-3
29,17,293,3,19,-16
29,17,294,17,14,3
29,17,295,17,19,-2
29,17,296,13,13,0
29,17,297,9,14,-5
29,17,298,6,16,-10
29,17,299,9,7,2
29,18,0,16,18,-2
29,18,1,14,19,-5
29,18,2,22,16,6
29,18,3,5,15,-10
29,18,4,15,15,0
29,18,5,10,21,-11
29,18,6,12,15,-3
29,18,7,15,22,-7
29,18,8,11,9,2
29,18,9,20,21,-1
29,18,10,12,9,3
29,18,11,5,8,-3
29,18,12,13,13,0
29,18,13,10,10,0
29,18,14,18,20,-2
29,18,15,9,11,-2
29,18,16,1,12,-11
29,18,17,6,16,-10
29,18,18,10,10,0
29,18,19,15,21,-6
29,18,20,12,30,-18
29,18,21,8,18,-10
29,18,22,14,9,5
29,18,23,12,16,-4
29,18,24,12,10,2
29,18,25,12,18,-6
29,18,26,10,20,-10
29,18,27,9,8,1
29,18,28,7,9,-2
29,18,29,7,6,1
29,18,30,14,16,-2
29,18,31,17,20,-3
29,18,32,6,11,-5
29,18,33,11,16,-5
29,18,34,9,11,-2
29,18,35,24,22,2
29,18,36,9,10,-1
29,18,37,12,15,-3
29,18,38,18,18,0
29,18,39,11,20,-9
29,18,40,15,22,-7
29,18,41,14,12,2
29,18,42,21,22,-1
29,18,43,10,15,-5
29,18,44,13,18,-5
29,18,45,11,22,-11
29,18,46,6,15,-9
29,18,47,5,19,-14
29,18,48,9,8,1
29,18,49,12,14,-2
29,18,50,14,13,1
29,18,51,12,13,-1
29,18,52,8,16,-8
29,18,53,11,24,-13
29,18,54,4,3,1
29,18,55,14,21,-7
29,18,56,19,18,1
29,18,57,9,15,-6
29,18,58,15,35,-20
29,18,59,14,15,-1
29,18,60,4,17,-13
29,18,61,8,9,-1
29,18,62,9,23,-14
29,18,63,5,12,-7
29,18,64,12,7,5
29,18,65,11,14,-3
29,18,66,6,19,-13
29,18,67,12,24,-12
29,18,68,6,15,-9
29,18,69,11,15,-4
29,18,70,14,28,-14
29,18,71,11,19,-8
29,18,72,12,23,-11
29,18,73,8,7,1
29,18,74,9,12,-3
29,18,75,13,28,-15
29,18,76,18,10,8
29,18,77,6,11,-5
29,18,78,13,22,-9
29,18,79,7,13,-6
29,18,80,7,7,0
29,18,81,7,15,-8
29,18,82,4,16,-12
29,18,83,12,17,-5
29,18,84,16,15,1
29,18,85,7,9,-2
29,18,86,10,17,-7
29,18,87,6,11,-5
29,18,88,6,13,-7
29,18,89,11,23,-12
29,18,90,13,9,4
29,18,91,12,10,2
29,18,92,11,19,-8
29,18,93,13,13,0
29,18,94,2,9,-7
29,18,95,16,13,3
29,18,96,9,9,0
29,18,97,9,21,-12
29,18,98,19,11,8
29,18,99,21,24,-3
29,18,100,17,24,-7
29,18,101,5,21,-16
29,18,102,6,0,6
29,18,103,3,10,-7
29,18,104,13,15,-2
29,18,105,14,29,-15
29,18,106,11,14,-3
29,18,107,13,25,-12
29,18,108,10,4,6
29,18,109,12,31,-19
29,18,110,11,22,-11
29,18,111,11,8,3
29,18,112,10,10,0
29,18,113,15,17,-2
29,18,114,24,19,5
29,18,115,10,29,-19
29,18,116,7,16,-9
29,18,117,6,15,-9
29,18,118,5,7,-2
29,18,119,16,18,-2
29,18,120,9,22,-13
29,18,121,26,11,15
29,18,122,7,13,-6
29,18,123,7,10,-3
29,18,124,26,20,6
29,18,125,7,27,-20
29,18,126,2,14,-12
29,18,127,16,21,-5
29,18,128,0,4,-4
29,18,129,6,9,-3
29,18,130,16,12,4
29,18,131,7,16,-9
29,18,132,13,15,-2
29,18,133,15,13,2
29,18,134,6,10,-4
29,18,135,8,15,-7
29,18,136,15,21,-6
29,18,137,6,12,-6
29,18,138,7,9,-2
29,18,139,14,19,-5
29,18,140,10,15,-5
29,18,141,9,7,2
29,18,142,9,21,-12
29,18,143,6,19,-13
29,18,144,9,21,-12
29,18,145,4,9,-5
29,18,146,9,12,-3
29,18,147,17,29,-12
29,18,148,9,17,-8
29,18,149,4,18,-14
29,18,150,12,8,4
29,18,151,6,9,-3
29,18,152,2,11,-9
29,18,153,6,14,-8
29,18,154,5,20,-15
29,18,155,15,8,7
29,18,156,13,25,-12
29,18,157,4,18,-14
29,18,158,4,6,-2
29,18,159,8,18,-10
29,18,160,5,13,-8
29,18,161,13,23,-10
29,18,162,10,12,-2
29,18,163,10,19,-9
29,18,164,11,15,-4
29,18,165,11,19,-8
29,18,166,11,23,-12
29,18,167,15,24,-9
29,18,168,8,21,-13
29,18,169,12,27,-15
29,18,170,12,13,-1
29,18,171,7,16,-9
29,18,172,13,32,-19
29,18,173,13,14,-1
29,18,174,5,13,-8
29,18,175,10,23,-13
29,18,176,14,5,9
29,18,177,8,15,-7
29,18,178,16,20,-4
29,18,179,11,17,-6
29,18,180,21,15,6
29,18,181,11,26,-15
29,18,182,8,12,-4
29,18,183,14,18,-4
29,18,184,18,17,1
29,18,185,7,8,-1
29,18,186,10,14,-4
29,18,187,12,8,4
29,18,188,14,19,-5
29,18,189,5,20,-15
29,18,190,9,12,-3
29,18,191,13,13,0
29,18,192,15,25,-10
29,18,193,12,26,-14
29,18,194,12,19,-7
29,18,195,9,17,-8
29,18,196,7,8,-1
29,18,197,15,18,-3
29,18,198,12,20,-8
29,18,199,7,15,-8
29,18,200,14,20,-6
29,18,201,7,23,-16
29,18,202,8,17,-9
29,18,203,2,17,-15
29,18,204,20,11,9
29,18,205,18,29,-11
29,18,206,14,20,-6
29,18,207,6,16,-10
29,18,208,6,22,-16
29,18,209,17,16,1
29,18,210,22,23,-1
29,18,211,17,15,2
29,18,212,12,14,-2
29,18,213,14,10,4
29,18,214,5,17,-12
29,18,215,5,11,-6
29,18,216,13,13,0
29,18,217,16,14,2
29,18,218,1,29,-28
29,18,219,7,6,1
29,18,220,12,19,-7
29,18,221,3,10,-7
29,18,222,12,12,0
29,18,223,13,13,0
29,18,224,16,14,2
29,18,225,11,10,1
29,18,226,7,10,-3
29,18,227,8,26,-18
29,18,228,11,19,-8
29,18,229,11,22,-11
29,18,230,15,25,-10
29,18,231,6,6,0
29,18,232,9,8,1
29,18,233,14,39,-25
29,18,234,6,11,-5
29,18,235,9,34,-25
29,18,236,9,11,-2
29,18,237,17,25,-8
29,18,238,14,16,-2
29,18,239,1,13,-12
29,18,240,6,20,-14
29,18,241,4,26,-22
29,18,242,22,6,16
29,18,243,6,26,-20
29,18,244,11,25,-14
29,18,245,5,13,-8
29,18,246,6,16,-10
29,18,247,14,14,0
29,18,248,12,24,-12
29,18,249,9,11,-2
29,18,250,10,8,2
29,18,251,12,7,5
29,18,252,8,12,-4
29,18,253,12,27,-15
29,18,254,15,21,-6
29,18,255,0,16,-16
29,18,256,13,10,3
29,18,257,12,25,-13
29,18,258,7,12,-5
29,18,259,18,11,7
29,18,260,13,9,4
29,18,261,20,28,-8
29,18,262,7,13,-6
29,18,263,9,19,-10
29,18,264,11,15,-4
29,18,265,6,7,-1
29,18,266,9,27,-18
29,18,267,11,15,-4
29,18,268,8,13,-5
29,18,269,7,27,-20
29,18,270,5,9,-4
29,18,271,4,14,-10
29,18,272,10,7,3
29,18,273,13,18,-5
29,18,274,7,32,-25
29,18,275,2,9,-7
29,18,276,5,13,-8
29,18,277,15,28,-13
29,18,278,7,16,-9
29,18,279,8,18,-10
29,18,280,15,27,-12
29,18,281,8,10,-2
29,18,282,10,27,-17
29,18,283,13,15,-2
29,18,284,12,19,-7
29,18,285,11,20,-9
29,18,286,17,23,-6
29,18,287,10,11,-1
29,18,288,5,23,-18
29,18,289,10,11,-1
29,18,290,5,19,-14
29,18,291,10,15,-5
29,18,292,11,15,-4
29,18,293,14,15,-1
29,18,294,2,12,-10
29,18,295,9,14,-5
29,18,296,5,19,-14
29,18,297,7,14,-7
29,18,298,9,23,-14
29,18,299,14,25,-11
29,19,0,7,21,-14
29,19,1,10,25,-15
29,19,2,11,16,-5
29,19,3,15,12,3
29,19,4,18,30,-12
29,19,5,10,17,-7
29,19,6,18,20,-2
29,19,7,12,17,-5
29,19,8,10,13,-3
29,19,9,16,32,-16
29,19,10,7,13,-6
29,19,11,14,16,-2
29,19,12,11,10,1
29,19,13,6,21,-15
29,19,14,5,13,-8
29,19,15,13,14,-1
29,19,16,8,7,1
29,19,17,7,4,3
29,19,18,13,13,0
29,19,19,12,21,-9
29,19,20,23,19,4
29,19,21,10,6,4
29,19,22,14,27,-13
29,19,23,14,14,0
29,19,24,10,20,-10
29,19,25,8,19,-11
29,19,26,7,11,-4
29,19,27,3,11,-8
29,19,28,9,10,-1
29,19,29,21,19,2
29,19,30,6,12,-6
29,19,31,9,13,-4
29,19,32,13,11,2
29,19,33,9,17,-8
29,19,34,11,22,-11
29,19,35,14,12,2
29,19,36,10,20,-10
29,19,37,10,21,-11
29,19,38,14,26,-12
29,19,39,27,23,4
29,19,40,7,16,-9
29,19,41,9,25,-16
29,19,42,10,13,-3
29,19,43,9,12,-3
29,19,44,16,18,-2
29,19,45,11,20,-9
29,19,46,15,38,-23
29,19,47,8,11,-3
29,19,48,21,23,-2
29,19,49,12,17,-5
29,19,50,12,36,-24
29,19,51,13,18,-5
29,19,52,7,3,4
29,19,53,14,18,-4
29,19,54,19,18,1
29,19,55,12,10,2
29,19,56,6,17,-11
29,19,57,11,9,2
29,19,58,12,8,4
29,19,59,11,21,-10
29,19,60,12,21,-9
29,19,61,9,13,-4
29,19,62,13,17,-4
29,19,63,15,23,-8
29,19,64,15,17,-2
29,19,65,15,11,4
29,19,66,7,10,-3
29,19,67,7,9,-2
29,19,68,9,9,0
29,19,69,12,23,-11
29,19,70,19,21,-2
29,19,71,9,6,3
29,19,72,9,23,-14
29,19,73,13,17,-4
29,19,74,11,14,-3
29,19,75,12,12,0
29,19,76,10,16,-6
29,19,77,8,17,-9
29,19,78,11,16,-5
29,19,79,15,25,-10
29,19,80,16,22,-6
29,19,81,9,11,-2
29,19,82,4,7,-3
29,19,83,11,14,-3
29,19,84,9,8,1
29,19,85,13,15,-2
29,19,86,4,7,-3
29,19,87,25,16,9
29,19,88,18,27,-9
29,19,89,16,17,-1
29,19,90,10,12,-2
29,19,91,9,16,-7
29,19,92,17,23,-6
29,19,93,19,13,6
29,19,94,13,20,-7
29,19,95,11,19,-8
29,19,96,9,7,2
29,19,97,14,17,-3
29,19,98,9,26,-17
29,19,99,11,32,-21
29,19,100,13,31,-18
29,19,101,18,18,0
29,19,102,8,7,1
29,19,103,2,19,-17
29,19,104,12,20,-8
29,19,105,9,11,-2
29,19,106,11,10,1
29,19,107,2,14,-12
29,19,108,15,13,2
29,19,109,18,10,8
29,19,110,21,11,10
29,19,111,12,25,-13
29,19,112,13,16,-3
29,19,113,8,15,-7
29,19,114,16,21,-5
29,19,115,16,16,0
29,19,116,11,19,-8
29,19,117,6,15,-9
29,19,118,7,16,-9
29,19,119,11,15,-4
29,19,120,5,21,-16
29,19,121,13,10,3
29,19,122,22,26,-4
29,19,123,8,28,-20
29,19,124,5,9,-4
29,19,125,6,9,-3
29,19,126,4,12,-8
29,19,127,9,13,-4
29,19,128,13,22,-9
29,19,129,12,6,6
29,19,130,8,10,-2
29,19,131,10,28,-18
29,19,132,5,17,-12
29,19,133,13,24,-11
29,19,134,14,13,1
29,19,135,9,9,0
29,19,136,17,28,-11
29,19,137,24,21,3
29,19,138,11,21,-10
29,19,139,4,9,-5
29,19,140,10,11,-1
29,19,141,15,34,-19
29,19,142,8,17,-9
29,19,143,6,9,-3
29,19,144,9,26,-17
29,19,145,7,14,-7
29,19,146,4,15,-11
29,19,147,10,33,-23
29,19,148,10,9,1
29,19,149,4,15,-11
29,19,150,16,12,4
29,19,151,7,15,-8
29,19,152,14,25,-11
29,19,153,7,34,-27
29,19,154,21,17,4
29,19,155,10,27,-17
29,19,156,8,15,-7
29,19,157,15,14,1
29,19,158,20,34,-14
29,19,159,11,16,-5
29,19,160,6,8,-2
29,19,161,4,1,3
29,19,162,5,23,-18
29,19,163,5,9,-4
29,19,164,18,18,0
29,19,165,11,22,-11
29,19,166,13,21,-8
29,19,167,6,14,-8
29,19,168,15,19,-4
29,19,169,7,11,-4
29,19,170,9,5,4
29,19,171,15,20,-5
29,19,172,13,25,-12
29,19,173,16,16,0
29,19,174,19,17,2
29,19,175,17,25,-8
29,19,176,7,7,0
29,19,177,18,24,-6
29,19,178,14,18,-4
29,19,179,5,12,-7
29,19,180,17,12,5
29,19,181,8,17,-9
29,19,182,9,14,-5
29,19,183,5,20,-15
29,19,184,10,19,-9
29,19,185,8,12,-4
29,19,186,13,25,-12
29,19,187,12,15,-3
29,19,188,13,8,5
29,19,189,9,8,1
29,19,190,15,18,-3
29,19,191,18,25,-7
29,19,192,10,12,-2
29,19,193,7,13,-6
29,19,194,14,18,-4
29,19,195,8,8,0
29,19,196,7,13,-6
29,19,197,8,13,-5
29,19,198,9,28,-19
29,19,199,12,16,-4
29,19,200,11,14,-3
29,19,201,7,26,-19
29,19,202,7,29,-22
29,19,203,9,22,-13
29,19,204,4,16,-12
29,19,205,18,9,9
29,19,206,16,9,7
29,19,207,6,20,-14
29,19,208,10,22,-12
29,19,209,9,11,-2
29,19,210,10,15,-5
29,19,211,13,9,4
29,19,212,8,16,-8
29,19,213,8,18,-10
29,19,214,14,11,3
29,19,215,8,20,-12
29,19,216,12,15,-3
29,19,217,3,6,-3
29,19,218,14,19,-5
29,19,219,17,20,-3
29,19,220,14,17,-3
29,19,221,15,25,-10
29,19,222,11,17,-6
29,19,223,12,4,8
29,19,224,8,14,-6
29,19,225,7,16,-9
29,19,226,16,7,9
29,19,227,9,17,-8
29,19,228,10,5,5
29,19,229,11,8,3
29,19,230,19,23,-4
29,19,231,7,23,-16
29,19,232,14,7,7
29,19,233,10,16,-6
29,19,234,7,12,-5
29,19,235,14,12,2
29,19,236,18,13,5
29,19,237,6,16,-10
29,19,238,23,15,8
29,19,239,11,16,-5
29,19,240,17,20,-3
29,19,241,13,26,-13
29,19,242,7,14,-7
29,19,243,15,17,-2
29,19,244,10,21,-11
29,19,245,7,13,-6
29,19,246,14,19,-5
29,19,247,21,30,-9
29,19,248,17,19,-2
29,19,249,10,23,-13
29,19,250,5,23,-18
29,19,251,8,13,-5
29,19,252,13,23,-10
29,19,253,11,10,1
29,19,254,9,10,-1
29,19,255,7,25,-18
29,19,256,15,20,-5
29,19,257,7,22,-15
29,19,258,14,12,2
29,19,259,9,26,-17
29,19,260,10,14,-4
29,19,261,13,15,-2
29,19,262,7,14,-7
29,19,263,19,24,-5
29,19,264,7,10,-3
29,19,265,14,21,-7
29,19,266,7,5,2
29,19,267,9,14,-5
29,19,268,5,17,-12
29,19,269,9,12,-3
29,19,270,8,17,-9
29,19,271,14,18,-4
29,19,272,8,19,-11
29,19,273,14,26,-12
29,19,274,15,9,6
29,19,275,15,20,-5
29,19,276,6,19,-13
29,19,277,3,3,0
29,19,278,20,18,2
29,19,279,9,12,-3
29,19,280,10,13,-3
29,19,281,11,21,-10
29,19,282,13,17,-4
29,19,283,14,17,-3
29,19,284,16,17,-1
29,19,285,7,9,-2
29,19,286,16,13,3
29,19,287,9,12,-3
29,19,288,11,10,1
29,19,289,11,13,-2
29,19,290,7,15,-8
29,19,291,11,10,1
29,19,292,10,26,-16
29,19,293,8,21,-13
29,19,294,7,22,-15
29,19,295,6,11,-5
29,19,296,6,1,5
29,19,297,20,26,-6
29,19,298,13,8,5
29,19,299,15,12,3
29,20,0,14,21,-7
29,20,1,12,12,0
29,20,2,13,19,-6
29,20,3,10,14,-4
29,20,4,15,24,-9
29,20,5,16,16,0
29,20,6,17,19,-2
29,20,7,13,8,5
29,20,8,8,10,-2
29,20,9,9,9,0
29,20,10,16,13,3
29,20,11,10,11,-1
29,20,12,15,28,-13
29,20,13,12,7,5
29,20,14,11,12,-1
29,20,15,22,29,-7
29,20,16,3,12,-9
29,20,17,12,12,0
29,20,18,12,29,-17
29,20,19,6,25,-19
29,20,20,11,16,-5
29,20,21,19,25,-6
29,20,22,9,22,-13
29,20,23,10,25,-15
29,20,24,12,5,7
29,20,25,7,18,-11
29,20,26,22,20,2
29,20,27,5,16,-11
29,20,28,10,7,3
29,20,29,3,15,-12
29,20,30,8,10,-2
29,20,31,15,29,-14
29,20,32,17,19,-2
29,20,33,6,27,-21
29,20,34,13,26,-13
29,20,35,16,22,-6
29,20,36,5,11,-6
29,20,37,10,20,-10
29,20,38,9,14,-5
29,20,39,19,15,4
29,20,40,9,17,-8
29,20,41,7,14,-7
29,20,42,5,16,-11
29,20,43,17,21,-4
29,20,44,9,18,-9
29,20,45,3,5,-2
29,20,46,8,18,-10
29,20,47,9,19,-10
29,20,48,11,18,-7
29,20,49,12,11,1
29,20,50,7,17,-10
29,20,51,6,20,-14
29,20,52,6,7,-1
29,20,53,16,13,3
29,20,54,12,25,-13
29,20,55,9,18,-9
29,20,56,15,21,-6
29,20,57,18,24,-6
29,20,58,14,9,5
29,20,59,9,13,-4
29,20,60,11,18,-7
29,20,61,12,20,-8
29,20,62,6,5,1
29,20,63,9,7,2
29,20,64,12,11,1
29,20,65,22,14,8
29,20,66,9,18,-9
29,20,67,11,18,-7
29,20,68,9,22,-13
29,20,69,12,17,-5
29,20,70,17,19,-2
29,20,71,19,18,1
29,20,72,10,12,-2
29,20,73,12,12,0
29,20,74,17,16,1
29,20,75,9,16,-7
29,20,76,10,15,-5
29,20,77,13,11,2
29,20,78,3,23,-20
29,20,79,14,12,2
29,20,80,10,11,-1
29,20,81,24,18,6
29,20,82,9,16,-7
29,20,83,17,14,3
29,20,84,12,11,1
29,20,85,9,12,-3
29,20,86,10,22,-12
29,20,87,8,8,0
29,20,88,8,16,-8
29,20,89,14,18,-4
29,20,90,5,20,-15
29,20,91,10,14,-4
29,20,92,18,20,-2
29,20,93,16,11,5
29,20,94,4,17,-13
29,20,95,18,22,-4
29,20,96,13,12,1
29,20,97,18,13,5
29,20,98,13,20,-7
29,20,99,13,25,-12
29,20,100,9,20,-11
29,20,101,7,20,-13
29,20,102,10,11,-1
29,20,103,11,11,0
29,20,104,10,7,3
29,20,105,13,22,-9
29,20,106,7,30,-23
29,20,107,10,29,-19
29,20,108,24,18,6
29,20,109,11,13,-2
29,20,110,12,10,2
29,20,111,8,23,-15
29,20,112,13,20,-7
29,20,113,9,15,-6
29,20,114,7,7,0
29,20,115,11,16,-5
29,20,116,6,10,-4
29,20,117,9,14,-5
29,20,118,21,26,-5
29,20,119,13,9,4
29,20,120,14,9,5
29,20,121,6,23,-17
29,20,122,15,9,6
29,20,123,4,3,1
29,20,124,3,12,-9
29,20,125,14,28,-14
29,20,126,11,15,-4
29,20,127,16,30,-14
29,20,128,17,15,2
29,20,129,10,17,-7
29,20,130,18,12,6
29,20,131,3,20,-17
29,20,132,11,8,3
29,20,133,8,9,-1
29,20,134,10,22,-12
29,20,135,6,17,-11
29,20,136,6,20,-14
29,20,137,11,29,-18
29,20,138,6,13,-7
29,20,139,9,7,2
29,20,140,3,16,-13
29,20,141,13,18,-5
29,20,142,3,18,-15
29,20,143,10,8,2
29,20,144,11,25,-14
29,20,145,10,7,3
29,20,146,17,27,-10
29,20,147,8,34,-26
29,20,148,12,20,-8
29,20,149,17,20,-3
29,20,150,10,15,-5
29,20,151,18,24,-6
29,20,152,15,14,1
29,20,153,12,29,-17
29,20,154,12,8,4
29,20,155,15,20,-5
29,20,156,8,15,-7
29,20,157,13,12,1
29,20,158,17,23,-6
29,20,159,9,15,-6
29,20,160,6,1,5
29,20,161,14,18,-4
29,20,162,15,18,-3
29,20,163,6,13,-7
29,20,164,0,6,-6
29,20,165,15,20,-5
29,20,166,9,17,-8
29,20,167,14,10,4
29,20,168,8,22,-14
29,20,169,11,11,0
29,20,170,6,3,3
29,20,171,10,19,-9
29,20,172,9,15,-6
29,20,173,8,14,-6
29,20,174,3,11,-8
29,20,175,11,15,-4
29,20,176,13,30,-17
29,20,177,11,13,-2
29,20,178,18,21,-3
29,20,179,15,15,0
29,20,180,11,8,3
29,20,181,11,17,-6
29,20,182,14,9,5
29,20,183,14,15,-1
29,20,184,11,5,6
29,20,185,25,20,5
29,20,186,10,23,-13
29,20,187,14,21,-7
29,20,188,7,16,-9
29,20,189,12,6,6
29,20,190,8,9,-1
29,20,191,4,16,-12
29,20,192,16,16,0
29,20,193,6,15,-9
29,20,194,8,9,-1
29,20,195,6,17,-11
29,20,196,9,13,-4
29,20,197,16,19,-3
29,20,198,19,25,-6
29,20,199,14,19,-5
29,20,200,6,28,-22
29,20,201,6,7,-1
29,20,202,9,12,-3
29,20,203,14,23,-9
29,20,204,14,29,-15
29,20,205,4,20,-16
29,20,206,7,15,-8
29,20,207,16,11,5
29,20,208,5,13,-8
29,20,209,16,9,7
29,20,210,9,12,-3
29,20,211,12,29,-17
29,20,212,9,13,-4
29,20,213,10,12,-2
29,20,214,10,24,-14
29,20,215,3,13,-10
29,20,216,8,14,-6
29,20,217,14,9,5
29,20,218,9,24,-15
29,20,219,26,23,3
29,20,220,21,11,10
29,20,221,5,14,-9
29,20,222,10,22,-12
29,20,223,1,13,-12
29,20,224,5,16,-11
29,20,225,8,9,-1
29,20,226,9,12,-3
29,20,227,12,18,-6
29,20,228,18,17,1
29,20,229,16,25,-9
29,20,230,14,11,3
29,20,231,18,22,-4
29,20,232,14,35,-21
29,20,233,18,19,-1
29,20,234,17,14,3
29,20,235,3,18,-15
29,20,236,14,7,7
29,20,237,11,16,-5
29,20,238,10,21,-11
29,20,239,17,12,5
29,20,240,4,5,-1
29,20,241,9,11,-2
29,20,242,10,9,1
29,20,243,12,15,-3
29,20,244,14,17,-3
29,20,245,16,18,-2
29,20,246,8,19,-11
29,20,247,13,29,-16
29,20,248,13,20,-7
29,20,249,2,16,-14
29,20,250,3,7,-4
29,20,251,12,9,3
29,20,252,5,7,-2
29,20,253,7,14,-7
29,20,254,7,10,-3
29,20,255,4,7,-3
29,20,256,9,34,-25
29,20,257,9,11,-2
29,20,258,22,27,-5
29,20,259,5,7,-2
29,20,260,6,11,-5
29,20,261,20,25,-5
29,20,262,10,12,-2
29,20,263,26,25,1
29,20,264,13,14,-1
29,20,265,17,22,-5
29,20,266,6,17,-11
29,20,267,9,4,5
29,20,268,5,13,-8
29,20,269,10,11,-1
29,20,270,14,17,-3
29,20,271,11,10,1
29,20,272,10,18,-8
29,20,273,4,16,-12
29,20,274,13,6,7
29,20,275,3,14,-11
29,20,276,16,21,-5
29,20,277,13,17,-4
29,20,278,4,16,-12
29,20,279,27,23,4
29,20,280,7,17,-10
29,20,281,10,33,-23
29,20,282,14,24,-10
29,20,283,16,16,0
29,20,284,3,17,-14
29,20,285,18,22,-4
29,20,286,16,22,-6
29,20,287,10,16,-6
29,20,288,14,12,2
29,20,289,13,23,-10
29,20,290,8,13,-5
29,20,291,12,9,3
29,20,292,9,18,-9
29,20,293,7,7,0
29,20,294,16,12,4
29,20,295,11,15,-4
29,20,296,19,16,3
29,20,297,16,24,-8
29,20,298,23,25,-2
29,20,299,9,21,-12
29,21,0,8,10,-2
29,21,1,14,17,-3
29,21,2,7,27,-20
29,21,3,19,11,8
29,21,4,8,13,-5
29,21,5,19,29,-10
29,21,6,4,14,-10
29,21,7,16,28,-12
29,21,8,7,12,-5
29,21,9,11,12,-1
29,21,10,10,21,-11
29,21,11,8,17,-9
29,21,12,15,18,-3
29,21,13,10,22,-12
29,21,14,9,14,-5
29,21,15,11,8,3
29,21,16,11,9,2
29,21,17,7,22,-15
29,21,18,13,19,-6
29,21,19,13,14,-1
29,21,20,8,8,0
29,21,21,10,10,0
29,21,22,11,30,-19
29,21,23,13,25,-12
29,21,24,14,24,-10
29,21,25,14,33,-19
29,21,26,13,11,2
29,21,27,9,15,-6
29,21,28,16,18,-2
29,21,29,6,19,-13
29,21,30,5,13,-8
29,21,31,18,27,-9
29,21,32,12,14,-2
29,21,33,13,22,-9
29,21,34,11,13,-2
29,21,35,21,7,14
29,21,36,24,25,-1
29,21,37,15,17,-2
29,21,38,18,15,3
29,21,39,7,21,-14
29,21,40,9,12,-3
29,21,41,11,24,-13
29,21,42,10,9,1
29,21,43,21,14,7
29,21,44,2,3,-1
29,21,45,18,14,4
29,21,46,18,20,-2
29,21,47,10,19,-9
29,21,48,10,20,-10
29,21,49,12,19,-7
29,21,50,16,7,9
29,21,51,8,12,-4
29,21,52,14,16,-2
29,21,53,6,5,1
29,21,54,11,26,-15
29,21,55,10,23,-13
29,21,56,10,11,-1
29,21,57,11,11,0
29,21,58,13,25,-12
29,21,59,9,14,-5
29,21,60,19,21,-2
29,21,61,8,14,-6
29,21,62,10,26,-16
29,21,63,4,15,-11
29,21,64,7,18,-11
29,21,65,13,25,-12
29,21,66,6,14,-8
29,21,67,21,15,6
29,21,68,6,19,-13
29,21,69,7,21,-14
29,21,70,14,22,-8
29,21,71,2,19,-17
29,21,72,4,18,-14
29,21,73,10,16,-6
29,21,74,6,11,-5
29,21,75,9,11,-2
29,21,76,13,12,1
29,21,77,11,23,-12
29,21,78,12,21,-9
29,21,79,16,19,-3
29,21,80,8,14,-6
29,21,81,10,16,-6
29,21,82,18,8,10
29,21,83,10,13,-3
29,21,84,5,9,-4
29,21,85,17,17,0
29,21,86,10,15,-5
29,21,87,5,13,-8
29,21,88,13,9,4
29,21,89,11,23,-12
29,21,90,18,23,-5
29,21,91,12,21,-9
29,21,92,7,23,-16
29,21,93,7,22,-15
29,21,94,9,16,-7
29,21,95,1,17,-16
29,21,96,17,20,-3
29,21,97,10,14,-4
29,21,98,9,9,0
29,21,99,15,23,-8
29,21,100,11,24,-13
29,21,101,12,14,-2
29,21,102,1,10,-9
29,21,103,10,6,4
29,21,104,20,25,-5
29,21,105,11,25,-14
29,21,106,5,10,-5
29,21,107,7,8,-1
29,21,108,11,20,-9
29,21,109,10,20,-10
29,21,110,2,12,-10
29,21,111,13,21,-8
29,21,112,9,36,-27
29,21,113,19,19,0
29,21,114,13,6,7
29,21,115,8,14,-6
29,21,116,9,10,-1
29,21,117,7,21,-14
29,21,118,13,14,-1
29,21,119,8,20,-12
29,21,120,10,21,-11
29,21,121,11,7,4
29,21,122,2,5,-3
29,21,123,6,14,-8
29,21,124,12,20,-8
29,21,125,6,16,-10
29,21,126,7,10,-3
29,21,127,6,11,-5
29,21,128,10,21,-11
29,21,129,6,11,-5
29,21,130,4,7,-3
29,21,131,2,14,-12
29,21,132,4,14,-10
29,21,133,6,21,-15
29,21,134,11,22,-11
29,21,135,6,7,-1
29,21,136,17,17,0
29,21,137,11,30,-19
29,21,138,4,12,-8
29,21,139,3,13,-10
29,21,140,9,19,-10
29,21,141,15,17,-2
29,21,142,12,18,-6
29,21,143,7,13,-6
29,21,144,7,22,-15
29,21,145,21,18,3
29,21,146,9,15,-6
29,21,147,8,9,-1
29,21,148,11,9,2
29,21,149,9,12,-3
29,21,150,11,14,-3
29,21,151,7,10,-3
29,21,152,8,10,-2
29,21,153,5,24,-19
29,21,154,13,26,-13
29,21,155,8,11,-3
29,21,156,21,20,1
29,21,157,8,20,-12
29,21,158,8,6,2
29,21,159,4,13,-9
29,21,160,5,10,-5
29,21,161,12,15,-3
29,21,162,16,22,-6
29,21,163,6,12,-6
29,21,164,7,27,-20
29,21,165,5,15,-10
29,21,166,14,13,1
29,21,167,7,15,-8
29,21,168,15,30,-15
29,21,169,11,24,-13
29,21,170,13,17,-4
29,21,171,10,20,-10
29,21,172,10,7,3
29,21,173,16,18,-2
29,21,174,11,28,-17
29,21,175,19,11,8
29,21,176,14,30,-16
29,21,177,16,9,7
29,21,178,14,26,-12
29,21,179,19,36,-17
29,21,180,10,16,-6
29,21,181,7,20,-13
29,21,182,4,17,-13
29,21,183,16,14,2
29,21,184,6,14,-8
29,21,185,8,13,-5
29,21,186,6,25,-19
29,21,187,4,14,-10
29,21,188,5,16,-11
29,21,189,22,21,1
29,21,190,9,17,-8
29,21,191,14,9,5
29,21,192,5,25,-20
29,21,193,17,19,-2
29,21,194,8,20,-12
29,21,195,8,19,-11
29,21,196,13,22,-9
29,21,197,10,18,-8
29,21,198,2,10,-8
29,21,199,9,12,-3
29,21,200,6,10,-4
29,21,201,19,16,3
29,21,202,11,12,-1
29,21,203,12,23,-11
29,21,204,15,17,-2
29,21,205,19,13,6
29,21,206,9,18,-9
29,21,207,23,18,5
29,21,208,12,24,-12
29,21,209,15,15,0
29,21,210,11,26,-15
29,21,211,15,11,4
29,21,212,19,13,6
29,21,213,16,23,-7
29,21,214,19,20,-1
29,21,215,17,24,-7
29,21,216,0,3,-3
29,21,217,23,32,-9
29,21,218,13,8,5
29,21,219,6,17,-11
29,21,220,16,8,8
29,21,221,10,6,4
29,21,222,5,18,-13
29,21,223,7,15,-8
29,21,224,8,27,-19
29,21,225,27,16,11
29,21,226,11,27,-16
29,21,227,12,22,-10
29,21,228,10,17,-7
29,21,229,12,16,-4
29,21,230,14,18,-4
29,21,231,13,9,4
29,21,232,12,10,2
29,21,233,2,19,-17
29,21,234,24,22,2
29,21,235,11,17,-6
29,21,236,15,24,-9
29,21,237,7,16,-9
29,21,238,10,19,-9
29,21,239,5,5,0
29,21,240,7,22,-15
29,21,241,13,17,-4
29,21,242,16,22,-6
29,21,243,6,19,-13
29,21,244,15,15,0
29,21,245,10,18,-8
29,21,246,13,22,-9
29,21,247,7,19,-12
29,21,248,7,3,4
29,21,249,26,28,-2
29,21,250,24,27,-3
29,21,251,8,18,-10
29,21,252,9,13,-4
29,21,253,5,16,-11
29,21,254,11,13,-2
29,21,255,17,17,0
29,21,256,7,29,-22
29,21,257,22,18,4
29,21,258,12,20,-8
29,21,259,5,15,-10
29,21,260,29,19,10
29,21,261,15,13,2
29,21,262,12,20,-8
29,21,263,9,14,-5
29,21,264,10,11,-1
29,21,265,11,13,-2
29,21,266,12,17,-5
29,21,267,5,12,-7
29,21,268,14,20,-6
29,21,269,7,20,-13
29,21,270,18,10,8
29,21,271,7,30,-23
29,21,272,10,16,-6
29,21,273,9,23,-14
29,21,274,21,26,-5
29,21,275,4,17,-13
29,21,276,9,12,-3
29,21,277,15,22,-7
29,21,278,15,14,1
29,21,279,9,7,2
29,21,280,12,12,0
29,21,281,3,18,-15
29,21,282,6,22,-16
29,21,283,8,12,-4
29,21,284,20,26,-6
29,21,285,18,13,5
29,21,286,5,16,-11
29,21,287,21,13,8
29,21,288,21,21,0
29,21,289,4,17,-13
29,21,290,10,21,-11
29,21,291,3,7,-4
29,21,292,14,22,-8
29,21,293,16,15,1
29,21,294,10,14,-4
29,21,295,6,19,-13
29,21,296,14,16,-2
29,21,297,10,18,-8
29,21,298,15,15,0
29,21,299,7,15,-8
29,22,0,16,16,0
29,22,1,8,30,-22
29,22,2,16,11,5
29,22,3,17,28,-11
29,22,4,15,13,2
29,22,5,6,29,-23
29,22,6,11,11,0
29,22,7,7,15,-8
29,22,8,17,12,5
29,22,9,9,20,-11
29,22,10,9,5,4
29,22,11,7,11,-4
29,22,12,11,19,-8
29,22,13,9,23,-14
29,22,14,7,17,-10
29,22,15,8,9,-1
29,22,16,4,3,1
29,22,17,9,20,-11
29,22,18,0,13,-13
29,22,19,13,14,-1
29,22,20,15,17,-2
29,22,21,8,17,-9
29,22,22,3,15,-12
29,22,23,7,10,-3
29,22,24,13,13,0
29,22,25,6,6,0
29,22,26,4,8,-4
29,22,27,7,19,-12
29,22,28,8,34,-26
29,22,29,16,20,-4
29,22,30,13,20,-7
29,22,31,14,13,1
29,22,32,8,8,0
29,22,33,5,18,-13
29,22,34,11,19,-8
29,22,35,9,10,-1
29,22,36,15,7,8
29,22,37,10,6,4
29,22,38,10,20,-10
29,22,39,17,15,2
29,22,40,9,9,0
29,22,41,9,8,1
29,22,42,3,4,-1
29,22,43,9,6,3
29,22,44,10,13,-3
29,22,45,14,18,-4
29,22,46,11,2,9
29,22,47,19,22,-3
29,22,48,5,21,-16
29,22,49,7,7,0
29,22,50,15,16,-1
29,22,51,7,19,-12
29,22,52,15,27,-12
29,22,53,13,17,-4
29,22,54,10,18,-8
29,22,55,13,16,-3
29,22,56,14,19,-5
29,22,57,10,14,-4
29,22,58,11,0,11
29,22,59,2,11,-9
29,22,60,8,9,-1
29,22,61,1,9,-8
29,22,62,14,21,-7
29,22,63,22,37,-15
29,22,64,20,20,0
29,22,65,10,4,6
29,22,66,12,14,-2
29,22,67,14,11,3
29,22,68,8,11,-3
29,22,69,15,17,-2
29,22,70,6,20,-14
29,22,71,16,15,1
29,22,72,5,9,-4
29,22,73,14,14,0
29,22,74,10,20,-10
29,22,75,6,11,-5
29,22,76,6,14,-8
29,22,77,15,11,4
29,22,78,14,15,-1
29,22,79,7,17,-10
29,22,80,12,25,-13
29,22,81,9,27,-18
29,22,82,27,8,19
29,22,83,9,13,-4
29,22,84,5,4,1
29,22,85,23,17,6
29,22,86,12,17,-5
29,22,87,13,11,2
29,22,88,12,4,8
29,22,89,9,14,-5
29,22,90,8,15,-7
29,22,91,11,8,3
29,22,92,8,12,-4
29,22,93,14,22,-8
29,22,94,7,15,-8
29,22,95,8,10,-2
29,22,96,2,2,0
29,22,97,8,19,-11
29,22,98,4,8,-4
29,22,99,15,16,-1
29,22,100,9,20,-11
29,22,101,6,14,-8
29,22,102,14,8,6
29,22,103,14,23,-9
29,22,104,4,9,-5
29,22,105,8,24,-16
29,22,106,14,21,-7
29,22,107,8,13,-5
29,22,108,16,39,-23
29,22,109,16,7,9
29,22,110,12,9,3
29,22,111,3,17,-14
29,22,112,16,19,-3
29,22,113,7,6,1
29,22,114,12,31,-19
29,22,115,9,8,1
29,22,116,8,10,-2
29,22,117,4,4,0
29,22,118,6,14,-8
29,22,119,20,16,4
29,22,120,11,10,1
29,22,121,9,14,-5
29,22,122,6,17,-11
29,22,123,11,29,-18
29,22,124,14,16,-2
29,22,125,17,15,2
29,22,126,8,1,7
29,22,127,8,16,-8
29,22,128,12,14,-2
29,22,129,4,26,-22
29,22,130,19,19,0
29,22,131,7,17,-10
29,22,132,13,22,-9
29,22,133,6,7,-1
29,22,134,11,31,-20
29,22,135,17,20,-3
29,22,136,3,9,-6
29,22,137,13,20,-7
29,22,138,4,10,-6
29,22,139,16,21,-5
29,22,140,8,21,-13
29,22,141,20,33,-13
29,22,142,14,7,7
29,22,143,6,6,0
29,22,144,10,17,-7
29,22,145,15,21,-6
29,22,146,9,8,1
29,22,147,11,15,-4
29,22,148,13,25,-12
29,22,149,13,14,-1
29,22,150,8,15,-7
29,22,151,3,12,-9
29,22,152,18,10,8
29,22,153,8,23,-15
29,22,154,15,31,-16
29,22,155,17,23,-6
29,22,156,17,8,9
29,22,157,12,35,-23
29,22,158,19,4,15
29,22,159,10,8,2
29,22,160,23,13,10
29,22,161,19,22,-3
29,22,162,13,11,2
29,22,163,3,11,-8
29,22,164,15,14,1
29,22,165,14,21,-7
29,22,166,20,22,-2
29,22,167,12,10,2
29,22,168,17,13,4
29,22,169,13,16,-3
29,22,170,11,7,4
29,22,171,11,23,-12
29,22,172,16,19,-3
29,22,173,23,27,-4
29,22,174,15,15,0
29,22,175,11,7,4
29,22,176,17,21,-4
29,22,177,16,9,7
29,22,178,13,24,-11
29,22,179,4,11,-7
29,22,180,12,21,-9
29,22,181,25,23,2
29,22,182,11,16,-5
29,22,183,12,17,-5
29,22,184,11,11,0
29,22,185,7,13,-6
29,22,186,7,13,-6
29,22,187,15,10,5
29,22,188,18,14,4
29,22,189,12,11,1
29,22,190,8,6,2
29,22,191,22,23,-1
29,22,192,11,20,-9
29,22,193,8,19,-11
29,22,194,7,5,2
29,22,195,8,17,-9
29,22,196,11,25,-14
29,22,197,3,6,-3
29,22,198,8,24,-16
29,22,199,8,17,-9
29,22,200,4,27,-23
29,22,201,25,15,10
29,22,202,5,15,-10
29,22,203,11,28,-17
29,22,204,19,17,2
29,22,205,20,23,-3
29,22,206,7,21,-14
29,22,207,3,11,-8
29,22,208,12,26,-14
29,22,209,6,13,-7
29,22,210,12,8,4
29,22,211,13,20,-7
29,22,212,6,14,-8
29,22,213,13,14,-1
29,22,214,6,8,-2
29,22,215,19,20,-1
29,22,216,26,20,6
29,22,217,8,16,-8
29,22,218,13,15,-2
29,22,219,15,12,3
29,22,220,5,39,-34
29,22,221,12,17,-5
29,22,222,9,14,-5
29,22,223,7,10,-3
29,22,224,14,14,0
29,22,225,6,16,-10
29,22,226,14,13,1
29,22,227,11,11,0
29,22,228,11,15,-4
29,22,229,14,14,0
29,22,230,15,15,0
29,22,231,8,13,-5
29,22,232,8,11,-3
29,22,233,6,19,-13
29,22,234,16,29,-13
29,22,235,11,19,-8
29,22,236,10,12,-2
29,22,237,7,7,0
29,22,238,6,13,-7
29,22,239,13,18,-5
29,22,240,5,17,-12
29,22,241,6,10,-4
29,22,242,10,16,-6
29,22,243,11,22,-11
29,22,244,8,14,-6
29,22,245,7,10,-3
29,22,246,14,22,-8
29,22,247,5,9,-4
29,22,248,11,22,-11
29,22,249,12,24,-12
29,22,250,5,15,-10
29,22,251,13,11,2
29,22,252,8,22,-14
29,22,253,8,16,-8
29,22,254,5,12,-7
29,22,255,20,16,4
29,22,256,9,11,-2
29,22,257,16,18,-2
29,22,258,15,17,-2
29,22,259,10,21,-11
29,22,260,12,15,-3
29,22,261,7,13,-6
29,22,262,16,10,6
29,22,263,14,17,-3
29,22,264,16,31,-15
29,22,265,13,11,2
29,22,266,9,16,-7
29,22,267,19,16,3
29,22,268,8,14,-6
29,22,269,10,20,-10
29,22,270,17,14,3
29,22,271,16,15,1
29,22,272,5,4,1
29,22,273,8,15,-7
29,22,274,9,6,3
29,22,275,16,18,-2
29,22,276,14,11,3
29,22,277,20,18,2
29,22,278,14,19,-5
29,22,279,3,22,-19
29,22,280,3,13,-10
29,22,281,22,19,3
29,22,282,4,16,-12
29,22,283,13,18,-5
29,22,284,19,11,8
29,22,285,8,13,-5
29,22,286,9,16,-7
29,22,287,12,25,-13
29,22,288,18,25,-7
29,22,289,13,27,-14
29,22,290,20,20,0
29,22,291,13,15,-2
29,22,292,9,10,-1
29,22,293,4,12,-8
29,22,294,12,13,-1
29,22,295,10,23,-13
29,22,296,12,16,-4
29,22,297,13,29,-16
29,22,298,8,8,0
29,22,299,11,8,3
29,23,0,12,9,3
29,23,1,6,11,-5
29,23,2,8,18,-10
29,23,3,12,14,-2
29,23,4,13,12,1
29,23,5,14,9,5
29,23,6,3,7,-4
29,23,7,5,15,-10
29,23,8,5,10,-5
29,23,9,20,26,-6
29,23,10,12,17,-5
29,23,11,10,21,-11
29,23,12,10,23,-13
29,23,13,8,15,-7
29,23,14,16,11,5
29,23,15,8,16,-8
29,23,16,5,11,-6
29,23,17,18,16,2
29,23,18,13,8,5
29,23,19,13,15,-2
29,23,20,8,10,-2
29,23,21,9,13,-4
29,23,22,10,12,-2
29,23,23,14,4,10
29,23,24,11,17,-6
29,23,25,13,16,-3
29,23,26,14,17,-3
29,23,27,13,12,1
29,23,28,2,7,-5
29,23,29,20,15,5
29,23,30,18,8,10
29,23,31,10,10,0
29,23,32,12,19,-7
29,23,33,9,4,5
29,23,34,8,30,-22
29,23,35,18,19,-1
29,23,36,14,18,-4
29,23,37,7,18,-11
29,23,38,11,14,-3
29,23,39,8,10,-2
29,23,40,6,12,-6
29,23,41,18,20,-2
29,23,42,12,12,0
29,23,43,20,16,4
29,23,44,27,18,9
29,23,45,15,16,-1
29,23,46,11,14,-3
29,23,47,16,10,6
29,23,48,19,18,1
29,23,49,4,6,-2
29,23,50,9,11,-2
29,23,51,6,10,-4
29,23,52,10,6,4
29,23,53,16,22,-6
29,23,54,16,22,-6
29,23,55,22,18,4
29,23,56,16,20,-4
29,23,57,22,22,0
29,23,58,11,12,-1
29,23,59,6,8,-2
29,23,60,22,12,10
29,23,61,8,20,-12
29,23,62,10,17,-7
29,23,63,12,26,-14
29,23,64,15,15,0
29,23,65,13,12,1
29,23,66,6,23,-17
29,23,67,11,20,-9
29,23,68,13,9,4
29,23,69,14,13,1
29,23,70,22,19,3
29,23,71,11,21,-10
29,23,72,7,11,-4
29,23,73,6,17,-11
29,23,74,9,14,-5
29,23,75,5,11,-6
29,23,76,18,18,0
29,23,77,17,20,-3
29,23,78,17,15,2
29,23,79,9,7,2
29,23,80,16,8,8
29,23,81,4,11,-7
29,23,82,16,15,1
29,23,83,12,6,6
29,23,84,10,24,-14
29,23,85,9,33,-24
29,23,86,20,12,8
29,23,87,5,9,-4
29,23,88,9,17,-8
29,23,89,14,9,5
29,23,90,7,23,-16
29,23,91,10,16,-6
29,23,92,12,12,0
29,23,93,8,16,-8
29,23,94,11,8,3
29,23,95,12,17,-5
29,23,96,9,17,-8
29,23,97,16,15,1
29,23,98,6,6,0
29,23,99,16,33,-17
29,23,100,7,19,-12
29,23,101,14,15,-1
29,23,102,12,6,6
29,23,103,8,6,2
29,23,104,11,9,2
29,23,105,9,4,5
29,23,106,9,13,-4
29,23,107,18,31,-13
29,23,108,10,17,-7
29,23,109,14,13,1
29,23,110,5,9,-4
29,23,111,14,19,-5
29,23,112,11,10,1
29,23,113,5,12,-7
29,23,114,14,22,-8
29,23,115,10,15,-5
29,23,116,18,20,-2
29,23,117,8,6,2
29,23,118,3,7,-4
29,23,119,9,16,-7
29,23,120,7,4,3
29,23,121,15,16,-1
29,23,122,7,14,-7
29,23,123,10,10,0
29,23,124,11,15,-4
29,23,125,14,23,-9
29,23,126,19,14,5
29,23,127,10,5,5
29,23,128,6,14,-8
29,23,129,6,17,-11
29,23,130,10,7,3
29,23,131,16,21,-5
29,23,132,16,19,-3
29,23,133,14,14,0
29,23,134,9,7,2
29,23,135,19,17,2
29,23,136,20,16,4
29,23,137,14,21,-7
29,23,138,9,12,-3
29,23,139,3,19,-16
29,23,140,10,14,-4
29,23,141,11,17,-6
29,23,142,5,14,-9
29,23,143,6,8,-2
29,23,144,12,14,-2
29,23,145,22,24,-2
29,23,146,13,22,-9
29,23,147,22,22,0
29,23,148,8,9,-1
29,23,149,15,18,-3
29,23,150,19,11,8
29,23,151,10,22,-12
29,23,152,10,14,-4
29,23,153,13,17,-4
29,23,154,16,24,-8
29,23,155,8,14,-6
29,23,156,13,9,4
29,23,157,8,23,-15
29,23,158,2,19,-17
29,23,159,9,11,-2
29,23,160,14,14,0
29,23,161,7,14,-7
29,23,162,8,18,-10
29,23,163,16,20,-4
29,23,164,11,13,-2
29,23,165,6,12,-6
29,23,166,12,17,-5
29,23,167,9,2,7
29,23,168,4,9,-5
29,23,169,7,14,-7
29,23,170,9,10,-1
29,23,171,6,16,-10
29,23,172,14,15,-1
29,23,173,24,18,6
29,23,174,7,4,3
29,23,175,11,6,5
29,23,176,11,16,-5
29,23,177,17,15,2
29,23,178,11,10,1
29,23,179,13,26,-13
29,23,180,9,15,-6
29,23,181,10,23,-13
29,23,182,15,20,-5
29,23,183,7,9,-2
29,23,184,10,15,-5
29,23,185,19,23,-4
29,23,186,9,12,-3
29,23,187,6,15,-9
29,23,188,11,13,-2
29,23,189,6,17,-11
29,23,190,20,15,5
29,23,191,7,15,-8
29,23,192,13,19,-6
29,23,193,19,23,-4
29,23,194,12,27,-15
29,23,195,10,14,-4
29,23,196,7,20,-13
29,23,197,6,7,-1
29,23,198,12,6,6
29,23,199,11,18,-7
29,23,200,13,13,0
29,23,201,11,23,-12
29,23,202,15,18,-3
29,23,203,6,24,-18
29,23,204,12,11,1
29,23,205,11,7,4
29,23,206,14,18,-4
29,23,207,7,12,-5
29,23,208,10,16,-6
29,23,209,7,23,-16
29,23,210,9,1,8
29,23,211,8,15,-7
29,23,212,13,14,-1
29,23,213,9,17,-8
29,23,214,18,20,-2
29,23,215,20,14,6
29,23,216,16,17,-1
29,23,217,4,8,-4
29,23,218,10,17,-7
29,23,219,8,5,3
29,23,220,11,19,-8
29,23,221,7,13,-6
29,23,222,2,11,-9
29,23,223,11,19,-8
29,23,224,17,21,-4
29,23,225,9,13,-4
29,23,226,14,17,-3
29,23,227,8,21,-13
29,23,228,23,15,8
29,23,229,7,11,-4
29,23,230,15,15,0
29,23,231,4,11,-7
29,23,232,8,10,-2
29,23,233,9,10,-1
29,23,234,12,18,-6
29,23,235,10,7,3
29,23,236,11,20,-9
29,23,237,14,23,-9
29,23,238,13,22,-9
29,23,239,12,11,1
29,23,240,7,15,-8
29,23,241,12,11,1
29,23,242,12,19,-7
29,23,243,17,11,6
29,23,244,20,26,-6
29,23,245,11,11,0
29,23,246,8,13,-5
29,23,247,15,13,2
29,23,248,10,15,-5
29,23,249,9,16,-7
29,23,250,8,13,-5
29,23,251,20,16,4
29,23,252,8,20,-12
29,23,253,9,6,3
29,23,254,4,12,-8
29,23,255,10,22,-12
29,23,256,8,17,-9
29,23,257,18,12,6
29,23,258,12,7,5
29,23,259,4,10,-6
29,23,260,9,8,1
29,23,261,20,18,2
29,23,262,10,12,-2
29,23,263,9,17,-8
29,23,264,17,25,-8
29,23,265,7,5,2
29,23,266,6,14,-8
29,23,267,17,11,6
29,23,268,20,21,-1
29,23,269,16,18,-2
29,23,270,9,5,4
29,23,271,10,16,-6
29,23,272,5,12,-7
29,23,273,5,9,-4
29,23,274,15,14,1
29,23,275,24,32,-8
29,23,276,5,18,-13
29,23,277,11,7,4
29,23,278,8,18,-10
29,23,279,13,15,-2
29,23,280,6,14,-8
29,23,281,6,12,-6
29,23,282,17,18,-1
29,23,283,12,23,-11
29,23,284,16,18,-2
29,23,285,14,32,-18
29,23,286,13,12,1
29,23,287,14,22,-8
29,23,288,6,15,-9
29,23,289,10,15,-5
29,23,290,8,10,-2
29,23,291,7,17,-10
29,23,292,13,13,0
29,23,293,16,20,-4
29,23,294,9,9,0
29,23,295,18,28,-10
29,23,296,11,19,-8
29,23,297,14,20,-6
29,23,298,14,20,-6
29,23,299,11,14,-3
29,24,0,10,12,-2
29,24,1,15,16,-1
29,24,2,4,6,-2
29,24,3,10,9,1
29,24,4,12,19,-7
29,24,5,4,16,-12
29,24,6,10,12,-2
29,24,7,3,15,-12
29,24,8,8,18,-10
29,24,9,7,16,-9
29,24,10,10,22,-12
29,24,11,27,9,18
29,24,12,8,8,0
29,24,13,8,12,-4
29,24,14,8,12,-4
29,24,15,24,45,-21
29,24,16,7,9,-2
29,24,17,7,7,0
29,24,18,7,19,-12
29,24,19,16,20,-4
29,24,20,20,12,8
29,24,21,11,17,-6
29,24,22,9,13,-4
29,24,23,17,19,-2
29,24,24,11,8,3
29,24,25,15,7,8
29,24,26,11,26,-15
29,24,27,12,7,5
29,24,28,10,8,2
29,24,29,5,19,-14
29,24,30,18,24,-6
29,24,31,14,9,5
29,24,32,12,34,-22
29,24,33,15,23,-8
29,24,34,10,20,-10
29,24,35,13,14,-1
29,24,36,13,14,-1
29,24,37,13,27,-14
29,24,38,6,13,-7
29,24,39,8,9,-1
29,24,40,16,17,-1
29,24,41,11,16,-5
29,24,42,12,25,-13
29,24,43,5,2,3
29,24,44,16,5,11
29,24,45,16,19,-3
29,24,46,3,12,-9
29,24,47,13,22,-9
29,24,48,23,23,0
29,24,49,11,9,2
29,24,50,7,19,-12
29,24,51,16,15,1
29,24,52,13,16,-3
29,24,53,16,4,12
29,24,54,8,20,-12
29,24,55,14,17,-3
29,24,56,8,20,-12
29,24,57,9,15,-6
29,24,58,10,1,9
29,24,59,6,19,-13
29,24,60,8,11,-3
29,24,61,2,12,-10
29,24,62,14,14,0
29,24,63,5,13,-8
29,24,64,6,10,-4
29,24,65,6,8,-2
29,24,66,12,14,-2
29,24,67,4,12,-8
29,24,68,13,21,-8
29,24,69,5,9,-4
29,24,70,10,12,-2
29,24,71,17,5,12
29,24,72,20,21,-1
29,24,73,12,20,-8
29,24,74,12,11,1
29,24,75,10,25,-15
29,24,76,3,10,-7
29,24,77,18,19,-1
29,24,78,12,11,1
29,24,79,3,11,-8
29,24,80,6,5,1
29,24,81,29,11,18
29,24,82,12,10,2
29,24,83,4,12,-8
29,24,84,10,14,-4
29,24,85,12,7,5
29,24,86,10,11,-1
29,24,87,17,12,5
29,24,88,14,9,5
29,24,89,16,8,8
29,24,90,12,16,-4
29,24,91,14,12,2
29,24,92,17,9,8
29,24,93,6,24,-18
29,24,94,15,12,3
29,24,95,6,14,-8
29,24,96,7,20,-13
29,24,97,7,13,-6
29,24,98,8,12,-4
29,24,99,4,12,-8
29,24,100,14,20,-6
29,24,101,18,18,0
29,24,102,13,10,3
29,24,103,8,14,-6
29,24,104,10,19,-9
29,24,105,12,17,-5
29,24,106,17,19,-2
29,24,107,8,3,5
29,24,108,22,17,5
29,24,109,8,17,-9
29,24,110,9,2,7
29,24,111,11,15,-4
29,24,112,8,5,3
29,24,113,10,10,0
29,24,114,10,19,-9
29,24,115,19,16,3
29,24,116,12,12,0
29,24,117,3,24,-21
29,24,118,13,16,-3
29,24,119,6,10,-4
29,24,120,21,9,12
29,24,121,6,12,-6
29,24,122,23,20,3
29,24,123,11,19,-8
29,24,124,11,15,-4
29,24,125,26,17,9
29,24,126,14,15,-1
29,24,127,12,15,-3
29,24,128,9,9,0
29,24,129,8,9,-1
29,24,130,5,6,-1
29,24,131,7,10,-3
29,24,132,2,13,-11
29,24,133,3,10,-7
29,24,134,14,16,-2
29,24,135,13,17,-4
29,24,136,15,10,5
29,24,137,14,16,-2
29,24,138,19,24,-5
29,24,139,5,6,-1
29,24,140,17,23,-6
29,24,141,12,5,7
29,24,142,9,13,-4
29,24,143,10,13,-3
29,24,144,14,10,4
29,24,145,7,13,-6
29,24,146,8,11,-3
29,24,147,12,22,-10
29,24,148,14,26,-12
29,24,149,11,18,-7
29,24,150,16,15,1
29,24,151,13,11,2
29,24,152,5,22,-17
29,24,153,9,7,2
29,24,154,13,20,-7
29,24,155,5,12,-7
29,24,156,17,31,-14
29,24,157,7,18,-11
29,24,158,6,20,-14
29,24,159,8,15,-7
29,24,160,14,17,-3
29,24,161,6,12,-6
29,24,162,15,10,5
29,24,163,9,9,0
29,24,164,11,10,1
29,24,165,8,7,1
29,24,166,7,15,-8
29,24,167,6,11,-5
29,24,168,16,6,10
29,24,169,10,26,-16
29,24,170,21,24,-3
29,24,171,4,16,-12
29,24,172,10,12,-2
29,24,173,7,4,3
29,24,174,11,13,-2
29,24,175,5,6,-1
29,24,176,4,8,-4
29,24,177,13,12,1
29,24,178,12,17,-5
29,24,179,3,4,-1
29,24,180,7,9,-2
29,24,181,19,20,-1
29,24,182,7,13,-6
29,24,183,10,13,-3
29,24,184,14,11,3
29,24,185,11,16,-5
29,24,186,19,14,5
29,24,187,12,10,2
29,24,188,31,12,19
29,24,189,4,12,-8
29,24,190,9,9,0
29,24,191,7,13,-6
29,24,192,11,17,-6
29,24,193,2,12,-10
29,24,194,14,18,-4
29,24,195,12,27,-15
29,24,196,13,11,2
29,24,197,11,6,5
29,24,198,10,10,0
29,24,199,11,28,-17
29,24,200,8,9,-1
29,24,201,3,10,-7
29,24,202,7,17,-10
29,24,203,12,17,-5
29,24,204,20,15,5
29,24,205,15,20,-5
29,24,206,18,14,4
29,24,207,14,1,13
29,24,208,12,23,-11
29,24,209,11,20,-9
29,24,210,8,21,-13
29,24,211,8,18,-10
29,24,212,16,14,2
29,24,213,9,7,2
29,24,214,18,9,9
29,24,215,19,23,-4
29,24,216,14,13,1
29,24,217,13,27,-14
29,24,218,8,2,6
29,24,219,9,9,0
29,24,220,9,9,0
29,24,221,8,11,-3
29,24,222,17,20,-3
29,24,223,7,13,-6
29,24,224,18,10,8
29,24,225,9,13,-4
29,24,226,10,20,-10
29,24,227,11,20,-9
29,24,228,19,6,13
29,24,229,12,20,-8
29,24,230,9,12,-3
29,24,231,7,5,2
29,24,232,12,11,1
29,24,233,8,9,-1
29,24,234,16,11,5
29,24,235,5,9,-4
29,24,236,14,3,11
29,24,237,9,4,5
29,24,238,17,18,-1
29,24,239,7,18,-11
29,24,240,10,6,4
29,24,241,7,14,-7
29,24,242,11,20,-9
29,24,243,5,13,-8
29,24,244,3,13,-10
29,24,245,11,4,7
29,24,246,9,10,-1
29,24,247,14,15,-1
29,24,248,2,23,-21
29,24,249,9,10,-1
29,24,250,14,21,-7
29,24,251,20,18,2
29,24,252,20,16,4
29,24,253,15,11,4
29,24,254,11,7,4
29,24,255,10,11,-1
29,24,256,21,18,3
29,24,257,27,22,5
29,24,258,13,7,6
29,24,259,7,10,-3
29,24,260,8,12,-4
29,24,261,9,17,-8
29,24,262,12,14,-2
29,24,263,16,19,-3
29,24,264,11,14,-3
29,24,265,8,14,-6
29,24,266,12,10,2
29,24,267,12,20,-8
29,24,268,28,18,10
29,24,269,10,11,-1
29,24,270,7,12,-5
29,24,271,13,19,-6
29,24,272,14,19,-5
29,24,273,5,7,-2
29,24,274,16,25,-9
29,24,275,13,17,-4
29,24,276,15,30,-15
29,24,277,5,17,-12
29,24,278,4,8,-4
29,24,279,21,13,8
29,24,280,8,11,-3
29,24,281,5,15,-10
29,24,282,7,4,3
29,24,283,7,20,-13
29,24,284,8,16,-8
29,24,285,15,21,-6
29,24,286,8,5,3
29,24,287,8,11,-3
29,24,288,6,9,-3
29,24,289,5,18,-13
29,24,290,8,28,-20
29,24,291,14,27,-13
29,24,292,13,11,2
29,24,293,9,11,-2
29,24,294,6,16,-10
29,24,295,10,11,-1
29,24,296,17,7,10
29,24,297,8,8,0
29,24,298,18,25,-7
29,24,299,8,12,-4
29,25,0,11,7,4
29,25,1,9,12,-3
29,25,2,12,15,-3
29,25,3,14,23,-9
29,25,4,10,10,0
29,25,5,10,21,-11
29,25,6,21,15,6
29,25,7,14,26,-12
29,25,8,8,9,-1
29,25,9,7,8,-1
29,25,10,11,16,-5
29,25,11,17,6,11
29,25,12,7,14,-7
29,25,13,13,8,5
29,25,14,16,17,-1
29,25,15,10,15,-5
29,25,16,16,20,-4
29,25,17,4,17,-13
29,25,18,7,12,-5
29,25,19,11,15,-4
29,25,20,16,14,2
29,25,21,7,13,-6
29,25,22,5,6,-1
29,25,23,14,11,3
29,25,24,13,10,3
29,25,25,19,13,6
29,25,26,9,21,-12
29,25,27,13,13,0
29,25,28,5,10,-5
29,25,29,5,19,-14
29,25,30,6,10,-4
29,25,31,16,11,5
29,25,32,5,8,-3
29,25,33,14,12,2
29,25,34,11,10,1
29,25,35,2,8,-6
29,25,36,13,21,-8
29,25,37,10,16,-6
29,25,38,5,11,-6
29,25,39,10,17,-7
29,25,40,20,5,15
29,25,41,17,15,2
29,25,42,12,19,-7
29,25,43,11,15,-4
29,25,44,13,23,-10
29,25,45,21,15,6
29,25,46,20,16,4
29,25,47,17,14,3
29,25,48,16,21,-5
29,25,49,8,13,-5
29,25,50,18,24,-6
29,25,51,18,12,6
29,25,52,19,12,7
29,25,53,10,19,-9
29,25,54,22,18,4
29,25,55,14,30,-16
29,25,56,8,16,-8
29,25,57,8,9,-1
29,25,58,7,9,-2
29,25,59,8,10,-2
29,25,60,14,21,-7
29,25,61,4,10,-6
29,25,62,8,13,-5
29,25,63,10,13,-3
29,25,64,11,9,2
29,25,65,13,19,-6
29,25,66,9,14,-5
29,25,67,9,18,-9
29,25,68,10,8,2
29,25,69,13,8,5
29,25,70,13,19,-6
29,25,71,14,9,5
29,25,72,14,14,0
29,25,73,7,10,-3
29,25,74,18,25,-7
29,25,75,12,9,3
29,25,76,7,7,0
29,25,77,12,27,-15
29,25,78,16,17,-1
29,25,79,4,8,-4
29,25,80,10,10,0
29,25,81,10,13,-3
29,25,82,9,4,5
29,25,83,14,17,-3
29,25,84,18,10,8
29,25,85,11,8,3
29,25,86,17,19,-2
29,25,87,3,15,-12
29,25,88,10,12,-2
29,25,89,9,20,-11
29,25,90,7,11,-4
29,25,91,20,16,4
29,25,92,10,20,-10
29,25,93,15,16,-1
29,25,94,14,6,8
29,25,95,10,19,-9
29,25,96,2,7,-5
29,25,97,19,12,7
29,25,98,5,16,-11
29,25,99,11,10,1
29,25,100,12,13,-1
29,25,101,12,18,-6
29,25,102,7,12,-5
29,25,103,3,10,-7
29,25,104,5,5,0
29,25,105,13,8,5
29,25,106,23,15,8
29,25,107,1,8,-7
29,25,108,2,8,-6
29,25,109,14,18,-4
29,25,110,29,8,21
29,25,111,9,12,-3
29,25,112,6,10,-4
29,25,113,6,8,-2
29,25,114,6,4,2
29,25,115,14,17,-3
29,25,116,20,20,0
29,25,117,9,12,-3
29,25,118,15,6,9
29,25,119,16,12,4
29,25,120,9,16,-7
29,25,121,15,27,-12
29,25,122,9,6,3
29,25,123,5,12,-7
29,25,124,8,11,-3
29,25,125,6,10,-4
29,25,126,8,2,6
29,25,127,7,12,-5
29,25,128,8,14,-6
29,25,129,25,12,13
29,25,130,14,11,3
29,25,131,20,9,11
29,25,132,8,10,-2
29,25,133,6,19,-13
29,25,134,6,8,-2
29,25,135,18,18,0
29,25,136,14,9,5
29,25,137,4,8,-4
29,25,138,2,9,-7
29,25,139,19,17,2
29,25,140,6,20,-14
29,25,141,18,26,-8
29,25,142,11,7,4
29,25,143,12,18,-6
29,25,144,6,10,-4
29,25,145,15,20,-5
29,25,146,13,14,-1
29,25,147,9,9,0
29,25,148,14,18,-4
29,25,149,11,15,-4
29,25,150,3,16,-13
29,25,151,10,24,-14
29,25,152,15,11,4
29,25,153,9,15,-6
29,25,154,16,14,2
29,25,155,13,9,4
29,25,156,13,2,11
29,25,157,7,18,-11
29,25,158,3,16,-13
29,25,159,9,9,0
29,25,160,22,16,6
29,25,161,5,4,1
29,25,162,13,12,1
29,25,163,9,21,-12
29,25,164,8,4,4
29,25,165,12,19,-7
29,25,166,7,10,-3
29,25,167,12,13,-1
29,25,168,4,7,-3
29,25,169,13,11,2
29,25,170,2,21,-19
29,25,171,9,17,-8
29,25,172,31,14,17
29,25,173,13,13,0
29,25,174,22,18,4
29,25,175,19,7,12
29,25,176,15,9,6
29,25,177,9,20,-11
29,25,178,13,11,2
29,25,179,20,15,5
29,25,180,7,17,-10
29,25,181,7,11,-4
29,25,182,14,13,1
29,25,183,6,11,-5
29,25,184,7,10,-3
29,25,185,14,9,5
29,25,186,23,11,12
29,25,187,12,12,0
29,25,188,10,11,-1
29,25,189,8,11,-3
29,25,190,8,18,-10
29,25,191,10,11,-1
29,25,192,19,15,4
29,25,193,14,9,5
29,25,194,7,23,-16
29,25,195,12,11,1
29,25,196,7,4,3
29,25,197,7,13,-6
29,25,198,10,13,-3
29,25,199,11,12,-1
29,25,200,9,8,1
29,25,201,6,16,-10
29,25,202,9,16,-7
29,25,203,8,30,-22
29,25,204,18,14,4
29,25,205,14,20,-6
29,25,206,4,3,1
29,25,207,16,14,2
29,25,208,8,17,-9
29,25,209,18,15,3
29,25,210,9,9,0
29,25,211,5,16,-11
29,25,212,21,19,2
29,25,213,8,6,2
29,25,214,4,7,-3
29,25,215,12,9,3
29,25,216,11,13,-2
29,25,217,6,10,-4
29,25,218,11,19,-8
29,25,219,5,6,-1
29,25,220,10,9,1
29,25,221,13,10,3
29,25,222,11,20,-9
29,25,223,7,16,-9
29,25,224,9,17,-8
29,25,225,2,14,-12
29,25,226,6,8,-2
29,25,227,5,5,0
29,25,228,6,23,-17
29,25,229,19,11,8
29,25,230,13,15,-2
29,25,231,9,14,-5
29,25,232,12,7,5
29,25,233,12,17,-5
29,25,234,14,17,-3
29,25,235,15,16,-1
29,25,236,12,16,-4
29,25,237,11,16,-5
29,25,238,15,9,6
29,25,239,15,11,4
29,25,240,16,17,-1
29,25,241,14,27,-13
29,25,242,12,14,-2
29,25,243,9,36,-27
29,25,244,8,6,2
29,25,245,14,16,-2
29,25,246,11,18,-7
29,25,247,20,22,-2
29,25,248,12,7,5
29,25,249,15,12,3
29,25,250,17,9,8
29,25,251,19,13,6
29,25,252,8,12,-4
29,25,253,10,7,3
29,25,254,6,14,-8
29,25,255,6,21,-15
29,25,256,10,8,2
29,25,257,10,9,1
29,25,258,19,17,2
29,25,259,8,10,-2
29,25,260,25,20,5
29,25,261,7,20,-13
29,25,262,10,15,-5
29,25,263,7,10,-3
29,25,264,7,16,-9
29,25,265,17,11,6
29,25,266,14,20,-6
29,25,267,6,16,-10
29,25,268,13,12,1
29,25,269,21,20,1
29,25,270,10,15,-5
29,25,271,7,8,-1
29,25,272,28,23,5
29,25,273,21,22,-1
29,25,274,15,5,10
29,25,275,12,7,5
29,25,276,7,15,-8
29,25,277,8,11,-3
29,25,278,12,11,1
29,25,279,14,12,2
29,25,280,13,12,1
29,25,281,23,19,4
29,25,282,8,17,-9
29,25,283,12,13,-1
29,25,284,13,19,-6
29,25,285,15,14,1
29,25,286,6,18,-12
29,25,287,13,11,2
29,25,288,9,14,-5
29,25,289,5,4,1
29,25,290,6,14,-8
29,25,291,15,30,-15
29,25,292,13,20,-7
29,25,293,15,9,6
29,25,294,15,24,-9
29,25,295,10,20,-10
29,25,296,10,20,-10
29,25,297,9,13,-4
29,25,298,10,13,-3
29,25,299,20,17,3
29,26,0,4,21,-17
29,26,1,4,13,-9
29,26,2,15,16,-1
29,26,3,9,11,-2
29,26,4,13,21,-8
29,26,5,8,18,-10
29,26,6,8,20,-12
29,26,7,1,7,-6
29,26,8,14,19,-5
29,26,9,9,11,-2
29,26,10,20,15,5
29,26,11,10,15,-5
29,26,12,7,15,-8
29,26,13,8,17,-9
29,26,14,10,13,-3
29,26,15,10,17,-7
29,26,16,3,11,-8
29,26,17,7,11,-4
29,26,18,11,11,0
29,26,19,5,12,-7
29,26,20,15,8,7
29,26,21,10,17,-7
29,26,22,10,18,-8
29,26,23,17,8,9
29,26,24,15,11,4
29,26,25,11,19,-8
29,26,26,14,16,-2
29,26,27,18,16,2
29,26,28,7,8,-1
29,26,29,12,13,-1
29,26,30,16,22,-6
29,26,31,11,9,2
29,26,32,13,10,3
29,26,33,18,17,1
29,26,34,16,14,2
29,26,35,12,14,-2
29,26,36,10,13,-3
29,26,37,16,8,8
29,26,38,5,7,-2
29,26,39,3,7,-4
29,26,40,9,15,-6
29,26,41,10,28,-18
29,26,42,4,12,-8
29,26,43,12,16,-4
29,26,44,16,16,0
29,26,45,10,6,4
29,26,46,9,8,1
29,26,47,7,24,-17
29,26,48,7,10,-3
29,26,49,8,21,-13
29,26,50,15,7,8
29,26,51,15,11,4
29,26,52,10,10,0
29,26,53,18,26,-8
29,26,54,15,12,3
29,26,55,7,12,-5
29,26,56,10,5,5
29,26,57,2,16,-14
29,26,58,9,5,4
29,26,59,12,27,-15
29,26,60,18,9,9
29,26,61,10,13,-3
29,26,62,21,14,7
29,26,63,15,18,-3
29,26,64,10,16,-6
29,26,65,15,7,8
29,26,66,25,21,4
29,26,67,6,11,-5
29,26,68,9,19,-10
29,26,69,13,14,-1
29,26,70,7,7,0
29,26,71,6,19,-13
29,26,72,16,31,-15
29,26,73,12,9,3
29,26,74,16,17,-1
29,26,75,10,13,-3
29,26,76,14,17,-3
29,26,77,10,6,4
29,26,78,15,15,0
29,26,79,10,4,6
29,26,80,16,6,10
29,26,81,10,12,-2
29,26,82,13,20,-7
29,26,83,8,18,-10
29,26,84,9,21,-12
29,26,85,9,11,-2
29,26,86,4,10,-6
29,26,87,7,11,-4
29,26,88,2,5,-3
29,26,89,22,7,15
29,26,90,16,11,5
29,26,91,8,9,-1
29,26,92,21,26,-5
29,26,93,8,14,-6
29,26,94,13,26,-13
29,26,95,14,18,-4
29,26,96,13,10,3
29,26,97,6,14,-8
29,26,98,9,6,3
29,26,99,10,19,-9
29,26,100,12,21,-9
29,26,101,15,11,4
29,26,102,11,17,-6
29,26,103,11,9,2
29,26,104,10,9,1
29,26,105,12,15,-3
29,26,106,11,13,-2
29,26,107,12,18,-6
29,26,108,10,14,-4
29,26,109,2,5,-3
29,26,110,7,4,3
29,26,111,12,6,6
29,26,112,19,19,0
29,26,113,20,17,3
29,26,114,13,8,5
29,26,115,6,13,-7
29,26,116,20,7,13
29,26,117,11,10,1
29,26,118,5,19,-14
29,26,119,2,3,-1
29,26,120,10,19,-9
29,26,121,16,13,3
29,26,122,21,22,-1
29,26,123,9,19,-10
29,26,124,6,4,2
29,26,125,13,7,6
29,26,126,11,8,3
29,26,127,8,19,-11
29,26,128,9,25,-16
29,26,129,11,5,6
29,26,130,19,11,8
29,26,131,7,13,-6
29,26,132,11,2,9
29,26,133,8,21,-13
29,26,134,23,10,13
29,26,135,8,13,-5
29,26,136,9,20,-11
29,26,137,8,23,-15
29,26,138,11,16,-5
29,26,139,4,10,-6
29,26,140,20,15,5
29,26,141,17,18,-1
29,26,142,14,18,-4
29,26,143,12,7,5
29,26,144,14,17,-3
29,26,145,8,7,1
29,26,146,13,22,-9
29,26,147,14,11,3
29,26,148,16,14,2
29,26,149,13,16,-3
29,26,150,14,15,-1
29,26,151,17,14,3
29,26,152,5,4,1
29,26,153,9,9,0
29,26,154,11,11,0
29,26,155,28,19,9
29,26,156,7,11,-4
29,26,157,16,14,2
29,26,158,19,13,6
29,26,159,12,10,2
29,26,160,13,9,4
29,26,161,16,11,5
29,26,162,11,11,0
29,26,163,11,16,-5
29,26,164,10,28,-18
29,26,165,8,21,-13
29,26,166,12,16,-4
29,26,167,7,9,-2
29,26,168,13,33,-20
29,26,169,5,10,-5
29,26,170,6,20,-14
29,26,171,11,10,1
29,26,172,18,11,7
29,26,173,8,10,-2
29,26,174,9,14,-5
29,26,175,7,9,-2
29,26,176,5,11,-6
29,26,177,21,7,14
29,26,178,14,10,4
29,26,179,9,29,-20
29,26,180,11,4,7
29,26,181,8,6,2
29,26,182,9,15,-6
29,26,183,12,19,-7
29,26,184,9,18,-9
29,26,185,10,14,-4
29,26,186,12,8,4
29,26,187,28,25,3
29,26,188,18,14,4
29,26,189,4,4,0
29,26,190,9,11,-2
29,26,191,19,19,0
29,26,192,22,12,10
29,26,193,11,11,0
29,26,194,16,19,-3
29,26,195,14,8,6
29,26,196,16,6,10
29,26,197,11,11,0
29,26,198,9,6,3
29,26,199,8,12,-4
29,26,200,19,10,9
29,26,201,7,11,-4
29,26,202,12,20,-8
29,26,203,10,12,-2
29,26,204,8,14,-6
29,26,205,22,20,2
29,26,206,15,21,-6
29,26,207,8,13,-5
29,26,208,8,16,-8
29,26,209,10,8,2
29,26,210,16,15,1
29,26,211,15,12,3
29,26,212,10,7,3
29,26,213,14,8,6
29,26,214,15,16,-1
29,26,215,5,22,-17
29,26,216,11,8,3
29,26,217,11,11,0
29,26,218,11,13,-2
29,26,219,13,16,-3
29,26,220,7,11,-4
29,26,221,12,15,-3
29,26,222,15,10,5
29,26,223,7,10,-3
29,26,224,16,18,-2
29,26,225,21,17,4
29,26,226,8,11,-3
29,26,227,3,5,-2
29,26,228,8,8,0
29,26,229,17,14,3
29,26,230,14,30,-16
29,26,231,13,18,-5
29,26,232,6,6,0
29,26,233,13,10,3
29,26,234,12,17,-5
29,26,235,14,12,2
29,26,236,22,14,8
29,26,237,3,15,-12
29,26,238,13,8,5
29,26,239,7,11,-4
29,26,240,10,24,-14
29,26,241,7,10,-3
29,26,242,16,20,-4
29,26,243,7,9,-2
29,26,244,12,5,7
29,26,245,7,12,-5
29,26,246,16,11,5
29,26,247,4,10,-6
29,26,248,22,16,6
29,26,249,17,16,1
29,26,250,9,12,-3
29,26,251,5,9,-4
29,26,252,9,19,-10
29,26,253,11,10,1
29,26,254,17,15,2
29,26,255,3,21,-18
29,26,256,11,29,-18
29,26,257,9,7,2
29,26,258,11,15,-4
29,26,259,12,13,-1
29,26,260,8,12,-4
29,26,261,2,10,-8
29,26,262,19,17,2
29,26,263,6,15,-9
29,26,264,14,20,-6
29,26,265,9,5,4
29,26,266,16,9,7
29,26,267,12,14,-2
29,26,268,8,12,-4
29,26,269,8,12,-4
29,26,270,12,15,-3
29,26,271,12,22,-10
29,26,272,11,5,6
29,26,273,16,9,7
29,26,274,19,21,-2
29,26,275,11,16,-5
29,26,276,8,18,-10
29,26,277,13,11,2
29,26,278,11,7,4
29,26,279,18,19,-1
29,26,280,21,22,-1
29,26,281,20,10,10
29,26,282,6,9,-3
29,26,283,10,11,-1
29,26,284,6,7,-1
29,26,285,11,19,-8
29,26,286,3,8,-5
29,26,287,7,17,-10
29,26,288,13,13,0
29,26,289,9,10,-1
29,26,290,7,22,-15
29,26,291,12,13,-1
29,26,292,15,12,3
29,26,293,18,18,0
29,26,294,16,20,-4
29,26,295,15,24,-9
29,26,296,18,21,-3
29,26,297,16,17,-1
29,26,298,15,26,-11
29,26,299,8,23,-15
29,27,0,15,18,-3
29,27,1,27,15,12
29,27,2,6,23,-17
29,27,3,11,10,1
29,27,4,17,13,4
29,27,5,4,9,-5
29,27,6,12,11,1
29,27,7,11,10,1
29,27,8,7,11,-4
29,27,9,16,10,6
29,27,10,14,25,-11
29,27,11,9,5,4
29,27,12,5,6,-1
29,27,13,14,11,3
29,27,14,13,8,5
29,27,15,11,15,-4
29,27,16,9,17,-8
29,27,17,11,2,9
29,27,18,19,12,7
29,27,19,14,16,-2
29,27,20,27,13,14
29,27,21,11,10,1
29,27,22,10,23,-13
29,27,23,6,7,-1
29,27,24,13,10,3
29,27,25,14,13,1
29,27,26,4,1,3
29,27,27,13,7,6
29,27,28,11,12,-1
29,27,29,13,15,-2
29,27,30,18,5,13
29,27,31,6,14,-8
29,27,32,3,5,-2
29,27,33,11,17,-6
29,27,34,12,14,-2
29,27,35,9,8,1
29,27,36,11,5,6
29,27,37,16,14,2
29,27,38,12,12,0
29,27,39,18,8,10
29,27,40,14,24,-10
29,27,41,26,12,14
29,27,42,9,5,4
29,27,43,7,19,-12
29,27,44,20,16,4
29,27,45,16,11,5
29,27,46,14,7,7
29,27,47,14,20,-6
29,27,48,9,12,-3
29,27,49,13,16,-3
29,27,50,5,7,-2
29,27,51,4,5,-1
29,27,52,16,16,0
29,27,53,7,6,1
29,27,54,13,19,-6
29,27,55,13,15,-2
29,27,56,6,12,-6
29,27,57,4,4,0
29,27,58,17,29,-12
29,27,59,5,10,-5
29,27,60,10,6,4
29,27,61,19,12,7
29,27,62,11,14,-3
29,27,63,12,22,-10
29,27,64,8,15,-7
29,27,65,19,12,7
29,27,66,14,17,-3
29,27,67,14,12,2
29,27,68,23,19,4
29,27,69,2,20,-18
29,27,70,14,8,6
29,27,71,19,12,7
29,27,72,13,5,8
29,27,73,12,11,1
29,27,74,10,8,2
29,27,75,14,24,-10
29,27,76,8,16,-8
29,27,77,9,15,-6
29,27,78,8,12,-4
29,27,79,5,17,-12
29,27,80,12,12,0
29,27,81,17,24,-7
29,27,82,4,13,-9
29,27,83,7,13,-6
29,27,84,10,9,1
29,27,85,16,10,6
29,27,86,2,9,-7
29,27,87,9,13,-4
29,27,88,23,11,12
29,27,89,19,11,8
29,27,90,8,6,2
29,27,91,13,11,2
29,27,92,4,6,-2
29,27,93,14,16,-2
29,27,94,17,17,0
29,27,95,10,9,1
29,27,96,5,20,-15
29,27,97,12,13,-1
29,27,98,6,12,-6
29,27,99,9,12,-3
29,27,100,9,15,-6
29,27,101,12,9,3
29,27,102,26,18,8
29,27,103,13,10,3
29,27,104,13,12,1
29,27,105,7,8,-1
29,27,106,21,27,-6
29,27,107,14,17,-3
29,27,108,6,9,-3
29,27,109,11,13,-2
29,27,110,16,15,1
29,27,111,2,20,-18
29,27,112,10,13,-3
29,27,113,6,8,-2
29,27,114,20,26,-6
29,27,115,16,13,3
29,27,116,3,21,-18
29,27,117,17,23,-6
29,27,118,8,15,-7
29,27,119,8,19,-11
29,27,120,10,14,-4
29,27,121,8,20,-12
29,27,122,8,6,2
29,27,123,6,8,-2
29,27,124,13,12,1
29,27,125,12,8,4
29,27,126,17,13,4
29,27,127,5,15,-10
29,27,128,13,25,-12
29,27,129,20,3,17
29,27,130,15,8,7
29,27,131,10,14,-4
29,27,132,26,21,5
29,27,133,9,14,-5
29,27,134,10,15,-5
29,27,135,12,13,-1
29,27,136,10,9,1
29,27,137,10,10,0
29,27,138,9,11,-2
29,27,139,12,14,-2
29,27,140,12,31,-19
29,27,141,6,12,-6
29,27,142,12,12,0
29,27,143,6,9,-3
29,27,144,10,11,-1
29,27,145,13,17,-4
29,27,146,11,9,2
29,27,147,10,16,-6
29,27,148,3,12,-9
29,27,149,6,4,2
29,27,150,12,13,-1
29,27,151,7,9,-2
29,27,152,13,26,-13
29,27,153,15,9,6
29,27,154,16,9,7
29,27,155,11,14,-3
29,27,156,4,10,-6
29,27,157,18,17,1
29,27,158,15,8,7
29,27,159,8,18,-10
29,27,160,11,11,0
29,27,161,3,12,-9
29,27,162,15,11,4
29,27,163,22,9,13
29,27,164,10,15,-5
29,27,165,13,21,-8
29,27,166,13,16,-3
29,27,167,11,14,-3
29,27,168,15,5,10
29,27,169,13,7,6
29,27,170,8,8,0
29,27,171,8,4,4
29,27,172,13,19,-6
29,27,173,23,25,-2
29,27,174,10,15,-5
29,27,175,13,14,-1
29,27,176,7,11,-4
29,27,177,14,15,-1
29,27,178,8,12,-4
29,27,179,6,23,-17
29,27,180,8,22,-14
29,27,181,14,13,1
29,27,182,9,13,-4
29,27,183,12,7,5
29,27,184,2,10,-8
29,27,185,13,7,6
29,27,186,7,5,2
29,27,187,7,15,-8
29,27,188,13,6,7
29,27,189,8,12,-4
29,27,190,10,13,-3
29,27,191,11,20,-9
29,27,192,14,12,2
29,27,193,2,14,-12
29,27,194,5,10,-5
29,27,195,19,6,13
29,27,196,8,15,-7
29,27,197,6,9,-3
29,27,198,18,12,6
29,27,199,16,21,-5
29,27,200,7,19,-12
29,27,201,20,5,15
29,27,202,9,11,-2
29,27,203,19,15,4
29,27,204,8,16,-8
29,27,205,13,13,0
29,27,206,8,9,-1
29,27,207,9,11,-2
29,27,208,7,19,-12
29,27,209,8,5,3
29,27,210,12,11,1
29,27,211,12,9,3
29,27,212,12,15,-3
29,27,213,6,15,-9
29,27,214,13,6,7
29,27,215,15,14,1
29,27,216,4,9,-5
29,27,217,18,18,0
29,27,218,7,13,-6
29,27,219,15,14,1
29,27,220,12,9,3
29,27,221,15,8,7
29,27,222,10,10,0
29,27,223,6,17,-11
29,27,224,7,16,-9
29,27,225,19,22,-3
29,27,226,5,21,-16
29,27,227,8,12,-4
29,27,228,16,21,-5
29,27,229,10,17,-7
29,27,230,16,17,-1
29,27,231,8,4,4
29,27,232,4,13,-9
29,27,233,11,10,1
29,27,234,10,11,-1
29,27,235,2,25,-23
29,27,236,17,20,-3
29,27,237,19,16,3
29,27,238,6,3,3
29,27,239,18,16,2
29,27,240,18,13,5
29,27,241,3,13,-10
29,27,242,14,20,-6
29,27,243,13,8,5
29,27,244,11,14,-3
29,27,245,8,14,-6
29,27,246,9,9,0
29,27,247,4,6,-2
29,27,248,9,8,1
29,27,249,8,22,-14
29,27,250,11,12,-1
29,27,251,11,23,-12
29,27,252,12,10,2
29,27,253,11,13,-2
29,27,254,11,8,3
29,27,255,7,15,-8
29,27,256,12,12,0
29,27,257,8,8,0
29,27,258,14,8,6
29,27,259,12,14,-2
29,27,260,4,7,-3
29,27,261,14,11,3
29,27,262,15,14,1
29,27,263,9,10,-1
29,27,264,5,4,1
29,27,265,16,13,3
29,27,266,8,17,-9
29,27,267,24,17,7
29,27,268,14,10,4
29,27,269,5,6,-1
29,27,270,6,6,0
29,27,271,9,7,2
29,27,272,18,9,9
29,27,273,15,11,4
29,27,274,12,23,-11
29,27,275,10,5,5
29,27,276,13,4,9
29,27,277,21,16,5
29,27,278,7,19,-12
29,27,279,12,2,10
29,27,280,15,16,-1
29,27,281,12,19,-7
29,27,282,13,11,2
29,27,283,10,14,-4
29,27,284,21,9,12
29,27,285,10,12,-2
29,27,286,10,15,-5
29,27,287,7,7,0
29,27,288,13,8,5
29,27,289,11,11,0
29,27,290,16,9,7
29,27,291,15,19,-4
29,27,292,6,9,-3
29,27,293,31,19,12
29,27,294,6,7,-1
29,27,295,8,9,-1
29,27,296,13,15,-2
29,27,297,18,16,2
29,27,298,11,11,0
29,27,299,5,8,-3
29,28,0,17,17,0
29,28,1,11,10,1
29,28,2,17,18,-1
29,28,3,4,11,-7
29,28,4,16,16,0
29,28,5,16,8,8
29,28,6,21,17,4
29,28,7,12,13,-1
29,28,8,7,22,-15
29,28,9,12,13,-1
29,28,10,10,8,2
29,28,11,14,15,-1
29,28,12,8,6,2
29,28,13,10,20,-10
29,28,14,16,24,-8
29,28,15,12,26,-14
29,28,16,16,14,2
29,28,17,12,13,-1
29,28,18,3,14,-11
29,28,19,11,14,-3
29,28,20,13,7,6
29,28,21,9,10,-1
29,28,22,14,14,0
29,28,23,10,9,1
29,28,24,13,13,0
29,28,25,6,20,-14
29,28,26,9,3,6
29,28,27,9,20,-11
29,28,28,11,24,-13
29,28,29,14,13,1
29,28,30,12,12,0
29,28,31,9,13,-4
29,28,32,21,11,10
29,28,33,9,12,-3
29,28,34,16,16,0
29,28,35,25,16,9
29,28,36,17,17,0
29,28,37,9,8,1
29,28,38,23,15,8
29,28,39,8,13,-5
29,28,40,9,8,1
29,28,41,19,10,9
29,28,42,11,5,6
29,28,43,12,20,-8
29,28,44,7,12,-5
29,28,45,11,11,0
29,28,46,14,12,2
29,28,47,6,12,-6
29,28,48,14,16,-2
29,28,49,7,6,1
29,28,50,12,13,-1
29,28,51,7,8,-1
29,28,52,11,5,6
29,28,53,6,4,2
29,28,54,14,14,0
29,28,55,18,12,6
29,28,56,9,13,-4
29,28,57,10,15,-5
29,28,58,15,11,4
29,28,59,26,18,8
29,28,60,7,16,-9
29,28,61,9,10,-1
29,28,62,5,6,-1
29,28,63,20,22,-2
29,28,64,12,12,0
29,28,65,14,10,4
29,28,66,11,12,-1
29,28,67,21,14,7
29,28,68,9,8,1
29,28,69,17,21,-4
29,28,70,11,10,1
29,28,71,12,3,9
29,28,72,15,15,0
29,28,73,7,9,-2
29,28,74,12,13,-1
29,28,75,9,13,-4
29,28,76,16,15,1
29,28,77,4,5,-1
29,28,78,11,16,-5
29,28,79,12,14,-2
29,28,80,6,12,-6
29,28,81,9,11,-2
29,28,82,16,15,1
29,28,83,4,19,-15
29,28,84,14,12,2
29,28,85,13,17,-4
29,28,86,18,23,-5
29,28,87,18,14,4
29,28,88,16,25,-9
29,28,89,15,24,-9
29,28,90,30,15,15
29,28,91,8,4,4
29,28,92,8,6,2
29,28,93,7,2,5
29,28,94,12,10,2
29,28,95,8,6,2
29,28,96,8,9,-1
29,28,97,9,9,0
29,28,98,16,26,-10
29,28,99,18,19,-1
29,28,100,12,22,-10
29,28,101,12,9,3
29,28,102,8,7,1
29,28,103,13,13,0
29,28,104,14,10,4
29,28,105,9,9,0
29,28,106,13,17,-4
29,28,107,16,14,2
29,28,108,10,14,-4
29,28,109,16,17,-1
29,28,110,10,8,2
29,28,111,14,26,-12
29,28,112,11,15,-4
29,28,113,11,14,-3
29,28,114,10,10,0
29,28,115,13,16,-3
29,28,116,22,8,14
29,28,117,14,8,6
29,28,118,9,9,0
29,28,119,11,13,-2
29,28,120,7,2,5
29,28,121,11,5,6
29,28,122,5,11,-6
29,28,123,10,17,-7
29,28,124,22,23,-1
29,28,125,7,17,-10
29,28,126,20,21,-1
29,28,127,8,13,-5
29,28,128,15,10,5
29,28,129,13,13,0
29,28,130,14,11,3
29,28,131,9,16,-7
29,28,132,5,22,-17
29,28,133,8,12,-4
29,28,134,17,14,3
29,28,135,14,11,3
29,28,136,14,11,3
29,28,137,19,15,4
29,28,138,19,29,-10
29,28,139,11,10,1
29,28,140,9,9,0
29,28,141,12,10,2
29,28,142,16,15,1
29,28,143,21,12,9
29,28,144,14,16,-2
29,28,145,11,5,6
29,28,146,11,14,-3
29,28,147,12,11,1
29,28,148,13,5,8
29,28,149,5,13,-8
29,28,150,5,17,-12
29,28,151,13,10,3
29,28,152,13,17,-4
29,28,153,16,9,7
29,28,154,4,4,0
29,28,155,8,18,-10
29,28,156,13,12,1
29,28,157,11,15,-4
29,28,158,10,19,-9
29,28,159,4,11,-7
29,28,160,7,17,-10
29,28,161,11,5,6
29,28,162,6,14,-8
29,28,163,11,17,-6
29,28,164,14,15,-1
29,28,165,17,18,-1
29,28,166,14,21,-7
29,28,167,10,5,5
29,28,168,11,13,-2
29,28,169,6,8,-2
29,28,170,5,14,-9
29,28,171,16,21,-5
29,28,172,9,13,-4
29,28,173,14,13,1
29,28,174,20,9,11
29,28,175,8,13,-5
29,28,176,5,11,-6
29,28,177,13,16,-3
29,28,178,12,16,-4
29,28,179,3,14,-11
29,28,180,9,19,-10
29,28,181,16,16,0
29,28,182,13,15,-2
29,28,183,3,12,-9
29,28,184,12,15,-3
29,28,185,23,8,15
29,28,186,8,16,-8
29,28,187,12,11,1
29,28,188,14,22,-8
29,28,189,12,7,5
29,28,190,14,20,-6
29,28,191,11,14,-3
29,28,192,16,22,-6
29,28,193,13,13,0
29,28,194,6,14,-8
29,28,195,14,11,3
29,28,196,23,20,3
29,28,197,13,10,3
29,28,198,10,5,5
29,28,199,19,28,-9
29,28,200,10,10,0
29,28,201,6,12,-6
29,28,202,8,14,-6
29,28,203,9,3,6
29,28,204,6,17,-11
29,28,205,18,10,8
29,28,206,8,16,-8
29,28,207,11,6,5
29,28,208,15,11,4
29,28,209,15,16,-1
29,28,210,17,11,6
29,28,211,14,8,6
29,28,212,5,8,-3
29,28,213,25,24,1
29,28,214,8,25,-17
29,28,215,10,5,5
29,28,216,13,27,-14
29,28,217,3,7,-4
29,28,218,8,11,-3
29,28,219,12,10,2
29,28,220,4,17,-13
29,28,221,18,15,3
29,28,222,14,10,4
29,28,223,8,9,-1
29,28,224,10,16,-6
29,28,225,16,9,7
29,28,226,12,19,-7
29,28,227,3,15,-12
29,28,228,12,11,1
29,28,229,10,8,2
29,28,230,10,15,-5
29,28,231,17,16,1
29,28,232,7,23,-16
29,28,233,10,5,5
29,28,234,21,9,12
29,28,235,7,16,-9
29,28,236,13,8,5
29,28,237,9,9,0
29,28,238,21,18,3
29,28,239,9,16,-7
29,28,240,0,14,-14
29,28,241,4,14,-10
29,28,242,12,9,3
29,28,243,12,11,1
29,28,244,18,18,0
29,28,245,14,8,6
29,28,246,17,15,2
29,28,247,13,12,1
29,28,248,17,12,5
29,28,249,14,25,-11
29,28,250,11,9,2
29,28,251,13,14,-1
29,28,252,9,12,-3
29,28,253,8,9,-1
29,28,254,10,2,8
29,28,255,14,10,4
29,28,256,15,9,6
29,28,257,8,9,-1
29,28,258,8,10,-2
29,28,259,11,10,1
29,28,260,5,15,-10
29,28,261,2,10,-8
29,28,262,9,6,3
29,28,263,9,16,-7
29,28,264,11,9,2
29,28,265,10,13,-3
29,28,266,4,19,-15
29,28,267,14,13,1
29,28,268,9,12,-3
29,28,269,13,16,-3
29,28,270,8,14,-6
29,28,271,10,12,-2
29,28,272,17,11,6
29,28,273,11,7,4
29,28,274,9,9,0
29,28,275,12,6,6
29,28,276,12,16,-4
29,28,277,15,25,-10
29,28,278,12,19,-7
29,28,279,9,16,-7
29,28,280,4,17,-13
29,28,281,10,12,-2
29,28,282,15,21,-6
29,28,283,1,1,0
29,28,284,17,8,9
29,28,285,18,11,7
29,28,286,22,19,3
29,28,287,12,11,1
29,28,288,17,6,11
29,28,289,20,16,4
29,28,290,8,4,4
29,28,291,12,13,-1
29,28,292,6,13,-7
29,28,293,7,10,-3
29,28,294,6,8,-2
29,28,295,10,4,6
29,28,296,16,10,6
29,28,297,9,10,-1
29,28,298,15,7,8
29,28,299,14,16,-2
29,29,0,8,17,-9
29,29,1,5,15,-10
29,29,2,9,5,4
29,29,3,12,17,-5
29,29,4,5,7,-2
29,29,5,7,4,3
29,29,6,16,18,-2
29,29,7,7,10,-3
29,29,8,10,15,-5
29,29,9,22,19,3
29,29,10,15,9,6
29,29,11,6,12,-6
29,29,12,15,14,1
29,29,13,5,15,-10
29,29,14,19,6,13
29,29,15,9,18,-9
29,29,16,4,17,-13
29,29,17,8,13,-5
29,29,18,14,6,8
29,29,19,3,14,-11
29,29,20,7,15,-8
29,29,21,2,9,-7
29,29,22,18,9,9
29,29,23,12,18,-6
29,29,24,12,11,1
29,29,25,7,7,0
29,29,26,9,1,8
29,29,27,6,13,-7
29,29,28,4,7,-3
29,29,29,3,7,-4
29,29,30,10,19,-9
29,29,31,4,10,-6
29,29,32,5,14,-9
29,29,33,13,9,4
29,29,34,7,10,-3
29,29,35,7,11,-4
29,29,36,7,4,3
29,29,37,18,17,1
29,29,38,16,7,9
29,29,39,22,14,8
29,29,40,4,14,-10
29,29,41,10,20,-10
29,29,42,5,11,-6
29,29,43,9,10,-1
29,29,44,9,14,-5
29,29,45,10,9,1
29,29,46,6,11,-5
29,29,47,13,13,0
29,29,48,9,16,-7
29,29,49,15,11,4
29,29,50,10,19,-9
29,29,51,6,11,-5
29,29,52,4,15,-11
29,29,53,3,4,-1
29,29,54,16,23,-7
29,29,55,13,14,-1
29,29,56,17,17,0
29,29,57,11,8,3
29,29,58,8,7,1
29,29,59,7,8,-1
29,29,60,9,14,-5
29,29,61,16,21,-5
29,29,62,2,17,-15
29,29,63,16,8,8
29,29,64,6,18,-12
29,29,65,6,25,-19
29,29,66,5,9,-4
29,29,67,12,10,2
29,29,68,0,12,-12
29,29,69,16,10,6
29,29,70,5,9,-4
29,29,71,6,11,-5
29,29,72,12,3,9
29,29,73,8,12,-4
29,29,74,14,12,2
29,29,75,10,3,7
29,29,76,14,16,-2
29,29,77,11,12,-1
29,29,78,13,7,6
29,29,79,10,14,-4
29,29,80,3,15,-12
29,29,81,19,12,7
29,29,82,9,15,-6
29,29,83,9,11,-2
29,29,84,10,11,-1
29,29,85,29,16,13
29,29,86,9,13,-4
29,29,87,19,20,-1
29,29,88,5,10,-5
29,29,89,12,12,0
29,29,90,13,8,5
29,29,91,13,18,-5
29,29,92,7,18,-11
29,29,93,12,12,0
29,29,94,14,21,-7
29,29,95,8,3,5
29,29,96,11,5,6
29,29,97,6,9,-3
29,29,98,15,11,4
29,29,99,6,13,-7
29,29,100,13,20,-7
29,29,101,12,18,-6
29,29,102,18,18,0
29,29,103,18,17,1
29,29,104,14,13,1
29,29,105,12,10,2
29,29,106,15,11,4
29,29,107,8,9,-1
29,29,108,12,12,0
29,29,109,11,10,1
29,29,110,1,16,-15
29,29,111,18,13,5
29,29,112,12,21,-9
29,29,113,7,18,-11
29,29,114,5,15,-10
29,29,115,13,10,3
29,29,116,6,8,-2
29,29,117,7,15,-8
29,29,118,18,23,-5
29,29,119,5,25,-20
29,29,120,7,22,-15
29,29,121,5,6,-1
29,29,122,22,14,8
29,29,123,16,8,8
29,29,124,6,3,3
29,29,125,11,18,-7
29,29,126,18,12,6
29,29,127,10,17,-7
29,29,128,17,17,0
29,29,129,12,8,4
29,29,130,8,11,-3
29,29,131,11,15,-4
29,29,132,13,11,2
29,29,133,12,15,-3
29,29,134,3,10,-7
29,29,135,4,4,0
29,29,136,4,9,-5
29,29,137,16,15,1
29,29,138,9,9,0
29,29,139,3,6,-3
29,29,140,13,13,0
29,29,141,8,16,-8
29,29,142,9,9,0
29,29,143,12,5,7
29,29,144,7,2,5
29,29,145,2,16,-14
29,29,146,15,15,0
29,29,147,12,11,1
29,29,148,11,12,-1
29,29,149,3,21,-18
29,29,150,8,10,-2
29,29,151,7,13,-6
29,29,152,9,11,-2
29,29,153,9,18,-9
29,29,154,8,13,-5
29,29,155,10,16,-6
29,29,156,15,27,-12
29,29,157,10,11,-1
29,29,158,6,15,-9
29,29,159,15,16,-1
29,29,160,14,20,-6
29,29,161,6,7,-1
29,29,162,7,20,-13
29,29,163,5,11,-6
29,29,164,8,10,-2
29,29,165,12,8,4
29,29,166,3,14,-11
29,29,167,8,5,3
29,29,168,8,8,0
29,29,169,14,8,6
29,29,170,5,9,-4
29,29,171,6,5,1
29,29,172,18,12,6
29,29,173,9,2,7
29,29,174,4,19,-15
29,29,175,15,10,5
29,29,176,21,15,6
29,29,177,4,9,-5
29,29,178,6,8,-2
29,29,179,8,8,0
29,29,180,9,12,-3
29,29,181,6,3,3
29,29,182,11,10,1
29,29,183,12,26,-14
29,29,184,20,11,9
29,29,185,4,7,-3
29,29,186,4,12,-8
29,29,187,12,13,-1
29,29,188,20,14,6
29,29,189,13,12,1
29,29,190,19,19,0
29,29,191,15,15,0
29,29,192,14,8,6
29,29,193,9,15,-6
29,29,194,11,10,1
29,29,195,9,9,0
29,29,196,6,11,-5
29,29,197,27,16,11
29,29,198,8,12,-4
29,29,199,9,11,-2
29,29,200,5,12,-7
29,29,201,14,7,7
29,29,202,8,13,-5
29,29,203,8,22,-14
29,29,204,9,16,-7
29,29,205,9,14,-5
29,29,206,11,25,-14
29,29,207,5,14,-9
29,29,208,12,17,-5
29,29,209,12,7,5
29,29,210,15,11,4
29,29,211,5,3,2
29,29,212,11,12,-1
29,29,213,12,14,-2
29,29,214,15,5,10
29,29,215,9,13,-4
29,29,216,11,8,3
29,29,217,10,5,5
29,29,218,2,8,-6
29,29,219,8,13,-5
29,29,220,12,16,-4
29,29,221,17,13,4
29,29,222,6,9,-3
29,29,223,4,12,-8
29,29,224,11,15,-4
29,29,225,10,12,-2
29,29,226,7,12,-5
29,29,227,6,21,-15
29,29,228,11,15,-4
29,29,229,9,14,-5
29,29,230,12,5,7
29,29,231,13,15,-2
29,29,232,13,3,10
29,29,233,4,15,-11
29,29,234,5,10,-5
29,29,235,2,7,-5
29,29,236,9,9,0
29,29,237,11,19,-8
29,29,238,4,5,-1
29,29,239,29,9,20
29,29,240,14,9,5
29,29,241,4,11,-7
29,29,242,6,6,0
29,29,243,5,10,-5
29,29,244,7,10,-3
29,29,245,11,21,-10
29,29,246,10,4,6
29,29,247,12,12,0
29,29,248,4,8,-4
29,29,249,12,10,2
29,29,250,11,14,-3
29,29,251,12,14,-2
29,29,252,5,7,-2
29,29,253,7,6,1
29,29,254,10,15,-5
29,29,255,12,3,9
29,29,256,2,14,-12
29,29,257,10,20,-10
29,29,258,8,3,5
29,29,259,5,3,2
29,29,260,8,20,-12
29,29,261,4,22,-18
29,29,262,5,11,-6
29,29,263,10,15,-5
29,29,264,10,13,-3
29,29,265,13,11,2
29,29,266,10,6,4
29,29,267,8,22,-14
29,29,268,17,17,0
29,29,269,12,11,1
29,29,270,20,18,2
29,29,271,14,14,0
29,29,272,3,3,0
29,29,273,8,16,-8
29,29,274,8,28,-20
29,29,275,12,9,3
29,29,276,17,26,-9
29,29,277,14,15,-1
29,29,278,3,10,-7
29,29,279,10,11,-1
29,29,280,8,4,4
29,29,281,17,16,1
29,29,282,9,11,-2
29,29,283,12,9,3
29,29,284,11,9,2
29,29,285,16,14,2
29,29,286,8,10,-2
29,29,287,8,14,-6
29,29,288,9,14,-5
29,29,289,2,12,-10
29,29,290,9,12,-3
29,29,291,6,8,-2
29,29,292,13,13,0
29,29,293,6,14,-8
29,29,294,16,9,7
29,29,295,9,8,1
29,29,296,17,13,4
29,29,297,15,20,-5
29,29,298,10,11,-1
29,29,299,6,16,-10
29,30,0,12,4,8
29,30,1,10,29,-19
29,30,2,16,9,7
29,30,3,20,15,5
29,30,4,8,17,-9
29,30,5,11,4,7
29,30,6,19,16,3
29,30,7,10,14,-4
29,30,8,4,7,-3
29,30,9,21,19,2
29,30,10,13,8,5
29,30,11,18,6,12
29,30,12,17,13,4
29,30,13,13,8,5
29,30,14,10,22,-12
29,30,15,12,12,0
29,30,16,11,7,4
29,30,17,8,9,-1
29,30,18,10,13,-3
29,30,19,15,18,-3
29,30,20,4,7,-3
29,30,21,11,5,6
29,30,22,4,12,-8
29,30,23,14,12,2
29,30,24,12,11,1
29,30,25,16,10,6
29,30,26,9,11,-2
29,30,27,16,14,2
29,30,28,12,14,-2
29,30,29,13,16,-3
29,30,30,7,12,-5
29,30,31,3,10,-7
29,30,32,8,4,4
29,30,33,11,2,9
29,30,34,7,9,-2
29,30,35,6,7,-1
29,30,36,10,9,1
29,30,37,14,13,1
29,30,38,7,12,-5
29,30,39,11,13,-2
29,30,40,14,20,-6
29,30,41,17,21,-4
29,30,42,8,20,-12
29,30,43,10,5,5
29,30,44,4,5,-1
29,30,45,6,5,1
29,30,46,11,13,-2
29,30,47,12,10,2
29,30,48,6,8,-2
29,30,49,14,5,9
29,30,50,4,11,-7
29,30,51,16,7,9
29,30,52,11,12,-1
29,30,53,8,9,-1
29,30,54,13,19,-6
29,30,55,20,17,3
29,30,56,13,11,2
29,30,57,20,11,9
29,30,58,10,14,-4
29,30,59,11,6,5
29,30,60,2,5,-3
29,30,61,10,10,0
29,30,62,22,15,7
29,30,63,3,4,-1
29,30,64,4,11,-7
29,30,65,11,7,4
29,30,66,6,9,-3
29,30,67,8,11,-3
29,30,68,7,4,3
29,30,69,3,9,-6
29,30,70,16,10,6
29,30,71,7,11,-4
29,30,72,13,8,5
29,30,73,19,10,9
29,30,74,8,5,3
29,30,75,10,8,2
29,30,76,9,5,4
29,30,77,11,11,0
29,30,78,8,21,-13
29,30,79,10,15,-5
29,30,80,7,15,-8
29,30,81,10,26,-16
29,30,82,9,7,2
29,30,83,15,14,1
29,30,84,13,13,0
29,30,85,5,8,-3
29,30,86,10,6,4
29,30,87,19,12,7
29,30,88,11,6,5
29,30,89,21,14,7
29,30,90,13,12,1
29,30,91,8,4,4
29,30,92,7,6,1
29,30,93,26,15,11
29,30,94,14,4,10
29,30,95,15,6,9
29,30,96,8,7,1
29,30,97,10,11,-1
29,30,98,16,19,-3
29,30,99,13,13,0
29,30,100,10,11,-1
29,30,101,9,10,-1
29,30,102,14,10,4
29,30,103,5,11,-6
29,30,104,6,7,-1
29,30,105,10,12,-2
29,30,106,9,16,-7
29,30,107,12,13,-1
29,30,108,21,9,12
29,30,109,7,6,1
29,30,110,2,20,-18
29,30,111,18,16,2
29,30,112,4,9,-5
29,30,113,7,14,-7
29,30,114,23,26,-3
29,30,115,7,6,1
29,30,116,16,28,-12
29,30,117,14,13,1
29,30,118,9,10,-1
29,30,119,10,14,-4
29,30,120,7,9,-2
29,30,121,14,18,-4
29,30,122,14,6,8
29,30,123,16,9,7
29,30,124,10,6,4
29,30,125,11,13,-2
29,30,126,9,17,-8
29,30,127,10,9,1
29,30,128,14,2,12
29,30,129,3,4,-1
29,30,130,9,13,-4
29,30,131,9,10,-1
29,30,132,8,25,-17
29,30,133,5,16,-11
29,30,134,16,15,1
29,30,135,7,12,-5
29,30,136,18,12,6
29,30,137,6,3,3
29,30,138,10,13,-3
29,30,139,11,4,7
29,30,140,13,6,7
29,30,141,15,4,11
29,30,142,7,19,-12
29,30,143,18,18,0
29,30,144,7,3,4
29,30,145,6,7,-1
29,30,146,11,23,-12
29,30,147,15,13,2
29,30,148,14,15,-1
29,30,149,11,20,-9
29,30,150,5,5,0
29,30,151,10,13,-3
29,30,152,7,3,4
29,30,153,11,5,6
29,30,154,13,9,4
29,30,155,16,22,-6
29,30,156,14,14,0
29,30,157,12,6,6
29,30,158,14,10,4
29,30,159,4,9,-5
29,30,160,12,18,-6
29,30,161,13,17,-4
29,30,162,4,11,-7
29,30,163,8,15,-7
29,30,164,17,16,1
29,30,165,12,4,8
29,30,166,10,19,-9
29,30,167,6,8,-2
29,30,168,8,11,-3
29,30,169,12,11,1
29,30,170,8,8,0
29,30,171,13,11,2
29,30,172,13,9,4
29,30,173,11,10,1
29,30,174,5,17,-12
29,30,175,17,14,3
29,30,176,14,12,2
29,30,177,21,15,6
29,30,178,16,7,9
29,30,179,17,11,6
29,30,180,18,12,6
29,30,181,11,7,4
29,30,182,8,10,-2
29,30,183,13,16,-3
29,30,184,13,12,1
29,30,185,12,12,0
29,30,186,19,8,11
29,30,187,12,9,3
29,30,188,12,16,-4
29,30,189,6,13,-7
29,30,190,5,4,1
29,30,191,15,7,8
29,30,192,20,20,0
29,30,193,6,7,-1
29,30,194,4,8,-4
29,30,195,8,17,-9
29,30,196,11,16,-5
29,30,197,16,15,1
29,30,198,17,17,0
29,30,199,13,11,2
29,30,200,10,3,7
29,30,201,26,23,3
29,30,202,4,5,-1
29,30,203,5,19,-14
29,30,204,25,5,20
29,30,205,5,5,0
29,30,206,12,13,-1
29,30,207,9,16,-7
29,30,208,3,4,-1
29,30,209,5,20,-15
29,30,210,13,15,-2
29,30,211,15,14,1
29,30,212,8,3,5
29,30,213,4,10,-6
29,30,214,12,7,5
29,30,215,4,6,-2
29,30,216,9,4,5
29,30,217,12,13,-1
29,30,218,19,33,-14
29,30,219,7,15,-8
29,30,220,13,8,5
29,30,221,17,11,6
29,30,222,6,6,0
29,30,223,9,12,-3
29,30,224,14,15,-1
29,30,225,9,6,3
29,30,226,16,13,3
29,30,227,12,4,8
29,30,228,8,10,-2
29,30,229,10,15,-5
29,30,230,12,4,8
29,30,231,9,5,4
29,30,232,6,12,-6
29,30,233,11,12,-1
29,30,234,11,9,2
29,30,235,7,11,-4
29,30,236,9,16,-7
29,30,237,13,16,-3
29,30,238,14,18,-4
29,30,239,9,8,1
29,30,240,17,12,5
29,30,241,11,11,0
29,30,242,10,21,-11
29,30,243,8,12,-4
29,30,244,8,12,-4
29,30,245,9,4,5
29,30,246,10,16,-6
29,30,247,13,12,1
29,30,248,6,10,-4
29,30,249,18,11,7
29,30,250,9,16,-7
29,30,251,8,25,-17
29,30,252,12,11,1
29,30,253,8,10,-2
29,30,254,11,5,6
29,30,255,17,9,8
29,30,256,1,16,-15
29,30,257,24,15,9
29,30,258,8,19,-11
29,30,259,13,19,-6
29,30,260,10,10,0
29,30,261,13,18,-5
29,30,262,8,13,-5
29,30,263,25,12,13
29,30,264,15,21,-6
29,30,265,15,7,8
29,30,266,14,14,0
29,30,267,24,14,10
29,30,268,4,26,-22
29,30,269,12,8,4
29,30,270,13,7,6
29,30,271,10,10,0
29,30,272,9,18,-9
29,30,273,11,12,-1
29,30,274,10,8,2
29,30,275,14,11,3
29,30,276,6,11,-5
29,30,277,3,10,-7
29,30,278,11,18,-7
29,30,279,12,19,-7
29,30,280,11,11,0
29,30,281,5,11,-6
29,30,282,2,19,-17
29,30,283,13,14,-1
29,30,284,7,8,-1
29,30,285,13,9,4
29,30,286,15,11,4
29,30,287,11,16,-5
29,30,288,17,12,5
29,30,289,15,11,4
29,30,290,13,18,-5
29,30,291,8,11,-3
29,30,292,12,6,6
29,30,293,12,16,-4
29,30,294,15,9,6
29,30,295,18,14,4
29,30,296,15,5,10
29,30,297,14,21,-7
29,30,298,5,6,-1
29,30,299,12,7,5
30,1,0,16,15,1
30,1,1,6,14,-8
30,1,2,10,29,-19
30,1,3,8,13,-5
30,1,4,3,22,-19
30,1,5,10,10,0
30,1,6,7,13,-6
30,1,7,6,20,-14
30,1,8,11,15,-4
30,1,9,6,10,-4
30,1,10,2,4,-2
30,1,11,5,16,-11
30,1,12,6,10,-4
30,1,13,11,25,-14
30,1,14,3,9,-6
30,1,15,7,24,-17
30,1,16,3,11,-8
30,1,17,4,19,-15
30,1,18,1,15,-14
30,1,19,8,16,-8
30,1,20,12,23,-11
30,1,21,4,18,-14
30,1,22,3,14,-11
30,1,23,6,10,-4
30,1,24,10,15,-5
30,1,25,8,24,-16
30,1,26,9,14,-5
30,1,27,3,12,-9
30,1,28,2,18,-16
30,1,29,8,24,-16
30,1,30,4,4,0
30,1,31,6,30,-24
30,1,32,6,13,-7
30,1,33,3,6,-3
30,1,34,8,19,-11
30,1,35,8,18,-10
30,1,36,2,12,-10
30,1,37,11,19,-8
30,1,38,5,8,-3
30,1,39,3,27,-24
30,1,40,5,13,-8
30,1,41,5,11,-6
30,1,42,8,16,-8
30,1,43,12,14,-2
30,1,44,6,17,-11
30,1,45,7,12,-5
30,1,46,9,13,-4
30,1,47,7,11,-4
30,1,48,9,12,-3
30,1,49,6,18,-12
30,1,50,11,15,-4
30,1,51,3,11,-8
30,1,52,4,26,-22
30,1,53,9,13,-4
30,1,54,3,12,-9
30,1,55,6,7,-1
30,1,56,7,32,-25
30,1,57,5,15,-10
30,1,58,5,22,-17
30,1,59,13,18,-5
30,1,60,9,17,-8
30,1,61,5,8,-3
30,1,62,5,11,-6
30,1,63,13,8,5
30,1,64,9,21,-12
30,1,65,3,9,-6
30,1,66,4,21,-17
30,1,67,4,14,-10
30,1,68,8,21,-13
30,1,69,2,7,-5
30,1,70,4,9,-5
30,1,71,8,13,-5
30,1,72,20,21,-1
30,1,73,11,24,-13
30,1,74,4,15,-11
30,1,75,4,16,-12
30,1,76,10,23,-13
30,1,77,9,16,-7
30,1,78,8,28,-20
30,1,79,6,15,-9
30,1,80,5,24,-19
30,1,81,16,19,-3
30,1,82,8,22,-14
30,1,83,3,17,-14
30,1,84,2,11,-9
30,1,85,4,11,-7
30,1,86,6,4,2
30,1,87,4,27,-23
30,1,88,3,19,-16
30,1,89,2,11,-9
30,1,90,11,23,-12
30,1,91,4,14,-10
30,1,92,8,27,-19
30,1,93,3,15,-12
30,1,94,10,20,-10
30,1,95,4,13,-9
30,1,96,4,23,-19
30,1,97,7,16,-9
30,1,98,2,25,-23
30,1,99,4,26,-22
30,1,100,7,20,-13
30,1,101,7,12,-5
30,1,102,4,12,-8
30,1,103,10,15,-5
30,1,104,3,11,-8
30,1,105,5,19,-14
30,1,106,7,19,-12
30,1,107,0,6,-6
30,1,108,12,31,-19
30,1,109,9,14,-5
30,1,110,1,13,-12
30,1,111,11,14,-3
30,1,112,1,11,-10
30,1,113,13,18,-5
30,1,114,8,10,-2
30,1,115,3,24,-21
30,1,116,4,18,-14
30,1,117,6,17,-11
30,1,118,3,12,-9
30,1,119,4,5,-1
30,1,120,8,20,-12
30,1,121,9,28,-19
30,1,122,13,23,-10
30,1,123,7,14,-7
30,1,124,7,11,-4
30,1,125,6,18,-12
30,1,126,7,20,-13
30,1,127,5,22,-17
30,1,128,11,14,-3
30,1,129,6,24,-18
30,1,130,7,23,-16
30,1,131,4,11,-7
30,1,132,8,11,-3
30,1,133,4,21,-17
30,1,134,9,14,-5
30,1,135,8,6,2
30,1,136,5,17,-12
30,1,137,6,26,-20
30,1,138,13,11,2
30,1,139,11,13,-2
30,1,140,7,21,-14
30,1,141,8,19,-11
30,1,142,8,15,-7
30,1,143,6,15,-9
30,1,144,11,23,-12
30,1,145,9,25,-16
30,1,146,0,10,-10
30,1,147,9,28,-19
30,1,148,4,13,-9
30,1,149,9,23,-14
30,1,150,8,19,-11
30,1,151,8,12,-4
30,1,152,5,5,0
30,1,153,6,7,-1
30,1,154,12,27,-15
30,1,155,11,28,-17
30,1,156,4,14,-10
30,1,157,4,23,-19
30,1,158,6,28,-22
30,1,159,6,11,-5
30,1,160,8,27,-19
30,1,161,5,6,-1
30,1,162,8,11,-3
30,1,163,8,11,-3
30,1,164,6,22,-16
30,1,165,4,19,-15
30,1,166,2,13,-11
30,1,167,8,20,-12
30,1,168,7,33,-26
30,1,169,5,10,-5
30,1,170,8,20,-12
30,1,171,10,11,-1
30,1,172,9,14,-5
30,1,173,4,1,3
30,1,174,7,22,-15
30,1,175,5,25,-20
30,1,176,7,14,-7
30,1,177,6,17,-11
30,1,178,10,30,-20
30,1,179,7,18,-11
30,1,180,1,7,-6
30,1,181,16,13,3
30,1,182,4,5,-1
30,1,183,3,15,-12
30,1,184,9,6,3
30,1,185,1,16,-15
30,1,186,7,18,-11
30,1,187,5,27,-22
30,1,188,5,12,-7
30,1,189,25,25,0
30,1,190,9,41,-32
30,1,191,11,16,-5
30,1,192,6,6,0
30,1,193,8,22,-14
30,1,194,5,15,-10
30,1,195,5,12,-7
30,1,196,5,14,-9
30,1,197,2,11,-9
30,1,198,3,19,-16
30,1,199,9,26,-17
30,1,200,5,20,-15
30,1,201,4,14,-10
30,1,202,11,25,-14
30,1,203,6,26,-20
30,1,204,7,12,-5
30,1,205,9,21,-12
30,1,206,4,15,-11
30,1,207,6,38,-32
30,1,208,6,21,-15
30,1,209,12,25,-13
30,1,210,4,10,-6
30,1,211,9,12,-3
30,1,212,5,22,-17
30,1,213,3,10,-7
30,1,214,3,26,-23
30,1,215,11,30,-19
30,1,216,11,15,-4
30,1,217,7,10,-3
30,1,218,8,25,-17
30,1,219,4,19,-15
30,1,220,11,13,-2
30,1,221,10,15,-5
30,1,222,4,13,-9
30,1,223,3,9,-6
30,1,224,9,4,5
30,1,225,9,20,-11
30,1,226,3,18,-15
30,1,227,6,13,-7
30,1,228,6,25,-19
30,1,229,9,21,-12
30,1,230,9,18,-9
30,1,231,3,17,-14
30,1,232,11,20,-9
30,1,233,12,15,-3
30,1,234,10,20,-10
30,1,235,8,23,-15
30,1,236,10,20,-10
30,1,237,7,19,-12
30,1,238,1,12,-11
30,1,239,8,12,-4
30,1,240,10,14,-4
30,1,241,5,10,-5
30,1,242,8,24,-16
30,1,243,3,13,-10
30,1,244,2,17,-15
30,1,245,4,20,-16
30,1,246,7,23,-16
30,1,247,7,19,-12
30,1,248,10,12,-2
30,1,249,4,28,-24
30,1,250,4,18,-14
30,1,251,4,15,-11
30,1,252,7,18,-11
30,1,253,4,15,-11
30,1,254,10,34,-24
30,1,255,4,12,-8
30,1,256,5,5,0
30,1,257,9,16,-7
30,1,258,13,23,-10
30,1,259,0,9,-9
30,1,260,4,7,-3
30,1,261,7,13,-6
30,1,262,6,19,-13
30,1,263,11,18,-7
30,1,264,5,21,-16
30,1,265,6,27,-21
30,1,266,8,10,-2
30,1,267,4,19,-15
30,1,268,13,29,-16
30,1,269,14,27,-13
30,1,270,7,26,-19
30,1,271,12,41,-29
30,1,272,3,12,-9
30,1,273,0,15,-15
30,1,274,7,18,-11
30,1,275,6,15,-9
30,1,276,4,5,-1
30,1,277,3,30,-27
30,1,278,3,19,-16
30,1,279,5,11,-6
30,1,280,9,7,2
30,1,281,4,10,-6
30,1,282,5,16,-11
30,1,283,6,13,-7
30,1,284,4,19,-15
30,1,285,5,13,-8
30,1,286,3,6,-3
30,1,287,12,24,-12
30,1,288,6,14,-8
30,1,289,1,7,-6
30,1,290,8,26,-18
30,1,291,9,15,-6
30,1,292,0,13,-13
30,1,293,3,24,-21
30,1,294,5,17,-12
30,1,295,15,16,-1
30,1,296,4,14,-10
30,1,297,5,23,-18
30,1,298,1,18,-17
30,1,299,3,27,-24
30,2,0,4,13,-9
30,2,1,9,32,-23
30,2,2,2,16,-14
30,2,3,18,20,-2
30,2,4,4,22,-18
30,2,5,5,24,-19
30,2,6,14,21,-7
30,2,7,15,18,-3
30,2,8,5,18,-13
30,2,9,13,14,-1
30,2,10,7,23,-16
30,2,11,18,35,-17
30,2,12,7,10,-3
30,2,13,11,22,-11
30,2,14,4,10,-6
30,2,15,7,12,-5
30,2,16,1,17,-16
30,2,17,9,23,-14
30,2,18,3,15,-12
30,2,19,6,21,-15
30,2,20,11,24,-13
30,2,21,3,8,-5
30,2,22,5,15,-10
30,2,23,4,14,-10
30,2,24,7,19,-12
30,2,25,4,24,-20
30,2,26,20,25,-5
30,2,27,8,19,-11
30,2,28,2,16,-14
30,2,29,9,12,-3
30,2,30,5,33,-28
30,2,31,10,31,-21
30,2,32,9,23,-14
30,2,33,5,16,-11
30,2,34,4,14,-10
30,2,35,2,20,-18
30,2,36,6,9,-3
30,2,37,3,16,-13
30,2,38,9,9,0
30,2,39,3,18,-15
30,2,40,13,19,-6
30,2,41,19,30,-11
30,2,42,9,28,-19
30,2,43,6,14,-8
30,2,44,4,12,-8
30,2,45,8,37,-29
30,2,46,3,10,-7
30,2,47,7,23,-16
30,2,48,14,21,-7
30,2,49,12,11,1
30,2,50,4,8,-4
30,2,51,12,27,-15
30,2,52,12,22,-10
30,2,53,5,16,-11
30,2,54,7,7,0
30,2,55,8,20,-12
30,2,56,6,18,-12
30,2,57,2,28,-26
30,2,58,6,19,-13
30,2,59,12,22,-10
30,2,60,0,13,-13
30,2,61,7,31,-24
30,2,62,13,22,-9
30,2,63,5,18,-13
30,2,64,1,29,-28
30,2,65,10,12,-2
30,2,66,11,30,-19
30,2,67,3,25,-22
30,2,68,3,12,-9
30,2,69,7,11,-4
30,2,70,9,21,-12
30,2,71,5,23,-18
30,2,72,14,16,-2
30,2,73,5,14,-9
30,2,74,9,30,-21
30,2,75,5,17,-12
30,2,76,7,24,-17
30,2,77,4,10,-6
30,2,78,4,9,-5
30,2,79,6,15,-9
30,2,80,1,16,-15
30,2,81,4,16,-12
30,2,82,10,21,-11
30,2,83,2,15,-13
30,2,84,3,20,-17
30,2,85,17,29,-12
30,2,86,10,18,-8
30,2,87,6,12,-6
30,2,88,2,15,-13
30,2,89,6,17,-11
30,2,90,5,8,-3
30,2,91,4,27,-23
30,2,92,7,35,-28
30,2,93,6,35,-29
30,2,94,6,10,-4
30,2,95,6,10,-4
30,2,96,3,17,-14
30,2,97,11,26,-15
30,2,98,11,17,-6
30,2,99,5,17,-12
30,2,100,0,22,-22
30,2,101,2,17,-15
30,2,102,9,33,-24
30,2,103,1,19,-18
30,2,104,8,17,-9
30,2,105,10,10,0
30,2,106,10,25,-15
30,2,107,10,19,-9
30,2,108,3,8,-5
30,2,109,6,11,-5
30,2,110,8,29,-21
30,2,111,11,26,-15
30,2,112,6,16,-10
30,2,113,11,23,-12
30,2,114,1,5,-4
30,2,115,2,14,-12
30,2,116,12,22,-10
30,2,117,9,5,4
30,2,118,11,27,-16
30,2,119,5,20,-15
30,2,120,2,10,-8
30,2,121,8,23,-15
30,2,122,9,23,-14
30,2,123,13,11,2
30,2,124,6,9,-3
30,2,125,3,22,-19
30,2,126,8,13,-5
30,2,127,15,25,-10
30,2,128,3,14,-11
30,2,129,7,12,-5
30,2,130,15,22,-7
30,2,131,4,14,-10
30,2,132,1,13,-12
30,2,133,6,32,-26
30,2,134,7,13,-6
30,2,135,16,30,-14
30,2,136,4,15,-11
30,2,137,2,21,-19
30,2,138,5,17,-12
30,2,139,4,18,-14
30,2,140,4,15,-11
30,2,141,11,16,-5
30,2,142,4,6,-2
30,2,143,5,17,-12
30,2,144,4,7,-3
30,2,145,15,33,-18
30,2,146,15,20,-5
30,2,147,6,28,-22
30,2,148,10,20,-10
30,2,149,0,17,-17
30,2,150,4,14,-10
30,2,151,12,14,-2
30,2,152,12,24,-12
30,2,153,7,24,-17
30,2,154,3,9,-6
30,2,155,6,12,-6
30,2,156,6,20,-14
30,2,157,4,22,-18
30,2,158,14,22,-8
30,2,159,8,27,-19
30,2,160,18,22,-4
30,2,161,6,1,5
30,2,162,11,15,-4
30,2,163,7,21,-14
30,2,164,6,17,-11
30,2,165,2,15,-13
30,2,166,15,19,-4
30,2,167,7,23,-16
30,2,168,10,21,-11
30,2,169,7,15,-8
30,2,170,11,23,-12
30,2,171,2,18,-16
30,2,172,3,14,-11
30,2,173,7,20,-13
30,2,174,12,13,-1
30,2,175,10,20,-10
30,2,176,17,33,-16
30,2,177,4,8,-4
30,2,178,4,31,-27
30,2,179,7,26,-19
30,2,180,2,10,-8
30,2,181,4,21,-17
30,2,182,7,10,-3
30,2,183,4,11,-7
30,2,184,0,14,-14
30,2,185,14,11,3
30,2,186,3,20,-17
30,2,187,5,17,-12
30,2,188,9,26,-17
30,2,189,1,27,-26
30,2,190,3,10,-7
30,2,191,6,14,-8
30,2,192,8,33,-25
30,2,193,5,11,-6
30,2,194,9,24,-15
30,2,195,3,14,-11
30,2,196,12,19,-7
30,2,197,18,27,-9
30,2,198,4,7,-3
30,2,199,11,27,-16
30,2,200,8,23,-15
30,2,201,5,14,-9
30,2,202,18,15,3
30,2,203,3,11,-8
30,2,204,8,19,-11
30,2,205,5,13,-8
30,2,206,4,12,-8
30,2,207,9,20,-11
30,2,208,8,12,-4
30,2,209,16,33,-17
30,2,210,5,19,-14
30,2,211,10,29,-19
30,2,212,8,19,-11
30,2,213,16,37,-21
30,2,214,3,15,-12
30,2,215,4,30,-26
30,2,216,8,23,-15
30,2,217,6,19,-13
30,2,218,2,31,-29
30,2,219,6,10,-4
30,2,220,7,17,-10
30,2,221,4,11,-7
30,2,222,8,8,0
30,2,223,2,4,-2
30,2,224,20,24,-4
30,2,225,10,22,-12
30,2,226,11,14,-3
30,2,227,2,12,-10
30,2,228,7,9,-2
30,2,229,14,17,-3
30,2,230,5,11,-6
30,2,231,1,22,-21
30,2,232,2,11,-9
30,2,233,2,9,-7
30,2,234,14,21,-7
30,2,235,8,20,-12
30,2,236,6,14,-8
30,2,237,7,29,-22
30,2,238,11,10,1
30,2,239,5,12,-7
30,2,240,9,24,-15
30,2,241,5,11,-6
30,2,242,3,24,-21
30,2,243,10,29,-19
30,2,244,10,21,-11
30,2,245,3,12,-9
30,2,246,6,13,-7
30,2,247,6,20,-14
30,2,248,4,26,-22
30,2,249,10,46,-36
30,2,250,12,31,-19
30,2,251,9,8,1
30,2,252,1,13,-12
30,2,253,18,17,1
30,2,254,7,24,-17
30,2,255,2,16,-14
30,2,256,8,16,-8
30,2,257,9,18,-9
30,2,258,18,21,-3
30,2,259,9,19,-10
30,2,260,10,23,-13
30,2,261,5,16,-11
30,2,262,6,31,-25
30,2,263,14,10,4
30,2,264,13,30,-17
30,2,265,12,9,3
30,2,266,14,21,-7
30,2,267,6,12,-6
30,2,268,4,20,-16
30,2,269,5,9,-4
30,2,270,3,30,-27
30,2,271,9,19,-10
30,2,272,8,36,-28
30,2,273,10,25,-15
30,2,274,13,24,-11
30,2,275,2,12,-10
30,2,276,8,38,-30
30,2,277,11,17,-6
30,2,278,8,18,-10
30,2,279,9,30,-21
30,2,280,12,32,-20
30,2,281,6,23,-17
30,2,282,8,19,-11
30,2,283,13,13,0
30,2,284,10,28,-18
30,2,285,11,18,-7
30,2,286,9,20,-11
30,2,287,6,12,-6
30,2,288,3,20,-17
30,2,289,5,21,-16
30,2,290,7,12,-5
30,2,291,8,15,-7
30,2,292,3,14,-11
30,2,293,2,17,-15
30,2,294,9,22,-13
30,2,295,6,19,-13
30,2,296,6,16,-10
30,2,297,9,33,-24
30,2,298,5,9,-4
30,2,299,9,25,-16
30,3,0,5,17,-12
30,3,1,9,20,-11
30,3,2,4,13,-9
30,3,3,7,22,-15
30,3,4,9,17,-8
30,3,5,6,8,-2
30,3,6,5,15,-10
30,3,7,7,23,-16
30,3,8,12,21,-9
30,3,9,4,13,-9
30,3,10,4,26,-22
30,3,11,10,19,-9
30,3,12,11,32,-21
30,3,13,11,23,-12
30,3,14,5,24,-19
30,3,15,7,12,-5
30,3,16,9,24,-15
30,3,17,12,27,-15
30,3,18,2,13,-11
30,3,19,7,24,-17
30,3,20,9,11,-2
30,3,21,5,15,-10
30,3,22,10,16,-6
30,3,23,2,17,-15
30,3,24,10,24,-14
30,3,25,7,20,-13
30,3,26,6,13,-7
30,3,27,12,24,-12
30,3,28,12,9,3
30,3,29,13,29,-16
30,3,30,7,21,-14
30,3,31,13,24,-11
30,3,32,11,23,-12
30,3,33,9,9,0
30,3,34,4,15,-11
30,3,35,4,17,-13
30,3,36,6,14,-8
30,3,37,12,25,-13
30,3,38,12,9,3
30,3,39,11,8,3
30,3,40,11,30,-19
30,3,41,14,37,-23
30,3,42,6,19,-13
30,3,43,5,12,-7
30,3,44,6,25,-19
30,3,45,7,15,-8
30,3,46,11,19,-8
30,3,47,7,17,-10
30,3,48,3,5,-2
30,3,49,5,10,-5
30,3,50,9,31,-22
30,3,51,7,27,-20
30,3,52,7,23,-16
30,3,53,4,11,-7
30,3,54,11,26,-15
30,3,55,5,17,-12
30,3,56,10,15,-5
30,3,57,1,18,-17
30,3,58,5,19,-14
30,3,59,0,13,-13
30,3,60,2,16,-14
30,3,61,5,11,-6
30,3,62,1,20,-19
30,3,63,2,10,-8
30,3,64,5,10,-5
30,3,65,3,10,-7
30,3,66,9,18,-9
30,3,67,7,19,-12
30,3,68,4,31,-27
30,3,69,7,10,-3
30,3,70,6,10,-4
30,3,71,9,19,-10
30,3,72,5,23,-18
30,3,73,17,11,6
30,3,74,3,17,-14
30,3,75,8,18,-10
30,3,76,12,20,-8
30,3,77,14,22,-8
30,3,78,14,25,-11
30,3,79,7,23,-16
30,3,80,3,28,-25
30,3,81,7,9,-2
30,3,82,12,13,-1
30,3,83,9,22,-13
30,3,84,8,20,-12
30,3,85,5,21,-16
30,3,86,12,14,-2
30,3,87,14,41,-27
30,3,88,4,34,-30
30,3,89,15,24,-9
30,3,90,5,14,-9
30,3,91,9,29,-20
30,3,92,4,8,-4
30,3,93,1,29,-28
30,3,94,7,16,-9
30,3,95,12,23,-11
30,3,96,11,18,-7
30,3,97,5,14,-9
30,3,98,15,17,-2
30,3,99,7,24,-17
30,3,100,7,14,-7
30,3,101,7,32,-25
30,3,102,2,20,-18
30,3,103,9,31,-22
30,3,104,15,24,-9
30,3,105,10,27,-17
30,3,106,11,13,-2
30,3,107,3,6,-3
30,3,108,3,9,-6
30,3,109,5,29,-24
30,3,110,8,32,-24
30,3,111,6,16,-10
30,3,112,10,15,-5
30,3,113,8,23,-15
30,3,114,11,18,-7
30,3,115,10,19,-9
30,3,116,16,21,-5
30,3,117,5,31,-26
30,3,118,5,10,-5
30,3,119,11,33,-22
30,3,120,12,16,-4
30,3,121,1,12,-11
30,3,122,4,22,-18
30,3,123,10,22,-12
30,3,124,9,19,-10
30,3,125,2,10,-8
30,3,126,14,20,-6
30,3,127,9,20,-11
30,3,128,8,11,-3
30,3,129,8,22,-14
30,3,130,5,9,-4
30,3,131,3,31,-28
30,3,132,9,21,-12
30,3,133,11,24,-13
30,3,134,8,28,-20
30,3,135,8,10,-2
30,3,136,13,21,-8
30,3,137,5,18,-13
30,3,138,6,9,-3
30,3,139,7,37,-30
30,3,140,5,18,-13
30,3,141,4,5,-1
30,3,142,16,30,-14
30,3,143,6,13,-7
30,3,144,9,28,-19
30,3,145,9,25,-16
30,3,146,4,16,-12
30,3,147,7,27,-20
30,3,148,2,20,-18
30,3,149,6,18,-12
30,3,150,7,18,-11
30,3,151,5,5,0
30,3,152,8,24,-16
30,3,153,6,32,-26
30,3,154,8,7,1
30,3,155,8,21,-13
30,3,156,5,21,-16
30,3,157,11,14,-3
30,3,158,14,23,-9
30,3,159,7,33,-26
30,3,160,14,36,-22
30,3,161,3,11,-8
30,3,162,3,18,-15
30,3,163,0,21,-21
30,3,164,14,17,-3
30,3,165,14,19,-5
30,3,166,10,13,-3
30,3,167,8,10,-2
30,3,168,4,15,-11
30,3,169,7,25,-18
30,3,170,7,11,-4
30,3,171,6,13,-7
30,3,172,9,11,-2
30,3,173,7,18,-11
30,3,174,5,10,-5
30,3,175,15,27,-12
30,3,176,11,21,-10
30,3,177,10,25,-15
30,3,178,13,32,-19
30,3,179,12,14,-2
30,3,180,14,24,-10
30,3,181,8,36,-28
30,3,182,7,11,-4
30,3,183,1,19,-18
30,3,184,5,13,-8
30,3,185,7,15,-8
30,3,186,5,12,-7
30,3,187,5,16,-11
30,3,188,10,29,-19
30,3,189,3,20,-17
30,3,190,3,24,-21
30,3,191,19,17,2
30,3,192,4,16,-12
30,3,193,3,17,-14
30,3,194,3,23,-20
30,3,195,4,8,-4
30,3,196,3,17,-14
30,3,197,6,17,-11
30,3,198,8,10,-2
30,3,199,4,21,-17
30,3,200,7,22,-15
30,3,201,14,51,-37
30,3,202,5,21,-16
30,3,203,12,18,-6
30,3,204,1,30,-29
30,3,205,3,18,-15
30,3,206,2,17,-15
30,3,207,16,28,-12
30,3,208,6,29,-23
30,3,209,8,17,-9
30,3,210,7,12,-5
30,3,211,10,16,-6
30,3,212,4,10,-6
30,3,213,1,7,-6
30,3,214,9,11,-2
30,3,215,12,46,-34
30,3,216,6,13,-7
30,3,217,3,6,-3
30,3,218,3,9,-6
30,3,219,10,20,-10
30,3,220,14,26,-12
30,3,221,7,22,-15
30,3,222,9,32,-23
30,3,223,7,8,-1
30,3,224,9,25,-16
30,3,225,6,17,-11
30,3,226,12,14,-2
30,3,227,4,24,-20
30,3,228,8,21,-13
30,3,229,8,25,-17
30,3,230,10,33,-23
30,3,231,7,20,-13
30,3,232,2,17,-15
30,3,233,9,10,-1
30,3,234,5,6,-1
30,3,235,8,9,-1
30,3,236,13,19,-6
30,3,237,11,28,-17
30,3,238,4,21,-17
30,3,239,8,14,-6
30,3,240,14,32,-18
30,3,241,3,20,-17
30,3,242,2,16,-14
30,3,243,6,16,-10
30,3,244,0,10,-10
30,3,245,15,37,-22
30,3,246,8,19,-11
30,3,247,3,34,-31
30,3,248,14,14,0
30,3,249,5,9,-4
30,3,250,8,20,-12
30,3,251,7,25,-18
30,3,252,5,24,-19
30,3,253,5,17,-12
30,3,254,12,17,-5
30,3,255,9,29,-20
30,3,256,14,21,-7
30,3,257,3,8,-5
30,3,258,12,11,1
30,3,259,10,13,-3
30,3,260,8,27,-19
30,3,261,10,15,-5
30,3,262,7,25,-18
30,3,263,3,17,-14
30,3,264,8,21,-13
30,3,265,13,37,-24
30,3,266,2,18,-16
30,3,267,12,17,-5
30,3,268,2,12,-10
30,3,269,8,34,-26
30,3,270,9,10,-1
30,3,271,7,8,-1
30,3,272,3,32,-29
30,3,273,8,19,-11
30,3,274,11,31,-20
30,3,275,11,14,-3
30,3,276,9,27,-18
30,3,277,3,7,-4
30,3,278,6,21,-15
30,3,279,7,19,-12
30,3,280,9,22,-13
30,3,281,3,8,-5
30,3,282,2,15,-13
30,3,283,5,8,-3
30,3,284,6,16,-10
30,3,285,18,29,-11
30,3,286,5,18,-13
30,3,287,6,11,-5
30,3,288,7,13,-6
30,3,289,7,18,-11
30,3,290,6,23,-17
30,3,291,7,11,-4
30,3,292,5,24,-19
30,3,293,13,38,-25
30,3,294,5,8,-3
30,3,295,4,18,-14
30,3,296,3,22,-19
30,3,297,7,18,-11
30,3,298,8,27,-19
30,3,299,11,43,-32
30,4,0,5,20,-15
30,4,1,7,10,-3
30,4,2,15,27,-12
30,4,3,3,16,-13
30,4,4,12,26,-14
30,4,5,15,14,1
30,4,6,11,26,-15
30,4,7,5,19,-14
30,4,8,12,19,-7
30,4,9,11,26,-15
30,4,10,6,6,0
30,4,11,15,23,-8
30,4,12,3,24,-21
30,4,13,17,17,0
30,4,14,4,20,-16
30,4,15,12,37,-25
30,4,16,11,17,-6
30,4,17,8,5,3
30,4,18,8,27,-19
30,4,19,6,21,-15
30,4,20,19,25,-6
30,4,21,18,24,-6
30,4,22,12,15,-3
30,4,23,6,20,-14
30,4,24,8,27,-19
30,4,25,11,26,-15
30,4,26,10,30,-20
30,4,27,13,24,-11
30,4,28,1,9,-8
30,4,29,7,14,-7
30,4,30,7,18,-11
30,4,31,7,39,-32
30,4,32,19,48,-29
30,4,33,5,10,-5
30,4,34,12,28,-16
30,4,35,5,17,-12
30,4,36,8,17,-9
30,4,37,5,12,-7
30,4,38,7,37,-30
30,4,39,3,23,-20
30,4,40,8,17,-9
30,4,41,6,10,-4
30,4,42,11,23,-12
30,4,43,3,21,-18
30,4,44,7,13,-6
30,4,45,3,15,-12
30,4,46,12,18,-6
30,4,47,9,13,-4
30,4,48,2,6,-4
30,4,49,8,15,-7
30,4,50,4,11,-7
30,4,51,5,22,-17
30,4,52,9,14,-5
30,4,53,10,14,-4
30,4,54,9,40,-31
30,4,55,5,24,-19
30,4,56,6,16,-10
30,4,57,10,16,-6
30,4,58,13,17,-4
30,4,59,11,26,-15
30,4,60,5,14,-9
30,4,61,4,22,-18
30,4,62,8,15,-7
30,4,63,5,19,-14
30,4,64,7,14,-7
30,4,65,11,13,-2
30,4,66,14,20,-6
30,4,67,10,8,2
30,4,68,2,13,-11
30,4,69,12,19,-7
30,4,70,5,15,-10
30,4,71,15,12,3
30,4,72,21,27,-6
30,4,73,5,17,-12
30,4,74,10,25,-15
30,4,75,9,16,-7
30,4,76,2,10,-8
30,4,77,17,38,-21
30,4,78,8,16,-8
30,4,79,4,16,-12
30,4,80,8,21,-13
30,4,81,11,6,5
30,4,82,13,21,-8
30,4,83,9,21,-12
30,4,84,4,12,-8
30,4,85,15,20,-5
30,4,86,14,22,-8
30,4,87,12,18,-6
30,4,88,5,25,-20
30,4,89,3,25,-22
30,4,90,8,24,-16
30,4,91,6,14,-8
30,4,92,5,13,-8
30,4,93,7,28,-21
30,4,94,11,11,0
30,4,95,15,9,6
30,4,96,10,20,-10
30,4,97,11,30,-19
30,4,98,8,22,-14
30,4,99,6,9,-3
30,4,100,10,32,-22
30,4,101,15,31,-16
30,4,102,8,12,-4
30,4,103,14,24,-10
30,4,104,18,27,-9
30,4,105,7,13,-6
30,4,106,9,19,-10
30,4,107,7,29,-22
30,4,108,9,23,-14
30,4,109,3,10,-7
30,4,110,6,11,-5
30,4,111,11,43,-32
30,4,112,11,34,-23
30,4,113,6,19,-13
30,4,114,8,34,-26
30,4,115,10,42,-32
30,4,116,10,27,-17
30,4,117,8,21,-13
30,4,118,15,13,2
30,4,119,7,18,-11
30,4,120,6,23,-17
30,4,121,8,13,-5
30,4,122,4,24,-20
30,4,123,12,36,-24
30,4,124,9,28,-19
30,4,125,3,15,-12
30,4,126,6,21,-15
30,4,127,15,29,-14
30,4,128,4,23,-19
30,4,129,6,12,-6
30,4,130,8,18,-10
30,4,131,10,28,-18
30,4,132,8,29,-21
30,4,133,3,7,-4
30,4,134,12,13,-1
30,4,135,6,22,-16
30,4,136,7,25,-18
30,4,137,8,16,-8
30,4,138,7,30,-23
30,4,139,4,21,-17
30,4,140,9,40,-31
30,4,141,5,37,-32
30,4,142,9,9,0
30,4,143,11,32,-21
30,4,144,4,9,-5
30,4,145,3,14,-11
30,4,146,7,19,-12
30,4,147,9,19,-10
30,4,148,4,15,-11
30,4,149,8,24,-16
30,4,150,9,26,-17
30,4,151,11,9,2
30,4,152,11,25,-14
30,4,153,5,19,-14
30,4,154,3,20,-17
30,4,155,4,14,-10
30,4,156,6,18,-12
30,4,157,7,15,-8
30,4,158,14,14,0
30,4,159,11,25,-14
30,4,160,5,18,-13
30,4,161,5,42,-37
30,4,162,9,30,-21
30,4,163,4,9,-5
30,4,164,7,12,-5
30,4,165,10,16,-6
30,4,166,6,21,-15
30,4,167,4,15,-11
30,4,168,10,25,-15
30,4,169,3,10,-7
30,4,170,7,29,-22
30,4,171,4,21,-17
30,4,172,9,29,-20
30,4,173,9,27,-18
30,4,174,9,26,-17
30,4,175,7,21,-14
30,4,176,1,21,-20
30,4,177,3,8,-5
30,4,178,15,31,-16
30,4,179,9,12,-3
30,4,180,6,22,-16
30,4,181,6,26,-20
30,4,182,6,11,-5
30,4,183,11,14,-3
30,4,184,14,13,1
30,4,185,13,25,-12
30,4,186,10,11,-1
30,4,187,9,20,-11
30,4,188,11,20,-9
30,4,189,9,24,-15
30,4,190,13,22,-9
30,4,191,7,33,-26
30,4,192,9,28,-19
30,4,193,5,25,-20
30,4,194,12,18,-6
30,4,195,5,16,-11
30,4,196,4,13,-9
30,4,197,15,30,-15
30,4,198,1,15,-14
30,4,199,5,22,-17
30,4,200,16,18,-2
30,4,201,5,26,-21
30,4,202,14,23,-9
30,4,203,3,14,-11
30,4,204,6,19,-13
30,4,205,7,20,-13
30,4,206,9,19,-10
30,4,207,2,29,-27
30,4,208,12,20,-8
30,4,209,11,30,-19
30,4,210,9,29,-20
30,4,211,5,21,-16
30,4,212,9,16,-7
30,4,213,11,32,-21
30,4,214,6,19,-13
30,4,215,11,20,-9
30,4,216,7,27,-20
30,4,217,15,26,-11
30,4,218,9,12,-3
30,4,219,1,8,-7
30,4,220,7,14,-7
30,4,221,18,26,-8
30,4,222,8,20,-12
30,4,223,9,21,-12
30,4,224,8,10,-2
30,4,225,8,20,-12
30,4,226,10,24,-14
30,4,227,6,21,-15
30,4,228,5,10,-5
30,4,229,13,28,-15
30,4,230,10,13,-3
30,4,231,0,11,-11
30,4,232,10,26,-16
30,4,233,5,25,-20
30,4,234,12,29,-17
30,4,235,12,19,-7
30,4,236,5,39,-34
30,4,237,9,21,-12
30,4,238,11,26,-15
30,4,239,2,10,-8
30,4,240,8,13,-5
30,4,241,4,26,-22
30,4,242,5,21,-16
30,4,243,7,18,-11
30,4,244,0,18,-18
30,4,245,5,28,-23
30,4,246,0,12,-12
30,4,247,4,25,-21
30,4,248,5,22,-17
30,4,249,8,27,-19
30,4,250,3,16,-13
30,4,251,22,40,-18
30,4,252,4,15,-11
30,4,253,17,22,-5
30,4,254,8,14,-6
30,4,255,3,14,-11
30,4,256,6,8,-2
30,4,257,4,25,-21
30,4,258,6,17,-11
30,4,259,2,26,-24
30,4,260,4,28,-24
30,4,261,8,23,-15
30,4,262,14,19,-5
30,4,263,4,7,-3
30,4,264,6,27,-21
30,4,265,6,23,-17
30,4,266,6,14,-8
30,4,267,10,19,-9
30,4,268,9,14,-5
30,4,269,6,25,-19
30,4,270,3,14,-11
30,4,271,13,17,-4
30,4,272,7,11,-4
30,4,273,10,18,-8
30,4,274,5,18,-13
30,4,275,15,32,-17
30,4,276,10,12,-2
30,4,277,17,32,-15
30,4,278,11,21,-10
30,4,279,13,32,-19
30,4,280,5,37,-32
30,4,281,6,19,-13
30,4,282,11,22,-11
30,4,283,6,10,-4
30,4,284,10,11,-1
30,4,285,14,23,-9
30,4,286,11,15,-4
30,4,287,3,24,-21
30,4,288,8,17,-9
30,4,289,10,25,-15
30,4,290,10,15,-5
30,4,291,15,18,-3
30,4,292,5,24,-19
30,4,293,13,31,-18
30,4,294,5,10,-5
30,4,295,6,16,-10
30,4,296,11,15,-4
30,4,297,6,19,-13
30,4,298,7,25,-18
30,4,299,2,10,-8
30,5,0,6,29,-23
30,5,1,6,29,-23
30,5,2,8,26,-18
30,5,3,22,41,-19
30,5,4,11,16,-5
30,5,5,6,25,-19
30,5,6,15,37,-22
30,5,7,9,17,-8
30,5,8,13,26,-13
30,5,9,5,27,-22
30,5,10,5,4,1
30,5,11,6,11,-5
30,5,12,5,18,-13
30,5,13,7,30,-23
30,5,14,5,16,-11
30,5,15,3,18,-15
30,5,16,5,30,-25
30,5,17,5,15,-10
30,5,18,9,21,-12
30,5,19,7,8,-1
30,5,20,5,25,-20
30,5,21,6,11,-5
30,5,22,10,26,-16
30,5,23,16,16,0
30,5,24,11,21,-10
30,5,25,8,25,-17
30,5,26,13,21,-8
30,5,27,5,29,-24
30,5,28,5,13,-8
30,5,29,4,16,-12
30,5,30,7,25,-18
30,5,31,15,11,4
30,5,32,9,27,-18
30,5,33,7,16,-9
30,5,34,2,17,-15
30,5,35,5,17,-12
30,5,36,7,21,-14
30,5,37,8,25,-17
30,5,38,11,29,-18
30,5,39,9,28,-19
30,5,40,5,31,-26
30,5,41,7,15,-8
30,5,42,13,15,-2
30,5,43,3,18,-15
30,5,44,6,22,-16
30,5,45,7,30,-23
30,5,46,16,24,-8
30,5,47,7,13,-6
30,5,48,8,18,-10
30,5,49,1,18,-17
30,5,50,4,18,-14
30,5,51,11,17,-6
30,5,52,4,30,-26
30,5,53,7,17,-10
30,5,54,10,11,-1
30,5,55,5,17,-12
30,5,56,3,16,-13
30,5,57,4,19,-15
30,5,58,9,15,-6
30,5,59,13,31,-18
30,5,60,4,31,-27
30,5,61,4,25,-21
30,5,62,4,9,-5
30,5,63,10,23,-13
30,5,64,6,10,-4
30,5,65,19,40,-21
30,5,66,8,18,-10
30,5,67,7,28,-21
30,5,68,4,20,-16
30,5,69,3,28,-25
30,5,70,10,28,-18
30,5,71,8,14,-6
30,5,72,3,13,-10
30,5,73,6,12,-6
30,5,74,1,18,-17
30,5,75,11,24,-13
30,5,76,11,36,-25
30,5,77,4,8,-4
30,5,78,3,24,-21
30,5,79,7,10,-3
30,5,80,6,12,-6
30,5,81,14,24,-10
30,5,82,7,28,-21
30,5,83,15,33,-18
30,5,84,6,20,-14
30,5,85,5,25,-20
30,5,86,7,20,-13
30,5,87,9,17,-8
30,5,88,7,21,-14
30,5,89,12,26,-14
30,5,90,11,14,-3
30,5,91,3,32,-29
30,5,92,8,15,-7
30,5,93,14,16,-2
30,5,94,11,43,-32
30,5,95,8,12,-4
30,5,96,15,14,1
30,5,97,9,27,-18
30,5,98,10,16,-6
30,5,99,9,19,-10
30,5,100,5,38,-33
30,5,101,4,8,-4
30,5,102,8,12,-4
30,5,103,4,17,-13
30,5,104,10,6,4
30,5,105,13,48,-35
30,5,106,14,14,0
30,5,107,7,23,-16
30,5,108,0,4,-4
30,5,109,16,12,4
30,5,110,10,21,-11
30,5,111,4,26,-22
30,5,112,10,37,-27
30,5,113,4,25,-21
30,5,114,5,15,-10
30,5,115,14,15,-1
30,5,116,7,12,-5
30,5,117,10,30,-20
30,5,118,2,16,-14
30,5,119,10,22,-12
30,5,120,7,21,-14
30,5,121,9,27,-18
30,5,122,10,25,-15
30,5,123,9,21,-12
30,5,124,8,33,-25
30,5,125,9,13,-4
30,5,126,0,14,-14
30,5,127,8,16,-8
30,5,128,5,25,-20
30,5,129,3,14,-11
30,5,130,7,13,-6
30,5,131,7,10,-3
30,5,132,8,23,-15
30,5,133,8,36,-28
30,5,134,5,12,-7
30,5,135,9,17,-8
30,5,136,9,26,-17
30,5,137,11,26,-15
30,5,138,3,8,-5
30,5,139,4,19,-15
30,5,140,12,18,-6
30,5,141,18,26,-8
30,5,142,12,39,-27
30,5,143,19,17,2
30,5,144,4,15,-11
30,5,145,2,10,-8
30,5,146,1,12,-11
30,5,147,2,21,-19
30,5,148,9,16,-7
30,5,149,10,31,-21
30,5,150,11,19,-8
30,5,151,7,19,-12
30,5,152,11,22,-11
30,5,153,10,16,-6
30,5,154,10,24,-14
30,5,155,4,7,-3
30,5,156,8,19,-11
30,5,157,9,24,-15
30,5,158,3,11,-8
30,5,159,7,27,-20
30,5,160,9,21,-12
30,5,161,4,19,-15
30,5,162,12,17,-5
30,5,163,5,22,-17
30,5,164,13,25,-12
30,5,165,8,23,-15
30,5,166,5,13,-8
30,5,167,6,31,-25
30,5,168,10,28,-18
30,5,169,10,13,-3
30,5,170,12,29,-17
30,5,171,13,10,3
30,5,172,7,33,-26
30,5,173,10,17,-7
30,5,174,7,30,-23
30,5,175,14,21,-7
30,5,176,12,17,-5
30,5,177,7,19,-12
30,5,178,5,14,-9
30,5,179,12,20,-8
30,5,180,10,32,-22
30,5,181,7,10,-3
30,5,182,7,35,-28
30,5,183,10,18,-8
30,5,184,6,23,-17
30,5,185,5,13,-8
30,5,186,16,36,-20
30,5,187,10,18,-8
30,5,188,0,17,-17
30,5,189,11,28,-17
30,5,190,5,18,-13
30,5,191,7,23,-16
30,5,192,9,32,-23
30,5,193,15,26,-11
30,5,194,2,4,-2
30,5,195,16,22,-6
30,5,196,4,14,-10
30,5,197,6,18,-12
30,5,198,3,18,-15
30,5,199,4,27,-23
30,5,200,6,32,-26
30,5,201,4,13,-9
30,5,202,9,14,-5
30,5,203,10,24,-14
30,5,204,4,12,-8
30,5,205,18,17,1
30,5,206,8,13,-5
30,5,207,6,26,-20
30,5,208,13,28,-15
30,5,209,14,22,-8
30,5,210,8,23,-15
30,5,211,4,18,-14
30,5,212,12,23,-11
30,5,213,10,19,-9
30,5,214,8,27,-19
30,5,215,12,26,-14
30,5,216,11,9,2
30,5,217,8,14,-6
30,5,218,1,11,-10
30,5,219,9,13,-4
30,5,220,7,9,-2
30,5,221,6,7,-1
30,5,222,2,16,-14
30,5,223,7,17,-10
30,5,224,6,21,-15
30,5,225,4,16,-12
30,5,226,7,13,-6
30,5,227,14,25,-11
30,5,228,4,28,-24
30,5,229,4,12,-8
30,5,230,7,16,-9
30,5,231,10,18,-8
30,5,232,9,26,-17
30,5,233,9,35,-26
30,5,234,17,25,-8
30,5,235,12,20,-8
30,5,236,2,19,-17
30,5,237,7,26,-19
30,5,238,8,33,-25
30,5,239,6,19,-13
30,5,240,8,40,-32
30,5,241,8,21,-13
30,5,242,0,15,-15
30,5,243,11,32,-21
30,5,244,6,10,-4
30,5,245,3,21,-18
30,5,246,10,25,-15
30,5,247,12,24,-12
30,5,248,13,22,-9
30,5,249,10,16,-6
30,5,250,3,19,-16
30,5,251,13,21,-8
30,5,252,6,21,-15
30,5,253,14,31,-17
30,5,254,3,22,-19
30,5,255,5,8,-3
30,5,256,10,30,-20
30,5,257,2,13,-11
30,5,258,5,34,-29
30,5,259,4,22,-18
30,5,260,2,10,-8
30,5,261,3,14,-11
30,5,262,20,27,-7
30,5,263,10,17,-7
30,5,264,6,11,-5
30,5,265,9,12,-3
30,5,266,4,11,-7
30,5,267,7,18,-11
30,5,268,13,25,-12
30,5,269,6,25,-19
30,5,270,8,14,-6
30,5,271,12,19,-7
30,5,272,6,17,-11
30,5,273,12,29,-17
30,5,274,21,27,-6
30,5,275,12,30,-18
30,5,276,5,28,-23
30,5,277,7,37,-30
30,5,278,20,23,-3
30,5,279,6,26,-20
30,5,280,11,14,-3
30,5,281,7,22,-15
30,5,282,10,28,-18
30,5,283,5,19,-14
30,5,284,14,26,-12
30,5,285,16,23,-7
30,5,286,7,12,-5
30,5,287,11,20,-9
30,5,288,5,15,-10
30,5,289,13,31,-18
30,5,290,7,9,-2
30,5,291,12,33,-21
30,5,292,5,24,-19
30,5,293,9,31,-22
30,5,294,4,17,-13
30,5,295,12,34,-22
30,5,296,8,24,-16
30,5,297,12,22,-10
30,5,298,13,25,-12
30,5,299,5,27,-22
30,6,0,7,22,-15
30,6,1,15,22,-7
30,6,2,13,17,-4
30,6,3,11,28,-17
30,6,4,9,32,-23
30,6,5,6,15,-9
30,6,6,11,25,-14
30,6,7,12,23,-11
30,6,8,7,29,-22
30,6,9,6,15,-9
30,6,10,5,31,-26
30,6,11,10,14,-4
30,6,12,13,20,-7
30,6,13,11,16,-5
30,6,14,7,24,-17
30,6,15,9,21,-12
30,6,16,6,30,-24
30,6,17,7,20,-13
30,6,18,8,21,-13
30,6,19,8,16,-8
30,6,20,13,29,-16
30,6,21,4,20,-16
30,6,22,15,13,2
30,6,23,13,36,-23
30,6,24,11,12,-1
30,6,25,20,29,-9
30,6,26,2,13,-11
30,6,27,14,22,-8
30,6,28,13,20,-7
30,6,29,14,24,-10
30,6,30,5,32,-27
30,6,31,5,19,-14
30,6,32,5,9,-4
30,6,33,12,31,-19
30,6,34,7,6,1
30,6,35,7,19,-12
30,6,36,9,6,3
30,6,37,9,17,-8
30,6,38,6,27,-21
30,6,39,7,14,-7
30,6,40,9,20,-11
30,6,41,8,22,-14
30,6,42,7,16,-9
30,6,43,8,13,-5
30,6,44,8,24,-16
30,6,45,13,21,-8
30,6,46,11,24,-13
30,6,47,4,13,-9
30,6,48,9,26,-17
30,6,49,7,22,-15
30,6,50,5,25,-20
30,6,51,2,8,-6
30,6,52,5,8,-3
30,6,53,12,23,-11
30,6,54,13,15,-2
30,6,55,13,25,-12
30,6,56,7,25,-18
30,6,57,15,30,-15
30,6,58,9,19,-10
30,6,59,4,7,-3
30,6,60,5,18,-13
30,6,61,4,22,-18
30,6,62,4,12,-8
30,6,63,4,18,-14
30,6,64,9,30,-21
30,6,65,4,7,-3
30,6,66,0,7,-7
30,6,67,20,28,-8
30,6,68,11,22,-11
30,6,69,7,17,-10
30,6,70,6,23,-17
30,6,71,18,11,7
30,6,72,3,11,-8
30,6,73,11,38,-27
30,6,74,7,23,-16
30,6,75,5,22,-17
30,6,76,8,16,-8
30,6,77,10,22,-12
30,6,78,12,25,-13
30,6,79,8,16,-8
30,6,80,14,15,-1
30,6,81,3,25,-22
30,6,82,5,8,-3
30,6,83,8,19,-11
30,6,84,3,15,-12
30,6,85,7,15,-8
30,6,86,12,34,-22
30,6,87,9,27,-18
30,6,88,6,29,-23
30,6,89,3,11,-8
30,6,90,8,18,-10
30,6,91,5,11,-6
30,6,92,12,21,-9
30,6,93,4,8,-4
30,6,94,16,25,-9
30,6,95,1,10,-9
30,6,96,7,28,-21
30,6,97,9,17,-8
30,6,98,4,21,-17
30,6,99,10,23,-13
30,6,100,8,11,-3
30,6,101,7,19,-12
30,6,102,12,23,-11
30,6,103,6,22,-16
30,6,104,8,15,-7
30,6,105,7,12,-5
30,6,106,9,21,-12
30,6,107,5,18,-13
30,6,108,3,10,-7
30,6,109,10,26,-16
30,6,110,13,26,-13
30,6,111,18,23,-5
30,6,112,6,16,-10
30,6,113,9,36,-27
30,6,114,16,28,-12
30,6,115,13,22,-9
30,6,116,17,25,-8
30,6,117,13,40,-27
30,6,118,8,20,-12
30,6,119,16,23,-7
30,6,120,8,20,-12
30,6,121,8,25,-17
30,6,122,9,23,-14
30,6,123,15,16,-1
30,6,124,3,13,-10
30,6,125,5,18,-13
30,6,126,8,27,-19
30,6,127,4,20,-16
30,6,128,9,25,-16
30,6,129,17,18,-1
30,6,130,17,16,1
30,6,131,7,22,-15
30,6,132,9,10,-1
30,6,133,10,10,0
30,6,134,5,19,-14
30,6,135,17,22,-5
30,6,136,8,21,-13
30,6,137,5,10,-5
30,6,138,18,27,-9
30,6,139,10,21,-11
30,6,140,2,24,-22
30,6,141,7,16,-9
30,6,142,3,20,-17
30,6,143,5,22,-17
30,6,144,16,30,-14
30,6,145,4,19,-15
30,6,146,5,14,-9
30,6,147,10,15,-5
30,6,148,14,22,-8
30,6,149,5,18,-13
30,6,150,3,18,-15
30,6,151,8,16,-8
30,6,152,13,27,-14
30,6,153,15,28,-13
30,6,154,5,13,-8
30,6,155,7,21,-14
30,6,156,7,16,-9
30,6,157,3,9,-6
30,6,158,8,24,-16
30,6,159,4,10,-6
30,6,160,10,25,-15
30,6,161,5,18,-13
30,6,162,8,22,-14
30,6,163,11,18,-7
30,6,164,7,16,-9
30,6,165,8,15,-7
30,6,166,9,9,0
30,6,167,1,11,-10
30,6,168,6,17,-11
30,6,169,1,28,-27
30,6,170,6,25,-19
30,6,171,7,15,-8
30,6,172,4,17,-13
30,6,173,5,21,-16
30,6,174,10,33,-23
30,6,175,6,22,-16
30,6,176,0,6,-6
30,6,177,5,24,-19
30,6,178,15,23,-8
30,6,179,12,13,-1
30,6,180,10,11,-1
30,6,181,15,18,-3
30,6,182,5,13,-8
30,6,183,3,30,-27
30,6,184,7,18,-11
30,6,185,9,18,-9
30,6,186,6,15,-9
30,6,187,3,19,-16
30,6,188,12,27,-15
30,6,189,1,18,-17
30,6,190,14,28,-14
30,6,191,7,17,-10
30,6,192,15,32,-17
30,6,193,5,6,-1
30,6,194,4,14,-10
30,6,195,7,14,-7
30,6,196,2,28,-26
30,6,197,1,11,-10
30,6,198,4,18,-14
30,6,199,6,20,-14
30,6,200,12,21,-9
30,6,201,14,28,-14
30,6,202,6,12,-6
30,6,203,5,28,-23
30,6,204,2,22,-20
30,6,205,9,22,-13
30,6,206,3,23,-20
30,6,207,9,18,-9
30,6,208,11,23,-12
30,6,209,13,15,-2
30,6,210,3,11,-8
30,6,211,14,18,-4
30,6,212,7,24,-17
30,6,213,3,15,-12
30,6,214,6,24,-18
30,6,215,14,25,-11
30,6,216,9,27,-18
30,6,217,5,8,-3
30,6,218,5,28,-23
30,6,219,4,22,-18
30,6,220,14,19,-5
30,6,221,6,11,-5
30,6,222,16,12,4
30,6,223,5,34,-29
30,6,224,8,20,-12
30,6,225,10,17,-7
30,6,226,8,16,-8
30,6,227,8,23,-15
30,6,228,6,28,-22
30,6,229,8,21,-13
30,6,230,7,13,-6
30,6,231,10,19,-9
30,6,232,15,33,-18
30,6,233,9,17,-8
30,6,234,23,28,-5
30,6,235,14,32,-18
30,6,236,8,24,-16
30,6,237,12,12,0
30,6,238,4,15,-11
30,6,239,16,29,-13
30,6,240,2,12,-10
30,6,241,7,17,-10
30,6,242,6,15,-9
30,6,243,6,17,-11
30,6,244,14,30,-16
30,6,245,8,20,-12
30,6,246,8,30,-22
30,6,247,0,16,-16
30,6,248,5,15,-10
30,6,249,12,11,1
30,6,250,9,19,-10
30,6,251,10,32,-22
30,6,252,7,15,-8
30,6,253,15,24,-9
30,6,254,12,17,-5
30,6,255,8,32,-24
30,6,256,10,15,-5
30,6,257,10,20,-10
30,6,258,15,24,-9
30,6,259,0,9,-9
30,6,260,6,12,-6
30,6,261,8,24,-16
30,6,262,0,27,-27
30,6,263,5,42,-37
30,6,264,3,26,-23
30,6,265,7,13,-6
30,6,266,5,14,-9
30,6,267,15,14,1
30,6,268,8,22,-14
30,6,269,11,20,-9
30,6,270,8,28,-20
30,6,271,12,14,-2
30,6,272,7,5,2
30,6,273,2,9,-7
30,6,274,5,30,-25
30,6,275,12,14,-2
30,6,276,5,18,-13
30,6,277,7,11,-4
30,6,278,6,25,-19
30,6,279,16,24,-8
30,6,280,9,33,-24
30,6,281,14,29,-15
30,6,282,7,39,-32
30,6,283,9,23,-14
30,6,284,7,29,-22
30,6,285,7,18,-11
30,6,286,3,19,-16
30,6,287,2,43,-41
30,6,288,10,23,-13
30,6,289,14,29,-15
30,6,290,15,11,4
30,6,291,2,20,-18
30,6,292,15,19,-4
30,6,293,5,15,-10
30,6,294,13,26,-13
30,6,295,7,39,-32
30,6,296,7,26,-19
30,6,297,9,18,-9
30,6,298,2,32,-30
30,6,299,7,18,-11
30,7,0,12,24,-12
30,7,1,7,20,-13
30,7,2,10,30,-20
30,7,3,8,27,-19
30,7,4,15,26,-11
30,7,5,6,29,-23
30,7,6,11,23,-12
30,7,7,17,24,-7
30,7,8,9,27,-18
30,7,9,8,34,-26
30,7,10,13,24,-11
30,7,11,10,15,-5
30,7,12,11,18,-7
30,7,13,10,26,-16
30,7,14,5,17,-12
30,7,15,17,22,-5
30,7,16,13,18,-5
30,7,17,10,21,-11
30,7,18,3,20,-17
30,7,19,11,36,-25
30,7,20,8,37,-29
30,7,21,18,21,-3
30,7,22,11,9,2
30,7,23,8,14,-6
30,7,24,7,13,-6
30,7,25,4,18,-14
30,7,26,7,11,-4
30,7,27,12,13,-1
30,7,28,9,32,-23
30,7,29,9,23,-14
30,7,30,12,8,4
30,7,31,8,19,-11
30,7,32,9,15,-6
30,7,33,14,10,4
30,7,34,9,44,-35
30,7,35,10,19,-9
30,7,36,12,19,-7
30,7,37,10,20,-10
30,7,38,1,7,-6
30,7,39,9,22,-13
30,7,40,12,26,-14
30,7,41,10,23,-13
30,7,42,12,18,-6
30,7,43,7,15,-8
30,7,44,6,15,-9
30,7,45,8,34,-26
30,7,46,13,19,-6
30,7,47,7,21,-14
30,7,48,3,6,-3
30,7,49,5,16,-11
30,7,50,14,25,-11
30,7,51,8,23,-15
30,7,52,14,22,-8
30,7,53,9,23,-14
30,7,54,9,11,-2
30,7,55,2,10,-8
30,7,56,11,11,0
30,7,57,1,16,-15
30,7,58,8,18,-10
30,7,59,4,15,-11
30,7,60,7,20,-13
30,7,61,10,13,-3
30,7,62,8,20,-12
30,7,63,2,23,-21
30,7,64,6,16,-10
30,7,65,10,28,-18
30,7,66,15,40,-25
30,7,67,17,29,-12
30,7,68,11,30,-19
30,7,69,5,20,-15
30,7,70,12,24,-12
30,7,71,9,22,-13
30,7,72,7,28,-21
30,7,73,6,20,-14
30,7,74,5,8,-3
30,7,75,8,34,-26
30,7,76,17,40,-23
30,7,77,6,27,-21
30,7,78,7,20,-13
30,7,79,3,15,-12
30,7,80,10,18,-8
30,7,81,22,18,4
30,7,82,4,16,-12
30,7,83,5,16,-11
30,7,84,14,14,0
30,7,85,12,18,-6
30,7,86,14,31,-17
30,7,87,15,19,-4
30,7,88,2,13,-11
30,7,89,7,10,-3
30,7,90,17,39,-22
30,7,91,3,13,-10
30,7,92,11,26,-15
30,7,93,6,24,-18
30,7,94,12,23,-11
30,7,95,11,11,0
30,7,96,5,17,-12
30,7,97,5,12,-7
30,7,98,4,30,-26
30,7,99,20,29,-9
30,7,100,9,32,-23
30,7,101,5,22,-17
30,7,102,9,29,-20
30,7,103,13,15,-2
30,7,104,7,11,-4
30,7,105,8,19,-11
30,7,106,9,25,-16
30,7,107,9,9,0
30,7,108,12,21,-9
30,7,109,19,36,-17
30,7,110,7,11,-4
30,7,111,19,27,-8
30,7,112,5,19,-14
30,7,113,12,31,-19
30,7,114,11,15,-4
30,7,115,18,31,-13
30,7,116,7,26,-19
30,7,117,4,12,-8
30,7,118,9,10,-1
30,7,119,3,16,-13
30,7,120,10,16,-6
30,7,121,10,14,-4
30,7,122,8,28,-20
30,7,123,7,28,-21
30,7,124,6,35,-29
30,7,125,11,27,-16
30,7,126,11,13,-2
30,7,127,8,29,-21
30,7,128,4,19,-15
30,7,129,11,22,-11
30,7,130,13,17,-4
30,7,131,6,17,-11
30,7,132,6,21,-15
30,7,133,5,23,-18
30,7,134,9,23,-14
30,7,135,9,16,-7
30,7,136,6,17,-11
30,7,137,9,9,0
30,7,138,8,17,-9
30,7,139,13,33,-20
30,7,140,13,23,-10
30,7,141,7,22,-15
30,7,142,9,17,-8
30,7,143,11,26,-15
30,7,144,7,19,-12
30,7,145,8,30,-22
30,7,146,8,27,-19
30,7,147,9,13,-4
30,7,148,4,24,-20
30,7,149,15,27,-12
30,7,150,6,21,-15
30,7,151,10,24,-14
30,7,152,11,23,-12
30,7,153,6,11,-5
30,7,154,6,26,-20
30,7,155,9,28,-19
30,7,156,2,9,-7
30,7,157,9,21,-12
30,7,158,6,16,-10
30,7,159,7,22,-15
30,7,160,5,18,-13
30,7,161,11,22,-11
30,7,162,13,8,5
30,7,163,6,13,-7
30,7,164,10,24,-14
30,7,165,12,10,2
30,7,166,16,14,2
30,7,167,11,8,3
30,7,168,3,9,-6
30,7,169,5,9,-4
30,7,170,8,14,-6
30,7,171,12,21,-9
30,7,172,12,27,-15
30,7,173,3,22,-19
30,7,174,4,21,-17
30,7,175,2,25,-23
30,7,176,7,18,-11
30,7,177,7,13,-6
30,7,178,11,9,2
30,7,179,8,16,-8
30,7,180,10,15,-5
30,7,181,15,33,-18
30,7,182,3,15,-12
30,7,183,11,24,-13
30,7,184,12,23,-11
30,7,185,5,15,-10
30,7,186,14,23,-9
30,7,187,10,17,-7
30,7,188,8,15,-7
30,7,189,7,17,-10
30,7,190,9,29,-20
30,7,191,7,23,-16
30,7,192,11,16,-5
30,7,193,15,28,-13
30,7,194,8,34,-26
30,7,195,17,22,-5
30,7,196,9,19,-10
30,7,197,2,14,-12
30,7,198,14,22,-8
30,7,199,13,23,-10
30,7,200,11,18,-7
30,7,201,8,17,-9
30,7,202,15,24,-9
30,7,203,17,27,-10
30,7,204,10,36,-26
30,7,205,13,22,-9
30,7,206,12,21,-9
30,7,207,5,19,-14
30,7,208,16,25,-9
30,7,209,8,24,-16
30,7,210,11,13,-2
30,7,211,18,14,4
30,7,212,7,14,-7
30,7,213,11,21,-10
30,7,214,9,19,-10
30,7,215,17,32,-15
30,7,216,7,15,-8
30,7,217,0,6,-6
30,7,218,10,30,-20
30,7,219,9,16,-7
30,7,220,7,24,-17
30,7,221,12,27,-15
30,7,222,7,19,-12
30,7,223,16,35,-19
30,7,224,7,17,-10
30,7,225,11,34,-23
30,7,226,9,18,-9
30,7,227,10,35,-25
30,7,228,4,15,-11
30,7,229,7,21,-14
30,7,230,10,20,-10
30,7,231,8,10,-2
30,7,232,6,9,-3
30,7,233,7,20,-13
30,7,234,7,16,-9
30,7,235,3,41,-38
30,7,236,8,9,-1
30,7,237,15,31,-16
30,7,238,15,20,-5
30,7,239,7,26,-19
30,7,240,5,16,-11
30,7,241,2,14,-12
30,7,242,13,32,-19
30,7,243,5,6,-1
30,7,244,9,29,-20
30,7,245,11,18,-7
30,7,246,18,26,-8
30,7,247,4,30,-26
30,7,248,15,20,-5
30,7,249,10,6,4
30,7,250,10,27,-17
30,7,251,19,39,-20
30,7,252,7,4,3
30,7,253,16,16,0
30,7,254,9,22,-13
30,7,255,10,22,-12
30,7,256,5,15,-10
30,7,257,6,36,-30
30,7,258,20,25,-5
30,7,259,2,12,-10
30,7,260,16,20,-4
30,7,261,6,14,-8
30,7,262,10,20,-10
30,7,263,18,34,-16
30,7,264,4,17,-13
30,7,265,16,26,-10
30,7,266,9,24,-15
30,7,267,13,27,-14
30,7,268,18,24,-6
30,7,269,8,28,-20
30,7,270,4,12,-8
30,7,271,9,24,-15
30,7,272,13,7,6
30,7,273,9,23,-14
30,7,274,22,34,-12
30,7,275,5,29,-24
30,7,276,2,26,-24
30,7,277,12,25,-13
30,7,278,9,21,-12
30,7,279,6,22,-16
30,7,280,7,12,-5
30,7,281,10,19,-9
30,7,282,12,21,-9
30,7,283,4,18,-14
30,7,284,11,20,-9
30,7,285,4,6,-2
30,7,286,12,29,-17
30,7,287,3,24,-21
30,7,288,4,10,-6
30,7,289,9,19,-10
30,7,290,10,22,-12
30,7,291,6,19,-13
30,7,292,10,18,-8
30,7,293,8,24,-16
30,7,294,13,20,-7
30,7,295,7,19,-12
30,7,296,13,29,-16
30,7,297,7,23,-16
30,7,298,14,13,1
30,7,299,8,18,-10
30,8,0,10,24,-14
30,8,1,4,17,-13
30,8,2,11,22,-11
30,8,3,7,10,-3
30,8,4,13,18,-5
30,8,5,11,18,-7
30,8,6,13,15,-2
30,8,7,9,17,-8
30,8,8,12,21,-9
30,8,9,11,20,-9
30,8,10,9,21,-12
30,8,11,7,25,-18
30,8,12,12,33,-21
30,8,13,19,25,-6
30,8,14,19,21,-2
30,8,15,9,17,-8
30,8,16,12,19,-7
30,8,17,8,18,-10
30,8,18,5,18,-13
30,8,19,2,5,-3
30,8,20,7,24,-17
30,8,21,6,38,-32
30,8,22,16,25,-9
30,8,23,4,17,-13
30,8,24,9,15,-6
30,8,25,12,15,-3
30,8,26,7,22,-15
30,8,27,10,37,-27
30,8,28,7,9,-2
30,8,29,9,23,-14
30,8,30,6,25,-19
30,8,31,9,18,-9
30,8,32,4,19,-15
30,8,33,11,28,-17
30,8,34,11,16,-5
30,8,35,2,13,-11
30,8,36,5,9,-4
30,8,37,11,10,1
30,8,38,5,15,-10
30,8,39,10,27,-17
30,8,40,10,13,-3
30,8,41,21,21,0
30,8,42,9,13,-4
30,8,43,11,23,-12
30,8,44,13,32,-19
30,8,45,6,23,-17
30,8,46,13,30,-17
30,8,47,5,18,-13
30,8,48,3,12,-9
30,8,49,6,31,-25
30,8,50,11,17,-6
30,8,51,8,20,-12
30,8,52,8,33,-25
30,8,53,16,26,-10
30,8,54,14,18,-4
30,8,55,10,18,-8
30,8,56,8,15,-7
30,8,57,3,9,-6
30,8,58,12,31,-19
30,8,59,0,28,-28
30,8,60,3,14,-11
30,8,61,4,11,-7
30,8,62,13,15,-2
30,8,63,14,25,-11
30,8,64,13,32,-19
30,8,65,6,6,0
30,8,66,8,18,-10
30,8,67,8,4,4
30,8,68,8,19,-11
30,8,69,12,35,-23
30,8,70,4,13,-9
30,8,71,11,23,-12
30,8,72,11,15,-4
30,8,73,14,28,-14
30,8,74,12,18,-6
30,8,75,12,28,-16
30,8,76,12,22,-10
30,8,77,7,34,-27
30,8,78,8,19,-11
30,8,79,6,22,-16
30,8,80,2,17,-15
30,8,81,6,27,-21
30,8,82,12,19,-7
30,8,83,5,14,-9
30,8,84,8,19,-11
30,8,85,5,19,-14
30,8,86,17,25,-8
30,8,87,4,10,-6
30,8,88,6,14,-8
30,8,89,13,33,-20
30,8,90,10,29,-19
30,8,91,10,27,-17
30,8,92,6,26,-20
30,8,93,3,17,-14
30,8,94,14,24,-10
30,8,95,12,20,-8
30,8,96,4,26,-22
30,8,97,9,25,-16
30,8,98,14,16,-2
30,8,99,11,31,-20
30,8,100,2,17,-15
30,8,101,11,20,-9
30,8,102,1,11,-10
30,8,103,8,19,-11
30,8,104,5,11,-6
30,8,105,7,17,-10
30,8,106,5,10,-5
30,8,107,7,11,-4
30,8,108,8,11,-3
30,8,109,11,29,-18
30,8,110,12,22,-10
30,8,111,2,17,-15
30,8,112,8,20,-12
30,8,113,9,22,-13
30,8,114,5,21,-16
30,8,115,9,25,-16
30,8,116,5,10,-5
30,8,117,7,22,-15
30,8,118,10,5,5
30,8,119,7,20,-13
30,8,120,6,20,-14
30,8,121,8,19,-11
30,8,122,9,42,-33
30,8,123,6,9,-3
30,8,124,14,28,-14
30,8,125,15,12,3
30,8,126,16,25,-9
30,8,127,10,39,-29
30,8,128,4,8,-4
30,8,129,9,31,-22
30,8,130,9,25,-16
30,8,131,6,35,-29
30,8,132,6,46,-40
30,8,133,10,31,-21
30,8,134,5,27,-22
30,8,135,3,9,-6
30,8,136,3,7,-4
30,8,137,6,15,-9
30,8,138,5,15,-10
30,8,139,6,23,-17
30,8,140,13,28,-15
30,8,141,6,15,-9
30,8,142,7,14,-7
30,8,143,20,35,-15
30,8,144,6,17,-11
30,8,145,13,13,0
30,8,146,8,18,-10
30,8,147,9,17,-8
30,8,148,3,17,-14
30,8,149,13,32,-19
30,8,150,10,22,-12
30,8,151,7,27,-20
30,8,152,10,13,-3
30,8,153,13,13,0
30,8,154,10,8,2
30,8,155,3,20,-17
30,8,156,6,37,-31
30,8,157,10,28,-18
30,8,158,9,27,-18
30,8,159,14,32,-18
30,8,160,5,19,-14
30,8,161,4,24,-20
30,8,162,6,30,-24
30,8,163,9,33,-24
30,8,164,4,21,-17
30,8,165,14,18,-4
30,8,166,13,23,-10
30,8,167,5,25,-20
30,8,168,4,11,-7
30,8,169,6,14,-8
30,8,170,8,18,-10
30,8,171,4,16,-12
30,8,172,7,9,-2
30,8,173,4,15,-11
30,8,174,15,19,-4
30,8,175,3,24,-21
30,8,176,13,34,-21
30,8,177,11,32,-21
30,8,178,10,7,3
30,8,179,5,16,-11
30,8,180,11,45,-34
30,8,181,8,11,-3
30,8,182,6,19,-13
30,8,183,4,25,-21
30,8,184,19,26,-7
30,8,185,9,34,-25
30,8,186,8,9,-1
30,8,187,21,43,-22
30,8,188,5,21,-16
30,8,189,7,19,-12
30,8,190,11,17,-6
30,8,191,10,14,-4
30,8,192,15,19,-4
30,8,193,13,26,-13
30,8,194,3,13,-10
30,8,195,4,26,-22
30,8,196,9,11,-2
30,8,197,10,23,-13
30,8,198,5,28,-23
30,8,199,7,27,-20
30,8,200,13,16,-3
30,8,201,9,26,-17
30,8,202,13,20,-7
30,8,203,1,14,-13
30,8,204,15,26,-11
30,8,205,11,22,-11
30,8,206,13,37,-24
30,8,207,6,17,-11
30,8,208,5,12,-7
30,8,209,16,21,-5
30,8,210,16,24,-8
30,8,211,9,24,-15
30,8,212,3,23,-20
30,8,213,12,25,-13
30,8,214,14,10,4
30,8,215,14,36,-22
30,8,216,16,26,-10
30,8,217,7,11,-4
30,8,218,10,18,-8
30,8,219,8,15,-7
30,8,220,14,23,-9
30,8,221,5,18,-13
30,8,222,10,30,-20
30,8,223,12,13,-1
30,8,224,9,18,-9
30,8,225,9,32,-23
30,8,226,23,31,-8
30,8,227,7,27,-20
30,8,228,4,30,-26
30,8,229,10,42,-32
30,8,230,13,31,-18
30,8,231,13,13,0
30,8,232,9,20,-11
30,8,233,9,12,-3
30,8,234,10,37,-27
30,8,235,7,26,-19
30,8,236,12,20,-8
30,8,237,4,33,-29
30,8,238,5,14,-9
30,8,239,11,20,-9
30,8,240,12,24,-12
30,8,241,7,18,-11
30,8,242,8,20,-12
30,8,243,6,16,-10
30,8,244,22,42,-20
30,8,245,10,19,-9
30,8,246,3,31,-28
30,8,247,8,24,-16
30,8,248,13,13,0
30,8,249,6,34,-28
30,8,250,3,12,-9
30,8,251,5,15,-10
30,8,252,0,24,-24
30,8,253,12,20,-8
30,8,254,11,18,-7
30,8,255,12,26,-14
30,8,256,12,11,1
30,8,257,2,12,-10
30,8,258,7,25,-18
30,8,259,5,11,-6
30,8,260,7,10,-3
30,8,261,15,22,-7
30,8,262,9,24,-15
30,8,263,5,12,-7
30,8,264,9,35,-26
30,8,265,23,24,-1
30,8,266,6,11,-5
30,8,267,13,28,-15
30,8,268,14,25,-11
30,8,269,4,19,-15
30,8,270,7,24,-17
30,8,271,8,12,-4
30,8,272,1,8,-7
30,8,273,10,25,-15
30,8,274,3,28,-25
30,8,275,13,19,-6
30,8,276,10,38,-28
30,8,277,9,15,-6
30,8,278,13,34,-21
30,8,279,20,34,-14
30,8,280,11,22,-11
30,8,281,6,11,-5
30,8,282,6,26,-20
30,8,283,13,13,0
30,8,284,11,22,-11
30,8,285,16,23,-7
30,8,286,10,14,-4
30,8,287,8,16,-8
30,8,288,17,30,-13
30,8,289,7,20,-13
30,8,290,13,20,-7
30,8,291,6,15,-9
30,8,292,7,25,-18
30,8,293,8,10,-2
30,8,294,10,42,-32
30,8,295,15,15,0
30,8,296,6,18,-12
30,8,297,6,29,-23
30,8,298,13,38,-25
30,8,299,7,21,-14
30,9,0,10,27,-17
30,9,1,7,15,-8
30,9,2,10,26,-16
30,9,3,9,20,-11
30,9,4,12,22,-10
30,9,5,10,13,-3
30,9,6,5,21,-16
30,9,7,8,10,-2
30,9,8,8,13,-5
30,9,9,9,9,0
30,9,10,4,11,-7
30,9,11,7,30,-23
30,9,12,16,21,-5
30,9,13,10,17,-7
30,9,14,4,20,-16
30,9,15,11,12,-1
30,9,16,6,14,-8
30,9,17,3,14,-11
30,9,18,4,21,-17
30,9,19,3,14,-11
30,9,20,6,7,-1
30,9,21,2,18,-16
30,9,22,13,29,-16
30,9,23,19,13,6
30,9,24,9,15,-6
30,9,25,16,23,-7
30,9,26,6,12,-6
30,9,27,10,25,-15
30,9,28,12,20,-8
30,9,29,6,17,-11
30,9,30,4,16,-12
30,9,31,10,36,-26
30,9,32,12,28,-16
30,9,33,10,16,-6
30,9,34,1,11,-10
30,9,35,9,17,-8
30,9,36,16,11,5
30,9,37,25,30,-5
30,9,38,7,9,-2
30,9,39,7,16,-9
30,9,40,2,11,-9
30,9,41,8,16,-8
30,9,42,2,16,-14
30,9,43,15,18,-3
30,9,44,5,22,-17
30,9,45,15,35,-20
30,9,46,4,21,-17
30,9,47,5,16,-11
30,9,48,10,14,-4
30,9,49,7,8,-1
30,9,50,9,10,-1
30,9,51,10,27,-17
30,9,52,16,15,1
30,9,53,7,32,-25
30,9,54,5,12,-7
30,9,55,11,26,-15
30,9,56,20,26,-6
30,9,57,14,22,-8
30,9,58,15,11,4
30,9,59,2,15,-13
30,9,60,3,23,-20
30,9,61,14,46,-32
30,9,62,8,16,-8
30,9,63,10,14,-4
30,9,64,15,17,-2
30,9,65,8,21,-13
30,9,66,13,12,1
30,9,67,9,19,-10
30,9,68,12,11,1
30,9,69,17,18,-1
30,9,70,9,11,-2
30,9,71,13,26,-13
30,9,72,11,23,-12
30,9,73,14,18,-4
30,9,74,11,19,-8
30,9,75,13,11,2
30,9,76,7,18,-11
30,9,77,2,16,-14
30,9,78,18,22,-4
30,9,79,3,21,-18
30,9,80,5,13,-8
30,9,81,20,33,-13
30,9,82,8,17,-9
30,9,83,6,30,-24
30,9,84,9,21,-12
30,9,85,8,19,-11
30,9,86,2,35,-33
30,9,87,6,15,-9
30,9,88,9,17,-8
30,9,89,17,21,-4
30,9,90,6,24,-18
30,9,91,7,17,-10
30,9,92,11,34,-23
30,9,93,10,33,-23
30,9,94,9,10,-1
30,9,95,17,36,-19
30,9,96,4,15,-11
30,9,97,9,33,-24
30,9,98,21,34,-13
30,9,99,6,14,-8
30,9,100,5,24,-19
30,9,101,12,26,-14
30,9,102,13,19,-6
30,9,103,5,12,-7
30,9,104,6,19,-13
30,9,105,12,21,-9
30,9,106,9,15,-6
30,9,107,9,21,-12
30,9,108,19,16,3
30,9,109,14,35,-21
30,9,110,3,15,-12
30,9,111,10,21,-11
30,9,112,11,25,-14
30,9,113,3,15,-12
30,9,114,7,23,-16
30,9,115,9,34,-25
30,9,116,7,21,-14
30,9,117,12,13,-1
30,9,118,11,13,-2
30,9,119,10,21,-11
30,9,120,4,19,-15
30,9,121,8,15,-7
30,9,122,5,34,-29
30,9,123,11,14,-3
30,9,124,7,16,-9
30,9,125,3,14,-11
30,9,126,7,23,-16
30,9,127,5,11,-6
30,9,128,8,12,-4
30,9,129,6,15,-9
30,9,130,7,16,-9
30,9,131,13,31,-18
30,9,132,15,32,-17
30,9,133,1,8,-7
30,9,134,6,9,-3
30,9,135,10,20,-10
30,9,136,5,15,-10
30,9,137,10,23,-13
30,9,138,16,29,-13
30,9,139,9,28,-19
30,9,140,5,24,-19
30,9,141,9,26,-17
30,9,142,16,17,-1
30,9,143,5,15,-10
30,9,144,14,38,-24
30,9,145,7,23,-16
30,9,146,16,22,-6
30,9,147,3,11,-8
30,9,148,9,18,-9
30,9,149,8,23,-15
30,9,150,9,18,-9
30,9,151,15,33,-18
30,9,152,11,21,-10
30,9,153,14,23,-9
30,9,154,12,18,-6
30,9,155,3,18,-15
30,9,156,14,23,-9
30,9,157,14,24,-10
30,9,158,15,21,-6
30,9,159,7,19,-12
30,9,160,6,15,-9
30,9,161,10,14,-4
30,9,162,8,12,-4
30,9,163,5,23,-18
30,9,164,13,15,-2
30,9,165,11,20,-9
30,9,166,0,14,-14
30,9,167,8,30,-22
30,9,168,8,25,-17
30,9,169,9,41,-32
30,9,170,7,17,-10
30,9,171,13,24,-11
30,9,172,8,25,-17
30,9,173,9,16,-7
30,9,174,7,12,-5
30,9,175,9,16,-7
30,9,176,7,26,-19
30,9,177,7,21,-14
30,9,178,18,28,-10
30,9,179,10,12,-2
30,9,180,10,21,-11
30,9,181,7,13,-6
30,9,182,21,22,-1
30,9,183,5,11,-6
30,9,184,8,18,-10
30,9,185,4,25,-21
30,9,186,16,18,-2
30,9,187,3,9,-6
30,9,188,5,23,-18
30,9,189,16,28,-12
30,9,190,4,13,-9
30,9,191,6,17,-11
30,9,192,5,16,-11
30,9,193,15,19,-4
30,9,194,7,15,-8
30,9,195,16,26,-10
30,9,196,8,15,-7
30,9,197,12,28,-16
30,9,198,6,21,-15
30,9,199,10,41,-31
30,9,200,10,26,-16
30,9,201,30,40,-10
30,9,202,8,18,-10
30,9,203,17,50,-33
30,9,204,4,17,-13
30,9,205,4,6,-2
30,9,206,3,27,-24
30,9,207,10,30,-20
30,9,208,9,16,-7
30,9,209,9,29,-20
30,9,210,8,22,-14
30,9,211,6,14,-8
30,9,212,8,11,-3
30,9,213,3,9,-6
30,9,214,5,30,-25
30,9,215,9,27,-18
30,9,216,10,19,-9
30,9,217,6,17,-11
30,9,218,5,28,-23
30,9,219,8,24,-16
30,9,220,10,30,-20
30,9,221,23,17,6
30,9,222,12,23,-11
30,9,223,8,8,0
30,9,224,12,24,-12
30,9,225,13,24,-11
30,9,226,3,23,-20
30,9,227,6,20,-14
30,9,228,11,31,-20
30,9,229,10,16,-6
30,9,230,16,26,-10
30,9,231,13,32,-19
30,9,232,10,20,-10
30,9,233,15,19,-4
30,9,234,14,28,-14
30,9,235,3,13,-10
30,9,236,7,9,-2
30,9,237,3,17,-14
30,9,238,13,20,-7
30,9,239,10,23,-13
30,9,240,6,32,-26
30,9,241,8,16,-8
30,9,242,5,13,-8
30,9,243,10,16,-6
30,9,244,4,16,-12
30,9,245,5,29,-24
30,9,246,14,24,-10
30,9,247,11,14,-3
30,9,248,12,28,-16
30,9,249,5,25,-20
30,9,250,10,16,-6
30,9,251,8,36,-28
30,9,252,20,23,-3
30,9,253,5,25,-20
30,9,254,17,17,0
30,9,255,13,33,-20
30,9,256,6,26,-20
30,9,257,13,20,-7
30,9,258,14,22,-8
30,9,259,6,35,-29
30,9,260,16,27,-11
30,9,261,8,6,2
30,9,262,28,25,3
30,9,263,11,13,-2
30,9,264,17,42,-25
30,9,265,3,25,-22
30,9,266,14,10,4
30,9,267,16,22,-6
30,9,268,6,12,-6
30,9,269,8,20,-12
30,9,270,8,33,-25
30,9,271,6,33,-27
30,9,272,6,16,-10
30,9,273,9,23,-14
30,9,274,8,24,-16
30,9,275,13,41,-28
30,9,276,16,22,-6
30,9,277,10,22,-12
30,9,278,7,20,-13
30,9,279,6,42,-36
30,9,280,7,13,-6
30,9,281,6,27,-21
30,9,282,10,20,-10
30,9,283,6,17,-11
30,9,284,11,26,-15
30,9,285,4,13,-9
30,9,286,7,22,-15
30,9,287,11,7,4
30,9,288,10,16,-6
30,9,289,5,24,-19
30,9,290,6,20,-14
30,9,291,9,27,-18
30,9,292,15,12,3
30,9,293,8,21,-13
30,9,294,17,28,-11
30,9,295,15,27,-12
30,9,296,14,17,-3
30,9,297,13,42,-29
30,9,298,9,26,-17
30,9,299,8,23,-15
30,10,0,6,11,-5
30,10,1,20,14,6
30,10,2,14,19,-5
30,10,3,10,13,-3
30,10,4,8,23,-15
30,10,5,5,19,-14
30,10,6,20,26,-6
30,10,7,10,19,-9
30,10,8,7,19,-12
30,10,9,5,21,-16
30,10,10,7,11,-4
30,10,11,9,18,-9
30,10,12,12,20,-8
30,10,13,12,20,-8
30,10,14,4,32,-28
30,10,15,8,11,-3
30,10,16,2,2,0
30,10,17,10,30,-20
30,10,18,9,38,-29
30,10,19,4,22,-18
30,10,20,9,22,-13
30,10,21,6,14,-8
30,10,22,9,10,-1
30,10,23,4,17,-13
30,10,24,13,24,-11
30,10,25,5,14,-9
30,10,26,16,25,-9
30,10,27,11,25,-14
30,10,28,9,26,-17
30,10,29,15,16,-1
30,10,30,5,30,-25
30,10,31,7,17,-10
30,10,32,16,20,-4
30,10,33,6,22,-16
30,10,34,11,25,-14
30,10,35,19,26,-7
30,10,36,4,17,-13
30,10,37,5,31,-26
30,10,38,8,28,-20
30,10,39,14,13,1
30,10,40,10,31,-21
30,10,41,14,17,-3
30,10,42,22,19,3
30,10,43,4,11,-7
30,10,44,2,16,-14
30,10,45,13,14,-1
30,10,46,3,15,-12
30,10,47,11,24,-13
30,10,48,10,10,0
30,10,49,10,27,-17
30,10,50,14,38,-24
30,10,51,6,19,-13
30,10,52,19,34,-15
30,10,53,7,14,-7
30,10,54,13,25,-12
30,10,55,6,14,-8
30,10,56,6,23,-17
30,10,57,7,18,-11
30,10,58,11,21,-10
30,10,59,13,21,-8
30,10,60,12,19,-7
30,10,61,9,21,-12
30,10,62,10,26,-16
30,10,63,9,16,-7
30,10,64,10,8,2
30,10,65,14,15,-1
30,10,66,7,21,-14
30,10,67,12,17,-5
30,10,68,5,15,-10
30,10,69,9,24,-15
30,10,70,7,10,-3
30,10,71,10,19,-9
30,10,72,9,17,-8
30,10,73,2,12,-10
30,10,74,3,13,-10
30,10,75,14,19,-5
30,10,76,12,12,0
30,10,77,13,29,-16
30,10,78,8,19,-11
30,10,79,5,16,-11
30,10,80,13,24,-11
30,10,81,6,15,-9
30,10,82,16,25,-9
30,10,83,11,14,-3
30,10,84,20,21,-1
30,10,85,13,30,-17
30,10,86,4,12,-8
30,10,87,13,26,-13
30,10,88,7,11,-4
30,10,89,13,39,-26
30,10,90,11,21,-10
30,10,91,8,22,-14
30,10,92,13,18,-5
30,10,93,8,15,-7
30,10,94,4,16,-12
30,10,95,6,22,-16
30,10,96,20,20,0
30,10,97,9,39,-30
30,10,98,6,16,-10
30,10,99,11,31,-20
30,10,100,5,20,-15
30,10,101,3,27,-24
30,10,102,14,19,-5
30,10,103,10,9,1
30,10,104,9,23,-14
30,10,105,9,24,-15
30,10,106,7,30,-23
30,10,107,13,22,-9
30,10,108,6,16,-10
30,10,109,6,19,-13
30,10,110,7,26,-19
30,10,111,7,20,-13
30,10,112,16,35,-19
30,10,113,19,23,-4
30,10,114,6,18,-12
30,10,115,5,17,-12
30,10,116,11,33,-22
30,10,117,16,26,-10
30,10,118,5,13,-8
30,10,119,6,21,-15
30,10,120,12,27,-15
30,10,121,7,21,-14
30,10,122,4,27,-23
30,10,123,13,28,-15
30,10,124,0,13,-13
30,10,125,10,19,-9
30,10,126,6,20,-14
30,10,127,10,12,-2
30,10,128,5,23,-18
30,10,129,6,16,-10
30,10,130,10,12,-2
30,10,131,9,27,-18
30,10,132,6,16,-10
30,10,133,4,25,-21
30,10,134,2,24,-22
30,10,135,11,29,-18
30,10,136,10,20,-10
30,10,137,8,20,-12
30,10,138,5,24,-19
30,10,139,6,23,-17
30,10,140,9,25,-16
30,10,141,2,30,-28
30,10,142,20,31,-11
30,10,143,8,24,-16
30,10,144,12,27,-15
30,10,145,3,19,-16
30,10,146,12,15,-3
30,10,147,8,13,-5
30,10,148,4,17,-13
30,10,149,5,15,-10
30,10,150,3,8,-5
30,10,151,6,27,-21
30,10,152,10,14,-4
30,10,153,16,20,-4
30,10,154,11,24,-13
30,10,155,19,25,-6
30,10,156,11,9,2
30,10,157,4,8,-4
30,10,158,10,11,-1
30,10,159,3,7,-4
30,10,160,6,15,-9
30,10,161,5,29,-24
30,10,162,18,30,-12
30,10,163,12,14,-2
30,10,164,4,24,-20
30,10,165,8,33,-25
30,10,166,13,24,-11
30,10,167,8,16,-8
30,10,168,12,17,-5
30,10,169,11,20,-9
30,10,170,8,24,-16
30,10,171,3,18,-15
30,10,172,16,16,0
30,10,173,14,26,-12
30,10,174,16,20,-4
30,10,175,8,7,1
30,10,176,10,20,-10
30,10,177,11,37,-26
30,10,178,12,24,-12
30,10,179,6,19,-13
30,10,180,9,18,-9
30,10,181,9,15,-6
30,10,182,4,17,-13
30,10,183,10,23,-13
30,10,184,13,21,-8
30,10,185,11,19,-8
30,10,186,10,23,-13
30,10,187,10,9,1
30,10,188,11,18,-7
30,10,189,10,27,-17
30,10,190,11,29,-18
30,10,191,12,21,-9
30,10,192,10,13,-3
30,10,193,13,32,-19
30,10,194,12,21,-9
30,10,195,8,16,-8
30,10,196,5,21,-16
30,10,197,13,18,-5
30,10,198,11,27,-16
30,10,199,12,19,-7
30,10,200,10,20,-10
30,10,201,9,17,-8
30,10,202,9,18,-9
30,10,203,13,23,-10
30,10,204,7,18,-11
30,10,205,5,27,-22
30,10,206,16,30,-14
30,10,207,11,18,-7
30,10,208,10,15,-5
30,10,209,13,22,-9
30,10,210,12,23,-11
30,10,211,14,16,-2
30,10,212,9,12,-3
30,10,213,20,30,-10
30,10,214,7,8,-1
30,10,215,16,19,-3
30,10,216,2,9,-7
30,10,217,9,32,-23
30,10,218,10,17,-7
30,10,219,14,15,-1
30,10,220,7,15,-8
30,10,221,4,6,-2
30,10,222,12,15,-3
30,10,223,6,20,-14
30,10,224,13,23,-10
30,10,225,13,26,-13
30,10,226,21,21,0
30,10,227,4,15,-11
30,10,228,10,11,-1
30,10,229,7,17,-10
30,10,230,6,23,-17
30,10,231,7,23,-16
30,10,232,14,24,-10
30,10,233,10,24,-14
30,10,234,9,27,-18
30,10,235,15,14,1
30,10,236,3,14,-11
30,10,237,24,22,2
30,10,238,10,24,-14
30,10,239,8,9,-1
30,10,240,23,21,2
30,10,241,9,16,-7
30,10,242,7,23,-16
30,10,243,8,21,-13
30,10,244,6,21,-15
30,10,245,5,31,-26
30,10,246,9,11,-2
30,10,247,5,23,-18
30,10,248,17,19,-2
30,10,249,5,18,-13
30,10,250,12,21,-9
30,10,251,1,18,-17
30,10,252,11,16,-5
30,10,253,4,10,-6
30,10,254,9,25,-16
30,10,255,17,23,-6
30,10,256,15,35,-20
30,10,257,15,24,-9
30,10,258,10,30,-20
30,10,259,8,21,-13
30,10,260,7,14,-7
30,10,261,14,25,-11
30,10,262,7,23,-16
30,10,263,19,18,1
30,10,264,3,17,-14
30,10,265,9,15,-6
30,10,266,8,32,-24
30,10,267,14,25,-11
30,10,268,8,19,-11
30,10,269,8,15,-7
30,10,270,13,22,-9
30,10,271,9,19,-10
30,10,272,13,13,0
30,10,273,4,11,-7
30,10,274,11,25,-14
30,10,275,13,28,-15
30,10,276,15,14,1
30,10,277,15,52,-37
30,10,278,6,15,-9
30,10,279,7,22,-15
30,10,280,3,11,-8
30,10,281,13,20,-7
30,10,282,14,28,-14
30,10,283,24,24,0
30,10,284,8,17,-9
30,10,285,7,26,-19
30,10,286,8,10,-2
30,10,287,12,27,-15
30,10,288,2,25,-23
30,10,289,12,23,-11
30,10,290,8,22,-14
30,10,291,5,24,-19
30,10,292,6,14,-8
30,10,293,10,23,-13
30,10,294,12,18,-6
30,10,295,14,26,-12
30,10,296,11,22,-11
30,10,297,4,8,-4
30,10,298,7,16,-9
30,10,299,12,19,-7
30,11,0,8,21,-13
30,11,1,17,30,-13
30,11,2,11,20,-9
30,11,3,11,33,-22
30,11,4,14,31,-17
30,11,5,13,20,-7
30,11,6,17,25,-8
30,11,7,15,21,-6
30,11,8,5,14,-9
30,11,9,5,21,-16
30,11,10,9,16,-7
30,11,11,7,17,-10
30,11,12,12,20,-8
30,11,13,10,14,-4
30,11,14,1,19,-18
30,11,15,12,38,-26
30,11,16,14,29,-15
30,11,17,13,26,-13
30,11,18,16,14,2
30,11,19,5,16,-11
30,11,20,12,13,-1
30,11,21,5,19,-14
30,11,22,14,28,-14
30,11,23,15,22,-7
30,11,24,4,12,-8
30,11,25,11,25,-14
30,11,26,2,10,-8
30,11,27,6,17,-11
30,11,28,7,19,-12
30,11,29,6,18,-12
30,11,30,0,24,-24
30,11,31,7,14,-7
30,11,32,5,20,-15
30,11,33,8,12,-4
30,11,34,4,27,-23
30,11,35,9,20,-11
30,11,36,8,19,-11
30,11,37,12,28,-16
30,11,38,11,19,-8
30,11,39,5,13,-8
30,11,40,13,17,-4
30,11,41,4,19,-15
30,11,42,0,14,-14
30,11,43,9,11,-2
30,11,44,2,10,-8
30,11,45,8,9,-1
30,11,46,13,13,0
30,11,47,14,15,-1
30,11,48,6,27,-21
30,11,49,8,22,-14
30,11,50,9,20,-11
30,11,51,9,26,-17
30,11,52,8,28,-20
30,11,53,6,12,-6
30,11,54,10,21,-11
30,11,55,10,18,-8
30,11,56,9,28,-19
30,11,57,15,31,-16
30,11,58,8,16,-8
30,11,59,18,27,-9
30,11,60,11,22,-11
30,11,61,10,19,-9
30,11,62,8,19,-11
30,11,63,8,23,-15
30,11,64,14,13,1
30,11,65,13,19,-6
30,11,66,14,20,-6
30,11,67,14,29,-15
30,11,68,19,34,-15
30,11,69,20,18,2
30,11,70,13,18,-5
30,11,71,10,16,-6
30,11,72,7,12,-5
30,11,73,13,15,-2
30,11,74,4,15,-11
30,11,75,20,11,9
30,11,76,6,20,-14
30,11,77,11,23,-12
30,11,78,5,13,-8
30,11,79,11,13,-2
30,11,80,8,18,-10
30,11,81,7,21,-14
30,11,82,13,20,-7
30,11,83,11,13,-2
30,11,84,8,14,-6
30,11,85,4,34,-30
30,11,86,3,12,-9
30,11,87,13,26,-13
30,11,88,3,29,-26
30,11,89,8,24,-16
30,11,90,11,14,-3
30,11,91,8,14,-6
30,11,92,14,14,0
30,11,93,11,11,0
30,11,94,10,19,-9
30,11,95,4,7,-3
30,11,96,10,19,-9
30,11,97,15,16,-1
30,11,98,7,16,-9
30,11,99,12,17,-5
30,11,100,12,17,-5
30,11,101,12,20,-8
30,11,102,11,18,-7
30,11,103,9,10,-1
30,11,104,4,21,-17
30,11,105,3,14,-11
30,11,106,12,27,-15
30,11,107,6,18,-12
30,11,108,15,9,6
30,11,109,10,14,-4
30,11,110,11,17,-6
30,11,111,13,28,-15
30,11,112,8,16,-8
30,11,113,12,17,-5
30,11,114,11,24,-13
30,11,115,15,24,-9
30,11,116,9,22,-13
30,11,117,9,33,-24
30,11,118,7,21,-14
30,11,119,16,25,-9
30,11,120,10,24,-14
30,11,121,13,12,1
30,11,122,7,20,-13
30,11,123,5,16,-11
30,11,124,7,13,-6
30,11,125,11,20,-9
30,11,126,8,19,-11
30,11,127,11,8,3
30,11,128,6,24,-18
30,11,129,8,20,-12
30,11,130,9,16,-7
30,11,131,19,28,-9
30,11,132,3,5,-2
30,11,133,10,30,-20
30,11,134,5,23,-18
30,11,135,11,21,-10
30,11,136,10,39,-29
30,11,137,9,25,-16
30,11,138,12,15,-3
30,11,139,7,22,-15
30,11,140,7,26,-19
30,11,141,15,14,1
30,11,142,13,14,-1
30,11,143,7,18,-11
30,11,144,17,29,-12
30,11,145,7,8,-1
30,11,146,15,22,-7
30,11,147,6,13,-7
30,11,148,12,16,-4
30,11,149,5,23,-18
30,11,150,3,14,-11
30,11,151,10,11,-1
30,11,152,1,10,-9
30,11,153,11,21,-10
30,11,154,10,22,-12
30,11,155,11,16,-5
30,11,156,11,23,-12
30,11,157,15,17,-2
30,11,158,21,39,-18
30,11,159,12,22,-10
30,11,160,13,17,-4
30,11,161,7,25,-18
30,11,162,8,37,-29
30,11,163,5,20,-15
30,11,164,9,14,-5
30,11,165,6,5,1
30,11,166,13,42,-29
30,11,167,20,7,13
30,11,168,19,31,-12
30,11,169,13,20,-7
30,11,170,13,19,-6
30,11,171,21,27,-6
30,11,172,13,16,-3
30,11,173,15,18,-3
30,11,174,10,29,-19
30,11,175,13,12,1
30,11,176,9,21,-12
30,11,177,12,13,-1
30,11,178,16,16,0
30,11,179,5,7,-2
30,11,180,1,5,-4
30,11,181,12,26,-14
30,11,182,10,29,-19
30,11,183,17,26,-9
30,11,184,4,19,-15
30,11,185,7,28,-21
30,11,186,16,22,-6
30,11,187,18,25,-7
30,11,188,10,11,-1
30,11,189,13,25,-12
30,11,190,17,18,-1
30,11,191,8,20,-12
30,11,192,12,27,-15
30,11,193,5,22,-17
30,11,194,13,26,-13
30,11,195,16,15,1
30,11,196,2,15,-13
30,11,197,19,20,-1
30,11,198,10,22,-12
30,11,199,11,17,-6
30,11,200,4,21,-17
30,11,201,7,14,-7
30,11,202,12,16,-4
30,11,203,11,22,-11
30,11,204,16,26,-10
30,11,205,18,16,2
30,11,206,11,10,1
30,11,207,8,20,-12
30,11,208,21,21,0
30,11,209,15,22,-7
30,11,210,17,27,-10
30,11,211,10,17,-7
30,11,212,6,26,-20
30,11,213,7,11,-4
30,11,214,19,17,2
30,11,215,8,22,-14
30,11,216,13,17,-4
30,11,217,9,20,-11
30,11,218,15,15,0
30,11,219,4,7,-3
30,11,220,2,15,-13
30,11,221,8,28,-20
30,11,222,10,19,-9
30,11,223,6,20,-14
30,11,224,10,26,-16
30,11,225,9,26,-17
30,11,226,13,23,-10
30,11,227,9,21,-12
30,11,228,6,4,2
30,11,229,10,17,-7
30,11,230,6,16,-10
30,11,231,10,15,-5
30,11,232,14,31,-17
30,11,233,9,23,-14
30,11,234,15,28,-13
30,11,235,9,17,-8
30,11,236,10,11,-1
30,11,237,15,24,-9
30,11,238,13,16,-3
30,11,239,12,31,-19
30,11,240,12,12,0
30,11,241,3,11,-8
30,11,242,8,26,-18
30,11,243,2,12,-10
30,11,244,4,21,-17
30,11,245,5,10,-5
30,11,246,14,24,-10
30,11,247,7,16,-9
30,11,248,17,30,-13
30,11,249,0,9,-9
30,11,250,10,21,-11
30,11,251,8,18,-10
30,11,252,16,20,-4
30,11,253,13,18,-5
30,11,254,7,13,-6
30,11,255,9,17,-8
30,11,256,5,14,-9
30,11,257,8,20,-12
30,11,258,2,9,-7
30,11,259,4,20,-16
30,11,260,5,33,-28
30,11,261,4,19,-15
30,11,262,12,26,-14
30,11,263,10,25,-15
30,11,264,10,12,-2
30,11,265,2,18,-16
30,11,266,15,20,-5
30,11,267,8,18,-10
30,11,268,13,28,-15
30,11,269,22,23,-1
30,11,270,6,6,0
30,11,271,9,17,-8
30,11,272,8,19,-11
30,11,273,7,23,-16
30,11,274,16,31,-15
30,11,275,13,22,-9
30,11,276,9,15,-6
30,11,277,13,20,-7
30,11,278,9,13,-4
30,11,279,5,14,-9
30,11,280,7,23,-16
30,11,281,14,17,-3
30,11,282,18,21,-3
30,11,283,15,19,-4
30,11,284,6,16,-10
30,11,285,10,16,-6
30,11,286,9,13,-4
30,11,287,12,20,-8
30,11,288,11,28,-17
30,11,289,15,13,2
30,11,290,15,12,3
30,11,291,4,31,-27
30,11,292,1,18,-17
30,11,293,4,14,-10
30,11,294,14,9,5
30,11,295,9,15,-6
30,11,296,3,16,-13
30,11,297,6,19,-13
30,11,298,3,13,-10
30,11,299,4,20,-16
30,12,0,11,13,-2
30,12,1,12,19,-7
30,12,2,11,21,-10
30,12,3,17,22,-5
30,12,4,5,16,-11
30,12,5,6,15,-9
30,12,6,14,23,-9
30,12,7,17,15,2
30,12,8,7,10,-3
30,12,9,7,25,-18
30,12,10,15,18,-3
30,12,11,7,10,-3
30,12,12,7,13,-6
30,12,13,16,22,-6
30,12,14,2,13,-11
30,12,15,13,24,-11
30,12,16,9,12,-3
30,12,17,10,26,-16
30,12,18,12,34,-22
30,12,19,8,17,-9
30,12,20,3,21,-18
30,12,21,8,15,-7
30,12,22,2,17,-15
30,12,23,3,8,-5
30,12,24,23,12,11
30,12,25,6,23,-17
30,12,26,5,18,-13
30,12,27,3,25,-22
30,12,28,10,20,-10
30,12,29,7,17,-10
30,12,30,6,11,-5
30,12,31,10,23,-13
30,12,32,9,11,-2
30,12,33,17,21,-4
30,12,34,9,16,-7
30,12,35,18,30,-12
30,12,36,7,17,-10
30,12,37,14,12,2
30,12,38,14,22,-8
30,12,39,6,26,-20
30,12,40,2,23,-21
30,12,41,17,14,3
30,12,42,9,9,0
30,12,43,9,10,-1
30,12,44,9,20,-11
30,12,45,8,9,-1
30,12,46,7,15,-8
30,12,47,15,31,-16
30,12,48,1,4,-3
30,12,49,16,25,-9
30,12,50,7,23,-16
30,12,51,15,17,-2
30,12,52,10,6,4
30,12,53,17,29,-12
30,12,54,11,21,-10
30,12,55,6,14,-8
30,12,56,9,25,-16
30,12,57,9,14,-5
30,12,58,12,22,-10
30,12,59,8,13,-5
30,12,60,6,15,-9
30,12,61,10,24,-14
30,12,62,3,19,-16
30,12,63,11,36,-25
30,12,64,7,15,-8
30,12,65,11,20,-9
30,12,66,18,31,-13
30,12,67,10,19,-9
30,12,68,22,13,9
30,12,69,18,22,-4
30,12,70,11,31,-20
30,12,71,17,26,-9
30,12,72,12,16,-4
30,12,73,8,23,-15
30,12,74,10,17,-7
30,12,75,9,23,-14
30,12,76,15,21,-6
30,12,77,7,24,-17
30,12,78,10,29,-19
30,12,79,12,25,-13
30,12,80,10,14,-4
30,12,81,5,12,-7
30,12,82,7,18,-11
30,12,83,6,19,-13
30,12,84,13,19,-6
30,12,85,15,21,-6
30,12,86,6,11,-5
30,12,87,8,10,-2
30,12,88,3,24,-21
30,12,89,7,7,0
30,12,90,6,11,-5
30,12,91,7,20,-13
30,12,92,5,14,-9
30,12,93,15,27,-12
30,12,94,7,16,-9
30,12,95,9,15,-6
30,12,96,8,12,-4
30,12,97,17,33,-16
30,12,98,14,29,-15
30,12,99,25,41,-16
30,12,100,25,20,5
30,12,101,7,26,-19
30,12,102,8,26,-18
30,12,103,10,19,-9
30,12,104,11,15,-4
30,12,105,5,16,-11
30,12,106,9,29,-20
30,12,107,5,20,-15
30,12,108,5,14,-9
30,12,109,17,37,-20
30,12,110,11,9,2
30,12,111,17,31,-14
30,12,112,11,11,0
30,12,113,16,19,-3
30,12,114,11,17,-6
30,12,115,8,20,-12
30,12,116,20,24,-4
30,12,117,16,17,-1
30,12,118,7,10,-3
30,12,119,18,29,-11
30,12,120,14,12,2
30,12,121,13,26,-13
30,12,122,15,23,-8
30,12,123,12,23,-11
30,12,124,11,15,-4
30,12,125,7,9,-2
30,12,126,6,11,-5
30,12,127,14,19,-5
30,12,128,7,28,-21
30,12,129,13,10,3
30,12,130,8,25,-17
30,12,131,13,22,-9
30,12,132,12,17,-5
30,12,133,8,30,-22
30,12,134,5,14,-9
30,12,135,13,28,-15
30,12,136,17,22,-5
30,12,137,9,18,-9
30,12,138,7,19,-12
30,12,139,6,15,-9
30,12,140,8,29,-21
30,12,141,17,32,-15
30,12,142,6,8,-2
30,12,143,16,22,-6
30,12,144,10,26,-16
30,12,145,10,25,-15
30,12,146,12,21,-9
30,12,147,6,17,-11
30,12,148,14,21,-7
30,12,149,12,28,-16
30,12,150,14,18,-4
30,12,151,11,15,-4
30,12,152,14,20,-6
30,12,153,9,12,-3
30,12,154,6,15,-9
30,12,155,30,30,0
30,12,156,12,18,-6
30,12,157,3,25,-22
30,12,158,15,18,-3
30,12,159,8,9,-1
30,12,160,10,8,2
30,12,161,10,21,-11
30,12,162,14,27,-13
30,12,163,6,5,1
30,12,164,7,25,-18
30,12,165,16,21,-5
30,12,166,9,13,-4
30,12,167,13,14,-1
30,12,168,11,23,-12
30,12,169,7,12,-5
30,12,170,14,20,-6
30,12,171,6,13,-7
30,12,172,13,16,-3
30,12,173,7,7,0
30,12,174,12,21,-9
30,12,175,3,13,-10
30,12,176,15,13,2
30,12,177,5,11,-6
30,12,178,8,22,-14
30,12,179,14,21,-7
30,12,180,7,13,-6
30,12,181,14,24,-10
30,12,182,9,19,-10
30,12,183,12,14,-2
30,12,184,15,26,-11
30,12,185,6,6,0
30,12,186,7,20,-13
30,12,187,14,34,-20
30,12,188,21,13,8
30,12,189,8,23,-15
30,12,190,12,12,0
30,12,191,13,15,-2
30,12,192,25,34,-9
30,12,193,8,14,-6
30,12,194,8,16,-8
30,12,195,6,3,3
30,12,196,6,16,-10
30,12,197,4,22,-18
30,12,198,8,19,-11
30,12,199,9,19,-10
30,12,200,3,20,-17
30,12,201,16,16,0
30,12,202,10,11,-1
30,12,203,13,22,-9
30,12,204,7,16,-9
30,12,205,13,18,-5
30,12,206,13,15,-2
30,12,207,13,13,0
30,12,208,5,19,-14
30,12,209,9,26,-17
30,12,210,14,23,-9
30,12,211,18,16,2
30,12,212,18,18,0
30,12,213,12,22,-10
30,12,214,12,18,-6
30,12,215,3,10,-7
30,12,216,9,6,3
30,12,217,8,19,-11
30,12,218,12,30,-18
30,12,219,21,17,4
30,12,220,13,5,8
30,12,221,10,8,2
30,12,222,11,17,-6
30,12,223,3,19,-16
30,12,224,23,15,8
30,12,225,11,17,-6
30,12,226,3,19,-16
30,12,227,11,13,-2
30,12,228,8,21,-13
30,12,229,4,21,-17
30,12,230,16,22,-6
30,12,231,5,14,-9
30,12,232,11,16,-5
30,12,233,11,10,1
30,12,234,8,11,-3
30,12,235,14,15,-1
30,12,236,11,28,-17
30,12,237,9,20,-11
30,12,238,10,26,-16
30,12,239,7,9,-2
30,12,240,8,14,-6
30,12,241,11,4,7
30,12,242,13,22,-9
30,12,243,7,23,-16
30,12,244,13,17,-4
30,12,245,11,18,-7
30,12,246,9,31,-22
30,12,247,5,18,-13
30,12,248,15,12,3
30,12,249,4,13,-9
30,12,250,1,21,-20
30,12,251,8,16,-8
30,12,252,3,16,-13
30,12,253,15,35,-20
30,12,254,8,0,8
30,12,255,12,29,-17
30,12,256,5,9,-4
30,12,257,14,25,-11
30,12,258,4,19,-15
30,12,259,16,22,-6
30,12,260,8,10,-2
30,12,261,15,25,-10
30,12,262,12,33,-21
30,12,263,12,19,-7
30,12,264,11,13,-2
30,12,265,12,12,0
30,12,266,19,13,6
30,12,267,10,17,-7
30,12,268,11,32,-21
30,12,269,16,30,-14
30,12,270,10,16,-6
30,12,271,19,27,-8
30,12,272,6,26,-20
30,12,273,10,23,-13
30,12,274,9,16,-7
30,12,275,14,39,-25
30,12,276,9,23,-14
30,12,277,13,24,-11
30,12,278,7,20,-13
30,12,279,15,16,-1
30,12,280,6,18,-12
30,12,281,6,22,-16
30,12,282,15,24,-9
30,12,283,11,13,-2
30,12,284,10,13,-3
30,12,285,4,15,-11
30,12,286,8,24,-16
30,12,287,9,15,-6
30,12,288,16,21,-5
30,12,289,11,25,-14
30,12,290,5,26,-21
30,12,291,22,21,1
30,12,292,8,21,-13
30,12,293,15,17,-2
30,12,294,10,20,-10
30,12,295,13,19,-6
30,12,296,18,35,-17
30,12,297,11,14,-3
30,12,298,11,15,-4
30,12,299,10,24,-14
30,13,0,8,29,-21
30,13,1,14,15,-1
30,13,2,19,20,-1
30,13,3,7,26,-19
30,13,4,13,12,1
30,13,5,11,24,-13
30,13,6,12,27,-15
30,13,7,2,12,-10
30,13,8,11,25,-14
30,13,9,5,12,-7
30,13,10,9,10,-1
30,13,11,7,10,-3
30,13,12,12,14,-2
30,13,13,4,15,-11
30,13,14,12,13,-1
30,13,15,8,13,-5
30,13,16,1,13,-12
30,13,17,14,14,0
30,13,18,12,17,-5
30,13,19,4,7,-3
30,13,20,5,30,-25
30,13,21,10,28,-18
30,13,22,11,18,-7
30,13,23,1,19,-18
30,13,24,10,11,-1
30,13,25,1,12,-11
30,13,26,10,12,-2
30,13,27,7,17,-10
30,13,28,9,18,-9
30,13,29,11,15,-4
30,13,30,8,20,-12
30,13,31,12,24,-12
30,13,32,2,6,-4
30,13,33,8,20,-12
30,13,34,26,26,0
30,13,35,4,25,-21
30,13,36,6,13,-7
30,13,37,10,23,-13
30,13,38,16,24,-8
30,13,39,8,20,-12
30,13,40,8,24,-16
30,13,41,12,16,-4
30,13,42,11,15,-4
30,13,43,9,16,-7
30,13,44,14,18,-4
30,13,45,14,14,0
30,13,46,18,29,-11
30,13,47,9,27,-18
30,13,48,4,9,-5
30,13,49,11,17,-6
30,13,50,13,37,-24
30,13,51,4,15,-11
30,13,52,7,10,-3
30,13,53,11,13,-2
30,13,54,9,12,-3
30,13,55,9,9,0
30,13,56,10,16,-6
30,13,57,15,21,-6
30,13,58,8,15,-7
30,13,59,3,30,-27
30,13,60,13,18,-5
30,13,61,9,19,-10
30,13,62,12,23,-11
30,13,63,15,15,0
30,13,64,8,20,-12
30,13,65,15,15,0
30,13,66,15,12,3
30,13,67,7,18,-11
30,13,68,9,24,-15
30,13,69,10,10,0
30,13,70,11,26,-15
30,13,71,10,10,0
30,13,72,5,19,-14
30,13,73,14,24,-10
30,13,74,17,25,-8
30,13,75,19,29,-10
30,13,76,3,7,-4
30,13,77,18,16,2
30,13,78,14,9,5
30,13,79,5,19,-14
30,13,80,2,8,-6
30,13,81,4,12,-8
30,13,82,14,14,0
30,13,83,9,10,-1
30,13,84,10,10,0
30,13,85,9,25,-16
30,13,86,7,9,-2
30,13,87,1,28,-27
30,13,88,13,18,-5
30,13,89,9,30,-21
30,13,90,21,13,8
30,13,91,8,10,-2
30,13,92,3,19,-16
30,13,93,5,15,-10
30,13,94,4,13,-9
30,13,95,4,22,-18
30,13,96,2,12,-10
30,13,97,8,18,-10
30,13,98,1,9,-8
30,13,99,9,20,-11
30,13,100,16,17,-1
30,13,101,4,13,-9
30,13,102,4,14,-10
30,13,103,4,20,-16
30,13,104,9,11,-2
30,13,105,10,14,-4
30,13,106,11,21,-10
30,13,107,27,24,3
30,13,108,8,16,-8
30,13,109,8,19,-11
30,13,110,7,16,-9
30,13,111,23,21,2
30,13,112,2,19,-17
30,13,113,7,19,-12
30,13,114,8,15,-7
30,13,115,10,18,-8
30,13,116,7,28,-21
30,13,117,6,26,-20
30,13,118,13,17,-4
30,13,119,17,43,-26
30,13,120,13,21,-8
30,13,121,8,20,-12
30,13,122,14,28,-14
30,13,123,12,26,-14
30,13,124,11,28,-17
30,13,125,13,26,-13
30,13,126,14,16,-2
30,13,127,4,27,-23
30,13,128,6,27,-21
30,13,129,9,32,-23
30,13,130,9,11,-2
30,13,131,13,21,-8
30,13,132,11,16,-5
30,13,133,4,16,-12
30,13,134,20,16,4
30,13,135,16,23,-7
30,13,136,22,24,-2
30,13,137,9,22,-13
30,13,138,12,15,-3
30,13,139,16,35,-19
30,13,140,9,13,-4
30,13,141,14,23,-9
30,13,142,11,22,-11
30,13,143,5,11,-6
30,13,144,12,31,-19
30,13,145,12,25,-13
30,13,146,8,20,-12
30,13,147,1,21,-20
30,13,148,7,10,-3
30,13,149,9,12,-3
30,13,150,8,18,-10
30,13,151,5,26,-21
30,13,152,7,15,-8
30,13,153,15,19,-4
30,13,154,12,16,-4
30,13,155,1,15,-14
30,13,156,12,8,4
30,13,157,12,25,-13
30,13,158,14,27,-13
30,13,159,12,13,-1
30,13,160,14,23,-9
30,13,161,1,19,-18
30,13,162,14,29,-15
30,13,163,16,26,-10
30,13,164,12,18,-6
30,13,165,10,22,-12
30,13,166,7,19,-12
30,13,167,12,23,-11
30,13,168,1,7,-6
30,13,169,4,15,-11
30,13,170,3,14,-11
30,13,171,14,21,-7
30,13,172,14,16,-2
30,13,173,5,16,-11
30,13,174,8,6,2
30,13,175,11,16,-5
30,13,176,15,20,-5
30,13,177,14,21,-7
30,13,178,11,24,-13
30,13,179,7,19,-12
30,13,180,4,8,-4
30,13,181,14,18,-4
30,13,182,5,12,-7
30,13,183,2,10,-8
30,13,184,11,16,-5
30,13,185,10,29,-19
30,13,186,10,23,-13
30,13,187,8,33,-25
30,13,188,5,12,-7
30,13,189,19,16,3
30,13,190,11,20,-9
30,13,191,9,20,-11
30,13,192,6,14,-8
30,13,193,12,10,2
30,13,194,9,13,-4
30,13,195,8,17,-9
30,13,196,13,23,-10
30,13,197,14,32,-18
30,13,198,21,30,-9
30,13,199,6,14,-8
30,13,200,15,13,2
30,13,201,21,24,-3
30,13,202,10,12,-2
30,13,203,10,13,-3
30,13,204,5,14,-9
30,13,205,8,20,-12
30,13,206,14,27,-13
30,13,207,15,21,-6
30,13,208,14,29,-15
30,13,209,17,32,-15
30,13,210,5,21,-16
30,13,211,8,18,-10
30,13,212,7,18,-11
30,13,213,3,9,-6
30,13,214,12,14,-2
30,13,215,15,26,-11
30,13,216,11,13,-2
30,13,217,17,20,-3
30,13,218,20,14,6
30,13,219,7,13,-6
30,13,220,6,32,-26
30,13,221,12,18,-6
30,13,222,7,22,-15
30,13,223,17,21,-4
30,13,224,11,24,-13
30,13,225,20,13,7
30,13,226,7,7,0
30,13,227,12,28,-16
30,13,228,7,25,-18
30,13,229,5,16,-11
30,13,230,17,27,-10
30,13,231,8,20,-12
30,13,232,2,22,-20
30,13,233,9,15,-6
30,13,234,15,17,-2
30,13,235,14,11,3
30,13,236,8,14,-6
30,13,237,11,13,-2
30,13,238,8,21,-13
30,13,239,5,17,-12
30,13,240,5,12,-7
30,13,241,6,15,-9
30,13,242,7,9,-2
30,13,243,21,14,7
30,13,244,13,7,6
30,13,245,9,14,-5
30,13,246,10,21,-11
30,13,247,9,10,-1
30,13,248,15,18,-3
30,13,249,8,17,-9
30,13,250,9,19,-10
30,13,251,19,21,-2
30,13,252,17,27,-10
30,13,253,2,25,-23
30,13,254,7,12,-5
30,13,255,10,13,-3
30,13,256,17,16,1
30,13,257,11,11,0
30,13,258,12,23,-11
30,13,259,3,16,-13
30,13,260,8,6,2
30,13,261,10,21,-11
30,13,262,13,13,0
30,13,263,13,15,-2
30,13,264,9,12,-3
30,13,265,8,21,-13
30,13,266,2,20,-18
30,13,267,11,15,-4
30,13,268,13,25,-12
30,13,269,20,12,8
30,13,270,13,18,-5
30,13,271,12,45,-33
30,13,272,5,10,-5
30,13,273,11,7,4
30,13,274,17,26,-9
30,13,275,14,20,-6
30,13,276,16,20,-4
30,13,277,8,3,5
30,13,278,4,16,-12
30,13,279,9,9,0
30,13,280,9,22,-13
30,13,281,12,26,-14
30,13,282,5,9,-4
30,13,283,9,33,-24
30,13,284,15,36,-21
30,13,285,5,16,-11
30,13,286,6,29,-23
30,13,287,9,18,-9
30,13,288,13,15,-2
30,13,289,14,31,-17
30,13,290,5,14,-9
30,13,291,9,19,-10
30,13,292,13,8,5
30,13,293,16,10,6
30,13,294,3,9,-6
30,13,295,11,17,-6
30,13,296,6,5,1
30,13,297,8,20,-12
30,13,298,9,18,-9
30,13,299,7,10,-3
30,14,0,7,25,-18
30,14,1,27,19,8
30,14,2,13,19,-6
30,14,3,4,12,-8
30,14,4,15,18,-3
30,14,5,14,17,-3
30,14,6,15,28,-13
30,14,7,13,24,-11
30,14,8,7,11,-4
30,14,9,9,21,-12
30,14,10,13,25,-12
30,14,11,9,22,-13
30,14,12,9,31,-22
30,14,13,7,15,-8
30,14,14,4,6,-2
30,14,15,9,22,-13
30,14,16,16,14,2
30,14,17,8,22,-14
30,14,18,13,24,-11
30,14,19,10,22,-12
30,14,20,10,25,-15
30,14,21,9,25,-16
30,14,22,8,12,-4
30,14,23,3,22,-19
30,14,24,10,20,-10
30,14,25,7,29,-22
30,14,26,10,12,-2
30,14,27,9,23,-14
30,14,28,10,16,-6
30,14,29,10,24,-14
30,14,30,19,25,-6
30,14,31,6,24,-18
30,14,32,13,31,-18
30,14,33,4,23,-19
30,14,34,1,26,-25
30,14,35,10,17,-7
30,14,36,13,17,-4
30,14,37,7,17,-10
30,14,38,10,32,-22
30,14,39,9,27,-18
30,14,40,10,20,-10
30,14,41,4,23,-19
30,14,42,13,11,2
30,14,43,3,18,-15
30,14,44,13,17,-4
30,14,45,9,18,-9
30,14,46,8,14,-6
30,14,47,9,24,-15
30,14,48,8,16,-8
30,14,49,4,13,-9
30,14,50,4,29,-25
30,14,51,9,7,2
30,14,52,18,21,-3
30,14,53,11,19,-8
30,14,54,6,24,-18
30,14,55,11,16,-5
30,14,56,10,18,-8
30,14,57,6,19,-13
30,14,58,11,20,-9
30,14,59,11,14,-3
30,14,60,4,23,-19
30,14,61,16,20,-4
30,14,62,13,21,-8
30,14,63,15,34,-19
30,14,64,11,22,-11
30,14,65,11,11,0
30,14,66,11,18,-7
30,14,67,7,23,-16
30,14,68,14,25,-11
30,14,69,14,19,-5
30,14,70,13,18,-5
30,14,71,6,23,-17
30,14,72,10,16,-6
30,14,73,2,19,-17
30,14,74,12,30,-18
30,14,75,17,8,9
30,14,76,15,18,-3
30,14,77,3,19,-16
30,14,78,11,28,-17
30,14,79,14,21,-7
30,14,80,4,13,-9
30,14,81,6,21,-15
30,14,82,9,5,4
30,14,83,9,15,-6
30,14,84,9,14,-5
30,14,85,14,21,-7
30,14,86,12,15,-3
30,14,87,9,14,-5
30,14,88,9,12,-3
30,14,89,5,14,-9
30,14,90,3,14,-11
30,14,91,10,23,-13
30,14,92,11,21,-10
30,14,93,19,30,-11
30,14,94,11,20,-9
30,14,95,11,24,-13
30,14,96,8,17,-9
30,14,97,15,17,-2
30,14,98,5,12,-7
30,14,99,21,16,5
30,14,100,5,9,-4
30,14,101,6,26,-20
30,14,102,11,11,0
30,14,103,14,23,-9
30,14,104,12,24,-12
30,14,105,4,17,-13
30,14,106,10,17,-7
30,14,107,18,16,2
30,14,108,7,24,-17
30,14,109,20,22,-2
30,14,110,10,14,-4
30,14,111,8,21,-13
30,14,112,5,10,-5
30,14,113,10,20,-10
30,14,114,14,16,-2
30,14,115,9,23,-14
30,14,116,10,23,-13
30,14,117,10,20,-10
30,14,118,5,16,-11
30,14,119,6,20,-14
30,14,120,2,14,-12
30,14,121,8,10,-2
30,14,122,2,14,-12
30,14,123,20,27,-7
30,14,124,13,19,-6
30,14,125,5,17,-12
30,14,126,20,17,3
30,14,127,11,9,2
30,14,128,13,27,-14
30,14,129,13,24,-11
30,14,130,18,12,6
30,14,131,11,33,-22
30,14,132,11,13,-2
30,14,133,9,13,-4
30,14,134,12,32,-20
30,14,135,18,18,0
30,14,136,3,8,-5
30,14,137,2,12,-10
30,14,138,7,12,-5
30,14,139,21,19,2
30,14,140,22,40,-18
30,14,141,7,18,-11
30,14,142,4,22,-18
30,14,143,8,34,-26
30,14,144,7,13,-6
30,14,145,18,11,7
30,14,146,4,17,-13
30,14,147,5,32,-27
30,14,148,17,21,-4
30,14,149,12,34,-22
30,14,150,7,22,-15
30,14,151,7,5,2
30,14,152,15,16,-1
30,14,153,20,27,-7
30,14,154,10,25,-15
30,14,155,14,19,-5
30,14,156,12,22,-10
30,14,157,7,19,-12
30,14,158,10,21,-11
30,14,159,10,10,0
30,14,160,9,14,-5
30,14,161,6,19,-13
30,14,162,12,9,3
30,14,163,9,20,-11
30,14,164,8,25,-17
30,14,165,18,14,4
30,14,166,7,11,-4
30,14,167,6,11,-5
30,14,168,11,27,-16
30,14,169,13,15,-2
30,14,170,17,31,-14
30,14,171,8,9,-1
30,14,172,7,21,-14
30,14,173,8,10,-2
30,14,174,6,15,-9
30,14,175,11,18,-7
30,14,176,10,35,-25
30,14,177,3,13,-10
30,14,178,9,15,-6
30,14,179,16,18,-2
30,14,180,10,18,-8
30,14,181,3,14,-11
30,14,182,18,20,-2
30,14,183,15,20,-5
30,14,184,12,17,-5
30,14,185,13,12,1
30,14,186,4,13,-9
30,14,187,6,25,-19
30,14,188,11,14,-3
30,14,189,6,7,-1
30,14,190,9,21,-12
30,14,191,18,34,-16
30,14,192,12,16,-4
30,14,193,22,27,-5
30,14,194,12,24,-12
30,14,195,11,18,-7
30,14,196,12,15,-3
30,14,197,5,26,-21
30,14,198,11,18,-7
30,14,199,13,21,-8
30,14,200,6,4,2
30,14,201,18,41,-23
30,14,202,16,17,-1
30,14,203,8,19,-11
30,14,204,8,22,-14
30,14,205,10,15,-5
30,14,206,16,25,-9
30,14,207,7,14,-7
30,14,208,13,25,-12
30,14,209,14,10,4
30,14,210,5,23,-18
30,14,211,11,32,-21
30,14,212,2,34,-32
30,14,213,12,18,-6
30,14,214,7,26,-19
30,14,215,12,12,0
30,14,216,11,16,-5
30,14,217,5,12,-7
30,14,218,3,12,-9
30,14,219,2,8,-6
30,14,220,14,13,1
30,14,221,17,13,4
30,14,222,15,23,-8
30,14,223,9,15,-6
30,14,224,13,9,4
30,14,225,7,9,-2
30,14,226,4,7,-3
30,14,227,15,16,-1
30,14,228,2,10,-8
30,14,229,16,13,3
30,14,230,10,15,-5
30,14,231,4,10,-6
30,14,232,12,16,-4
30,14,233,15,16,-1
30,14,234,10,4,6
30,14,235,7,10,-3
30,14,236,8,21,-13
30,14,237,17,23,-6
30,14,238,3,16,-13
30,14,239,8,17,-9
30,14,240,11,19,-8
30,14,241,5,21,-16
30,14,242,11,20,-9
30,14,243,6,8,-2
30,14,244,8,15,-7
30,14,245,13,10,3
30,14,246,16,31,-15
30,14,247,9,12,-3
30,14,248,14,11,3
30,14,249,11,12,-1
30,14,250,11,27,-16
30,14,251,10,23,-13
30,14,252,9,23,-14
30,14,253,2,11,-9
30,14,254,5,8,-3
30,14,255,7,17,-10
30,14,256,14,12,2
30,14,257,14,15,-1
30,14,258,6,16,-10
30,14,259,14,18,-4
30,14,260,17,16,1
30,14,261,11,21,-10
30,14,262,7,13,-6
30,14,263,11,27,-16
30,14,264,4,13,-9
30,14,265,2,5,-3
30,14,266,10,17,-7
30,14,267,4,20,-16
30,14,268,7,14,-7
30,14,269,19,17,2
30,14,270,11,29,-18
30,14,271,8,15,-7
30,14,272,23,32,-9
30,14,273,15,8,7
30,14,274,12,29,-17
30,14,275,4,10,-6
30,14,276,12,15,-3
30,14,277,6,10,-4
30,14,278,14,24,-10
30,14,279,22,12,10
30,14,280,6,25,-19
30,14,281,3,10,-7
30,14,282,20,22,-2
30,14,283,13,14,-1
30,14,284,5,25,-20
30,14,285,16,18,-2
30,14,286,9,16,-7
30,14,287,12,10,2
30,14,288,12,14,-2
30,14,289,10,15,-5
30,14,290,10,10,0
30,14,291,10,35,-25
30,14,292,2,7,-5
30,14,293,7,15,-8
30,14,294,9,22,-13
30,14,295,14,28,-14
30,14,296,14,17,-3
30,14,297,17,17,0
30,14,298,9,18,-9
30,14,299,8,16,-8
30,15,0,4,27,-23
30,15,1,6,3,3
30,15,2,7,15,-8
30,15,3,7,16,-9
30,15,4,9,19,-10
30,15,5,17,27,-10
30,15,6,13,20,-7
30,15,7,2,11,-9
30,15,8,10,38,-28
30,15,9,6,34,-28
30,15,10,15,15,0
30,15,11,14,20,-6
30,15,12,12,21,-9
30,15,13,13,14,-1
30,15,14,7,17,-10
30,15,15,7,14,-7
30,15,16,7,32,-25
30,15,17,4,17,-13
30,15,18,11,26,-15
30,15,19,13,17,-4
30,15,20,7,19,-12
30,15,21,17,23,-6
30,15,22,6,14,-8
30,15,23,11,22,-11
30,15,24,9,15,-6
30,15,25,9,12,-3
30,15,26,7,13,-6
30,15,27,8,16,-8
30,15,28,7,20,-13
30,15,29,12,18,-6
30,15,30,24,29,-5
30,15,31,9,14,-5
30,15,32,8,10,-2
30,15,33,9,20,-11
30,15,34,5,13,-8
30,15,35,6,16,-10
30,15,36,3,11,-8
30,15,37,16,16,0
30,15,38,4,25,-21
30,15,39,5,17,-12
30,15,40,10,27,-17
30,15,41,12,14,-2
30,15,42,14,26,-12
30,15,43,9,23,-14
30,15,44,14,21,-7
30,15,45,13,24,-11
30,15,46,18,32,-14
30,15,47,11,19,-8
30,15,48,20,20,0
30,15,49,14,14,0
30,15,50,12,22,-10
30,15,51,14,21,-7
30,15,52,10,9,1
30,15,53,12,24,-12
30,15,54,9,21,-12
30,15,55,11,28,-17
30,15,56,6,16,-10
30,15,57,10,12,-2
30,15,58,17,18,-1
30,15,59,7,21,-14
30,15,60,2,17,-15
30,15,61,1,16,-15
30,15,62,13,22,-9
30,15,63,9,16,-7
30,15,64,6,18,-12
30,15,65,7,32,-25
30,15,66,5,14,-9
30,15,67,6,20,-14
30,15,68,9,21,-12
30,15,69,6,22,-16
30,15,70,9,15,-6
30,15,71,16,33,-17
30,15,72,5,15,-10
30,15,73,14,13,1
30,15,74,8,15,-7
30,15,75,15,18,-3
30,15,76,18,17,1
30,15,77,14,23,-9
30,15,78,8,15,-7
30,15,79,22,18,4
30,15,80,7,16,-9
30,15,81,8,13,-5
30,15,82,16,17,-1
30,15,83,8,21,-13
30,15,84,13,37,-24
30,15,85,4,11,-7
30,15,86,14,18,-4
30,15,87,5,20,-15
30,15,88,9,15,-6
30,15,89,20,39,-19
30,15,90,11,23,-12
30,15,91,12,21,-9
30,15,92,9,18,-9
30,15,93,23,25,-2
30,15,94,0,13,-13
30,15,95,7,19,-12
30,15,96,15,40,-25
30,15,97,7,19,-12
30,15,98,9,20,-11
30,15,99,10,27,-17
30,15,100,8,27,-19
30,15,101,6,11,-5
30,15,102,4,20,-16
30,15,103,11,26,-15
30,15,104,1,7,-6
30,15,105,12,22,-10
30,15,106,6,3,3
30,15,107,5,13,-8
30,15,108,9,13,-4
30,15,109,3,19,-16
30,15,110,16,19,-3
30,15,111,22,16,6
30,15,112,18,19,-1
30,15,113,12,15,-3
30,15,114,14,9,5
30,15,115,11,17,-6
30,15,116,8,9,-1
30,15,117,9,11,-2
30,15,118,2,19,-17
30,15,119,7,18,-11
30,15,120,5,11,-6
30,15,121,10,23,-13
30,15,122,6,24,-18
30,15,123,10,9,1
30,15,124,12,15,-3
30,15,125,5,25,-20
30,15,126,11,10,1
30,15,127,9,16,-7
30,15,128,13,14,-1
30,15,129,14,11,3
30,15,130,13,19,-6
30,15,131,10,20,-10
30,15,132,3,19,-16
30,15,133,7,19,-12
30,15,134,11,10,1
30,15,135,7,23,-16
30,15,136,10,20,-10
30,15,137,5,33,-28
30,15,138,19,18,1
30,15,139,5,12,-7
30,15,140,6,27,-21
30,15,141,7,18,-11
30,15,142,7,17,-10
30,15,143,7,29,-22
30,15,144,6,15,-9
30,15,145,7,16,-9
30,15,146,14,16,-2
30,15,147,9,13,-4
30,15,148,5,14,-9
30,15,149,6,23,-17
30,15,150,13,33,-20
30,15,151,19,17,2
30,15,152,6,14,-8
30,15,153,12,16,-4
30,15,154,11,20,-9
30,15,155,13,20,-7
30,15,156,6,7,-1
30,15,157,7,12,-5
30,15,158,9,15,-6
30,15,159,12,25,-13
30,15,160,5,17,-12
30,15,161,6,14,-8
30,15,162,13,19,-6
30,15,163,15,17,-2
30,15,164,5,14,-9
30,15,165,14,17,-3
30,15,166,4,17,-13
30,15,167,7,25,-18
30,15,168,17,16,1
30,15,169,9,18,-9
30,15,170,11,13,-2
30,15,171,5,10,-5
30,15,172,12,31,-19
30,15,173,8,15,-7
30,15,174,11,10,1
30,15,175,8,21,-13
30,15,176,11,12,-1
30,15,177,9,14,-5
30,15,178,10,31,-21
30,15,179,25,16,9
30,15,180,9,22,-13
30,15,181,5,16,-11
30,15,182,11,26,-15
30,15,183,4,11,-7
30,15,184,11,16,-5
30,15,185,12,16,-4
30,15,186,14,33,-19
30,15,187,13,15,-2
30,15,188,10,22,-12
30,15,189,2,13,-11
30,15,190,5,9,-4
30,15,191,9,28,-19
30,15,192,8,20,-12
30,15,193,9,16,-7
30,15,194,14,12,2
30,15,195,12,13,-1
30,15,196,16,23,-7
30,15,197,6,14,-8
30,15,198,5,23,-18
30,15,199,14,35,-21
30,15,200,3,26,-23
30,15,201,8,19,-11
30,15,202,6,5,1
30,15,203,16,17,-1
30,15,204,5,8,-3
30,15,205,6,24,-18
30,15,206,4,10,-6
30,15,207,10,12,-2
30,15,208,11,17,-6
30,15,209,8,15,-7
30,15,210,6,9,-3
30,15,211,14,9,5
30,15,212,7,11,-4
30,15,213,8,17,-9
30,15,214,7,8,-1
30,15,215,14,13,1
30,15,216,9,21,-12
30,15,217,9,10,-1
30,15,218,8,19,-11
30,15,219,19,7,12
30,15,220,11,11,0
30,15,221,2,12,-10
30,15,222,2,12,-10
30,15,223,9,24,-15
30,15,224,10,25,-15
30,15,225,6,25,-19
30,15,226,4,25,-21
30,15,227,10,31,-21
30,15,228,13,15,-2
30,15,229,13,18,-5
30,15,230,9,6,3
30,15,231,9,29,-20
30,15,232,7,16,-9
30,15,233,13,23,-10
30,15,234,25,26,-1
30,15,235,7,25,-18
30,15,236,14,14,0
30,15,237,7,15,-8
30,15,238,16,36,-20
30,15,239,5,17,-12
30,15,240,7,14,-7
30,15,241,5,20,-15
30,15,242,11,24,-13
30,15,243,18,28,-10
30,15,244,8,12,-4
30,15,245,4,20,-16
30,15,246,9,16,-7
30,15,247,5,15,-10
30,15,248,12,24,-12
30,15,249,6,17,-11
30,15,250,14,10,4
30,15,251,1,14,-13
30,15,252,10,33,-23
30,15,253,17,28,-11
30,15,254,14,16,-2
30,15,255,4,15,-11
30,15,256,13,32,-19
30,15,257,14,11,3
30,15,258,12,14,-2
30,15,259,13,7,6
30,15,260,9,18,-9
30,15,261,3,15,-12
30,15,262,7,13,-6
30,15,263,14,28,-14
30,15,264,12,28,-16
30,15,265,16,17,-1
30,15,266,18,24,-6
30,15,267,11,14,-3
30,15,268,10,28,-18
30,15,269,19,31,-12
30,15,270,13,16,-3
30,15,271,8,21,-13
30,15,272,8,14,-6
30,15,273,12,19,-7
30,15,274,13,26,-13
30,15,275,14,26,-12
30,15,276,4,10,-6
30,15,277,12,21,-9
30,15,278,4,12,-8
30,15,279,10,21,-11
30,15,280,8,13,-5
30,15,281,5,13,-8
30,15,282,6,12,-6
30,15,283,20,20,0
30,15,284,10,12,-2
30,15,285,3,21,-18
30,15,286,8,16,-8
30,15,287,10,9,1
30,15,288,7,18,-11
30,15,289,10,22,-12
30,15,290,11,20,-9
30,15,291,12,27,-15
30,15,292,12,17,-5
30,15,293,17,12,5
30,15,294,4,22,-18
30,15,295,2,20,-18
30,15,296,18,19,-1
30,15,297,10,13,-3
30,15,298,9,13,-4
30,15,299,6,23,-17
30,16,0,5,22,-17
30,16,1,14,6,8
30,16,2,8,11,-3
30,16,3,6,15,-9
30,16,4,17,12,5
30,16,5,12,14,-2
30,16,6,3,13,-10
30,16,7,20,12,8
30,16,8,10,18,-8
30,16,9,11,15,-4
30,16,10,13,16,-3
30,16,11,5,18,-13
30,16,12,7,21,-14
30,16,13,9,17,-8
30,16,14,19,20,-1
30,16,15,16,29,-13
30,16,16,3,21,-18
30,16,17,14,16,-2
30,16,18,18,18,0
30,16,19,4,11,-7
30,16,20,9,22,-13
30,16,21,5,9,-4
30,16,22,15,20,-5
30,16,23,5,10,-5
30,16,24,13,8,5
30,16,25,14,19,-5
30,16,26,16,20,-4
30,16,27,13,25,-12
30,16,28,8,14,-6
30,16,29,9,20,-11
30,16,30,8,15,-7
30,16,31,3,12,-9
30,16,32,7,24,-17
30,16,33,12,17,-5
30,16,34,12,12,0
30,16,35,11,25,-14
30,16,36,10,12,-2
30,16,37,14,12,2
30,16,38,4,11,-7
30,16,39,5,26,-21
30,16,40,7,26,-19
30,16,41,7,8,-1
30,16,42,9,25,-16
30,16,43,7,16,-9
30,16,44,15,21,-6
30,16,45,9,19,-10
30,16,46,9,17,-8
30,16,47,17,16,1
30,16,48,11,22,-11
30,16,49,4,12,-8
30,16,50,7,33,-26
30,16,51,10,17,-7
30,16,52,15,18,-3
30,16,53,3,6,-3
30,16,54,12,20,-8
30,16,55,11,22,-11
30,16,56,12,30,-18
30,16,57,14,18,-4
30,16,58,9,10,-1
30,16,59,5,12,-7
30,16,60,11,15,-4
30,16,61,12,18,-6
30,16,62,10,15,-5
30,16,63,10,21,-11
30,16,64,7,25,-18
30,16,65,14,18,-4
30,16,66,7,16,-9
30,16,67,18,17,1
30,16,68,8,10,-2
30,16,69,13,14,-1
30,16,70,6,14,-8
30,16,71,17,15,2
30,16,72,12,15,-3
30,16,73,15,28,-13
30,16,74,11,23,-12
30,16,75,13,32,-19
30,16,76,15,16,-1
30,16,77,11,14,-3
30,16,78,15,21,-6
30,16,79,5,22,-17
30,16,80,16,31,-15
30,16,81,4,16,-12
30,16,82,12,13,-1
30,16,83,7,7,0
30,16,84,17,19,-2
30,16,85,3,23,-20
30,16,86,11,10,1
30,16,87,18,16,2
30,16,88,14,22,-8
30,16,89,4,25,-21
30,16,90,9,19,-10
30,16,91,16,23,-7
30,16,92,8,16,-8
30,16,93,18,19,-1
30,16,94,4,10,-6
30,16,95,10,16,-6
30,16,96,19,6,13
30,16,97,3,3,0
30,16,98,9,25,-16
30,16,99,6,17,-11
30,16,100,10,17,-7
30,16,101,11,18,-7
30,16,102,10,39,-29
30,16,103,9,15,-6
30,16,104,21,27,-6
30,16,105,5,20,-15
30,16,106,11,16,-5
30,16,107,5,23,-18
30,16,108,15,36,-21
30,16,109,11,14,-3
30,16,110,6,29,-23
30,16,111,7,11,-4
30,16,112,7,13,-6
30,16,113,17,11,6
30,16,114,14,25,-11
30,16,115,8,22,-14
30,16,116,4,11,-7
30,16,117,3,12,-9
30,16,118,15,24,-9
30,16,119,8,17,-9
30,16,120,10,31,-21
30,16,121,17,20,-3
30,16,122,13,11,2
30,16,123,10,16,-6
30,16,124,10,11,-1
30,16,125,14,25,-11
30,16,126,15,21,-6
30,16,127,9,11,-2
30,16,128,6,9,-3
30,16,129,12,17,-5
30,16,130,12,6,6
30,16,131,4,10,-6
30,16,132,7,12,-5
30,16,133,4,14,-10
30,16,134,4,15,-11
30,16,135,11,13,-2
30,16,136,13,19,-6
30,16,137,6,16,-10
30,16,138,16,12,4
30,16,139,26,18,8
30,16,140,4,12,-8
30,16,141,3,16,-13
30,16,142,15,17,-2
30,16,143,9,8,1
30,16,144,18,17,1
30,16,145,5,11,-6
30,16,146,1,16,-15
30,16,147,15,9,6
30,16,148,20,12,8
30,16,149,7,27,-20
30,16,150,10,13,-3
30,16,151,6,16,-10
30,16,152,6,18,-12
30,16,153,13,14,-1
30,16,154,5,12,-7
30,16,155,9,19,-10
30,16,156,11,20,-9
30,16,157,9,20,-11
30,16,158,8,16,-8
30,16,159,7,4,3
30,16,160,11,21,-10
30,16,161,13,22,-9
30,16,162,5,15,-10
30,16,163,10,17,-7
30,16,164,15,13,2
30,16,165,16,25,-9
30,16,166,20,15,5
30,16,167,7,10,-3
30,16,168,15,21,-6
30,16,169,8,28,-20
30,16,170,5,9,-4
30,16,171,14,9,5
30,16,172,6,5,1
30,16,173,17,17,0
30,16,174,12,32,-20
30,16,175,3,24,-21
30,16,176,16,22,-6
30,16,177,14,12,2
30,16,178,28,28,0
30,16,179,8,12,-4
30,16,180,3,17,-14
30,16,181,12,15,-3
30,16,182,14,14,0
30,16,183,11,19,-8
30,16,184,6,27,-21
30,16,185,8,18,-10
30,16,186,14,25,-11
30,16,187,9,15,-6
30,16,188,15,15,0
30,16,189,8,9,-1
30,16,190,8,13,-5
30,16,191,2,6,-4
30,16,192,10,14,-4
30,16,193,10,14,-4
30,16,194,18,21,-3
30,16,195,15,21,-6
30,16,196,4,7,-3
30,16,197,10,25,-15
30,16,198,18,15,3
30,16,199,6,17,-11
30,16,200,13,9,4
30,16,201,22,12,10
30,16,202,6,7,-1
30,16,203,7,16,-9
30,16,204,15,15,0
30,16,205,6,8,-2
30,16,206,7,23,-16
30,16,207,8,9,-1
30,16,208,16,13,3
30,16,209,15,24,-9
30,16,210,12,15,-3
30,16,211,8,20,-12
30,16,212,7,7,0
30,16,213,7,19,-12
30,16,214,13,21,-8
30,16,215,19,7,12
30,16,216,10,8,2
30,16,217,9,12,-3
30,16,218,9,13,-4
30,16,219,6,16,-10
30,16,220,7,14,-7
30,16,221,14,18,-4
30,16,222,6,13,-7
30,16,223,10,21,-11
30,16,224,7,14,-7
30,16,225,5,18,-13
30,16,226,12,26,-14
30,16,227,8,14,-6
30,16,228,14,22,-8
30,16,229,15,25,-10
30,16,230,19,19,0
30,16,231,16,18,-2
30,16,232,10,22,-12
30,16,233,16,23,-7
30,16,234,16,19,-3
30,16,235,16,9,7
30,16,236,9,25,-16
30,16,237,10,15,-5
30,16,238,6,24,-18
30,16,239,14,20,-6
30,16,240,11,24,-13
30,16,241,18,22,-4
30,16,242,24,14,10
30,16,243,9,21,-12
30,16,244,10,14,-4
30,16,245,13,6,7
30,16,246,9,36,-27
30,16,247,16,18,-2
30,16,248,11,14,-3
30,16,249,24,36,-12
30,16,250,7,7,0
30,16,251,10,11,-1
30,16,252,5,18,-13
30,16,253,7,12,-5
30,16,254,9,26,-17
30,16,255,8,12,-4
30,16,256,11,28,-17
30,16,257,10,18,-8
30,16,258,10,14,-4
30,16,259,7,14,-7
30,16,260,5,23,-18
30,16,261,14,18,-4
30,16,262,11,19,-8
30,16,263,9,17,-8
30,16,264,16,23,-7
30,16,265,14,26,-12
30,16,266,11,27,-16
30,16,267,6,14,-8
30,16,268,6,22,-16
30,16,269,21,17,4
30,16,270,13,12,1
30,16,271,11,12,-1
30,16,272,14,21,-7
30,16,273,10,19,-9
30,16,274,10,10,0
30,16,275,9,13,-4
30,16,276,15,17,-2
30,16,277,21,11,10
30,16,278,14,11,3
30,16,279,9,24,-15
30,16,280,4,2,2
30,16,281,6,5,1
30,16,282,26,24,2
30,16,283,5,13,-8
30,16,284,10,16,-6
30,16,285,17,27,-10
30,16,286,14,15,-1
30,16,287,12,11,1
30,16,288,7,15,-8
30,16,289,12,14,-2
30,16,290,11,25,-14
30,16,291,19,10,9
30,16,292,11,23,-12
30,16,293,16,17,-1
30,16,294,12,17,-5
30,16,295,8,22,-14
30,16,296,3,9,-6
30,16,297,9,15,-6
30,16,298,7,17,-10
30,16,299,13,20,-7
30,17,0,11,20,-9
30,17,1,6,15,-9
30,17,2,8,11,-3
30,17,3,8,6,2
30,17,4,11,12,-1
30,17,5,6,14,-8
30,17,6,4,17,-13
30,17,7,2,5,-3
30,17,8,16,16,0
30,17,9,11,15,-4
30,17,10,4,17,-13
30,17,11,13,12,1
30,17,12,13,10,3
30,17,13,11,23,-12
30,17,14,6,13,-7
30,17,15,9,11,-2
30,17,16,16,29,-13
30,17,17,5,10,-5
30,17,18,16,17,-1
30,17,19,10,19,-9
30,17,20,7,10,-3
30,17,21,7,19,-12
30,17,22,15,33,-18
30,17,23,10,8,2
30,17,24,16,16,0
30,17,25,22,20,2
30,17,26,9,22,-13
30,17,27,6,21,-15
30,17,28,11,17,-6
30,17,29,11,17,-6
30,17,30,9,17,-8
30,17,31,20,20,0
30,17,32,10,19,-9
30,17,33,14,10,4
30,17,34,4,17,-13
30,17,35,25,13,12
30,17,36,11,19,-8
30,17,37,9,19,-10
30,17,38,6,22,-16
30,17,39,8,10,-2
30,17,40,7,15,-8
30,17,41,8,17,-9
30,17,42,3,6,-3
30,17,43,13,8,5
30,17,44,16,14,2
30,17,45,18,26,-8
30,17,46,12,19,-7
30,17,47,3,19,-16
30,17,48,12,14,-2
30,17,49,8,24,-16
30,17,50,8,26,-18
30,17,51,15,21,-6
30,17,52,28,21,7
30,17,53,8,2,6
30,17,54,12,10,2
30,17,55,9,15,-6
30,17,56,18,30,-12
30,17,57,22,27,-5
30,17,58,9,24,-15
30,17,59,17,17,0
30,17,60,19,15,4
30,17,61,6,19,-13
30,17,62,6,15,-9
30,17,63,8,6,2
30,17,64,7,20,-13
30,17,65,14,26,-12
30,17,66,5,10,-5
30,17,67,3,10,-7
30,17,68,7,33,-26
30,17,69,15,10,5
30,17,70,18,31,-13
30,17,71,8,9,-1
30,17,72,11,16,-5
30,17,73,9,15,-6
30,17,74,2,13,-11
30,17,75,23,32,-9
30,17,76,8,14,-6
30,17,77,17,16,1
30,17,78,11,20,-9
30,17,79,10,32,-22
30,17,80,12,17,-5
30,17,81,4,15,-11
30,17,82,17,42,-25
30,17,83,15,9,6
30,17,84,12,17,-5
30,17,85,9,7,2
30,17,86,8,16,-8
30,17,87,11,34,-23
30,17,88,8,16,-8
30,17,89,15,16,-1
30,17,90,8,12,-4
30,17,91,10,7,3
30,17,92,17,19,-2
30,17,93,18,12,6
30,17,94,14,24,-10
30,17,95,15,27,-12
30,17,96,11,16,-5
30,17,97,14,34,-20
30,17,98,9,15,-6
30,17,99,13,21,-8
30,17,100,8,20,-12
30,17,101,4,8,-4
30,17,102,3,15,-12
30,17,103,6,15,-9
30,17,104,15,22,-7
30,17,105,15,20,-5
30,17,106,7,16,-9
30,17,107,11,14,-3
30,17,108,12,5,7
30,17,109,13,33,-20
30,17,110,15,27,-12
30,17,111,13,14,-1
30,17,112,22,24,-2
30,17,113,21,24,-3
30,17,114,2,15,-13
30,17,115,25,31,-6
30,17,116,7,11,-4
30,17,117,16,20,-4
30,17,118,9,13,-4
30,17,119,11,16,-5
30,17,120,9,16,-7
30,17,121,6,17,-11
30,17,122,10,10,0
30,17,123,10,14,-4
30,17,124,8,13,-5
30,17,125,6,18,-12
30,17,126,18,14,4
30,17,127,7,11,-4
30,17,128,11,26,-15
30,17,129,14,22,-8
30,17,130,5,8,-3
30,17,131,14,13,1
30,17,132,10,2,8
30,17,133,5,7,-2
30,17,134,18,34,-16
30,17,135,10,21,-11
30,17,136,13,7,6
30,17,137,18,18,0
30,17,138,13,12,1
30,17,139,12,15,-3
30,17,140,20,28,-8
30,17,141,14,15,-1
30,17,142,9,13,-4
30,17,143,18,23,-5
30,17,144,2,2,0
30,17,145,8,21,-13
30,17,146,6,14,-8
30,17,147,10,18,-8
30,17,148,10,5,5
30,17,149,12,18,-6
30,17,150,12,20,-8
30,17,151,15,10,5
30,17,152,16,17,-1
30,17,153,6,13,-7
30,17,154,18,16,2
30,17,155,7,8,-1
30,17,156,9,20,-11
30,17,157,17,16,1
30,17,158,9,8,1
30,17,159,12,17,-5
30,17,160,6,22,-16
30,17,161,10,21,-11
30,17,162,21,5,16
30,17,163,5,11,-6
30,17,164,9,13,-4
30,17,165,4,24,-20
30,17,166,13,21,-8
30,17,167,10,24,-14
30,17,168,7,15,-8
30,17,169,11,14,-3
30,17,170,10,28,-18
30,17,171,9,14,-5
30,17,172,21,21,0
30,17,173,16,12,4
30,17,174,2,23,-21
30,17,175,11,12,-1
30,17,176,8,23,-15
30,17,177,9,13,-4
30,17,178,4,2,2
30,17,179,11,24,-13
30,17,180,10,11,-1
30,17,181,9,25,-16
30,17,182,12,15,-3
30,17,183,15,15,0
30,17,184,12,25,-13
30,17,185,11,13,-2
30,17,186,11,16,-5
30,17,187,11,14,-3
30,17,188,17,30,-13
30,17,189,8,14,-6
30,17,190,17,20,-3
30,17,191,17,16,1
30,17,192,4,16,-12
30,17,193,2,10,-8
30,17,194,15,13,2
30,17,195,12,19,-7
30,17,196,7,19,-12
30,17,197,13,15,-2
30,17,198,9,18,-9
30,17,199,13,25,-12
30,17,200,13,11,2
30,17,201,16,18,-2
30,17,202,11,10,1
30,17,203,13,14,-1
30,17,204,5,17,-12
30,17,205,9,16,-7
30,17,206,14,20,-6
30,17,207,13,20,-7
30,17,208,7,11,-4
30,17,209,14,27,-13
30,17,210,7,25,-18
30,17,211,8,16,-8
30,17,212,8,14,-6
30,17,213,12,17,-5
30,17,214,11,6,5
30,17,215,12,18,-6
30,17,216,12,25,-13
30,17,217,19,20,-1
30,17,218,10,25,-15
30,17,219,12,15,-3
30,17,220,14,22,-8
30,17,221,7,8,-1
30,17,222,11,18,-7
30,17,223,6,8,-2
30,17,224,9,19,-10
30,17,225,9,10,-1
30,17,226,1,11,-10
30,17,227,13,11,2
30,17,228,12,17,-5
30,17,229,4,16,-12
30,17,230,11,19,-8
30,17,231,11,18,-7
30,17,232,9,24,-15
30,17,233,14,17,-3
30,17,234,9,22,-13
30,17,235,7,19,-12
30,17,236,9,15,-6
30,17,237,6,10,-4
30,17,238,3,14,-11
30,17,239,9,12,-3
30,17,240,11,20,-9
30,17,241,9,15,-6
30,17,242,9,8,1
30,17,243,10,23,-13
30,17,244,5,7,-2
30,17,245,13,7,6
30,17,246,5,20,-15
30,17,247,13,10,3
30,17,248,12,28,-16
30,17,249,5,16,-11
30,17,250,12,24,-12
30,17,251,12,30,-18
30,17,252,12,12,0
30,17,253,15,28,-13
30,17,254,19,23,-4
30,17,255,3,10,-7
30,17,256,13,22,-9
30,17,257,21,23,-2
30,17,258,11,16,-5
30,17,259,6,14,-8
30,17,260,10,5,5
30,17,261,12,22,-10
30,17,262,11,17,-6
30,17,263,5,14,-9
30,17,264,14,14,0
30,17,265,15,24,-9
30,17,266,16,18,-2
30,17,267,7,20,-13
30,17,268,6,28,-22
30,17,269,6,22,-16
30,17,270,7,11,-4
30,17,271,13,27,-14
30,17,272,12,31,-19
30,17,273,18,15,3
30,17,274,8,5,3
30,17,275,2,13,-11
30,17,276,14,25,-11
30,17,277,15,18,-3
30,17,278,7,13,-6
30,17,279,13,16,-3
30,17,280,3,23,-20
30,17,281,10,16,-6
30,17,282,3,10,-7
30,17,283,16,21,-5
30,17,284,18,22,-4
30,17,285,9,12,-3
30,17,286,20,35,-15
30,17,287,12,14,-2
30,17,288,9,20,-11
30,17,289,7,22,-15
30,17,290,17,20,-3
30,17,291,15,25,-10
30,17,292,6,21,-15
30,17,293,11,24,-13
30,17,294,13,8,5
30,17,295,6,29,-23
30,17,296,14,19,-5
30,17,297,19,22,-3
30,17,298,21,4,17
30,17,299,5,6,-1
30,18,0,15,29,-14
30,18,1,9,28,-19
30,18,2,5,10,-5
30,18,3,5,15,-10
30,18,4,12,11,1
30,18,5,6,25,-19
30,18,6,8,10,-2
30,18,7,15,10,5
30,18,8,16,17,-1
30,18,9,9,12,-3
30,18,10,9,17,-8
30,18,11,5,12,-7
30,18,12,13,17,-4
30,18,13,8,17,-9
30,18,14,12,25,-13
30,18,15,11,15,-4
30,18,16,14,29,-15
30,18,17,9,21,-12
30,18,18,19,23,-4
30,18,19,16,19,-3
30,18,20,4,19,-15
30,18,21,3,15,-12
30,18,22,10,6,4
30,18,23,12,10,2
30,18,24,4,10,-6
30,18,25,12,6,6
30,18,26,11,10,1
30,18,27,8,15,-7
30,18,28,12,26,-14
30,18,29,11,22,-11
30,18,30,10,7,3
30,18,31,11,14,-3
30,18,32,15,11,4
30,18,33,5,6,-1
30,18,34,15,14,1
30,18,35,10,19,-9
30,18,36,13,24,-11
30,18,37,10,4,6
30,18,38,23,16,7
30,18,39,8,10,-2
30,18,40,13,12,1
30,18,41,20,20,0
30,18,42,10,21,-11
30,18,43,10,9,1
30,18,44,3,0,3
30,18,45,6,6,0
30,18,46,12,9,3
30,18,47,9,15,-6
30,18,48,10,11,-1
30,18,49,12,24,-12
30,18,50,13,10,3
30,18,51,5,12,-7
30,18,52,14,14,0
30,18,53,12,11,1
30,18,54,7,20,-13
30,18,55,11,22,-11
30,18,56,8,7,1
30,18,57,15,18,-3
30,18,58,6,7,-1
30,18,59,9,9,0
30,18,60,4,9,-5
30,18,61,9,8,1
30,18,62,15,22,-7
30,18,63,11,15,-4
30,18,64,11,27,-16
30,18,65,8,25,-17
30,18,66,7,21,-14
30,18,67,12,15,-3
30,18,68,9,16,-7
30,18,69,16,16,0
30,18,70,20,24,-4
30,18,71,9,22,-13
30,18,72,15,21,-6
30,18,73,14,16,-2
30,18,74,12,7,5
30,18,75,6,24,-18
30,18,76,20,17,3
30,18,77,19,5,14
30,18,78,6,27,-21
30,18,79,13,15,-2
30,18,80,16,22,-6
30,18,81,9,22,-13
30,18,82,18,9,9
30,18,83,14,12,2
30,18,84,11,4,7
30,18,85,18,9,9
30,18,86,12,20,-8
30,18,87,1,11,-10
30,18,88,12,11,1
30,18,89,9,11,-2
30,18,90,14,28,-14
30,18,91,10,19,-9
30,18,92,11,22,-11
30,18,93,16,12,4
30,18,94,7,7,0
30,18,95,8,23,-15
30,18,96,8,21,-13
30,18,97,13,21,-8
30,18,98,7,13,-6
30,18,99,13,33,-20
30,18,100,10,22,-12
30,18,101,8,16,-8
30,18,102,5,12,-7
30,18,103,15,12,3
30,18,104,9,16,-7
30,18,105,3,17,-14
30,18,106,15,21,-6
30,18,107,10,16,-6
30,18,108,7,11,-4
30,18,109,5,10,-5
30,18,110,6,33,-27
30,18,111,7,22,-15
30,18,112,11,24,-13
30,18,113,13,22,-9
30,18,114,5,12,-7
30,18,115,8,13,-5
30,18,116,16,27,-11
30,18,117,23,22,1
30,18,118,13,27,-14
30,18,119,10,12,-2
30,18,120,12,19,-7
30,18,121,8,19,-11
30,18,122,12,19,-7
30,18,123,8,21,-13
30,18,124,21,36,-15
30,18,125,11,17,-6
30,18,126,15,20,-5
30,18,127,6,22,-16
30,18,128,5,17,-12
30,18,129,11,30,-19
30,18,130,8,12,-4
30,18,131,11,13,-2
30,18,132,8,25,-17
30,18,133,7,11,-4
30,18,134,11,9,2
30,18,135,12,27,-15
30,18,136,9,10,-1
30,18,137,10,6,4
30,18,138,5,12,-7
30,18,139,5,17,-12
30,18,140,18,23,-5
30,18,141,4,18,-14
30,18,142,19,13,6
30,18,143,14,28,-14
30,18,144,11,14,-3
30,18,145,12,26,-14
30,18,146,9,21,-12
30,18,147,16,17,-1
30,18,148,4,12,-8
30,18,149,10,14,-4
30,18,150,8,8,0
30,18,151,9,27,-18
30,18,152,7,12,-5
30,18,153,11,23,-12
30,18,154,8,23,-15
30,18,155,7,6,1
30,18,156,11,14,-3
30,18,157,11,26,-15
30,18,158,5,19,-14
30,18,159,11,17,-6
30,18,160,13,15,-2
30,18,161,14,11,3
30,18,162,5,20,-15
30,18,163,4,14,-10
30,18,164,12,25,-13
30,18,165,10,5,5
30,18,166,5,13,-8
30,18,167,5,10,-5
30,18,168,4,18,-14
30,18,169,2,10,-8
30,18,170,4,19,-15
30,18,171,8,30,-22
30,18,172,8,14,-6
30,18,173,7,10,-3
30,18,174,17,19,-2
30,18,175,14,16,-2
30,18,176,5,6,-1
30,18,177,6,4,2
30,18,178,13,20,-7
30,18,179,12,12,0
30,18,180,19,8,11
30,18,181,12,15,-3
30,18,182,9,24,-15
30,18,183,13,26,-13
30,18,184,19,14,5
30,18,185,7,17,-10
30,18,186,17,21,-4
30,18,187,13,15,-2
30,18,188,15,26,-11
30,18,189,12,18,-6
30,18,190,12,12,0
30,18,191,12,2,10
30,18,192,8,4,4
30,18,193,11,26,-15
30,18,194,6,27,-21
30,18,195,8,18,-10
30,18,196,25,30,-5
30,18,197,20,21,-1
30,18,198,14,10,4
30,18,199,23,21,2
30,18,200,14,14,0
30,18,201,3,11,-8
30,18,202,14,13,1
30,18,203,7,17,-10
30,18,204,13,24,-11
30,18,205,12,10,2
30,18,206,8,10,-2
30,18,207,6,7,-1
30,18,208,9,13,-4
30,18,209,4,9,-5
30,18,210,16,12,4
30,18,211,12,22,-10
30,18,212,23,21,2
30,18,213,14,20,-6
30,18,214,13,18,-5
30,18,215,15,8,7
30,18,216,8,16,-8
30,18,217,8,9,-1
30,18,218,7,29,-22
30,18,219,10,18,-8
30,18,220,18,19,-1
30,18,221,12,13,-1
30,18,222,13,8,5
30,18,223,16,25,-9
30,18,224,12,19,-7
30,18,225,16,21,-5
30,18,226,14,9,5
30,18,227,5,12,-7
30,18,228,3,12,-9
30,18,229,9,20,-11
30,18,230,7,25,-18
30,18,231,11,14,-3
30,18,232,11,17,-6
30,18,233,11,21,-10
30,18,234,18,21,-3
30,18,235,6,10,-4
30,18,236,30,19,11
30,18,237,8,10,-2
30,18,238,7,13,-6
30,18,239,16,29,-13
30,18,240,6,12,-6
30,18,241,5,8,-3
30,18,242,10,17,-7
30,18,243,9,10,-1
30,18,244,1,10,-9
30,18,245,9,21,-12
30,18,246,16,17,-1
30,18,247,3,15,-12
30,18,248,13,15,-2
30,18,249,10,31,-21
30,18,250,9,14,-5
30,18,251,18,19,-1
30,18,252,15,17,-2
30,18,253,12,24,-12
30,18,254,14,15,-1
30,18,255,12,7,5
30,18,256,18,12,6
30,18,257,3,6,-3
30,18,258,1,11,-10
30,18,259,14,12,2
30,18,260,11,13,-2
30,18,261,7,16,-9
30,18,262,10,10,0
30,18,263,15,8,7
30,18,264,20,18,2
30,18,265,9,19,-10
30,18,266,9,8,1
30,18,267,11,15,-4
30,18,268,11,29,-18
30,18,269,5,19,-14
30,18,270,1,13,-12
30,18,271,11,12,-1
30,18,272,23,8,15
30,18,273,17,31,-14
30,18,274,8,19,-11
30,18,275,10,32,-22
30,18,276,10,20,-10
30,18,277,11,21,-10
30,18,278,10,22,-12
30,18,279,11,14,-3
30,18,280,9,9,0
30,18,281,8,9,-1
30,18,282,7,6,1
30,18,283,20,30,-10
30,18,284,11,21,-10
30,18,285,4,11,-7
30,18,286,1,4,-3
30,18,287,12,19,-7
30,18,288,6,13,-7
30,18,289,15,18,-3
30,18,290,7,15,-8
30,18,291,15,16,-1
30,18,292,21,21,0
30,18,293,7,21,-14
30,18,294,12,23,-11
30,18,295,12,19,-7
30,18,296,4,19,-15
30,18,297,5,10,-5
30,18,298,10,19,-9
30,18,299,7,10,-3
30,19,0,5,19,-14
30,19,1,10,16,-6
30,19,2,6,25,-19
30,19,3,6,10,-4
30,19,4,11,13,-2
30,19,5,10,9,1
30,19,6,18,24,-6
30,19,7,6,13,-7
30,19,8,5,13,-8
30,19,9,15,15,0
30,19,10,5,7,-2
30,19,11,5,14,-9
30,19,12,8,9,-1
30,19,13,13,22,-9
30,19,14,10,16,-6
30,19,15,1,9,-8
30,19,16,22,22,0
30,19,17,8,10,-2
30,19,18,9,22,-13
30,19,19,12,20,-8
30,19,20,16,4,12
30,19,21,2,11,-9
30,19,22,7,11,-4
30,19,23,15,15,0
30,19,24,9,11,-2
30,19,25,11,14,-3
30,19,26,21,27,-6
30,19,27,9,18,-9
30,19,28,12,27,-15
30,19,29,13,23,-10
30,19,30,12,9,3
30,19,31,10,15,-5
30,19,32,14,24,-10
30,19,33,14,15,-1
30,19,34,20,23,-3
30,19,35,8,11,-3
30,19,36,7,15,-8
30,19,37,9,14,-5
30,19,38,2,12,-10
30,19,39,11,6,5
30,19,40,22,16,6
30,19,41,14,14,0
30,19,42,7,20,-13
30,19,43,5,19,-14
30,19,44,10,9,1
30,19,45,9,27,-18
30,19,46,12,20,-8
30,19,47,8,13,-5
30,19,48,12,4,8
30,19,49,2,15,-13
30,19,50,17,13,4
30,19,51,25,9,16
30,19,52,15,23,-8
30,19,53,16,13,3
30,19,54,26,26,0
30,19,55,10,9,1
30,19,56,10,20,-10
30,19,57,17,16,1
30,19,58,18,36,-18
30,19,59,9,5,4
30,19,60,13,25,-12
30,19,61,16,27,-11
30,19,62,15,32,-17
30,19,63,14,17,-3
30,19,64,11,11,0
30,19,65,19,25,-6
30,19,66,12,24,-12
30,19,67,15,6,9
30,19,68,5,20,-15
30,19,69,10,24,-14
30,19,70,9,10,-1
30,19,71,17,15,2
30,19,72,17,16,1
30,19,73,10,12,-2
30,19,74,5,19,-14
30,19,75,12,23,-11
30,19,76,11,23,-12
30,19,77,16,14,2
30,19,78,21,15,6
30,19,79,9,20,-11
30,19,80,2,8,-6
30,19,81,2,11,-9
30,19,82,5,6,-1
30,19,83,13,13,0
30,19,84,13,24,-11
30,19,85,16,18,-2
30,19,86,20,13,7
30,19,87,22,13,9
30,19,88,9,19,-10
30,19,89,17,16,1
30,19,90,1,18,-17
30,19,91,5,17,-12
30,19,92,8,18,-10
30,19,93,17,13,4
30,19,94,8,18,-10
30,19,95,14,14,0
30,19,96,9,27,-18
30,19,97,14,15,-1
30,19,98,8,16,-8
30,19,99,9,6,3
30,19,100,28,18,10
30,19,101,15,27,-12
30,19,102,4,12,-8
30,19,103,11,13,-2
30,19,104,18,19,-1
30,19,105,7,15,-8
30,19,106,20,27,-7
30,19,107,4,16,-12
30,19,108,20,32,-12
30,19,109,3,18,-15
30,19,110,13,10,3
30,19,111,10,18,-8
30,19,112,9,28,-19
30,19,113,1,10,-9
30,19,114,6,8,-2
30,19,115,8,19,-11
30,19,116,12,14,-2
30,19,117,14,18,-4
30,19,118,6,16,-10
30,19,119,3,28,-25
30,19,120,13,18,-5
30,19,121,10,25,-15
30,19,122,6,18,-12
30,19,123,6,14,-8
30,19,124,11,17,-6
30,19,125,8,14,-6
30,19,126,22,23,-1
30,19,127,13,19,-6
30,19,128,16,12,4
30,19,129,4,12,-8
30,19,130,7,17,-10
30,19,131,9,12,-3
30,19,132,6,14,-8
30,19,133,10,11,-1
30,19,134,12,20,-8
30,19,135,7,18,-11
30,19,136,9,22,-13
30,19,137,20,14,6
30,19,138,15,22,-7
30,19,139,13,20,-7
30,19,140,10,22,-12
30,19,141,15,22,-7
30,19,142,17,17,0
30,19,143,13,22,-9
30,19,144,10,23,-13
30,19,145,8,11,-3
30,19,146,14,11,3
30,19,147,14,12,2
30,19,148,11,24,-13
30,19,149,5,12,-7
30,19,150,1,8,-7
30,19,151,6,20,-14
30,19,152,6,10,-4
30,19,153,9,10,-1
30,19,154,9,17,-8
30,19,155,9,10,-1
30,19,156,12,10,2
30,19,157,14,13,1
30,19,158,10,11,-1
30,19,159,5,11,-6
30,19,160,11,8,3
30,19,161,13,6,7
30,19,162,5,21,-16
30,19,163,12,19,-7
30,19,164,13,19,-6
30,19,165,13,24,-11
30,19,166,14,18,-4
30,19,167,7,11,-4
30,19,168,7,10,-3
30,19,169,11,14,-3
30,19,170,13,27,-14
30,19,171,14,21,-7
30,19,172,2,9,-7
30,19,173,16,19,-3
30,19,174,19,19,0
30,19,175,12,15,-3
30,19,176,10,9,1
30,19,177,12,10,2
30,19,178,3,5,-2
30,19,179,9,21,-12
30,19,180,14,21,-7
30,19,181,9,14,-5
30,19,182,12,8,4
30,19,183,7,11,-4
30,19,184,4,11,-7
30,19,185,8,30,-22
30,19,186,12,19,-7
30,19,187,18,17,1
30,19,188,6,12,-6
30,19,189,9,12,-3
30,19,190,10,15,-5
30,19,191,6,7,-1
30,19,192,8,20,-12
30,19,193,15,25,-10
30,19,194,11,15,-4
30,19,195,8,17,-9
30,19,196,6,5,1
30,19,197,6,14,-8
30,19,198,12,21,-9
30,19,199,1,23,-22
30,19,200,9,9,0
30,19,201,5,13,-8
30,19,202,20,15,5
30,19,203,10,22,-12
30,19,204,7,12,-5
30,19,205,3,24,-21
30,19,206,14,15,-1
30,19,207,17,22,-5
30,19,208,23,27,-4
30,19,209,7,21,-14
30,19,210,12,22,-10
30,19,211,6,16,-10
30,19,212,11,13,-2
30,19,213,6,29,-23
30,19,214,18,16,2
30,19,215,14,13,1
30,19,216,9,13,-4
30,19,217,16,12,4
30,19,218,3,16,-13
30,19,219,6,25,-19
30,19,220,4,14,-10
30,19,221,8,13,-5
30,19,222,7,11,-4
30,19,223,13,18,-5
30,19,224,8,17,-9
30,19,225,13,21,-8
30,19,226,17,16,1
30,19,227,8,16,-8
30,19,228,7,19,-12
30,19,229,15,21,-6
30,19,230,15,13,2
30,19,231,7,13,-6
30,19,232,12,31,-19
30,19,233,16,32,-16
30,19,234,4,24,-20
30,19,235,13,8,5
30,19,236,8,13,-5
30,19,237,17,15,2
30,19,238,8,14,-6
30,19,239,20,10,10
30,19,240,10,8,2
30,19,241,5,10,-5
30,19,242,17,15,2
30,19,243,9,25,-16
30,19,244,13,7,6
30,19,245,18,23,-5
30,19,246,11,9,2
30,19,247,8,18,-10
30,19,248,13,14,-1
30,19,249,4,11,-7
30,19,250,11,18,-7
30,19,251,12,11,1
30,19,252,13,13,0
30,19,253,13,24,-11
30,19,254,3,6,-3
30,19,255,13,18,-5
30,19,256,8,15,-7
30,19,257,19,9,10
30,19,258,18,19,-1
30,19,259,11,14,-3
30,19,260,23,15,8
30,19,261,4,17,-13
30,19,262,12,13,-1
30,19,263,11,12,-1
30,19,264,15,10,5
30,19,265,8,8,0
30,19,266,14,14,0
30,19,267,13,18,-5
30,19,268,11,9,2
30,19,269,7,28,-21
30,19,270,19,18,1
30,19,271,10,10,0
30,19,272,10,11,-1
30,19,273,6,20,-14
30,19,274,13,18,-5
30,19,275,6,19,-13
30,19,276,9,10,-1
30,19,277,6,14,-8
30,19,278,11,21,-10
30,19,279,10,9,1
30,19,280,20,25,-5
30,19,281,14,17,-3
30,19,282,15,9,6
30,19,283,17,21,-4
30,19,284,13,12,1
30,19,285,19,12,7
30,19,286,7,17,-10
30,19,287,9,10,-1
30,19,288,17,18,-1
30,19,289,12,16,-4
30,19,290,13,21,-8
30,19,291,14,34,-20
30,19,292,5,8,-3
30,19,293,12,18,-6
30,19,294,7,12,-5
30,19,295,9,17,-8
30,19,296,9,11,-2
30,19,297,13,17,-4
30,19,298,6,15,-9
30,19,299,21,22,-1
30,20,0,7,16,-9
30,20,1,11,14,-3
30,20,2,13,14,-1
30,20,3,8,13,-5
30,20,4,5,19,-14
30,20,5,19,25,-6
30,20,6,6,13,-7
30,20,7,20,21,-1
30,20,8,17,19,-2
30,20,9,17,12,5
30,20,10,11,14,-3
30,20,11,8,12,-4
30,20,12,15,15,0
30,20,13,11,13,-2
30,20,14,11,15,-4
30,20,15,10,26,-16
30,20,16,11,24,-13
30,20,17,11,16,-5
30,20,18,10,17,-7
30,20,19,6,22,-16
30,20,20,15,14,1
30,20,21,8,24,-16
30,20,22,11,8,3
30,20,23,7,6,1
30,20,24,10,12,-2
30,20,25,10,19,-9
30,20,26,6,17,-11
30,20,27,2,9,-7
30,20,28,7,13,-6
30,20,29,8,11,-3
30,20,30,7,10,-3
30,20,31,0,13,-13
30,20,32,18,18,0
30,20,33,13,15,-2
30,20,34,15,27,-12
30,20,35,11,7,4
30,20,36,10,9,1
30,20,37,8,21,-13
30,20,38,15,25,-10
30,20,39,10,8,2
30,20,40,4,12,-8
30,20,41,15,11,4
30,20,42,10,11,-1
30,20,43,12,25,-13
30,20,44,8,28,-20
30,20,45,20,14,6
30,20,46,10,22,-12
30,20,47,8,15,-7
30,20,48,7,19,-12
30,20,49,9,17,-8
30,20,50,9,14,-5
30,20,51,12,11,1
30,20,52,7,19,-12
30,20,53,15,20,-5
30,20,54,8,15,-7
30,20,55,6,10,-4
30,20,56,5,17,-12
30,20,57,22,29,-7
30,20,58,10,4,6
30,20,59,29,16,13
30,20,60,6,6,0
30,20,61,10,17,-7
30,20,62,11,15,-4
30,20,63,5,8,-3
30,20,64,7,7,0
30,20,65,6,10,-4
30,20,66,10,10,0
30,20,67,9,15,-6
30,20,68,7,11,-4
30,20,69,20,19,1
30,20,70,8,19,-11
30,20,71,16,14,2
30,20,72,6,17,-11
30,20,73,7,11,-4
30,20,74,10,9,1
30,20,75,3,16,-13
30,20,76,2,15,-13
30,20,77,11,10,1
30,20,78,11,26,-15
30,20,79,9,23,-14
30,20,80,8,18,-10
30,20,81,16,9,7
30,20,82,5,24,-19
30,20,83,13,15,-2
30,20,84,14,12,2
30,20,85,8,20,-12
30,20,86,7,16,-9
30,20,87,11,8,3
30,20,88,7,19,-12
30,20,89,14,12,2
30,20,90,12,23,-11
30,20,91,15,30,-15
30,20,92,6,18,-12
30,20,93,12,10,2
30,20,94,16,19,-3
30,20,95,8,16,-8
30,20,96,5,4,1
30,20,97,7,3,4
30,20,98,11,23,-12
30,20,99,10,28,-18
30,20,100,7,18,-11
30,20,101,12,18,-6
30,20,102,7,19,-12
30,20,103,4,9,-5
30,20,104,10,15,-5
30,20,105,10,9,1
30,20,106,16,8,8
30,20,107,13,12,1
30,20,108,11,16,-5
30,20,109,6,17,-11
30,20,110,6,12,-6
30,20,111,9,9,0
30,20,112,7,17,-10
30,20,113,11,11,0
30,20,114,16,13,3
30,20,115,20,19,1
30,20,116,10,10,0
30,20,117,11,12,-1
30,20,118,11,4,7
30,20,119,11,16,-5
30,20,120,10,27,-17
30,20,121,7,11,-4
30,20,122,3,24,-21
30,20,123,11,15,-4
30,20,124,13,20,-7
30,20,125,20,21,-1
30,20,126,7,18,-11
30,20,127,7,32,-25
30,20,128,14,28,-14
30,20,129,27,30,-3
30,20,130,9,12,-3
30,20,131,8,12,-4
30,20,132,11,17,-6
30,20,133,7,16,-9
30,20,134,11,15,-4
30,20,135,7,9,-2
30,20,136,6,11,-5
30,20,137,6,20,-14
30,20,138,7,16,-9
30,20,139,12,14,-2
30,20,140,15,10,5
30,20,141,8,15,-7
30,20,142,15,16,-1
30,20,143,10,14,-4
30,20,144,11,14,-3
30,20,145,8,14,-6
30,20,146,8,18,-10
30,20,147,7,26,-19
30,20,148,8,13,-5
30,20,149,12,20,-8
30,20,150,4,14,-10
30,20,151,6,15,-9
30,20,152,20,22,-2
30,20,153,15,16,-1
30,20,154,15,7,8
30,20,155,10,14,-4
30,20,156,6,19,-13
30,20,157,10,17,-7
30,20,158,3,7,-4
30,20,159,10,10,0
30,20,160,11,7,4
30,20,161,17,20,-3
30,20,162,14,17,-3
30,20,163,8,16,-8
30,20,164,12,17,-5
30,20,165,17,21,-4
30,20,166,5,20,-15
30,20,167,9,9,0
30,20,168,8,13,-5
30,20,169,12,7,5
30,20,170,6,11,-5
30,20,171,23,33,-10
30,20,172,14,12,2
30,20,173,3,7,-4
30,20,174,7,19,-12
30,20,175,2,10,-8
30,20,176,10,14,-4
30,20,177,3,6,-3
30,20,178,5,13,-8
30,20,179,13,15,-2
30,20,180,9,12,-3
30,20,181,6,16,-10
30,20,182,17,16,1
30,20,183,4,18,-14
30,20,184,12,17,-5
30,20,185,11,6,5
30,20,186,8,9,-1
30,20,187,14,11,3
30,20,188,14,19,-5
30,20,189,14,12,2
30,20,190,5,10,-5
30,20,191,5,15,-10
30,20,192,10,11,-1
30,20,193,9,10,-1
30,20,194,6,13,-7
30,20,195,2,12,-10
30,20,196,9,15,-6
30,20,197,7,23,-16
30,20,198,10,15,-5
30,20,199,10,16,-6
30,20,200,7,20,-13
30,20,201,4,15,-11
30,20,202,18,15,3
30,20,203,21,29,-8
30,20,204,11,28,-17
30,20,205,8,6,2
30,20,206,14,9,5
30,20,207,12,12,0
30,20,208,5,6,-1
30,20,209,8,13,-5
30,20,210,12,29,-17
30,20,211,6,12,-6
30,20,212,14,19,-5
30,20,213,13,19,-6
30,20,214,10,12,-2
30,20,215,12,15,-3
30,20,216,9,13,-4
30,20,217,7,16,-9
30,20,218,11,17,-6
30,20,219,9,17,-8
30,20,220,4,22,-18
30,20,221,12,15,-3
30,20,222,1,13,-12
30,20,223,15,17,-2
30,20,224,15,9,6
30,20,225,11,14,-3
30,20,226,4,4,0
30,20,227,13,20,-7
30,20,228,21,16,5
30,20,229,6,9,-3
30,20,230,17,15,2
30,20,231,8,15,-7
30,20,232,12,13,-1
30,20,233,7,16,-9
30,20,234,13,20,-7
30,20,235,8,19,-11
30,20,236,9,19,-10
30,20,237,13,13,0
30,20,238,4,9,-5
30,20,239,10,12,-2
30,20,240,11,5,6
30,20,241,7,17,-10
30,20,242,12,20,-8
30,20,243,14,21,-7
30,20,244,13,1,12
30,20,245,10,6,4
30,20,246,12,24,-12
30,20,247,8,12,-4
30,20,248,6,11,-5
30,20,249,14,31,-17
30,20,250,7,15,-8
30,20,251,16,13,3
30,20,252,12,28,-16
30,20,253,14,26,-12
30,20,254,14,8,6
30,20,255,7,4,3
30,20,256,10,22,-12
30,20,257,15,23,-8
30,20,258,33,16,17
30,20,259,10,18,-8
30,20,260,9,20,-11
30,20,261,19,19,0
30,20,262,5,11,-6
30,20,263,9,9,0
30,20,264,2,13,-11
30,20,265,17,23,-6
30,20,266,5,13,-8
30,20,267,8,16,-8
30,20,268,7,21,-14
30,20,269,5,15,-10
30,20,270,15,8,7
30,20,271,14,13,1
30,20,272,5,9,-4
30,20,273,13,22,-9
30,20,274,19,29,-10
30,20,275,17,33,-16
30,20,276,11,10,1
30,20,277,10,17,-7
30,20,278,7,10,-3
30,20,279,10,18,-8
30,20,280,4,12,-8
30,20,281,4,6,-2
30,20,282,9,12,-3
30,20,283,6,10,-4
30,20,284,14,15,-1
30,20,285,20,16,4
30,20,286,11,14,-3
30,20,287,11,14,-3
30,20,288,11,15,-4
30,20,289,13,11,2
30,20,290,12,18,-6
30,20,291,7,9,-2
30,20,292,10,25,-15
30,20,293,7,20,-13
30,20,294,6,3,3
30,20,295,14,25,-11
30,20,296,13,12,1
30,20,297,9,9,0
30,20,298,12,18,-6
30,20,299,5,22,-17
30,21,0,8,25,-17
30,21,1,4,14,-10
30,21,2,13,13,0
30,21,3,7,15,-8
30,21,4,14,21,-7
30,21,5,9,15,-6
30,21,6,17,20,-3
30,21,7,12,19,-7
30,21,8,10,12,-2
30,21,9,5,7,-2
30,21,10,8,18,-10
30,21,11,13,15,-2
30,21,12,13,24,-11
30,21,13,11,22,-11
30,21,14,10,13,-3
30,21,15,8,20,-12
30,21,16,5,16,-11
30,21,17,17,17,0
30,21,18,3,15,-12
30,21,19,12,10,2
30,21,20,11,23,-12
30,21,21,15,18,-3
30,21,22,12,16,-4
30,21,23,5,9,-4
30,21,24,7,17,-10
30,21,25,17,15,2
30,21,26,12,18,-6
30,21,27,10,15,-5
30,21,28,15,23,-8
30,21,29,11,6,5
30,21,30,6,11,-5
30,21,31,11,26,-15
30,21,32,4,16,-12
30,21,33,10,16,-6
30,21,34,15,18,-3
30,21,35,10,18,-8
30,21,36,0,1,-1
30,21,37,8,16,-8
30,21,38,8,22,-14
30,21,39,19,15,4
30,21,40,6,16,-10
30,21,41,5,6,-1
30,21,42,0,9,-9
30,21,43,14,15,-1
30,21,44,16,25,-9
30,21,45,8,15,-7
30,21,46,14,7,7
30,21,47,3,7,-4
30,21,48,9,16,-7
30,21,49,15,11,4
30,21,50,10,9,1
30,21,51,4,10,-6
30,21,52,13,22,-9
30,21,53,7,15,-8
30,21,54,9,13,-4
30,21,55,12,17,-5
30,21,56,15,11,4
30,21,57,13,22,-9
30,21,58,16,22,-6
30,21,59,8,8,0
30,21,60,14,24,-10
30,21,61,22,21,1
30,21,62,19,16,3
30,21,63,9,16,-7
30,21,64,26,15,11
30,21,65,15,17,-2
30,21,66,16,15,1
30,21,67,9,9,0
30,21,68,11,12,-1
30,21,69,23,22,1
30,21,70,6,17,-11
30,21,71,4,11,-7
30,21,72,8,9,-1
30,21,73,11,11,0
30,21,74,8,8,0
30,21,75,12,24,-12
30,21,76,8,12,-4
30,21,77,11,15,-4
30,21,78,12,11,1
30,21,79,10,23,-13
30,21,80,4,22,-18
30,21,81,9,16,-7
30,21,82,11,24,-13
30,21,83,13,10,3
30,21,84,14,6,8
30,21,85,4,8,-4
30,21,86,6,9,-3
30,21,87,10,10,0
30,21,88,8,9,-1
30,21,89,2,13,-11
30,21,90,18,33,-15
30,21,91,15,14,1
30,21,92,6,12,-6
30,21,93,10,21,-11
30,21,94,14,7,7
30,21,95,11,12,-1
30,21,96,14,26,-12
30,21,97,10,4,6
30,21,98,18,31,-13
30,21,99,12,20,-8
30,21,100,4,11,-7
30,21,101,11,13,-2
30,21,102,9,10,-1
30,21,103,18,19,-1
30,21,104,14,6,8
30,21,105,6,12,-6
30,21,106,9,14,-5
30,21,107,7,13,-6
30,21,108,7,17,-10
30,21,109,15,19,-4
30,21,110,16,28,-12
30,21,111,5,15,-10
30,21,112,14,21,-7
30,21,113,8,13,-5
30,21,114,13,25,-12
30,21,115,10,11,-1
30,21,116,3,9,-6
30,21,117,10,12,-2
30,21,118,6,7,-1
30,21,119,7,20,-13
30,21,120,9,13,-4
30,21,121,14,19,-5
30,21,122,16,19,-3
30,21,123,12,11,1
30,21,124,23,29,-6
30,21,125,15,13,2
30,21,126,7,17,-10
30,21,127,8,14,-6
30,21,128,13,13,0
30,21,129,1,12,-11
30,21,130,9,9,0
30,21,131,5,9,-4
30,21,132,27,22,5
30,21,133,17,16,1
30,21,134,8,18,-10
30,21,135,7,19,-12
30,21,136,9,12,-3
30,21,137,12,18,-6
30,21,138,5,21,-16
30,21,139,15,17,-2
30,21,140,12,15,-3
30,21,141,13,21,-8
30,21,142,13,21,-8
30,21,143,14,8,6
30,21,144,18,12,6
30,21,145,7,20,-13
30,21,146,13,16,-3
30,21,147,15,8,7
30,21,148,12,23,-11
30,21,149,14,18,-4
30,21,150,22,22,0
30,21,151,12,18,-6
30,21,152,6,7,-1
30,21,153,6,24,-18
30,21,154,11,21,-10
30,21,155,10,16,-6
30,21,156,11,2,9
30,21,157,10,8,2
30,21,158,16,11,5
30,21,159,3,8,-5
30,21,160,12,17,-5
30,21,161,10,15,-5
30,21,162,5,17,-12
30,21,163,7,15,-8
30,21,164,12,17,-5
30,21,165,15,17,-2
30,21,166,5,9,-4
30,21,167,12,12,0
30,21,168,19,27,-8
30,21,169,6,13,-7
30,21,170,7,12,-5
30,21,171,9,27,-18
30,21,172,14,11,3
30,21,173,11,16,-5
30,21,174,10,45,-35
30,21,175,8,10,-2
30,21,176,16,22,-6
30,21,177,10,20,-10
30,21,178,5,3,2
30,21,179,11,12,-1
30,21,180,11,6,5
30,21,181,16,8,8
30,21,182,11,22,-11
30,21,183,8,21,-13
30,21,184,6,21,-15
30,21,185,11,14,-3
30,21,186,4,14,-10
30,21,187,6,13,-7
30,21,188,7,9,-2
30,21,189,6,16,-10
30,21,190,13,20,-7
30,21,191,7,8,-1
30,21,192,5,13,-8
30,21,193,11,11,0
30,21,194,8,17,-9
30,21,195,14,14,0
30,21,196,7,27,-20
30,21,197,11,12,-1
30,21,198,7,21,-14
30,21,199,7,13,-6
30,21,200,14,14,0
30,21,201,9,17,-8
30,21,202,11,8,3
30,21,203,23,12,11
30,21,204,7,11,-4
30,21,205,13,23,-10
30,21,206,7,25,-18
30,21,207,12,13,-1
30,21,208,9,20,-11
30,21,209,13,13,0
30,21,210,7,10,-3
30,21,211,7,17,-10
30,21,212,11,12,-1
30,21,213,4,13,-9
30,21,214,10,5,5
30,21,215,19,14,5
30,21,216,11,15,-4
30,21,217,10,10,0
30,21,218,8,13,-5
30,21,219,8,7,1
30,21,220,22,16,6
30,21,221,16,19,-3
30,21,222,10,17,-7
30,21,223,14,21,-7
30,21,224,17,18,-1
30,21,225,14,12,2
30,21,226,6,33,-27
30,21,227,13,14,-1
30,21,228,8,18,-10
30,21,229,4,14,-10
30,21,230,21,22,-1
30,21,231,15,19,-4
30,21,232,12,23,-11
30,21,233,11,10,1
30,21,234,11,12,-1
30,21,235,10,11,-1
30,21,236,5,12,-7
30,21,237,2,14,-12
30,21,238,21,14,7
30,21,239,3,16,-13
30,21,240,10,14,-4
30,21,241,9,12,-3
30,21,242,13,16,-3
30,21,243,3,17,-14
30,21,244,14,7,7
30,21,245,24,16,8
30,21,246,4,23,-19
30,21,247,4,14,-10
30,21,248,10,19,-9
30,21,249,6,15,-9
30,21,250,8,2,6
30,21,251,20,14,6
30,21,252,9,10,-1
30,21,253,7,19,-12
30,21,254,7,14,-7
30,21,255,12,12,0
30,21,256,14,21,-7
30,21,257,10,12,-2
30,21,258,11,30,-19
30,21,259,27,13,14
30,21,260,7,28,-21
30,21,261,8,15,-7
30,21,262,12,7,5
30,21,263,8,13,-5
30,21,264,13,13,0
30,21,265,9,18,-9
30,21,266,21,15,6
30,21,267,8,7,1
30,21,268,12,7,5
30,21,269,6,7,-1
30,21,270,5,13,-8
30,21,271,9,19,-10
30,21,272,11,25,-14
30,21,273,9,12,-3
30,21,274,8,12,-4
30,21,275,17,18,-1
30,21,276,6,17,-11
30,21,277,6,13,-7
30,21,278,11,17,-6
30,21,279,3,12,-9
30,21,280,21,15,6
30,21,281,8,16,-8
30,21,282,3,12,-9
30,21,283,9,19,-10
30,21,284,13,19,-6
30,21,285,9,8,1
30,21,286,8,11,-3
30,21,287,8,18,-10
30,21,288,15,18,-3
30,21,289,6,11,-5
30,21,290,15,8,7
30,21,291,10,17,-7
30,21,292,9,19,-10
30,21,293,8,16,-8
30,21,294,14,10,4
30,21,295,10,15,-5
30,21,296,10,16,-6
30,21,297,5,23,-18
30,21,298,19,29,-10
30,21,299,11,13,-2
30,22,0,12,12,0
30,22,1,12,4,8
30,22,2,11,17,-6
30,22,3,4,10,-6
30,22,4,17,19,-2
30,22,5,12,15,-3
30,22,6,9,15,-6
30,22,7,8,16,-8
30,22,8,15,8,7
30,22,9,10,13,-3
30,22,10,10,10,0
30,22,11,24,16,8
30,22,12,14,14,0
30,22,13,9,4,5
30,22,14,11,17,-6
30,22,15,9,9,0
30,22,16,5,10,-5
30,22,17,11,12,-1
30,22,18,7,5,2
30,22,19,16,25,-9
30,22,20,14,14,0
30,22,21,16,23,-7
30,22,22,12,14,-2
30,22,23,9,22,-13
30,22,24,10,20,-10
30,22,25,16,9,7
30,22,26,6,11,-5
30,22,27,8,6,2
30,22,28,13,25,-12
30,22,29,11,26,-15
30,22,30,9,13,-4
30,22,31,9,6,3
30,22,32,11,13,-2
30,22,33,10,12,-2
30,22,34,5,15,-10
30,22,35,15,15,0
30,22,36,10,12,-2
30,22,37,8,12,-4
30,22,38,18,22,-4
30,22,39,16,19,-3
30,22,40,6,17,-11
30,22,41,14,14,0
30,22,42,13,20,-7
30,22,43,9,17,-8
30,22,44,12,21,-9
30,22,45,19,22,-3
30,22,46,12,30,-18
30,22,47,16,24,-8
30,22,48,18,11,7
30,22,49,8,11,-3
30,22,50,8,17,-9
30,22,51,10,29,-19
30,22,52,5,17,-12
30,22,53,10,10,0
30,22,54,7,16,-9
30,22,55,8,13,-5
30,22,56,11,16,-5
30,22,57,4,9,-5
30,22,58,16,24,-8
30,22,59,7,14,-7
30,22,60,9,21,-12
30,22,61,10,15,-5
30,22,62,11,18,-7
30,22,63,17,13,4
30,22,64,2,11,-9
30,22,65,6,12,-6
30,22,66,8,15,-7
30,22,67,15,15,0
30,22,68,15,19,-4
30,22,69,7,9,-2
30,22,70,7,6,1
30,22,71,13,16,-3
30,22,72,7,8,-1
30,22,73,10,5,5
30,22,74,4,3,1
30,22,75,17,12,5
30,22,76,15,28,-13
30,22,77,10,15,-5
30,22,78,9,19,-10
30,22,79,9,24,-15
30,22,80,8,11,-3
30,22,81,8,5,3
30,22,82,6,17,-11
30,22,83,11,18,-7
30,22,84,1,4,-3
30,22,85,15,11,4
30,22,86,11,5,6
30,22,87,16,17,-1
30,22,88,8,23,-15
30,22,89,6,14,-8
30,22,90,9,9,0
30,22,91,2,10,-8
30,22,92,20,8,12
30,22,93,8,9,-1
30,22,94,18,23,-5
30,22,95,32,30,2
30,22,96,9,12,-3
30,22,97,12,5,7
30,22,98,11,17,-6
30,22,99,12,21,-9
30,22,100,11,14,-3
30,22,101,13,15,-2
30,22,102,14,33,-19
30,22,103,6,24,-18
30,22,104,22,12,10
30,22,105,10,11,-1
30,22,106,10,5,5
30,22,107,9,7,2
30,22,108,8,15,-7
30,22,109,11,9,2
30,22,110,12,15,-3
30,22,111,6,14,-8
30,22,112,12,11,1
30,22,113,20,20,0
30,22,114,18,22,-4
30,22,115,3,18,-15
30,22,116,17,10,7
30,22,117,14,12,2
30,22,118,4,19,-15
30,22,119,10,18,-8
30,22,120,14,14,0
30,22,121,5,10,-5
30,22,122,13,2,11
30,22,123,11,12,-1
30,22,124,19,9,10
30,22,125,18,26,-8
30,22,126,18,15,3
30,22,127,13,14,-1
30,22,128,9,10,-1
30,22,129,23,10,13
30,22,130,11,23,-12
30,22,131,22,28,-6
30,22,132,19,28,-9
30,22,133,0,4,-4
30,22,134,9,13,-4
30,22,135,11,19,-8
30,22,136,7,18,-11
30,22,137,11,20,-9
30,22,138,10,16,-6
30,22,139,13,9,4
30,22,140,11,14,-3
30,22,141,8,18,-10
30,22,142,4,12,-8
30,22,143,8,11,-3
30,22,144,5,10,-5
30,22,145,7,24,-17
30,22,146,10,14,-4
30,22,147,9,18,-9
30,22,148,10,31,-21
30,22,149,6,9,-3
30,22,150,12,20,-8
30,22,151,11,7,4
30,22,152,23,9,14
30,22,153,15,18,-3
30,22,154,11,14,-3
30,22,155,22,28,-6
30,22,156,4,11,-7
30,22,157,13,17,-4
30,22,158,13,12,1
30,22,159,13,21,-8
30,22,160,4,12,-8
30,22,161,8,15,-7
30,22,162,13,13,0
30,22,163,12,10,2
30,22,164,6,13,-7
30,22,165,15,34,-19
30,22,166,30,20,10
30,22,167,24,23,1
30,22,168,6,18,-12
30,22,169,7,11,-4
30,22,170,13,18,-5
30,22,171,6,7,-1
30,22,172,4,16,-12
30,22,173,7,19,-12
30,22,174,12,22,-10
30,22,175,8,9,-1
30,22,176,19,21,-2
30,22,177,11,19,-8
30,22,178,5,11,-6
30,22,179,8,22,-14
30,22,180,3,7,-4
30,22,181,20,40,-20
30,22,182,16,12,4
30,22,183,15,21,-6
30,22,184,10,19,-9
30,22,185,13,25,-12
30,22,186,5,15,-10
30,22,187,12,14,-2
30,22,188,6,15,-9
30,22,189,10,9,1
30,22,190,14,34,-20
30,22,191,10,6,4
30,22,192,18,14,4
30,22,193,8,15,-7
30,22,194,15,13,2
30,22,195,11,15,-4
30,22,196,16,13,3
30,22,197,9,11,-2
30,22,198,12,22,-10
30,22,199,6,19,-13
30,22,200,15,22,-7
30,22,201,10,13,-3
30,22,202,10,13,-3
30,22,203,6,13,-7
30,22,204,4,28,-24
30,22,205,13,15,-2
30,22,206,11,20,-9
30,22,207,8,11,-3
30,22,208,9,22,-13
30,22,209,8,16,-8
30,22,210,18,14,4
30,22,211,17,14,3
30,22,212,15,26,-11
30,22,213,9,17,-8
30,22,214,9,10,-1
30,22,215,13,12,1
30,22,216,9,17,-8
30,22,217,9,32,-23
30,22,218,9,10,-1
30,22,219,6,9,-3
30,22,220,11,12,-1
30,22,221,24,19,5
30,22,222,12,12,0
30,22,223,14,9,5
30,22,224,9,12,-3
30,22,225,6,15,-9
30,22,226,9,9,0
30,22,227,6,23,-17
30,22,228,4,9,-5
30,22,229,5,6,-1
30,22,230,4,12,-8
30,22,231,12,17,-5
30,22,232,9,13,-4
30,22,233,13,21,-8
30,22,234,17,17,0
30,22,235,6,12,-6
30,22,236,10,25,-15
30,22,237,14,25,-11
30,22,238,14,15,-1
30,22,239,11,13,-2
30,22,240,5,19,-14
30,22,241,11,15,-4
30,22,242,5,7,-2
30,22,243,2,10,-8
30,22,244,6,12,-6
30,22,245,2,4,-2
30,22,246,16,15,1
30,22,247,3,5,-2
30,22,248,5,15,-10
30,22,249,12,11,1
30,22,250,6,13,-7
30,22,251,12,15,-3
30,22,252,13,8,5
30,22,253,10,13,-3
30,22,254,18,21,-3
30,22,255,14,24,-10
30,22,256,16,12,4
30,22,257,19,12,7
30,22,258,2,8,-6
30,22,259,16,4,12
30,22,260,3,16,-13
30,22,261,5,21,-16
30,22,262,23,19,4
30,22,263,24,15,9
30,22,264,16,20,-4
30,22,265,5,10,-5
30,22,266,11,19,-8
30,22,267,20,8,12
30,22,268,9,16,-7
30,22,269,8,23,-15
30,22,270,13,24,-11
30,22,271,14,21,-7
30,22,272,17,12,5
30,22,273,19,20,-1
30,22,274,11,16,-5
30,22,275,4,9,-5
30,22,276,7,22,-15
30,22,277,20,17,3
30,22,278,13,9,4
30,22,279,11,14,-3
30,22,280,12,20,-8
30,22,281,4,7,-3
30,22,282,11,10,1
30,22,283,12,30,-18
30,22,284,16,20,-4
30,22,285,12,18,-6
30,22,286,13,20,-7
30,22,287,18,9,9
30,22,288,4,19,-15
30,22,289,7,34,-27
30,22,290,11,9,2
30,22,291,22,14,8
30,22,292,19,15,4
30,22,293,10,12,-2
30,22,294,4,19,-15
30,22,295,21,17,4
30,22,296,12,22,-10
30,22,297,7,17,-10
30,22,298,8,6,2
30,22,299,14,9,5
30,23,0,10,8,2
30,23,1,15,23,-8
30,23,2,17,12,5
30,23,3,11,21,-10
30,23,4,9,13,-4
30,23,5,6,9,-3
30,23,6,12,15,-3
30,23,7,4,29,-25
30,23,8,13,6,7
30,23,9,6,19,-13
30,23,10,17,14,3
30,23,11,15,17,-2
30,23,12,14,14,0
30,23,13,22,18,4
30,23,14,16,17,-1
30,23,15,17,18,-1
30,23,16,4,14,-10
30,23,17,14,17,-3
30,23,18,8,15,-7
30,23,19,15,10,5
30,23,20,13,37,-24
30,23,21,16,21,-5
30,23,22,18,21,-3
30,23,23,15,31,-16
30,23,24,14,19,-5
30,23,25,14,19,-5
30,23,26,16,3,13
30,23,27,17,29,-12
30,23,28,13,18,-5
30,23,29,7,23,-16
30,23,30,10,16,-6
30,23,31,19,20,-1
30,23,32,16,31,-15
30,23,33,12,23,-11
30,23,34,12,23,-11
30,23,35,2,13,-11
30,23,36,6,20,-14
30,23,37,5,9,-4
30,23,38,10,15,-5
30,23,39,14,14,0
30,23,40,6,22,-16
30,23,41,12,29,-17
30,23,42,11,7,4
30,23,43,12,15,-3
30,23,44,7,11,-4
30,23,45,10,21,-11
30,23,46,13,22,-9
30,23,47,14,18,-4
30,23,48,16,17,-1
30,23,49,8,8,0
30,23,50,12,13,-1
30,23,51,7,14,-7
30,23,52,16,3,13
30,23,53,10,21,-11
30,23,54,21,11,10
30,23,55,16,16,0
30,23,56,22,12,10
30,23,57,7,11,-4
30,23,58,4,16,-12
30,23,59,15,14,1
30,23,60,8,12,-4
30,23,61,5,8,-3
30,23,62,17,21,-4
30,23,63,18,25,-7
30,23,64,2,14,-12
30,23,65,10,12,-2
30,23,66,17,6,11
30,23,67,16,12,4
30,23,68,14,22,-8
30,23,69,17,21,-4
30,23,70,13,13,0
30,23,71,11,13,-2
30,23,72,12,15,-3
30,23,73,4,10,-6
30,23,74,7,14,-7
30,23,75,9,24,-15
30,23,76,21,19,2
30,23,77,5,15,-10
30,23,78,9,19,-10
30,23,79,8,12,-4
30,23,80,7,8,-1
30,23,81,11,11,0
30,23,82,7,14,-7
30,23,83,3,10,-7
30,23,84,7,4,3
30,23,85,7,31,-24
30,23,86,13,21,-8
30,23,87,13,10,3
30,23,88,15,18,-3
30,23,89,13,16,-3
30,23,90,11,31,-20
30,23,91,14,24,-10
30,23,92,14,16,-2
30,23,93,9,13,-4
30,23,94,14,19,-5
30,23,95,11,11,0
30,23,96,8,12,-4
30,23,97,15,18,-3
30,23,98,22,14,8
30,23,99,12,19,-7
30,23,100,12,11,1
30,23,101,14,14,0
30,23,102,10,7,3
30,23,103,9,11,-2
30,23,104,21,16,5
30,23,105,13,23,-10
30,23,106,14,22,-8
30,23,107,7,7,0
30,23,108,9,2,7
30,23,109,8,7,1
30,23,110,11,14,-3
30,23,111,26,16,10
30,23,112,8,11,-3
30,23,113,10,19,-9
30,23,114,8,10,-2
30,23,115,17,8,9
30,23,116,4,17,-13
30,23,117,16,22,-6
30,23,118,5,7,-2
30,23,119,11,13,-2
30,23,120,16,20,-4
30,23,121,22,12,10
30,23,122,10,12,-2
30,23,123,15,22,-7
30,23,124,8,15,-7
30,23,125,12,4,8
30,23,126,8,12,-4
30,23,127,10,21,-11
30,23,128,18,9,9
30,23,129,3,14,-11
30,23,130,10,9,1
30,23,131,15,37,-22
30,23,132,9,18,-9
30,23,133,17,13,4
30,23,134,12,12,0
30,23,135,18,19,-1
30,23,136,6,12,-6
30,23,137,17,21,-4
30,23,138,12,7,5
30,23,139,10,9,1
30,23,140,11,12,-1
30,23,141,11,17,-6
30,23,142,11,16,-5
30,23,143,8,12,-4
30,23,144,13,24,-11
30,23,145,10,8,2
30,23,146,5,25,-20
30,23,147,10,7,3
30,23,148,7,10,-3
30,23,149,11,11,0
30,23,150,12,9,3
30,23,151,16,13,3
30,23,152,15,8,7
30,23,153,10,20,-10
30,23,154,11,21,-10
30,23,155,13,22,-9
30,23,156,17,14,3
30,23,157,10,35,-25
30,23,158,14,32,-18
30,23,159,25,40,-15
30,23,160,14,11,3
30,23,161,5,7,-2
30,23,162,13,17,-4
30,23,163,4,22,-18
30,23,164,8,13,-5
30,23,165,21,12,9
30,23,166,10,19,-9
30,23,167,10,7,3
30,23,168,12,24,-12
30,23,169,17,21,-4
30,23,170,10,12,-2
30,23,171,9,10,-1
30,23,172,10,15,-5
30,23,173,9,13,-4
30,23,174,13,11,2
30,23,175,14,19,-5
30,23,176,10,21,-11
30,23,177,8,6,2
30,23,178,9,6,3
30,23,179,12,15,-3
30,23,180,14,27,-13
30,23,181,11,17,-6
30,23,182,12,8,4
30,23,183,15,20,-5
30,23,184,5,10,-5
30,23,185,12,13,-1
30,23,186,10,8,2
30,23,187,9,25,-16
30,23,188,8,12,-4
30,23,189,6,12,-6
30,23,190,5,17,-12
30,23,191,11,11,0
30,23,192,16,1,15
30,23,193,15,16,-1
30,23,194,10,20,-10
30,23,195,8,8,0
30,23,196,10,21,-11
30,23,197,11,8,3
30,23,198,20,27,-7
30,23,199,3,18,-15
30,23,200,11,13,-2
30,23,201,17,17,0
30,23,202,13,15,-2
30,23,203,16,18,-2
30,23,204,14,11,3
30,23,205,9,10,-1
30,23,206,14,17,-3
30,23,207,11,17,-6
30,23,208,8,16,-8
30,23,209,12,19,-7
30,23,210,10,15,-5
30,23,211,12,20,-8
30,23,212,16,17,-1
30,23,213,8,16,-8
30,23,214,9,11,-2
30,23,215,13,14,-1
30,23,216,12,22,-10
30,23,217,16,15,1
30,23,218,9,11,-2
30,23,219,11,24,-13
30,23,220,4,18,-14
30,23,221,3,20,-17
30,23,222,6,16,-10
30,23,223,7,12,-5
30,23,224,9,15,-6
30,23,225,13,3,10
30,23,226,9,22,-13
30,23,227,14,22,-8
30,23,228,16,20,-4
30,23,229,15,4,11
30,23,230,10,17,-7
30,23,231,11,14,-3
30,23,232,8,9,-1
30,23,233,1,11,-10
30,23,234,11,10,1
30,23,235,7,17,-10
30,23,236,19,19,0
30,23,237,6,11,-5
30,23,238,7,19,-12
30,23,239,8,15,-7
30,23,240,11,9,2
30,23,241,9,8,1
30,23,242,10,21,-11
30,23,243,4,14,-10
30,23,244,13,9,4
30,23,245,7,12,-5
30,23,246,26,20,6
30,23,247,10,9,1
30,23,248,4,9,-5
30,23,249,13,14,-1
30,23,250,10,19,-9
30,23,251,26,14,12
30,23,252,14,11,3
30,23,253,16,17,-1
30,23,254,7,13,-6
30,23,255,14,12,2
30,23,256,4,4,0
30,23,257,4,14,-10
30,23,258,6,9,-3
30,23,259,12,9,3
30,23,260,13,17,-4
30,23,261,4,21,-17
30,23,262,6,12,-6
30,23,263,13,15,-2
30,23,264,5,9,-4
30,23,265,3,12,-9
30,23,266,8,32,-24
30,23,267,13,25,-12
30,23,268,5,10,-5
30,23,269,6,21,-15
30,23,270,13,17,-4
30,23,271,5,19,-14
30,23,272,11,16,-5
30,23,273,6,19,-13
30,23,274,13,18,-5
30,23,275,19,30,-11
30,23,276,18,12,6
30,23,277,22,16,6
30,23,278,12,23,-11
30,23,279,10,15,-5
30,23,280,9,23,-14
30,23,281,3,8,-5
30,23,282,7,19,-12
30,23,283,11,7,4
30,23,284,11,24,-13
30,23,285,6,22,-16
30,23,286,1,3,-2
30,23,287,23,11,12
30,23,288,13,11,2
30,23,289,2,9,-7
30,23,290,12,15,-3
30,23,291,10,10,0
30,23,292,14,19,-5
30,23,293,5,11,-6
30,23,294,23,19,4
30,23,295,8,9,-1
30,23,296,13,17,-4
30,23,297,13,7,6
30,23,298,25,15,10
30,23,299,17,17,0
30,24,0,21,16,5
30,24,1,16,13,3
30,24,2,7,14,-7
30,24,3,5,14,-9
30,24,4,8,10,-2
30,24,5,9,14,-5
30,24,6,6,8,-2
30,24,7,6,17,-11
30,24,8,7,9,-2
30,24,9,7,14,-7
30,24,10,7,7,0
30,24,11,18,12,6
30,24,12,12,19,-7
30,24,13,10,15,-5
30,24,14,21,19,2
30,24,15,8,13,-5
30,24,16,17,11,6
30,24,17,5,3,2
30,24,18,13,8,5
30,24,19,7,26,-19
30,24,20,12,18,-6
30,24,21,5,12,-7
30,24,22,9,20,-11
30,24,23,8,14,-6
30,24,24,14,23,-9
30,24,25,9,17,-8
30,24,26,7,6,1
30,24,27,6,9,-3
30,24,28,17,17,0
30,24,29,18,17,1
30,24,30,14,19,-5
30,24,31,11,9,2
30,24,32,9,10,-1
30,24,33,15,18,-3
30,24,34,10,9,1
30,24,35,13,11,2
30,24,36,2,7,-5
30,24,37,20,22,-2
30,24,38,20,25,-5
30,24,39,13,8,5
30,24,40,12,4,8
30,24,41,7,16,-9
30,24,42,13,17,-4
30,24,43,11,3,8
30,24,44,16,35,-19
30,24,45,7,10,-3
30,24,46,8,13,-5
30,24,47,5,13,-8
30,24,48,20,12,8
30,24,49,11,10,1
30,24,50,3,8,-5
30,24,51,15,12,3
30,24,52,12,4,8
30,24,53,15,18,-3
30,24,54,15,17,-2
30,24,55,9,17,-8
30,24,56,7,14,-7
30,24,57,30,20,10
30,24,58,10,20,-10
30,24,59,12,11,1
30,24,60,21,14,7
30,24,61,13,7,6
30,24,62,16,10,6
30,24,63,11,25,-14
30,24,64,20,21,-1
30,24,65,12,13,-1
30,24,66,14,21,-7
30,24,67,7,13,-6
30,24,68,6,14,-8
30,24,69,20,8,12
30,24,70,6,13,-7
30,24,71,12,28,-16
30,24,72,7,11,-4
30,24,73,5,11,-6
30,24,74,10,12,-2
30,24,75,12,11,1
30,24,76,11,25,-14
30,24,77,16,22,-6
30,24,78,11,7,4
30,24,79,17,32,-15
30,24,80,10,19,-9
30,24,81,27,26,1
30,24,82,12,17,-5
30,24,83,18,23,-5
30,24,84,7,8,-1
30,24,85,8,21,-13
30,24,86,9,13,-4
30,24,87,20,17,3
30,24,88,13,17,-4
30,24,89,11,15,-4
30,24,90,9,11,-2
30,24,91,12,11,1
30,24,92,12,31,-19
30,24,93,7,15,-8
30,24,94,8,9,-1
30,24,95,3,9,-6
30,24,96,10,11,-1
30,24,97,12,14,-2
30,24,98,13,19,-6
30,24,99,25,29,-4
30,24,100,17,14,3
30,24,101,7,11,-4
30,24,102,19,17,2
30,24,103,4,6,-2
30,24,104,20,14,6
30,24,105,4,23,-19
30,24,106,11,19,-8
30,24,107,16,19,-3
30,24,108,12,12,0
30,24,109,13,10,3
30,24,110,18,31,-13
30,24,111,12,12,0
30,24,112,4,9,-5
30,24,113,7,7,0
30,24,114,6,20,-14
30,24,115,7,17,-10
30,24,116,10,12,-2
30,24,117,21,15,6
30,24,118,10,19,-9
30,24,119,19,28,-9
30,24,120,6,6,0
30,24,121,13,17,-4
30,24,122,9,8,1
30,24,123,18,13,5
30,24,124,11,11,0
30,24,125,6,11,-5
30,24,126,12,17,-5
30,24,127,11,20,-9
30,24,128,9,11,-2
30,24,129,9,24,-15
30,24,130,15,19,-4
30,24,131,14,18,-4
30,24,132,13,12,1
30,24,133,11,26,-15
30,24,134,11,18,-7
30,24,135,14,14,0
30,24,136,6,20,-14
30,24,137,24,16,8
30,24,138,16,21,-5
30,24,139,6,7,-1
30,24,140,8,21,-13
30,24,141,5,20,-15
30,24,142,17,10,7
30,24,143,8,15,-7
30,24,144,14,7,7
30,24,145,17,10,7
30,24,146,10,10,0
30,24,147,7,25,-18
30,24,148,2,4,-2
30,24,149,19,26,-7
30,24,150,13,17,-4
30,24,151,4,15,-11
30,24,152,20,16,4
30,24,153,4,16,-12
30,24,154,8,4,4
30,24,155,8,23,-15
30,24,156,14,17,-3
30,24,157,13,12,1
30,24,158,20,18,2
30,24,159,4,9,-5
30,24,160,10,25,-15
30,24,161,5,11,-6
30,24,162,8,4,4
30,24,163,16,19,-3
30,24,164,20,25,-5
30,24,165,16,16,0
30,24,166,7,26,-19
30,24,167,21,15,6
30,24,168,17,10,7
30,24,169,13,8,5
30,24,170,4,15,-11
30,24,171,9,8,1
30,24,172,5,15,-10
30,24,173,6,8,-2
30,24,174,6,9,-3
30,24,175,10,23,-13
30,24,176,8,11,-3
30,24,177,7,11,-4
30,24,178,16,15,1
30,24,179,15,21,-6
30,24,180,9,18,-9
30,24,181,14,10,4
30,24,182,5,21,-16
30,24,183,7,15,-8
30,24,184,14,20,-6
30,24,185,5,25,-20
30,24,186,6,19,-13
30,24,187,11,17,-6
30,24,188,7,18,-11
30,24,189,18,16,2
30,24,190,9,23,-14
30,24,191,9,5,4
30,24,192,7,15,-8
30,24,193,12,19,-7
30,24,194,15,18,-3
30,24,195,6,19,-13
30,24,196,12,13,-1
30,24,197,9,8,1
30,24,198,14,19,-5
30,24,199,12,22,-10
30,24,200,29,17,12
30,24,201,18,17,1
30,24,202,9,15,-6
30,24,203,16,7,9
30,24,204,13,16,-3
30,24,205,21,15,6
30,24,206,5,14,-9
30,24,207,5,20,-15
30,24,208,11,11,0
30,24,209,17,20,-3
30,24,210,10,16,-6
30,24,211,1,13,-12
30,24,212,8,12,-4
30,24,213,14,9,5
30,24,214,14,13,1
30,24,215,14,22,-8
30,24,216,15,10,5
30,24,217,3,6,-3
30,24,218,12,15,-3
30,24,219,14,14,0
30,24,220,11,14,-3
30,24,221,14,22,-8
30,24,222,17,15,2
30,24,223,8,20,-12
30,24,224,12,15,-3
30,24,225,6,14,-8
30,24,226,13,23,-10
30,24,227,14,14,0
30,24,228,14,19,-5
30,24,229,19,12,7
30,24,230,8,31,-23
30,24,231,9,10,-1
30,24,232,4,12,-8
30,24,233,9,18,-9
30,24,234,13,16,-3
30,24,235,11,26,-15
30,24,236,14,8,6
30,24,237,6,13,-7
30,24,238,6,16,-10
30,24,239,6,15,-9
30,24,240,10,8,2
30,24,241,6,6,0
30,24,242,6,18,-12
30,24,243,10,15,-5
30,24,244,14,10,4
30,24,245,7,9,-2
30,24,246,5,20,-15
30,24,247,19,13,6
30,24,248,5,16,-11
30,24,249,9,13,-4
30,24,250,8,27,-19
30,24,251,13,10,3
30,24,252,15,18,-3
30,24,253,17,20,-3
30,24,254,6,25,-19
30,24,255,6,13,-7
30,24,256,10,12,-2
30,24,257,13,13,0
30,24,258,14,21,-7
30,24,259,6,10,-4
30,24,260,12,15,-3
30,24,261,8,7,1
30,24,262,6,14,-8
30,24,263,20,25,-5
30,24,264,14,15,-1
30,24,265,17,13,4
30,24,266,7,12,-5
30,24,267,16,22,-6
30,24,268,2,15,-13
30,24,269,19,9,10
30,24,270,8,15,-7
30,24,271,13,3,10
30,24,272,7,6,1
30,24,273,9,10,-1
30,24,274,12,19,-7
30,24,275,18,25,-7
30,24,276,18,15,3
30,24,277,13,11,2
30,24,278,18,23,-5
30,24,279,11,17,-6
30,24,280,7,18,-11
30,24,281,9,11,-2
30,24,282,6,7,-1
30,24,283,15,18,-3
30,24,284,17,14,3
30,24,285,9,14,-5
30,24,286,12,13,-1
30,24,287,14,23,-9
30,24,288,3,10,-7
30,24,289,7,14,-7
30,24,290,18,17,1
30,24,291,15,25,-10
30,24,292,16,8,8
30,24,293,13,24,-11
30,24,294,7,10,-3
30,24,295,5,11,-6
30,24,296,14,13,1
30,24,297,9,12,-3
30,24,298,8,15,-7
30,24,299,12,15,-3
30,25,0,2,9,-7
30,25,1,10,5,5
30,25,2,7,6,1
30,25,3,10,12,-2
30,25,4,7,14,-7
30,25,5,19,20,-1
30,25,6,2,8,-6
30,25,7,32,30,2
30,25,8,11,7,4
30,25,9,12,11,1
30,25,10,7,10,-3
30,25,11,12,25,-13
30,25,12,6,16,-10
30,25,13,7,13,-6
30,25,14,7,2,5
30,25,15,13,6,7
30,25,16,9,18,-9
30,25,17,8,11,-3
30,25,18,8,10,-2
30,25,19,9,18,-9
30,25,20,7,13,-6
30,25,21,11,27,-16
30,25,22,9,22,-13
30,25,23,7,6,1
30,25,24,7,7,0
30,25,25,11,11,0
30,25,26,12,6,6
30,25,27,8,3,5
30,25,28,10,12,-2
30,25,29,10,24,-14
30,25,30,4,10,-6
30,25,31,11,12,-1
30,25,32,14,21,-7
30,25,33,18,8,10
30,25,34,5,11,-6
30,25,35,15,26,-11
30,25,36,9,12,-3
30,25,37,6,17,-11
30,25,38,9,14,-5
30,25,39,12,18,-6
30,25,40,13,16,-3
30,25,41,6,16,-10
30,25,42,17,17,0
30,25,43,15,22,-7
30,25,44,9,9,0
30,25,45,15,10,5
30,25,46,17,16,1
30,25,47,4,10,-6
30,25,48,19,6,13
30,25,49,4,13,-9
30,25,50,7,13,-6
30,25,51,5,6,-1
30,25,52,22,20,2
30,25,53,12,10,2
30,25,54,14,21,-7
30,25,55,5,11,-6
30,25,56,9,21,-12
30,25,57,17,15,2
30,25,58,10,6,4
30,25,59,17,14,3
30,25,60,1,4,-3
30,25,61,8,11,-3
30,25,62,11,9,2
30,25,63,14,17,-3
30,25,64,16,21,-5
30,25,65,13,10,3
30,25,66,10,21,-11
30,25,67,17,9,8
30,25,68,19,14,5
30,25,69,14,11,3
30,25,70,4,10,-6
30,25,71,5,11,-6
30,25,72,8,16,-8
30,25,73,15,21,-6
30,25,74,17,18,-1
30,25,75,7,10,-3
30,25,76,6,16,-10
30,25,77,7,13,-6
30,25,78,5,7,-2
30,25,79,7,7,0
30,25,80,21,8,13
30,25,81,8,12,-4
30,25,82,11,23,-12
30,25,83,11,15,-4
30,25,84,18,20,-2
30,25,85,19,12,7
30,25,86,6,23,-17
30,25,87,20,15,5
30,25,88,19,27,-8
30,25,89,9,21,-12
30,25,90,9,8,1
30,25,91,15,17,-2
30,25,92,11,7,4
30,25,93,13,10,3
30,25,94,7,11,-4
30,25,95,2,8,-6
30,25,96,13,20,-7
30,25,97,10,28,-18
30,25,98,10,18,-8
30,25,99,10,17,-7
30,25,100,9,11,-2
30,25,101,11,23,-12
30,25,102,5,13,-8
30,25,103,4,16,-12
30,25,104,10,5,5
30,25,105,12,26,-14
30,25,106,7,4,3
30,25,107,10,27,-17
30,25,108,12,9,3
30,25,109,6,17,-11
30,25,110,6,14,-8
30,25,111,6,11,-5
30,25,112,19,19,0
30,25,113,10,28,-18
30,25,114,10,19,-9
30,25,115,16,12,4
30,25,116,11,18,-7
30,25,117,4,11,-7
30,25,118,5,15,-10
30,25,119,8,13,-5
30,25,120,12,16,-4
30,25,121,7,10,-3
30,25,122,11,18,-7
30,25,123,16,21,-5
30,25,124,8,20,-12
30,25,125,9,21,-12
30,25,126,14,16,-2
30,25,127,5,5,0
30,25,128,10,13,-3
30,25,129,10,29,-19
30,25,130,6,16,-10
30,25,131,6,11,-5
30,25,132,10,15,-5
30,25,133,4,3,1
30,25,134,13,16,-3
30,25,135,2,8,-6
30,25,136,10,16,-6
30,25,137,10,17,-7
30,25,138,10,22,-12
30,25,139,9,13,-4
30,25,140,9,14,-5
30,25,141,8,13,-5
30,25,142,5,5,0
30,25,143,10,11,-1
30,25,144,14,17,-3
30,25,145,8,9,-1
30,25,146,11,9,2
30,25,147,15,9,6
30,25,148,11,17,-6
30,25,149,9,17,-8
30,25,150,12,6,6
30,25,151,12,17,-5
30,25,152,13,7,6
30,25,153,8,10,-2
30,25,154,18,27,-9
30,25,155,9,14,-5
30,25,156,19,25,-6
30,25,157,11,14,-3
30,25,158,6,9,-3
30,25,159,15,20,-5
30,25,160,5,19,-14
30,25,161,12,16,-4
30,25,162,3,13,-10
30,25,163,6,11,-5
30,25,164,15,17,-2
30,25,165,5,14,-9
30,25,166,13,16,-3
30,25,167,18,14,4
30,25,168,6,5,1
30,25,169,8,15,-7
30,25,170,5,13,-8
30,25,171,12,13,-1
30,25,172,8,11,-3
30,25,173,10,13,-3
30,25,174,12,14,-2
30,25,175,10,25,-15
30,25,176,9,13,-4
30,25,177,13,10,3
30,25,178,12,14,-2
30,25,179,15,24,-9
30,25,180,21,6,15
30,25,181,11,12,-1
30,25,182,5,19,-14
30,25,183,21,14,7
30,25,184,25,21,4
30,25,185,3,13,-10
30,25,186,16,14,2
30,25,187,11,17,-6
30,25,188,8,20,-12
30,25,189,8,19,-11
30,25,190,9,12,-3
30,25,191,14,18,-4
30,25,192,16,8,8
30,25,193,6,13,-7
30,25,194,11,11,0
30,25,195,11,15,-4
30,25,196,11,6,5
30,25,197,8,10,-2
30,25,198,5,9,-4
30,25,199,5,14,-9
30,25,200,11,12,-1
30,25,201,11,19,-8
30,25,202,20,13,7
30,25,203,6,5,1
30,25,204,14,18,-4
30,25,205,7,15,-8
30,25,206,13,10,3
30,25,207,21,29,-8
30,25,208,6,10,-4
30,25,209,12,13,-1
30,25,210,7,17,-10
30,25,211,9,16,-7
30,25,212,5,10,-5
30,25,213,11,10,1
30,25,214,16,12,4
30,25,215,13,29,-16
30,25,216,21,13,8
30,25,217,17,16,1
30,25,218,12,11,1
30,25,219,16,25,-9
30,25,220,14,8,6
30,25,221,10,17,-7
30,25,222,4,12,-8
30,25,223,12,5,7
30,25,224,11,6,5
30,25,225,7,13,-6
30,25,226,23,33,-10
30,25,227,8,9,-1
30,25,228,22,16,6
30,25,229,24,28,-4
30,25,230,6,9,-3
30,25,231,7,9,-2
30,25,232,9,6,3
30,25,233,15,18,-3
30,25,234,6,11,-5
30,25,235,7,11,-4
30,25,236,3,10,-7
30,25,237,7,10,-3
30,25,238,12,11,1
30,25,239,22,12,10
30,25,240,12,6,6
30,25,241,7,6,1
30,25,242,7,9,-2
30,25,243,2,20,-18
30,25,244,10,18,-8
30,25,245,15,14,1
30,25,246,13,16,-3
30,25,247,5,15,-10
30,25,248,16,31,-15
30,25,249,10,25,-15
30,25,250,13,15,-2
30,25,251,6,13,-7
30,25,252,8,19,-11
30,25,253,7,24,-17
30,25,254,16,13,3
30,25,255,5,8,-3
30,25,256,18,11,7
30,25,257,12,10,2
30,25,258,11,27,-16
30,25,259,14,10,4
30,25,260,14,22,-8
30,25,261,4,22,-18
30,25,262,12,14,-2
30,25,263,6,11,-5
30,25,264,9,19,-10
30,25,265,13,12,1
30,25,266,7,16,-9
30,25,267,16,16,0
30,25,268,13,19,-6
30,25,269,5,18,-13
30,25,270,4,15,-11
30,25,271,6,10,-4
30,25,272,11,23,-12
30,25,273,6,8,-2
30,25,274,18,12,6
30,25,275,23,14,9
30,25,276,10,16,-6
30,25,277,17,26,-9
30,25,278,12,11,1
30,25,279,6,17,-11
30,25,280,14,20,-6
30,25,281,7,7,0
30,25,282,8,18,-10
30,25,283,18,17,1
30,25,284,16,17,-1
30,25,285,8,11,-3
30,25,286,10,23,-13
30,25,287,8,7,1
30,25,288,6,20,-14
30,25,289,6,17,-11
30,25,290,3,4,-1
30,25,291,12,14,-2
30,25,292,9,9,0
30,25,293,12,11,1
30,25,294,11,14,-3
30,25,295,16,9,7
30,25,296,3,22,-19
30,25,297,23,11,12
30,25,298,4,7,-3
30,25,299,17,17,0
30,26,0,16,21,-5
30,26,1,8,12,-4
30,26,2,13,3,10
30,26,3,22,10,12
30,26,4,11,12,-1
30,26,5,6,14,-8
30,26,6,12,21,-9
30,26,7,14,7,7
30,26,8,5,26,-21
30,26,9,14,18,-4
30,26,10,9,20,-11
30,26,11,9,14,-5
30,26,12,11,5,6
30,26,13,10,9,1
30,26,14,11,11,0
30,26,15,10,15,-5
30,26,16,14,12,2
30,26,17,3,22,-19
30,26,18,7,27,-20
30,26,19,13,16,-3
30,26,20,20,27,-7
30,26,21,11,14,-3
30,26,22,12,12,0
30,26,23,9,17,-8
30,26,24,19,19,0
30,26,25,9,12,-3
30,26,26,15,14,1
30,26,27,18,29,-11
30,26,28,11,16,-5
30,26,29,13,11,2
30,26,30,7,11,-4
30,26,31,11,14,-3
30,26,32,3,9,-6
30,26,33,19,10,9
30,26,34,17,24,-7
30,26,35,8,17,-9
30,26,36,17,25,-8
30,26,37,4,16,-12
30,26,38,6,10,-4
30,26,39,2,8,-6
30,26,40,19,25,-6
30,26,41,12,21,-9
30,26,42,13,17,-4
30,26,43,14,12,2
30,26,44,21,19,2
30,26,45,13,13,0
30,26,46,4,18,-14
30,26,47,12,19,-7
30,26,48,14,15,-1
30,26,49,8,6,2
30,26,50,17,9,8
30,26,51,4,11,-7
30,26,52,4,12,-8
30,26,53,12,12,0
30,26,54,3,21,-18
30,26,55,10,7,3
30,26,56,10,11,-1
30,26,57,7,8,-1
30,26,58,4,8,-4
30,26,59,23,33,-10
30,26,60,7,7,0
30,26,61,11,16,-5
30,26,62,5,12,-7
30,26,63,11,16,-5
30,26,64,5,7,-2
30,26,65,14,16,-2
30,26,66,7,13,-6
30,26,67,14,4,10
30,26,68,10,18,-8
30,26,69,10,11,-1
30,26,70,21,16,5
30,26,71,16,13,3
30,26,72,23,13,10
30,26,73,17,11,6
30,26,74,7,16,-9
30,26,75,4,11,-7
30,26,76,7,10,-3
30,26,77,14,11,3
30,26,78,15,7,8
30,26,79,7,3,4
30,26,80,13,10,3
30,26,81,9,22,-13
30,26,82,16,18,-2
30,26,83,4,19,-15
30,26,84,3,16,-13
30,26,85,7,5,2
30,26,86,2,5,-3
30,26,87,12,13,-1
30,26,88,9,8,1
30,26,89,19,18,1
30,26,90,22,11,11
30,26,91,19,24,-5
30,26,92,10,7,3
30,26,93,13,10,3
30,26,94,13,17,-4
30,26,95,5,8,-3
30,26,96,10,17,-7
30,26,97,4,10,-6
30,26,98,3,3,0
30,26,99,12,5,7
30,26,100,15,12,3
30,26,101,18,14,4
30,26,102,7,13,-6
30,26,103,16,10,6
30,26,104,4,14,-10
30,26,105,20,19,1
30,26,106,11,13,-2
30,26,107,12,14,-2
30,26,108,12,22,-10
30,26,109,7,10,-3
30,26,110,17,10,7
30,26,111,20,19,1
30,26,112,13,26,-13
30,26,113,14,12,2
30,26,114,9,7,2
30,26,115,8,16,-8
30,26,116,4,7,-3
30,26,117,5,5,0
30,26,118,6,6,0
30,26,119,17,9,8
30,26,120,11,9,2
30,26,121,12,11,1
30,26,122,9,14,-5
30,26,123,12,9,3
30,26,124,11,21,-10
30,26,125,3,16,-13
30,26,126,14,10,4
30,26,127,7,10,-3
30,26,128,2,6,-4
30,26,129,8,20,-12
30,26,130,13,17,-4
30,26,131,5,11,-6
30,26,132,4,7,-3
30,26,133,11,19,-8
30,26,134,3,13,-10
30,26,135,4,11,-7
30,26,136,14,17,-3
30,26,137,7,4,3
30,26,138,10,8,2
30,26,139,17,16,1
30,26,140,9,13,-4
30,26,141,9,18,-9
30,26,142,7,13,-6
30,26,143,17,13,4
30,26,144,14,14,0
30,26,145,9,15,-6
30,26,146,6,7,-1
30,26,147,11,9,2
30,26,148,13,14,-1
30,26,149,12,19,-7
30,26,150,16,12,4
30,26,151,14,20,-6
30,26,152,20,17,3
30,26,153,12,10,2
30,26,154,9,9,0
30,26,155,11,9,2
30,26,156,11,6,5
30,26,157,14,5,9
30,26,158,13,12,1
30,26,159,11,18,-7
30,26,160,8,12,-4
30,26,161,21,11,10
30,26,162,8,15,-7
30,26,163,9,15,-6
30,26,164,12,21,-9
30,26,165,21,24,-3
30,26,166,20,13,7
30,26,167,10,31,-21
30,26,168,6,7,-1
30,26,169,15,15,0
30,26,170,11,15,-4
30,26,171,13,21,-8
30,26,172,4,16,-12
30,26,173,9,4,5
30,26,174,11,20,-9
30,26,175,7,22,-15
30,26,176,13,16,-3
30,26,177,21,11,10
30,26,178,7,18,-11
30,26,179,14,15,-1
30,26,180,11,20,-9
30,26,181,18,12,6
30,26,182,13,12,1
30,26,183,12,10,2
30,26,184,12,15,-3
30,26,185,8,22,-14
30,26,186,11,13,-2
30,26,187,0,14,-14
30,26,188,12,11,1
30,26,189,2,13,-11
30,26,190,4,9,-5
30,26,191,11,18,-7
30,26,192,16,28,-12
30,26,193,6,12,-6
30,26,194,23,12,11
30,26,195,4,14,-10
30,26,196,12,5,7
30,26,197,9,11,-2
30,26,198,22,22,0
30,26,199,20,19,1
30,26,200,15,13,2
30,26,201,13,7,6
30,26,202,15,10,5
30,26,203,11,7,4
30,26,204,10,14,-4
30,26,205,9,13,-4
30,26,206,14,15,-1
30,26,207,2,8,-6
30,26,208,12,17,-5
30,26,209,6,14,-8
30,26,210,12,20,-8
30,26,211,9,16,-7
30,26,212,16,11,5
30,26,213,14,5,9
30,26,214,6,8,-2
30,26,215,12,15,-3
30,26,216,17,23,-6
30,26,217,10,12,-2
30,26,218,9,4,5
30,26,219,5,7,-2
30,26,220,6,12,-6
30,26,221,5,6,-1
30,26,222,10,12,-2
30,26,223,12,14,-2
30,26,224,21,18,3
30,26,225,14,21,-7
30,26,226,16,17,-1
30,26,227,8,21,-13
30,26,228,8,19,-11
30,26,229,2,14,-12
30,26,230,11,20,-9
30,26,231,16,14,2
30,26,232,11,8,3
30,26,233,12,14,-2
30,26,234,3,6,-3
30,26,235,14,7,7
30,26,236,27,24,3
30,26,237,9,14,-5
30,26,238,9,13,-4
30,26,239,17,17,0
30,26,240,9,14,-5
30,26,241,15,14,1
30,26,242,17,19,-2
30,26,243,16,8,8
30,26,244,19,18,1
30,26,245,4,14,-10
30,26,246,9,7,2
30,26,247,10,5,5
30,26,248,14,13,1
30,26,249,4,7,-3
30,26,250,11,15,-4
30,26,251,7,14,-7
30,26,252,11,12,-1
30,26,253,9,11,-2
30,26,254,4,20,-16
30,26,255,12,8,4
30,26,256,13,14,-1
30,26,257,6,11,-5
30,26,258,20,14,6
30,26,259,13,17,-4
30,26,260,10,7,3
30,26,261,10,22,-12
30,26,262,10,18,-8
30,26,263,16,9,7
30,26,264,10,10,0
30,26,265,9,13,-4
30,26,266,9,7,2
30,26,267,7,21,-14
30,26,268,1,5,-4
30,26,269,8,7,1
30,26,270,7,17,-10
30,26,271,10,6,4
30,26,272,11,5,6
30,26,273,6,22,-16
30,26,274,14,14,0
30,26,275,9,10,-1
30,26,276,10,14,-4
30,26,277,7,13,-6
30,26,278,10,12,-2
30,26,279,8,15,-7
30,26,280,15,16,-1
30,26,281,9,14,-5
30,26,282,15,15,0
30,26,283,3,18,-15
30,26,284,5,10,-5
30,26,285,8,18,-10
30,26,286,11,5,6
30,26,287,6,10,-4
30,26,288,13,17,-4
30,26,289,3,7,-4
30,26,290,7,12,-5
30,26,291,7,22,-15
30,26,292,17,19,-2
30,26,293,20,20,0
30,26,294,10,9,1
30,26,295,9,10,-1
30,26,296,21,10,11
30,26,297,19,15,4
30,26,298,10,8,2
30,26,299,9,10,-1
30,27,0,10,11,-1
30,27,1,17,13,4
30,27,2,15,8,7
30,27,3,10,6,4
30,27,4,5,3,2
30,27,5,18,28,-10
30,27,6,13,32,-19
30,27,7,23,11,12
30,27,8,14,18,-4
30,27,9,21,20,1
30,27,10,9,16,-7
30,27,11,11,11,0
30,27,12,11,11,0
30,27,13,17,18,-1
30,27,14,20,19,1
30,27,15,13,14,-1
30,27,16,16,12,4
30,27,17,5,13,-8
30,27,18,16,13,3
30,27,19,23,11,12
30,27,20,7,17,-10
30,27,21,11,8,3
30,27,22,3,6,-3
30,27,23,7,8,-1
30,27,24,16,19,-3
30,27,25,7,12,-5
30,27,26,9,13,-4
30,27,27,9,16,-7
30,27,28,6,7,-1
30,27,29,22,13,9
30,27,30,3,12,-9
30,27,31,9,23,-14
30,27,32,14,17,-3
30,27,33,16,3,13
30,27,34,5,14,-9
30,27,35,15,17,-2
30,27,36,13,11,2
30,27,37,13,7,6
30,27,38,3,8,-5
30,27,39,9,16,-7
30,27,40,13,10,3
30,27,41,8,20,-12
30,27,42,18,6,12
30,27,43,6,3,3
30,27,44,19,19,0
30,27,45,14,15,-1
30,27,46,10,14,-4
30,27,47,6,8,-2
30,27,48,13,17,-4
30,27,49,6,7,-1
30,27,50,8,12,-4
30,27,51,13,14,-1
30,27,52,15,11,4
30,27,53,17,12,5
30,27,54,10,10,0
30,27,55,9,12,-3
30,27,56,17,13,4
30,27,57,19,18,1
30,27,58,2,18,-16
30,27,59,13,8,5
30,27,60,12,11,1
30,27,61,10,12,-2
30,27,62,12,13,-1
30,27,63,9,9,0
30,27,64,2,4,-2
30,27,65,16,11,5
30,27,66,18,15,3
30,27,67,10,14,-4
30,27,68,15,20,-5
30,27,69,15,18,-3
30,27,70,12,3,9
30,27,71,12,11,1
30,27,72,13,6,7
30,27,73,5,6,-1
30,27,74,13,16,-3
30,27,75,12,14,-2
30,27,76,12,10,2
30,27,77,10,9,1
30,27,78,12,16,-4
30,27,79,9,10,-1
30,27,80,12,8,4
30,27,81,18,7,11
30,27,82,13,19,-6
30,27,83,6,10,-4
30,27,84,8,19,-11
30,27,85,9,18,-9
30,27,86,5,6,-1
30,27,87,9,7,2
30,27,88,14,12,2
30,27,89,10,14,-4
30,27,90,15,24,-9
30,27,91,10,13,-3
30,27,92,10,12,-2
30,27,93,28,17,11
30,27,94,13,17,-4
30,27,95,9,14,-5
30,27,96,9,19,-10
30,27,97,12,13,-1
30,27,98,10,2,8
30,27,99,13,10,3
30,27,100,13,3,10
30,27,101,12,9,3
30,27,102,4,13,-9
30,27,103,10,13,-3
30,27,104,8,4,4
30,27,105,11,5,6
30,27,106,14,9,5
30,27,107,8,9,-1
30,27,108,6,5,1
30,27,109,10,14,-4
30,27,110,11,13,-2
30,27,111,8,9,-1
30,27,112,16,4,12
30,27,113,19,23,-4
30,27,114,9,9,0
30,27,115,7,5,2
30,27,116,13,13,0
30,27,117,20,20,0
30,27,118,13,13,0
30,27,119,3,10,-7
30,27,120,10,20,-10
30,27,121,16,11,5
30,27,122,5,14,-9
30,27,123,20,15,5
30,27,124,8,10,-2
30,27,125,6,11,-5
30,27,126,17,18,-1
30,27,127,9,9,0
30,27,128,8,19,-11
30,27,129,18,12,6
30,27,130,18,13,5
30,27,131,10,8,2
30,27,132,6,9,-3
30,27,133,11,9,2
30,27,134,8,10,-2
30,27,135,8,9,-1
30,27,136,13,14,-1
30,27,137,14,5,9
30,27,138,5,5,0
30,27,139,9,14,-5
30,27,140,7,11,-4
30,27,141,10,22,-12
30,27,142,14,25,-11
30,27,143,10,6,4
30,27,144,13,4,9
30,27,145,16,12,4
30,27,146,11,11,0
30,27,147,13,15,-2
30,27,148,10,10,0
30,27,149,9,6,3
30,27,150,13,10,3
30,27,151,18,18,0
30,27,152,8,5,3
30,27,153,7,10,-3
30,27,154,13,16,-3
30,27,155,7,12,-5
30,27,156,12,9,3
30,27,157,14,22,-8
30,27,158,17,9,8
30,27,159,9,20,-11
30,27,160,9,10,-1
30,27,161,4,9,-5
30,27,162,7,12,-5
30,27,163,6,16,-10
30,27,164,19,13,6
30,27,165,10,8,2
30,27,166,15,13,2
30,27,167,9,2,7
30,27,168,5,9,-4
30,27,169,19,7,12
30,27,170,15,25,-10
30,27,171,10,12,-2
30,27,172,11,23,-12
30,27,173,10,16,-6
30,27,174,15,8,7
30,27,175,13,11,2
30,27,176,17,9,8
30,27,177,16,23,-7
30,27,178,10,13,-3
30,27,179,16,17,-1
30,27,180,10,13,-3
30,27,181,12,13,-1
30,27,182,12,11,1
30,27,183,3,7,-4
30,27,184,9,6,3
30,27,185,6,10,-4
30,27,186,6,11,-5
30,27,187,21,19,2
30,27,188,14,13,1
30,27,189,5,7,-2
30,27,190,17,18,-1
30,27,191,2,16,-14
30,27,192,13,3,10
30,27,193,6,12,-6
30,27,194,20,8,12
30,27,195,7,15,-8
30,27,196,14,12,2
30,27,197,4,9,-5
30,27,198,10,17,-7
30,27,199,14,17,-3
30,27,200,19,8,11
30,27,201,5,12,-7
30,27,202,7,12,-5
30,27,203,7,6,1
30,27,204,10,19,-9
30,27,205,10,8,2
30,27,206,13,14,-1
30,27,207,8,13,-5
30,27,208,12,5,7
30,27,209,16,11,5
30,27,210,12,12,0
30,27,211,19,9,10
30,27,212,10,8,2
30,27,213,9,15,-6
30,27,214,9,19,-10
30,27,215,9,14,-5
30,27,216,20,15,5
30,27,217,13,7,6
30,27,218,11,8,3
30,27,219,2,1,1
30,27,220,6,17,-11
30,27,221,19,23,-4
30,27,222,14,19,-5
30,27,223,6,10,-4
30,27,224,4,13,-9
30,27,225,10,25,-15
30,27,226,10,23,-13
30,27,227,10,18,-8
30,27,228,3,8,-5
30,27,229,8,10,-2
30,27,230,29,17,12
30,27,231,8,13,-5
30,27,232,23,13,10
30,27,233,14,10,4
30,27,234,10,25,-15
30,27,235,13,13,0
30,27,236,7,12,-5
30,27,237,2,3,-1
30,27,238,11,17,-6
30,27,239,7,6,1
30,27,240,10,10,0
30,27,241,8,17,-9
30,27,242,10,16,-6
30,27,243,14,19,-5
30,27,244,7,8,-1
30,27,245,11,19,-8
30,27,246,9,7,2
30,27,247,10,4,6
30,27,248,11,19,-8
30,27,249,14,23,-9
30,27,250,6,13,-7
30,27,251,10,10,0
30,27,252,7,10,-3
30,27,253,21,15,6
30,27,254,19,18,1
30,27,255,13,18,-5
30,27,256,8,6,2
30,27,257,13,14,-1
30,27,258,10,20,-10
30,27,259,11,25,-14
30,27,260,15,20,-5
30,27,261,9,6,3
30,27,262,10,7,3
30,27,263,4,7,-3
30,27,264,8,14,-6
30,27,265,12,9,3
30,27,266,4,10,-6
30,27,267,13,13,0
30,27,268,16,12,4
30,27,269,10,13,-3
30,27,270,10,12,-2
30,27,271,15,11,4
30,27,272,13,23,-10
30,27,273,12,12,0
30,27,274,16,20,-4
30,27,275,10,13,-3
30,27,276,6,3,3
30,27,277,11,13,-2
30,27,278,4,13,-9
30,27,279,16,3,13
30,27,280,24,15,9
30,27,281,7,18,-11
30,27,282,6,14,-8
30,27,283,11,16,-5
30,27,284,17,22,-5
30,27,285,12,18,-6
30,27,286,9,9,0
30,27,287,9,15,-6
30,27,288,8,9,-1
30,27,289,20,17,3
30,27,290,9,11,-2
30,27,291,10,17,-7
30,27,292,9,10,-1
30,27,293,11,6,5
30,27,294,13,7,6
30,27,295,6,13,-7
30,27,296,4,15,-11
30,27,297,7,12,-5
30,27,298,12,15,-3
30,27,299,17,11,6
30,28,0,10,12,-2
30,28,1,4,7,-3
30,28,2,19,5,14
30,28,3,13,14,-1
30,28,4,8,8,0
30,28,5,10,6,4
30,28,6,9,4,5
30,28,7,12,9,3
30,28,8,23,22,1
30,28,9,4,11,-7
30,28,10,8,11,-3
30,28,11,12,11,1
30,28,12,12,17,-5
30,28,13,11,11,0
30,28,14,7,16,-9
30,28,15,18,13,5
30,28,16,8,7,1
30,28,17,12,8,4
30,28,18,10,9,1
30,28,19,10,23,-13
30,28,20,9,15,-6
30,28,21,15,6,9
30,28,22,11,24,-13
30,28,23,6,10,-4
30,28,24,6,7,-1
30,28,25,8,14,-6
30,28,26,13,12,1
30,28,27,19,14,5
30,28,28,4,20,-16
30,28,29,10,15,-5
30,28,30,20,10,10
30,28,31,7,5,2
30,28,32,11,18,-7
30,28,33,13,9,4
30,28,34,11,7,4
30,28,35,8,9,-1
30,28,36,1,8,-7
30,28,37,2,3,-1
30,28,38,13,12,1
30,28,39,14,14,0
30,28,40,16,12,4
30,28,41,25,15,10
30,28,42,9,21,-12
30,28,43,7,16,-9
30,28,44,10,9,1
30,28,45,9,22,-13
30,28,46,6,11,-5
30,28,47,13,10,3
30,28,48,8,16,-8
30,28,49,12,8,4
30,28,50,9,6,3
30,28,51,6,14,-8
30,28,52,14,9,5
30,28,53,15,13,2
30,28,54,12,7,5
30,28,55,3,21,-18
30,28,56,4,9,-5
30,28,57,9,12,-3
30,28,58,11,12,-1
30,28,59,3,15,-12
30,28,60,2,9,-7
30,28,61,19,14,5
30,28,62,12,15,-3
30,28,63,22,18,4
30,28,64,17,8,9
30,28,65,13,20,-7
30,28,66,8,8,0
30,28,67,15,19,-4
30,28,68,24,13,11
30,28,69,5,9,-4
30,28,70,5,9,-4
30,28,71,12,5,7
30,28,72,9,12,-3
30,28,73,12,14,-2
30,28,74,18,17,1
30,28,75,4,18,-14
30,28,76,6,10,-4
30,28,77,8,18,-10
30,28,78,30,22,8
30,28,79,16,9,7
30,28,80,14,5,9
30,28,81,10,14,-4
30,28,82,11,9,2
30,28,83,11,18,-7
30,28,84,5,4,1
30,28,85,5,11,-6
30,28,86,10,14,-4
30,28,87,10,0,10
30,28,88,9,6,3
30,28,89,17,14,3
30,28,90,6,16,-10
30,28,91,11,13,-2
30,28,92,18,19,-1
30,28,93,14,10,4
30,28,94,9,15,-6
30,28,95,7,17,-10
30,28,96,8,7,1
30,28,97,13,4,9
30,28,98,19,19,0
30,28,99,6,19,-13
30,28,100,7,16,-9
30,28,101,26,13,13
30,28,102,4,8,-4
30,28,103,22,12,10
30,28,104,18,14,4
30,28,105,11,21,-10
30,28,106,9,14,-5
30,28,107,9,24,-15
30,28,108,6,6,0
30,28,109,6,7,-1
30,28,110,13,2,11
30,28,111,9,11,-2
30,28,112,11,13,-2
30,28,113,8,19,-11
30,28,114,11,20,-9
30,28,115,12,15,-3
30,28,116,7,6,1
30,28,117,10,12,-2
30,28,118,12,11,1
30,28,119,12,16,-4
30,28,120,14,20,-6
30,28,121,18,13,5
30,28,122,5,4,1
30,28,123,10,3,7
30,28,124,9,17,-8
30,28,125,10,11,-1
30,28,126,1,9,-8
30,28,127,14,17,-3
30,28,128,15,14,1
30,28,129,11,15,-4
30,28,130,16,12,4
30,28,131,14,11,3
30,28,132,20,25,-5
30,28,133,5,8,-3
30,28,134,4,13,-9
30,28,135,8,16,-8
30,28,136,6,13,-7
30,28,137,10,8,2
30,28,138,12,12,0
30,28,139,9,7,2
30,28,140,6,7,-1
30,28,141,15,30,-15
30,28,142,13,14,-1
30,28,143,18,11,7
30,28,144,5,15,-10
30,28,145,12,9,3
30,28,146,15,8,7
30,28,147,12,24,-12
30,28,148,18,9,9
30,28,149,13,16,-3
30,28,150,15,20,-5
30,28,151,3,6,-3
30,28,152,4,7,-3
30,28,153,17,7,10
30,28,154,18,21,-3
30,28,155,20,15,5
30,28,156,9,9,0
30,28,157,13,8,5
30,28,158,5,10,-5
30,28,159,10,9,1
30,28,160,21,15,6
30,28,161,18,8,10
30,28,162,17,11,6
30,28,163,11,13,-2
30,28,164,13,8,5
30,28,165,10,9,1
30,28,166,12,15,-3
30,28,167,16,12,4
30,28,168,3,6,-3
30,28,169,6,16,-10
30,28,170,18,11,7
30,28,171,7,16,-9
30,28,172,2,14,-12
30,28,173,16,9,7
30,28,174,3,7,-4
30,28,175,8,10,-2
30,28,176,11,11,0
30,28,177,13,16,-3
30,28,178,12,12,0
30,28,179,17,11,6
30,28,180,7,8,-1
30,28,181,12,17,-5
30,28,182,12,16,-4
30,28,183,8,6,2
30,28,184,18,4,14
30,28,185,18,18,0
30,28,186,10,13,-3
30,28,187,6,9,-3
30,28,188,17,22,-5
30,28,189,9,10,-1
30,28,190,11,15,-4
30,28,191,14,10,4
30,28,192,21,32,-11
30,28,193,8,11,-3
30,28,194,11,14,-3
30,28,195,10,12,-2
30,28,196,7,12,-5
30,28,197,9,9,0
30,28,198,19,33,-14
30,28,199,13,13,0
30,28,200,10,9,1
30,28,201,2,11,-9
30,28,202,2,10,-8
30,28,203,16,7,9
30,28,204,15,20,-5
30,28,205,10,11,-1
30,28,206,18,11,7
30,28,207,11,12,-1
30,28,208,10,11,-1
30,28,209,12,12,0
30,28,210,16,14,2
30,28,211,2,7,-5
30,28,212,12,8,4
30,28,213,11,9,2
30,28,214,5,13,-8
30,28,215,10,9,1
30,28,216,3,15,-12
30,28,217,4,9,-5
30,28,218,4,24,-20
30,28,219,4,18,-14
30,28,220,12,9,3
30,28,221,7,9,-2
30,28,222,12,16,-4
30,28,223,7,9,-2
30,28,224,9,19,-10
30,28,225,16,17,-1
30,28,226,12,17,-5
30,28,227,6,19,-13
30,28,228,8,16,-8
30,28,229,13,8,5
30,28,230,12,6,6
30,28,231,13,13,0
30,28,232,12,16,-4
30,28,233,8,7,1
30,28,234,15,27,-12
30,28,235,10,13,-3
30,28,236,12,10,2
30,28,237,11,12,-1
30,28,238,10,4,6
30,28,239,20,20,0
30,28,240,19,22,-3
30,28,241,9,14,-5
30,28,242,10,11,-1
30,28,243,9,8,1
30,28,244,3,8,-5
30,28,245,5,5,0
30,28,246,14,15,-1
30,28,247,14,15,-1
30,28,248,8,16,-8
30,28,249,6,12,-6
30,28,250,12,12,0
30,28,251,6,21,-15
30,28,252,13,12,1
30,28,253,9,3,6
30,28,254,10,8,2
30,28,255,7,19,-12
30,28,256,17,8,9
30,28,257,8,5,3
30,28,258,7,4,3
30,28,259,5,6,-1
30,28,260,14,16,-2
30,28,261,13,20,-7
30,28,262,11,8,3
30,28,263,15,8,7
30,28,264,26,6,20
30,28,265,12,13,-1
30,28,266,12,9,3
30,28,267,20,12,8
30,28,268,8,13,-5
30,28,269,8,13,-5
30,28,270,16,16,0
30,28,271,11,10,1
30,28,272,5,9,-4
30,28,273,9,11,-2
30,28,274,4,15,-11
30,28,275,17,14,3
30,28,276,18,17,1
30,28,277,11,6,5
30,28,278,16,13,3
30,28,279,5,11,-6
30,28,280,0,6,-6
30,28,281,11,29,-18
30,28,282,13,18,-5
30,28,283,16,7,9
30,28,284,6,19,-13
30,28,285,4,8,-4
30,28,286,15,21,-6
30,28,287,19,14,5
30,28,288,15,10,5
30,28,289,9,28,-19
30,28,290,25,19,6
30,28,291,14,15,-1
30,28,292,17,10,7
30,28,293,7,14,-7
30,28,294,18,14,4
30,28,295,18,20,-2
30,28,296,8,16,-8
30,28,297,17,10,7
30,28,298,11,9,2
30,28,299,4,2,2
30,29,0,20,16,4
30,29,1,7,8,-1
30,29,2,11,7,4
30,29,3,17,17,0
30,29,4,14,9,5
30,29,5,15,10,5
30,29,6,6,9,-3
30,29,7,9,6,3
30,29,8,16,19,-3
30,29,9,9,13,-4
30,29,10,16,20,-4
30,29,11,19,9,10
30,29,12,12,12,0
30,29,13,10,22,-12
30,29,14,5,6,-1
30,29,15,9,17,-8
30,29,16,8,8,0
30,29,17,8,6,2
30,29,18,5,7,-2
30,29,19,15,21,-6
30,29,20,8,6,2
30,29,21,15,16,-1
30,29,22,9,12,-3
30,29,23,10,11,-1
30,29,24,12,6,6
30,29,25,10,13,-3
30,29,26,9,9,0
30,29,27,5,14,-9
30,29,28,13,7,6
30,29,29,5,7,-2
30,29,30,11,10,1
30,29,31,8,19,-11
30,29,32,11,23,-12
30,29,33,2,3,-1
30,29,34,7,18,-11
30,29,35,13,11,2
30,29,36,6,6,0
30,29,37,8,18,-10
30,29,38,10,10,0
30,29,39,14,18,-4
30,29,40,17,14,3
30,29,41,11,8,3
30,29,42,9,4,5
30,29,43,7,16,-9
30,29,44,3,5,-2
30,29,45,13,17,-4
30,29,46,9,9,0
30,29,47,12,9,3
30,29,48,13,9,4
30,29,49,9,22,-13
30,29,50,2,7,-5
30,29,51,9,6,3
30,29,52,8,3,5
30,29,53,14,29,-15
30,29,54,14,13,1
30,29,55,13,14,-1
30,29,56,8,8,0
30,29,57,11,15,-4
30,29,58,9,13,-4
30,29,59,8,9,-1
30,29,60,11,10,1
30,29,61,7,17,-10
30,29,62,5,8,-3
30,29,63,18,12,6
30,29,64,16,11,5
30,29,65,7,4,3
30,29,66,8,17,-9
30,29,67,15,11,4
30,29,68,19,20,-1
30,29,69,17,6,11
30,29,70,6,12,-6
30,29,71,8,9,-1
30,29,72,10,8,2
30,29,73,11,9,2
30,29,74,6,6,0
30,29,75,10,17,-7
30,29,76,8,6,2
30,29,77,4,24,-20
30,29,78,18,23,-5
30,29,79,10,21,-11
30,29,80,8,16,-8
30,29,81,7,5,2
30,29,82,10,10,0
30,29,83,13,12,1
30,29,84,10,20,-10
30,29,85,10,14,-4
30,29,86,16,7,9
30,29,87,17,7,10
30,29,88,9,14,-5
30,29,89,10,18,-8
30,29,90,10,12,-2
30,29,91,6,5,1
30,29,92,16,9,7
30,29,93,13,11,2
30,29,94,10,16,-6
30,29,95,15,7,8
30,29,96,9,10,-1
30,29,97,13,11,2
30,29,98,5,11,-6
30,29,99,14,15,-1
30,29,100,11,7,4
30,29,101,16,11,5
30,29,102,4,17,-13
30,29,103,4,13,-9
30,29,104,12,4,8
30,29,105,12,11,1
30,29,106,11,13,-2
30,29,107,11,11,0
30,29,108,6,8,-2
30,29,109,8,9,-1
30,29,110,1,6,-5
30,29,111,5,8,-3
30,29,112,5,13,-8
30,29,113,5,14,-9
30,29,114,12,9,3
30,29,115,23,13,10
30,29,116,16,10,6
30,29,117,8,10,-2
30,29,118,8,6,2
30,29,119,12,15,-3
30,29,120,10,13,-3
30,29,121,8,13,-5
30,29,122,12,5,7
30,29,123,10,14,-4
30,29,124,12,5,7
30,29,125,13,11,2
30,29,126,8,12,-4
30,29,127,10,5,5
30,29,128,12,19,-7
30,29,129,13,21,-8
30,29,130,9,14,-5
30,29,131,11,12,-1
30,29,132,9,10,-1
30,29,133,16,16,0
30,29,134,10,26,-16
30,29,135,8,11,-3
30,29,136,6,11,-5
30,29,137,16,15,1
30,29,138,9,15,-6
30,29,139,9,12,-3
30,29,140,9,12,-3
30,29,141,16,14,2
30,29,142,10,14,-4
30,29,143,15,19,-4
30,29,144,10,8,2
30,29,145,21,18,3
30,29,146,9,21,-12
30,29,147,7,11,-4
30,29,148,6,2,4
30,29,149,7,20,-13
30,29,150,14,15,-1
30,29,151,8,6,2
30,29,152,8,15,-7
30,29,153,17,9,8
30,29,154,8,4,4
30,29,155,4,10,-6
30,29,156,10,3,7
30,29,157,4,10,-6
30,29,158,7,8,-1
30,29,159,7,20,-13
30,29,160,15,12,3
30,29,161,21,19,2
30,29,162,14,14,0
30,29,163,7,5,2
30,29,164,22,13,9
30,29,165,4,14,-10
30,29,166,21,20,1
30,29,167,10,8,2
30,29,168,11,14,-3
30,29,169,4,9,-5
30,29,170,16,10,6
30,29,171,4,9,-5
30,29,172,5,8,-3
30,29,173,9,11,-2
30,29,174,8,6,2
30,29,175,5,13,-8
30,29,176,8,7,1
30,29,177,30,18,12
30,29,178,12,7,5
30,29,179,7,15,-8
30,29,180,6,11,-5
30,29,181,12,10,2
30,29,182,7,18,-11
30,29,183,11,12,-1
30,29,184,16,9,7
30,29,185,6,15,-9
30,29,186,20,9,11
30,29,187,3,14,-11
30,29,188,3,9,-6
30,29,189,14,12,2
30,29,190,12,14,-2
30,29,191,10,12,-2
30,29,192,7,1,6
30,29,193,13,13,0
30,29,194,8,2,6
30,29,195,8,7,1
30,29,196,12,13,-1
30,29,197,12,22,-10
30,29,198,7,6,1
30,29,199,10,21,-11
30,29,200,17,24,-7
30,29,201,4,11,-7
30,29,202,21,17,4
30,29,203,7,11,-4
30,29,204,9,10,-1
30,29,205,7,10,-3
30,29,206,5,12,-7
30,29,207,11,19,-8
30,29,208,18,17,1
30,29,209,16,12,4
30,29,210,22,17,5
30,29,211,6,13,-7
30,29,212,14,13,1
30,29,213,8,9,-1
30,29,214,7,8,-1
30,29,215,4,10,-6
30,29,216,16,11,5
30,29,217,10,12,-2
30,29,218,8,6,2
30,29,219,10,7,3
30,29,220,9,19,-10
30,29,221,12,5,7
30,29,222,11,3,8
30,29,223,9,8,1
30,29,224,5,15,-10
30,29,225,0,5,-5
30,29,226,12,10,2
30,29,227,8,5,3
30,29,228,14,17,-3
30,29,229,7,14,-7
30,29,230,3,3,0
30,29,231,6,10,-4
30,29,232,19,15,4
30,29,233,14,10,4
30,29,234,15,12,3
30,29,235,12,23,-11
30,29,236,24,13,11
30,29,237,16,13,3
30,29,238,8,15,-7
30,29,239,14,10,4
30,29,240,10,19,-9
30,29,241,13,19,-6
30,29,242,4,14,-10
30,29,243,17,13,4
30,29,244,6,6,0
30,29,245,17,20,-3
30,29,246,8,16,-8
30,29,247,9,13,-4
30,29,248,2,2,0
30,29,249,11,5,6
30,29,250,8,10,-2
30,29,251,22,11,11
30,29,252,7,5,2
30,29,253,9,5,4
30,29,254,13,16,-3
30,29,255,9,10,-1
30,29,256,10,5,5
30,29,257,12,8,4
30,29,258,12,13,-1
30,29,259,8,13,-5
30,29,260,10,21,-11
30,29,261,14,14,0
30,29,262,10,7,3
30,29,263,9,11,-2
30,29,264,13,6,7
30,29,265,8,11,-3
30,29,266,10,18,-8
30,29,267,12,18,-6
30,29,268,13,22,-9
30,29,269,13,15,-2
30,29,270,14,10,4
30,29,271,5,6,-1
30,29,272,6,4,2
30,29,273,17,10,7
30,29,274,16,9,7
30,29,275,20,22,-2
30,29,276,7,7,0
30,29,277,10,3,7
30,29,278,5,19,-14
30,29,279,22,9,13
30,29,280,14,9,5
30,29,281,12,12,0
30,29,282,13,18,-5
30,29,283,14,7,7
30,29,284,17,17,0
30,29,285,5,14,-9
30,29,286,11,14,-3
30,29,287,11,9,2
30,29,288,8,16,-8
30,29,289,10,15,-5
30,29,290,7,10,-3
30,29,291,17,13,4
30,29,292,4,9,-5
30,29,293,5,9,-4
30,29,294,22,14,8
30,29,295,15,11,4
30,29,296,8,17,-9
30,29,297,13,11,2
30,29,298,13,17,-4
30,29,299,10,9,1
30,30,0,10,17,-7
30,30,1,6,2,4
30,30,2,19,10,9
30,30,3,4,5,-1
30,30,4,4,11,-7
30,30,5,7,12,-5
30,30,6,8,9,-1
30,30,7,11,16,-5
30,30,8,4,20,-16
30,30,9,10,12,-2
30,30,10,9,11,-2
30,30,11,7,13,-6
30,30,12,3,13,-10
30,30,13,9,10,-1
30,30,14,15,14,1
30,30,15,21,20,1
30,30,16,13,12,1
30,30,17,12,13,-1
30,30,18,3,13,-10
30,30,19,12,15,-3
30,30,20,13,19,-6
30,30,21,13,18,-5
30,30,22,7,13,-6
30,30,23,1,4,-3
30,30,24,11,14,-3
30,30,25,19,17,2
30,30,26,10,11,-1
30,30,27,7,20,-13
30,30,28,9,10,-1
30,30,29,9,5,4
30,30,30,4,7,-3
30,30,31,8,9,-1
30,30,32,7,8,-1
30,30,33,7,13,-6
30,30,34,6,7,-1
30,30,35,12,11,1
30,30,36,7,8,-1
30,30,37,7,14,-7
30,30,38,6,3,3
30,30,39,5,17,-12
30,30,40,7,8,-1
30,30,41,11,9,2
30,30,42,12,14,-2
30,30,43,19,14,5
30,30,44,6,19,-13
30,30,45,15,16,-1
30,30,46,19,8,11
30,30,47,12,11,1
30,30,48,10,12,-2
30,30,49,15,22,-7
30,30,50,6,12,-6
30,30,51,3,7,-4
30,30,52,10,9,1
30,30,53,2,16,-14
30,30,54,10,12,-2
30,30,55,26,19,7
30,30,56,10,8,2
30,30,57,7,16,-9
30,30,58,15,13,2
30,30,59,17,19,-2
30,30,60,13,17,-4
30,30,61,8,12,-4
30,30,62,6,13,-7
30,30,63,9,12,-3
30,30,64,10,18,-8
30,30,65,14,7,7
30,30,66,4,3,1
30,30,67,17,23,-6
30,30,68,13,8,5
30,30,69,8,12,-4
30,30,70,18,10,8
30,30,71,14,9,5
30,30,72,7,6,1
30,30,73,7,12,-5
30,30,74,6,4,2
30,30,75,16,8,8
30,30,76,6,12,-6
30,30,77,11,10,1
30,30,78,6,13,-7
30,30,79,5,14,-9
30,30,80,17,8,9
30,30,81,3,13,-10
30,30,82,13,5,8
30,30,83,8,8,0
30,30,84,6,5,1
30,30,85,14,11,3
30,30,86,8,18,-10
30,30,87,5,5,0
30,30,88,11,13,-2
30,30,89,16,16,0
30,30,90,4,13,-9
30,30,91,10,14,-4
30,30,92,10,16,-6
30,30,93,13,10,3
30,30,94,19,8,11
30,30,95,16,17,-1
30,30,96,9,10,-1
30,30,97,11,4,7
30,30,98,9,5,4
30,30,99,7,17,-10
30,30,100,4,17,-13
30,30,101,19,20,-1
30,30,102,14,6,8
30,30,103,10,8,2
30,30,104,15,20,-5
30,30,105,15,9,6
30,30,106,9,19,-10
30,30,107,4,5,-1
30,30,108,6,5,1
30,30,109,12,14,-2
30,30,110,7,23,-16
30,30,111,11,16,-5
30,30,112,7,12,-5
30,30,113,11,8,3
30,30,114,13,8,5
30,30,115,14,14,0
30,30,116,20,22,-2
30,30,117,7,6,1
30,30,118,7,10,-3
30,30,119,7,8,-1
30,30,120,14,8,6
30,30,121,9,14,-5
30,30,122,10,7,3
30,30,123,2,9,-7
30,30,124,11,14,-3
30,30,125,20,22,-2
30,30,126,8,17,-9
30,30,127,16,11,5
30,30,128,11,9,2
30,30,129,8,11,-3
30,30,130,2,4,-2
30,30,131,13,7,6
30,30,132,3,8,-5
30,30,133,15,24,-9
30,30,134,14,15,-1
30,30,135,8,13,-5
30,30,136,20,21,-1
30,30,137,9,10,-1
30,30,138,6,18,-12
30,30,139,13,9,4
30,30,140,17,19,-2
30,30,141,7,11,-4
30,30,142,6,8,-2
30,30,143,4,6,-2
30,30,144,8,14,-6
30,30,145,6,13,-7
30,30,146,14,16,-2
30,30,147,10,10,0
30,30,148,9,16,-7
30,30,149,14,12,2
30,30,150,10,6,4
30,30,151,14,12,2
30,30,152,11,10,1
30,30,153,5,19,-14
30,30,154,11,8,3
30,30,155,4,12,-8
30,30,156,13,9,4
30,30,157,12,12,0
30,30,158,10,6,4
30,30,159,11,17,-6
30,30,160,0,17,-17
30,30,161,17,20,-3
30,30,162,13,12,1
30,30,163,8,22,-14
30,30,164,16,15,1
30,30,165,6,6,0
30,30,166,8,12,-4
30,30,167,11,13,-2
30,30,168,20,18,2
30,30,169,13,20,-7
30,30,170,12,13,-1
30,30,171,5,17,-12
30,30,172,4,15,-11
30,30,173,3,5,-2
30,30,174,17,15,2
30,30,175,2,12,-10
30,30,176,9,8,1
30,30,177,2,14,-12
30,30,178,13,19,-6
30,30,179,11,6,5
30,30,180,12,6,6
30,30,181,4,10,-6
30,30,182,2,12,-10
30,30,183,14,13,1
30,30,184,6,8,-2
30,30,185,4,19,-15
30,30,186,8,12,-4
30,30,187,16,19,-3
30,30,188,10,14,-4
30,30,189,10,16,-6
30,30,190,10,9,1
30,30,191,16,22,-6
30,30,192,8,13,-5
30,30,193,5,4,1
30,30,194,14,15,-1
30,30,195,14,9,5
30,30,196,16,5,11
30,30,197,7,8,-1
30,30,198,7,17,-10
30,30,199,10,16,-6
30,30,200,3,4,-1
30,30,201,8,7,1
30,30,202,7,7,0
30,30,203,19,12,7
30,30,204,7,8,-1
30,30,205,7,8,-1
30,30,206,8,12,-4
30,30,207,9,12,-3
30,30,208,9,7,2
30,30,209,10,11,-1
30,30,210,9,12,-3
30,30,211,8,11,-3
30,30,212,4,5,-1
30,30,213,16,14,2
30,30,214,9,7,2
30,30,215,13,29,-16
30,30,216,9,11,-2
30,30,217,7,9,-2
30,30,218,6,6,0
30,30,219,8,10,-2
30,30,220,4,7,-3
30,30,221,10,12,-2
30,30,222,9,13,-4
30,30,223,20,29,-9
30,30,224,8,7,1
30,30,225,17,17,0
30,30,226,8,10,-2
30,30,227,2,6,-4
30,30,228,15,13,2
30,30,229,4,12,-8
30,30,230,18,9,9
30,30,231,19,13,6
30,30,232,6,6,0
30,30,233,8,13,-5
30,30,234,9,13,-4
30,30,235,9,10,-1
30,30,236,5,3,2
30,30,237,8,23,-15
30,30,238,6,7,-1
30,30,239,15,17,-2
30,30,240,11,6,5
30,30,241,3,0,3
30,30,242,9,10,-1
30,30,243,6,18,-12
30,30,244,8,7,1
30,30,245,4,13,-9
30,30,246,8,9,-1
30,30,247,3,23,-20
30,30,248,1,14,-13
30,30,249,12,9,3
30,30,250,3,6,-3
30,30,251,17,20,-3
30,30,252,13,14,-1
30,30,253,13,9,4
30,30,254,18,18,0
30,30,255,10,14,-4
30,30,256,11,5,6
30,30,257,2,14,-12
30,30,258,15,14,1
30,30,259,22,15,7
30,30,260,7,14,-7
30,30,261,6,9,-3
30,30,262,6,14,-8
30,30,263,11,10,1
30,30,264,10,9,1
30,30,265,7,14,-7
30,30,266,5,2,3
30,30,267,4,11,-7
30,30,268,6,20,-14
30,30,269,8,8,0
30,30,270,13,15,-2
30,30,271,8,14,-6
30,30,272,9,19,-10
30,30,273,5,9,-4
30,30,274,17,9,8
30,30,275,17,21,-4
30,30,276,0,3,-3
30,30,277,6,12,-6
30,30,278,18,21,-3
30,30,279,16,13,3
30,30,280,6,14,-8
30,30,281,9,10,-1
30,30,282,3,13,-10
30,30,283,3,6,-3
30,30,284,4,14,-10
30,30,285,8,10,-2
30,30,286,18,18,0
30,30,287,11,12,-1
30,30,288,22,23,-1
30,30,289,6,13,-7
30,30,290,16,26,-10
30,30,291,9,19,-10
30,30,292,13,6,7
30,30,293,16,20,-4
30,30,294,6,2,4
30,30,295,13,12,1
30,30,296,7,13,-6
30,30,297,11,11,0
30,30,298,16,15,1
30,30,299,8,3,5
