# frame_skip_agent_A, frame_skip_agent_B, episode, score_A, score_B, reward
1,1,0,3,4,-1
1,1,1,7,5,2
1,1,2,2,2,0
1,1,3,5,3,2
1,1,4,0,0,0
1,1,5,13,10,3
1,1,6,8,5,3
1,1,7,4,1,3
1,1,8,20,7,13
1,1,9,0,1,-1
1,1,10,5,5,0
1,1,11,8,9,-1
1,1,12,6,3,3
1,1,13,0,4,-4
1,1,14,2,12,-10
1,1,15,5,9,-4
1,1,16,9,17,-8
1,1,17,5,4,1
1,1,18,18,6,12
1,1,19,4,1,3
1,1,20,11,6,5
1,1,21,0,0,0
1,1,22,2,3,-1
1,1,23,12,6,6
1,1,24,4,4,0
1,1,25,3,5,-2
1,1,26,1,6,-5
1,1,27,3,6,-3
1,1,28,2,4,-2
1,1,29,5,2,3
1,1,30,6,12,-6
1,1,31,6,7,-1
1,1,32,3,6,-3
1,1,33,1,8,-7
1,1,34,3,1,2
1,1,35,3,4,-1
1,1,36,4,2,2
1,1,37,7,6,1
1,1,38,10,17,-7
1,1,39,12,5,7
1,1,40,14,13,1
1,1,41,10,13,-3
1,1,42,5,1,4
1,1,43,5,11,-6
1,1,44,3,7,-4
1,1,45,3,4,-1
1,1,46,1,4,-3
1,1,47,6,2,4
1,1,48,3,6,-3
1,1,49,12,6,6
1,1,50,0,3,-3
1,1,51,5,3,2
1,1,52,2,3,-1
1,1,53,2,2,0
1,1,54,2,4,-2
1,1,55,4,4,0
1,1,56,6,8,-2
1,1,57,4,8,-4
1,1,58,5,15,-10
1,1,59,4,0,4
1,1,60,15,7,8
1,1,61,3,6,-3
1,1,62,12,14,-2
1,1,63,10,10,0
1,1,64,6,3,3
1,1,65,7,7,0
1,1,66,4,7,-3
1,1,67,6,14,-8
1,1,68,0,4,-4
1,1,69,4,2,2
1,1,70,6,12,-6
1,1,71,7,3,4
1,1,72,3,6,-3
1,1,73,7,7,0
1,1,74,1,3,-2
1,1,75,13,10,3
1,1,76,0,2,-2
1,1,77,7,5,2
1,1,78,4,5,-1
1,1,79,4,8,-4
1,1,80,3,5,-2
1,1,81,5,10,-5
1,1,82,4,2,2
1,1,83,9,6,3
1,1,84,1,3,-2
1,1,85,1,0,1
1,1,86,6,14,-8
1,1,87,15,3,12
1,1,88,4,8,-4
1,1,89,6,5,1
1,1,90,4,6,-2
1,1,91,1,1,0
1,1,92,7,5,2
1,1,93,4,6,-2
1,1,94,16,7,9
1,1,95,4,5,-1
1,1,96,6,2,4
1,1,97,4,7,-3
1,1,98,3,1,2
1,1,99,9,2,7
1,1,100,1,7,-6
1,1,101,13,5,8
1,1,102,18,20,-2
1,1,103,7,3,4
1,1,104,19,10,9
1,1,105,3,5,-2
1,1,106,0,2,-2
1,1,107,6,13,-7
1,1,108,8,8,0
1,1,109,5,11,-6
1,1,110,4,4,0
1,1,111,13,6,7
1,1,112,6,6,0
1,1,113,7,11,-4
1,1,114,8,8,0
1,1,115,0,1,-1
1,1,116,16,15,1
1,1,117,3,6,-3
1,1,118,2,4,-2
1,1,119,8,8,0
1,1,120,8,7,1
1,1,121,2,3,-1
1,1,122,7,7,0
1,1,123,2,4,-2
1,1,124,8,8,0
1,1,125,8,1,7
1,1,126,6,3,3
1,1,127,5,2,3
1,1,128,5,14,-9
1,1,129,3,1,2
1,1,130,2,2,0
1,1,131,6,7,-1
1,1,132,6,4,2
1,1,133,9,4,5
1,1,134,5,7,-2
1,1,135,9,6,3
1,1,136,2,5,-3
1,1,137,3,2,1
1,1,138,2,1,1
1,1,139,12,10,2
1,1,140,10,6,4
1,1,141,9,8,1
1,1,142,8,9,-1
1,1,143,3,10,-7
1,1,144,5,10,-5
1,1,145,7,5,2
1,1,146,5,4,1
1,1,147,4,7,-3
1,1,148,2,6,-4
1,1,149,9,6,3
1,1,150,3,15,-12
1,1,151,3,8,-5
1,1,152,6,15,-9
1,1,153,6,3,3
1,1,154,4,9,-5
1,1,155,5,1,4
1,1,156,9,6,3
1,1,157,5,4,1
1,1,158,2,8,-6
1,1,159,2,1,1
1,1,160,4,4,0
1,1,161,6,3,3
1,1,162,3,6,-3
1,1,163,6,15,-9
1,1,164,6,9,-3
1,1,165,4,17,-13
1,1,166,4,10,-6
1,1,167,9,8,1
1,1,168,7,3,4
1,1,169,6,12,-6
1,1,170,12,15,-3
1,1,171,7,8,-1
1,1,172,1,0,1
1,1,173,7,4,3
1,1,174,1,12,-11
1,1,175,5,8,-3
1,1,176,17,6,11
1,1,177,3,3,0
1,1,178,1,8,-7
1,1,179,4,4,0
1,1,180,6,6,0
1,1,181,11,5,6
1,1,182,6,6,0
1,1,183,7,4,3
1,1,184,1,3,-2
1,1,185,11,7,4
1,1,186,7,3,4
1,1,187,3,8,-5
1,1,188,2,3,-1
1,1,189,9,6,3
1,1,190,10,16,-6
1,1,191,2,1,1
1,1,192,11,5,6
1,1,193,7,10,-3
1,1,194,3,3,0
1,1,195,6,1,5
1,1,196,19,17,2
1,1,197,2,2,0
1,1,198,6,10,-4
1,1,199,12,6,6
1,1,200,0,7,-7
1,1,201,4,5,-1
1,1,202,1,1,0
1,1,203,4,5,-1
1,1,204,2,5,-3
1,1,205,9,10,-1
1,1,206,5,13,-8
1,1,207,2,6,-4
1,1,208,3,14,-11
1,1,209,15,7,8
1,1,210,8,13,-5
1,1,211,11,8,3
1,1,212,4,9,-5
1,1,213,1,4,-3
1,1,214,11,7,4
1,1,215,2,1,1
1,1,216,4,3,1
1,1,217,2,9,-7
1,1,218,6,11,-5
1,1,219,13,8,5
1,1,220,4,17,-13
1,1,221,1,3,-2
1,1,222,8,2,6
1,1,223,5,6,-1
1,1,224,9,4,5
1,1,225,4,6,-2
1,1,226,5,7,-2
1,1,227,3,4,-1
1,1,228,12,17,-5
1,1,229,2,4,-2
1,1,230,7,7,0
1,1,231,6,10,-4
1,1,232,5,7,-2
1,1,233,8,12,-4
1,1,234,2,1,1
1,1,235,10,3,7
1,1,236,5,2,3
1,1,237,7,11,-4
1,1,238,10,6,4
1,1,239,6,8,-2
1,1,240,2,8,-6
1,1,241,9,10,-1
1,1,242,5,7,-2
1,1,243,0,3,-3
1,1,244,4,4,0
1,1,245,3,7,-4
1,1,246,4,4,0
1,1,247,8,6,2
1,1,248,1,5,-4
1,1,249,6,2,4
1,1,250,5,3,2
1,1,251,3,3,0
1,1,252,4,8,-4
1,1,253,5,2,3
1,1,254,9,6,3
1,1,255,6,6,0
1,1,256,6,8,-2
1,1,257,3,3,0
1,1,258,7,2,5
1,1,259,6,8,-2
1,1,260,6,3,3
1,1,261,4,11,-7
1,1,262,5,6,-1
1,1,263,5,4,1
1,1,264,3,7,-4
1,1,265,7,13,-6
1,1,266,10,8,2
1,1,267,2,1,1
1,1,268,3,2,1
1,1,269,2,2,0
1,1,270,6,6,0
1,1,271,5,5,0
1,1,272,3,9,-6
1,1,273,5,16,-11
1,1,274,0,1,-1
1,1,275,0,3,-3
1,1,276,4,10,-6
1,1,277,12,10,2
1,1,278,0,0,0
1,1,279,4,7,-3
1,1,280,9,5,4
1,1,281,9,7,2
1,1,282,6,15,-9
1,1,283,7,4,3
1,1,284,12,10,2
1,1,285,5,7,-2
1,1,286,4,0,4
1,1,287,4,10,-6
1,1,288,6,13,-7
1,1,289,6,7,-1
1,1,290,7,1,6
1,1,291,3,4,-1
1,1,292,5,9,-4
1,1,293,9,7,2
1,1,294,7,8,-1
1,1,295,6,7,-1
1,1,296,3,8,-5
1,1,297,6,12,-6
1,1,298,3,11,-8
1,1,299,5,5,0
2,2,0,13,12,1
2,2,1,12,14,-2
2,2,2,2,1,1
2,2,3,21,19,2
2,2,4,2,6,-4
2,2,5,14,4,10
2,2,6,8,5,3
2,2,7,11,8,3
2,2,8,2,5,-3
2,2,9,13,5,8
2,2,10,4,2,2
2,2,11,9,2,7
2,2,12,5,11,-6
2,2,13,26,12,14
2,2,14,2,2,0
2,2,15,6,6,0
2,2,16,5,8,-3
2,2,17,16,3,13
2,2,18,5,7,-2
2,2,19,2,10,-8
2,2,20,17,9,8
2,2,21,1,5,-4
2,2,22,2,7,-5
2,2,23,5,9,-4
2,2,24,6,5,1
2,2,25,6,6,0
2,2,26,1,7,-6
2,2,27,13,17,-4
2,2,28,4,5,-1
2,2,29,15,11,4
2,2,30,9,9,0
2,2,31,7,13,-6
2,2,32,10,18,-8
2,2,33,8,6,2
2,2,34,17,17,0
2,2,35,7,3,4
2,2,36,12,7,5
2,2,37,15,11,4
2,2,38,14,21,-7
2,2,39,5,5,0
2,2,40,14,6,8
2,2,41,10,13,-3
2,2,42,4,9,-5
2,2,43,21,14,7
2,2,44,6,6,0
2,2,45,3,9,-6
2,2,46,5,4,1
2,2,47,9,11,-2
2,2,48,9,14,-5
2,2,49,3,1,2
2,2,50,5,16,-11
2,2,51,4,8,-4
2,2,52,7,9,-2
2,2,53,5,5,0
2,2,54,0,8,-8
2,2,55,9,6,3
2,2,56,14,6,8
2,2,57,5,12,-7
2,2,58,9,7,2
2,2,59,2,0,2
2,2,60,4,11,-7
2,2,61,6,10,-4
2,2,62,4,8,-4
2,2,63,13,3,10
2,2,64,9,6,3
2,2,65,7,9,-2
2,2,66,9,7,2
2,2,67,4,12,-8
2,2,68,9,9,0
2,2,69,11,9,2
2,2,70,7,9,-2
2,2,71,2,0,2
2,2,72,12,12,0
2,2,73,6,6,0
2,2,74,14,18,-4
2,2,75,3,13,-10
2,2,76,2,8,-6
2,2,77,22,6,16
2,2,78,6,10,-4
2,2,79,11,24,-13
2,2,80,2,7,-5
2,2,81,9,21,-12
2,2,82,3,5,-2
2,2,83,6,13,-7
2,2,84,9,19,-10
2,2,85,3,10,-7
2,2,86,11,5,6
2,2,87,9,5,4
2,2,88,4,6,-2
2,2,89,3,5,-2
2,2,90,3,14,-11
2,2,91,1,6,-5
2,2,92,2,2,0
2,2,93,5,3,2
2,2,94,15,11,4
2,2,95,2,1,1
2,2,96,1,3,-2
2,2,97,15,10,5
2,2,98,1,2,-1
2,2,99,2,22,-20
2,2,100,6,8,-2
2,2,101,10,17,-7
2,2,102,4,6,-2
2,2,103,5,6,-1
2,2,104,2,6,-4
2,2,105,9,9,0
2,2,106,1,0,1
2,2,107,5,0,5
2,2,108,15,12,3
2,2,109,1,5,-4
2,2,110,16,8,8
2,2,111,23,15,8
2,2,112,8,9,-1
2,2,113,15,14,1
2,2,114,9,14,-5
2,2,115,17,15,2
2,2,116,10,8,2
2,2,117,5,2,3
2,2,118,8,6,2
2,2,119,4,18,-14
2,2,120,9,11,-2
2,2,121,4,13,-9
2,2,122,3,4,-1
2,2,123,7,14,-7
2,2,124,5,7,-2
2,2,125,2,4,-2
2,2,126,4,8,-4
2,2,127,9,18,-9
2,2,128,5,2,3
2,2,129,11,12,-1
2,2,130,6,4,2
2,2,131,10,7,3
2,2,132,13,1,12
2,2,133,5,7,-2
2,2,134,11,13,-2
2,2,135,1,6,-5
2,2,136,8,2,6
2,2,137,5,8,-3
2,2,138,9,7,2
2,2,139,6,3,3
2,2,140,5,12,-7
2,2,141,11,14,-3
2,2,142,4,9,-5
2,2,143,7,1,6
2,2,144,4,3,1
2,2,145,4,9,-5
2,2,146,0,6,-6
2,2,147,6,11,-5
2,2,148,3,15,-12
2,2,149,7,5,2
2,2,150,10,10,0
2,2,151,9,10,-1
2,2,152,5,3,2
2,2,153,4,0,4
2,2,154,7,16,-9
2,2,155,3,11,-8
2,2,156,2,7,-5
2,2,157,5,7,-2
2,2,158,2,9,-7
2,2,159,12,17,-5
2,2,160,3,6,-3
2,2,161,6,16,-10
2,2,162,14,6,8
2,2,163,8,9,-1
2,2,164,0,1,-1
2,2,165,16,16,0
2,2,166,3,6,-3
2,2,167,4,6,-2
2,2,168,8,5,3
2,2,169,11,17,-6
2,2,170,7,7,0
2,2,171,15,9,6
2,2,172,4,7,-3
2,2,173,2,6,-4
2,2,174,18,6,12
2,2,175,4,5,-1
2,2,176,1,1,0
2,2,177,8,7,1
2,2,178,5,7,-2
2,2,179,4,8,-4
2,2,180,1,6,-5
2,2,181,12,10,2
2,2,182,1,8,-7
2,2,183,7,16,-9
2,2,184,8,12,-4
2,2,185,9,5,4
2,2,186,8,6,2
2,2,187,8,5,3
2,2,188,3,6,-3
2,2,189,5,10,-5
2,2,190,12,19,-7
2,2,191,6,2,4
2,2,192,12,4,8
2,2,193,13,4,9
2,2,194,2,7,-5
2,2,195,15,12,3
2,2,196,8,10,-2
2,2,197,2,5,-3
2,2,198,6,5,1
2,2,199,5,9,-4
2,2,200,5,9,-4
2,2,201,9,10,-1
2,2,202,9,5,4
2,2,203,8,9,-1
2,2,204,9,0,9
2,2,205,5,6,-1
2,2,206,8,12,-4
2,2,207,12,11,1
2,2,208,8,10,-2
2,2,209,9,10,-1
2,2,210,7,8,-1
2,2,211,17,22,-5
2,2,212,4,8,-4
2,2,213,8,5,3
2,2,214,10,6,4
2,2,215,8,10,-2
2,2,216,3,4,-1
2,2,217,7,12,-5
2,2,218,12,6,6
2,2,219,2,7,-5
2,2,220,5,12,-7
2,2,221,4,4,0
2,2,222,11,11,0
2,2,223,4,6,-2
2,2,224,5,4,1
2,2,225,4,0,4
2,2,226,5,7,-2
2,2,227,5,6,-1
2,2,228,2,2,0
2,2,229,8,12,-4
2,2,230,8,14,-6
2,2,231,4,10,-6
2,2,232,4,5,-1
2,2,233,6,9,-3
2,2,234,6,9,-3
2,2,235,5,8,-3
2,2,236,6,8,-2
2,2,237,13,13,0
2,2,238,4,8,-4
2,2,239,1,1,0
2,2,240,4,16,-12
2,2,241,9,7,2
2,2,242,10,9,1
2,2,243,10,10,0
2,2,244,3,6,-3
2,2,245,0,1,-1
2,2,246,3,6,-3
2,2,247,17,22,-5
2,2,248,3,6,-3
2,2,249,8,5,3
2,2,250,5,5,0
2,2,251,3,3,0
2,2,252,15,5,10
2,2,253,12,10,2
2,2,254,11,21,-10
2,2,255,7,10,-3
2,2,256,5,5,0
2,2,257,8,5,3
2,2,258,3,4,-1
2,2,259,0,0,0
2,2,260,7,11,-4
2,2,261,6,9,-3
2,2,262,3,8,-5
2,2,263,25,4,21
2,2,264,4,6,-2
2,2,265,3,3,0
2,2,266,9,12,-3
2,2,267,13,5,8
2,2,268,5,22,-17
2,2,269,6,9,-3
2,2,270,18,12,6
2,2,271,4,17,-13
2,2,272,5,10,-5
2,2,273,2,6,-4
2,2,274,7,10,-3
2,2,275,3,9,-6
2,2,276,5,5,0
2,2,277,1,10,-9
2,2,278,3,9,-6
2,2,279,10,12,-2
2,2,280,2,2,0
2,2,281,12,9,3
2,2,282,3,11,-8
2,2,283,7,7,0
2,2,284,21,4,17
2,2,285,13,4,9
2,2,286,7,9,-2
2,2,287,8,8,0
2,2,288,3,5,-2
2,2,289,12,10,2
2,2,290,2,24,-22
2,2,291,8,8,0
2,2,292,10,11,-1
2,2,293,5,11,-6
2,2,294,9,14,-5
2,2,295,8,17,-9
2,2,296,8,14,-6
2,2,297,3,7,-4
2,2,298,8,9,-1
2,2,299,12,10,2
3,3,0,33,4,29
3,3,1,6,14,-8
3,3,2,2,3,-1
3,3,3,15,12,3
3,3,4,8,9,-1
3,3,5,6,11,-5
3,3,6,20,6,14
3,3,7,7,3,4
3,3,8,11,9,2
3,3,9,13,12,1
3,3,10,10,6,4
3,3,11,16,32,-16
3,3,12,9,14,-5
3,3,13,15,15,0
3,3,14,10,11,-1
3,3,15,10,14,-4
3,3,16,3,4,-1
3,3,17,11,3,8
3,3,18,24,7,17
3,3,19,11,5,6
3,3,20,4,10,-6
3,3,21,14,12,2
3,3,22,8,5,3
3,3,23,5,10,-5
3,3,24,19,12,7
3,3,25,14,8,6
3,3,26,6,10,-4
3,3,27,17,16,1
3,3,28,8,12,-4
3,3,29,6,11,-5
3,3,30,10,13,-3
3,3,31,14,9,5
3,3,32,4,14,-10
3,3,33,0,10,-10
3,3,34,5,7,-2
3,3,35,12,14,-2
3,3,36,4,6,-2
3,3,37,4,9,-5
3,3,38,10,17,-7
3,3,39,11,9,2
3,3,40,14,20,-6
3,3,41,5,10,-5
3,3,42,9,7,2
3,3,43,8,8,0
3,3,44,24,13,11
3,3,45,6,6,0
3,3,46,4,6,-2
3,3,47,6,5,1
3,3,48,13,9,4
3,3,49,6,4,2
3,3,50,11,8,3
3,3,51,10,9,1
3,3,52,9,5,4
3,3,53,7,17,-10
3,3,54,4,1,3
3,3,55,7,7,0
3,3,56,9,3,6
3,3,57,9,14,-5
3,3,58,4,2,2
3,3,59,12,5,7
3,3,60,10,18,-8
3,3,61,11,3,8
3,3,62,18,19,-1
3,3,63,4,12,-8
3,3,64,15,15,0
3,3,65,12,13,-1
3,3,66,9,7,2
3,3,67,4,4,0
3,3,68,9,5,4
3,3,69,13,7,6
3,3,70,19,17,2
3,3,71,17,21,-4
3,3,72,7,5,2
3,3,73,15,13,2
3,3,74,8,16,-8
3,3,75,3,10,-7
3,3,76,8,6,2
3,3,77,2,5,-3
3,3,78,6,9,-3
3,3,79,14,7,7
3,3,80,8,7,1
3,3,81,10,16,-6
3,3,82,11,16,-5
3,3,83,9,6,3
3,3,84,11,17,-6
3,3,85,18,6,12
3,3,86,8,15,-7
3,3,87,15,6,9
3,3,88,9,8,1
3,3,89,9,11,-2
3,3,90,8,6,2
3,3,91,10,10,0
3,3,92,9,21,-12
3,3,93,5,2,3
3,3,94,7,7,0
3,3,95,9,14,-5
3,3,96,14,6,8
3,3,97,9,11,-2
3,3,98,8,7,1
3,3,99,7,9,-2
3,3,100,9,18,-9
3,3,101,8,4,4
3,3,102,6,7,-1
3,3,103,13,19,-6
3,3,104,2,5,-3
3,3,105,22,11,11
3,3,106,7,7,0
3,3,107,10,20,-10
3,3,108,14,7,7
3,3,109,6,5,1
3,3,110,8,10,-2
3,3,111,0,1,-1
3,3,112,22,12,10
3,3,113,5,3,2
3,3,114,1,5,-4
3,3,115,12,13,-1
3,3,116,7,3,4
3,3,117,10,13,-3
3,3,118,15,23,-8
3,3,119,16,11,5
3,3,120,9,24,-15
3,3,121,16,11,5
3,3,122,17,12,5
3,3,123,14,16,-2
3,3,124,10,13,-3
3,3,125,8,4,4
3,3,126,8,14,-6
3,3,127,7,8,-1
3,3,128,5,7,-2
3,3,129,8,9,-1
3,3,130,10,6,4
3,3,131,9,11,-2
3,3,132,10,22,-12
3,3,133,3,6,-3
3,3,134,10,18,-8
3,3,135,10,11,-1
3,3,136,15,28,-13
3,3,137,11,10,1
3,3,138,24,9,15
3,3,139,20,6,14
3,3,140,4,4,0
3,3,141,12,6,6
3,3,142,12,13,-1
3,3,143,7,14,-7
3,3,144,11,11,0
3,3,145,12,10,2
3,3,146,6,14,-8
3,3,147,8,12,-4
3,3,148,12,23,-11
3,3,149,2,3,-1
3,3,150,11,6,5
3,3,151,19,7,12
3,3,152,11,5,6
3,3,153,4,9,-5
3,3,154,1,7,-6
3,3,155,16,9,7
3,3,156,18,8,10
3,3,157,7,4,3
3,3,158,15,18,-3
3,3,159,13,14,-1
3,3,160,4,7,-3
3,3,161,17,7,10
3,3,162,8,3,5
3,3,163,11,11,0
3,3,164,5,17,-12
3,3,165,8,4,4
3,3,166,7,13,-6
3,3,167,10,11,-1
3,3,168,9,11,-2
3,3,169,7,15,-8
3,3,170,7,18,-11
3,3,171,13,4,9
3,3,172,7,7,0
3,3,173,3,8,-5
3,3,174,6,10,-4
3,3,175,12,19,-7
3,3,176,10,23,-13
3,3,177,7,18,-11
3,3,178,10,1,9
3,3,179,1,19,-18
3,3,180,8,9,-1
3,3,181,6,7,-1
3,3,182,14,7,7
3,3,183,10,21,-11
3,3,184,2,2,0
3,3,185,17,12,5
3,3,186,4,14,-10
3,3,187,6,11,-5
3,3,188,5,1,4
3,3,189,2,11,-9
3,3,190,6,9,-3
3,3,191,9,7,2
3,3,192,5,10,-5
3,3,193,10,9,1
3,3,194,4,3,1
3,3,195,2,5,-3
3,3,196,15,18,-3
3,3,197,10,13,-3
3,3,198,4,6,-2
3,3,199,9,15,-6
3,3,200,8,3,5
3,3,201,19,5,14
3,3,202,6,13,-7
3,3,203,5,5,0
3,3,204,5,12,-7
3,3,205,9,6,3
3,3,206,5,13,-8
3,3,207,8,1,7
3,3,208,5,8,-3
3,3,209,11,11,0
3,3,210,17,7,10
3,3,211,16,15,1
3,3,212,5,5,0
3,3,213,14,7,7
3,3,214,12,18,-6
3,3,215,17,16,1
3,3,216,9,2,7
3,3,217,8,15,-7
3,3,218,15,6,9
3,3,219,15,13,2
3,3,220,10,7,3
3,3,221,2,4,-2
3,3,222,8,15,-7
3,3,223,12,27,-15
3,3,224,4,14,-10
3,3,225,8,4,4
3,3,226,6,19,-13
3,3,227,13,10,3
3,3,228,8,8,0
3,3,229,8,8,0
3,3,230,3,6,-3
3,3,231,7,8,-1
3,3,232,6,13,-7
3,3,233,13,10,3
3,3,234,9,14,-5
3,3,235,8,13,-5
3,3,236,7,9,-2
3,3,237,10,7,3
3,3,238,5,8,-3
3,3,239,4,8,-4
3,3,240,17,13,4
3,3,241,11,8,3
3,3,242,3,3,0
3,3,243,8,15,-7
3,3,244,15,12,3
3,3,245,7,10,-3
3,3,246,4,8,-4
3,3,247,12,14,-2
3,3,248,9,4,5
3,3,249,12,13,-1
3,3,250,13,9,4
3,3,251,14,15,-1
3,3,252,8,9,-1
3,3,253,3,7,-4
3,3,254,5,10,-5
3,3,255,6,19,-13
3,3,256,8,17,-9
3,3,257,12,20,-8
3,3,258,13,10,3
3,3,259,10,9,1
3,3,260,9,10,-1
3,3,261,10,8,2
3,3,262,5,6,-1
3,3,263,4,6,-2
3,3,264,6,4,2
3,3,265,7,5,2
3,3,266,4,7,-3
3,3,267,7,6,1
3,3,268,2,3,-1
3,3,269,11,8,3
3,3,270,9,15,-6
3,3,271,6,1,5
3,3,272,7,12,-5
3,3,273,24,14,10
3,3,274,7,3,4
3,3,275,9,21,-12
3,3,276,4,10,-6
3,3,277,5,10,-5
3,3,278,4,5,-1
3,3,279,4,9,-5
3,3,280,1,2,-1
3,3,281,10,9,1
3,3,282,7,10,-3
3,3,283,8,5,3
3,3,284,7,12,-5
3,3,285,12,9,3
3,3,286,6,7,-1
3,3,287,7,0,7
3,3,288,19,12,7
3,3,289,6,5,1
3,3,290,17,16,1
3,3,291,8,11,-3
3,3,292,18,9,9
3,3,293,8,15,-7
3,3,294,9,10,-1
3,3,295,7,6,1
3,3,296,8,16,-8
3,3,297,6,12,-6
3,3,298,0,3,-3
3,3,299,14,9,5
4,4,0,9,7,2
4,4,1,7,9,-2
4,4,2,13,14,-1
4,4,3,13,12,1
4,4,4,8,7,1
4,4,5,15,2,13
4,4,6,8,8,0
4,4,7,7,8,-1
4,4,8,13,21,-8
4,4,9,6,7,-1
4,4,10,6,8,-2
4,4,11,26,17,9
4,4,12,3,3,0
4,4,13,9,15,-6
4,4,14,20,15,5
4,4,15,31,10,21
4,4,16,8,12,-4
4,4,17,6,5,1
4,4,18,6,9,-3
4,4,19,9,6,3
4,4,20,18,25,-7
4,4,21,18,13,5
4,4,22,8,14,-6
4,4,23,11,17,-6
4,4,24,7,9,-2
4,4,25,10,20,-10
4,4,26,26,18,8
4,4,27,15,12,3
4,4,28,14,9,5
4,4,29,19,20,-1
4,4,30,12,11,1
4,4,31,7,7,0
4,4,32,6,13,-7
4,4,33,14,16,-2
4,4,34,10,5,5
4,4,35,14,22,-8
4,4,36,7,9,-2
4,4,37,6,15,-9
4,4,38,10,6,4
4,4,39,17,14,3
4,4,40,9,9,0
4,4,41,13,3,10
4,4,42,15,20,-5
4,4,43,11,18,-7
4,4,44,4,9,-5
4,4,45,13,9,4
4,4,46,18,16,2
4,4,47,8,14,-6
4,4,48,10,9,1
4,4,49,1,7,-6
4,4,50,24,11,13
4,4,51,5,5,0
4,4,52,1,4,-3
4,4,53,6,7,-1
4,4,54,14,11,3
4,4,55,18,6,12
4,4,56,14,9,5
4,4,57,13,16,-3
4,4,58,17,20,-3
4,4,59,14,10,4
4,4,60,17,16,1
4,4,61,7,12,-5
4,4,62,6,4,2
4,4,63,15,14,1
4,4,64,8,11,-3
4,4,65,11,16,-5
4,4,66,7,9,-2
4,4,67,4,7,-3
4,4,68,14,13,1
4,4,69,6,11,-5
4,4,70,6,10,-4
4,4,71,17,12,5
4,4,72,12,13,-1
4,4,73,7,8,-1
4,4,74,20,20,0
4,4,75,17,4,13
4,4,76,17,19,-2
4,4,77,11,6,5
4,4,78,15,18,-3
4,4,79,21,10,11
4,4,80,11,9,2
4,4,81,4,4,0
4,4,82,13,19,-6
4,4,83,16,17,-1
4,4,84,9,12,-3
4,4,85,6,4,2
4,4,86,7,11,-4
4,4,87,7,10,-3
4,4,88,9,8,1
4,4,89,17,9,8
4,4,90,19,16,3
4,4,91,23,19,4
4,4,92,24,23,1
4,4,93,6,10,-4
4,4,94,7,5,2
4,4,95,8,5,3
4,4,96,10,6,4
4,4,97,11,12,-1
4,4,98,10,11,-1
4,4,99,13,20,-7
4,4,100,8,5,3
4,4,101,13,20,-7
4,4,102,14,18,-4
4,4,103,22,18,4
4,4,104,11,11,0
4,4,105,19,20,-1
4,4,106,16,21,-5
4,4,107,6,4,2
4,4,108,13,15,-2
4,4,109,7,14,-7
4,4,110,7,10,-3
4,4,111,3,4,-1
4,4,112,8,13,-5
4,4,113,9,5,4
4,4,114,9,23,-14
4,4,115,14,6,8
4,4,116,25,21,4
4,4,117,10,13,-3
4,4,118,11,14,-3
4,4,119,18,14,4
4,4,120,9,14,-5
4,4,121,11,21,-10
4,4,122,8,20,-12
4,4,123,12,6,6
4,4,124,21,6,15
4,4,125,11,14,-3
4,4,126,3,14,-11
4,4,127,5,10,-5
4,4,128,8,9,-1
4,4,129,8,21,-13
4,4,130,21,14,7
4,4,131,19,11,8
4,4,132,6,10,-4
4,4,133,19,14,5
4,4,134,9,3,6
4,4,135,13,32,-19
4,4,136,12,8,4
4,4,137,13,6,7
4,4,138,14,2,12
4,4,139,12,18,-6
4,4,140,8,14,-6
4,4,141,13,10,3
4,4,142,11,6,5
4,4,143,21,7,14
4,4,144,13,25,-12
4,4,145,8,8,0
4,4,146,14,10,4
4,4,147,4,5,-1
4,4,148,15,14,1
4,4,149,20,18,2
4,4,150,13,10,3
4,4,151,13,6,7
4,4,152,8,14,-6
4,4,153,11,7,4
4,4,154,4,7,-3
4,4,155,6,8,-2
4,4,156,9,14,-5
4,4,157,6,14,-8
4,4,158,11,18,-7
4,4,159,10,21,-11
4,4,160,7,23,-16
4,4,161,4,10,-6
4,4,162,4,15,-11
4,4,163,5,20,-15
4,4,164,24,10,14
4,4,165,9,14,-5
4,4,166,3,8,-5
4,4,167,8,10,-2
4,4,168,10,15,-5
4,4,169,4,9,-5
4,4,170,16,9,7
4,4,171,1,10,-9
4,4,172,14,10,4
4,4,173,8,17,-9
4,4,174,9,5,4
4,4,175,3,8,-5
4,4,176,9,26,-17
4,4,177,10,3,7
4,4,178,11,25,-14
4,4,179,5,12,-7
4,4,180,30,9,21
4,4,181,7,6,1
4,4,182,14,19,-5
4,4,183,8,6,2
4,4,184,7,9,-2
4,4,185,9,16,-7
4,4,186,18,17,1
4,4,187,14,10,4
4,4,188,11,11,0
4,4,189,9,14,-5
4,4,190,5,3,2
4,4,191,13,13,0
4,4,192,10,5,5
4,4,193,2,3,-1
4,4,194,11,12,-1
4,4,195,26,28,-2
4,4,196,10,21,-11
4,4,197,16,23,-7
4,4,198,6,9,-3
4,4,199,7,18,-11
4,4,200,19,10,9
4,4,201,8,12,-4
4,4,202,7,10,-3
4,4,203,6,6,0
4,4,204,8,13,-5
4,4,205,16,2,14
4,4,206,8,2,6
4,4,207,16,5,11
4,4,208,3,4,-1
4,4,209,9,10,-1
4,4,210,16,17,-1
4,4,211,10,7,3
4,4,212,8,14,-6
4,4,213,16,19,-3
4,4,214,13,9,4
4,4,215,15,15,0
4,4,216,2,10,-8
4,4,217,13,11,2
4,4,218,10,17,-7
4,4,219,6,14,-8
4,4,220,4,30,-26
4,4,221,7,16,-9
4,4,222,4,9,-5
4,4,223,11,6,5
4,4,224,10,23,-13
4,4,225,7,13,-6
4,4,226,5,9,-4
4,4,227,18,9,9
4,4,228,13,23,-10
4,4,229,10,11,-1
4,4,230,6,8,-2
4,4,231,6,18,-12
4,4,232,10,22,-12
4,4,233,7,6,1
4,4,234,12,24,-12
4,4,235,6,8,-2
4,4,236,2,7,-5
4,4,237,7,4,3
4,4,238,11,17,-6
4,4,239,13,12,1
4,4,240,10,8,2
4,4,241,4,11,-7
4,4,242,12,11,1
4,4,243,15,15,0
4,4,244,9,8,1
4,4,245,10,6,4
4,4,246,9,5,4
4,4,247,20,8,12
4,4,248,10,11,-1
4,4,249,9,11,-2
4,4,250,8,8,0
4,4,251,10,17,-7
4,4,252,15,15,0
4,4,253,13,8,5
4,4,254,12,10,2
4,4,255,10,5,5
4,4,256,3,8,-5
4,4,257,10,14,-4
4,4,258,1,2,-1
4,4,259,3,6,-3
4,4,260,7,13,-6
4,4,261,9,13,-4
4,4,262,20,8,12
4,4,263,6,8,-2
4,4,264,13,10,3
4,4,265,3,10,-7
4,4,266,10,5,5
4,4,267,7,8,-1
4,4,268,8,4,4
4,4,269,11,17,-6
4,4,270,22,20,2
4,4,271,8,11,-3
4,4,272,14,15,-1
4,4,273,12,17,-5
4,4,274,6,13,-7
4,4,275,20,16,4
4,4,276,14,17,-3
4,4,277,8,18,-10
4,4,278,11,12,-1
4,4,279,7,9,-2
4,4,280,24,17,7
4,4,281,5,21,-16
4,4,282,9,13,-4
4,4,283,11,5,6
4,4,284,20,17,3
4,4,285,14,19,-5
4,4,286,22,9,13
4,4,287,6,12,-6
4,4,288,3,8,-5
4,4,289,21,9,12
4,4,290,18,16,2
4,4,291,9,13,-4
4,4,292,15,18,-3
4,4,293,10,12,-2
4,4,294,11,7,4
4,4,295,6,3,3
4,4,296,20,13,7
4,4,297,9,10,-1
4,4,298,4,12,-8
4,4,299,8,6,2
5,5,0,5,4,1
5,5,1,24,20,4
5,5,2,8,15,-7
5,5,3,18,9,9
5,5,4,9,3,6
5,5,5,2,6,-4
5,5,6,12,8,4
5,5,7,6,17,-11
5,5,8,16,10,6
5,5,9,9,19,-10
5,5,10,12,7,5
5,5,11,11,8,3
5,5,12,5,7,-2
5,5,13,13,10,3
5,5,14,13,13,0
5,5,15,8,15,-7
5,5,16,5,8,-3
5,5,17,13,3,10
5,5,18,7,19,-12
5,5,19,10,12,-2
5,5,20,14,23,-9
5,5,21,4,4,0
5,5,22,21,19,2
5,5,23,15,12,3
5,5,24,26,20,6
5,5,25,19,18,1
5,5,26,15,12,3
5,5,27,5,12,-7
5,5,28,12,8,4
5,5,29,5,13,-8
5,5,30,10,14,-4
5,5,31,2,7,-5
5,5,32,13,19,-6
5,5,33,8,16,-8
5,5,34,25,16,9
5,5,35,11,26,-15
5,5,36,27,19,8
5,5,37,2,3,-1
5,5,38,12,16,-4
5,5,39,15,6,9
5,5,40,19,12,7
5,5,41,4,13,-9
5,5,42,15,14,1
5,5,43,23,18,5
5,5,44,14,10,4
5,5,45,5,12,-7
5,5,46,13,12,1
5,5,47,1,13,-12
5,5,48,6,18,-12
5,5,49,13,4,9
5,5,50,20,16,4
5,5,51,12,14,-2
5,5,52,17,8,9
5,5,53,1,6,-5
5,5,54,7,24,-17
5,5,55,19,8,11
5,5,56,25,18,7
5,5,57,7,20,-13
5,5,58,9,24,-15
5,5,59,12,15,-3
5,5,60,18,14,4
5,5,61,9,11,-2
5,5,62,9,19,-10
5,5,63,11,11,0
5,5,64,7,16,-9
5,5,65,9,14,-5
5,5,66,9,6,3
5,5,67,8,12,-4
5,5,68,9,20,-11
5,5,69,7,6,1
5,5,70,17,15,2
5,5,71,8,3,5
5,5,72,17,13,4
5,5,73,12,15,-3
5,5,74,7,8,-1
5,5,75,16,29,-13
5,5,76,8,15,-7
5,5,77,13,17,-4
5,5,78,10,13,-3
5,5,79,11,18,-7
5,5,80,3,8,-5
5,5,81,15,13,2
5,5,82,15,23,-8
5,5,83,16,18,-2
5,5,84,3,9,-6
5,5,85,7,12,-5
5,5,86,14,8,6
5,5,87,13,19,-6
5,5,88,19,30,-11
5,5,89,14,10,4
5,5,90,19,14,5
5,5,91,12,22,-10
5,5,92,10,9,1
5,5,93,10,25,-15
5,5,94,17,9,8
5,5,95,10,8,2
5,5,96,9,24,-15
5,5,97,10,23,-13
5,5,98,9,19,-10
5,5,99,9,11,-2
5,5,100,14,7,7
5,5,101,4,13,-9
5,5,102,10,7,3
5,5,103,11,15,-4
5,5,104,12,10,2
5,5,105,15,15,0
5,5,106,14,4,10
5,5,107,12,18,-6
5,5,108,13,5,8
5,5,109,12,11,1
5,5,110,12,17,-5
5,5,111,7,3,4
5,5,112,10,20,-10
5,5,113,7,19,-12
5,5,114,17,18,-1
5,5,115,18,21,-3
5,5,116,8,10,-2
5,5,117,12,10,2
5,5,118,18,21,-3
5,5,119,9,16,-7
5,5,120,12,12,0
5,5,121,18,22,-4
5,5,122,6,3,3
5,5,123,10,10,0
5,5,124,12,8,4
5,5,125,17,12,5
5,5,126,8,10,-2
5,5,127,9,13,-4
5,5,128,15,9,6
5,5,129,8,5,3
5,5,130,3,10,-7
5,5,131,1,6,-5
5,5,132,8,11,-3
5,5,133,13,15,-2
5,5,134,14,8,6
5,5,135,11,16,-5
5,5,136,10,16,-6
5,5,137,7,12,-5
5,5,138,6,12,-6
5,5,139,5,15,-10
5,5,140,11,10,1
5,5,141,8,11,-3
5,5,142,14,17,-3
5,5,143,9,16,-7
5,5,144,14,11,3
5,5,145,10,7,3
5,5,146,7,15,-8
5,5,147,15,28,-13
5,5,148,17,7,10
5,5,149,10,5,5
5,5,150,12,11,1
5,5,151,8,7,1
5,5,152,6,21,-15
5,5,153,17,12,5
5,5,154,8,9,-1
5,5,155,13,16,-3
5,5,156,17,11,6
5,5,157,9,13,-4
5,5,158,14,14,0
5,5,159,21,20,1
5,5,160,11,6,5
5,5,161,16,20,-4
5,5,162,17,8,9
5,5,163,10,8,2
5,5,164,6,5,1
5,5,165,9,26,-17
5,5,166,12,19,-7
5,5,167,11,18,-7
5,5,168,7,16,-9
5,5,169,18,13,5
5,5,170,10,13,-3
5,5,171,11,16,-5
5,5,172,6,17,-11
5,5,173,5,12,-7
5,5,174,12,6,6
5,5,175,6,8,-2
5,5,176,15,17,-2
5,5,177,22,7,15
5,5,178,24,14,10
5,5,179,2,11,-9
5,5,180,16,20,-4
5,5,181,15,18,-3
5,5,182,9,8,1
5,5,183,19,13,6
5,5,184,28,4,24
5,5,185,13,25,-12
5,5,186,16,22,-6
5,5,187,15,22,-7
5,5,188,13,12,1
5,5,189,13,15,-2
5,5,190,6,14,-8
5,5,191,7,12,-5
5,5,192,11,17,-6
5,5,193,11,19,-8
5,5,194,3,3,0
5,5,195,15,23,-8
5,5,196,10,8,2
5,5,197,11,12,-1
5,5,198,9,16,-7
5,5,199,14,19,-5
5,5,200,9,3,6
5,5,201,12,15,-3
5,5,202,15,20,-5
5,5,203,7,9,-2
5,5,204,7,4,3
5,5,205,10,7,3
5,5,206,19,6,13
5,5,207,12,6,6
5,5,208,8,8,0
5,5,209,14,25,-11
5,5,210,12,8,4
5,5,211,14,15,-1
5,5,212,12,18,-6
5,5,213,9,13,-4
5,5,214,10,20,-10
5,5,215,10,11,-1
5,5,216,7,13,-6
5,5,217,10,4,6
5,5,218,10,13,-3
5,5,219,2,8,-6
5,5,220,13,10,3
5,5,221,4,10,-6
5,5,222,17,12,5
5,5,223,5,13,-8
5,5,224,15,21,-6
5,5,225,15,15,0
5,5,226,12,8,4
5,5,227,19,32,-13
5,5,228,13,15,-2
5,5,229,3,7,-4
5,5,230,15,15,0
5,5,231,18,18,0
5,5,232,9,9,0
5,5,233,15,22,-7
5,5,234,12,15,-3
5,5,235,25,17,8
5,5,236,13,8,5
5,5,237,11,21,-10
5,5,238,10,15,-5
5,5,239,6,9,-3
5,5,240,12,11,1
5,5,241,8,14,-6
5,5,242,13,22,-9
5,5,243,10,4,6
5,5,244,15,19,-4
5,5,245,18,7,11
5,5,246,17,12,5
5,5,247,34,12,22
5,5,248,7,19,-12
5,5,249,8,5,3
5,5,250,8,13,-5
5,5,251,20,7,13
5,5,252,4,7,-3
5,5,253,17,30,-13
5,5,254,8,12,-4
5,5,255,11,33,-22
5,5,256,7,10,-3
5,5,257,13,10,3
5,5,258,9,1,8
5,5,259,1,3,-2
5,5,260,13,7,6
5,5,261,15,17,-2
5,5,262,20,14,6
5,5,263,12,8,4
5,5,264,11,18,-7
5,5,265,14,23,-9
5,5,266,14,9,5
5,5,267,9,14,-5
5,5,268,24,15,9
5,5,269,15,25,-10
5,5,270,19,12,7
5,5,271,12,6,6
5,5,272,11,15,-4
5,5,273,12,12,0
5,5,274,14,12,2
5,5,275,6,10,-4
5,5,276,9,16,-7
5,5,277,7,6,1
5,5,278,7,20,-13
5,5,279,6,8,-2
5,5,280,16,9,7
5,5,281,7,8,-1
5,5,282,9,17,-8
5,5,283,21,20,1
5,5,284,12,10,2
5,5,285,13,11,2
5,5,286,8,17,-9
5,5,287,7,14,-7
5,5,288,9,16,-7
5,5,289,24,11,13
5,5,290,26,17,9
5,5,291,15,16,-1
5,5,292,15,11,4
5,5,293,10,14,-4
5,5,294,16,22,-6
5,5,295,12,18,-6
5,5,296,13,25,-12
5,5,297,19,15,4
5,5,298,16,11,5
5,5,299,12,16,-4
6,6,0,12,5,7
6,6,1,11,12,-1
6,6,2,11,16,-5
6,6,3,11,15,-4
6,6,4,7,17,-10
6,6,5,10,11,-1
6,6,6,28,14,14
6,6,7,4,12,-8
6,6,8,13,16,-3
6,6,9,10,11,-1
6,6,10,7,8,-1
6,6,11,7,7,0
6,6,12,27,22,5
6,6,13,14,10,4
6,6,14,11,6,5
6,6,15,21,15,6
6,6,16,10,18,-8
6,6,17,7,23,-16
6,6,18,19,11,8
6,6,19,17,12,5
6,6,20,14,19,-5
6,6,21,10,12,-2
6,6,22,22,15,7
6,6,23,12,15,-3
6,6,24,16,11,5
6,6,25,15,21,-6
6,6,26,14,11,3
6,6,27,15,27,-12
6,6,28,5,14,-9
6,6,29,13,11,2
6,6,30,7,10,-3
6,6,31,17,20,-3
6,6,32,15,11,4
6,6,33,8,8,0
6,6,34,17,13,4
6,6,35,21,19,2
6,6,36,17,26,-9
6,6,37,17,13,4
6,6,38,14,11,3
6,6,39,5,9,-4
6,6,40,12,10,2
6,6,41,10,12,-2
6,6,42,14,12,2
6,6,43,30,10,20
6,6,44,12,20,-8
6,6,45,13,26,-13
6,6,46,20,11,9
6,6,47,16,13,3
6,6,48,11,3,8
6,6,49,8,13,-5
6,6,50,7,24,-17
6,6,51,9,20,-11
6,6,52,12,15,-3
6,6,53,10,20,-10
6,6,54,12,14,-2
6,6,55,13,23,-10
6,6,56,11,20,-9
6,6,57,4,7,-3
6,6,58,10,28,-18
6,6,59,15,18,-3
6,6,60,3,12,-9
6,6,61,16,10,6
6,6,62,12,14,-2
6,6,63,19,26,-7
6,6,64,7,11,-4
6,6,65,19,12,7
6,6,66,4,13,-9
6,6,67,19,21,-2
6,6,68,8,33,-25
6,6,69,9,14,-5
6,6,70,10,11,-1
6,6,71,12,9,3
6,6,72,10,19,-9
6,6,73,10,9,1
6,6,74,6,0,6
6,6,75,22,21,1
6,6,76,5,11,-6
6,6,77,10,20,-10
6,6,78,18,29,-11
6,6,79,25,16,9
6,6,80,15,3,12
6,6,81,5,14,-9
6,6,82,12,9,3
6,6,83,3,9,-6
6,6,84,10,11,-1
6,6,85,15,15,0
6,6,86,10,8,2
6,6,87,12,6,6
6,6,88,13,18,-5
6,6,89,17,21,-4
6,6,90,14,18,-4
6,6,91,6,9,-3
6,6,92,10,3,7
6,6,93,7,22,-15
6,6,94,17,8,9
6,6,95,16,13,3
6,6,96,6,5,1
6,6,97,11,11,0
6,6,98,19,16,3
6,6,99,8,8,0
6,6,100,14,10,4
6,6,101,8,7,1
6,6,102,12,5,7
6,6,103,7,27,-20
6,6,104,21,20,1
6,6,105,3,17,-14
6,6,106,20,16,4
6,6,107,10,6,4
6,6,108,15,15,0
6,6,109,17,28,-11
6,6,110,16,22,-6
6,6,111,14,13,1
6,6,112,10,13,-3
6,6,113,20,10,10
6,6,114,4,20,-16
6,6,115,18,11,7
6,6,116,12,13,-1
6,6,117,8,13,-5
6,6,118,16,31,-15
6,6,119,9,8,1
6,6,120,14,9,5
6,6,121,15,37,-22
6,6,122,12,10,2
6,6,123,9,6,3
6,6,124,10,12,-2
6,6,125,23,14,9
6,6,126,10,6,4
6,6,127,21,28,-7
6,6,128,3,10,-7
6,6,129,18,8,10
6,6,130,10,19,-9
6,6,131,8,8,0
6,6,132,13,14,-1
6,6,133,10,9,1
6,6,134,15,20,-5
6,6,135,14,8,6
6,6,136,14,17,-3
6,6,137,10,8,2
6,6,138,13,21,-8
6,6,139,9,14,-5
6,6,140,12,17,-5
6,6,141,13,12,1
6,6,142,14,16,-2
6,6,143,14,21,-7
6,6,144,12,17,-5
6,6,145,11,7,4
6,6,146,17,12,5
6,6,147,28,17,11
6,6,148,6,29,-23
6,6,149,5,13,-8
6,6,150,21,17,4
6,6,151,15,9,6
6,6,152,14,8,6
6,6,153,19,19,0
6,6,154,17,17,0
6,6,155,6,8,-2
6,6,156,29,21,8
6,6,157,9,9,0
6,6,158,15,13,2
6,6,159,9,26,-17
6,6,160,21,9,12
6,6,161,4,11,-7
6,6,162,16,8,8
6,6,163,16,17,-1
6,6,164,16,14,2
6,6,165,11,9,2
6,6,166,1,11,-10
6,6,167,12,17,-5
6,6,168,9,8,1
6,6,169,20,22,-2
6,6,170,7,17,-10
6,6,171,11,20,-9
6,6,172,14,32,-18
6,6,173,21,14,7
6,6,174,5,13,-8
6,6,175,7,7,0
6,6,176,22,14,8
6,6,177,20,23,-3
6,6,178,12,9,3
6,6,179,11,10,1
6,6,180,12,23,-11
6,6,181,14,11,3
6,6,182,15,23,-8
6,6,183,18,24,-6
6,6,184,5,6,-1
6,6,185,5,10,-5
6,6,186,18,10,8
6,6,187,17,18,-1
6,6,188,19,24,-5
6,6,189,7,7,0
6,6,190,10,12,-2
6,6,191,12,18,-6
6,6,192,16,20,-4
6,6,193,16,15,1
6,6,194,13,3,10
6,6,195,5,9,-4
6,6,196,9,17,-8
6,6,197,7,25,-18
6,6,198,32,25,7
6,6,199,12,10,2
6,6,200,32,21,11
6,6,201,13,10,3
6,6,202,12,20,-8
6,6,203,10,14,-4
6,6,204,6,16,-10
6,6,205,13,12,1
6,6,206,15,19,-4
6,6,207,22,16,6
6,6,208,15,20,-5
6,6,209,10,21,-11
6,6,210,19,19,0
6,6,211,3,7,-4
6,6,212,14,18,-4
6,6,213,12,8,4
6,6,214,11,11,0
6,6,215,3,9,-6
6,6,216,10,11,-1
6,6,217,9,13,-4
6,6,218,7,7,0
6,6,219,11,12,-1
6,6,220,13,7,6
6,6,221,9,5,4
6,6,222,9,18,-9
6,6,223,22,15,7
6,6,224,16,16,0
6,6,225,10,13,-3
6,6,226,12,6,6
6,6,227,29,17,12
6,6,228,14,11,3
6,6,229,26,20,6
6,6,230,10,18,-8
6,6,231,20,22,-2
6,6,232,16,17,-1
6,6,233,6,16,-10
6,6,234,12,23,-11
6,6,235,22,13,9
6,6,236,10,7,3
6,6,237,25,20,5
6,6,238,9,9,0
6,6,239,7,7,0
6,6,240,22,16,6
6,6,241,12,15,-3
6,6,242,13,21,-8
6,6,243,7,12,-5
6,6,244,15,9,6
6,6,245,1,8,-7
6,6,246,10,7,3
6,6,247,16,16,0
6,6,248,3,5,-2
6,6,249,12,9,3
6,6,250,5,10,-5
6,6,251,16,18,-2
6,6,252,12,11,1
6,6,253,14,15,-1
6,6,254,11,16,-5
6,6,255,16,21,-5
6,6,256,12,25,-13
6,6,257,17,15,2
6,6,258,25,12,13
6,6,259,10,7,3
6,6,260,3,11,-8
6,6,261,10,17,-7
6,6,262,5,12,-7
6,6,263,9,11,-2
6,6,264,10,15,-5
6,6,265,15,10,5
6,6,266,16,4,12
6,6,267,23,15,8
6,6,268,14,13,1
6,6,269,7,23,-16
6,6,270,30,14,16
6,6,271,15,16,-1
6,6,272,13,26,-13
6,6,273,17,13,4
6,6,274,9,7,2
6,6,275,14,10,4
6,6,276,14,18,-4
6,6,277,8,10,-2
6,6,278,11,10,1
6,6,279,7,12,-5
6,6,280,12,10,2
6,6,281,15,15,0
6,6,282,18,12,6
6,6,283,3,11,-8
6,6,284,18,11,7
6,6,285,6,13,-7
6,6,286,16,13,3
6,6,287,23,13,10
6,6,288,7,14,-7
6,6,289,8,4,4
6,6,290,14,8,6
6,6,291,13,10,3
6,6,292,8,15,-7
6,6,293,19,13,6
6,6,294,10,14,-4
6,6,295,27,13,14
6,6,296,18,15,3
6,6,297,9,9,0
6,6,298,21,40,-19
6,6,299,10,9,1
7,7,0,11,17,-6
7,7,1,22,13,9
7,7,2,10,11,-1
7,7,3,14,14,0
7,7,4,16,11,5
7,7,5,24,42,-18
7,7,6,17,21,-4
7,7,7,12,20,-8
7,7,8,13,9,4
7,7,9,14,11,3
7,7,10,12,11,1
7,7,11,14,5,9
7,7,12,13,17,-4
7,7,13,5,11,-6
7,7,14,18,13,5
7,7,15,15,7,8
7,7,16,21,19,2
7,7,17,12,23,-11
7,7,18,8,15,-7
7,7,19,20,17,3
7,7,20,11,10,1
7,7,21,12,12,0
7,7,22,10,10,0
7,7,23,12,12,0
7,7,24,19,14,5
7,7,25,13,20,-7
7,7,26,17,13,4
7,7,27,17,12,5
7,7,28,23,16,7
7,7,29,8,2,6
7,7,30,10,17,-7
7,7,31,15,29,-14
7,7,32,10,14,-4
7,7,33,18,8,10
7,7,34,15,16,-1
7,7,35,11,17,-6
7,7,36,9,19,-10
7,7,37,10,20,-10
7,7,38,22,16,6
7,7,39,8,14,-6
7,7,40,20,17,3
7,7,41,12,10,2
7,7,42,17,11,6
7,7,43,17,16,1
7,7,44,13,18,-5
7,7,45,10,4,6
7,7,46,11,6,5
7,7,47,21,19,2
7,7,48,21,13,8
7,7,49,4,17,-13
7,7,50,7,10,-3
7,7,51,13,13,0
7,7,52,13,9,4
7,7,53,11,11,0
7,7,54,12,20,-8
7,7,55,13,6,7
7,7,56,6,18,-12
7,7,57,13,15,-2
7,7,58,12,19,-7
7,7,59,20,16,4
7,7,60,13,21,-8
7,7,61,8,13,-5
7,7,62,8,12,-4
7,7,63,14,27,-13
7,7,64,9,11,-2
7,7,65,9,18,-9
7,7,66,11,12,-1
7,7,67,19,13,6
7,7,68,7,11,-4
7,7,69,23,15,8
7,7,70,10,13,-3
7,7,71,13,19,-6
7,7,72,8,11,-3
7,7,73,10,14,-4
7,7,74,23,30,-7
7,7,75,13,12,1
7,7,76,18,24,-6
7,7,77,10,17,-7
7,7,78,19,14,5
7,7,79,14,9,5
7,7,80,17,10,7
7,7,81,6,14,-8
7,7,82,15,15,0
7,7,83,13,17,-4
7,7,84,29,16,13
7,7,85,10,29,-19
7,7,86,17,13,4
7,7,87,21,20,1
7,7,88,20,17,3
7,7,89,11,25,-14
7,7,90,16,14,2
7,7,91,18,15,3
7,7,92,11,14,-3
7,7,93,16,19,-3
7,7,94,22,21,1
7,7,95,14,18,-4
7,7,96,12,11,1
7,7,97,29,29,0
7,7,98,9,12,-3
7,7,99,10,12,-2
7,7,100,8,14,-6
7,7,101,19,27,-8
7,7,102,21,14,7
7,7,103,22,19,3
7,7,104,3,8,-5
7,7,105,17,14,3
7,7,106,5,20,-15
7,7,107,18,10,8
7,7,108,3,7,-4
7,7,109,16,19,-3
7,7,110,14,13,1
7,7,111,17,15,2
7,7,112,18,8,10
7,7,113,15,12,3
7,7,114,7,4,3
7,7,115,13,5,8
7,7,116,19,18,1
7,7,117,5,8,-3
7,7,118,11,12,-1
7,7,119,18,23,-5
7,7,120,11,14,-3
7,7,121,18,17,1
7,7,122,11,15,-4
7,7,123,22,10,12
7,7,124,9,6,3
7,7,125,13,20,-7
7,7,126,4,12,-8
7,7,127,11,11,0
7,7,128,10,13,-3
7,7,129,16,15,1
7,7,130,12,10,2
7,7,131,6,3,3
7,7,132,17,14,3
7,7,133,18,15,3
7,7,134,9,17,-8
7,7,135,6,7,-1
7,7,136,12,15,-3
7,7,137,18,9,9
7,7,138,10,26,-16
7,7,139,8,10,-2
7,7,140,5,6,-1
7,7,141,19,17,2
7,7,142,5,6,-1
7,7,143,20,17,3
7,7,144,7,9,-2
7,7,145,13,9,4
7,7,146,16,12,4
7,7,147,18,17,1
7,7,148,8,14,-6
7,7,149,11,11,0
7,7,150,13,8,5
7,7,151,12,14,-2
7,7,152,12,17,-5
7,7,153,15,9,6
7,7,154,10,18,-8
7,7,155,22,27,-5
7,7,156,22,18,4
7,7,157,10,19,-9
7,7,158,19,17,2
7,7,159,6,8,-2
7,7,160,22,20,2
7,7,161,19,18,1
7,7,162,12,11,1
7,7,163,29,17,12
7,7,164,19,11,8
7,7,165,12,17,-5
7,7,166,14,12,2
7,7,167,16,34,-18
7,7,168,7,16,-9
7,7,169,21,13,8
7,7,170,16,20,-4
7,7,171,17,12,5
7,7,172,11,18,-7
7,7,173,16,13,3
7,7,174,9,7,2
7,7,175,11,9,2
7,7,176,8,13,-5
7,7,177,6,12,-6
7,7,178,24,24,0
7,7,179,17,15,2
7,7,180,14,20,-6
7,7,181,11,13,-2
7,7,182,17,16,1
7,7,183,13,28,-15
7,7,184,15,11,4
7,7,185,9,6,3
7,7,186,22,20,2
7,7,187,21,18,3
7,7,188,17,12,5
7,7,189,23,18,5
7,7,190,10,15,-5
7,7,191,19,11,8
7,7,192,13,7,6
7,7,193,11,18,-7
7,7,194,13,8,5
7,7,195,11,18,-7
7,7,196,7,9,-2
7,7,197,8,3,5
7,7,198,28,22,6
7,7,199,12,30,-18
7,7,200,13,16,-3
7,7,201,7,11,-4
7,7,202,26,25,1
7,7,203,16,19,-3
7,7,204,6,24,-18
7,7,205,21,22,-1
7,7,206,11,21,-10
7,7,207,24,14,10
7,7,208,14,19,-5
7,7,209,17,18,-1
7,7,210,19,12,7
7,7,211,11,8,3
7,7,212,15,9,6
7,7,213,4,12,-8
7,7,214,6,10,-4
7,7,215,12,13,-1
7,7,216,11,10,1
7,7,217,12,8,4
7,7,218,17,16,1
7,7,219,9,12,-3
7,7,220,29,22,7
7,7,221,18,22,-4
7,7,222,20,20,0
7,7,223,4,9,-5
7,7,224,12,20,-8
7,7,225,17,5,12
7,7,226,8,20,-12
7,7,227,27,16,11
7,7,228,17,10,7
7,7,229,12,20,-8
7,7,230,6,11,-5
7,7,231,15,12,3
7,7,232,4,5,-1
7,7,233,12,17,-5
7,7,234,15,11,4
7,7,235,16,22,-6
7,7,236,18,14,4
7,7,237,12,14,-2
7,7,238,11,22,-11
7,7,239,6,13,-7
7,7,240,8,13,-5
7,7,241,19,14,5
7,7,242,5,14,-9
7,7,243,12,14,-2
7,7,244,22,13,9
7,7,245,10,12,-2
7,7,246,13,25,-12
7,7,247,11,13,-2
7,7,248,17,21,-4
7,7,249,16,18,-2
7,7,250,8,16,-8
7,7,251,15,31,-16
7,7,252,16,20,-4
7,7,253,15,15,0
7,7,254,13,14,-1
7,7,255,21,21,0
7,7,256,17,17,0
7,7,257,9,16,-7
7,7,258,15,13,2
7,7,259,9,14,-5
7,7,260,23,18,5
7,7,261,9,7,2
7,7,262,11,22,-11
7,7,263,10,7,3
7,7,264,9,17,-8
7,7,265,8,7,1
7,7,266,17,17,0
7,7,267,21,22,-1
7,7,268,9,18,-9
7,7,269,6,14,-8
7,7,270,11,19,-8
7,7,271,6,16,-10
7,7,272,6,14,-8
7,7,273,16,25,-9
7,7,274,18,17,1
7,7,275,18,12,6
7,7,276,11,12,-1
7,7,277,11,24,-13
7,7,278,13,20,-7
7,7,279,9,10,-1
7,7,280,8,11,-3
7,7,281,6,15,-9
7,7,282,15,10,5
7,7,283,19,26,-7
7,7,284,17,26,-9
7,7,285,16,16,0
7,7,286,19,14,5
7,7,287,23,19,4
7,7,288,7,14,-7
7,7,289,18,24,-6
7,7,290,7,10,-3
7,7,291,18,15,3
7,7,292,12,8,4
7,7,293,13,2,11
7,7,294,21,21,0
7,7,295,20,31,-11
7,7,296,33,20,13
7,7,297,18,13,5
7,7,298,15,9,6
7,7,299,9,8,1
8,8,0,24,18,6
8,8,1,16,20,-4
8,8,2,14,20,-6
8,8,3,15,14,1
8,8,4,21,22,-1
8,8,5,12,23,-11
8,8,6,7,11,-4
8,8,7,25,17,8
8,8,8,17,28,-11
8,8,9,20,14,6
8,8,10,17,31,-14
8,8,11,9,19,-10
8,8,12,22,18,4
8,8,13,9,19,-10
8,8,14,10,22,-12
8,8,15,13,21,-8
8,8,16,14,10,4
8,8,17,8,12,-4
8,8,18,17,16,1
8,8,19,20,23,-3
8,8,20,11,11,0
8,8,21,8,6,2
8,8,22,15,16,-1
8,8,23,28,22,6
8,8,24,3,14,-11
8,8,25,29,18,11
8,8,26,15,17,-2
8,8,27,10,10,0
8,8,28,12,11,1
8,8,29,19,24,-5
8,8,30,14,17,-3
8,8,31,13,10,3
8,8,32,9,11,-2
8,8,33,19,17,2
8,8,34,16,4,12
8,8,35,18,9,9
8,8,36,14,14,0
8,8,37,14,14,0
8,8,38,1,7,-6
8,8,39,8,17,-9
8,8,40,14,14,0
8,8,41,20,16,4
8,8,42,17,16,1
8,8,43,18,30,-12
8,8,44,5,8,-3
8,8,45,14,18,-4
8,8,46,16,27,-11
8,8,47,18,21,-3
8,8,48,8,9,-1
8,8,49,19,28,-9
8,8,50,18,12,6
8,8,51,10,19,-9
8,8,52,9,21,-12
8,8,53,19,18,1
8,8,54,15,11,4
8,8,55,11,26,-15
8,8,56,7,11,-4
8,8,57,14,12,2
8,8,58,10,17,-7
8,8,59,18,16,2
8,8,60,10,18,-8
8,8,61,28,29,-1
8,8,62,22,21,1
8,8,63,11,16,-5
8,8,64,4,21,-17
8,8,65,17,8,9
8,8,66,17,17,0
8,8,67,16,16,0
8,8,68,11,15,-4
8,8,69,17,15,2
8,8,70,5,9,-4
8,8,71,8,11,-3
8,8,72,4,7,-3
8,8,73,23,12,11
8,8,74,11,30,-19
8,8,75,16,13,3
8,8,76,5,9,-4
8,8,77,26,15,11
8,8,78,26,18,8
8,8,79,14,13,1
8,8,80,11,16,-5
8,8,81,15,14,1
8,8,82,5,20,-15
8,8,83,26,23,3
8,8,84,20,17,3
8,8,85,10,25,-15
8,8,86,16,11,5
8,8,87,16,10,6
8,8,88,14,18,-4
8,8,89,17,11,6
8,8,90,12,18,-6
8,8,91,16,12,4
8,8,92,23,16,7
8,8,93,8,8,0
8,8,94,9,26,-17
8,8,95,14,12,2
8,8,96,8,13,-5
8,8,97,18,15,3
8,8,98,8,18,-10
8,8,99,13,11,2
8,8,100,6,7,-1
8,8,101,17,20,-3
8,8,102,26,20,6
8,8,103,11,26,-15
8,8,104,15,17,-2
8,8,105,23,21,2
8,8,106,18,27,-9
8,8,107,15,10,5
8,8,108,21,19,2
8,8,109,17,9,8
8,8,110,4,4,0
8,8,111,13,20,-7
8,8,112,16,17,-1
8,8,113,13,10,3
8,8,114,11,10,1
8,8,115,12,19,-7
8,8,116,13,25,-12
8,8,117,28,26,2
8,8,118,9,12,-3
8,8,119,8,4,4
8,8,120,26,17,9
8,8,121,15,28,-13
8,8,122,21,20,1
8,8,123,14,22,-8
8,8,124,15,12,3
8,8,125,17,15,2
8,8,126,14,17,-3
8,8,127,6,15,-9
8,8,128,15,15,0
8,8,129,5,9,-4
8,8,130,20,18,2
8,8,131,14,22,-8
8,8,132,3,8,-5
8,8,133,28,19,9
8,8,134,10,24,-14
8,8,135,14,6,8
8,8,136,18,20,-2
8,8,137,9,17,-8
8,8,138,12,19,-7
8,8,139,16,12,4
8,8,140,14,13,1
8,8,141,17,7,10
8,8,142,13,12,1
8,8,143,13,19,-6
8,8,144,20,36,-16
8,8,145,12,12,0
8,8,146,7,9,-2
8,8,147,8,17,-9
8,8,148,7,11,-4
8,8,149,12,8,4
8,8,150,25,7,18
8,8,151,13,28,-15
8,8,152,14,17,-3
8,8,153,19,22,-3
8,8,154,18,15,3
8,8,155,10,11,-1
8,8,156,12,11,1
8,8,157,15,32,-17
8,8,158,11,21,-10
8,8,159,17,31,-14
8,8,160,7,8,-1
8,8,161,19,21,-2
8,8,162,19,19,0
8,8,163,14,26,-12
8,8,164,11,12,-1
8,8,165,8,7,1
8,8,166,8,8,0
8,8,167,19,13,6
8,8,168,7,11,-4
8,8,169,20,17,3
8,8,170,12,5,7
8,8,171,5,3,2
8,8,172,13,18,-5
8,8,173,13,22,-9
8,8,174,13,14,-1
8,8,175,16,25,-9
8,8,176,6,10,-4
8,8,177,7,7,0
8,8,178,21,21,0
8,8,179,7,18,-11
8,8,180,10,16,-6
8,8,181,18,10,8
8,8,182,8,8,0
8,8,183,18,12,6
8,8,184,16,12,4
8,8,185,17,13,4
8,8,186,13,15,-2
8,8,187,21,16,5
8,8,188,11,20,-9
8,8,189,17,17,0
8,8,190,16,17,-1
8,8,191,14,8,6
8,8,192,14,23,-9
8,8,193,6,10,-4
8,8,194,20,27,-7
8,8,195,22,17,5
8,8,196,18,16,2
8,8,197,14,14,0
8,8,198,10,12,-2
8,8,199,20,19,1
8,8,200,8,2,6
8,8,201,18,21,-3
8,8,202,14,10,4
8,8,203,12,7,5
8,8,204,22,16,6
8,8,205,11,10,1
8,8,206,16,9,7
8,8,207,18,25,-7
8,8,208,14,7,7
8,8,209,10,10,0
8,8,210,10,25,-15
8,8,211,21,12,9
8,8,212,22,20,2
8,8,213,6,10,-4
8,8,214,12,16,-4
8,8,215,21,20,1
8,8,216,19,22,-3
8,8,217,12,12,0
8,8,218,9,5,4
8,8,219,10,14,-4
8,8,220,15,9,6
8,8,221,7,9,-2
8,8,222,9,9,0
8,8,223,10,22,-12
8,8,224,12,12,0
8,8,225,20,14,6
8,8,226,8,9,-1
8,8,227,5,13,-8
8,8,228,13,20,-7
8,8,229,9,15,-6
8,8,230,12,9,3
8,8,231,14,18,-4
8,8,232,11,25,-14
8,8,233,21,22,-1
8,8,234,7,10,-3
8,8,235,9,14,-5
8,8,236,17,11,6
8,8,237,14,20,-6
8,8,238,8,6,2
8,8,239,11,10,1
8,8,240,14,15,-1
8,8,241,23,12,11
8,8,242,8,12,-4
8,8,243,13,10,3
8,8,244,8,11,-3
8,8,245,16,12,4
8,8,246,12,14,-2
8,8,247,4,13,-9
8,8,248,8,3,5
8,8,249,10,9,1
8,8,250,20,12,8
8,8,251,26,15,11
8,8,252,24,22,2
8,8,253,8,6,2
8,8,254,10,8,2
8,8,255,12,16,-4
8,8,256,23,12,11
8,8,257,18,17,1
8,8,258,14,23,-9
8,8,259,14,11,3
8,8,260,4,15,-11
8,8,261,23,21,2
8,8,262,8,6,2
8,8,263,14,26,-12
8,8,264,13,4,9
8,8,265,9,9,0
8,8,266,20,20,0
8,8,267,19,27,-8
8,8,268,7,19,-12
8,8,269,21,20,1
8,8,270,15,15,0
8,8,271,24,11,13
8,8,272,9,13,-4
8,8,273,13,15,-2
8,8,274,18,25,-7
8,8,275,16,16,0
8,8,276,39,21,18
8,8,277,14,11,3
8,8,278,14,10,4
8,8,279,8,20,-12
8,8,280,3,10,-7
8,8,281,19,9,10
8,8,282,10,10,0
8,8,283,5,13,-8
8,8,284,9,9,0
8,8,285,18,12,6
8,8,286,9,15,-6
8,8,287,5,16,-11
8,8,288,14,8,6
8,8,289,14,9,5
8,8,290,16,14,2
8,8,291,13,20,-7
8,8,292,18,18,0
8,8,293,17,26,-9
8,8,294,14,13,1
8,8,295,26,15,11
8,8,296,12,6,6
8,8,297,23,26,-3
8,8,298,3,22,-19
8,8,299,9,3,6
9,9,0,11,25,-14
9,9,1,28,24,4
9,9,2,7,12,-5
9,9,3,15,17,-2
9,9,4,15,13,2
9,9,5,18,21,-3
9,9,6,11,9,2
9,9,7,4,21,-17
9,9,8,15,17,-2
9,9,9,11,10,1
9,9,10,12,11,1
9,9,11,15,18,-3
9,9,12,11,14,-3
9,9,13,15,7,8
9,9,14,10,13,-3
9,9,15,24,14,10
9,9,16,17,15,2
9,9,17,12,12,0
9,9,18,15,14,1
9,9,19,10,14,-4
9,9,20,20,17,3
9,9,21,17,23,-6
9,9,22,14,10,4
9,9,23,11,20,-9
9,9,24,9,11,-2
9,9,25,14,9,5
9,9,26,5,17,-12
9,9,27,10,23,-13
9,9,28,10,12,-2
9,9,29,11,13,-2
9,9,30,16,19,-3
9,9,31,6,25,-19
9,9,32,15,10,5
9,9,33,15,25,-10
9,9,34,10,18,-8
9,9,35,7,9,-2
9,9,36,10,25,-15
9,9,37,13,24,-11
9,9,38,12,15,-3
9,9,39,3,16,-13
9,9,40,15,15,0
9,9,41,10,16,-6
9,9,42,13,14,-1
9,9,43,14,20,-6
9,9,44,18,14,4
9,9,45,21,15,6
9,9,46,7,6,1
9,9,47,5,8,-3
9,9,48,10,14,-4
9,9,49,19,16,3
9,9,50,10,24,-14
9,9,51,4,9,-5
9,9,52,6,9,-3
9,9,53,17,14,3
9,9,54,18,11,7
9,9,55,29,27,2
9,9,56,21,14,7
9,9,57,12,26,-14
9,9,58,6,9,-3
9,9,59,6,33,-27
9,9,60,9,18,-9
9,9,61,4,14,-10
9,9,62,5,10,-5
9,9,63,10,12,-2
9,9,64,15,24,-9
9,9,65,6,9,-3
9,9,66,7,7,0
9,9,67,13,13,0
9,9,68,11,16,-5
9,9,69,12,24,-12
9,9,70,11,10,1
9,9,71,14,15,-1
9,9,72,21,9,12
9,9,73,7,16,-9
9,9,74,9,14,-5
9,9,75,21,14,7
9,9,76,18,24,-6
9,9,77,10,41,-31
9,9,78,12,20,-8
9,9,79,7,9,-2
9,9,80,17,10,7
9,9,81,11,17,-6
9,9,82,9,13,-4
9,9,83,8,16,-8
9,9,84,24,21,3
9,9,85,16,20,-4
9,9,86,9,9,0
9,9,87,11,11,0
9,9,88,8,16,-8
9,9,89,13,20,-7
9,9,90,14,14,0
9,9,91,21,21,0
9,9,92,22,20,2
9,9,93,16,22,-6
9,9,94,19,23,-4
9,9,95,10,21,-11
9,9,96,12,16,-4
9,9,97,7,10,-3
9,9,98,17,14,3
9,9,99,8,21,-13
9,9,100,35,19,16
9,9,101,15,16,-1
9,9,102,10,15,-5
9,9,103,12,16,-4
9,9,104,3,9,-6
9,9,105,21,13,8
9,9,106,15,21,-6
9,9,107,14,18,-4
9,9,108,23,23,0
9,9,109,12,20,-8
9,9,110,2,8,-6
9,9,111,15,19,-4
9,9,112,11,17,-6
9,9,113,20,9,11
9,9,114,16,12,4
9,9,115,11,14,-3
9,9,116,11,17,-6
9,9,117,20,13,7
9,9,118,16,7,9
9,9,119,13,7,6
9,9,120,20,10,10
9,9,121,16,16,0
9,9,122,7,25,-18
9,9,123,22,12,10
9,9,124,5,19,-14
9,9,125,15,16,-1
9,9,126,20,14,6
9,9,127,8,9,-1
9,9,128,7,2,5
9,9,129,32,23,9
9,9,130,19,8,11
9,9,131,20,17,3
9,9,132,11,6,5
9,9,133,9,8,1
9,9,134,8,10,-2
9,9,135,19,14,5
9,9,136,16,18,-2
9,9,137,3,6,-3
9,9,138,15,24,-9
9,9,139,9,27,-18
9,9,140,10,13,-3
9,9,141,18,20,-2
9,9,142,34,29,5
9,9,143,10,25,-15
9,9,144,5,6,-1
9,9,145,7,17,-10
9,9,146,14,12,2
9,9,147,21,16,5
9,9,148,11,14,-3
9,9,149,9,14,-5
9,9,150,2,14,-12
9,9,151,7,14,-7
9,9,152,14,18,-4
9,9,153,19,27,-8
9,9,154,10,12,-2
9,9,155,9,17,-8
9,9,156,16,19,-3
9,9,157,14,19,-5
9,9,158,19,15,4
9,9,159,13,24,-11
9,9,160,15,25,-10
9,9,161,12,15,-3
9,9,162,12,15,-3
9,9,163,16,18,-2
9,9,164,13,11,2
9,9,165,13,25,-12
9,9,166,18,18,0
9,9,167,8,14,-6
9,9,168,11,3,8
9,9,169,12,13,-1
9,9,170,32,28,4
9,9,171,25,18,7
9,9,172,23,28,-5
9,9,173,15,21,-6
9,9,174,9,11,-2
9,9,175,12,15,-3
9,9,176,12,21,-9
9,9,177,9,5,4
9,9,178,8,11,-3
9,9,179,14,14,0
9,9,180,8,20,-12
9,9,181,23,20,3
9,9,182,12,18,-6
9,9,183,18,18,0
9,9,184,23,17,6
9,9,185,13,12,1
9,9,186,23,19,4
9,9,187,13,21,-8
9,9,188,16,20,-4
9,9,189,13,14,-1
9,9,190,11,16,-5
9,9,191,14,11,3
9,9,192,25,33,-8
9,9,193,17,13,4
9,9,194,15,22,-7
9,9,195,18,21,-3
9,9,196,21,5,16
9,9,197,18,23,-5
9,9,198,29,20,9
9,9,199,17,21,-4
9,9,200,21,18,3
9,9,201,17,13,4
9,9,202,10,19,-9
9,9,203,14,13,1
9,9,204,25,10,15
9,9,205,12,20,-8
9,9,206,17,11,6
9,9,207,6,16,-10
9,9,208,10,35,-25
9,9,209,10,13,-3
9,9,210,15,14,1
9,9,211,24,22,2
9,9,212,12,17,-5
9,9,213,25,14,11
9,9,214,11,11,0
9,9,215,18,20,-2
9,9,216,19,14,5
9,9,217,6,3,3
9,9,218,17,17,0
9,9,219,21,25,-4
9,9,220,21,13,8
9,9,221,10,28,-18
9,9,222,16,8,8
9,9,223,23,11,12
9,9,224,6,11,-5
9,9,225,19,27,-8
9,9,226,8,10,-2
9,9,227,12,8,4
9,9,228,7,12,-5
9,9,229,10,19,-9
9,9,230,10,8,2
9,9,231,6,4,2
9,9,232,24,29,-5
9,9,233,11,28,-17
9,9,234,21,30,-9
9,9,235,16,29,-13
9,9,236,8,20,-12
9,9,237,6,39,-33
9,9,238,22,14,8
9,9,239,11,11,0
9,9,240,8,19,-11
9,9,241,13,15,-2
9,9,242,12,7,5
9,9,243,14,12,2
9,9,244,13,11,2
9,9,245,9,7,2
9,9,246,12,20,-8
9,9,247,3,12,-9
9,9,248,27,17,10
9,9,249,17,14,3
9,9,250,15,19,-4
9,9,251,19,8,11
9,9,252,21,24,-3
9,9,253,3,16,-13
9,9,254,9,12,-3
9,9,255,13,18,-5
9,9,256,24,11,13
9,9,257,12,20,-8
9,9,258,15,25,-10
9,9,259,11,11,0
9,9,260,3,7,-4
9,9,261,12,12,0
9,9,262,15,16,-1
9,9,263,22,13,9
9,9,264,17,18,-1
9,9,265,12,17,-5
9,9,266,11,23,-12
9,9,267,5,13,-8
9,9,268,10,14,-4
9,9,269,16,18,-2
9,9,270,9,21,-12
9,9,271,18,13,5
9,9,272,25,23,2
9,9,273,19,24,-5
9,9,274,12,12,0
9,9,275,12,18,-6
9,9,276,22,16,6
9,9,277,20,32,-12
9,9,278,15,15,0
9,9,279,18,15,3
9,9,280,6,31,-25
9,9,281,9,13,-4
9,9,282,15,17,-2
9,9,283,17,39,-22
9,9,284,18,18,0
9,9,285,8,18,-10
9,9,286,15,13,2
9,9,287,15,18,-3
9,9,288,24,15,9
9,9,289,32,19,13
9,9,290,16,21,-5
9,9,291,11,20,-9
9,9,292,8,14,-6
9,9,293,3,7,-4
9,9,294,12,12,0
9,9,295,18,8,10
9,9,296,16,22,-6
9,9,297,15,18,-3
9,9,298,12,20,-8
9,9,299,7,3,4
10,10,0,21,21,0
10,10,1,4,18,-14
10,10,2,26,16,10
10,10,3,15,24,-9
10,10,4,13,15,-2
10,10,5,19,12,7
10,10,6,13,21,-8
10,10,7,7,18,-11
10,10,8,20,18,2
10,10,9,15,13,2
10,10,10,32,20,12
10,10,11,23,23,0
10,10,12,21,30,-9
10,10,13,10,21,-11
10,10,14,19,19,0
10,10,15,20,30,-10
10,10,16,12,14,-2
10,10,17,23,20,3
10,10,18,20,5,15
10,10,19,8,17,-9
10,10,20,14,12,2
10,10,21,14,6,8
10,10,22,9,11,-2
10,10,23,18,20,-2
10,10,24,11,14,-3
10,10,25,15,22,-7
10,10,26,13,31,-18
10,10,27,10,16,-6
10,10,28,8,13,-5
10,10,29,11,14,-3
10,10,30,16,22,-6
10,10,31,22,17,5
10,10,32,11,33,-22
10,10,33,2,8,-6
10,10,34,13,8,5
10,10,35,9,12,-3
10,10,36,8,6,2
10,10,37,13,12,1
10,10,38,2,8,-6
10,10,39,16,8,8
10,10,40,13,12,1
10,10,41,22,17,5
10,10,42,13,7,6
10,10,43,13,13,0
10,10,44,7,8,-1
10,10,45,17,8,9
10,10,46,6,14,-8
10,10,47,11,17,-6
10,10,48,29,23,6
10,10,49,19,14,5
10,10,50,15,18,-3
10,10,51,12,8,4
10,10,52,14,11,3
10,10,53,6,10,-4
10,10,54,14,22,-8
10,10,55,16,12,4
10,10,56,12,26,-14
10,10,57,12,19,-7
10,10,58,4,6,-2
10,10,59,13,10,3
10,10,60,14,17,-3
10,10,61,15,17,-2
10,10,62,24,20,4
10,10,63,15,22,-7
10,10,64,19,18,1
10,10,65,20,25,-5
10,10,66,17,16,1
10,10,67,14,14,0
10,10,68,16,34,-18
10,10,69,17,17,0
10,10,70,12,12,0
10,10,71,18,22,-4
10,10,72,17,9,8
10,10,73,25,17,8
10,10,74,30,20,10
10,10,75,20,16,4
10,10,76,20,16,4
10,10,77,13,18,-5
10,10,78,28,18,10
10,10,79,7,8,-1
10,10,80,13,10,3
10,10,81,18,22,-4
10,10,82,19,18,1
10,10,83,13,15,-2
10,10,84,15,23,-8
10,10,85,15,10,5
10,10,86,17,11,6
10,10,87,17,24,-7
10,10,88,15,15,0
10,10,89,3,11,-8
10,10,90,13,14,-1
10,10,91,14,13,1
10,10,92,14,19,-5
10,10,93,9,12,-3
10,10,94,30,13,17
10,10,95,15,19,-4
10,10,96,11,9,2
10,10,97,19,28,-9
10,10,98,8,5,3
10,10,99,10,12,-2
10,10,100,12,18,-6
10,10,101,13,11,2
10,10,102,20,18,2
10,10,103,17,23,-6
10,10,104,11,4,7
10,10,105,16,20,-4
10,10,106,12,10,2
10,10,107,4,13,-9
10,10,108,12,14,-2
10,10,109,11,14,-3
10,10,110,14,21,-7
10,10,111,13,6,7
10,10,112,17,17,0
10,10,113,14,22,-8
10,10,114,11,15,-4
10,10,115,10,9,1
10,10,116,14,14,0
10,10,117,19,13,6
10,10,118,8,29,-21
10,10,119,11,19,-8
10,10,120,22,15,7
10,10,121,12,23,-11
10,10,122,15,12,3
10,10,123,20,14,6
10,10,124,12,11,1
10,10,125,19,34,-15
10,10,126,27,21,6
10,10,127,13,12,1
10,10,128,21,20,1
10,10,129,21,17,4
10,10,130,13,18,-5
10,10,131,6,11,-5
10,10,132,17,19,-2
10,10,133,23,20,3
10,10,134,6,21,-15
10,10,135,13,4,9
10,10,136,15,19,-4
10,10,137,14,10,4
10,10,138,8,20,-12
10,10,139,25,15,10
10,10,140,26,24,2
10,10,141,14,13,1
10,10,142,20,23,-3
10,10,143,9,11,-2
10,10,144,11,27,-16
10,10,145,13,8,5
10,10,146,14,24,-10
10,10,147,16,14,2
10,10,148,19,11,8
10,10,149,8,19,-11
10,10,150,13,9,4
10,10,151,11,27,-16
10,10,152,13,20,-7
10,10,153,16,12,4
10,10,154,17,30,-13
10,10,155,15,8,7
10,10,156,15,17,-2
10,10,157,17,16,1
10,10,158,16,21,-5
10,10,159,26,18,8
10,10,160,26,32,-6
10,10,161,20,11,9
10,10,162,15,16,-1
10,10,163,13,22,-9
10,10,164,18,15,3
10,10,165,21,14,7
10,10,166,11,12,-1
10,10,167,13,21,-8
10,10,168,19,19,0
10,10,169,13,14,-1
10,10,170,11,19,-8
10,10,171,6,18,-12
10,10,172,12,22,-10
10,10,173,11,13,-2
10,10,174,13,21,-8
10,10,175,16,16,0
10,10,176,14,18,-4
10,10,177,10,21,-11
10,10,178,11,12,-1
10,10,179,24,23,1
10,10,180,20,22,-2
10,10,181,16,30,-14
10,10,182,21,20,1
10,10,183,24,22,2
10,10,184,13,14,-1
10,10,185,6,13,-7
10,10,186,20,13,7
10,10,187,7,10,-3
10,10,188,14,21,-7
10,10,189,7,26,-19
10,10,190,9,7,2
10,10,191,16,11,5
10,10,192,10,16,-6
10,10,193,32,20,12
10,10,194,8,11,-3
10,10,195,19,21,-2
10,10,196,13,15,-2
10,10,197,12,11,1
10,10,198,18,14,4
10,10,199,8,15,-7
10,10,200,16,3,13
10,10,201,11,17,-6
10,10,202,10,23,-13
10,10,203,21,21,0
10,10,204,16,31,-15
10,10,205,10,14,-4
10,10,206,15,13,2
10,10,207,13,11,2
10,10,208,12,9,3
10,10,209,16,33,-17
10,10,210,18,14,4
10,10,211,17,21,-4
10,10,212,18,10,8
10,10,213,11,17,-6
10,10,214,8,14,-6
10,10,215,15,13,2
10,10,216,9,13,-4
10,10,217,12,10,2
10,10,218,24,25,-1
10,10,219,10,9,1
10,10,220,14,18,-4
10,10,221,13,13,0
10,10,222,14,23,-9
10,10,223,17,23,-6
10,10,224,32,22,10
10,10,225,7,8,-1
10,10,226,11,17,-6
10,10,227,19,36,-17
10,10,228,15,14,1
10,10,229,22,29,-7
10,10,230,13,27,-14
10,10,231,15,12,3
10,10,232,21,20,1
10,10,233,12,9,3
10,10,234,9,21,-12
10,10,235,26,17,9
10,10,236,21,13,8
10,10,237,13,13,0
10,10,238,15,21,-6
10,10,239,21,14,7
10,10,240,10,12,-2
10,10,241,18,5,13
10,10,242,21,25,-4
10,10,243,12,20,-8
10,10,244,13,28,-15
10,10,245,10,16,-6
10,10,246,11,15,-4
10,10,247,35,24,11
10,10,248,6,11,-5
10,10,249,18,21,-3
10,10,250,4,16,-12
10,10,251,28,19,9
10,10,252,15,14,1
10,10,253,9,6,3
10,10,254,3,9,-6
10,10,255,15,18,-3
10,10,256,24,17,7
10,10,257,22,26,-4
10,10,258,12,14,-2
10,10,259,16,16,0
10,10,260,12,8,4
10,10,261,18,10,8
10,10,262,18,17,1
10,10,263,19,14,5
10,10,264,11,19,-8
10,10,265,14,15,-1
10,10,266,22,12,10
10,10,267,25,19,6
10,10,268,21,16,5
10,10,269,22,19,3
10,10,270,17,22,-5
10,10,271,14,13,1
10,10,272,3,16,-13
10,10,273,20,8,12
10,10,274,17,12,5
10,10,275,29,12,17
10,10,276,16,11,5
10,10,277,17,21,-4
10,10,278,16,22,-6
10,10,279,10,18,-8
10,10,280,15,14,1
10,10,281,24,13,11
10,10,282,14,12,2
10,10,283,12,19,-7
10,10,284,19,13,6
10,10,285,22,18,4
10,10,286,9,17,-8
10,10,287,12,17,-5
10,10,288,9,18,-9
10,10,289,14,16,-2
10,10,290,5,13,-8
10,10,291,16,25,-9
10,10,292,15,14,1
10,10,293,21,22,-1
10,10,294,24,18,6
10,10,295,4,5,-1
10,10,296,12,9,3
10,10,297,17,11,6
10,10,298,17,26,-9
10,10,299,8,20,-12
11,11,0,9,28,-19
11,11,1,24,20,4
11,11,2,21,15,6
11,11,3,11,13,-2
11,11,4,15,11,4
11,11,5,11,14,-3
11,11,6,16,19,-3
11,11,7,16,21,-5
11,11,8,18,18,0
11,11,9,22,10,12
11,11,10,13,19,-6
11,11,11,6,16,-10
11,11,12,29,23,6
11,11,13,9,7,2
11,11,14,11,15,-4
11,11,15,12,14,-2
11,11,16,11,13,-2
11,11,17,14,19,-5
11,11,18,16,10,6
11,11,19,13,12,1
11,11,20,10,14,-4
11,11,21,9,13,-4
11,11,22,24,22,2
11,11,23,6,16,-10
11,11,24,11,27,-16
11,11,25,15,26,-11
11,11,26,5,20,-15
11,11,27,25,24,1
11,11,28,16,7,9
11,11,29,13,19,-6
11,11,30,25,34,-9
11,11,31,12,16,-4
11,11,32,16,22,-6
11,11,33,12,10,2
11,11,34,25,18,7
11,11,35,22,15,7
11,11,36,20,17,3
11,11,37,8,11,-3
11,11,38,19,26,-7
11,11,39,6,18,-12
11,11,40,18,8,10
11,11,41,20,25,-5
11,11,42,13,16,-3
11,11,43,28,13,15
11,11,44,13,26,-13
11,11,45,7,15,-8
11,11,46,22,16,6
11,11,47,0,9,-9
11,11,48,16,20,-4
11,11,49,21,6,15
11,11,50,27,10,17
11,11,51,9,16,-7
11,11,52,14,21,-7
11,11,53,17,22,-5
11,11,54,14,17,-3
11,11,55,9,7,2
11,11,56,15,18,-3
11,11,57,20,12,8
11,11,58,18,23,-5
11,11,59,18,22,-4
11,11,60,16,13,3
11,11,61,10,21,-11
11,11,62,27,17,10
11,11,63,7,10,-3
11,11,64,30,27,3
11,11,65,19,18,1
11,11,66,11,11,0
11,11,67,13,23,-10
11,11,68,10,9,1
11,11,69,11,29,-18
11,11,70,17,19,-2
11,11,71,23,26,-3
11,11,72,13,14,-1
11,11,73,20,21,-1
11,11,74,9,10,-1
11,11,75,27,31,-4
11,11,76,17,21,-4
11,11,77,21,23,-2
11,11,78,23,10,13
11,11,79,18,12,6
11,11,80,12,8,4
11,11,81,20,25,-5
11,11,82,10,7,3
11,11,83,14,13,1
11,11,84,9,11,-2
11,11,85,23,19,4
11,11,86,13,12,1
11,11,87,16,17,-1
11,11,88,21,13,8
11,11,89,11,15,-4
11,11,90,17,19,-2
11,11,91,8,9,-1
11,11,92,7,20,-13
11,11,93,18,12,6
11,11,94,23,22,1
11,11,95,11,9,2
11,11,96,8,16,-8
11,11,97,9,18,-9
11,11,98,17,22,-5
11,11,99,10,12,-2
11,11,100,8,15,-7
11,11,101,12,20,-8
11,11,102,13,13,0
11,11,103,17,9,8
11,11,104,4,17,-13
11,11,105,14,11,3
11,11,106,11,18,-7
11,11,107,16,19,-3
11,11,108,13,8,5
11,11,109,12,13,-1
11,11,110,10,20,-10
11,11,111,20,17,3
11,11,112,28,17,11
11,11,113,13,9,4
11,11,114,20,14,6
11,11,115,18,26,-8
11,11,116,21,23,-2
11,11,117,23,8,15
11,11,118,21,14,7
11,11,119,15,15,0
11,11,120,16,24,-8
11,11,121,7,10,-3
11,11,122,15,18,-3
11,11,123,14,6,8
11,11,124,11,28,-17
11,11,125,16,20,-4
11,11,126,3,15,-12
11,11,127,25,13,12
11,11,128,25,29,-4
11,11,129,12,14,-2
11,11,130,10,11,-1
11,11,131,15,14,1
11,11,132,19,20,-1
11,11,133,20,27,-7
11,11,134,11,18,-7
11,11,135,27,9,18
11,11,136,12,20,-8
11,11,137,13,14,-1
11,11,138,20,9,11
11,11,139,29,26,3
11,11,140,15,22,-7
11,11,141,9,31,-22
11,11,142,22,19,3
11,11,143,19,4,15
11,11,144,15,10,5
11,11,145,13,27,-14
11,11,146,11,15,-4
11,11,147,10,15,-5
11,11,148,14,21,-7
11,11,149,10,14,-4
11,11,150,10,16,-6
11,11,151,23,19,4
11,11,152,19,18,1
11,11,153,21,13,8
11,11,154,16,10,6
11,11,155,20,24,-4
11,11,156,14,13,1
11,11,157,14,9,5
11,11,158,16,24,-8
11,11,159,8,18,-10
11,11,160,13,21,-8
11,11,161,13,15,-2
11,11,162,14,12,2
11,11,163,14,26,-12
11,11,164,9,14,-5
11,11,165,9,14,-5
11,11,166,17,19,-2
11,11,167,24,25,-1
11,11,168,16,13,3
11,11,169,21,22,-1
11,11,170,11,11,0
11,11,171,10,14,-4
11,11,172,16,15,1
11,11,173,22,17,5
11,11,174,19,19,0
11,11,175,12,16,-4
11,11,176,14,20,-6
11,11,177,16,23,-7
11,11,178,23,14,9
11,11,179,16,9,7
11,11,180,10,12,-2
11,11,181,14,21,-7
11,11,182,9,11,-2
11,11,183,11,9,2
11,11,184,12,15,-3
11,11,185,15,4,11
11,11,186,12,16,-4
11,11,187,13,13,0
11,11,188,17,12,5
11,11,189,9,11,-2
11,11,190,11,18,-7
11,11,191,18,21,-3
11,11,192,22,18,4
11,11,193,23,9,14
11,11,194,11,26,-15
11,11,195,15,21,-6
11,11,196,12,13,-1
11,11,197,13,6,7
11,11,198,17,12,5
11,11,199,8,12,-4
11,11,200,10,10,0
11,11,201,10,8,2
11,11,202,9,1,8
11,11,203,17,27,-10
11,11,204,20,20,0
11,11,205,0,13,-13
11,11,206,16,26,-10
11,11,207,12,11,1
11,11,208,28,26,2
11,11,209,12,14,-2
11,11,210,14,18,-4
11,11,211,22,16,6
11,11,212,7,10,-3
11,11,213,13,11,2
11,11,214,22,17,5
11,11,215,9,18,-9
11,11,216,22,10,12
11,11,217,25,24,1
11,11,218,10,21,-11
11,11,219,10,15,-5
11,11,220,8,16,-8
11,11,221,4,16,-12
11,11,222,10,21,-11
11,11,223,16,8,8
11,11,224,27,14,13
11,11,225,16,14,2
11,11,226,7,8,-1
11,11,227,18,13,5
11,11,228,16,18,-2
11,11,229,18,16,2
11,11,230,15,13,2
11,11,231,17,8,9
11,11,232,6,20,-14
11,11,233,13,13,0
11,11,234,11,17,-6
11,11,235,19,14,5
11,11,236,14,19,-5
11,11,237,17,9,8
11,11,238,8,18,-10
11,11,239,20,20,0
11,11,240,22,10,12
11,11,241,22,13,9
11,11,242,17,30,-13
11,11,243,16,13,3
11,11,244,22,18,4
11,11,245,22,19,3
11,11,246,6,6,0
11,11,247,10,24,-14
11,11,248,16,17,-1
11,11,249,2,14,-12
11,11,250,32,36,-4
11,11,251,17,10,7
11,11,252,11,15,-4
11,11,253,15,22,-7
11,11,254,25,12,13
11,11,255,18,14,4
11,11,256,15,22,-7
11,11,257,8,4,4
11,11,258,9,18,-9
11,11,259,15,11,4
11,11,260,11,15,-4
11,11,261,19,25,-6
11,11,262,25,18,7
11,11,263,10,13,-3
11,11,264,16,15,1
11,11,265,6,9,-3
11,11,266,25,8,17
11,11,267,18,16,2
11,11,268,12,9,3
11,11,269,21,16,5
11,11,270,11,14,-3
11,11,271,23,27,-4
11,11,272,15,26,-11
11,11,273,11,18,-7
11,11,274,19,20,-1
11,11,275,14,13,1
11,11,276,9,12,-3
11,11,277,14,10,4
11,11,278,13,11,2
11,11,279,15,7,8
11,11,280,19,23,-4
11,11,281,25,17,8
11,11,282,13,12,1
11,11,283,27,19,8
11,11,284,16,14,2
11,11,285,12,27,-15
11,11,286,13,18,-5
11,11,287,12,15,-3
11,11,288,21,16,5
11,11,289,18,14,4
11,11,290,25,34,-9
11,11,291,29,15,14
11,11,292,16,11,5
11,11,293,25,11,14
11,11,294,11,14,-3
11,11,295,6,7,-1
11,11,296,12,21,-9
11,11,297,25,27,-2
11,11,298,25,15,10
11,11,299,15,13,2
12,12,0,10,13,-3
12,12,1,12,12,0
12,12,2,16,11,5
12,12,3,18,25,-7
12,12,4,13,4,9
12,12,5,24,15,9
12,12,6,23,31,-8
12,12,7,22,12,10
12,12,8,13,15,-2
12,12,9,23,19,4
12,12,10,18,20,-2
12,12,11,5,20,-15
12,12,12,7,15,-8
12,12,13,7,16,-9
12,12,14,24,20,4
12,12,15,12,27,-15
12,12,16,6,11,-5
12,12,17,19,22,-3
12,12,18,8,13,-5
12,12,19,9,16,-7
12,12,20,17,14,3
12,12,21,9,5,4
12,12,22,17,25,-8
12,12,23,10,13,-3
12,12,24,10,10,0
12,12,25,17,13,4
12,12,26,13,17,-4
12,12,27,9,15,-6
12,12,28,8,20,-12
12,12,29,11,14,-3
12,12,30,10,21,-11
12,12,31,11,6,5
12,12,32,8,14,-6
12,12,33,11,13,-2
12,12,34,16,13,3
12,12,35,8,15,-7
12,12,36,5,16,-11
12,12,37,17,12,5
12,12,38,16,15,1
12,12,39,20,21,-1
12,12,40,12,10,2
12,12,41,7,6,1
12,12,42,11,6,5
12,12,43,9,18,-9
12,12,44,17,22,-5
12,12,45,25,25,0
12,12,46,13,16,-3
12,12,47,18,13,5
12,12,48,11,23,-12
12,12,49,26,19,7
12,12,50,13,36,-23
12,12,51,9,11,-2
12,12,52,16,11,5
12,12,53,9,18,-9
12,12,54,18,32,-14
12,12,55,24,12,12
12,12,56,28,23,5
12,12,57,12,20,-8
12,12,58,17,13,4
12,12,59,14,18,-4
12,12,60,12,13,-1
12,12,61,35,11,24
12,12,62,19,20,-1
12,12,63,17,19,-2
12,12,64,21,27,-6
12,12,65,15,19,-4
12,12,66,13,20,-7
12,12,67,13,15,-2
12,12,68,15,13,2
12,12,69,13,24,-11
12,12,70,8,15,-7
12,12,71,12,15,-3
12,12,72,11,19,-8
12,12,73,10,20,-10
12,12,74,8,4,4
12,12,75,15,22,-7
12,12,76,12,12,0
12,12,77,7,12,-5
12,12,78,8,8,0
12,12,79,18,12,6
12,12,80,21,21,0
12,12,81,19,23,-4
12,12,82,10,14,-4
12,12,83,8,3,5
12,12,84,18,28,-10
12,12,85,12,17,-5
12,12,86,6,13,-7
12,12,87,8,9,-1
12,12,88,10,8,2
12,12,89,28,26,2
12,12,90,5,4,1
12,12,91,15,17,-2
12,12,92,9,13,-4
12,12,93,19,22,-3
12,12,94,13,17,-4
12,12,95,16,34,-18
12,12,96,19,39,-20
12,12,97,10,17,-7
12,12,98,15,18,-3
12,12,99,13,29,-16
12,12,100,13,7,6
12,12,101,17,9,8
12,12,102,7,12,-5
12,12,103,6,11,-5
12,12,104,22,17,5
12,12,105,14,17,-3
12,12,106,14,24,-10
12,12,107,18,17,1
12,12,108,32,22,10
12,12,109,6,17,-11
12,12,110,18,23,-5
12,12,111,15,16,-1
12,12,112,13,23,-10
12,12,113,11,23,-12
12,12,114,17,19,-2
12,12,115,14,10,4
12,12,116,11,10,1
12,12,117,16,24,-8
12,12,118,12,13,-1
12,12,119,23,19,4
12,12,120,6,15,-9
12,12,121,14,17,-3
12,12,122,16,11,5
12,12,123,24,25,-1
12,12,124,6,7,-1
12,12,125,21,22,-1
12,12,126,9,14,-5
12,12,127,25,24,1
12,12,128,8,21,-13
12,12,129,12,13,-1
12,12,130,9,7,2
12,12,131,12,26,-14
12,12,132,21,17,4
12,12,133,12,10,2
12,12,134,10,17,-7
12,12,135,15,11,4
12,12,136,13,18,-5
12,12,137,15,25,-10
12,12,138,13,13,0
12,12,139,38,25,13
12,12,140,15,23,-8
12,12,141,11,8,3
12,12,142,23,27,-4
12,12,143,13,9,4
12,12,144,9,11,-2
12,12,145,21,21,0
12,12,146,24,19,5
12,12,147,20,10,10
12,12,148,18,5,13
12,12,149,21,6,15
12,12,150,11,9,2
12,12,151,12,14,-2
12,12,152,8,11,-3
12,12,153,19,13,6
12,12,154,17,21,-4
12,12,155,12,10,2
12,12,156,17,30,-13
12,12,157,18,36,-18
12,12,158,12,41,-29
12,12,159,7,9,-2
12,12,160,22,11,11
12,12,161,7,18,-11
12,12,162,12,18,-6
12,12,163,19,22,-3
12,12,164,16,21,-5
12,12,165,7,15,-8
12,12,166,20,23,-3
12,12,167,9,19,-10
12,12,168,16,10,6
12,12,169,17,15,2
12,12,170,14,14,0
12,12,171,14,14,0
12,12,172,8,9,-1
12,12,173,19,26,-7
12,12,174,14,14,0
12,12,175,14,16,-2
12,12,176,18,19,-1
12,12,177,16,21,-5
12,12,178,15,17,-2
12,12,179,15,18,-3
12,12,180,20,20,0
12,12,181,16,13,3
12,12,182,12,10,2
12,12,183,19,24,-5
12,12,184,12,17,-5
12,12,185,19,14,5
12,12,186,13,9,4
12,12,187,11,15,-4
12,12,188,10,31,-21
12,12,189,11,3,8
12,12,190,17,16,1
12,12,191,12,12,0
12,12,192,12,17,-5
12,12,193,17,9,8
12,12,194,14,26,-12
12,12,195,10,14,-4
12,12,196,13,21,-8
12,12,197,6,17,-11
12,12,198,9,7,2
12,12,199,22,12,10
12,12,200,21,22,-1
12,12,201,19,32,-13
12,12,202,12,14,-2
12,12,203,11,9,2
12,12,204,13,10,3
12,12,205,17,24,-7
12,12,206,16,18,-2
12,12,207,7,17,-10
12,12,208,9,10,-1
12,12,209,6,21,-15
12,12,210,11,25,-14
12,12,211,7,9,-2
12,12,212,13,13,0
12,12,213,21,16,5
12,12,214,17,43,-26
12,12,215,8,7,1
12,12,216,17,37,-20
12,12,217,19,20,-1
12,12,218,11,14,-3
12,12,219,17,19,-2
12,12,220,17,13,4
12,12,221,12,26,-14
12,12,222,31,29,2
12,12,223,21,11,10
12,12,224,16,23,-7
12,12,225,20,12,8
12,12,226,22,19,3
12,12,227,10,13,-3
12,12,228,6,12,-6
12,12,229,11,12,-1
12,12,230,22,19,3
12,12,231,13,18,-5
12,12,232,14,15,-1
12,12,233,13,8,5
12,12,234,9,18,-9
12,12,235,13,18,-5
12,12,236,16,19,-3
12,12,237,18,10,8
12,12,238,20,26,-6
12,12,239,19,15,4
12,12,240,14,14,0
12,12,241,8,21,-13
12,12,242,15,14,1
12,12,243,5,12,-7
12,12,244,23,14,9
12,12,245,10,8,2
12,12,246,14,15,-1
12,12,247,19,20,-1
12,12,248,13,18,-5
12,12,249,7,25,-18
12,12,250,16,26,-10
12,12,251,11,7,4
12,12,252,17,9,8
12,12,253,10,23,-13
12,12,254,28,12,16
12,12,255,16,24,-8
12,12,256,20,23,-3
12,12,257,16,11,5
12,12,258,24,20,4
12,12,259,20,13,7
12,12,260,8,8,0
12,12,261,12,9,3
12,12,262,21,15,6
12,12,263,9,17,-8
12,12,264,17,7,10
12,12,265,22,19,3
12,12,266,9,13,-4
12,12,267,9,15,-6
12,12,268,25,17,8
12,12,269,25,24,1
12,12,270,14,20,-6
12,12,271,18,15,3
12,12,272,9,9,0
12,12,273,17,15,2
12,12,274,15,20,-5
12,12,275,20,13,7
12,12,276,10,14,-4
12,12,277,26,21,5
12,12,278,12,19,-7
12,12,279,20,16,4
12,12,280,9,8,1
12,12,281,6,21,-15
12,12,282,22,23,-1
12,12,283,7,12,-5
12,12,284,8,13,-5
12,12,285,16,21,-5
12,12,286,18,19,-1
12,12,287,6,6,0
12,12,288,12,14,-2
12,12,289,16,13,3
12,12,290,20,23,-3
12,12,291,10,15,-5
12,12,292,9,4,5
12,12,293,26,27,-1
12,12,294,18,17,1
12,12,295,14,18,-4
12,12,296,13,15,-2
12,12,297,13,22,-9
12,12,298,12,16,-4
12,12,299,17,19,-2
13,13,0,6,9,-3
13,13,1,8,12,-4
13,13,2,9,14,-5
13,13,3,13,16,-3
13,13,4,8,16,-8
13,13,5,19,16,3
13,13,6,12,22,-10
13,13,7,17,7,10
13,13,8,15,11,4
13,13,9,11,13,-2
13,13,10,15,16,-1
13,13,11,6,15,-9
13,13,12,10,12,-2
13,13,13,14,21,-7
13,13,14,7,8,-1
13,13,15,15,28,-13
13,13,16,13,18,-5
13,13,17,18,11,7
13,13,18,14,13,1
13,13,19,15,17,-2
13,13,20,20,15,5
13,13,21,13,13,0
13,13,22,10,11,-1
13,13,23,12,21,-9
13,13,24,21,14,7
13,13,25,16,19,-3
13,13,26,23,26,-3
13,13,27,18,20,-2
13,13,28,31,21,10
13,13,29,27,16,11
13,13,30,8,17,-9
13,13,31,14,18,-4
13,13,32,19,27,-8
13,13,33,7,13,-6
13,13,34,19,12,7
13,13,35,7,25,-18
13,13,36,12,13,-1
13,13,37,13,11,2
13,13,38,14,49,-35
13,13,39,21,29,-8
13,13,40,8,15,-7
13,13,41,10,7,3
13,13,42,11,9,2
13,13,43,21,16,5
13,13,44,16,28,-12
13,13,45,11,21,-10
13,13,46,5,15,-10
13,13,47,24,19,5
13,13,48,18,10,8
13,13,49,13,16,-3
13,13,50,10,18,-8
13,13,51,22,23,-1
13,13,52,15,18,-3
13,13,53,27,19,8
13,13,54,10,23,-13
13,13,55,9,25,-16
13,13,56,9,14,-5
13,13,57,21,29,-8
13,13,58,12,19,-7
13,13,59,14,16,-2
13,13,60,15,8,7
13,13,61,17,18,-1
13,13,62,17,6,11
13,13,63,17,22,-5
13,13,64,20,12,8
13,13,65,15,15,0
13,13,66,11,18,-7
13,13,67,9,8,1
13,13,68,8,22,-14
13,13,69,24,18,6
13,13,70,12,15,-3
13,13,71,14,16,-2
13,13,72,15,15,0
13,13,73,14,27,-13
13,13,74,15,15,0
13,13,75,19,8,11
13,13,76,14,6,8
13,13,77,26,22,4
13,13,78,15,13,2
13,13,79,3,16,-13
13,13,80,11,12,-1
13,13,81,13,21,-8
13,13,82,19,13,6
13,13,83,13,15,-2
13,13,84,15,18,-3
13,13,85,18,13,5
13,13,86,11,9,2
13,13,87,9,12,-3
13,13,88,26,26,0
13,13,89,8,20,-12
13,13,90,17,29,-12
13,13,91,14,13,1
13,13,92,17,20,-3
13,13,93,25,23,2
13,13,94,12,14,-2
13,13,95,17,11,6
13,13,96,14,7,7
13,13,97,22,17,5
13,13,98,20,26,-6
13,13,99,19,41,-22
13,13,100,11,20,-9
13,13,101,14,25,-11
13,13,102,17,23,-6
13,13,103,20,12,8
13,13,104,27,34,-7
13,13,105,15,14,1
13,13,106,17,17,0
13,13,107,22,27,-5
13,13,108,6,14,-8
13,13,109,10,14,-4
13,13,110,12,30,-18
13,13,111,11,14,-3
13,13,112,11,11,0
13,13,113,25,10,15
13,13,114,20,16,4
13,13,115,14,15,-1
13,13,116,27,19,8
13,13,117,17,10,7
13,13,118,10,15,-5
13,13,119,14,11,3
13,13,120,12,17,-5
13,13,121,11,5,6
13,13,122,10,10,0
13,13,123,17,33,-16
13,13,124,10,24,-14
13,13,125,19,20,-1
13,13,126,24,17,7
13,13,127,11,14,-3
13,13,128,29,12,17
13,13,129,14,25,-11
13,13,130,13,4,9
13,13,131,19,19,0
13,13,132,8,11,-3
13,13,133,17,16,1
13,13,134,13,9,4
13,13,135,3,15,-12
13,13,136,7,6,1
13,13,137,20,12,8
13,13,138,8,22,-14
13,13,139,10,15,-5
13,13,140,17,8,9
13,13,141,16,18,-2
13,13,142,14,23,-9
13,13,143,3,16,-13
13,13,144,9,12,-3
13,13,145,20,22,-2
13,13,146,15,28,-13
13,13,147,12,19,-7
13,13,148,8,18,-10
13,13,149,12,13,-1
13,13,150,19,11,8
13,13,151,15,16,-1
13,13,152,13,14,-1
13,13,153,25,11,14
13,13,154,9,15,-6
13,13,155,8,10,-2
13,13,156,8,10,-2
13,13,157,8,12,-4
13,13,158,11,18,-7
13,13,159,12,16,-4
13,13,160,17,34,-17
13,13,161,5,16,-11
13,13,162,9,8,1
13,13,163,12,20,-8
13,13,164,20,12,8
13,13,165,16,14,2
13,13,166,13,20,-7
13,13,167,8,15,-7
13,13,168,4,16,-12
13,13,169,15,13,2
13,13,170,10,10,0
13,13,171,15,26,-11
13,13,172,16,31,-15
13,13,173,9,10,-1
13,13,174,16,19,-3
13,13,175,7,18,-11
13,13,176,8,10,-2
13,13,177,11,11,0
13,13,178,14,9,5
13,13,179,13,11,2
13,13,180,15,14,1
13,13,181,21,21,0
13,13,182,15,21,-6
13,13,183,10,15,-5
13,13,184,8,23,-15
13,13,185,19,18,1
13,13,186,6,11,-5
13,13,187,9,11,-2
13,13,188,13,12,1
13,13,189,20,19,1
13,13,190,17,12,5
13,13,191,9,19,-10
13,13,192,19,19,0
13,13,193,7,10,-3
13,13,194,9,16,-7
13,13,195,11,16,-5
13,13,196,12,12,0
13,13,197,14,11,3
13,13,198,15,14,1
13,13,199,12,12,0
13,13,200,19,21,-2
13,13,201,8,12,-4
13,13,202,7,20,-13
13,13,203,14,13,1
13,13,204,16,8,8
13,13,205,12,21,-9
13,13,206,16,16,0
13,13,207,21,25,-4
13,13,208,8,17,-9
13,13,209,9,15,-6
13,13,210,15,16,-1
13,13,211,20,18,2
13,13,212,6,4,2
13,13,213,19,18,1
13,13,214,20,18,2
13,13,215,15,25,-10
13,13,216,9,16,-7
13,13,217,18,20,-2
13,13,218,8,23,-15
13,13,219,24,19,5
13,13,220,14,21,-7
13,13,221,9,16,-7
13,13,222,10,8,2
13,13,223,21,18,3
13,13,224,25,13,12
13,13,225,13,11,2
13,13,226,15,26,-11
13,13,227,7,11,-4
13,13,228,16,10,6
13,13,229,6,8,-2
13,13,230,6,12,-6
13,13,231,18,24,-6
13,13,232,16,14,2
13,13,233,16,23,-7
13,13,234,11,8,3
13,13,235,11,19,-8
13,13,236,27,34,-7
13,13,237,9,15,-6
13,13,238,14,22,-8
13,13,239,9,10,-1
13,13,240,11,17,-6
13,13,241,6,18,-12
13,13,242,5,5,0
13,13,243,13,6,7
13,13,244,11,17,-6
13,13,245,18,17,1
13,13,246,11,18,-7
13,13,247,22,18,4
13,13,248,8,20,-12
13,13,249,22,12,10
13,13,250,2,5,-3
13,13,251,18,19,-1
13,13,252,10,20,-10
13,13,253,6,16,-10
13,13,254,14,18,-4
13,13,255,13,20,-7
13,13,256,2,14,-12
13,13,257,15,4,11
13,13,258,16,26,-10
13,13,259,14,20,-6
13,13,260,11,18,-7
13,13,261,8,18,-10
13,13,262,12,21,-9
13,13,263,31,13,18
13,13,264,12,13,-1
13,13,265,22,25,-3
13,13,266,9,15,-6
13,13,267,8,19,-11
13,13,268,10,22,-12
13,13,269,19,28,-9
13,13,270,15,10,5
13,13,271,28,29,-1
13,13,272,14,12,2
13,13,273,9,19,-10
13,13,274,7,13,-6
13,13,275,9,23,-14
13,13,276,20,19,1
13,13,277,8,19,-11
13,13,278,16,13,3
13,13,279,15,16,-1
13,13,280,15,12,3
13,13,281,11,23,-12
13,13,282,18,13,5
13,13,283,15,7,8
13,13,284,10,14,-4
13,13,285,14,15,-1
13,13,286,11,13,-2
13,13,287,17,9,8
13,13,288,31,21,10
13,13,289,8,7,1
13,13,290,3,2,1
13,13,291,17,14,3
13,13,292,17,36,-19
13,13,293,18,8,10
13,13,294,15,24,-9
13,13,295,21,23,-2
13,13,296,17,19,-2
13,13,297,11,27,-16
13,13,298,24,17,7
13,13,299,15,27,-12
14,14,0,34,22,12
14,14,1,12,17,-5
14,14,2,19,15,4
14,14,3,12,20,-8
14,14,4,16,9,7
14,14,5,12,20,-8
14,14,6,27,14,13
14,14,7,23,11,12
14,14,8,26,20,6
14,14,9,22,12,10
14,14,10,20,6,14
14,14,11,4,14,-10
14,14,12,16,3,13
14,14,13,17,13,4
14,14,14,21,27,-6
14,14,15,10,15,-5
14,14,16,17,26,-9
14,14,17,26,18,8
14,14,18,11,3,8
14,14,19,11,23,-12
14,14,20,28,18,10
14,14,21,11,9,2
14,14,22,10,30,-20
14,14,23,10,10,0
14,14,24,10,14,-4
14,14,25,14,16,-2
14,14,26,12,14,-2
14,14,27,9,14,-5
14,14,28,7,8,-1
14,14,29,20,20,0
14,14,30,15,21,-6
14,14,31,20,12,8
14,14,32,17,11,6
14,14,33,13,24,-11
14,14,34,8,16,-8
14,14,35,14,17,-3
14,14,36,16,15,1
14,14,37,13,12,1
14,14,38,19,10,9
14,14,39,12,14,-2
14,14,40,17,19,-2
14,14,41,14,24,-10
14,14,42,8,10,-2
14,14,43,10,16,-6
14,14,44,12,12,0
14,14,45,9,19,-10
14,14,46,14,16,-2
14,14,47,13,24,-11
14,14,48,20,8,12
14,14,49,6,24,-18
14,14,50,17,11,6
14,14,51,15,21,-6
14,14,52,15,16,-1
14,14,53,21,23,-2
14,14,54,15,20,-5
14,14,55,13,11,2
14,14,56,10,15,-5
14,14,57,22,12,10
14,14,58,11,12,-1
14,14,59,25,6,19
14,14,60,21,24,-3
14,14,61,10,8,2
14,14,62,8,27,-19
14,14,63,21,13,8
14,14,64,21,31,-10
14,14,65,11,16,-5
14,14,66,23,32,-9
14,14,67,7,18,-11
14,14,68,20,26,-6
14,14,69,18,21,-3
14,14,70,19,13,6
14,14,71,11,11,0
14,14,72,5,4,1
14,14,73,20,22,-2
14,14,74,7,31,-24
14,14,75,9,7,2
14,14,76,16,12,4
14,14,77,4,13,-9
14,14,78,5,7,-2
14,14,79,14,9,5
14,14,80,7,6,1
14,14,81,6,13,-7
14,14,82,15,17,-2
14,14,83,16,20,-4
14,14,84,34,18,16
14,14,85,13,16,-3
14,14,86,19,24,-5
14,14,87,14,15,-1
14,14,88,22,19,3
14,14,89,12,7,5
14,14,90,25,28,-3
14,14,91,28,17,11
14,14,92,10,26,-16
14,14,93,15,36,-21
14,14,94,14,21,-7
14,14,95,13,21,-8
14,14,96,16,18,-2
14,14,97,23,21,2
14,14,98,15,23,-8
14,14,99,14,19,-5
14,14,100,10,19,-9
14,14,101,14,18,-4
14,14,102,8,16,-8
14,14,103,23,18,5
14,14,104,10,10,0
14,14,105,16,6,10
14,14,106,10,23,-13
14,14,107,25,22,3
14,14,108,10,22,-12
14,14,109,18,17,1
14,14,110,18,16,2
14,14,111,22,20,2
14,14,112,21,9,12
14,14,113,13,16,-3
14,14,114,25,20,5
14,14,115,17,12,5
14,14,116,16,19,-3
14,14,117,16,10,6
14,14,118,14,14,0
14,14,119,11,14,-3
14,14,120,17,24,-7
14,14,121,15,14,1
14,14,122,25,17,8
14,14,123,17,11,6
14,14,124,11,13,-2
14,14,125,12,3,9
14,14,126,20,20,0
14,14,127,6,12,-6
14,14,128,25,17,8
14,14,129,18,23,-5
14,14,130,5,4,1
14,14,131,21,14,7
14,14,132,26,23,3
14,14,133,18,18,0
14,14,134,22,9,13
14,14,135,19,21,-2
14,14,136,5,16,-11
14,14,137,13,9,4
14,14,138,15,15,0
14,14,139,17,15,2
14,14,140,8,16,-8
14,14,141,15,17,-2
14,14,142,27,11,16
14,14,143,25,24,1
14,14,144,32,16,16
14,14,145,16,23,-7
14,14,146,9,18,-9
14,14,147,19,16,3
14,14,148,9,22,-13
14,14,149,18,17,1
14,14,150,10,20,-10
14,14,151,11,21,-10
14,14,152,16,26,-10
14,14,153,15,16,-1
14,14,154,7,23,-16
14,14,155,7,20,-13
14,14,156,12,11,1
14,14,157,15,18,-3
14,14,158,13,15,-2
14,14,159,21,14,7
14,14,160,28,21,7
14,14,161,26,3,23
14,14,162,18,20,-2
14,14,163,11,9,2
14,14,164,24,30,-6
14,14,165,16,11,5
14,14,166,6,18,-12
14,14,167,19,8,11
14,14,168,17,14,3
14,14,169,15,10,5
14,14,170,12,14,-2
14,14,171,11,11,0
14,14,172,11,23,-12
14,14,173,17,18,-1
14,14,174,7,8,-1
14,14,175,19,16,3
14,14,176,6,30,-24
14,14,177,14,24,-10
14,14,178,9,10,-1
14,14,179,18,11,7
14,14,180,15,6,9
14,14,181,23,23,0
14,14,182,17,23,-6
14,14,183,9,11,-2
14,14,184,6,10,-4
14,14,185,22,9,13
14,14,186,22,21,1
14,14,187,14,18,-4
14,14,188,16,26,-10
14,14,189,22,21,1
14,14,190,19,10,9
14,14,191,24,30,-6
14,14,192,17,21,-4
14,14,193,14,10,4
14,14,194,21,14,7
14,14,195,9,11,-2
14,14,196,15,10,5
14,14,197,1,7,-6
14,14,198,14,3,11
14,14,199,18,22,-4
14,14,200,12,20,-8
14,14,201,20,11,9
14,14,202,21,11,10
14,14,203,10,10,0
14,14,204,18,32,-14
14,14,205,18,15,3
14,14,206,13,15,-2
14,14,207,5,16,-11
14,14,208,11,16,-5
14,14,209,23,14,9
14,14,210,18,13,5
14,14,211,17,18,-1
14,14,212,16,17,-1
14,14,213,17,21,-4
14,14,214,20,26,-6
14,14,215,10,15,-5
14,14,216,14,14,0
14,14,217,14,22,-8
14,14,218,10,10,0
14,14,219,16,13,3
14,14,220,8,11,-3
14,14,221,18,30,-12
14,14,222,24,10,14
14,14,223,20,10,10
14,14,224,17,21,-4
14,14,225,9,6,3
14,14,226,4,12,-8
14,14,227,9,15,-6
14,14,228,6,13,-7
14,14,229,20,20,0
14,14,230,15,26,-11
14,14,231,25,19,6
14,14,232,11,25,-14
14,14,233,19,14,5
14,14,234,12,33,-21
14,14,235,18,13,5
14,14,236,8,3,5
14,14,237,10,15,-5
14,14,238,18,25,-7
14,14,239,15,11,4
14,14,240,16,13,3
14,14,241,12,12,0
14,14,242,4,8,-4
14,14,243,10,10,0
14,14,244,19,21,-2
14,14,245,12,13,-1
14,14,246,8,14,-6
14,14,247,20,20,0
14,14,248,5,11,-6
14,14,249,25,21,4
14,14,250,13,18,-5
14,14,251,11,7,4
14,14,252,5,16,-11
14,14,253,7,14,-7
14,14,254,14,18,-4
14,14,255,13,23,-10
14,14,256,19,24,-5
14,14,257,11,18,-7
14,14,258,18,12,6
14,14,259,21,24,-3
14,14,260,22,17,5
14,14,261,9,16,-7
14,14,262,10,14,-4
14,14,263,8,9,-1
14,14,264,12,18,-6
14,14,265,26,13,13
14,14,266,11,9,2
14,14,267,17,16,1
14,14,268,6,21,-15
14,14,269,22,11,11
14,14,270,10,9,1
14,14,271,8,7,1
14,14,272,7,6,1
14,14,273,15,15,0
14,14,274,20,19,1
14,14,275,34,9,25
14,14,276,17,15,2
14,14,277,10,13,-3
14,14,278,19,21,-2
14,14,279,11,12,-1
14,14,280,7,12,-5
14,14,281,14,21,-7
14,14,282,4,11,-7
14,14,283,9,17,-8
14,14,284,16,10,6
14,14,285,7,9,-2
14,14,286,21,30,-9
14,14,287,10,12,-2
14,14,288,22,19,3
14,14,289,18,18,0
14,14,290,17,17,0
14,14,291,7,9,-2
14,14,292,6,19,-13
14,14,293,16,15,1
14,14,294,9,17,-8
14,14,295,18,12,6
14,14,296,12,23,-11
14,14,297,16,13,3
14,14,298,16,22,-6
14,14,299,7,21,-14
15,15,0,16,13,3
15,15,1,23,21,2
15,15,2,9,19,-10
15,15,3,6,22,-16
15,15,4,8,21,-13
15,15,5,6,16,-10
15,15,6,16,14,2
15,15,7,16,13,3
15,15,8,20,9,11
15,15,9,16,25,-9
15,15,10,17,13,4
15,15,11,7,9,-2
15,15,12,13,15,-2
15,15,13,9,32,-23
15,15,14,19,12,7
15,15,15,3,5,-2
15,15,16,4,26,-22
15,15,17,26,12,14
15,15,18,11,12,-1
15,15,19,9,8,1
15,15,20,7,4,3
15,15,21,15,6,9
15,15,22,17,19,-2
15,15,23,24,24,0
15,15,24,9,10,-1
15,15,25,28,17,11
15,15,26,20,30,-10
15,15,27,5,24,-19
15,15,28,12,6,6
15,15,29,13,19,-6
15,15,30,11,22,-11
15,15,31,23,25,-2
15,15,32,18,18,0
15,15,33,26,17,9
15,15,34,15,8,7
15,15,35,11,20,-9
15,15,36,7,9,-2
15,15,37,5,19,-14
15,15,38,16,15,1
15,15,39,19,9,10
15,15,40,13,15,-2
15,15,41,23,12,11
15,15,42,13,9,4
15,15,43,16,23,-7
15,15,44,14,8,6
15,15,45,7,17,-10
15,15,46,18,20,-2
15,15,47,15,32,-17
15,15,48,11,18,-7
15,15,49,5,6,-1
15,15,50,14,20,-6
15,15,51,24,20,4
15,15,52,16,12,4
15,15,53,13,14,-1
15,15,54,10,4,6
15,15,55,14,18,-4
15,15,56,9,19,-10
15,15,57,7,8,-1
15,15,58,8,11,-3
15,15,59,26,21,5
15,15,60,14,17,-3
15,15,61,1,7,-6
15,15,62,10,18,-8
15,15,63,7,10,-3
15,15,64,9,8,1
15,15,65,6,13,-7
15,15,66,29,29,0
15,15,67,20,23,-3
15,15,68,18,20,-2
15,15,69,7,18,-11
15,15,70,7,7,0
15,15,71,10,10,0
15,15,72,18,10,8
15,15,73,15,28,-13
15,15,74,29,23,6
15,15,75,6,17,-11
15,15,76,8,19,-11
15,15,77,14,11,3
15,15,78,14,27,-13
15,15,79,16,22,-6
15,15,80,18,19,-1
15,15,81,22,27,-5
15,15,82,16,17,-1
15,15,83,18,18,0
15,15,84,8,14,-6
15,15,85,31,11,20
15,15,86,14,32,-18
15,15,87,12,24,-12
15,15,88,8,16,-8
15,15,89,9,17,-8
15,15,90,3,19,-16
15,15,91,13,32,-19
15,15,92,18,24,-6
15,15,93,10,15,-5
15,15,94,16,23,-7
15,15,95,34,20,14
15,15,96,20,26,-6
15,15,97,19,31,-12
15,15,98,13,15,-2
15,15,99,11,6,5
15,15,100,15,24,-9
15,15,101,9,7,2
15,15,102,20,18,2
15,15,103,17,23,-6
15,15,104,23,12,11
15,15,105,25,18,7
15,15,106,17,25,-8
15,15,107,9,9,0
15,15,108,14,14,0
15,15,109,18,31,-13
15,15,110,13,6,7
15,15,111,18,15,3
15,15,112,7,16,-9
15,15,113,10,16,-6
15,15,114,12,11,1
15,15,115,19,14,5
15,15,116,14,14,0
15,15,117,6,20,-14
15,15,118,15,21,-6
15,15,119,9,13,-4
15,15,120,5,12,-7
15,15,121,8,26,-18
15,15,122,15,12,3
15,15,123,8,17,-9
15,15,124,15,13,2
15,15,125,10,7,3
15,15,126,14,20,-6
15,15,127,26,16,10
15,15,128,18,13,5
15,15,129,20,21,-1
15,15,130,10,11,-1
15,15,131,9,30,-21
15,15,132,8,18,-10
15,15,133,7,12,-5
15,15,134,20,18,2
15,15,135,6,6,0
15,15,136,14,29,-15
15,15,137,23,30,-7
15,15,138,20,15,5
15,15,139,13,22,-9
15,15,140,13,21,-8
15,15,141,19,43,-24
15,15,142,5,14,-9
15,15,143,13,20,-7
15,15,144,29,14,15
15,15,145,10,12,-2
15,15,146,8,7,1
15,15,147,14,11,3
15,15,148,9,14,-5
15,15,149,23,16,7
15,15,150,13,21,-8
15,15,151,9,11,-2
15,15,152,23,7,16
15,15,153,19,11,8
15,15,154,20,13,7
15,15,155,17,11,6
15,15,156,13,18,-5
15,15,157,17,18,-1
15,15,158,17,15,2
15,15,159,19,8,11
15,15,160,20,23,-3
15,15,161,8,6,2
15,15,162,8,9,-1
15,15,163,9,17,-8
15,15,164,8,8,0
15,15,165,23,18,5
15,15,166,13,11,2
15,15,167,8,12,-4
15,15,168,13,17,-4
15,15,169,19,12,7
15,15,170,6,7,-1
15,15,171,13,17,-4
15,15,172,17,18,-1
15,15,173,7,23,-16
15,15,174,15,24,-9
15,15,175,12,17,-5
15,15,176,11,12,-1
15,15,177,6,18,-12
15,15,178,5,15,-10
15,15,179,14,17,-3
15,15,180,9,22,-13
15,15,181,15,22,-7
15,15,182,20,15,5
15,15,183,7,8,-1
15,15,184,20,24,-4
15,15,185,10,19,-9
15,15,186,21,18,3
15,15,187,7,17,-10
15,15,188,12,22,-10
15,15,189,14,17,-3
15,15,190,18,22,-4
15,15,191,15,25,-10
15,15,192,20,12,8
15,15,193,20,10,10
15,15,194,8,7,1
15,15,195,9,24,-15
15,15,196,7,11,-4
15,15,197,9,28,-19
15,15,198,6,15,-9
15,15,199,7,19,-12
15,15,200,11,10,1
15,15,201,11,12,-1
15,15,202,24,32,-8
15,15,203,10,14,-4
15,15,204,10,17,-7
15,15,205,20,31,-11
15,15,206,13,8,5
15,15,207,13,14,-1
15,15,208,11,26,-15
15,15,209,13,16,-3
15,15,210,8,6,2
15,15,211,15,10,5
15,15,212,12,12,0
15,15,213,17,13,4
15,15,214,1,9,-8
15,15,215,6,11,-5
15,15,216,15,21,-6
15,15,217,15,17,-2
15,15,218,14,19,-5
15,15,219,9,11,-2
15,15,220,17,25,-8
15,15,221,24,15,9
15,15,222,10,8,2
15,15,223,16,14,2
15,15,224,11,16,-5
15,15,225,6,13,-7
15,15,226,15,33,-18
15,15,227,30,18,12
15,15,228,11,16,-5
15,15,229,9,9,0
15,15,230,6,14,-8
15,15,231,25,22,3
15,15,232,16,18,-2
15,15,233,15,18,-3
15,15,234,8,13,-5
15,15,235,23,13,10
15,15,236,26,15,11
15,15,237,17,14,3
15,15,238,20,9,11
15,15,239,10,20,-10
15,15,240,27,13,14
15,15,241,12,20,-8
15,15,242,13,11,2
15,15,243,6,13,-7
15,15,244,14,20,-6
15,15,245,17,23,-6
15,15,246,19,12,7
15,15,247,21,28,-7
15,15,248,13,22,-9
15,15,249,23,18,5
15,15,250,10,26,-16
15,15,251,11,14,-3
15,15,252,16,15,1
15,15,253,14,7,7
15,15,254,10,24,-14
15,15,255,12,27,-15
15,15,256,5,6,-1
15,15,257,8,10,-2
15,15,258,10,21,-11
15,15,259,21,20,1
15,15,260,9,23,-14
15,15,261,18,22,-4
15,15,262,15,29,-14
15,15,263,12,20,-8
15,15,264,19,21,-2
15,15,265,15,15,0
15,15,266,17,18,-1
15,15,267,25,18,7
15,15,268,6,15,-9
15,15,269,8,16,-8
15,15,270,25,21,4
15,15,271,10,12,-2
15,15,272,19,7,12
15,15,273,18,15,3
15,15,274,13,16,-3
15,15,275,11,18,-7
15,15,276,14,15,-1
15,15,277,8,18,-10
15,15,278,26,18,8
15,15,279,8,14,-6
15,15,280,33,20,13
15,15,281,18,18,0
15,15,282,2,12,-10
15,15,283,7,9,-2
15,15,284,8,15,-7
15,15,285,22,10,12
15,15,286,11,22,-11
15,15,287,12,5,7
15,15,288,12,12,0
15,15,289,17,14,3
15,15,290,14,20,-6
15,15,291,21,30,-9
15,15,292,15,16,-1
15,15,293,12,13,-1
15,15,294,6,22,-16
15,15,295,6,7,-1
15,15,296,8,21,-13
15,15,297,14,15,-1
15,15,298,18,10,8
15,15,299,7,23,-16
16,16,0,15,12,3
16,16,1,14,15,-1
16,16,2,15,11,4
16,16,3,5,15,-10
16,16,4,18,21,-3
16,16,5,14,30,-16
16,16,6,11,13,-2
16,16,7,19,19,0
16,16,8,17,12,5
16,16,9,10,16,-6
16,16,10,2,9,-7
16,16,11,8,11,-3
16,16,12,11,13,-2
16,16,13,7,14,-7
16,16,14,6,5,1
16,16,15,11,13,-2
16,16,16,5,23,-18
16,16,17,22,21,1
16,16,18,16,13,3
16,16,19,9,19,-10
16,16,20,15,19,-4
16,16,21,28,23,5
16,16,22,27,43,-16
16,16,23,18,19,-1
16,16,24,16,9,7
16,16,25,9,23,-14
16,16,26,10,22,-12
16,16,27,20,26,-6
16,16,28,14,13,1
16,16,29,10,11,-1
16,16,30,12,18,-6
16,16,31,11,16,-5
16,16,32,17,5,12
16,16,33,7,14,-7
16,16,34,13,12,1
16,16,35,14,9,5
16,16,36,11,24,-13
16,16,37,17,20,-3
16,16,38,12,17,-5
16,16,39,20,17,3
16,16,40,9,9,0
16,16,41,23,25,-2
16,16,42,20,23,-3
16,16,43,9,9,0
16,16,44,15,29,-14
16,16,45,14,20,-6
16,16,46,28,13,15
16,16,47,9,14,-5
16,16,48,7,4,3
16,16,49,18,10,8
16,16,50,16,9,7
16,16,51,11,11,0
16,16,52,6,8,-2
16,16,53,19,19,0
16,16,54,15,17,-2
16,16,55,5,10,-5
16,16,56,4,14,-10
16,16,57,24,24,0
16,16,58,17,16,1
16,16,59,23,4,19
16,16,60,14,14,0
16,16,61,4,21,-17
16,16,62,9,19,-10
16,16,63,16,7,9
16,16,64,24,16,8
16,16,65,17,14,3
16,16,66,11,18,-7
16,16,67,17,11,6
16,16,68,12,9,3
16,16,69,8,13,-5
16,16,70,9,13,-4
16,16,71,18,14,4
16,16,72,19,24,-5
16,16,73,8,7,1
16,16,74,8,13,-5
16,16,75,19,24,-5
16,16,76,14,32,-18
16,16,77,15,27,-12
16,16,78,15,17,-2
16,16,79,3,13,-10
16,16,80,4,5,-1
16,16,81,5,11,-6
16,16,82,13,31,-18
16,16,83,14,18,-4
16,16,84,14,15,-1
16,16,85,13,9,4
16,16,86,13,18,-5
16,16,87,8,6,2
16,16,88,16,26,-10
16,16,89,10,18,-8
16,16,90,14,24,-10
16,16,91,22,12,10
16,16,92,17,15,2
16,16,93,4,10,-6
16,16,94,7,15,-8
16,16,95,18,14,4
16,16,96,20,10,10
16,16,97,19,11,8
16,16,98,17,14,3
16,16,99,11,16,-5
16,16,100,15,14,1
16,16,101,12,15,-3
16,16,102,11,16,-5
16,16,103,10,10,0
16,16,104,16,14,2
16,16,105,25,11,14
16,16,106,12,14,-2
16,16,107,14,24,-10
16,16,108,10,21,-11
16,16,109,3,21,-18
16,16,110,7,21,-14
16,16,111,21,16,5
16,16,112,11,12,-1
16,16,113,13,25,-12
16,16,114,13,17,-4
16,16,115,13,25,-12
16,16,116,23,11,12
16,16,117,18,21,-3
16,16,118,16,19,-3
16,16,119,19,13,6
16,16,120,11,20,-9
16,16,121,9,16,-7
16,16,122,14,9,5
16,16,123,18,14,4
16,16,124,25,31,-6
16,16,125,12,8,4
16,16,126,13,13,0
16,16,127,20,15,5
16,16,128,14,7,7
16,16,129,15,8,7
16,16,130,14,14,0
16,16,131,21,6,15
16,16,132,15,10,5
16,16,133,4,10,-6
16,16,134,12,9,3
16,16,135,21,9,12
16,16,136,21,27,-6
16,16,137,11,20,-9
16,16,138,8,13,-5
16,16,139,12,15,-3
16,16,140,12,10,2
16,16,141,32,16,16
16,16,142,14,6,8
16,16,143,10,18,-8
16,16,144,5,11,-6
16,16,145,10,16,-6
16,16,146,8,7,1
16,16,147,22,26,-4
16,16,148,13,18,-5
16,16,149,11,13,-2
16,16,150,24,19,5
16,16,151,13,15,-2
16,16,152,9,6,3
16,16,153,13,12,1
16,16,154,4,8,-4
16,16,155,12,10,2
16,16,156,24,16,8
16,16,157,16,27,-11
16,16,158,11,14,-3
16,16,159,10,12,-2
16,16,160,10,22,-12
16,16,161,8,14,-6
16,16,162,6,11,-5
16,16,163,20,12,8
16,16,164,10,17,-7
16,16,165,14,14,0
16,16,166,15,5,10
16,16,167,29,22,7
16,16,168,16,18,-2
16,16,169,10,8,2
16,16,170,9,15,-6
16,16,171,22,10,12
16,16,172,8,21,-13
16,16,173,13,11,2
16,16,174,13,31,-18
16,16,175,13,13,0
16,16,176,24,26,-2
16,16,177,18,12,6
16,16,178,18,15,3
16,16,179,5,16,-11
16,16,180,22,27,-5
16,16,181,15,7,8
16,16,182,5,16,-11
16,16,183,10,16,-6
16,16,184,11,15,-4
16,16,185,11,29,-18
16,16,186,19,7,12
16,16,187,18,24,-6
16,16,188,7,18,-11
16,16,189,13,9,4
16,16,190,24,24,0
16,16,191,18,13,5
16,16,192,14,23,-9
16,16,193,4,8,-4
16,16,194,6,7,-1
16,16,195,18,18,0
16,16,196,18,20,-2
16,16,197,11,10,1
16,16,198,8,22,-14
16,16,199,1,6,-5
16,16,200,18,24,-6
16,16,201,18,15,3
16,16,202,6,7,-1
16,16,203,23,14,9
16,16,204,14,12,2
16,16,205,13,17,-4
16,16,206,26,19,7
16,16,207,3,13,-10
16,16,208,12,15,-3
16,16,209,13,19,-6
16,16,210,24,19,5
16,16,211,16,13,3
16,16,212,17,20,-3
16,16,213,8,24,-16
16,16,214,18,14,4
16,16,215,15,10,5
16,16,216,18,20,-2
16,16,217,12,14,-2
16,16,218,9,9,0
16,16,219,14,10,4
16,16,220,8,20,-12
16,16,221,12,8,4
16,16,222,13,17,-4
16,16,223,16,13,3
16,16,224,31,15,16
16,16,225,16,19,-3
16,16,226,14,16,-2
16,16,227,8,13,-5
16,16,228,5,19,-14
16,16,229,17,24,-7
16,16,230,18,27,-9
16,16,231,27,21,6
16,16,232,18,30,-12
16,16,233,7,17,-10
16,16,234,10,14,-4
16,16,235,19,15,4
16,16,236,13,8,5
16,16,237,15,16,-1
16,16,238,14,16,-2
16,16,239,17,21,-4
16,16,240,18,12,6
16,16,241,18,25,-7
16,16,242,23,21,2
16,16,243,14,25,-11
16,16,244,25,25,0
16,16,245,15,15,0
16,16,246,38,40,-2
16,16,247,11,13,-2
16,16,248,15,8,7
16,16,249,19,15,4
16,16,250,31,16,15
16,16,251,11,25,-14
16,16,252,19,12,7
16,16,253,27,17,10
16,16,254,21,15,6
16,16,255,16,9,7
16,16,256,17,26,-9
16,16,257,12,17,-5
16,16,258,7,10,-3
16,16,259,11,5,6
16,16,260,15,21,-6
16,16,261,7,8,-1
16,16,262,10,19,-9
16,16,263,10,18,-8
16,16,264,7,14,-7
16,16,265,22,15,7
16,16,266,8,17,-9
16,16,267,26,35,-9
16,16,268,18,25,-7
16,16,269,22,28,-6
16,16,270,7,20,-13
16,16,271,9,14,-5
16,16,272,17,22,-5
16,16,273,11,18,-7
16,16,274,10,10,0
16,16,275,11,11,0
16,16,276,9,21,-12
16,16,277,11,20,-9
16,16,278,11,4,7
16,16,279,6,12,-6
16,16,280,24,12,12
16,16,281,14,11,3
16,16,282,15,9,6
16,16,283,19,16,3
16,16,284,24,21,3
16,16,285,12,22,-10
16,16,286,15,13,2
16,16,287,19,15,4
16,16,288,9,8,1
16,16,289,18,11,7
16,16,290,15,19,-4
16,16,291,24,15,9
16,16,292,14,18,-4
16,16,293,21,22,-1
16,16,294,13,15,-2
16,16,295,12,21,-9
16,16,296,17,20,-3
16,16,297,12,13,-1
16,16,298,18,16,2
16,16,299,8,12,-4
17,17,0,20,26,-6
17,17,1,15,20,-5
17,17,2,13,24,-11
17,17,3,13,13,0
17,17,4,32,15,17
17,17,5,21,21,0
17,17,6,6,11,-5
17,17,7,20,13,7
17,17,8,11,19,-8
17,17,9,21,22,-1
17,17,10,12,6,6
17,17,11,7,8,-1
17,17,12,9,15,-6
17,17,13,19,13,6
17,17,14,11,14,-3
17,17,15,18,19,-1
17,17,16,17,8,9
17,17,17,20,17,3
17,17,18,15,9,6
17,17,19,9,20,-11
17,17,20,14,15,-1
17,17,21,9,13,-4
17,17,22,20,20,0
17,17,23,11,18,-7
17,17,24,6,19,-13
17,17,25,20,20,0
17,17,26,14,31,-17
17,17,27,22,20,2
17,17,28,17,8,9
17,17,29,17,13,4
17,17,30,11,17,-6
17,17,31,14,18,-4
17,17,32,3,5,-2
17,17,33,11,24,-13
17,17,34,11,20,-9
17,17,35,18,21,-3
17,17,36,12,11,1
17,17,37,8,10,-2
17,17,38,21,21,0
17,17,39,12,11,1
17,17,40,10,14,-4
17,17,41,10,16,-6
17,17,42,22,19,3
17,17,43,12,13,-1
17,17,44,16,13,3
17,17,45,17,24,-7
17,17,46,7,17,-10
17,17,47,17,9,8
17,17,48,8,12,-4
17,17,49,16,11,5
17,17,50,14,16,-2
17,17,51,21,30,-9
17,17,52,20,13,7
17,17,53,15,24,-9
17,17,54,10,13,-3
17,17,55,17,32,-15
17,17,56,12,14,-2
17,17,57,17,35,-18
17,17,58,18,20,-2
17,17,59,9,13,-4
17,17,60,8,11,-3
17,17,61,16,12,4
17,17,62,7,31,-24
17,17,63,13,30,-17
17,17,64,9,10,-1
17,17,65,11,7,4
17,17,66,19,32,-13
17,17,67,12,24,-12
17,17,68,9,7,2
17,17,69,13,16,-3
17,17,70,7,15,-8
17,17,71,10,25,-15
17,17,72,6,4,2
17,17,73,10,13,-3
17,17,74,8,14,-6
17,17,75,9,26,-17
17,17,76,28,19,9
17,17,77,17,35,-18
17,17,78,15,10,5
17,17,79,13,13,0
17,17,80,17,7,10
17,17,81,16,14,2
17,17,82,12,16,-4
17,17,83,11,20,-9
17,17,84,10,21,-11
17,17,85,12,13,-1
17,17,86,16,19,-3
17,17,87,22,22,0
17,17,88,5,24,-19
17,17,89,7,20,-13
17,17,90,14,11,3
17,17,91,9,12,-3
17,17,92,10,11,-1
17,17,93,13,11,2
17,17,94,15,21,-6
17,17,95,11,14,-3
17,17,96,12,20,-8
17,17,97,12,21,-9
17,17,98,13,10,3
17,17,99,9,18,-9
17,17,100,20,20,0
17,17,101,18,11,7
17,17,102,10,13,-3
17,17,103,14,20,-6
17,17,104,28,30,-2
17,17,105,11,17,-6
17,17,106,13,11,2
17,17,107,6,14,-8
17,17,108,15,21,-6
17,17,109,15,10,5
17,17,110,7,23,-16
17,17,111,25,16,9
17,17,112,17,22,-5
17,17,113,23,19,4
17,17,114,10,8,2
17,17,115,21,14,7
17,17,116,18,24,-6
17,17,117,8,14,-6
17,17,118,14,18,-4
17,17,119,18,15,3
17,17,120,13,28,-15
17,17,121,12,20,-8
17,17,122,17,10,7
17,17,123,10,22,-12
17,17,124,4,14,-10
17,17,125,18,20,-2
17,17,126,9,20,-11
17,17,127,13,18,-5
17,17,128,25,26,-1
17,17,129,10,1,9
17,17,130,10,9,1
17,17,131,8,11,-3
17,17,132,12,29,-17
17,17,133,18,19,-1
17,17,134,23,10,13
17,17,135,14,11,3
17,17,136,13,5,8
17,17,137,15,16,-1
17,17,138,13,18,-5
17,17,139,22,12,10
17,17,140,9,19,-10
17,17,141,24,23,1
17,17,142,22,23,-1
17,17,143,16,11,5
17,17,144,15,16,-1
17,17,145,17,29,-12
17,17,146,12,23,-11
17,17,147,4,16,-12
17,17,148,12,19,-7
17,17,149,23,12,11
17,17,150,14,19,-5
17,17,151,12,13,-1
17,17,152,12,14,-2
17,17,153,9,8,1
17,17,154,10,12,-2
17,17,155,19,26,-7
17,17,156,7,7,0
17,17,157,27,17,10
17,17,158,12,12,0
17,17,159,13,20,-7
17,17,160,11,16,-5
17,17,161,24,19,5
17,17,162,23,18,5
17,17,163,10,14,-4
17,17,164,6,13,-7
17,17,165,6,18,-12
17,17,166,13,13,0
17,17,167,4,8,-4
17,17,168,14,23,-9
17,17,169,9,14,-5
17,17,170,8,23,-15
17,17,171,15,12,3
17,17,172,10,24,-14
17,17,173,12,15,-3
17,17,174,10,17,-7
17,17,175,8,25,-17
17,17,176,17,8,9
17,17,177,2,8,-6
17,17,178,5,14,-9
17,17,179,11,8,3
17,17,180,22,20,2
17,17,181,9,22,-13
17,17,182,9,10,-1
17,17,183,9,15,-6
17,17,184,14,19,-5
17,17,185,23,31,-8
17,17,186,17,11,6
17,17,187,7,4,3
17,17,188,7,10,-3
17,17,189,9,16,-7
17,17,190,10,6,4
17,17,191,10,23,-13
17,17,192,15,14,1
17,17,193,15,11,4
17,17,194,14,17,-3
17,17,195,4,11,-7
17,17,196,4,16,-12
17,17,197,11,9,2
17,17,198,17,10,7
17,17,199,23,16,7
17,17,200,18,22,-4
17,17,201,15,12,3
17,17,202,12,11,1
17,17,203,15,22,-7
17,17,204,12,9,3
17,17,205,15,11,4
17,17,206,19,18,1
17,17,207,17,16,1
17,17,208,16,24,-8
17,17,209,7,7,0
17,17,210,11,12,-1
17,17,211,6,13,-7
17,17,212,15,15,0
17,17,213,11,13,-2
17,17,214,30,17,13
17,17,215,13,19,-6
17,17,216,18,11,7
17,17,217,9,8,1
17,17,218,35,7,28
17,17,219,24,24,0
17,17,220,9,7,2
17,17,221,5,8,-3
17,17,222,16,16,0
17,17,223,14,20,-6
17,17,224,14,23,-9
17,17,225,19,19,0
17,17,226,9,24,-15
17,17,227,15,10,5
17,17,228,10,17,-7
17,17,229,14,10,4
17,17,230,13,21,-8
17,17,231,6,7,-1
17,17,232,12,7,5
17,17,233,6,16,-10
17,17,234,7,10,-3
17,17,235,14,17,-3
17,17,236,12,12,0
17,17,237,5,6,-1
17,17,238,10,10,0
17,17,239,17,9,8
17,17,240,20,8,12
17,17,241,10,15,-5
17,17,242,10,13,-3
17,17,243,15,29,-14
17,17,244,18,23,-5
17,17,245,7,13,-6
17,17,246,8,20,-12
17,17,247,18,21,-3
17,17,248,17,17,0
17,17,249,10,13,-3
17,17,250,16,4,12
17,17,251,16,23,-7
17,17,252,20,14,6
17,17,253,14,12,2
17,17,254,8,13,-5
17,17,255,9,12,-3
17,17,256,23,19,4
17,17,257,27,13,14
17,17,258,7,13,-6
17,17,259,5,20,-15
17,17,260,11,12,-1
17,17,261,12,16,-4
17,17,262,12,17,-5
17,17,263,21,27,-6
17,17,264,11,5,6
17,17,265,15,19,-4
17,17,266,10,18,-8
17,17,267,13,22,-9
17,17,268,13,15,-2
17,17,269,10,11,-1
17,17,270,15,5,10
17,17,271,10,13,-3
17,17,272,10,7,3
17,17,273,17,20,-3
17,17,274,14,15,-1
17,17,275,21,18,3
17,17,276,19,16,3
17,17,277,15,21,-6
17,17,278,20,15,5
17,17,279,14,15,-1
17,17,280,18,13,5
17,17,281,12,15,-3
17,17,282,5,16,-11
17,17,283,14,24,-10
17,17,284,15,29,-14
17,17,285,11,16,-5
17,17,286,18,11,7
17,17,287,4,17,-13
17,17,288,2,6,-4
17,17,289,17,21,-4
17,17,290,22,10,12
17,17,291,8,6,2
17,17,292,17,20,-3
17,17,293,23,24,-1
17,17,294,13,10,3
17,17,295,9,25,-16
17,17,296,20,20,0
17,17,297,15,41,-26
17,17,298,15,20,-5
17,17,299,12,7,5
18,18,0,0,11,-11
18,18,1,17,8,9
18,18,2,19,26,-7
18,18,3,3,10,-7
18,18,4,24,15,9
18,18,5,26,27,-1
18,18,6,9,11,-2
18,18,7,17,17,0
18,18,8,12,14,-2
18,18,9,13,8,5
18,18,10,12,27,-15
18,18,11,11,12,-1
18,18,12,8,9,-1
18,18,13,19,23,-4
18,18,14,7,15,-8
18,18,15,8,7,1
18,18,16,11,14,-3
18,18,17,14,14,0
18,18,18,11,24,-13
18,18,19,9,6,3
18,18,20,11,26,-15
18,18,21,15,16,-1
18,18,22,17,11,6
18,18,23,3,12,-9
18,18,24,22,12,10
18,18,25,12,15,-3
18,18,26,7,7,0
18,18,27,17,18,-1
18,18,28,7,12,-5
18,18,29,24,23,1
18,18,30,7,11,-4
18,18,31,16,12,4
18,18,32,11,12,-1
18,18,33,22,25,-3
18,18,34,24,20,4
18,18,35,14,24,-10
18,18,36,7,18,-11
18,18,37,20,22,-2
18,18,38,11,16,-5
18,18,39,17,29,-12
18,18,40,10,9,1
18,18,41,20,26,-6
18,18,42,13,13,0
18,18,43,4,7,-3
18,18,44,11,14,-3
18,18,45,7,14,-7
18,18,46,8,5,3
18,18,47,14,16,-2
18,18,48,15,14,1
18,18,49,10,12,-2
18,18,50,16,21,-5
18,18,51,11,24,-13
18,18,52,15,15,0
18,18,53,13,13,0
18,18,54,9,11,-2
18,18,55,16,28,-12
18,18,56,7,12,-5
18,18,57,9,15,-6
18,18,58,13,16,-3
18,18,59,5,17,-12
18,18,60,7,8,-1
18,18,61,17,15,2
18,18,62,10,12,-2
18,18,63,14,10,4
18,18,64,9,11,-2
18,18,65,19,19,0
18,18,66,9,11,-2
18,18,67,12,36,-24
18,18,68,13,21,-8
18,18,69,16,28,-12
18,18,70,8,5,3
18,18,71,15,23,-8
18,18,72,13,11,2
18,18,73,15,19,-4
18,18,74,16,26,-10
18,18,75,10,12,-2
18,18,76,23,29,-6
18,18,77,13,12,1
18,18,78,15,21,-6
18,18,79,6,10,-4
18,18,80,15,18,-3
18,18,81,8,20,-12
18,18,82,8,15,-7
18,18,83,17,18,-1
18,18,84,20,21,-1
18,18,85,17,6,11
18,18,86,14,15,-1
18,18,87,24,16,8
18,18,88,12,13,-1
18,18,89,15,16,-1
18,18,90,24,18,6
18,18,91,15,20,-5
18,18,92,18,27,-9
18,18,93,16,19,-3
18,18,94,12,18,-6
18,18,95,8,16,-8
18,18,96,14,17,-3
18,18,97,24,16,8
18,18,98,5,13,-8
18,18,99,6,15,-9
18,18,100,8,10,-2
18,18,101,25,14,11
18,18,102,4,11,-7
18,18,103,6,4,2
18,18,104,14,17,-3
18,18,105,14,4,10
18,18,106,20,29,-9
18,18,107,11,16,-5
18,18,108,7,10,-3
18,18,109,21,14,7
18,18,110,16,31,-15
18,18,111,13,23,-10
18,18,112,11,12,-1
18,18,113,13,19,-6
18,18,114,26,23,3
18,18,115,19,8,11
18,18,116,17,17,0
18,18,117,13,16,-3
18,18,118,14,26,-12
18,18,119,16,10,6
18,18,120,19,14,5
18,18,121,15,16,-1
18,18,122,15,4,11
18,18,123,13,8,5
18,18,124,15,17,-2
18,18,125,5,17,-12
18,18,126,10,31,-21
18,18,127,4,10,-6
18,18,128,13,13,0
18,18,129,15,22,-7
18,18,130,12,10,2
18,18,131,3,9,-6
18,18,132,11,16,-5
18,18,133,18,9,9
18,18,134,10,8,2
18,18,135,15,7,8
18,18,136,18,16,2
18,18,137,6,9,-3
18,18,138,5,6,-1
18,18,139,15,11,4
18,18,140,5,14,-9
18,18,141,6,11,-5
18,18,142,10,18,-8
18,18,143,7,18,-11
18,18,144,15,10,5
18,18,145,10,15,-5
18,18,146,18,21,-3
18,18,147,13,16,-3
18,18,148,12,11,1
18,18,149,11,15,-4
18,18,150,12,13,-1
18,18,151,23,31,-8
18,18,152,31,27,4
18,18,153,9,9,0
18,18,154,11,24,-13
18,18,155,13,16,-3
18,18,156,19,21,-2
18,18,157,3,12,-9
18,18,158,4,11,-7
18,18,159,5,4,1
18,18,160,12,21,-9
18,18,161,18,17,1
18,18,162,8,15,-7
18,18,163,7,12,-5
18,18,164,17,23,-6
18,18,165,11,19,-8
18,18,166,15,15,0
18,18,167,7,8,-1
18,18,168,5,6,-1
18,18,169,11,10,1
18,18,170,20,29,-9
18,18,171,18,7,11
18,18,172,24,19,5
18,18,173,6,19,-13
18,18,174,19,17,2
18,18,175,11,17,-6
18,18,176,15,26,-11
18,18,177,19,16,3
18,18,178,12,11,1
18,18,179,15,25,-10
18,18,180,7,22,-15
18,18,181,14,11,3
18,18,182,21,34,-13
18,18,183,22,18,4
18,18,184,20,16,4
18,18,185,29,12,17
18,18,186,22,10,12
18,18,187,16,18,-2
18,18,188,12,8,4
18,18,189,10,13,-3
18,18,190,6,25,-19
18,18,191,11,15,-4
18,18,192,8,26,-18
18,18,193,11,11,0
18,18,194,20,27,-7
18,18,195,15,18,-3
18,18,196,6,6,0
18,18,197,11,10,1
18,18,198,14,32,-18
18,18,199,11,20,-9
18,18,200,22,12,10
18,18,201,18,8,10
18,18,202,13,10,3
18,18,203,12,13,-1
18,18,204,12,14,-2
18,18,205,11,14,-3
18,18,206,23,17,6
18,18,207,10,12,-2
18,18,208,13,6,7
18,18,209,21,32,-11
18,18,210,6,19,-13
18,18,211,17,14,3
18,18,212,13,12,1
18,18,213,16,26,-10
18,18,214,12,10,2
18,18,215,14,17,-3
18,18,216,11,14,-3
18,18,217,13,26,-13
18,18,218,9,6,3
18,18,219,10,14,-4
18,18,220,3,9,-6
18,18,221,7,18,-11
18,18,222,8,15,-7
18,18,223,16,29,-13
18,18,224,16,36,-20
18,18,225,3,10,-7
18,18,226,26,23,3
18,18,227,19,12,7
18,18,228,9,20,-11
18,18,229,21,16,5
18,18,230,12,12,0
18,18,231,9,16,-7
18,18,232,18,22,-4
18,18,233,6,12,-6
18,18,234,8,14,-6
18,18,235,14,14,0
18,18,236,4,12,-8
18,18,237,11,11,0
18,18,238,8,10,-2
18,18,239,8,11,-3
18,18,240,19,31,-12
18,18,241,25,12,13
18,18,242,17,11,6
18,18,243,17,8,9
18,18,244,7,23,-16
18,18,245,18,17,1
18,18,246,12,5,7
18,18,247,10,12,-2
18,18,248,11,8,3
18,18,249,16,21,-5
18,18,250,8,27,-19
18,18,251,18,14,4
18,18,252,5,16,-11
18,18,253,19,29,-10
18,18,254,5,10,-5
18,18,255,13,13,0
18,18,256,11,9,2
18,18,257,18,18,0
18,18,258,16,17,-1
18,18,259,4,8,-4
18,18,260,8,15,-7
18,18,261,25,17,8
18,18,262,22,16,6
18,18,263,16,20,-4
18,18,264,10,7,3
18,18,265,19,20,-1
18,18,266,16,14,2
18,18,267,24,14,10
18,18,268,7,11,-4
18,18,269,17,16,1
18,18,270,24,17,7
18,18,271,8,9,-1
18,18,272,13,32,-19
18,18,273,7,10,-3
18,18,274,11,19,-8
18,18,275,9,22,-13
18,18,276,8,15,-7
18,18,277,6,12,-6
18,18,278,12,27,-15
18,18,279,17,10,7
18,18,280,16,19,-3
18,18,281,19,35,-16
18,18,282,18,11,7
18,18,283,11,22,-11
18,18,284,14,6,8
18,18,285,5,8,-3
18,18,286,6,12,-6
18,18,287,18,28,-10
18,18,288,15,14,1
18,18,289,13,7,6
18,18,290,13,15,-2
18,18,291,19,24,-5
18,18,292,12,8,4
18,18,293,13,23,-10
18,18,294,9,12,-3
18,18,295,18,11,7
18,18,296,11,9,2
18,18,297,14,24,-10
18,18,298,7,15,-8
18,18,299,8,11,-3
19,19,0,17,18,-1
19,19,1,4,18,-14
19,19,2,5,8,-3
19,19,3,5,16,-11
19,19,4,9,20,-11
19,19,5,11,19,-8
19,19,6,27,25,2
19,19,7,11,25,-14
19,19,8,24,23,1
19,19,9,16,17,-1
19,19,10,14,5,9
19,19,11,18,12,6
19,19,12,10,15,-5
19,19,13,12,6,6
19,19,14,10,18,-8
19,19,15,13,13,0
19,19,16,11,21,-10
19,19,17,12,5,7
19,19,18,9,1,8
19,19,19,18,14,4
19,19,20,17,17,0
19,19,21,14,20,-6
19,19,22,6,4,2
19,19,23,14,14,0
19,19,24,16,16,0
19,19,25,15,17,-2
19,19,26,13,20,-7
19,19,27,10,25,-15
19,19,28,9,16,-7
19,19,29,12,9,3
19,19,30,16,10,6
19,19,31,19,17,2
19,19,32,21,17,4
19,19,33,16,9,7
19,19,34,6,11,-5
19,19,35,12,15,-3
19,19,36,8,18,-10
19,19,37,8,13,-5
19,19,38,26,29,-3
19,19,39,8,14,-6
19,19,40,17,21,-4
19,19,41,25,11,14
19,19,42,14,20,-6
19,19,43,11,22,-11
19,19,44,9,11,-2
19,19,45,11,8,3
19,19,46,9,16,-7
19,19,47,6,10,-4
19,19,48,12,9,3
19,19,49,10,4,6
19,19,50,11,11,0
19,19,51,23,14,9
19,19,52,4,8,-4
19,19,53,18,23,-5
19,19,54,19,30,-11
19,19,55,10,10,0
19,19,56,1,8,-7
19,19,57,26,29,-3
19,19,58,8,9,-1
19,19,59,26,32,-6
19,19,60,9,14,-5
19,19,61,17,26,-9
19,19,62,12,9,3
19,19,63,3,16,-13
19,19,64,9,19,-10
19,19,65,14,12,2
19,19,66,22,17,5
19,19,67,5,9,-4
19,19,68,4,5,-1
19,19,69,8,19,-11
19,19,70,8,11,-3
19,19,71,8,16,-8
19,19,72,10,3,7
19,19,73,14,14,0
19,19,74,4,9,-5
19,19,75,19,12,7
19,19,76,13,15,-2
19,19,77,12,18,-6
19,19,78,9,9,0
19,19,79,15,23,-8
19,19,80,6,11,-5
19,19,81,7,11,-4
19,19,82,9,9,0
19,19,83,16,25,-9
19,19,84,9,14,-5
19,19,85,11,12,-1
19,19,86,12,17,-5
19,19,87,17,10,7
19,19,88,9,7,2
19,19,89,9,4,5
19,19,90,9,15,-6
19,19,91,9,24,-15
19,19,92,15,6,9
19,19,93,22,10,12
19,19,94,21,11,10
19,19,95,28,8,20
19,19,96,18,23,-5
19,19,97,15,12,3
19,19,98,22,23,-1
19,19,99,21,23,-2
19,19,100,14,12,2
19,19,101,8,25,-17
19,19,102,9,14,-5
19,19,103,16,26,-10
19,19,104,5,9,-4
19,19,105,15,18,-3
19,19,106,12,15,-3
19,19,107,15,27,-12
19,19,108,11,19,-8
19,19,109,8,27,-19
19,19,110,13,15,-2
19,19,111,14,21,-7
19,19,112,13,17,-4
19,19,113,11,11,0
19,19,114,20,11,9
19,19,115,12,9,3
19,19,116,17,19,-2
19,19,117,9,11,-2
19,19,118,17,18,-1
19,19,119,11,17,-6
19,19,120,32,24,8
19,19,121,15,19,-4
19,19,122,18,29,-11
19,19,123,15,10,5
19,19,124,2,10,-8
19,19,125,7,18,-11
19,19,126,14,15,-1
19,19,127,17,8,9
19,19,128,2,10,-8
19,19,129,20,8,12
19,19,130,25,19,6
19,19,131,18,18,0
19,19,132,7,23,-16
19,19,133,9,9,0
19,19,134,9,21,-12
19,19,135,13,6,7
19,19,136,9,9,0
19,19,137,11,15,-4
19,19,138,7,8,-1
19,19,139,12,6,6
19,19,140,7,17,-10
19,19,141,11,6,5
19,19,142,23,22,1
19,19,143,14,14,0
19,19,144,14,19,-5
19,19,145,10,14,-4
19,19,146,10,11,-1
19,19,147,15,11,4
19,19,148,12,13,-1
19,19,149,15,11,4
19,19,150,13,6,7
19,19,151,11,21,-10
19,19,152,10,20,-10
19,19,153,8,10,-2
19,19,154,15,22,-7
19,19,155,6,14,-8
19,19,156,6,7,-1
19,19,157,10,14,-4
19,19,158,27,29,-2
19,19,159,13,17,-4
19,19,160,8,14,-6
19,19,161,13,27,-14
19,19,162,16,15,1
19,19,163,10,11,-1
19,19,164,11,8,3
19,19,165,9,15,-6
19,19,166,11,9,2
19,19,167,6,5,1
19,19,168,20,13,7
19,19,169,15,17,-2
19,19,170,8,18,-10
19,19,171,19,16,3
19,19,172,20,18,2
19,19,173,9,19,-10
19,19,174,13,26,-13
19,19,175,23,9,14
19,19,176,15,22,-7
19,19,177,18,22,-4
19,19,178,14,10,4
19,19,179,23,13,10
19,19,180,18,17,1
19,19,181,18,12,6
19,19,182,11,20,-9
19,19,183,19,21,-2
19,19,184,10,11,-1
19,19,185,14,15,-1
19,19,186,14,24,-10
19,19,187,17,19,-2
19,19,188,17,6,11
19,19,189,5,6,-1
19,19,190,12,8,4
19,19,191,14,6,8
19,19,192,9,14,-5
19,19,193,14,20,-6
19,19,194,7,10,-3
19,19,195,5,15,-10
19,19,196,13,15,-2
19,19,197,15,20,-5
19,19,198,13,16,-3
19,19,199,10,8,2
19,19,200,7,10,-3
19,19,201,21,15,6
19,19,202,15,14,1
19,19,203,20,12,8
19,19,204,15,19,-4
19,19,205,19,14,5
19,19,206,14,16,-2
19,19,207,9,15,-6
19,19,208,19,26,-7
19,19,209,14,15,-1
19,19,210,17,13,4
19,19,211,19,14,5
19,19,212,8,15,-7
19,19,213,11,10,1
19,19,214,15,10,5
19,19,215,22,15,7
19,19,216,9,8,1
19,19,217,15,9,6
19,19,218,18,17,1
19,19,219,5,15,-10
19,19,220,3,6,-3
19,19,221,18,17,1
19,19,222,12,17,-5
19,19,223,13,18,-5
19,19,224,10,16,-6
19,19,225,19,30,-11
19,19,226,25,28,-3
19,19,227,8,11,-3
19,19,228,14,5,9
19,19,229,13,17,-4
19,19,230,15,17,-2
19,19,231,11,18,-7
19,19,232,13,6,7
19,19,233,15,17,-2
19,19,234,30,22,8
19,19,235,18,15,3
19,19,236,23,15,8
19,19,237,22,13,9
19,19,238,13,13,0
19,19,239,12,19,-7
19,19,240,7,13,-6
19,19,241,14,13,1
19,19,242,27,32,-5
19,19,243,16,14,2
19,19,244,14,16,-2
19,19,245,15,21,-6
19,19,246,9,11,-2
19,19,247,14,19,-5
19,19,248,12,25,-13
19,19,249,23,29,-6
19,19,250,15,21,-6
19,19,251,6,8,-2
19,19,252,6,4,2
19,19,253,10,16,-6
19,19,254,11,13,-2
19,19,255,3,5,-2
19,19,256,6,10,-4
19,19,257,3,8,-5
19,19,258,13,5,8
19,19,259,6,24,-18
19,19,260,9,4,5
19,19,261,11,11,0
19,19,262,11,20,-9
19,19,263,10,8,2
19,19,264,13,7,6
19,19,265,11,12,-1
19,19,266,11,14,-3
19,19,267,20,13,7
19,19,268,5,4,1
19,19,269,21,8,13
19,19,270,25,21,4
19,19,271,6,13,-7
19,19,272,4,15,-11
19,19,273,19,17,2
19,19,274,16,15,1
19,19,275,14,12,2
19,19,276,14,18,-4
19,19,277,11,21,-10
19,19,278,14,18,-4
19,19,279,15,12,3
19,19,280,12,22,-10
19,19,281,9,15,-6
19,19,282,20,26,-6
19,19,283,16,10,6
19,19,284,22,23,-1
19,19,285,6,21,-15
19,19,286,16,10,6
19,19,287,16,13,3
19,19,288,14,19,-5
19,19,289,13,11,2
19,19,290,21,21,0
19,19,291,15,15,0
19,19,292,16,19,-3
19,19,293,12,13,-1
19,19,294,12,19,-7
19,19,295,10,17,-7
19,19,296,20,13,7
19,19,297,9,1,8
19,19,298,12,25,-13
19,19,299,19,14,5
20,20,0,8,7,1
20,20,1,10,11,-1
20,20,2,23,14,9
20,20,3,8,7,1
20,20,4,14,19,-5
20,20,5,7,7,0
20,20,6,8,11,-3
20,20,7,3,14,-11
20,20,8,7,19,-12
20,20,9,18,9,9
20,20,10,8,10,-2
20,20,11,16,13,3
20,20,12,17,23,-6
20,20,13,15,12,3
20,20,14,25,20,5
20,20,15,13,8,5
20,20,16,15,18,-3
20,20,17,15,15,0
20,20,18,10,13,-3
20,20,19,12,21,-9
20,20,20,8,8,0
20,20,21,10,18,-8
20,20,22,7,12,-5
20,20,23,10,6,4
20,20,24,18,13,5
20,20,25,16,24,-8
20,20,26,19,26,-7
20,20,27,7,16,-9
20,20,28,16,17,-1
20,20,29,26,21,5
20,20,30,7,17,-10
20,20,31,9,12,-3
20,20,32,13,21,-8
20,20,33,14,19,-5
20,20,34,14,13,1
20,20,35,16,17,-1
20,20,36,11,12,-1
20,20,37,12,9,3
20,20,38,16,10,6
20,20,39,6,17,-11
20,20,40,10,30,-20
20,20,41,24,21,3
20,20,42,14,17,-3
20,20,43,9,30,-21
20,20,44,14,15,-1
20,20,45,4,22,-18
20,20,46,17,17,0
20,20,47,17,18,-1
20,20,48,11,19,-8
20,20,49,11,11,0
20,20,50,16,18,-2
20,20,51,26,20,6
20,20,52,11,12,-1
20,20,53,14,18,-4
20,20,54,10,8,2
20,20,55,20,22,-2
20,20,56,14,23,-9
20,20,57,8,8,0
20,20,58,12,14,-2
20,20,59,20,11,9
20,20,60,15,16,-1
20,20,61,11,19,-8
20,20,62,15,15,0
20,20,63,11,23,-12
20,20,64,9,8,1
20,20,65,8,36,-28
20,20,66,12,12,0
20,20,67,15,6,9
20,20,68,12,27,-15
20,20,69,16,17,-1
20,20,70,37,25,12
20,20,71,16,12,4
20,20,72,24,12,12
20,20,73,10,10,0
20,20,74,12,15,-3
20,20,75,17,7,10
20,20,76,12,19,-7
20,20,77,6,8,-2
20,20,78,13,26,-13
20,20,79,16,16,0
20,20,80,21,27,-6
20,20,81,18,33,-15
20,20,82,18,11,7
20,20,83,26,22,4
20,20,84,4,20,-16
20,20,85,25,17,8
20,20,86,21,11,10
20,20,87,12,6,6
20,20,88,5,18,-13
20,20,89,22,14,8
20,20,90,9,17,-8
20,20,91,9,12,-3
20,20,92,12,9,3
20,20,93,9,8,1
20,20,94,25,13,12
20,20,95,14,17,-3
20,20,96,5,7,-2
20,20,97,26,6,20
20,20,98,11,8,3
20,20,99,11,11,0
20,20,100,9,9,0
20,20,101,16,10,6
20,20,102,9,17,-8
20,20,103,19,11,8
20,20,104,12,14,-2
20,20,105,12,9,3
20,20,106,11,9,2
20,20,107,10,5,5
20,20,108,9,17,-8
20,20,109,12,27,-15
20,20,110,14,21,-7
20,20,111,7,15,-8
20,20,112,10,18,-8
20,20,113,4,13,-9
20,20,114,13,19,-6
20,20,115,28,14,14
20,20,116,17,16,1
20,20,117,17,22,-5
20,20,118,16,20,-4
20,20,119,5,5,0
20,20,120,11,6,5
20,20,121,11,15,-4
20,20,122,8,28,-20
20,20,123,20,23,-3
20,20,124,11,8,3
20,20,125,14,12,2
20,20,126,14,16,-2
20,20,127,17,18,-1
20,20,128,16,21,-5
20,20,129,22,17,5
20,20,130,17,11,6
20,20,131,7,15,-8
20,20,132,14,11,3
20,20,133,9,5,4
20,20,134,7,18,-11
20,20,135,17,16,1
20,20,136,11,14,-3
20,20,137,18,18,0
20,20,138,13,17,-4
20,20,139,17,26,-9
20,20,140,10,7,3
20,20,141,12,7,5
20,20,142,18,10,8
20,20,143,13,18,-5
20,20,144,17,9,8
20,20,145,19,18,1
20,20,146,14,13,1
20,20,147,9,6,3
20,20,148,20,13,7
20,20,149,27,20,7
20,20,150,22,23,-1
20,20,151,16,11,5
20,20,152,15,11,4
20,20,153,21,32,-11
20,20,154,7,13,-6
20,20,155,7,11,-4
20,20,156,11,12,-1
20,20,157,15,11,4
20,20,158,15,19,-4
20,20,159,14,5,9
20,20,160,25,23,2
20,20,161,18,23,-5
20,20,162,4,16,-12
20,20,163,17,10,7
20,20,164,25,10,15
20,20,165,15,10,5
20,20,166,11,21,-10
20,20,167,22,8,14
20,20,168,11,14,-3
20,20,169,10,10,0
20,20,170,28,21,7
20,20,171,8,17,-9
20,20,172,6,18,-12
20,20,173,24,29,-5
20,20,174,13,16,-3
20,20,175,15,13,2
20,20,176,9,10,-1
20,20,177,19,15,4
20,20,178,7,20,-13
20,20,179,8,15,-7
20,20,180,15,24,-9
20,20,181,6,8,-2
20,20,182,11,7,4
20,20,183,16,23,-7
20,20,184,8,7,1
20,20,185,11,14,-3
20,20,186,15,15,0
20,20,187,13,10,3
20,20,188,8,16,-8
20,20,189,12,16,-4
20,20,190,18,14,4
20,20,191,17,22,-5
20,20,192,5,18,-13
20,20,193,12,13,-1
20,20,194,17,18,-1
20,20,195,18,36,-18
20,20,196,11,24,-13
20,20,197,18,20,-2
20,20,198,5,6,-1
20,20,199,13,7,6
20,20,200,7,5,2
20,20,201,18,19,-1
20,20,202,17,11,6
20,20,203,15,38,-23
20,20,204,19,16,3
20,20,205,6,20,-14
20,20,206,6,8,-2
20,20,207,18,25,-7
20,20,208,19,28,-9
20,20,209,6,11,-5
20,20,210,30,11,19
20,20,211,10,23,-13
20,20,212,10,15,-5
20,20,213,12,26,-14
20,20,214,9,19,-10
20,20,215,9,10,-1
20,20,216,14,23,-9
20,20,217,14,15,-1
20,20,218,15,22,-7
20,20,219,19,18,1
20,20,220,21,17,4
20,20,221,17,15,2
20,20,222,8,3,5
20,20,223,8,14,-6
20,20,224,4,15,-11
20,20,225,12,17,-5
20,20,226,24,14,10
20,20,227,16,11,5
20,20,228,16,17,-1
20,20,229,37,28,9
20,20,230,21,14,7
20,20,231,5,12,-7
20,20,232,6,7,-1
20,20,233,8,11,-3
20,20,234,5,12,-7
20,20,235,13,15,-2
20,20,236,11,18,-7
20,20,237,20,23,-3
20,20,238,7,25,-18
20,20,239,15,18,-3
20,20,240,11,10,1
20,20,241,18,16,2
20,20,242,6,15,-9
20,20,243,10,19,-9
20,20,244,9,6,3
20,20,245,10,14,-4
20,20,246,20,17,3
20,20,247,3,11,-8
20,20,248,16,17,-1
20,20,249,15,32,-17
20,20,250,5,8,-3
20,20,251,8,19,-11
20,20,252,8,9,-1
20,20,253,11,7,4
20,20,254,11,18,-7
20,20,255,3,13,-10
20,20,256,12,13,-1
20,20,257,12,23,-11
20,20,258,6,10,-4
20,20,259,21,13,8
20,20,260,6,17,-11
20,20,261,10,22,-12
20,20,262,19,13,6
20,20,263,12,11,1
20,20,264,8,10,-2
20,20,265,12,20,-8
20,20,266,4,11,-7
20,20,267,14,12,2
20,20,268,21,26,-5
20,20,269,16,20,-4
20,20,270,12,15,-3
20,20,271,9,11,-2
20,20,272,15,14,1
20,20,273,23,16,7
20,20,274,9,15,-6
20,20,275,12,20,-8
20,20,276,8,20,-12
20,20,277,20,11,9
20,20,278,18,16,2
20,20,279,7,15,-8
20,20,280,14,10,4
20,20,281,28,16,12
20,20,282,21,15,6
20,20,283,8,15,-7
20,20,284,14,13,1
20,20,285,7,11,-4
20,20,286,19,13,6
20,20,287,16,29,-13
20,20,288,16,10,6
20,20,289,22,32,-10
20,20,290,16,10,6
20,20,291,22,19,3
20,20,292,10,18,-8
20,20,293,6,19,-13
20,20,294,21,16,5
20,20,295,17,27,-10
20,20,296,8,19,-11
20,20,297,12,4,8
20,20,298,11,14,-3
20,20,299,2,10,-8
21,21,0,4,6,-2
21,21,1,21,18,3
21,21,2,23,16,7
21,21,3,5,15,-10
21,21,4,21,25,-4
21,21,5,22,16,6
21,21,6,6,13,-7
21,21,7,21,25,-4
21,21,8,20,13,7
21,21,9,19,16,3
21,21,10,27,11,16
21,21,11,19,11,8
21,21,12,18,18,0
21,21,13,15,23,-8
21,21,14,19,16,3
21,21,15,12,15,-3
21,21,16,7,7,0
21,21,17,11,18,-7
21,21,18,3,12,-9
21,21,19,6,7,-1
21,21,20,11,10,1
21,21,21,16,25,-9
21,21,22,12,10,2
21,21,23,20,16,4
21,21,24,19,21,-2
21,21,25,3,17,-14
21,21,26,17,12,5
21,21,27,11,7,4
21,21,28,5,12,-7
21,21,29,10,16,-6
21,21,30,10,12,-2
21,21,31,11,11,0
21,21,32,4,19,-15
21,21,33,23,22,1
21,21,34,16,12,4
21,21,35,17,10,7
21,21,36,9,12,-3
21,21,37,17,14,3
21,21,38,17,11,6
21,21,39,9,12,-3
21,21,40,4,12,-8
21,21,41,19,13,6
21,21,42,16,29,-13
21,21,43,5,9,-4
21,21,44,4,9,-5
21,21,45,19,26,-7
21,21,46,11,18,-7
21,21,47,8,13,-5
21,21,48,17,24,-7
21,21,49,11,17,-6
21,21,50,15,8,7
21,21,51,10,7,3
21,21,52,8,18,-10
21,21,53,11,13,-2
21,21,54,19,18,1
21,21,55,10,9,1
21,21,56,20,11,9
21,21,57,11,14,-3
21,21,58,19,19,0
21,21,59,15,15,0
21,21,60,21,14,7
21,21,61,15,8,7
21,21,62,12,16,-4
21,21,63,12,7,5
21,21,64,16,35,-19
21,21,65,9,18,-9
21,21,66,34,16,18
21,21,67,4,17,-13
21,21,68,13,27,-14
21,21,69,32,21,11
21,21,70,22,18,4
21,21,71,12,29,-17
21,21,72,14,19,-5
21,21,73,18,19,-1
21,21,74,13,9,4
21,21,75,14,21,-7
21,21,76,22,13,9
21,21,77,12,11,1
21,21,78,26,11,15
21,21,79,6,12,-6
21,21,80,11,17,-6
21,21,81,7,14,-7
21,21,82,6,8,-2
21,21,83,10,33,-23
21,21,84,9,11,-2
21,21,85,25,23,2
21,21,86,16,18,-2
21,21,87,24,5,19
21,21,88,23,18,5
21,21,89,25,13,12
21,21,90,13,22,-9
21,21,91,7,15,-8
21,21,92,2,7,-5
21,21,93,10,21,-11
21,21,94,13,7,6
21,21,95,6,14,-8
21,21,96,8,30,-22
21,21,97,11,5,6
21,21,98,10,16,-6
21,21,99,13,10,3
21,21,100,15,22,-7
21,21,101,16,14,2
21,21,102,9,13,-4
21,21,103,2,18,-16
21,21,104,15,13,2
21,21,105,6,16,-10
21,21,106,24,18,6
21,21,107,10,13,-3
21,21,108,12,9,3
21,21,109,8,10,-2
21,21,110,15,6,9
21,21,111,15,18,-3
21,21,112,15,21,-6
21,21,113,28,27,1
21,21,114,10,12,-2
21,21,115,9,14,-5
21,21,116,11,21,-10
21,21,117,7,8,-1
21,21,118,9,7,2
21,21,119,12,23,-11
21,21,120,12,11,1
21,21,121,12,17,-5
21,21,122,17,19,-2
21,21,123,5,9,-4
21,21,124,11,7,4
21,21,125,14,10,4
21,21,126,8,13,-5
21,21,127,12,7,5
21,21,128,20,16,4
21,21,129,11,18,-7
21,21,130,10,15,-5
21,21,131,4,11,-7
21,21,132,16,21,-5
21,21,133,5,8,-3
21,21,134,11,17,-6
21,21,135,21,25,-4
21,21,136,20,10,10
21,21,137,25,20,5
21,21,138,3,4,-1
21,21,139,17,18,-1
21,21,140,13,9,4
21,21,141,17,13,4
21,21,142,9,17,-8
21,21,143,16,27,-11
21,21,144,8,30,-22
21,21,145,12,14,-2
21,21,146,19,16,3
21,21,147,13,22,-9
21,21,148,25,16,9
21,21,149,12,23,-11
21,21,150,20,19,1
21,21,151,12,17,-5
21,21,152,3,12,-9
21,21,153,7,11,-4
21,21,154,9,13,-4
21,21,155,14,20,-6
21,21,156,11,10,1
21,21,157,5,9,-4
21,21,158,6,11,-5
21,21,159,10,12,-2
21,21,160,20,18,2
21,21,161,9,16,-7
21,21,162,29,18,11
21,21,163,20,27,-7
21,21,164,16,11,5
21,21,165,6,18,-12
21,21,166,12,8,4
21,21,167,14,10,4
21,21,168,19,24,-5
21,21,169,10,9,1
21,21,170,14,8,6
21,21,171,18,13,5
21,21,172,15,15,0
21,21,173,6,16,-10
21,21,174,12,20,-8
21,21,175,14,12,2
21,21,176,5,16,-11
21,21,177,14,34,-20
21,21,178,12,20,-8
21,21,179,20,20,0
21,21,180,7,11,-4
21,21,181,21,18,3
21,21,182,15,7,8
21,21,183,11,14,-3
21,21,184,13,16,-3
21,21,185,12,13,-1
21,21,186,23,16,7
21,21,187,24,15,9
21,21,188,18,19,-1
21,21,189,18,9,9
21,21,190,6,8,-2
21,21,191,7,17,-10
21,21,192,11,19,-8
21,21,193,9,14,-5
21,21,194,17,24,-7
21,21,195,12,3,9
21,21,196,8,7,1
21,21,197,14,19,-5
21,21,198,7,16,-9
21,21,199,19,5,14
21,21,200,18,15,3
21,21,201,10,13,-3
21,21,202,8,23,-15
21,21,203,20,10,10
21,21,204,14,16,-2
21,21,205,4,9,-5
21,21,206,12,18,-6
21,21,207,8,11,-3
21,21,208,9,24,-15
21,21,209,5,12,-7
21,21,210,21,11,10
21,21,211,13,14,-1
21,21,212,14,15,-1
21,21,213,10,9,1
21,21,214,14,21,-7
21,21,215,17,15,2
21,21,216,23,20,3
21,21,217,14,15,-1
21,21,218,13,21,-8
21,21,219,13,19,-6
21,21,220,8,9,-1
21,21,221,12,9,3
21,21,222,11,7,4
21,21,223,12,18,-6
21,21,224,19,24,-5
21,21,225,12,9,3
21,21,226,13,5,8
21,21,227,19,16,3
21,21,228,8,15,-7
21,21,229,10,19,-9
21,21,230,18,14,4
21,21,231,24,18,6
21,21,232,28,20,8
21,21,233,7,11,-4
21,21,234,8,13,-5
21,21,235,11,20,-9
21,21,236,8,15,-7
21,21,237,18,6,12
21,21,238,19,15,4
21,21,239,10,8,2
21,21,240,20,21,-1
21,21,241,9,14,-5
21,21,242,15,17,-2
21,21,243,9,12,-3
21,21,244,5,8,-3
21,21,245,15,20,-5
21,21,246,16,8,8
21,21,247,10,20,-10
21,21,248,23,8,15
21,21,249,12,13,-1
21,21,250,24,34,-10
21,21,251,19,13,6
21,21,252,23,18,5
21,21,253,9,20,-11
21,21,254,9,9,0
21,21,255,10,10,0
21,21,256,5,8,-3
21,21,257,13,17,-4
21,21,258,12,15,-3
21,21,259,8,25,-17
21,21,260,7,16,-9
21,21,261,30,19,11
21,21,262,19,13,6
21,21,263,10,14,-4
21,21,264,19,21,-2
21,21,265,15,23,-8
21,21,266,8,12,-4
21,21,267,16,16,0
21,21,268,8,22,-14
21,21,269,11,13,-2
21,21,270,13,19,-6
21,21,271,19,11,8
21,21,272,15,11,4
21,21,273,8,25,-17
21,21,274,20,10,10
21,21,275,16,11,5
21,21,276,3,19,-16
21,21,277,23,34,-11
21,21,278,20,16,4
21,21,279,11,23,-12
21,21,280,5,6,-1
21,21,281,11,24,-13
21,21,282,21,15,6
21,21,283,13,18,-5
21,21,284,6,16,-10
21,21,285,7,12,-5
21,21,286,10,11,-1
21,21,287,18,16,2
21,21,288,9,20,-11
21,21,289,16,9,7
21,21,290,27,27,0
21,21,291,5,14,-9
21,21,292,12,8,4
21,21,293,12,33,-21
21,21,294,12,24,-12
21,21,295,6,12,-6
21,21,296,11,15,-4
21,21,297,13,12,1
21,21,298,16,23,-7
21,21,299,14,12,2
22,22,0,23,18,5
22,22,1,9,11,-2
22,22,2,12,17,-5
22,22,3,7,5,2
22,22,4,8,14,-6
22,22,5,3,10,-7
22,22,6,11,9,2
22,22,7,8,25,-17
22,22,8,16,15,1
22,22,9,21,13,8
22,22,10,6,0,6
22,22,11,16,22,-6
22,22,12,7,13,-6
22,22,13,13,6,7
22,22,14,18,12,6
22,22,15,9,14,-5
22,22,16,10,23,-13
22,22,17,7,19,-12
22,22,18,10,7,3
22,22,19,18,30,-12
22,22,20,11,19,-8
22,22,21,9,12,-3
22,22,22,11,13,-2
22,22,23,20,20,0
22,22,24,16,17,-1
22,22,25,21,16,5
22,22,26,9,8,1
22,22,27,10,16,-6
22,22,28,15,5,10
22,22,29,16,22,-6
22,22,30,18,17,1
22,22,31,2,19,-17
22,22,32,13,19,-6
22,22,33,9,20,-11
22,22,34,14,15,-1
22,22,35,18,17,1
22,22,36,21,7,14
22,22,37,12,15,-3
22,22,38,12,19,-7
22,22,39,18,9,9
22,22,40,16,16,0
22,22,41,18,25,-7
22,22,42,27,15,12
22,22,43,8,13,-5
22,22,44,2,19,-17
22,22,45,13,6,7
22,22,46,16,13,3
22,22,47,17,22,-5
22,22,48,12,10,2
22,22,49,29,20,9
22,22,50,19,15,4
22,22,51,20,14,6
22,22,52,11,13,-2
22,22,53,15,26,-11
22,22,54,9,19,-10
22,22,55,9,32,-23
22,22,56,13,14,-1
22,22,57,6,5,1
22,22,58,15,16,-1
22,22,59,14,15,-1
22,22,60,16,18,-2
22,22,61,6,10,-4
22,22,62,11,24,-13
22,22,63,27,21,6
22,22,64,9,17,-8
22,22,65,13,11,2
22,22,66,18,20,-2
22,22,67,14,15,-1
22,22,68,6,8,-2
22,22,69,13,34,-21
22,22,70,17,29,-12
22,22,71,18,13,5
22,22,72,19,18,1
22,22,73,16,20,-4
22,22,74,17,16,1
22,22,75,8,15,-7
22,22,76,18,13,5
22,22,77,9,22,-13
22,22,78,8,11,-3
22,22,79,15,29,-14
22,22,80,20,18,2
22,22,81,12,11,1
22,22,82,19,12,7
22,22,83,10,3,7
22,22,84,12,14,-2
22,22,85,9,24,-15
22,22,86,10,14,-4
22,22,87,21,20,1
22,22,88,13,20,-7
22,22,89,7,16,-9
22,22,90,24,9,15
22,22,91,8,14,-6
22,22,92,12,14,-2
22,22,93,20,14,6
22,22,94,9,11,-2
22,22,95,9,8,1
22,22,96,16,21,-5
22,22,97,10,14,-4
22,22,98,13,12,1
22,22,99,11,20,-9
22,22,100,22,16,6
22,22,101,19,14,5
22,22,102,11,22,-11
22,22,103,13,17,-4
22,22,104,10,16,-6
22,22,105,5,12,-7
22,22,106,5,13,-8
22,22,107,15,15,0
22,22,108,9,14,-5
22,22,109,20,17,3
22,22,110,4,13,-9
22,22,111,15,18,-3
22,22,112,12,24,-12
22,22,113,13,14,-1
22,22,114,7,18,-11
22,22,115,36,23,13
22,22,116,8,17,-9
22,22,117,10,20,-10
22,22,118,17,24,-7
22,22,119,13,21,-8
22,22,120,12,14,-2
22,22,121,16,19,-3
22,22,122,9,9,0
22,22,123,3,14,-11
22,22,124,22,12,10
22,22,125,24,12,12
22,22,126,11,18,-7
22,22,127,10,10,0
22,22,128,14,15,-1
22,22,129,21,17,4
22,22,130,9,8,1
22,22,131,6,26,-20
22,22,132,4,14,-10
22,22,133,6,15,-9
22,22,134,16,11,5
22,22,135,15,14,1
22,22,136,15,19,-4
22,22,137,7,8,-1
22,22,138,14,10,4
22,22,139,7,22,-15
22,22,140,36,21,15
22,22,141,5,9,-4
22,22,142,3,19,-16
22,22,143,25,6,19
22,22,144,10,18,-8
22,22,145,14,23,-9
22,22,146,11,18,-7
22,22,147,15,25,-10
22,22,148,6,11,-5
22,22,149,13,4,9
22,22,150,5,7,-2
22,22,151,9,22,-13
22,22,152,12,12,0
22,22,153,17,22,-5
22,22,154,22,8,14
22,22,155,11,14,-3
22,22,156,18,16,2
22,22,157,8,11,-3
22,22,158,20,29,-9
22,22,159,15,20,-5
22,22,160,15,10,5
22,22,161,10,14,-4
22,22,162,11,16,-5
22,22,163,8,18,-10
22,22,164,12,13,-1
22,22,165,4,12,-8
22,22,166,15,19,-4
22,22,167,13,14,-1
22,22,168,11,9,2
22,22,169,12,11,1
22,22,170,9,13,-4
22,22,171,16,13,3
22,22,172,20,13,7
22,22,173,21,13,8
22,22,174,13,17,-4
22,22,175,9,23,-14
22,22,176,11,23,-12
22,22,177,13,14,-1
22,22,178,20,19,1
22,22,179,9,19,-10
22,22,180,11,24,-13
22,22,181,3,13,-10
22,22,182,12,12,0
22,22,183,12,23,-11
22,22,184,12,17,-5
22,22,185,7,12,-5
22,22,186,17,12,5
22,22,187,10,17,-7
22,22,188,11,5,6
22,22,189,12,16,-4
22,22,190,15,29,-14
22,22,191,7,19,-12
22,22,192,21,15,6
22,22,193,10,12,-2
22,22,194,8,22,-14
22,22,195,20,13,7
22,22,196,11,6,5
22,22,197,12,14,-2
22,22,198,11,22,-11
22,22,199,11,14,-3
22,22,200,31,22,9
22,22,201,24,12,12
22,22,202,14,17,-3
22,22,203,9,28,-19
22,22,204,11,14,-3
22,22,205,9,19,-10
22,22,206,8,9,-1
22,22,207,10,16,-6
22,22,208,13,15,-2
22,22,209,16,21,-5
22,22,210,24,26,-2
22,22,211,12,27,-15
22,22,212,8,12,-4
22,22,213,15,16,-1
22,22,214,12,20,-8
22,22,215,7,17,-10
22,22,216,12,8,4
22,22,217,20,11,9
22,22,218,8,17,-9
22,22,219,8,10,-2
22,22,220,12,30,-18
22,22,221,9,31,-22
22,22,222,9,12,-3
22,22,223,11,10,1
22,22,224,6,12,-6
22,22,225,23,10,13
22,22,226,12,22,-10
22,22,227,16,13,3
22,22,228,9,8,1
22,22,229,13,9,4
22,22,230,12,6,6
22,22,231,21,29,-8
22,22,232,5,11,-6
22,22,233,13,17,-4
22,22,234,25,11,14
22,22,235,6,5,1
22,22,236,12,24,-12
22,22,237,15,17,-2
22,22,238,11,18,-7
22,22,239,9,15,-6
22,22,240,4,17,-13
22,22,241,12,18,-6
22,22,242,16,16,0
22,22,243,17,19,-2
22,22,244,11,12,-1
22,22,245,14,22,-8
22,22,246,15,14,1
22,22,247,16,16,0
22,22,248,10,19,-9
22,22,249,3,8,-5
22,22,250,16,10,6
22,22,251,13,14,-1
22,22,252,10,11,-1
22,22,253,16,17,-1
22,22,254,20,20,0
22,22,255,8,7,1
22,22,256,11,10,1
22,22,257,12,11,1
22,22,258,22,20,2
22,22,259,11,6,5
22,22,260,6,22,-16
22,22,261,18,23,-5
22,22,262,8,19,-11
22,22,263,17,19,-2
22,22,264,20,20,0
22,22,265,12,17,-5
22,22,266,11,4,7
22,22,267,10,15,-5
22,22,268,11,22,-11
22,22,269,19,32,-13
22,22,270,11,13,-2
22,22,271,10,5,5
22,22,272,4,10,-6
22,22,273,8,11,-3
22,22,274,17,19,-2
22,22,275,13,22,-9
22,22,276,14,15,-1
22,22,277,15,12,3
22,22,278,15,27,-12
22,22,279,21,25,-4
22,22,280,17,20,-3
22,22,281,24,12,12
22,22,282,13,8,5
22,22,283,18,15,3
22,22,284,14,11,3
22,22,285,13,20,-7
22,22,286,19,8,11
22,22,287,8,8,0
22,22,288,18,20,-2
22,22,289,6,11,-5
22,22,290,6,11,-5
22,22,291,10,9,1
22,22,292,9,6,3
22,22,293,12,14,-2
22,22,294,14,17,-3
22,22,295,8,11,-3
22,22,296,11,15,-4
22,22,297,14,20,-6
22,22,298,10,7,3
22,22,299,8,14,-6
23,23,0,7,14,-7
23,23,1,7,12,-5
23,23,2,11,21,-10
23,23,3,5,11,-6
23,23,4,6,9,-3
23,23,5,6,21,-15
23,23,6,17,16,1
23,23,7,17,16,1
23,23,8,8,18,-10
23,23,9,11,11,0
23,23,10,21,28,-7
23,23,11,18,1,17
23,23,12,17,12,5
23,23,13,9,15,-6
23,23,14,24,24,0
23,23,15,9,14,-5
23,23,16,9,15,-6
23,23,17,26,13,13
23,23,18,22,6,16
23,23,19,11,14,-3
23,23,20,9,6,3
23,23,21,30,21,9
23,23,22,9,10,-1
23,23,23,18,17,1
23,23,24,9,10,-1
23,23,25,8,13,-5
23,23,26,15,24,-9
23,23,27,23,12,11
23,23,28,7,25,-18
23,23,29,20,17,3
23,23,30,9,23,-14
23,23,31,12,7,5
23,23,32,13,14,-1
23,23,33,20,23,-3
23,23,34,10,17,-7
23,23,35,22,25,-3
23,23,36,9,10,-1
23,23,37,11,11,0
23,23,38,13,14,-1
23,23,39,14,13,1
23,23,40,10,14,-4
23,23,41,23,23,0
23,23,42,13,19,-6
23,23,43,13,12,1
23,23,44,11,9,2
23,23,45,9,11,-2
23,23,46,12,10,2
23,23,47,14,30,-16
23,23,48,13,19,-6
23,23,49,12,18,-6
23,23,50,11,12,-1
23,23,51,22,20,2
23,23,52,8,8,0
23,23,53,17,14,3
23,23,54,13,11,2
23,23,55,9,20,-11
23,23,56,11,22,-11
23,23,57,15,9,6
23,23,58,15,24,-9
23,23,59,9,13,-4
23,23,60,8,14,-6
23,23,61,13,11,2
23,23,62,15,9,6
23,23,63,18,11,7
23,23,64,17,21,-4
23,23,65,13,8,5
23,23,66,8,14,-6
23,23,67,13,19,-6
23,23,68,16,15,1
23,23,69,10,10,0
23,23,70,13,14,-1
23,23,71,14,11,3
23,23,72,11,8,3
23,23,73,14,10,4
23,23,74,14,19,-5
23,23,75,11,9,2
23,23,76,14,14,0
23,23,77,11,17,-6
23,23,78,10,22,-12
23,23,79,20,10,10
23,23,80,15,13,2
23,23,81,16,13,3
23,23,82,17,16,1
23,23,83,11,18,-7
23,23,84,19,18,1
23,23,85,10,6,4
23,23,86,17,21,-4
23,23,87,16,20,-4
23,23,88,13,30,-17
23,23,89,12,16,-4
23,23,90,12,24,-12
23,23,91,12,11,1
23,23,92,8,23,-15
23,23,93,18,26,-8
23,23,94,8,8,0
23,23,95,6,12,-6
23,23,96,25,9,16
23,23,97,10,15,-5
23,23,98,6,6,0
23,23,99,8,5,3
23,23,100,16,21,-5
23,23,101,10,14,-4
23,23,102,12,13,-1
23,23,103,18,18,0
23,23,104,19,16,3
23,23,105,16,9,7
23,23,106,12,11,1
23,23,107,11,13,-2
23,23,108,7,19,-12
23,23,109,19,17,2
23,23,110,11,27,-16
23,23,111,9,11,-2
23,23,112,6,22,-16
23,23,113,12,16,-4
23,23,114,22,18,4
23,23,115,9,19,-10
23,23,116,17,16,1
23,23,117,11,17,-6
23,23,118,12,12,0
23,23,119,16,25,-9
23,23,120,15,14,1
23,23,121,12,10,2
23,23,122,13,9,4
23,23,123,8,11,-3
23,23,124,14,9,5
23,23,125,27,25,2
23,23,126,24,27,-3
23,23,127,17,15,2
23,23,128,6,13,-7
23,23,129,14,4,10
23,23,130,13,11,2
23,23,131,13,10,3
23,23,132,8,21,-13
23,23,133,16,17,-1
23,23,134,16,17,-1
23,23,135,4,10,-6
23,23,136,8,5,3
23,23,137,8,10,-2
23,23,138,13,18,-5
23,23,139,10,16,-6
23,23,140,13,9,4
23,23,141,14,22,-8
23,23,142,14,20,-6
23,23,143,11,10,1
23,23,144,30,18,12
23,23,145,12,16,-4
23,23,146,12,20,-8
23,23,147,8,27,-19
23,23,148,12,11,1
23,23,149,15,10,5
23,23,150,19,13,6
23,23,151,22,20,2
23,23,152,15,10,5
23,23,153,20,23,-3
23,23,154,5,9,-4
23,23,155,14,10,4
23,23,156,14,17,-3
23,23,157,25,21,4
23,23,158,19,13,6
23,23,159,6,17,-11
23,23,160,15,12,3
23,23,161,14,5,9
23,23,162,21,11,10
23,23,163,1,6,-5
23,23,164,14,12,2
23,23,165,14,19,-5
23,23,166,11,18,-7
23,23,167,10,18,-8
23,23,168,10,16,-6
23,23,169,12,15,-3
23,23,170,12,16,-4
23,23,171,9,16,-7
23,23,172,18,14,4
23,23,173,16,12,4
23,23,174,10,12,-2
23,23,175,15,27,-12
23,23,176,11,15,-4
23,23,177,12,22,-10
23,23,178,7,20,-13
23,23,179,25,27,-2
23,23,180,15,23,-8
23,23,181,29,27,2
23,23,182,29,17,12
23,23,183,5,9,-4
23,23,184,12,13,-1
23,23,185,14,12,2
23,23,186,14,13,1
23,23,187,12,15,-3
23,23,188,22,17,5
23,23,189,11,12,-1
23,23,190,11,24,-13
23,23,191,11,20,-9
23,23,192,15,9,6
23,23,193,19,21,-2
23,23,194,9,8,1
23,23,195,19,12,7
23,23,196,14,10,4
23,23,197,14,16,-2
23,23,198,24,17,7
23,23,199,6,15,-9
23,23,200,18,18,0
23,23,201,14,16,-2
23,23,202,13,7,6
23,23,203,18,10,8
23,23,204,9,12,-3
23,23,205,8,16,-8
23,23,206,26,16,10
23,23,207,14,21,-7
23,23,208,8,6,2
23,23,209,14,15,-1
23,23,210,16,17,-1
23,23,211,8,9,-1
23,23,212,9,5,4
23,23,213,13,28,-15
23,23,214,5,14,-9
23,23,215,27,22,5
23,23,216,9,18,-9
23,23,217,8,14,-6
23,23,218,15,19,-4
23,23,219,9,16,-7
23,23,220,19,12,7
23,23,221,7,13,-6
23,23,222,21,9,12
23,23,223,6,9,-3
23,23,224,10,15,-5
23,23,225,15,8,7
23,23,226,14,8,6
23,23,227,7,7,0
23,23,228,15,16,-1
23,23,229,4,29,-25
23,23,230,22,21,1
23,23,231,7,8,-1
23,23,232,7,14,-7
23,23,233,14,14,0
23,23,234,17,8,9
23,23,235,12,32,-20
23,23,236,13,9,4
23,23,237,6,7,-1
23,23,238,11,11,0
23,23,239,7,12,-5
23,23,240,14,24,-10
23,23,241,8,27,-19
23,23,242,11,6,5
23,23,243,29,21,8
23,23,244,14,16,-2
23,23,245,7,17,-10
23,23,246,19,31,-12
23,23,247,6,14,-8
23,23,248,8,11,-3
23,23,249,11,27,-16
23,23,250,7,21,-14
23,23,251,19,10,9
23,23,252,14,12,2
23,23,253,17,17,0
23,23,254,7,15,-8
23,23,255,11,13,-2
23,23,256,18,18,0
23,23,257,22,31,-9
23,23,258,17,6,11
23,23,259,11,17,-6
23,23,260,12,15,-3
23,23,261,12,10,2
23,23,262,18,12,6
23,23,263,6,7,-1
23,23,264,13,4,9
23,23,265,11,22,-11
23,23,266,25,17,8
23,23,267,15,6,9
23,23,268,7,11,-4
23,23,269,22,27,-5
23,23,270,14,21,-7
23,23,271,22,24,-2
23,23,272,14,24,-10
23,23,273,13,16,-3
23,23,274,10,15,-5
23,23,275,14,9,5
23,23,276,21,16,5
23,23,277,14,25,-11
23,23,278,10,6,4
23,23,279,23,30,-7
23,23,280,9,6,3
23,23,281,11,15,-4
23,23,282,16,14,2
23,23,283,5,13,-8
23,23,284,13,32,-19
23,23,285,13,14,-1
23,23,286,16,12,4
23,23,287,16,14,2
23,23,288,10,16,-6
23,23,289,12,3,9
23,23,290,11,12,-1
23,23,291,9,18,-9
23,23,292,11,17,-6
23,23,293,13,13,0
23,23,294,14,20,-6
23,23,295,4,24,-20
23,23,296,20,23,-3
23,23,297,19,13,6
23,23,298,7,7,0
23,23,299,20,39,-19
24,24,0,14,25,-11
24,24,1,13,17,-4
24,24,2,10,15,-5
24,24,3,11,7,4
24,24,4,6,9,-3
24,24,5,17,17,0
24,24,6,11,13,-2
24,24,7,17,8,9
24,24,8,14,30,-16
24,24,9,15,16,-1
24,24,10,13,17,-4
24,24,11,12,11,1
24,24,12,4,25,-21
24,24,13,20,12,8
24,24,14,11,18,-7
24,24,15,13,11,2
24,24,16,24,17,7
24,24,17,6,12,-6
24,24,18,18,12,6
24,24,19,17,6,11
24,24,20,12,15,-3
24,24,21,18,16,2
24,24,22,14,13,1
24,24,23,4,4,0
24,24,24,13,5,8
24,24,25,8,22,-14
24,24,26,14,17,-3
24,24,27,13,10,3
24,24,28,22,10,12
24,24,29,12,19,-7
24,24,30,15,16,-1
24,24,31,22,25,-3
24,24,32,5,7,-2
24,24,33,15,14,1
24,24,34,13,18,-5
24,24,35,10,5,5
24,24,36,8,12,-4
24,24,37,12,17,-5
24,24,38,10,13,-3
24,24,39,13,12,1
24,24,40,13,14,-1
24,24,41,12,15,-3
24,24,42,14,8,6
24,24,43,5,13,-8
24,24,44,15,12,3
24,24,45,6,11,-5
24,24,46,6,13,-7
24,24,47,7,15,-8
24,24,48,7,5,2
24,24,49,8,9,-1
24,24,50,10,13,-3
24,24,51,15,14,1
24,24,52,6,15,-9
24,24,53,15,20,-5
24,24,54,15,23,-8
24,24,55,4,17,-13
24,24,56,10,13,-3
24,24,57,11,13,-2
24,24,58,8,18,-10
24,24,59,11,14,-3
24,24,60,16,11,5
24,24,61,6,17,-11
24,24,62,24,18,6
24,24,63,16,20,-4
24,24,64,7,13,-6
24,24,65,8,24,-16
24,24,66,28,12,16
24,24,67,8,7,1
24,24,68,24,17,7
24,24,69,19,22,-3
24,24,70,19,17,2
24,24,71,16,21,-5
24,24,72,11,7,4
24,24,73,17,22,-5
24,24,74,10,13,-3
24,24,75,4,16,-12
24,24,76,8,20,-12
24,24,77,9,17,-8
24,24,78,18,13,5
24,24,79,20,11,9
24,24,80,17,16,1
24,24,81,8,12,-4
24,24,82,18,26,-8
24,24,83,9,15,-6
24,24,84,11,15,-4
24,24,85,5,13,-8
24,24,86,7,6,1
24,24,87,17,15,2
24,24,88,22,30,-8
24,24,89,7,6,1
24,24,90,8,16,-8
24,24,91,8,10,-2
24,24,92,9,31,-22
24,24,93,11,10,1
24,24,94,5,11,-6
24,24,95,20,16,4
24,24,96,8,7,1
24,24,97,11,19,-8
24,24,98,18,23,-5
24,24,99,13,19,-6
24,24,100,7,21,-14
24,24,101,13,10,3
24,24,102,15,14,1
24,24,103,15,15,0
24,24,104,11,7,4
24,24,105,17,16,1
24,24,106,4,12,-8
24,24,107,10,15,-5
24,24,108,9,13,-4
24,24,109,12,9,3
24,24,110,13,14,-1
24,24,111,10,15,-5
24,24,112,21,29,-8
24,24,113,12,6,6
24,24,114,6,6,0
24,24,115,11,6,5
24,24,116,9,6,3
24,24,117,7,13,-6
24,24,118,21,22,-1
24,24,119,5,3,2
24,24,120,14,16,-2
24,24,121,12,14,-2
24,24,122,21,21,0
24,24,123,5,15,-10
24,24,124,18,23,-5
24,24,125,13,16,-3
24,24,126,11,11,0
24,24,127,21,15,6
24,24,128,17,37,-20
24,24,129,9,15,-6
24,24,130,5,10,-5
24,24,131,13,9,4
24,24,132,18,16,2
24,24,133,11,21,-10
24,24,134,9,11,-2
24,24,135,7,11,-4
24,24,136,9,12,-3
24,24,137,12,31,-19
24,24,138,28,21,7
24,24,139,15,8,7
24,24,140,5,13,-8
24,24,141,8,15,-7
24,24,142,9,16,-7
24,24,143,10,20,-10
24,24,144,10,4,6
24,24,145,6,18,-12
24,24,146,10,14,-4
24,24,147,10,13,-3
24,24,148,2,4,-2
24,24,149,18,17,1
24,24,150,11,17,-6
24,24,151,19,29,-10
24,24,152,13,7,6
24,24,153,13,25,-12
24,24,154,11,16,-5
24,24,155,10,14,-4
24,24,156,11,17,-6
24,24,157,6,11,-5
24,24,158,24,18,6
24,24,159,12,14,-2
24,24,160,7,14,-7
24,24,161,16,19,-3
24,24,162,16,14,2
24,24,163,5,11,-6
24,24,164,13,9,4
24,24,165,11,23,-12
24,24,166,11,14,-3
24,24,167,24,19,5
24,24,168,9,11,-2
24,24,169,11,29,-18
24,24,170,21,24,-3
24,24,171,13,13,0
24,24,172,14,17,-3
24,24,173,7,16,-9
24,24,174,11,12,-1
24,24,175,15,15,0
24,24,176,14,13,1
24,24,177,14,25,-11
24,24,178,12,13,-1
24,24,179,8,15,-7
24,24,180,10,31,-21
24,24,181,20,22,-2
24,24,182,13,14,-1
24,24,183,17,24,-7
24,24,184,9,25,-16
24,24,185,22,15,7
24,24,186,16,19,-3
24,24,187,16,21,-5
24,24,188,11,11,0
24,24,189,20,24,-4
24,24,190,7,14,-7
24,24,191,7,11,-4
24,24,192,9,17,-8
24,24,193,10,19,-9
24,24,194,12,18,-6
24,24,195,8,16,-8
24,24,196,21,19,2
24,24,197,21,14,7
24,24,198,13,17,-4
24,24,199,11,12,-1
24,24,200,10,13,-3
24,24,201,11,9,2
24,24,202,15,12,3
24,24,203,14,8,6
24,24,204,17,21,-4
24,24,205,12,14,-2
24,24,206,12,15,-3
24,24,207,17,18,-1
24,24,208,11,12,-1
24,24,209,16,7,9
24,24,210,22,15,7
24,24,211,8,16,-8
24,24,212,11,12,-1
24,24,213,25,19,6
24,24,214,10,9,1
24,24,215,21,16,5
24,24,216,12,12,0
24,24,217,21,16,5
24,24,218,9,21,-12
24,24,219,11,25,-14
24,24,220,18,10,8
24,24,221,14,12,2
24,24,222,12,16,-4
24,24,223,8,15,-7
24,24,224,8,14,-6
24,24,225,2,4,-2
24,24,226,23,19,4
24,24,227,4,4,0
24,24,228,13,22,-9
24,24,229,9,12,-3
24,24,230,11,22,-11
24,24,231,7,21,-14
24,24,232,9,11,-2
24,24,233,12,7,5
24,24,234,10,10,0
24,24,235,2,12,-10
24,24,236,11,5,6
24,24,237,8,28,-20
24,24,238,14,16,-2
24,24,239,14,7,7
24,24,240,15,16,-1
24,24,241,19,28,-9
24,24,242,13,7,6
24,24,243,10,16,-6
24,24,244,34,35,-1
24,24,245,6,6,0
24,24,246,8,10,-2
24,24,247,10,14,-4
24,24,248,9,9,0
24,24,249,11,7,4
24,24,250,20,15,5
24,24,251,18,22,-4
24,24,252,18,11,7
24,24,253,23,29,-6
24,24,254,13,17,-4
24,24,255,16,19,-3
24,24,256,9,16,-7
24,24,257,16,8,8
24,24,258,7,4,3
24,24,259,16,21,-5
24,24,260,12,12,0
24,24,261,15,7,8
24,24,262,9,8,1
24,24,263,12,8,4
24,24,264,10,22,-12
24,24,265,6,12,-6
24,24,266,17,11,6
24,24,267,7,10,-3
24,24,268,17,17,0
24,24,269,7,13,-6
24,24,270,11,17,-6
24,24,271,11,17,-6
24,24,272,16,16,0
24,24,273,5,11,-6
24,24,274,11,16,-5
24,24,275,19,10,9
24,24,276,16,12,4
24,24,277,11,17,-6
24,24,278,8,9,-1
24,24,279,2,16,-14
24,24,280,11,11,0
24,24,281,13,9,4
24,24,282,16,11,5
24,24,283,16,10,6
24,24,284,5,10,-5
24,24,285,9,21,-12
24,24,286,11,14,-3
24,24,287,20,16,4
24,24,288,9,14,-5
24,24,289,16,21,-5
24,24,290,14,13,1
24,24,291,6,12,-6
24,24,292,3,10,-7
24,24,293,17,24,-7
24,24,294,18,23,-5
24,24,295,10,17,-7
24,24,296,12,11,1
24,24,297,3,4,-1
24,24,298,11,7,4
24,24,299,18,23,-5
25,25,0,9,13,-4
25,25,1,16,13,3
25,25,2,12,13,-1
25,25,3,8,12,-4
25,25,4,7,13,-6
25,25,5,8,5,3
25,25,6,18,14,4
25,25,7,15,25,-10
25,25,8,7,19,-12
25,25,9,10,24,-14
25,25,10,8,13,-5
25,25,11,12,14,-2
25,25,12,9,8,1
25,25,13,7,21,-14
25,25,14,8,11,-3
25,25,15,4,11,-7
25,25,16,15,14,1
25,25,17,6,9,-3
25,25,18,16,16,0
25,25,19,4,9,-5
25,25,20,13,14,-1
25,25,21,6,12,-6
25,25,22,18,7,11
25,25,23,18,21,-3
25,25,24,16,16,0
25,25,25,16,12,4
25,25,26,13,2,11
25,25,27,3,7,-4
25,25,28,9,8,1
25,25,29,5,13,-8
25,25,30,13,12,1
25,25,31,14,4,10
25,25,32,24,12,12
25,25,33,6,2,4
25,25,34,19,14,5
25,25,35,12,21,-9
25,25,36,16,10,6
25,25,37,9,8,1
25,25,38,22,14,8
25,25,39,9,10,-1
25,25,40,13,6,7
25,25,41,10,9,1
25,25,42,4,9,-5
25,25,43,16,10,6
25,25,44,10,19,-9
25,25,45,17,12,5
25,25,46,5,10,-5
25,25,47,16,13,3
25,25,48,17,15,2
25,25,49,10,11,-1
25,25,50,15,15,0
25,25,51,15,11,4
25,25,52,9,11,-2
25,25,53,14,9,5
25,25,54,10,13,-3
25,25,55,14,20,-6
25,25,56,11,8,3
25,25,57,17,27,-10
25,25,58,15,19,-4
25,25,59,7,8,-1
25,25,60,7,16,-9
25,25,61,12,14,-2
25,25,62,10,12,-2
25,25,63,17,14,3
25,25,64,16,24,-8
25,25,65,8,9,-1
25,25,66,7,10,-3
25,25,67,12,9,3
25,25,68,10,12,-2
25,25,69,11,19,-8
25,25,70,11,6,5
25,25,71,18,16,2
25,25,72,9,12,-3
25,25,73,21,11,10
25,25,74,12,20,-8
25,25,75,10,8,2
25,25,76,12,16,-4
25,25,77,15,13,2
25,25,78,12,5,7
25,25,79,9,14,-5
25,25,80,12,17,-5
25,25,81,15,9,6
25,25,82,8,15,-7
25,25,83,6,8,-2
25,25,84,6,7,-1
25,25,85,8,12,-4
25,25,86,17,20,-3
25,25,87,12,24,-12
25,25,88,7,7,0
25,25,89,13,13,0
25,25,90,9,6,3
25,25,91,19,20,-1
25,25,92,11,12,-1
25,25,93,13,5,8
25,25,94,17,11,6
25,25,95,11,14,-3
25,25,96,18,7,11
25,25,97,10,20,-10
25,25,98,23,13,10
25,25,99,8,17,-9
25,25,100,8,19,-11
25,25,101,10,15,-5
25,25,102,16,19,-3
25,25,103,4,18,-14
25,25,104,12,14,-2
25,25,105,20,10,10
25,25,106,19,13,6
25,25,107,9,20,-11
25,25,108,8,11,-3
25,25,109,23,8,15
25,25,110,8,12,-4
25,25,111,10,7,3
25,25,112,7,10,-3
25,25,113,12,5,7
25,25,114,10,10,0
25,25,115,17,15,2
25,25,116,13,13,0
25,25,117,4,18,-14
25,25,118,1,0,1
25,25,119,1,14,-13
25,25,120,12,7,5
25,25,121,14,14,0
25,25,122,13,13,0
25,25,123,10,11,-1
25,25,124,14,9,5
25,25,125,15,14,1
25,25,126,8,20,-12
25,25,127,8,12,-4
25,25,128,15,24,-9
25,25,129,11,22,-11
25,25,130,19,14,5
25,25,131,13,14,-1
25,25,132,23,20,3
25,25,133,6,18,-12
25,25,134,7,11,-4
25,25,135,16,15,1
25,25,136,22,17,5
25,25,137,18,8,10
25,25,138,9,9,0
25,25,139,7,16,-9
25,25,140,22,22,0
25,25,141,19,14,5
25,25,142,13,8,5
25,25,143,19,13,6
25,25,144,7,15,-8
25,25,145,7,8,-1
25,25,146,30,22,8
25,25,147,18,11,7
25,25,148,23,22,1
25,25,149,23,12,11
25,25,150,6,11,-5
25,25,151,11,15,-4
25,25,152,5,9,-4
25,25,153,15,9,6
25,25,154,12,4,8
25,25,155,11,18,-7
25,25,156,10,19,-9
25,25,157,12,14,-2
25,25,158,8,14,-6
25,25,159,13,25,-12
25,25,160,7,9,-2
25,25,161,15,11,4
25,25,162,21,20,1
25,25,163,20,13,7
25,25,164,11,9,2
25,25,165,11,11,0
25,25,166,10,12,-2
25,25,167,17,8,9
25,25,168,15,16,-1
25,25,169,4,9,-5
25,25,170,9,16,-7
25,25,171,11,14,-3
25,25,172,10,5,5
25,25,173,14,26,-12
25,25,174,11,13,-2
25,25,175,10,11,-1
25,25,176,5,14,-9
25,25,177,10,7,3
25,25,178,10,12,-2
25,25,179,18,19,-1
25,25,180,15,21,-6
25,25,181,10,17,-7
25,25,182,5,13,-8
25,25,183,14,26,-12
25,25,184,19,11,8
25,25,185,15,20,-5
25,25,186,9,11,-2
25,25,187,14,16,-2
25,25,188,11,19,-8
25,25,189,9,20,-11
25,25,190,10,12,-2
25,25,191,10,4,6
25,25,192,15,7,8
25,25,193,5,6,-1
25,25,194,9,11,-2
25,25,195,0,11,-11
25,25,196,11,17,-6
25,25,197,11,17,-6
25,25,198,10,14,-4
25,25,199,14,10,4
25,25,200,5,15,-10
25,25,201,18,25,-7
25,25,202,7,7,0
25,25,203,14,9,5
25,25,204,18,10,8
25,25,205,9,16,-7
25,25,206,16,13,3
25,25,207,15,13,2
25,25,208,11,9,2
25,25,209,8,8,0
25,25,210,7,9,-2
25,25,211,19,11,8
25,25,212,12,13,-1
25,25,213,13,19,-6
25,25,214,4,9,-5
25,25,215,5,7,-2
25,25,216,11,23,-12
25,25,217,10,11,-1
25,25,218,17,20,-3
25,25,219,15,12,3
25,25,220,12,17,-5
25,25,221,6,8,-2
25,25,222,12,6,6
25,25,223,8,7,1
25,25,224,6,12,-6
25,25,225,17,22,-5
25,25,226,19,13,6
25,25,227,11,13,-2
25,25,228,16,25,-9
25,25,229,11,8,3
25,25,230,11,15,-4
25,25,231,7,17,-10
25,25,232,11,25,-14
25,25,233,15,9,6
25,25,234,9,15,-6
25,25,235,14,15,-1
25,25,236,9,16,-7
25,25,237,14,7,7
25,25,238,13,5,8
25,25,239,9,8,1
25,25,240,8,15,-7
25,25,241,17,14,3
25,25,242,3,7,-4
25,25,243,11,18,-7
25,25,244,11,13,-2
25,25,245,4,7,-3
25,25,246,4,9,-5
25,25,247,9,11,-2
25,25,248,5,9,-4
25,25,249,15,5,10
25,25,250,7,6,1
25,25,251,14,19,-5
25,25,252,14,12,2
25,25,253,14,17,-3
25,25,254,13,13,0
25,25,255,17,23,-6
25,25,256,7,21,-14
25,25,257,17,9,8
25,25,258,6,16,-10
25,25,259,2,6,-4
25,25,260,8,21,-13
25,25,261,6,8,-2
25,25,262,8,20,-12
25,25,263,8,11,-3
25,25,264,11,17,-6
25,25,265,19,16,3
25,25,266,19,21,-2
25,25,267,11,11,0
25,25,268,14,6,8
25,25,269,7,3,4
25,25,270,13,4,9
25,25,271,6,21,-15
25,25,272,5,13,-8
25,25,273,17,18,-1
25,25,274,12,16,-4
25,25,275,11,9,2
25,25,276,19,12,7
25,25,277,22,2,20
25,25,278,11,10,1
25,25,279,19,11,8
25,25,280,2,9,-7
25,25,281,21,20,1
25,25,282,11,9,2
25,25,283,7,14,-7
25,25,284,8,17,-9
25,25,285,22,16,6
25,25,286,6,12,-6
25,25,287,9,6,3
25,25,288,5,9,-4
25,25,289,13,9,4
25,25,290,8,8,0
25,25,291,9,19,-10
25,25,292,5,14,-9
25,25,293,21,20,1
25,25,294,10,7,3
25,25,295,14,27,-13
25,25,296,8,6,2
25,25,297,8,13,-5
25,25,298,2,7,-5
25,25,299,8,20,-12
26,26,0,5,23,-18
26,26,1,6,10,-4
26,26,2,3,14,-11
26,26,3,11,9,2
26,26,4,11,17,-6
26,26,5,4,11,-7
26,26,6,10,14,-4
26,26,7,2,11,-9
26,26,8,4,8,-4
26,26,9,15,21,-6
26,26,10,17,12,5
26,26,11,10,17,-7
26,26,12,11,22,-11
26,26,13,9,9,0
26,26,14,17,13,4
26,26,15,9,14,-5
26,26,16,15,16,-1
26,26,17,15,13,2
26,26,18,13,18,-5
26,26,19,20,16,4
26,26,20,9,17,-8
26,26,21,10,25,-15
26,26,22,17,19,-2
26,26,23,16,9,7
26,26,24,13,15,-2
26,26,25,4,13,-9
26,26,26,9,14,-5
26,26,27,11,20,-9
26,26,28,13,18,-5
26,26,29,13,14,-1
26,26,30,19,28,-9
26,26,31,14,13,1
26,26,32,10,17,-7
26,26,33,23,23,0
26,26,34,14,5,9
26,26,35,13,12,1
26,26,36,21,26,-5
26,26,37,12,22,-10
26,26,38,7,14,-7
26,26,39,12,11,1
26,26,40,10,23,-13
26,26,41,13,10,3
26,26,42,15,6,9
26,26,43,12,19,-7
26,26,44,3,19,-16
26,26,45,1,8,-7
26,26,46,14,8,6
26,26,47,4,7,-3
26,26,48,14,16,-2
26,26,49,7,12,-5
26,26,50,8,6,2
26,26,51,12,18,-6
26,26,52,8,14,-6
26,26,53,6,9,-3
26,26,54,18,19,-1
26,26,55,7,13,-6
26,26,56,8,17,-9
26,26,57,11,8,3
26,26,58,13,10,3
26,26,59,8,9,-1
26,26,60,6,17,-11
26,26,61,14,10,4
26,26,62,20,9,11
26,26,63,8,4,4
26,26,64,8,7,1
26,26,65,12,8,4
26,26,66,20,10,10
26,26,67,6,21,-15
26,26,68,12,17,-5
26,26,69,17,22,-5
26,26,70,13,17,-4
26,26,71,7,14,-7
26,26,72,11,6,5
26,26,73,8,15,-7
26,26,74,12,7,5
26,26,75,16,24,-8
26,26,76,12,17,-5
26,26,77,22,19,3
26,26,78,12,16,-4
26,26,79,8,4,4
26,26,80,15,21,-6
26,26,81,5,13,-8
26,26,82,10,18,-8
26,26,83,20,12,8
26,26,84,6,6,0
26,26,85,22,21,1
26,26,86,12,15,-3
26,26,87,9,12,-3
26,26,88,9,18,-9
26,26,89,7,7,0
26,26,90,17,18,-1
26,26,91,3,14,-11
26,26,92,8,10,-2
26,26,93,15,9,6
26,26,94,17,12,5
26,26,95,13,13,0
26,26,96,10,7,3
26,26,97,11,7,4
26,26,98,5,7,-2
26,26,99,8,15,-7
26,26,100,13,8,5
26,26,101,11,18,-7
26,26,102,17,18,-1
26,26,103,10,21,-11
26,26,104,9,8,1
26,26,105,7,8,-1
26,26,106,13,13,0
26,26,107,6,4,2
26,26,108,14,8,6
26,26,109,9,16,-7
26,26,110,8,8,0
26,26,111,7,8,-1
26,26,112,10,8,2
26,26,113,6,6,0
26,26,114,17,9,8
26,26,115,15,6,9
26,26,116,13,13,0
26,26,117,8,8,0
26,26,118,9,12,-3
26,26,119,9,8,1
26,26,120,20,20,0
26,26,121,10,8,2
26,26,122,4,8,-4
26,26,123,14,16,-2
26,26,124,23,10,13
26,26,125,20,13,7
26,26,126,16,13,3
26,26,127,8,17,-9
26,26,128,6,15,-9
26,26,129,11,21,-10
26,26,130,12,13,-1
26,26,131,9,7,2
26,26,132,14,3,11
26,26,133,8,7,1
26,26,134,14,15,-1
26,26,135,14,13,1
26,26,136,8,10,-2
26,26,137,12,9,3
26,26,138,23,24,-1
26,26,139,10,11,-1
26,26,140,11,5,6
26,26,141,5,21,-16
26,26,142,13,19,-6
26,26,143,17,21,-4
26,26,144,17,9,8
26,26,145,20,14,6
26,26,146,10,21,-11
26,26,147,13,11,2
26,26,148,11,23,-12
26,26,149,7,14,-7
26,26,150,9,8,1
26,26,151,16,22,-6
26,26,152,12,12,0
26,26,153,8,13,-5
26,26,154,13,15,-2
26,26,155,11,14,-3
26,26,156,16,30,-14
26,26,157,13,16,-3
26,26,158,6,13,-7
26,26,159,12,9,3
26,26,160,8,5,3
26,26,161,5,11,-6
26,26,162,15,18,-3
26,26,163,8,8,0
26,26,164,7,6,1
26,26,165,19,14,5
26,26,166,11,23,-12
26,26,167,4,20,-16
26,26,168,11,14,-3
26,26,169,7,8,-1
26,26,170,9,15,-6
26,26,171,16,13,3
26,26,172,14,9,5
26,26,173,16,30,-14
26,26,174,16,9,7
26,26,175,19,14,5
26,26,176,19,10,9
26,26,177,15,7,8
26,26,178,10,16,-6
26,26,179,5,9,-4
26,26,180,8,13,-5
26,26,181,9,10,-1
26,26,182,8,10,-2
26,26,183,14,12,2
26,26,184,12,21,-9
26,26,185,6,13,-7
26,26,186,15,15,0
26,26,187,20,23,-3
26,26,188,10,2,8
26,26,189,12,17,-5
26,26,190,14,6,8
26,26,191,4,8,-4
26,26,192,17,10,7
26,26,193,5,11,-6
26,26,194,7,16,-9
26,26,195,3,9,-6
26,26,196,6,13,-7
26,26,197,6,13,-7
26,26,198,12,15,-3
26,26,199,8,13,-5
26,26,200,16,16,0
26,26,201,9,19,-10
26,26,202,12,21,-9
26,26,203,7,15,-8
26,26,204,30,16,14
26,26,205,13,9,4
26,26,206,26,23,3
26,26,207,10,10,0
26,26,208,11,5,6
26,26,209,9,21,-12
26,26,210,8,15,-7
26,26,211,2,8,-6
26,26,212,9,12,-3
26,26,213,9,12,-3
26,26,214,17,10,7
26,26,215,12,13,-1
26,26,216,19,18,1
26,26,217,17,12,5
26,26,218,10,17,-7
26,26,219,3,11,-8
26,26,220,16,12,4
26,26,221,7,11,-4
26,26,222,8,13,-5
26,26,223,11,10,1
26,26,224,10,14,-4
26,26,225,15,20,-5
26,26,226,15,10,5
26,26,227,8,18,-10
26,26,228,12,11,1
26,26,229,5,10,-5
26,26,230,4,10,-6
26,26,231,7,5,2
26,26,232,12,14,-2
26,26,233,5,10,-5
26,26,234,8,12,-4
26,26,235,18,10,8
26,26,236,6,17,-11
26,26,237,12,13,-1
26,26,238,8,1,7
26,26,239,6,13,-7
26,26,240,7,14,-7
26,26,241,10,13,-3
26,26,242,18,9,9
26,26,243,15,12,3
26,26,244,13,16,-3
26,26,245,10,9,1
26,26,246,11,18,-7
26,26,247,8,11,-3
26,26,248,17,9,8
26,26,249,10,16,-6
26,26,250,3,19,-16
26,26,251,10,11,-1
26,26,252,16,14,2
26,26,253,14,23,-9
26,26,254,9,10,-1
26,26,255,8,8,0
26,26,256,20,10,10
26,26,257,14,11,3
26,26,258,5,4,1
26,26,259,18,28,-10
26,26,260,12,17,-5
26,26,261,4,9,-5
26,26,262,23,13,10
26,26,263,11,18,-7
26,26,264,21,15,6
26,26,265,18,19,-1
26,26,266,8,14,-6
26,26,267,7,21,-14
26,26,268,6,11,-5
26,26,269,6,14,-8
26,26,270,13,8,5
26,26,271,2,10,-8
26,26,272,11,4,7
26,26,273,17,15,2
26,26,274,5,7,-2
26,26,275,4,13,-9
26,26,276,13,4,9
26,26,277,14,12,2
26,26,278,8,9,-1
26,26,279,11,10,1
26,26,280,7,27,-20
26,26,281,7,22,-15
26,26,282,9,8,1
26,26,283,12,15,-3
26,26,284,7,5,2
26,26,285,8,13,-5
26,26,286,7,13,-6
26,26,287,18,15,3
26,26,288,5,8,-3
26,26,289,14,16,-2
26,26,290,8,10,-2
26,26,291,13,9,4
26,26,292,8,20,-12
26,26,293,8,3,5
26,26,294,10,8,2
26,26,295,12,17,-5
26,26,296,9,2,7
26,26,297,2,11,-9
26,26,298,18,22,-4
26,26,299,5,9,-4
27,27,0,6,8,-2
27,27,1,9,8,1
27,27,2,6,8,-2
27,27,3,3,6,-3
27,27,4,16,14,2
27,27,5,15,15,0
27,27,6,8,16,-8
27,27,7,8,17,-9
27,27,8,7,8,-1
27,27,9,11,8,3
27,27,10,11,22,-11
27,27,11,7,4,3
27,27,12,8,1,7
27,27,13,10,11,-1
27,27,14,20,15,5
27,27,15,9,19,-10
27,27,16,18,18,0
27,27,17,9,17,-8
27,27,18,13,36,-23
27,27,19,14,14,0
27,27,20,0,13,-13
27,27,21,17,14,3
27,27,22,15,24,-9
27,27,23,11,12,-1
27,27,24,9,14,-5
27,27,25,8,9,-1
27,27,26,19,10,9
27,27,27,6,8,-2
27,27,28,6,16,-10
27,27,29,7,20,-13
27,27,30,10,9,1
27,27,31,16,17,-1
27,27,32,5,12,-7
27,27,33,12,19,-7
27,27,34,10,27,-17
27,27,35,19,27,-8
27,27,36,11,10,1
27,27,37,12,15,-3
27,27,38,8,9,-1
27,27,39,14,9,5
27,27,40,6,19,-13
27,27,41,20,16,4
27,27,42,11,12,-1
27,27,43,16,21,-5
27,27,44,0,10,-10
27,27,45,17,12,5
27,27,46,22,16,6
27,27,47,5,16,-11
27,27,48,14,13,1
27,27,49,15,13,2
27,27,50,9,10,-1
27,27,51,4,5,-1
27,27,52,2,12,-10
27,27,53,6,9,-3
27,27,54,22,24,-2
27,27,55,16,33,-17
27,27,56,10,11,-1
27,27,57,5,12,-7
27,27,58,13,19,-6
27,27,59,16,21,-5
27,27,60,9,16,-7
27,27,61,5,13,-8
27,27,62,14,12,2
27,27,63,9,18,-9
27,27,64,25,8,17
27,27,65,19,22,-3
27,27,66,14,15,-1
27,27,67,9,20,-11
27,27,68,12,12,0
27,27,69,11,8,3
27,27,70,12,17,-5
27,27,71,9,14,-5
27,27,72,12,17,-5
27,27,73,18,3,15
27,27,74,14,16,-2
27,27,75,12,16,-4
27,27,76,3,8,-5
27,27,77,11,1,10
27,27,78,5,20,-15
27,27,79,9,22,-13
27,27,80,8,10,-2
27,27,81,2,3,-1
27,27,82,12,12,0
27,27,83,5,8,-3
27,27,84,2,10,-8
27,27,85,6,5,1
27,27,86,12,21,-9
27,27,87,7,11,-4
27,27,88,11,9,2
27,27,89,20,6,14
27,27,90,20,14,6
27,27,91,4,10,-6
27,27,92,14,25,-11
27,27,93,7,7,0
27,27,94,19,23,-4
27,27,95,7,17,-10
27,27,96,4,6,-2
27,27,97,6,7,-1
27,27,98,8,8,0
27,27,99,19,23,-4
27,27,100,10,8,2
27,27,101,5,8,-3
27,27,102,14,14,0
27,27,103,10,20,-10
27,27,104,11,8,3
27,27,105,7,8,-1
27,27,106,5,11,-6
27,27,107,10,22,-12
27,27,108,18,14,4
27,27,109,9,10,-1
27,27,110,25,16,9
27,27,111,22,20,2
27,27,112,24,15,9
27,27,113,20,13,7
27,27,114,13,15,-2
27,27,115,9,12,-3
27,27,116,17,20,-3
27,27,117,13,14,-1
27,27,118,10,9,1
27,27,119,13,10,3
27,27,120,2,10,-8
27,27,121,21,18,3
27,27,122,11,25,-14
27,27,123,13,10,3
27,27,124,13,6,7
27,27,125,9,15,-6
27,27,126,15,8,7
27,27,127,16,11,5
27,27,128,14,16,-2
27,27,129,7,10,-3
27,27,130,11,13,-2
27,27,131,8,5,3
27,27,132,18,14,4
27,27,133,14,26,-12
27,27,134,12,18,-6
27,27,135,19,16,3
27,27,136,6,16,-10
27,27,137,7,10,-3
27,27,138,11,6,5
27,27,139,9,23,-14
27,27,140,8,9,-1
27,27,141,11,17,-6
27,27,142,17,9,8
27,27,143,10,18,-8
27,27,144,10,10,0
27,27,145,8,15,-7
27,27,146,8,20,-12
27,27,147,15,15,0
27,27,148,17,12,5
27,27,149,10,17,-7
27,27,150,15,4,11
27,27,151,6,8,-2
27,27,152,10,17,-7
27,27,153,15,4,11
27,27,154,18,14,4
27,27,155,19,15,4
27,27,156,2,17,-15
27,27,157,7,24,-17
27,27,158,6,10,-4
27,27,159,11,8,3
27,27,160,11,13,-2
27,27,161,14,14,0
27,27,162,9,8,1
27,27,163,18,18,0
27,27,164,10,17,-7
27,27,165,10,16,-6
27,27,166,4,7,-3
27,27,167,6,9,-3
27,27,168,6,10,-4
27,27,169,2,22,-20
27,27,170,16,10,6
27,27,171,5,20,-15
27,27,172,12,7,5
27,27,173,7,11,-4
27,27,174,7,3,4
27,27,175,14,14,0
27,27,176,11,5,6
27,27,177,9,26,-17
27,27,178,14,11,3
27,27,179,13,17,-4
27,27,180,18,16,2
27,27,181,17,17,0
27,27,182,18,11,7
27,27,183,11,12,-1
27,27,184,12,13,-1
27,27,185,15,11,4
27,27,186,0,18,-18
27,27,187,15,10,5
27,27,188,6,8,-2
27,27,189,4,1,3
27,27,190,4,8,-4
27,27,191,8,19,-11
27,27,192,14,4,10
27,27,193,7,16,-9
27,27,194,12,18,-6
27,27,195,19,26,-7
27,27,196,9,5,4
27,27,197,13,7,6
27,27,198,18,18,0
27,27,199,13,12,1
27,27,200,13,11,2
27,27,201,5,10,-5
27,27,202,10,16,-6
27,27,203,9,21,-12
27,27,204,15,20,-5
27,27,205,4,5,-1
27,27,206,16,17,-1
27,27,207,2,7,-5
27,27,208,7,7,0
27,27,209,4,8,-4
27,27,210,0,9,-9
27,27,211,10,15,-5
27,27,212,11,11,0
27,27,213,7,12,-5
27,27,214,19,17,2
27,27,215,2,9,-7
27,27,216,8,13,-5
27,27,217,12,5,7
27,27,218,11,10,1
27,27,219,14,19,-5
27,27,220,13,8,5
27,27,221,12,29,-17
27,27,222,15,28,-13
27,27,223,9,14,-5
27,27,224,20,25,-5
27,27,225,13,9,4
27,27,226,9,18,-9
27,27,227,10,6,4
27,27,228,21,17,4
27,27,229,15,11,4
27,27,230,3,9,-6
27,27,231,24,21,3
27,27,232,6,9,-3
27,27,233,5,10,-5
27,27,234,21,13,8
27,27,235,11,15,-4
27,27,236,12,14,-2
27,27,237,5,11,-6
27,27,238,22,12,10
27,27,239,11,17,-6
27,27,240,10,10,0
27,27,241,6,18,-12
27,27,242,15,15,0
27,27,243,24,19,5
27,27,244,9,23,-14
27,27,245,10,8,2
27,27,246,17,26,-9
27,27,247,19,18,1
27,27,248,18,8,10
27,27,249,9,14,-5
27,27,250,8,11,-3
27,27,251,11,15,-4
27,27,252,10,23,-13
27,27,253,4,11,-7
27,27,254,4,5,-1
27,27,255,18,15,3
27,27,256,7,11,-4
27,27,257,14,9,5
27,27,258,6,9,-3
27,27,259,12,6,6
27,27,260,16,13,3
27,27,261,10,10,0
27,27,262,6,7,-1
27,27,263,8,21,-13
27,27,264,9,26,-17
27,27,265,11,17,-6
27,27,266,10,9,1
27,27,267,13,10,3
27,27,268,13,35,-22
27,27,269,6,19,-13
27,27,270,14,16,-2
27,27,271,17,13,4
27,27,272,6,15,-9
27,27,273,9,18,-9
27,27,274,11,23,-12
27,27,275,16,14,2
27,27,276,18,12,6
27,27,277,12,33,-21
27,27,278,9,7,2
27,27,279,9,13,-4
27,27,280,6,12,-6
27,27,281,9,10,-1
27,27,282,8,8,0
27,27,283,7,1,6
27,27,284,20,19,1
27,27,285,8,10,-2
27,27,286,6,13,-7
27,27,287,19,12,7
27,27,288,16,8,8
27,27,289,11,17,-6
27,27,290,13,9,4
27,27,291,16,22,-6
27,27,292,14,7,7
27,27,293,5,5,0
27,27,294,10,14,-4
27,27,295,15,14,1
27,27,296,17,27,-10
27,27,297,10,9,1
27,27,298,11,9,2
27,27,299,6,12,-6
28,28,0,9,12,-3
28,28,1,11,12,-1
28,28,2,11,22,-11
28,28,3,5,16,-11
28,28,4,9,11,-2
28,28,5,13,4,9
28,28,6,13,19,-6
28,28,7,8,10,-2
28,28,8,11,17,-6
28,28,9,16,31,-15
28,28,10,8,5,3
28,28,11,5,18,-13
28,28,12,10,23,-13
28,28,13,22,10,12
28,28,14,15,17,-2
28,28,15,11,22,-11
28,28,16,3,8,-5
28,28,17,12,21,-9
28,28,18,10,9,1
28,28,19,9,8,1
28,28,20,4,10,-6
28,28,21,8,19,-11
28,28,22,5,1,4
28,28,23,10,11,-1
28,28,24,14,12,2
28,28,25,10,12,-2
28,28,26,13,13,0
28,28,27,19,22,-3
28,28,28,4,16,-12
28,28,29,10,16,-6
28,28,30,13,9,4
28,28,31,16,11,5
28,28,32,8,4,4
28,28,33,8,8,0
28,28,34,13,10,3
28,28,35,5,10,-5
28,28,36,9,15,-6
28,28,37,28,20,8
28,28,38,11,13,-2
28,28,39,13,14,-1
28,28,40,8,15,-7
28,28,41,4,21,-17
28,28,42,5,18,-13
28,28,43,9,12,-3
28,28,44,10,8,2
28,28,45,18,8,10
28,28,46,14,9,5
28,28,47,6,10,-4
28,28,48,21,26,-5
28,28,49,10,22,-12
28,28,50,11,15,-4
28,28,51,10,14,-4
28,28,52,4,4,0
28,28,53,3,14,-11
28,28,54,13,15,-2
28,28,55,13,14,-1
28,28,56,6,9,-3
28,28,57,12,19,-7
28,28,58,17,11,6
28,28,59,10,11,-1
28,28,60,12,10,2
28,28,61,4,16,-12
28,28,62,14,0,14
28,28,63,10,6,4
28,28,64,14,21,-7
28,28,65,8,6,2
28,28,66,9,1,8
28,28,67,13,19,-6
28,28,68,10,10,0
28,28,69,12,7,5
28,28,70,9,9,0
28,28,71,12,10,2
28,28,72,8,13,-5
28,28,73,11,14,-3
28,28,74,9,18,-9
28,28,75,23,16,7
28,28,76,7,15,-8
28,28,77,14,12,2
28,28,78,12,7,5
28,28,79,12,16,-4
28,28,80,4,7,-3
28,28,81,8,11,-3
28,28,82,16,14,2
28,28,83,6,13,-7
28,28,84,6,13,-7
28,28,85,6,13,-7
28,28,86,17,18,-1
28,28,87,13,8,5
28,28,88,17,13,4
28,28,89,9,16,-7
28,28,90,10,27,-17
28,28,91,6,16,-10
28,28,92,12,9,3
28,28,93,8,12,-4
28,28,94,12,12,0
28,28,95,8,18,-10
28,28,96,5,9,-4
28,28,97,7,8,-1
28,28,98,9,3,6
28,28,99,10,5,5
28,28,100,7,16,-9
28,28,101,2,7,-5
28,28,102,11,9,2
28,28,103,11,13,-2
28,28,104,13,21,-8
28,28,105,10,6,4
28,28,106,6,7,-1
28,28,107,6,4,2
28,28,108,6,12,-6
28,28,109,15,21,-6
28,28,110,13,11,2
28,28,111,11,7,4
28,28,112,13,11,2
28,28,113,12,21,-9
28,28,114,17,7,10
28,28,115,16,4,12
28,28,116,7,12,-5
28,28,117,3,12,-9
28,28,118,17,15,2
28,28,119,9,8,1
28,28,120,9,10,-1
28,28,121,18,18,0
28,28,122,20,13,7
28,28,123,13,14,-1
28,28,124,7,5,2
28,28,125,21,11,10
28,28,126,6,11,-5
28,28,127,5,11,-6
28,28,128,16,18,-2
28,28,129,18,12,6
28,28,130,8,9,-1
28,28,131,12,10,2
28,28,132,9,18,-9
28,28,133,10,13,-3
28,28,134,7,22,-15
28,28,135,9,12,-3
28,28,136,9,13,-4
28,28,137,9,5,4
28,28,138,8,14,-6
28,28,139,6,15,-9
28,28,140,19,19,0
28,28,141,4,10,-6
28,28,142,8,12,-4
28,28,143,16,8,8
28,28,144,12,17,-5
28,28,145,11,15,-4
28,28,146,24,22,2
28,28,147,8,14,-6
28,28,148,15,13,2
28,28,149,5,10,-5
28,28,150,11,13,-2
28,28,151,19,13,6
28,28,152,15,26,-11
28,28,153,7,8,-1
28,28,154,8,8,0
28,28,155,14,13,1
28,28,156,6,12,-6
28,28,157,13,14,-1
28,28,158,14,10,4
28,28,159,8,6,2
28,28,160,10,11,-1
28,28,161,9,13,-4
28,28,162,19,23,-4
28,28,163,20,17,3
28,28,164,1,9,-8
28,28,165,12,9,3
28,28,166,8,13,-5
28,28,167,12,12,0
28,28,168,9,9,0
28,28,169,0,6,-6
28,28,170,14,19,-5
28,28,171,5,2,3
28,28,172,9,19,-10
28,28,173,8,7,1
28,28,174,9,16,-7
28,28,175,18,14,4
28,28,176,13,18,-5
28,28,177,11,10,1
28,28,178,2,3,-1
28,28,179,8,21,-13
28,28,180,20,25,-5
28,28,181,2,12,-10
28,28,182,12,19,-7
28,28,183,5,13,-8
28,28,184,21,18,3
28,28,185,11,11,0
28,28,186,3,10,-7
28,28,187,15,13,2
28,28,188,8,24,-16
28,28,189,20,12,8
28,28,190,13,14,-1
28,28,191,6,8,-2
28,28,192,7,14,-7
28,28,193,9,25,-16
28,28,194,9,18,-9
28,28,195,12,13,-1
28,28,196,5,6,-1
28,28,197,9,11,-2
28,28,198,8,13,-5
28,28,199,8,14,-6
28,28,200,13,16,-3
28,28,201,5,11,-6
28,28,202,6,14,-8
28,28,203,17,20,-3
28,28,204,22,23,-1
28,28,205,10,16,-6
28,28,206,4,17,-13
28,28,207,11,14,-3
28,28,208,11,15,-4
28,28,209,7,20,-13
28,28,210,14,14,0
28,28,211,21,7,14
28,28,212,12,13,-1
28,28,213,16,19,-3
28,28,214,8,6,2
28,28,215,10,16,-6
28,28,216,7,20,-13
28,28,217,11,23,-12
28,28,218,12,17,-5
28,28,219,15,10,5
28,28,220,9,21,-12
28,28,221,9,14,-5
28,28,222,14,21,-7
28,28,223,5,6,-1
28,28,224,21,21,0
28,28,225,13,19,-6
28,28,226,21,15,6
28,28,227,6,14,-8
28,28,228,4,5,-1
28,28,229,6,9,-3
28,28,230,14,1,13
28,28,231,13,24,-11
28,28,232,7,17,-10
28,28,233,16,9,7
28,28,234,9,13,-4
28,28,235,17,10,7
28,28,236,15,17,-2
28,28,237,9,8,1
28,28,238,14,13,1
28,28,239,5,3,2
28,28,240,21,20,1
28,28,241,11,18,-7
28,28,242,14,2,12
28,28,243,11,19,-8
28,28,244,9,9,0
28,28,245,22,14,8
28,28,246,2,4,-2
28,28,247,8,16,-8
28,28,248,17,28,-11
28,28,249,7,12,-5
28,28,250,19,15,4
28,28,251,11,12,-1
28,28,252,5,9,-4
28,28,253,18,12,6
28,28,254,22,17,5
28,28,255,14,16,-2
28,28,256,9,8,1
28,28,257,9,6,3
28,28,258,19,22,-3
28,28,259,17,20,-3
28,28,260,3,14,-11
28,28,261,10,11,-1
28,28,262,8,14,-6
28,28,263,12,13,-1
28,28,264,20,15,5
28,28,265,9,13,-4
28,28,266,9,16,-7
28,28,267,6,11,-5
28,28,268,11,8,3
28,28,269,15,8,7
28,28,270,7,9,-2
28,28,271,26,25,1
28,28,272,6,11,-5
28,28,273,14,20,-6
28,28,274,4,8,-4
28,28,275,8,17,-9
28,28,276,12,4,8
28,28,277,14,23,-9
28,28,278,6,12,-6
28,28,279,7,7,0
28,28,280,9,9,0
28,28,281,13,10,3
28,28,282,13,18,-5
28,28,283,14,20,-6
28,28,284,11,8,3
28,28,285,9,4,5
28,28,286,10,9,1
28,28,287,4,6,-2
28,28,288,12,13,-1
28,28,289,13,11,2
28,28,290,4,7,-3
28,28,291,9,9,0
28,28,292,4,7,-3
28,28,293,17,9,8
28,28,294,19,19,0
28,28,295,11,15,-4
28,28,296,6,16,-10
28,28,297,6,12,-6
28,28,298,7,4,3
28,28,299,3,18,-15
29,29,0,12,12,0
29,29,1,2,10,-8
29,29,2,9,21,-12
29,29,3,6,16,-10
29,29,4,18,11,7
29,29,5,11,17,-6
29,29,6,14,19,-5
29,29,7,8,9,-1
29,29,8,18,13,5
29,29,9,11,14,-3
29,29,10,11,15,-4
29,29,11,6,7,-1
29,29,12,11,16,-5
29,29,13,11,17,-6
29,29,14,14,12,2
29,29,15,6,11,-5
29,29,16,7,12,-5
29,29,17,19,12,7
29,29,18,12,18,-6
29,29,19,11,19,-8
29,29,20,7,15,-8
29,29,21,10,8,2
29,29,22,9,14,-5
29,29,23,14,10,4
29,29,24,8,19,-11
29,29,25,12,11,1
29,29,26,10,12,-2
29,29,27,21,16,5
29,29,28,11,8,3
29,29,29,10,16,-6
29,29,30,13,12,1
29,29,31,8,9,-1
29,29,32,4,6,-2
29,29,33,9,8,1
29,29,34,15,12,3
29,29,35,4,6,-2
29,29,36,8,10,-2
29,29,37,18,9,9
29,29,38,9,18,-9
29,29,39,15,10,5
29,29,40,11,17,-6
29,29,41,11,14,-3
29,29,42,4,10,-6
29,29,43,8,14,-6
29,29,44,13,13,0
29,29,45,4,6,-2
29,29,46,9,5,4
29,29,47,1,8,-7
29,29,48,11,9,2
29,29,49,13,20,-7
29,29,50,4,12,-8
29,29,51,7,8,-1
29,29,52,12,9,3
29,29,53,10,7,3
29,29,54,4,10,-6
29,29,55,10,12,-2
29,29,56,4,3,1
29,29,57,17,13,4
29,29,58,1,20,-19
29,29,59,15,10,5
29,29,60,14,4,10
29,29,61,5,7,-2
29,29,62,6,12,-6
29,29,63,10,11,-1
29,29,64,16,9,7
29,29,65,13,9,4
29,29,66,19,22,-3
29,29,67,11,18,-7
29,29,68,12,1,11
29,29,69,11,9,2
29,29,70,6,13,-7
29,29,71,3,10,-7
29,29,72,11,11,0
29,29,73,7,13,-6
29,29,74,12,17,-5
29,29,75,1,4,-3
29,29,76,7,14,-7
29,29,77,8,9,-1
29,29,78,8,23,-15
29,29,79,14,12,2
29,29,80,16,9,7
29,29,81,4,10,-6
29,29,82,7,5,2
29,29,83,20,10,10
29,29,84,14,9,5
29,29,85,7,17,-10
29,29,86,20,16,4
29,29,87,8,15,-7
29,29,88,10,9,1
29,29,89,6,20,-14
29,29,90,9,19,-10
29,29,91,15,17,-2
29,29,92,2,9,-7
29,29,93,6,11,-5
29,29,94,10,9,1
29,29,95,7,21,-14
29,29,96,5,9,-4
29,29,97,15,12,3
29,29,98,6,3,3
29,29,99,17,6,11
29,29,100,3,10,-7
29,29,101,15,13,2
29,29,102,6,19,-13
29,29,103,11,10,1
29,29,104,14,10,4
29,29,105,13,13,0
29,29,106,10,10,0
29,29,107,12,9,3
29,29,108,12,8,4
29,29,109,7,9,-2
29,29,110,3,8,-5
29,29,111,11,17,-6
29,29,112,12,14,-2
29,29,113,9,9,0
29,29,114,13,7,6
29,29,115,2,8,-6
29,29,116,12,10,2
29,29,117,8,9,-1
29,29,118,7,12,-5
29,29,119,5,9,-4
29,29,120,17,8,9
29,29,121,10,13,-3
29,29,122,14,20,-6
29,29,123,19,18,1
29,29,124,3,14,-11
29,29,125,6,12,-6
29,29,126,9,7,2
29,29,127,5,0,5
29,29,128,10,8,2
29,29,129,12,14,-2
29,29,130,7,18,-11
29,29,131,18,16,2
29,29,132,10,7,3
29,29,133,6,5,1
29,29,134,11,22,-11
29,29,135,6,10,-4
29,29,136,3,5,-2
29,29,137,8,7,1
29,29,138,3,12,-9
29,29,139,8,9,-1
29,29,140,5,15,-10
29,29,141,10,18,-8
29,29,142,19,11,8
29,29,143,12,7,5
29,29,144,15,11,4
29,29,145,9,11,-2
29,29,146,8,8,0
29,29,147,7,9,-2
29,29,148,8,2,6
29,29,149,14,16,-2
29,29,150,14,8,6
29,29,151,2,4,-2
29,29,152,10,13,-3
29,29,153,13,14,-1
29,29,154,14,18,-4
29,29,155,12,9,3
29,29,156,6,10,-4
29,29,157,11,9,2
29,29,158,11,12,-1
29,29,159,9,10,-1
29,29,160,10,10,0
29,29,161,13,15,-2
29,29,162,5,11,-6
29,29,163,7,16,-9
29,29,164,7,11,-4
29,29,165,8,2,6
29,29,166,5,3,2
29,29,167,7,15,-8
29,29,168,15,6,9
29,29,169,10,4,6
29,29,170,14,13,1
29,29,171,6,8,-2
29,29,172,17,10,7
29,29,173,20,15,5
29,29,174,18,20,-2
29,29,175,6,12,-6
29,29,176,8,3,5
29,29,177,5,10,-5
29,29,178,14,13,1
29,29,179,5,15,-10
29,29,180,8,17,-9
29,29,181,10,17,-7
29,29,182,8,7,1
29,29,183,7,15,-8
29,29,184,11,9,2
29,29,185,13,19,-6
29,29,186,7,9,-2
29,29,187,14,19,-5
29,29,188,5,5,0
29,29,189,17,7,10
29,29,190,9,16,-7
29,29,191,15,12,3
29,29,192,5,12,-7
29,29,193,10,13,-3
29,29,194,16,6,10
29,29,195,16,18,-2
29,29,196,9,15,-6
29,29,197,8,15,-7
29,29,198,9,7,2
29,29,199,5,14,-9
29,29,200,7,2,5
29,29,201,13,11,2
29,29,202,5,15,-10
29,29,203,6,19,-13
29,29,204,6,13,-7
29,29,205,6,7,-1
29,29,206,17,18,-1
29,29,207,4,14,-10
29,29,208,10,16,-6
29,29,209,22,22,0
29,29,210,11,10,1
29,29,211,20,17,3
29,29,212,4,11,-7
29,29,213,5,6,-1
29,29,214,11,11,0
29,29,215,8,13,-5
29,29,216,4,6,-2
29,29,217,6,5,1
29,29,218,9,18,-9
29,29,219,8,10,-2
29,29,220,5,17,-12
29,29,221,3,13,-10
29,29,222,9,20,-11
29,29,223,16,13,3
29,29,224,4,7,-3
29,29,225,9,17,-8
29,29,226,9,9,0
29,29,227,5,12,-7
29,29,228,2,13,-11
29,29,229,7,13,-6
29,29,230,11,9,2
29,29,231,19,14,5
29,29,232,11,16,-5
29,29,233,7,10,-3
29,29,234,1,15,-14
29,29,235,13,13,0
29,29,236,9,10,-1
29,29,237,7,9,-2
29,29,238,7,8,-1
29,29,239,7,14,-7
29,29,240,18,11,7
29,29,241,14,14,0
29,29,242,11,7,4
29,29,243,10,14,-4
29,29,244,18,4,14
29,29,245,11,13,-2
29,29,246,10,23,-13
29,29,247,5,8,-3
29,29,248,13,9,4
29,29,249,10,5,5
29,29,250,27,28,-1
29,29,251,17,12,5
29,29,252,5,11,-6
29,29,253,15,20,-5
29,29,254,20,14,6
29,29,255,17,16,1
29,29,256,12,8,4
29,29,257,9,17,-8
29,29,258,6,23,-17
29,29,259,11,15,-4
29,29,260,5,7,-2
29,29,261,21,9,12
29,29,262,3,14,-11
29,29,263,2,12,-10
29,29,264,9,8,1
29,29,265,12,10,2
29,29,266,5,19,-14
29,29,267,3,10,-7
29,29,268,14,21,-7
29,29,269,5,9,-4
29,29,270,15,12,3
29,29,271,22,11,11
29,29,272,5,11,-6
29,29,273,9,10,-1
29,29,274,11,15,-4
29,29,275,12,11,1
29,29,276,4,15,-11
29,29,277,8,11,-3
29,29,278,11,17,-6
29,29,279,10,21,-11
29,29,280,19,17,2
29,29,281,9,18,-9
29,29,282,15,11,4
29,29,283,12,9,3
29,29,284,11,11,0
29,29,285,18,12,6
29,29,286,8,8,0
29,29,287,14,12,2
29,29,288,15,6,9
29,29,289,3,8,-5
29,29,290,7,14,-7
29,29,291,14,11,3
29,29,292,4,10,-6
29,29,293,10,9,1
29,29,294,16,15,1
29,29,295,30,18,12
29,29,296,18,5,13
29,29,297,14,5,9
29,29,298,3,9,-6
29,29,299,8,9,-1
30,30,0,11,11,0
30,30,1,5,16,-11
30,30,2,11,10,1
30,30,3,9,10,-1
30,30,4,13,11,2
30,30,5,5,12,-7
30,30,6,9,7,2
30,30,7,8,17,-9
30,30,8,15,10,5
30,30,9,5,13,-8
30,30,10,13,15,-2
30,30,11,14,4,10
30,30,12,8,11,-3
30,30,13,13,7,6
30,30,14,4,4,0
30,30,15,7,11,-4
30,30,16,6,8,-2
30,30,17,7,6,1
30,30,18,7,20,-13
30,30,19,9,10,-1
30,30,20,8,15,-7
30,30,21,15,11,4
30,30,22,5,17,-12
30,30,23,5,7,-2
30,30,24,7,15,-8
30,30,25,12,18,-6
30,30,26,15,8,7
30,30,27,5,3,2
30,30,28,0,10,-10
30,30,29,5,18,-13
30,30,30,5,9,-4
30,30,31,9,6,3
30,30,32,5,7,-2
30,30,33,15,18,-3
30,30,34,1,16,-15
30,30,35,9,22,-13
30,30,36,11,9,2
30,30,37,5,12,-7
30,30,38,5,8,-3
30,30,39,17,14,3
30,30,40,13,13,0
30,30,41,6,5,1
30,30,42,4,19,-15
30,30,43,9,3,6
30,30,44,12,10,2
30,30,45,9,8,1
30,30,46,6,15,-9
30,30,47,9,20,-11
30,30,48,11,9,2
30,30,49,8,14,-6
30,30,50,6,5,1
30,30,51,1,4,-3
30,30,52,5,11,-6
30,30,53,11,15,-4
30,30,54,6,11,-5
30,30,55,9,4,5
30,30,56,5,14,-9
30,30,57,17,14,3
30,30,58,2,9,-7
30,30,59,14,7,7
30,30,60,10,9,1
30,30,61,10,13,-3
30,30,62,13,18,-5
30,30,63,11,9,2
30,30,64,13,12,1
30,30,65,5,15,-10
30,30,66,8,12,-4
30,30,67,6,4,2
30,30,68,5,9,-4
30,30,69,13,13,0
30,30,70,12,3,9
30,30,71,12,22,-10
30,30,72,20,10,10
30,30,73,6,10,-4
30,30,74,9,7,2
30,30,75,15,22,-7
30,30,76,8,19,-11
30,30,77,17,5,12
30,30,78,6,8,-2
30,30,79,22,27,-5
30,30,80,10,9,1
30,30,81,10,4,6
30,30,82,10,16,-6
30,30,83,8,11,-3
30,30,84,9,8,1
30,30,85,9,10,-1
30,30,86,4,14,-10
30,30,87,6,18,-12
30,30,88,8,10,-2
30,30,89,8,13,-5
30,30,90,7,5,2
30,30,91,8,8,0
30,30,92,11,12,-1
30,30,93,16,7,9
30,30,94,10,11,-1
30,30,95,8,6,2
30,30,96,8,2,6
30,30,97,11,9,2
30,30,98,6,8,-2
30,30,99,14,14,0
30,30,100,7,9,-2
30,30,101,6,13,-7
30,30,102,7,9,-2
30,30,103,3,5,-2
30,30,104,9,10,-1
30,30,105,8,10,-2
30,30,106,11,18,-7
30,30,107,8,9,-1
30,30,108,14,7,7
30,30,109,14,17,-3
30,30,110,7,15,-8
30,30,111,14,7,7
30,30,112,7,15,-8
30,30,113,7,15,-8
30,30,114,14,18,-4
30,30,115,26,16,10
30,30,116,21,12,9
30,30,117,9,12,-3
30,30,118,8,6,2
30,30,119,19,14,5
30,30,120,11,6,5
30,30,121,9,11,-2
30,30,122,12,13,-1
30,30,123,6,7,-1
30,30,124,2,7,-5
30,30,125,8,12,-4
30,30,126,7,19,-12
30,30,127,5,13,-8
30,30,128,16,6,10
30,30,129,11,16,-5
30,30,130,7,6,1
30,30,131,1,8,-7
30,30,132,7,6,1
30,30,133,9,9,0
30,30,134,4,13,-9
30,30,135,10,14,-4
30,30,136,6,11,-5
30,30,137,8,4,4
30,30,138,14,11,3
30,30,139,18,10,8
30,30,140,20,22,-2
30,30,141,3,1,2
30,30,142,11,15,-4
30,30,143,8,14,-6
30,30,144,8,14,-6
30,30,145,6,12,-6
30,30,146,2,5,-3
30,30,147,17,9,8
30,30,148,5,5,0
30,30,149,8,16,-8
30,30,150,10,11,-1
30,30,151,7,6,1
30,30,152,9,15,-6
30,30,153,5,9,-4
30,30,154,8,12,-4
30,30,155,10,15,-5
30,30,156,16,13,3
30,30,157,23,14,9
30,30,158,8,7,1
30,30,159,7,18,-11
30,30,160,14,10,4
30,30,161,13,15,-2
30,30,162,12,9,3
30,30,163,10,9,1
30,30,164,4,7,-3
30,30,165,6,8,-2
30,30,166,5,13,-8
30,30,167,8,17,-9
30,30,168,17,6,11
30,30,169,11,10,1
30,30,170,4,2,2
30,30,171,8,15,-7
30,30,172,9,11,-2
30,30,173,14,12,2
30,30,174,4,10,-6
30,30,175,8,8,0
30,30,176,12,14,-2
30,30,177,3,10,-7
30,30,178,11,14,-3
30,30,179,16,12,4
30,30,180,10,9,1
30,30,181,13,5,8
30,30,182,6,18,-12
30,30,183,4,13,-9
30,30,184,7,8,-1
30,30,185,7,16,-9
30,30,186,8,13,-5
30,30,187,12,9,3
30,30,188,16,15,1
30,30,189,13,11,2
30,30,190,10,20,-10
30,30,191,7,15,-8
30,30,192,7,10,-3
30,30,193,8,12,-4
30,30,194,5,8,-3
30,30,195,2,3,-1
30,30,196,7,15,-8
30,30,197,13,12,1
30,30,198,8,12,-4
30,30,199,7,14,-7
30,30,200,5,17,-12
30,30,201,10,11,-1
30,30,202,6,4,2
30,30,203,6,15,-9
30,30,204,5,6,-1
30,30,205,4,12,-8
30,30,206,12,7,5
30,30,207,11,11,0
30,30,208,6,10,-4
30,30,209,9,11,-2
30,30,210,7,10,-3
30,30,211,6,24,-18
30,30,212,7,15,-8
30,30,213,8,6,2
30,30,214,26,16,10
30,30,215,11,13,-2
30,30,216,7,13,-6
30,30,217,19,12,7
30,30,218,19,8,11
30,30,219,10,8,2
30,30,220,17,24,-7
30,30,221,5,10,-5
30,30,222,7,14,-7
30,30,223,14,13,1
30,30,224,13,16,-3
30,30,225,4,5,-1
30,30,226,6,13,-7
30,30,227,9,17,-8
30,30,228,15,13,2
30,30,229,9,11,-2
30,30,230,5,4,1
30,30,231,8,12,-4
30,30,232,5,15,-10
30,30,233,13,16,-3
30,30,234,16,16,0
30,30,235,16,12,4
30,30,236,12,6,6
30,30,237,13,13,0
30,30,238,16,10,6
30,30,239,12,6,6
30,30,240,23,11,12
30,30,241,10,12,-2
30,30,242,8,0,8
30,30,243,14,9,5
30,30,244,7,13,-6
30,30,245,17,10,7
30,30,246,14,10,4
30,30,247,14,13,1
30,30,248,7,6,1
30,30,249,15,14,1
30,30,250,16,12,4
30,30,251,9,13,-4
30,30,252,11,12,-1
30,30,253,7,10,-3
30,30,254,13,12,1
30,30,255,14,23,-9
30,30,256,14,6,8
30,30,257,3,11,-8
30,30,258,10,12,-2
30,30,259,14,15,-1
30,30,260,7,7,0
30,30,261,5,7,-2
30,30,262,9,23,-14
30,30,263,8,8,0
30,30,264,11,7,4
30,30,265,11,12,-1
30,30,266,10,12,-2
30,30,267,4,3,1
30,30,268,9,18,-9
30,30,269,8,7,1
30,30,270,15,15,0
30,30,271,13,8,5
30,30,272,12,12,0
30,30,273,18,15,3
30,30,274,9,23,-14
30,30,275,6,7,-1
30,30,276,9,7,2
30,30,277,6,16,-10
30,30,278,4,10,-6
30,30,279,11,20,-9
30,30,280,16,15,1
30,30,281,16,10,6
30,30,282,16,15,1
30,30,283,7,14,-7
30,30,284,1,3,-2
30,30,285,8,9,-1
30,30,286,8,6,2
30,30,287,16,22,-6
30,30,288,6,13,-7
30,30,289,7,15,-8
30,30,290,17,23,-6
30,30,291,6,5,1
30,30,292,7,17,-10
30,30,293,7,15,-8
30,30,294,19,23,-4
30,30,295,15,24,-9
30,30,296,12,13,-1
30,30,297,6,12,-6
30,30,298,8,8,0
30,30,299,9,12,-3
