# frame_skip_agent_A, frame_skip_agent_B, episode, score_A, score_B, reward
1,1,0,6,4,2
1,1,1,4,2,2
1,1,2,2,4,-2
1,1,3,3,5,-2
1,1,4,1,3,-2
1,1,5,9,6,3
1,1,6,4,4,0
1,1,7,11,7,4
1,1,8,1,1,0
1,1,9,5,5,0
1,1,10,5,7,-2
1,1,11,2,8,-6
1,1,12,4,8,-4
1,1,13,8,5,3
1,1,14,10,14,-4
1,1,15,9,5,4
1,1,16,6,6,0
1,1,17,7,7,0
1,1,18,4,5,-1
1,1,19,12,10,2
1,1,20,6,10,-4
1,1,21,13,3,10
1,1,22,7,10,-3
1,1,23,7,8,-1
1,1,24,13,11,2
1,1,25,4,8,-4
1,1,26,6,3,3
1,1,27,14,8,6
1,1,28,5,2,3
1,1,29,4,3,1
1,1,30,9,11,-2
1,1,31,4,2,2
1,1,32,9,20,-11
1,1,33,5,5,0
1,1,34,0,0,0
1,1,35,2,7,-5
1,1,36,4,6,-2
1,1,37,9,5,4
1,1,38,7,7,0
1,1,39,2,1,1
1,1,40,4,4,0
1,1,41,4,3,1
1,1,42,1,3,-2
1,1,43,3,10,-7
1,1,44,17,8,9
1,1,45,7,10,-3
1,1,46,14,16,-2
1,1,47,3,6,-3
1,1,48,4,4,0
1,1,49,4,4,0
1,1,50,5,3,2
1,1,51,6,6,0
1,1,52,19,14,5
1,1,53,6,11,-5
1,1,54,5,9,-4
1,1,55,7,5,2
1,1,56,4,5,-1
1,1,57,6,3,3
1,1,58,5,7,-2
1,1,59,8,4,4
1,1,60,4,7,-3
1,1,61,9,5,4
1,1,62,2,5,-3
1,1,63,8,8,0
1,1,64,7,6,1
1,1,65,0,6,-6
1,1,66,3,1,2
1,1,67,5,6,-1
1,1,68,4,1,3
1,1,69,9,20,-11
1,1,70,0,2,-2
1,1,71,5,8,-3
1,1,72,11,8,3
1,1,73,6,9,-3
1,1,74,6,6,0
1,1,75,3,7,-4
1,1,76,2,2,0
1,1,77,7,8,-1
1,1,78,2,4,-2
1,1,79,0,1,-1
1,1,80,9,23,-14
1,1,81,5,4,1
1,1,82,5,5,0
1,1,83,13,9,4
1,1,84,4,8,-4
1,1,85,3,5,-2
1,1,86,5,3,2
1,1,87,4,5,-1
1,1,88,3,14,-11
1,1,89,6,12,-6
1,1,90,12,13,-1
1,1,91,2,1,1
1,1,92,5,3,2
1,1,93,7,2,5
1,1,94,14,5,9
1,1,95,6,3,3
1,1,96,9,9,0
1,1,97,2,3,-1
1,1,98,12,11,1
1,1,99,4,3,1
1,1,100,2,6,-4
1,1,101,11,8,3
1,1,102,8,13,-5
1,1,103,9,8,1
1,1,104,4,4,0
1,1,105,3,0,3
1,1,106,1,1,0
1,1,107,3,4,-1
1,1,108,2,2,0
1,1,109,2,2,0
1,1,110,2,12,-10
1,1,111,12,16,-4
1,1,112,3,1,2
1,1,113,6,2,4
1,1,114,4,3,1
1,1,115,4,3,1
1,1,116,4,6,-2
1,1,117,3,5,-2
1,1,118,2,1,1
1,1,119,1,2,-1
1,1,120,3,7,-4
1,1,121,7,13,-6
1,1,122,6,6,0
1,1,123,4,4,0
1,1,124,2,1,1
1,1,125,5,11,-6
1,1,126,5,11,-6
1,1,127,8,9,-1
1,1,128,8,5,3
1,1,129,8,17,-9
1,1,130,10,11,-1
1,1,131,3,6,-3
1,1,132,9,9,0
1,1,133,2,8,-6
1,1,134,2,2,0
1,1,135,5,7,-2
1,1,136,10,13,-3
1,1,137,2,2,0
1,1,138,6,8,-2
1,1,139,2,4,-2
1,1,140,2,4,-2
1,1,141,17,11,6
1,1,142,0,0,0
1,1,143,6,7,-1
1,1,144,5,8,-3
1,1,145,7,5,2
1,1,146,4,4,0
1,1,147,3,2,1
1,1,148,2,7,-5
1,1,149,5,6,-1
1,1,150,1,2,-1
1,1,151,2,2,0
1,1,152,4,9,-5
1,1,153,2,5,-3
1,1,154,3,9,-6
1,1,155,4,5,-1
1,1,156,10,16,-6
1,1,157,8,3,5
1,1,158,1,5,-4
1,1,159,4,2,2
1,1,160,4,4,0
1,1,161,6,6,0
1,1,162,3,8,-5
1,1,163,10,9,1
1,1,164,9,14,-5
1,1,165,1,6,-5
1,1,166,22,11,11
1,1,167,7,7,0
1,1,168,7,5,2
1,1,169,7,12,-5
1,1,170,7,6,1
1,1,171,3,2,1
1,1,172,6,14,-8
1,1,173,2,2,0
1,1,174,4,4,0
1,1,175,13,7,6
1,1,176,5,10,-5
1,1,177,11,5,6
1,1,178,14,12,2
1,1,179,6,3,3
1,1,180,3,9,-6
1,1,181,6,8,-2
1,1,182,10,2,8
1,1,183,6,9,-3
1,1,184,4,18,-14
1,1,185,5,4,1
1,1,186,6,3,3
1,1,187,5,3,2
1,1,188,2,2,0
1,1,189,8,7,1
1,1,190,11,2,9
1,1,191,9,9,0
1,1,192,6,12,-6
1,1,193,9,7,2
1,1,194,9,14,-5
1,1,195,1,1,0
1,1,196,4,1,3
1,1,197,4,9,-5
1,1,198,5,11,-6
1,1,199,7,3,4
1,1,200,2,1,1
1,1,201,3,7,-4
1,1,202,0,3,-3
1,1,203,5,2,3
1,1,204,6,3,3
1,1,205,7,3,4
1,1,206,2,10,-8
1,1,207,2,1,1
1,1,208,15,11,4
1,1,209,7,6,1
1,1,210,6,4,2
1,1,211,4,6,-2
1,1,212,2,5,-3
1,1,213,8,3,5
1,1,214,4,14,-10
1,1,215,7,7,0
1,1,216,2,5,-3
1,1,217,10,8,2
1,1,218,6,2,4
1,1,219,2,2,0
1,1,220,11,16,-5
1,1,221,15,4,11
1,1,222,8,4,4
1,1,223,1,3,-2
1,1,224,4,3,1
1,1,225,3,2,1
1,1,226,8,6,2
1,1,227,7,6,1
1,1,228,4,17,-13
1,1,229,2,4,-2
1,1,230,1,0,1
1,1,231,1,0,1
1,1,232,4,4,0
1,1,233,6,8,-2
1,1,234,8,3,5
1,1,235,12,3,9
1,1,236,3,7,-4
1,1,237,5,5,0
1,1,238,1,4,-3
1,1,239,7,12,-5
1,1,240,1,5,-4
1,1,241,6,13,-7
1,1,242,2,8,-6
1,1,243,7,5,2
1,1,244,5,5,0
1,1,245,1,1,0
1,1,246,5,4,1
1,1,247,2,5,-3
1,1,248,5,4,1
1,1,249,2,5,-3
1,1,250,1,0,1
1,1,251,1,2,-1
1,1,252,4,6,-2
1,1,253,8,11,-3
1,1,254,6,4,2
1,1,255,3,4,-1
1,1,256,5,7,-2
1,1,257,3,8,-5
1,1,258,1,9,-8
1,1,259,10,10,0
1,1,260,6,5,1
1,1,261,2,1,1
1,1,262,8,5,3
1,1,263,9,11,-2
1,1,264,4,4,0
1,1,265,3,3,0
1,1,266,6,4,2
1,1,267,3,1,2
1,1,268,7,6,1
1,1,269,10,2,8
1,1,270,2,7,-5
1,1,271,0,0,0
1,1,272,6,6,0
1,1,273,16,9,7
1,1,274,3,5,-2
1,1,275,3,2,1
1,1,276,5,16,-11
1,1,277,5,4,1
1,1,278,2,4,-2
1,1,279,18,12,6
1,1,280,4,9,-5
1,1,281,4,3,1
1,1,282,4,3,1
1,1,283,8,9,-1
1,1,284,5,6,-1
1,1,285,5,7,-2
1,1,286,1,3,-2
1,1,287,4,4,0
1,1,288,6,3,3
1,1,289,1,4,-3
1,1,290,7,4,3
1,1,291,5,8,-3
1,1,292,6,4,2
1,1,293,5,4,1
1,1,294,8,7,1
1,1,295,5,2,3
1,1,296,8,8,0
1,1,297,17,5,12
1,1,298,4,1,3
1,1,299,1,5,-4
1,2,0,0,3,-3
1,2,1,17,13,4
1,2,2,7,7,0
1,2,3,8,4,4
1,2,4,2,10,-8
1,2,5,5,2,3
1,2,6,5,4,1
1,2,7,3,8,-5
1,2,8,3,3,0
1,2,9,3,11,-8
1,2,10,5,3,2
1,2,11,4,7,-3
1,2,12,11,10,1
1,2,13,0,2,-2
1,2,14,7,7,0
1,2,15,13,12,1
1,2,16,11,5,6
1,2,17,4,6,-2
1,2,18,7,6,1
1,2,19,9,11,-2
1,2,20,13,7,6
1,2,21,0,5,-5
1,2,22,6,7,-1
1,2,23,3,12,-9
1,2,24,14,15,-1
1,2,25,5,3,2
1,2,26,20,11,9
1,2,27,3,3,0
1,2,28,6,7,-1
1,2,29,10,11,-1
1,2,30,6,18,-12
1,2,31,9,9,0
1,2,32,13,10,3
1,2,33,10,7,3
1,2,34,7,11,-4
1,2,35,2,2,0
1,2,36,7,10,-3
1,2,37,6,4,2
1,2,38,4,9,-5
1,2,39,2,6,-4
1,2,40,5,8,-3
1,2,41,6,3,3
1,2,42,4,2,2
1,2,43,3,1,2
1,2,44,4,0,4
1,2,45,2,4,-2
1,2,46,12,12,0
1,2,47,3,1,2
1,2,48,7,3,4
1,2,49,3,7,-4
1,2,50,3,3,0
1,2,51,6,12,-6
1,2,52,6,5,1
1,2,53,5,5,0
1,2,54,8,8,0
1,2,55,5,4,1
1,2,56,2,4,-2
1,2,57,3,7,-4
1,2,58,15,8,7
1,2,59,2,3,-1
1,2,60,10,9,1
1,2,61,4,7,-3
1,2,62,11,16,-5
1,2,63,11,18,-7
1,2,64,7,11,-4
1,2,65,4,3,1
1,2,66,4,3,1
1,2,67,6,6,0
1,2,68,1,7,-6
1,2,69,7,6,1
1,2,70,2,5,-3
1,2,71,12,8,4
1,2,72,0,1,-1
1,2,73,4,4,0
1,2,74,7,8,-1
1,2,75,9,13,-4
1,2,76,7,2,5
1,2,77,14,12,2
1,2,78,9,9,0
1,2,79,11,11,0
1,2,80,9,7,2
1,2,81,5,4,1
1,2,82,10,11,-1
1,2,83,8,1,7
1,2,84,7,6,1
1,2,85,4,4,0
1,2,86,18,5,13
1,2,87,6,3,3
1,2,88,4,4,0
1,2,89,6,11,-5
1,2,90,4,4,0
1,2,91,7,12,-5
1,2,92,17,5,12
1,2,93,4,3,1
1,2,94,7,6,1
1,2,95,4,8,-4
1,2,96,5,3,2
1,2,97,6,5,1
1,2,98,4,6,-2
1,2,99,7,9,-2
1,2,100,3,7,-4
1,2,101,5,4,1
1,2,102,1,4,-3
1,2,103,11,6,5
1,2,104,12,13,-1
1,2,105,9,2,7
1,2,106,13,10,3
1,2,107,5,8,-3
1,2,108,9,6,3
1,2,109,3,7,-4
1,2,110,8,11,-3
1,2,111,0,2,-2
1,2,112,16,6,10
1,2,113,7,6,1
1,2,114,4,2,2
1,2,115,7,8,-1
1,2,116,9,8,1
1,2,117,5,7,-2
1,2,118,9,6,3
1,2,119,3,3,0
1,2,120,4,6,-2
1,2,121,4,8,-4
1,2,122,6,6,0
1,2,123,14,7,7
1,2,124,3,17,-14
1,2,125,5,7,-2
1,2,126,0,0,0
1,2,127,5,6,-1
1,2,128,5,8,-3
1,2,129,2,11,-9
1,2,130,4,16,-12
1,2,131,7,4,3
1,2,132,4,3,1
1,2,133,9,3,6
1,2,134,1,1,0
1,2,135,8,13,-5
1,2,136,2,2,0
1,2,137,6,3,3
1,2,138,5,1,4
1,2,139,7,3,4
1,2,140,8,4,4
1,2,141,9,16,-7
1,2,142,12,7,5
1,2,143,3,6,-3
1,2,144,8,4,4
1,2,145,13,6,7
1,2,146,8,13,-5
1,2,147,3,15,-12
1,2,148,5,9,-4
1,2,149,4,17,-13
1,2,150,4,5,-1
1,2,151,5,1,4
1,2,152,3,4,-1
1,2,153,12,8,4
1,2,154,3,3,0
1,2,155,5,4,1
1,2,156,15,2,13
1,2,157,6,9,-3
1,2,158,12,3,9
1,2,159,6,5,1
1,2,160,3,1,2
1,2,161,7,4,3
1,2,162,14,9,5
1,2,163,7,1,6
1,2,164,4,2,2
1,2,165,6,7,-1
1,2,166,5,2,3
1,2,167,6,9,-3
1,2,168,6,3,3
1,2,169,5,4,1
1,2,170,5,5,0
1,2,171,2,4,-2
1,2,172,3,12,-9
1,2,173,6,6,0
1,2,174,0,3,-3
1,2,175,9,2,7
1,2,176,3,7,-4
1,2,177,3,1,2
1,2,178,4,4,0
1,2,179,1,3,-2
1,2,180,4,4,0
1,2,181,14,3,11
1,2,182,5,5,0
1,2,183,5,4,1
1,2,184,8,10,-2
1,2,185,10,17,-7
1,2,186,6,5,1
1,2,187,2,1,1
1,2,188,5,12,-7
1,2,189,15,11,4
1,2,190,5,7,-2
1,2,191,4,9,-5
1,2,192,3,6,-3
1,2,193,13,9,4
1,2,194,6,7,-1
1,2,195,3,4,-1
1,2,196,4,9,-5
1,2,197,11,19,-8
1,2,198,7,16,-9
1,2,199,5,11,-6
1,2,200,6,0,6
1,2,201,4,3,1
1,2,202,6,5,1
1,2,203,11,16,-5
1,2,204,6,3,3
1,2,205,7,11,-4
1,2,206,3,4,-1
1,2,207,3,3,0
1,2,208,1,2,-1
1,2,209,9,18,-9
1,2,210,8,11,-3
1,2,211,7,5,2
1,2,212,6,5,1
1,2,213,5,9,-4
1,2,214,9,4,5
1,2,215,6,12,-6
1,2,216,4,8,-4
1,2,217,3,5,-2
1,2,218,8,5,3
1,2,219,17,6,11
1,2,220,2,4,-2
1,2,221,4,2,2
1,2,222,9,11,-2
1,2,223,5,10,-5
1,2,224,8,7,1
1,2,225,1,2,-1
1,2,226,5,6,-1
1,2,227,2,6,-4
1,2,228,5,6,-1
1,2,229,2,4,-2
1,2,230,8,4,4
1,2,231,3,10,-7
1,2,232,17,16,1
1,2,233,9,13,-4
1,2,234,4,5,-1
1,2,235,14,4,10
1,2,236,8,9,-1
1,2,237,0,9,-9
1,2,238,1,10,-9
1,2,239,4,2,2
1,2,240,8,5,3
1,2,241,13,7,6
1,2,242,5,6,-1
1,2,243,10,8,2
1,2,244,8,4,4
1,2,245,1,4,-3
1,2,246,7,5,2
1,2,247,0,2,-2
1,2,248,7,7,0
1,2,249,7,4,3
1,2,250,9,7,2
1,2,251,7,7,0
1,2,252,11,16,-5
1,2,253,2,0,2
1,2,254,1,4,-3
1,2,255,2,0,2
1,2,256,6,15,-9
1,2,257,3,5,-2
1,2,258,12,10,2
1,2,259,6,5,1
1,2,260,2,8,-6
1,2,261,1,2,-1
1,2,262,6,7,-1
1,2,263,4,3,1
1,2,264,6,3,3
1,2,265,3,10,-7
1,2,266,8,4,4
1,2,267,8,4,4
1,2,268,14,10,4
1,2,269,5,8,-3
1,2,270,2,3,-1
1,2,271,2,6,-4
1,2,272,7,20,-13
1,2,273,12,11,1
1,2,274,8,8,0
1,2,275,2,6,-4
1,2,276,6,6,0
1,2,277,7,5,2
1,2,278,4,9,-5
1,2,279,7,5,2
1,2,280,10,11,-1
1,2,281,15,10,5
1,2,282,13,12,1
1,2,283,2,1,1
1,2,284,16,9,7
1,2,285,2,5,-3
1,2,286,3,9,-6
1,2,287,1,12,-11
1,2,288,8,10,-2
1,2,289,7,1,6
1,2,290,0,4,-4
1,2,291,8,5,3
1,2,292,9,17,-8
1,2,293,5,10,-5
1,2,294,4,6,-2
1,2,295,5,3,2
1,2,296,8,4,4
1,2,297,8,12,-4
1,2,298,8,6,2
1,2,299,15,14,1
1,3,0,15,16,-1
1,3,1,7,4,3
1,3,2,14,6,8
1,3,3,7,14,-7
1,3,4,4,14,-10
1,3,5,6,10,-4
1,3,6,9,2,7
1,3,7,4,11,-7
1,3,8,7,9,-2
1,3,9,3,6,-3
1,3,10,5,4,1
1,3,11,8,9,-1
1,3,12,7,6,1
1,3,13,5,9,-4
1,3,14,4,12,-8
1,3,15,4,3,1
1,3,16,13,5,8
1,3,17,7,13,-6
1,3,18,7,8,-1
1,3,19,7,8,-1
1,3,20,13,25,-12
1,3,21,6,8,-2
1,3,22,3,1,2
1,3,23,9,5,4
1,3,24,8,5,3
1,3,25,9,5,4
1,3,26,3,3,0
1,3,27,14,6,8
1,3,28,2,8,-6
1,3,29,3,4,-1
1,3,30,2,4,-2
1,3,31,2,12,-10
1,3,32,8,1,7
1,3,33,3,3,0
1,3,34,3,4,-1
1,3,35,7,2,5
1,3,36,11,13,-2
1,3,37,9,4,5
1,3,38,8,8,0
1,3,39,2,3,-1
1,3,40,5,4,1
1,3,41,7,8,-1
1,3,42,13,6,7
1,3,43,4,8,-4
1,3,44,14,7,7
1,3,45,8,12,-4
1,3,46,11,12,-1
1,3,47,11,11,0
1,3,48,4,2,2
1,3,49,6,7,-1
1,3,50,11,9,2
1,3,51,8,11,-3
1,3,52,2,7,-5
1,3,53,10,5,5
1,3,54,3,11,-8
1,3,55,14,26,-12
1,3,56,13,4,9
1,3,57,2,3,-1
1,3,58,7,10,-3
1,3,59,7,7,0
1,3,60,7,5,2
1,3,61,5,14,-9
1,3,62,10,17,-7
1,3,63,7,14,-7
1,3,64,10,6,4
1,3,65,21,12,9
1,3,66,8,7,1
1,3,67,2,7,-5
1,3,68,6,6,0
1,3,69,9,12,-3
1,3,70,4,11,-7
1,3,71,4,5,-1
1,3,72,2,3,-1
1,3,73,4,21,-17
1,3,74,8,7,1
1,3,75,5,19,-14
1,3,76,6,6,0
1,3,77,11,6,5
1,3,78,21,21,0
1,3,79,13,11,2
1,3,80,3,2,1
1,3,81,15,16,-1
1,3,82,5,5,0
1,3,83,6,5,1
1,3,84,3,9,-6
1,3,85,7,8,-1
1,3,86,7,8,-1
1,3,87,3,3,0
1,3,88,4,5,-1
1,3,89,7,4,3
1,3,90,15,10,5
1,3,91,8,12,-4
1,3,92,12,15,-3
1,3,93,11,5,6
1,3,94,11,5,6
1,3,95,0,1,-1
1,3,96,9,15,-6
1,3,97,9,15,-6
1,3,98,11,9,2
1,3,99,10,4,6
1,3,100,19,10,9
1,3,101,6,5,1
1,3,102,4,8,-4
1,3,103,4,14,-10
1,3,104,20,29,-9
1,3,105,13,12,1
1,3,106,10,7,3
1,3,107,7,1,6
1,3,108,14,11,3
1,3,109,10,7,3
1,3,110,9,12,-3
1,3,111,12,17,-5
1,3,112,7,5,2
1,3,113,4,5,-1
1,3,114,4,4,0
1,3,115,9,10,-1
1,3,116,4,4,0
1,3,117,2,10,-8
1,3,118,10,1,9
1,3,119,24,11,13
1,3,120,14,22,-8
1,3,121,9,10,-1
1,3,122,7,7,0
1,3,123,5,8,-3
1,3,124,3,9,-6
1,3,125,5,6,-1
1,3,126,3,7,-4
1,3,127,9,9,0
1,3,128,11,8,3
1,3,129,7,11,-4
1,3,130,6,18,-12
1,3,131,16,8,8
1,3,132,12,9,3
1,3,133,4,8,-4
1,3,134,9,6,3
1,3,135,9,10,-1
1,3,136,7,10,-3
1,3,137,9,1,8
1,3,138,9,6,3
1,3,139,9,6,3
1,3,140,3,10,-7
1,3,141,17,11,6
1,3,142,13,10,3
1,3,143,13,14,-1
1,3,144,10,3,7
1,3,145,5,7,-2
1,3,146,11,3,8
1,3,147,2,5,-3
1,3,148,7,5,2
1,3,149,6,13,-7
1,3,150,3,13,-10
1,3,151,26,11,15
1,3,152,10,17,-7
1,3,153,5,4,1
1,3,154,7,7,0
1,3,155,5,15,-10
1,3,156,13,12,1
1,3,157,21,14,7
1,3,158,6,11,-5
1,3,159,0,7,-7
1,3,160,4,3,1
1,3,161,13,14,-1
1,3,162,10,8,2
1,3,163,10,8,2
1,3,164,0,2,-2
1,3,165,18,10,8
1,3,166,3,3,0
1,3,167,3,7,-4
1,3,168,7,12,-5
1,3,169,13,14,-1
1,3,170,8,9,-1
1,3,171,1,5,-4
1,3,172,7,4,3
1,3,173,5,1,4
1,3,174,10,9,1
1,3,175,8,9,-1
1,3,176,3,4,-1
1,3,177,8,7,1
1,3,178,7,6,1
1,3,179,14,7,7
1,3,180,10,6,4
1,3,181,12,8,4
1,3,182,16,26,-10
1,3,183,6,3,3
1,3,184,1,4,-3
1,3,185,11,7,4
1,3,186,12,8,4
1,3,187,11,10,1
1,3,188,12,14,-2
1,3,189,7,5,2
1,3,190,8,14,-6
1,3,191,7,8,-1
1,3,192,3,5,-2
1,3,193,4,1,3
1,3,194,1,1,0
1,3,195,9,2,7
1,3,196,4,7,-3
1,3,197,3,12,-9
1,3,198,6,4,2
1,3,199,5,5,0
1,3,200,5,6,-1
1,3,201,9,6,3
1,3,202,13,13,0
1,3,203,4,6,-2
1,3,204,14,12,2
1,3,205,5,14,-9
1,3,206,5,5,0
1,3,207,8,7,1
1,3,208,1,1,0
1,3,209,7,9,-2
1,3,210,6,4,2
1,3,211,1,3,-2
1,3,212,20,27,-7
1,3,213,13,13,0
1,3,214,7,5,2
1,3,215,4,8,-4
1,3,216,8,4,4
1,3,217,6,8,-2
1,3,218,4,11,-7
1,3,219,4,6,-2
1,3,220,9,15,-6
1,3,221,8,4,4
1,3,222,10,16,-6
1,3,223,4,5,-1
1,3,224,4,1,3
1,3,225,10,6,4
1,3,226,5,22,-17
1,3,227,16,5,11
1,3,228,7,10,-3
1,3,229,11,10,1
1,3,230,12,6,6
1,3,231,14,7,7
1,3,232,5,4,1
1,3,233,16,13,3
1,3,234,10,9,1
1,3,235,13,5,8
1,3,236,3,3,0
1,3,237,4,12,-8
1,3,238,3,6,-3
1,3,239,13,9,4
1,3,240,8,6,2
1,3,241,0,1,-1
1,3,242,5,20,-15
1,3,243,7,7,0
1,3,244,4,7,-3
1,3,245,4,3,1
1,3,246,4,8,-4
1,3,247,8,6,2
1,3,248,12,4,8
1,3,249,8,17,-9
1,3,250,2,5,-3
1,3,251,2,7,-5
1,3,252,7,9,-2
1,3,253,7,6,1
1,3,254,15,16,-1
1,3,255,8,0,8
1,3,256,12,3,9
1,3,257,6,7,-1
1,3,258,11,6,5
1,3,259,17,9,8
1,3,260,3,3,0
1,3,261,6,11,-5
1,3,262,5,7,-2
1,3,263,2,3,-1
1,3,264,1,1,0
1,3,265,6,8,-2
1,3,266,12,13,-1
1,3,267,7,9,-2
1,3,268,6,4,2
1,3,269,7,7,0
1,3,270,2,12,-10
1,3,271,13,6,7
1,3,272,1,7,-6
1,3,273,6,7,-1
1,3,274,8,12,-4
1,3,275,8,10,-2
1,3,276,7,2,5
1,3,277,8,12,-4
1,3,278,9,4,5
1,3,279,4,6,-2
1,3,280,7,15,-8
1,3,281,3,7,-4
1,3,282,6,8,-2
1,3,283,10,4,6
1,3,284,6,13,-7
1,3,285,10,9,1
1,3,286,9,5,4
1,3,287,6,6,0
1,3,288,4,7,-3
1,3,289,7,8,-1
1,3,290,5,2,3
1,3,291,0,6,-6
1,3,292,6,5,1
1,3,293,10,6,4
1,3,294,3,15,-12
1,3,295,7,21,-14
1,3,296,7,1,6
1,3,297,5,4,1
1,3,298,2,6,-4
1,3,299,8,15,-7
1,4,0,9,6,3
1,4,1,0,6,-6
1,4,2,17,16,1
1,4,3,10,4,6
1,4,4,5,7,-2
1,4,5,4,3,1
1,4,6,2,3,-1
1,4,7,14,7,7
1,4,8,2,5,-3
1,4,9,6,5,1
1,4,10,7,5,2
1,4,11,7,17,-10
1,4,12,11,9,2
1,4,13,11,8,3
1,4,14,5,4,1
1,4,15,8,6,2
1,4,16,15,11,4
1,4,17,8,2,6
1,4,18,13,5,8
1,4,19,15,7,8
1,4,20,9,6,3
1,4,21,12,8,4
1,4,22,15,12,3
1,4,23,8,11,-3
1,4,24,7,11,-4
1,4,25,2,2,0
1,4,26,3,2,1
1,4,27,21,8,13
1,4,28,13,6,7
1,4,29,9,11,-2
1,4,30,10,10,0
1,4,31,10,6,4
1,4,32,3,2,1
1,4,33,5,5,0
1,4,34,4,5,-1
1,4,35,6,4,2
1,4,36,4,5,-1
1,4,37,10,14,-4
1,4,38,2,6,-4
1,4,39,6,2,4
1,4,40,12,11,1
1,4,41,8,6,2
1,4,42,18,16,2
1,4,43,7,13,-6
1,4,44,22,16,6
1,4,45,6,5,1
1,4,46,7,10,-3
1,4,47,2,3,-1
1,4,48,9,8,1
1,4,49,11,7,4
1,4,50,1,3,-2
1,4,51,9,8,1
1,4,52,6,7,-1
1,4,53,9,18,-9
1,4,54,3,4,-1
1,4,55,4,18,-14
1,4,56,12,3,9
1,4,57,16,6,10
1,4,58,7,8,-1
1,4,59,17,13,4
1,4,60,10,9,1
1,4,61,1,8,-7
1,4,62,12,14,-2
1,4,63,11,10,1
1,4,64,14,8,6
1,4,65,3,2,1
1,4,66,21,5,16
1,4,67,11,6,5
1,4,68,9,16,-7
1,4,69,6,7,-1
1,4,70,8,14,-6
1,4,71,4,5,-1
1,4,72,10,2,8
1,4,73,7,8,-1
1,4,74,6,8,-2
1,4,75,8,8,0
1,4,76,12,5,7
1,4,77,5,7,-2
1,4,78,11,7,4
1,4,79,14,10,4
1,4,80,7,12,-5
1,4,81,9,9,0
1,4,82,11,9,2
1,4,83,3,6,-3
1,4,84,21,2,19
1,4,85,7,5,2
1,4,86,12,9,3
1,4,87,8,2,6
1,4,88,4,5,-1
1,4,89,11,15,-4
1,4,90,17,10,7
1,4,91,4,7,-3
1,4,92,3,4,-1
1,4,93,9,2,7
1,4,94,6,9,-3
1,4,95,10,8,2
1,4,96,8,23,-15
1,4,97,4,7,-3
1,4,98,2,4,-2
1,4,99,8,3,5
1,4,100,15,9,6
1,4,101,9,7,2
1,4,102,15,14,1
1,4,103,9,6,3
1,4,104,17,5,12
1,4,105,14,5,9
1,4,106,11,10,1
1,4,107,6,5,1
1,4,108,11,16,-5
1,4,109,2,7,-5
1,4,110,6,1,5
1,4,111,1,3,-2
1,4,112,4,4,0
1,4,113,0,7,-7
1,4,114,5,14,-9
1,4,115,6,10,-4
1,4,116,15,16,-1
1,4,117,18,11,7
1,4,118,3,5,-2
1,4,119,9,7,2
1,4,120,12,14,-2
1,4,121,5,12,-7
1,4,122,9,7,2
1,4,123,3,11,-8
1,4,124,13,17,-4
1,4,125,9,7,2
1,4,126,3,12,-9
1,4,127,9,4,5
1,4,128,14,13,1
1,4,129,15,7,8
1,4,130,7,12,-5
1,4,131,8,7,1
1,4,132,5,7,-2
1,4,133,20,7,13
1,4,134,3,4,-1
1,4,135,12,9,3
1,4,136,6,1,5
1,4,137,15,7,8
1,4,138,8,13,-5
1,4,139,15,13,2
1,4,140,9,9,0
1,4,141,1,0,1
1,4,142,5,4,1
1,4,143,8,10,-2
1,4,144,5,12,-7
1,4,145,5,8,-3
1,4,146,3,10,-7
1,4,147,8,10,-2
1,4,148,2,2,0
1,4,149,12,9,3
1,4,150,13,6,7
1,4,151,3,3,0
1,4,152,8,15,-7
1,4,153,8,10,-2
1,4,154,4,13,-9
1,4,155,8,6,2
1,4,156,13,8,5
1,4,157,5,11,-6
1,4,158,11,25,-14
1,4,159,8,3,5
1,4,160,13,15,-2
1,4,161,11,19,-8
1,4,162,9,15,-6
1,4,163,10,4,6
1,4,164,9,7,2
1,4,165,18,8,10
1,4,166,1,8,-7
1,4,167,11,7,4
1,4,168,3,3,0
1,4,169,4,9,-5
1,4,170,13,5,8
1,4,171,17,14,3
1,4,172,8,7,1
1,4,173,4,5,-1
1,4,174,14,10,4
1,4,175,6,20,-14
1,4,176,3,8,-5
1,4,177,14,11,3
1,4,178,10,8,2
1,4,179,5,15,-10
1,4,180,9,8,1
1,4,181,9,11,-2
1,4,182,3,4,-1
1,4,183,18,10,8
1,4,184,8,6,2
1,4,185,16,5,11
1,4,186,8,12,-4
1,4,187,4,3,1
1,4,188,7,7,0
1,4,189,9,15,-6
1,4,190,13,7,6
1,4,191,10,15,-5
1,4,192,8,8,0
1,4,193,5,9,-4
1,4,194,8,5,3
1,4,195,7,4,3
1,4,196,12,10,2
1,4,197,18,11,7
1,4,198,3,13,-10
1,4,199,13,12,1
1,4,200,14,11,3
1,4,201,4,0,4
1,4,202,8,3,5
1,4,203,5,8,-3
1,4,204,6,8,-2
1,4,205,33,14,19
1,4,206,3,6,-3
1,4,207,11,6,5
1,4,208,1,3,-2
1,4,209,16,8,8
1,4,210,9,10,-1
1,4,211,12,12,0
1,4,212,5,15,-10
1,4,213,8,11,-3
1,4,214,11,15,-4
1,4,215,10,5,5
1,4,216,17,18,-1
1,4,217,7,11,-4
1,4,218,0,0,0
1,4,219,3,6,-3
1,4,220,5,9,-4
1,4,221,15,17,-2
1,4,222,13,15,-2
1,4,223,16,9,7
1,4,224,12,3,9
1,4,225,12,4,8
1,4,226,5,4,1
1,4,227,8,10,-2
1,4,228,7,22,-15
1,4,229,12,10,2
1,4,230,7,11,-4
1,4,231,15,5,10
1,4,232,6,2,4
1,4,233,14,26,-12
1,4,234,11,12,-1
1,4,235,10,0,10
1,4,236,6,6,0
1,4,237,9,14,-5
1,4,238,6,2,4
1,4,239,7,13,-6
1,4,240,11,8,3
1,4,241,24,19,5
1,4,242,8,10,-2
1,4,243,6,4,2
1,4,244,14,11,3
1,4,245,16,12,4
1,4,246,9,4,5
1,4,247,6,1,5
1,4,248,14,26,-12
1,4,249,8,11,-3
1,4,250,4,2,2
1,4,251,7,10,-3
1,4,252,6,8,-2
1,4,253,10,9,1
1,4,254,14,13,1
1,4,255,20,13,7
1,4,256,3,4,-1
1,4,257,9,11,-2
1,4,258,0,1,-1
1,4,259,8,12,-4
1,4,260,5,5,0
1,4,261,19,8,11
1,4,262,14,6,8
1,4,263,4,6,-2
1,4,264,8,7,1
1,4,265,11,6,5
1,4,266,13,3,10
1,4,267,5,8,-3
1,4,268,3,4,-1
1,4,269,2,1,1
1,4,270,7,8,-1
1,4,271,4,12,-8
1,4,272,5,4,1
1,4,273,4,11,-7
1,4,274,14,5,9
1,4,275,12,13,-1
1,4,276,9,12,-3
1,4,277,11,9,2
1,4,278,10,13,-3
1,4,279,21,15,6
1,4,280,8,4,4
1,4,281,12,6,6
1,4,282,5,5,0
1,4,283,10,17,-7
1,4,284,13,13,0
1,4,285,14,10,4
1,4,286,10,7,3
1,4,287,7,5,2
1,4,288,11,11,0
1,4,289,8,10,-2
1,4,290,10,8,2
1,4,291,10,8,2
1,4,292,1,8,-7
1,4,293,10,8,2
1,4,294,16,17,-1
1,4,295,6,2,4
1,4,296,8,14,-6
1,4,297,9,3,6
1,4,298,7,3,4
1,4,299,10,19,-9
1,5,0,7,15,-8
1,5,1,1,7,-6
1,5,2,19,15,4
1,5,3,6,2,4
1,5,4,13,6,7
1,5,5,6,5,1
1,5,6,22,12,10
1,5,7,7,5,2
1,5,8,4,4,0
1,5,9,10,9,1
1,5,10,5,8,-3
1,5,11,7,8,-1
1,5,12,4,6,-2
1,5,13,12,11,1
1,5,14,9,6,3
1,5,15,15,8,7
1,5,16,9,8,1
1,5,17,4,3,1
1,5,18,9,6,3
1,5,19,6,4,2
1,5,20,6,5,1
1,5,21,13,12,1
1,5,22,10,22,-12
1,5,23,14,5,9
1,5,24,9,9,0
1,5,25,4,1,3
1,5,26,14,12,2
1,5,27,7,3,4
1,5,28,10,8,2
1,5,29,11,11,0
1,5,30,8,12,-4
1,5,31,13,7,6
1,5,32,13,3,10
1,5,33,9,14,-5
1,5,34,7,3,4
1,5,35,16,7,9
1,5,36,10,15,-5
1,5,37,27,9,18
1,5,38,13,12,1
1,5,39,4,18,-14
1,5,40,12,4,8
1,5,41,11,9,2
1,5,42,1,10,-9
1,5,43,6,9,-3
1,5,44,11,18,-7
1,5,45,16,17,-1
1,5,46,6,5,1
1,5,47,12,13,-1
1,5,48,10,3,7
1,5,49,13,18,-5
1,5,50,28,13,15
1,5,51,9,17,-8
1,5,52,9,12,-3
1,5,53,13,9,4
1,5,54,8,8,0
1,5,55,8,14,-6
1,5,56,18,9,9
1,5,57,10,12,-2
1,5,58,5,3,2
1,5,59,11,9,2
1,5,60,10,5,5
1,5,61,19,20,-1
1,5,62,15,15,0
1,5,63,13,10,3
1,5,64,14,14,0
1,5,65,7,7,0
1,5,66,1,3,-2
1,5,67,12,9,3
1,5,68,14,7,7
1,5,69,11,14,-3
1,5,70,25,13,12
1,5,71,4,9,-5
1,5,72,7,2,5
1,5,73,16,15,1
1,5,74,19,10,9
1,5,75,8,2,6
1,5,76,22,7,15
1,5,77,6,3,3
1,5,78,4,1,3
1,5,79,7,4,3
1,5,80,2,4,-2
1,5,81,7,7,0
1,5,82,6,11,-5
1,5,83,11,4,7
1,5,84,13,7,6
1,5,85,13,8,5
1,5,86,16,7,9
1,5,87,14,20,-6
1,5,88,3,5,-2
1,5,89,12,5,7
1,5,90,4,4,0
1,5,91,22,17,5
1,5,92,9,7,2
1,5,93,9,13,-4
1,5,94,11,11,0
1,5,95,14,17,-3
1,5,96,7,9,-2
1,5,97,6,9,-3
1,5,98,7,3,4
1,5,99,13,6,7
1,5,100,4,2,2
1,5,101,4,3,1
1,5,102,8,8,0
1,5,103,18,22,-4
1,5,104,0,2,-2
1,5,105,10,9,1
1,5,106,5,9,-4
1,5,107,2,3,-1
1,5,108,12,6,6
1,5,109,10,10,0
1,5,110,7,4,3
1,5,111,13,4,9
1,5,112,10,10,0
1,5,113,6,10,-4
1,5,114,8,15,-7
1,5,115,14,23,-9
1,5,116,8,2,6
1,5,117,6,5,1
1,5,118,13,16,-3
1,5,119,3,8,-5
1,5,120,13,26,-13
1,5,121,11,17,-6
1,5,122,13,14,-1
1,5,123,12,13,-1
1,5,124,7,2,5
1,5,125,15,15,0
1,5,126,14,7,7
1,5,127,4,13,-9
1,5,128,8,22,-14
1,5,129,11,12,-1
1,5,130,6,6,0
1,5,131,13,8,5
1,5,132,11,10,1
1,5,133,10,11,-1
1,5,134,9,10,-1
1,5,135,4,6,-2
1,5,136,11,3,8
1,5,137,12,7,5
1,5,138,11,7,4
1,5,139,13,12,1
1,5,140,8,9,-1
1,5,141,17,17,0
1,5,142,8,3,5
1,5,143,16,19,-3
1,5,144,4,1,3
1,5,145,13,13,0
1,5,146,3,12,-9
1,5,147,6,12,-6
1,5,148,19,10,9
1,5,149,13,5,8
1,5,150,9,13,-4
1,5,151,3,5,-2
1,5,152,8,10,-2
1,5,153,2,6,-4
1,5,154,7,7,0
1,5,155,9,10,-1
1,5,156,8,4,4
1,5,157,6,6,0
1,5,158,11,14,-3
1,5,159,16,10,6
1,5,160,2,6,-4
1,5,161,6,5,1
1,5,162,9,6,3
1,5,163,10,8,2
1,5,164,3,5,-2
1,5,165,7,4,3
1,5,166,13,9,4
1,5,167,11,12,-1
1,5,168,14,7,7
1,5,169,14,11,3
1,5,170,5,13,-8
1,5,171,4,3,1
1,5,172,9,6,3
1,5,173,11,21,-10
1,5,174,6,5,1
1,5,175,7,4,3
1,5,176,9,7,2
1,5,177,5,10,-5
1,5,178,10,11,-1
1,5,179,8,5,3
1,5,180,8,11,-3
1,5,181,4,5,-1
1,5,182,10,14,-4
1,5,183,11,9,2
1,5,184,16,15,1
1,5,185,9,7,2
1,5,186,9,11,-2
1,5,187,7,6,1
1,5,188,13,4,9
1,5,189,19,11,8
1,5,190,1,7,-6
1,5,191,4,7,-3
1,5,192,11,5,6
1,5,193,13,18,-5
1,5,194,5,16,-11
1,5,195,8,7,1
1,5,196,16,18,-2
1,5,197,12,2,10
1,5,198,10,4,6
1,5,199,16,8,8
1,5,200,5,7,-2
1,5,201,6,8,-2
1,5,202,5,9,-4
1,5,203,6,18,-12
1,5,204,8,5,3
1,5,205,10,5,5
1,5,206,8,3,5
1,5,207,2,8,-6
1,5,208,8,3,5
1,5,209,7,4,3
1,5,210,20,22,-2
1,5,211,10,11,-1
1,5,212,8,3,5
1,5,213,8,4,4
1,5,214,9,15,-6
1,5,215,19,16,3
1,5,216,3,6,-3
1,5,217,11,1,10
1,5,218,7,6,1
1,5,219,5,10,-5
1,5,220,7,2,5
1,5,221,2,7,-5
1,5,222,10,12,-2
1,5,223,14,18,-4
1,5,224,10,10,0
1,5,225,6,9,-3
1,5,226,10,8,2
1,5,227,8,15,-7
1,5,228,17,14,3
1,5,229,12,7,5
1,5,230,13,7,6
1,5,231,12,11,1
1,5,232,9,16,-7
1,5,233,10,9,1
1,5,234,16,8,8
1,5,235,6,6,0
1,5,236,18,10,8
1,5,237,2,6,-4
1,5,238,6,11,-5
1,5,239,14,9,5
1,5,240,13,7,6
1,5,241,2,7,-5
1,5,242,17,9,8
1,5,243,7,1,6
1,5,244,16,9,7
1,5,245,8,4,4
1,5,246,15,7,8
1,5,247,3,4,-1
1,5,248,6,6,0
1,5,249,9,5,4
1,5,250,6,3,3
1,5,251,3,3,0
1,5,252,19,17,2
1,5,253,19,12,7
1,5,254,9,3,6
1,5,255,2,6,-4
1,5,256,11,8,3
1,5,257,4,5,-1
1,5,258,7,13,-6
1,5,259,10,8,2
1,5,260,8,2,6
1,5,261,7,2,5
1,5,262,8,13,-5
1,5,263,6,13,-7
1,5,264,11,13,-2
1,5,265,19,17,2
1,5,266,14,9,5
1,5,267,6,6,0
1,5,268,3,6,-3
1,5,269,7,6,1
1,5,270,10,11,-1
1,5,271,7,7,0
1,5,272,10,7,3
1,5,273,18,17,1
1,5,274,7,4,3
1,5,275,6,1,5
1,5,276,8,14,-6
1,5,277,7,8,-1
1,5,278,11,4,7
1,5,279,8,7,1
1,5,280,19,15,4
1,5,281,23,6,17
1,5,282,7,5,2
1,5,283,8,7,1
1,5,284,11,18,-7
1,5,285,10,6,4
1,5,286,5,7,-2
1,5,287,13,18,-5
1,5,288,9,6,3
1,5,289,27,5,22
1,5,290,12,11,1
1,5,291,3,0,3
1,5,292,3,12,-9
1,5,293,12,12,0
1,5,294,8,6,2
1,5,295,2,6,-4
1,5,296,6,5,1
1,5,297,12,7,5
1,5,298,13,6,7
1,5,299,6,1,5
1,6,0,9,3,6
1,6,1,9,7,2
1,6,2,6,10,-4
1,6,3,14,7,7
1,6,4,4,1,3
1,6,5,15,2,13
1,6,6,16,11,5
1,6,7,5,5,0
1,6,8,20,23,-3
1,6,9,2,10,-8
1,6,10,7,4,3
1,6,11,5,11,-6
1,6,12,9,16,-7
1,6,13,9,5,4
1,6,14,11,5,6
1,6,15,10,10,0
1,6,16,12,4,8
1,6,17,11,9,2
1,6,18,12,7,5
1,6,19,4,5,-1
1,6,20,14,1,13
1,6,21,10,26,-16
1,6,22,5,12,-7
1,6,23,10,12,-2
1,6,24,8,11,-3
1,6,25,12,17,-5
1,6,26,8,8,0
1,6,27,11,6,5
1,6,28,14,25,-11
1,6,29,10,10,0
1,6,30,14,7,7
1,6,31,8,25,-17
1,6,32,3,0,3
1,6,33,8,26,-18
1,6,34,3,6,-3
1,6,35,6,3,3
1,6,36,7,2,5
1,6,37,12,19,-7
1,6,38,18,7,11
1,6,39,8,10,-2
1,6,40,13,8,5
1,6,41,13,15,-2
1,6,42,6,7,-1
1,6,43,7,5,2
1,6,44,12,16,-4
1,6,45,3,6,-3
1,6,46,6,4,2
1,6,47,5,6,-1
1,6,48,10,0,10
1,6,49,5,7,-2
1,6,50,19,6,13
1,6,51,18,15,3
1,6,52,10,13,-3
1,6,53,14,8,6
1,6,54,13,19,-6
1,6,55,12,7,5
1,6,56,9,7,2
1,6,57,3,4,-1
1,6,58,12,15,-3
1,6,59,16,6,10
1,6,60,12,5,7
1,6,61,11,2,9
1,6,62,9,8,1
1,6,63,11,10,1
1,6,64,9,10,-1
1,6,65,11,10,1
1,6,66,3,7,-4
1,6,67,15,5,10
1,6,68,12,11,1
1,6,69,4,6,-2
1,6,70,8,15,-7
1,6,71,11,7,4
1,6,72,2,7,-5
1,6,73,20,9,11
1,6,74,23,20,3
1,6,75,8,7,1
1,6,76,17,15,2
1,6,77,10,10,0
1,6,78,27,18,9
1,6,79,15,19,-4
1,6,80,15,12,3
1,6,81,22,6,16
1,6,82,14,7,7
1,6,83,16,6,10
1,6,84,6,7,-1
1,6,85,13,9,4
1,6,86,8,9,-1
1,6,87,14,7,7
1,6,88,9,12,-3
1,6,89,7,8,-1
1,6,90,8,7,1
1,6,91,5,12,-7
1,6,92,8,17,-9
1,6,93,15,7,8
1,6,94,6,11,-5
1,6,95,7,16,-9
1,6,96,8,6,2
1,6,97,30,12,18
1,6,98,10,5,5
1,6,99,7,6,1
1,6,100,6,13,-7
1,6,101,3,8,-5
1,6,102,16,13,3
1,6,103,7,3,4
1,6,104,4,10,-6
1,6,105,7,16,-9
1,6,106,20,19,1
1,6,107,7,6,1
1,6,108,12,7,5
1,6,109,14,18,-4
1,6,110,15,25,-10
1,6,111,6,10,-4
1,6,112,11,10,1
1,6,113,10,13,-3
1,6,114,4,11,-7
1,6,115,11,9,2
1,6,116,6,5,1
1,6,117,22,12,10
1,6,118,7,3,4
1,6,119,6,6,0
1,6,120,13,6,7
1,6,121,3,6,-3
1,6,122,12,9,3
1,6,123,16,20,-4
1,6,124,10,10,0
1,6,125,12,9,3
1,6,126,7,7,0
1,6,127,9,9,0
1,6,128,13,8,5
1,6,129,10,13,-3
1,6,130,15,11,4
1,6,131,11,8,3
1,6,132,20,23,-3
1,6,133,9,6,3
1,6,134,3,12,-9
1,6,135,9,16,-7
1,6,136,10,1,9
1,6,137,5,4,1
1,6,138,8,5,3
1,6,139,20,24,-4
1,6,140,30,10,20
1,6,141,7,11,-4
1,6,142,8,5,3
1,6,143,19,21,-2
1,6,144,13,14,-1
1,6,145,14,10,4
1,6,146,9,8,1
1,6,147,8,16,-8
1,6,148,15,16,-1
1,6,149,18,11,7
1,6,150,8,11,-3
1,6,151,19,14,5
1,6,152,11,6,5
1,6,153,5,13,-8
1,6,154,11,5,6
1,6,155,18,16,2
1,6,156,12,6,6
1,6,157,10,12,-2
1,6,158,10,4,6
1,6,159,8,7,1
1,6,160,17,4,13
1,6,161,10,12,-2
1,6,162,8,2,6
1,6,163,11,24,-13
1,6,164,9,6,3
1,6,165,7,10,-3
1,6,166,13,8,5
1,6,167,14,8,6
1,6,168,5,6,-1
1,6,169,7,4,3
1,6,170,8,8,0
1,6,171,18,12,6
1,6,172,9,10,-1
1,6,173,19,15,4
1,6,174,7,1,6
1,6,175,12,23,-11
1,6,176,11,10,1
1,6,177,11,9,2
1,6,178,8,18,-10
1,6,179,14,12,2
1,6,180,7,10,-3
1,6,181,10,16,-6
1,6,182,12,5,7
1,6,183,16,9,7
1,6,184,8,22,-14
1,6,185,5,8,-3
1,6,186,13,7,6
1,6,187,14,16,-2
1,6,188,12,4,8
1,6,189,11,8,3
1,6,190,17,5,12
1,6,191,20,10,10
1,6,192,9,12,-3
1,6,193,6,15,-9
1,6,194,15,18,-3
1,6,195,8,13,-5
1,6,196,16,14,2
1,6,197,6,9,-3
1,6,198,11,13,-2
1,6,199,19,18,1
1,6,200,6,17,-11
1,6,201,12,5,7
1,6,202,15,12,3
1,6,203,5,14,-9
1,6,204,18,7,11
1,6,205,5,3,2
1,6,206,5,2,3
1,6,207,13,21,-8
1,6,208,16,19,-3
1,6,209,7,6,1
1,6,210,6,8,-2
1,6,211,10,6,4
1,6,212,17,6,11
1,6,213,4,20,-16
1,6,214,12,12,0
1,6,215,17,9,8
1,6,216,16,13,3
1,6,217,6,6,0
1,6,218,6,7,-1
1,6,219,8,2,6
1,6,220,7,3,4
1,6,221,8,9,-1
1,6,222,9,6,3
1,6,223,14,9,5
1,6,224,15,12,3
1,6,225,7,16,-9
1,6,226,12,14,-2
1,6,227,19,13,6
1,6,228,12,15,-3
1,6,229,13,7,6
1,6,230,17,10,7
1,6,231,6,5,1
1,6,232,7,18,-11
1,6,233,12,3,9
1,6,234,9,5,4
1,6,235,10,3,7
1,6,236,5,6,-1
1,6,237,7,5,2
1,6,238,14,11,3
1,6,239,20,18,2
1,6,240,16,11,5
1,6,241,6,10,-4
1,6,242,7,7,0
1,6,243,5,12,-7
1,6,244,12,14,-2
1,6,245,21,8,13
1,6,246,11,5,6
1,6,247,6,6,0
1,6,248,8,9,-1
1,6,249,15,14,1
1,6,250,5,4,1
1,6,251,3,1,2
1,6,252,13,26,-13
1,6,253,9,18,-9
1,6,254,12,11,1
1,6,255,8,0,8
1,6,256,8,10,-2
1,6,257,9,10,-1
1,6,258,6,14,-8
1,6,259,2,7,-5
1,6,260,1,4,-3
1,6,261,5,6,-1
1,6,262,8,5,3
1,6,263,16,4,12
1,6,264,9,11,-2
1,6,265,19,12,7
1,6,266,10,10,0
1,6,267,16,13,3
1,6,268,7,2,5
1,6,269,7,12,-5
1,6,270,13,8,5
1,6,271,6,10,-4
1,6,272,6,8,-2
1,6,273,9,11,-2
1,6,274,15,9,6
1,6,275,5,2,3
1,6,276,13,9,4
1,6,277,15,2,13
1,6,278,6,2,4
1,6,279,5,2,3
1,6,280,17,13,4
1,6,281,12,11,1
1,6,282,5,4,1
1,6,283,9,16,-7
1,6,284,15,9,6
1,6,285,21,18,3
1,6,286,18,9,9
1,6,287,11,8,3
1,6,288,3,1,2
1,6,289,24,6,18
1,6,290,9,19,-10
1,6,291,14,5,9
1,6,292,12,11,1
1,6,293,2,1,1
1,6,294,13,12,1
1,6,295,6,11,-5
1,6,296,6,9,-3
1,6,297,13,18,-5
1,6,298,7,8,-1
1,6,299,8,1,7
1,7,0,13,25,-12
1,7,1,11,10,1
1,7,2,18,8,10
1,7,3,7,23,-16
1,7,4,10,11,-1
1,7,5,7,18,-11
1,7,6,6,12,-6
1,7,7,13,4,9
1,7,8,6,9,-3
1,7,9,10,10,0
1,7,10,1,6,-5
1,7,11,9,5,4
1,7,12,5,7,-2
1,7,13,20,20,0
1,7,14,19,36,-17
1,7,15,4,4,0
1,7,16,10,9,1
1,7,17,12,9,3
1,7,18,5,7,-2
1,7,19,9,14,-5
1,7,20,12,12,0
1,7,21,10,5,5
1,7,22,12,14,-2
1,7,23,9,11,-2
1,7,24,7,8,-1
1,7,25,7,6,1
1,7,26,9,6,3
1,7,27,18,17,1
1,7,28,16,28,-12
1,7,29,12,15,-3
1,7,30,16,6,10
1,7,31,4,12,-8
1,7,32,11,3,8
1,7,33,7,4,3
1,7,34,13,14,-1
1,7,35,10,8,2
1,7,36,8,15,-7
1,7,37,10,17,-7
1,7,38,10,18,-8
1,7,39,11,23,-12
1,7,40,4,12,-8
1,7,41,19,8,11
1,7,42,13,16,-3
1,7,43,14,9,5
1,7,44,10,4,6
1,7,45,15,10,5
1,7,46,10,13,-3
1,7,47,10,4,6
1,7,48,16,9,7
1,7,49,4,16,-12
1,7,50,6,5,1
1,7,51,8,8,0
1,7,52,27,12,15
1,7,53,10,6,4
1,7,54,15,9,6
1,7,55,19,21,-2
1,7,56,9,16,-7
1,7,57,8,3,5
1,7,58,11,14,-3
1,7,59,5,5,0
1,7,60,8,10,-2
1,7,61,17,13,4
1,7,62,15,14,1
1,7,63,1,1,0
1,7,64,16,20,-4
1,7,65,11,6,5
1,7,66,14,15,-1
1,7,67,11,19,-8
1,7,68,15,2,13
1,7,69,3,4,-1
1,7,70,9,8,1
1,7,71,6,9,-3
1,7,72,9,7,2
1,7,73,12,18,-6
1,7,74,18,12,6
1,7,75,13,12,1
1,7,76,12,9,3
1,7,77,5,4,1
1,7,78,18,18,0
1,7,79,2,4,-2
1,7,80,15,18,-3
1,7,81,13,12,1
1,7,82,3,1,2
1,7,83,14,11,3
1,7,84,13,7,6
1,7,85,14,19,-5
1,7,86,7,3,4
1,7,87,17,16,1
1,7,88,10,8,2
1,7,89,12,5,7
1,7,90,17,14,3
1,7,91,2,4,-2
1,7,92,2,1,1
1,7,93,9,6,3
1,7,94,13,14,-1
1,7,95,9,10,-1
1,7,96,10,10,0
1,7,97,15,16,-1
1,7,98,6,4,2
1,7,99,18,13,5
1,7,100,6,4,2
1,7,101,15,13,2
1,7,102,7,7,0
1,7,103,10,10,0
1,7,104,23,7,16
1,7,105,8,8,0
1,7,106,17,13,4
1,7,107,12,4,8
1,7,108,9,3,6
1,7,109,21,19,2
1,7,110,12,11,1
1,7,111,6,4,2
1,7,112,12,8,4
1,7,113,10,14,-4
1,7,114,8,6,2
1,7,115,15,11,4
1,7,116,13,1,12
1,7,117,6,10,-4
1,7,118,8,6,2
1,7,119,4,2,2
1,7,120,12,13,-1
1,7,121,19,8,11
1,7,122,19,20,-1
1,7,123,16,15,1
1,7,124,17,13,4
1,7,125,18,9,9
1,7,126,21,9,12
1,7,127,9,9,0
1,7,128,19,12,7
1,7,129,17,13,4
1,7,130,14,13,1
1,7,131,7,13,-6
1,7,132,21,9,12
1,7,133,8,6,2
1,7,134,11,7,4
1,7,135,10,23,-13
1,7,136,9,2,7
1,7,137,1,3,-2
1,7,138,21,13,8
1,7,139,14,24,-10
1,7,140,10,7,3
1,7,141,14,14,0
1,7,142,6,11,-5
1,7,143,11,6,5
1,7,144,6,7,-1
1,7,145,8,6,2
1,7,146,9,15,-6
1,7,147,10,7,3
1,7,148,12,10,2
1,7,149,8,10,-2
1,7,150,16,13,3
1,7,151,20,13,7
1,7,152,5,7,-2
1,7,153,13,3,10
1,7,154,14,10,4
1,7,155,12,10,2
1,7,156,10,12,-2
1,7,157,13,14,-1
1,7,158,8,5,3
1,7,159,15,8,7
1,7,160,11,12,-1
1,7,161,18,10,8
1,7,162,22,24,-2
1,7,163,13,2,11
1,7,164,18,16,2
1,7,165,13,8,5
1,7,166,9,12,-3
1,7,167,12,7,5
1,7,168,5,6,-1
1,7,169,20,23,-3
1,7,170,8,4,4
1,7,171,14,11,3
1,7,172,16,16,0
1,7,173,5,6,-1
1,7,174,16,9,7
1,7,175,13,13,0
1,7,176,18,14,4
1,7,177,9,4,5
1,7,178,14,10,4
1,7,179,16,12,4
1,7,180,5,7,-2
1,7,181,4,3,1
1,7,182,18,19,-1
1,7,183,9,9,0
1,7,184,4,10,-6
1,7,185,9,9,0
1,7,186,19,7,12
1,7,187,13,7,6
1,7,188,3,13,-10
1,7,189,15,8,7
1,7,190,13,11,2
1,7,191,18,17,1
1,7,192,17,16,1
1,7,193,11,13,-2
1,7,194,0,6,-6
1,7,195,8,3,5
1,7,196,11,8,3
1,7,197,11,6,5
1,7,198,11,5,6
1,7,199,4,8,-4
1,7,200,11,11,0
1,7,201,16,17,-1
1,7,202,8,6,2
1,7,203,2,6,-4
1,7,204,2,7,-5
1,7,205,6,1,5
1,7,206,6,13,-7
1,7,207,17,9,8
1,7,208,8,8,0
1,7,209,14,6,8
1,7,210,7,12,-5
1,7,211,14,7,7
1,7,212,4,11,-7
1,7,213,11,15,-4
1,7,214,10,13,-3
1,7,215,17,16,1
1,7,216,20,13,7
1,7,217,8,8,0
1,7,218,2,1,1
1,7,219,14,17,-3
1,7,220,16,12,4
1,7,221,19,12,7
1,7,222,18,12,6
1,7,223,8,6,2
1,7,224,5,6,-1
1,7,225,11,5,6
1,7,226,11,3,8
1,7,227,3,8,-5
1,7,228,11,15,-4
1,7,229,7,3,4
1,7,230,15,7,8
1,7,231,25,19,6
1,7,232,8,1,7
1,7,233,16,9,7
1,7,234,22,10,12
1,7,235,19,12,7
1,7,236,2,2,0
1,7,237,6,7,-1
1,7,238,6,8,-2
1,7,239,6,6,0
1,7,240,5,7,-2
1,7,241,12,6,6
1,7,242,12,12,0
1,7,243,15,9,6
1,7,244,3,9,-6
1,7,245,19,15,4
1,7,246,20,5,15
1,7,247,3,8,-5
1,7,248,7,3,4
1,7,249,13,6,7
1,7,250,3,7,-4
1,7,251,6,12,-6
1,7,252,2,6,-4
1,7,253,22,7,15
1,7,254,7,10,-3
1,7,255,16,10,6
1,7,256,12,8,4
1,7,257,19,5,14
1,7,258,6,7,-1
1,7,259,11,14,-3
1,7,260,8,11,-3
1,7,261,13,8,5
1,7,262,7,10,-3
1,7,263,8,12,-4
1,7,264,18,9,9
1,7,265,4,10,-6
1,7,266,3,6,-3
1,7,267,18,4,14
1,7,268,8,11,-3
1,7,269,6,12,-6
1,7,270,21,17,4
1,7,271,11,6,5
1,7,272,2,19,-17
1,7,273,20,5,15
1,7,274,10,13,-3
1,7,275,14,16,-2
1,7,276,11,7,4
1,7,277,2,6,-4
1,7,278,13,8,5
1,7,279,7,5,2
1,7,280,10,16,-6
1,7,281,11,9,2
1,7,282,18,15,3
1,7,283,11,10,1
1,7,284,15,5,10
1,7,285,13,9,4
1,7,286,3,4,-1
1,7,287,12,16,-4
1,7,288,19,17,2
1,7,289,15,11,4
1,7,290,8,7,1
1,7,291,18,15,3
1,7,292,11,12,-1
1,7,293,11,19,-8
1,7,294,17,10,7
1,7,295,4,10,-6
1,7,296,13,8,5
1,7,297,26,2,24
1,7,298,9,6,3
1,7,299,19,20,-1
1,8,0,15,23,-8
1,8,1,15,6,9
1,8,2,5,7,-2
1,8,3,9,4,5
1,8,4,15,5,10
1,8,5,11,8,3
1,8,6,6,11,-5
1,8,7,10,4,6
1,8,8,6,11,-5
1,8,9,17,9,8
1,8,10,4,0,4
1,8,11,12,3,9
1,8,12,20,22,-2
1,8,13,12,12,0
1,8,14,7,10,-3
1,8,15,4,10,-6
1,8,16,7,5,2
1,8,17,8,2,6
1,8,18,7,4,3
1,8,19,7,12,-5
1,8,20,9,11,-2
1,8,21,5,8,-3
1,8,22,12,8,4
1,8,23,14,17,-3
1,8,24,6,6,0
1,8,25,14,21,-7
1,8,26,10,14,-4
1,8,27,16,11,5
1,8,28,7,15,-8
1,8,29,8,3,5
1,8,30,16,25,-9
1,8,31,1,3,-2
1,8,32,11,3,8
1,8,33,6,10,-4
1,8,34,10,18,-8
1,8,35,0,10,-10
1,8,36,12,11,1
1,8,37,16,18,-2
1,8,38,3,10,-7
1,8,39,10,5,5
1,8,40,11,10,1
1,8,41,12,10,2
1,8,42,15,13,2
1,8,43,9,19,-10
1,8,44,11,9,2
1,8,45,4,1,3
1,8,46,9,13,-4
1,8,47,14,25,-11
1,8,48,21,6,15
1,8,49,7,12,-5
1,8,50,19,19,0
1,8,51,28,10,18
1,8,52,10,7,3
1,8,53,10,3,7
1,8,54,20,10,10
1,8,55,13,9,4
1,8,56,18,28,-10
1,8,57,11,9,2
1,8,58,3,3,0
1,8,59,18,11,7
1,8,60,20,15,5
1,8,61,14,4,10
1,8,62,16,8,8
1,8,63,12,10,2
1,8,64,9,13,-4
1,8,65,8,14,-6
1,8,66,20,11,9
1,8,67,4,4,0
1,8,68,19,8,11
1,8,69,7,8,-1
1,8,70,16,10,6
1,8,71,15,8,7
1,8,72,16,5,11
1,8,73,16,13,3
1,8,74,11,7,4
1,8,75,11,5,6
1,8,76,13,11,2
1,8,77,2,7,-5
1,8,78,9,6,3
1,8,79,16,19,-3
1,8,80,13,2,11
1,8,81,11,7,4
1,8,82,15,21,-6
1,8,83,10,8,2
1,8,84,10,9,1
1,8,85,8,2,6
1,8,86,10,8,2
1,8,87,2,5,-3
1,8,88,9,9,0
1,8,89,11,10,1
1,8,90,22,22,0
1,8,91,11,7,4
1,8,92,3,8,-5
1,8,93,8,12,-4
1,8,94,5,2,3
1,8,95,5,0,5
1,8,96,14,6,8
1,8,97,8,12,-4
1,8,98,18,7,11
1,8,99,10,5,5
1,8,100,9,20,-11
1,8,101,18,7,11
1,8,102,6,8,-2
1,8,103,2,0,2
1,8,104,12,7,5
1,8,105,10,6,4
1,8,106,7,7,0
1,8,107,10,5,5
1,8,108,8,9,-1
1,8,109,6,7,-1
1,8,110,3,6,-3
1,8,111,1,2,-1
1,8,112,5,9,-4
1,8,113,8,5,3
1,8,114,9,7,2
1,8,115,12,7,5
1,8,116,7,5,2
1,8,117,4,6,-2
1,8,118,12,6,6
1,8,119,13,12,1
1,8,120,15,6,9
1,8,121,18,13,5
1,8,122,13,14,-1
1,8,123,6,13,-7
1,8,124,10,6,4
1,8,125,15,13,2
1,8,126,10,6,4
1,8,127,6,9,-3
1,8,128,18,23,-5
1,8,129,10,12,-2
1,8,130,17,15,2
1,8,131,4,3,1
1,8,132,11,10,1
1,8,133,6,12,-6
1,8,134,11,15,-4
1,8,135,8,4,4
1,8,136,13,18,-5
1,8,137,14,8,6
1,8,138,6,4,2
1,8,139,5,8,-3
1,8,140,7,6,1
1,8,141,10,7,3
1,8,142,9,7,2
1,8,143,19,19,0
1,8,144,7,14,-7
1,8,145,9,15,-6
1,8,146,9,7,2
1,8,147,8,20,-12
1,8,148,26,13,13
1,8,149,17,15,2
1,8,150,9,10,-1
1,8,151,8,5,3
1,8,152,8,12,-4
1,8,153,20,19,1
1,8,154,7,12,-5
1,8,155,8,13,-5
1,8,156,3,3,0
1,8,157,8,14,-6
1,8,158,7,8,-1
1,8,159,11,20,-9
1,8,160,8,7,1
1,8,161,19,9,10
1,8,162,10,13,-3
1,8,163,12,5,7
1,8,164,9,9,0
1,8,165,16,6,10
1,8,166,9,11,-2
1,8,167,11,11,0
1,8,168,3,8,-5
1,8,169,10,12,-2
1,8,170,10,6,4
1,8,171,11,7,4
1,8,172,8,10,-2
1,8,173,8,8,0
1,8,174,15,8,7
1,8,175,15,8,7
1,8,176,9,9,0
1,8,177,15,24,-9
1,8,178,18,8,10
1,8,179,22,11,11
1,8,180,14,16,-2
1,8,181,12,8,4
1,8,182,7,8,-1
1,8,183,12,17,-5
1,8,184,8,4,4
1,8,185,11,7,4
1,8,186,6,5,1
1,8,187,16,9,7
1,8,188,11,5,6
1,8,189,9,4,5
1,8,190,11,10,1
1,8,191,4,2,2
1,8,192,12,17,-5
1,8,193,12,17,-5
1,8,194,11,10,1
1,8,195,14,16,-2
1,8,196,14,8,6
1,8,197,19,11,8
1,8,198,9,9,0
1,8,199,21,11,10
1,8,200,10,13,-3
1,8,201,10,9,1
1,8,202,10,6,4
1,8,203,19,18,1
1,8,204,10,12,-2
1,8,205,6,3,3
1,8,206,8,15,-7
1,8,207,14,8,6
1,8,208,13,12,1
1,8,209,14,6,8
1,8,210,6,12,-6
1,8,211,11,12,-1
1,8,212,10,10,0
1,8,213,9,10,-1
1,8,214,19,14,5
1,8,215,19,9,10
1,8,216,10,14,-4
1,8,217,15,5,10
1,8,218,14,16,-2
1,8,219,12,15,-3
1,8,220,12,11,1
1,8,221,18,20,-2
1,8,222,4,2,2
1,8,223,17,5,12
1,8,224,1,1,0
1,8,225,24,6,18
1,8,226,2,3,-1
1,8,227,16,13,3
1,8,228,6,7,-1
1,8,229,12,10,2
1,8,230,12,10,2
1,8,231,22,17,5
1,8,232,15,8,7
1,8,233,17,19,-2
1,8,234,5,0,5
1,8,235,22,16,6
1,8,236,14,8,6
1,8,237,13,4,9
1,8,238,13,21,-8
1,8,239,7,5,2
1,8,240,3,1,2
1,8,241,14,10,4
1,8,242,9,8,1
1,8,243,15,4,11
1,8,244,6,4,2
1,8,245,6,13,-7
1,8,246,16,14,2
1,8,247,3,9,-6
1,8,248,12,7,5
1,8,249,23,7,16
1,8,250,10,8,2
1,8,251,8,8,0
1,8,252,16,7,9
1,8,253,11,7,4
1,8,254,11,9,2
1,8,255,6,8,-2
1,8,256,23,8,15
1,8,257,15,8,7
1,8,258,14,10,4
1,8,259,3,1,2
1,8,260,12,17,-5
1,8,261,12,10,2
1,8,262,10,8,2
1,8,263,9,3,6
1,8,264,14,16,-2
1,8,265,7,6,1
1,8,266,7,5,2
1,8,267,12,19,-7
1,8,268,18,4,14
1,8,269,20,9,11
1,8,270,9,16,-7
1,8,271,15,11,4
1,8,272,9,15,-6
1,8,273,20,11,9
1,8,274,2,4,-2
1,8,275,8,8,0
1,8,276,11,15,-4
1,8,277,5,10,-5
1,8,278,5,10,-5
1,8,279,12,14,-2
1,8,280,13,11,2
1,8,281,6,10,-4
1,8,282,30,9,21
1,8,283,21,6,15
1,8,284,13,12,1
1,8,285,8,20,-12
1,8,286,5,10,-5
1,8,287,24,20,4
1,8,288,10,4,6
1,8,289,10,11,-1
1,8,290,15,8,7
1,8,291,7,13,-6
1,8,292,21,17,4
1,8,293,9,7,2
1,8,294,14,6,8
1,8,295,13,12,1
1,8,296,13,10,3
1,8,297,7,5,2
1,8,298,15,8,7
1,8,299,17,16,1
1,9,0,7,8,-1
1,9,1,28,9,19
1,9,2,13,18,-5
1,9,3,12,7,5
1,9,4,12,15,-3
1,9,5,16,13,3
1,9,6,20,19,1
1,9,7,15,13,2
1,9,8,21,5,16
1,9,9,13,8,5
1,9,10,10,14,-4
1,9,11,11,18,-7
1,9,12,8,15,-7
1,9,13,17,5,12
1,9,14,13,10,3
1,9,15,6,5,1
1,9,16,21,11,10
1,9,17,16,9,7
1,9,18,16,9,7
1,9,19,8,6,2
1,9,20,18,17,1
1,9,21,8,9,-1
1,9,22,8,4,4
1,9,23,17,12,5
1,9,24,18,5,13
1,9,25,16,12,4
1,9,26,15,23,-8
1,9,27,14,11,3
1,9,28,18,10,8
1,9,29,12,8,4
1,9,30,15,4,11
1,9,31,10,12,-2
1,9,32,10,10,0
1,9,33,2,2,0
1,9,34,10,22,-12
1,9,35,10,6,4
1,9,36,18,11,7
1,9,37,11,20,-9
1,9,38,10,14,-4
1,9,39,12,6,6
1,9,40,13,4,9
1,9,41,13,13,0
1,9,42,9,4,5
1,9,43,16,18,-2
1,9,44,14,5,9
1,9,45,38,5,33
1,9,46,17,10,7
1,9,47,8,16,-8
1,9,48,11,13,-2
1,9,49,15,15,0
1,9,50,13,10,3
1,9,51,11,15,-4
1,9,52,5,12,-7
1,9,53,13,13,0
1,9,54,11,12,-1
1,9,55,11,11,0
1,9,56,12,1,11
1,9,57,13,10,3
1,9,58,7,7,0
1,9,59,14,13,1
1,9,60,23,13,10
1,9,61,15,20,-5
1,9,62,13,11,2
1,9,63,7,14,-7
1,9,64,8,7,1
1,9,65,8,10,-2
1,9,66,7,4,3
1,9,67,7,20,-13
1,9,68,5,10,-5
1,9,69,7,3,4
1,9,70,21,4,17
1,9,71,11,6,5
1,9,72,14,9,5
1,9,73,12,10,2
1,9,74,11,5,6
1,9,75,15,7,8
1,9,76,11,21,-10
1,9,77,8,6,2
1,9,78,19,15,4
1,9,79,6,2,4
1,9,80,13,9,4
1,9,81,13,19,-6
1,9,82,8,6,2
1,9,83,2,5,-3
1,9,84,14,14,0
1,9,85,8,8,0
1,9,86,20,12,8
1,9,87,10,6,4
1,9,88,19,13,6
1,9,89,6,4,2
1,9,90,17,11,6
1,9,91,14,9,5
1,9,92,4,3,1
1,9,93,12,9,3
1,9,94,6,5,1
1,9,95,11,9,2
1,9,96,8,10,-2
1,9,97,17,1,16
1,9,98,19,20,-1
1,9,99,15,9,6
1,9,100,13,12,1
1,9,101,8,9,-1
1,9,102,14,14,0
1,9,103,11,13,-2
1,9,104,10,11,-1
1,9,105,4,0,4
1,9,106,32,29,3
1,9,107,19,22,-3
1,9,108,11,7,4
1,9,109,6,4,2
1,9,110,12,5,7
1,9,111,4,7,-3
1,9,112,14,8,6
1,9,113,5,8,-3
1,9,114,9,14,-5
1,9,115,11,11,0
1,9,116,16,13,3
1,9,117,18,18,0
1,9,118,21,17,4
1,9,119,6,4,2
1,9,120,15,12,3
1,9,121,17,16,1
1,9,122,5,6,-1
1,9,123,15,18,-3
1,9,124,15,8,7
1,9,125,14,6,8
1,9,126,9,11,-2
1,9,127,11,9,2
1,9,128,19,11,8
1,9,129,11,6,5
1,9,130,21,12,9
1,9,131,13,19,-6
1,9,132,8,10,-2
1,9,133,3,9,-6
1,9,134,10,8,2
1,9,135,12,7,5
1,9,136,14,13,1
1,9,137,24,5,19
1,9,138,12,13,-1
1,9,139,16,7,9
1,9,140,17,18,-1
1,9,141,6,7,-1
1,9,142,12,10,2
1,9,143,13,8,5
1,9,144,6,6,0
1,9,145,8,16,-8
1,9,146,11,14,-3
1,9,147,6,5,1
1,9,148,10,7,3
1,9,149,21,16,5
1,9,150,10,7,3
1,9,151,12,11,1
1,9,152,3,6,-3
1,9,153,17,11,6
1,9,154,8,12,-4
1,9,155,6,5,1
1,9,156,18,15,3
1,9,157,10,16,-6
1,9,158,7,7,0
1,9,159,10,10,0
1,9,160,11,5,6
1,9,161,15,12,3
1,9,162,7,3,4
1,9,163,12,16,-4
1,9,164,12,3,9
1,9,165,5,2,3
1,9,166,10,4,6
1,9,167,8,14,-6
1,9,168,8,3,5
1,9,169,11,5,6
1,9,170,4,8,-4
1,9,171,4,2,2
1,9,172,20,6,14
1,9,173,25,11,14
1,9,174,18,9,9
1,9,175,23,10,13
1,9,176,6,11,-5
1,9,177,8,6,2
1,9,178,7,13,-6
1,9,179,20,14,6
1,9,180,13,8,5
1,9,181,7,12,-5
1,9,182,4,5,-1
1,9,183,19,6,13
1,9,184,12,17,-5
1,9,185,12,11,1
1,9,186,10,7,3
1,9,187,10,9,1
1,9,188,5,3,2
1,9,189,24,17,7
1,9,190,7,10,-3
1,9,191,14,13,1
1,9,192,15,6,9
1,9,193,2,9,-7
1,9,194,5,9,-4
1,9,195,14,11,3
1,9,196,9,9,0
1,9,197,15,4,11
1,9,198,12,19,-7
1,9,199,15,27,-12
1,9,200,12,10,2
1,9,201,19,9,10
1,9,202,11,11,0
1,9,203,18,13,5
1,9,204,12,12,0
1,9,205,16,4,12
1,9,206,11,8,3
1,9,207,13,13,0
1,9,208,8,8,0
1,9,209,11,2,9
1,9,210,17,5,12
1,9,211,1,1,0
1,9,212,8,6,2
1,9,213,11,15,-4
1,9,214,15,3,12
1,9,215,8,11,-3
1,9,216,12,3,9
1,9,217,26,15,11
1,9,218,11,8,3
1,9,219,10,19,-9
1,9,220,15,15,0
1,9,221,10,7,3
1,9,222,10,10,0
1,9,223,13,11,2
1,9,224,14,8,6
1,9,225,17,8,9
1,9,226,11,16,-5
1,9,227,16,15,1
1,9,228,22,19,3
1,9,229,7,10,-3
1,9,230,12,5,7
1,9,231,12,14,-2
1,9,232,20,8,12
1,9,233,17,9,8
1,9,234,14,2,12
1,9,235,19,12,7
1,9,236,10,4,6
1,9,237,10,11,-1
1,9,238,11,2,9
1,9,239,18,9,9
1,9,240,14,11,3
1,9,241,15,10,5
1,9,242,10,12,-2
1,9,243,14,20,-6
1,9,244,5,13,-8
1,9,245,11,23,-12
1,9,246,13,11,2
1,9,247,15,16,-1
1,9,248,8,8,0
1,9,249,16,12,4
1,9,250,20,16,4
1,9,251,6,12,-6
1,9,252,10,4,6
1,9,253,5,1,4
1,9,254,7,10,-3
1,9,255,8,13,-5
1,9,256,24,9,15
1,9,257,3,9,-6
1,9,258,27,12,15
1,9,259,15,7,8
1,9,260,1,0,1
1,9,261,8,4,4
1,9,262,9,13,-4
1,9,263,10,5,5
1,9,264,8,8,0
1,9,265,21,15,6
1,9,266,14,17,-3
1,9,267,19,3,16
1,9,268,10,11,-1
1,9,269,9,5,4
1,9,270,20,12,8
1,9,271,7,11,-4
1,9,272,9,9,0
1,9,273,11,12,-1
1,9,274,16,8,8
1,9,275,12,12,0
1,9,276,17,3,14
1,9,277,14,15,-1
1,9,278,12,11,1
1,9,279,13,6,7
1,9,280,11,6,5
1,9,281,17,9,8
1,9,282,12,8,4
1,9,283,15,11,4
1,9,284,15,2,13
1,9,285,9,22,-13
1,9,286,13,6,7
1,9,287,6,7,-1
1,9,288,9,13,-4
1,9,289,17,5,12
1,9,290,11,15,-4
1,9,291,7,1,6
1,9,292,9,14,-5
1,9,293,17,11,6
1,9,294,17,12,5
1,9,295,8,16,-8
1,9,296,5,15,-10
1,9,297,13,9,4
1,9,298,23,5,18
1,9,299,12,5,7
1,10,0,52,6,46
1,10,1,7,6,1
1,10,2,13,9,4
1,10,3,20,18,2
1,10,4,19,11,8
1,10,5,10,4,6
1,10,6,12,12,0
1,10,7,7,11,-4
1,10,8,13,9,4
1,10,9,17,9,8
1,10,10,14,5,9
1,10,11,4,10,-6
1,10,12,14,2,12
1,10,13,12,6,6
1,10,14,9,8,1
1,10,15,17,23,-6
1,10,16,17,18,-1
1,10,17,8,9,-1
1,10,18,19,10,9
1,10,19,13,13,0
1,10,20,8,6,2
1,10,21,4,1,3
1,10,22,8,8,0
1,10,23,8,13,-5
1,10,24,8,6,2
1,10,25,11,6,5
1,10,26,19,10,9
1,10,27,3,8,-5
1,10,28,10,6,4
1,10,29,20,28,-8
1,10,30,9,12,-3
1,10,31,7,4,3
1,10,32,13,15,-2
1,10,33,9,7,2
1,10,34,6,3,3
1,10,35,17,13,4
1,10,36,7,6,1
1,10,37,19,17,2
1,10,38,9,3,6
1,10,39,8,7,1
1,10,40,7,13,-6
1,10,41,14,7,7
1,10,42,9,13,-4
1,10,43,14,6,8
1,10,44,16,10,6
1,10,45,14,3,11
1,10,46,11,15,-4
1,10,47,8,7,1
1,10,48,8,8,0
1,10,49,23,9,14
1,10,50,6,8,-2
1,10,51,10,8,2
1,10,52,18,12,6
1,10,53,5,5,0
1,10,54,10,11,-1
1,10,55,26,21,5
1,10,56,14,10,4
1,10,57,6,10,-4
1,10,58,16,13,3
1,10,59,8,7,1
1,10,60,13,3,10
1,10,61,3,8,-5
1,10,62,16,8,8
1,10,63,16,14,2
1,10,64,6,4,2
1,10,65,20,9,11
1,10,66,14,7,7
1,10,67,7,2,5
1,10,68,11,8,3
1,10,69,6,7,-1
1,10,70,7,11,-4
1,10,71,15,12,3
1,10,72,17,6,11
1,10,73,14,5,9
1,10,74,8,12,-4
1,10,75,12,8,4
1,10,76,24,8,16
1,10,77,22,6,16
1,10,78,6,2,4
1,10,79,10,7,3
1,10,80,6,8,-2
1,10,81,10,9,1
1,10,82,12,12,0
1,10,83,12,10,2
1,10,84,7,13,-6
1,10,85,15,18,-3
1,10,86,11,15,-4
1,10,87,13,8,5
1,10,88,6,1,5
1,10,89,13,9,4
1,10,90,8,3,5
1,10,91,25,15,10
1,10,92,20,23,-3
1,10,93,12,10,2
1,10,94,15,13,2
1,10,95,20,8,12
1,10,96,13,6,7
1,10,97,19,13,6
1,10,98,7,1,6
1,10,99,11,19,-8
1,10,100,10,5,5
1,10,101,11,13,-2
1,10,102,17,14,3
1,10,103,17,7,10
1,10,104,6,10,-4
1,10,105,13,16,-3
1,10,106,9,15,-6
1,10,107,11,15,-4
1,10,108,5,4,1
1,10,109,12,12,0
1,10,110,19,7,12
1,10,111,12,5,7
1,10,112,9,6,3
1,10,113,6,7,-1
1,10,114,3,4,-1
1,10,115,5,8,-3
1,10,116,16,11,5
1,10,117,10,11,-1
1,10,118,15,15,0
1,10,119,9,4,5
1,10,120,16,9,7
1,10,121,8,8,0
1,10,122,18,9,9
1,10,123,15,5,10
1,10,124,9,9,0
1,10,125,16,13,3
1,10,126,12,9,3
1,10,127,17,7,10
1,10,128,20,22,-2
1,10,129,16,15,1
1,10,130,20,9,11
1,10,131,14,12,2
1,10,132,8,2,6
1,10,133,13,21,-8
1,10,134,10,3,7
1,10,135,4,3,1
1,10,136,8,9,-1
1,10,137,23,3,20
1,10,138,15,11,4
1,10,139,20,22,-2
1,10,140,19,7,12
1,10,141,6,6,0
1,10,142,15,12,3
1,10,143,22,22,0
1,10,144,10,12,-2
1,10,145,17,13,4
1,10,146,17,20,-3
1,10,147,30,14,16
1,10,148,7,5,2
1,10,149,4,3,1
1,10,150,13,21,-8
1,10,151,15,9,6
1,10,152,13,9,4
1,10,153,8,10,-2
1,10,154,12,10,2
1,10,155,21,13,8
1,10,156,10,10,0
1,10,157,12,8,4
1,10,158,7,7,0
1,10,159,20,9,11
1,10,160,14,14,0
1,10,161,18,15,3
1,10,162,13,8,5
1,10,163,20,11,9
1,10,164,14,9,5
1,10,165,15,2,13
1,10,166,13,5,8
1,10,167,11,9,2
1,10,168,15,14,1
1,10,169,7,3,4
1,10,170,2,3,-1
1,10,171,12,14,-2
1,10,172,10,8,2
1,10,173,22,21,1
1,10,174,12,13,-1
1,10,175,3,2,1
1,10,176,20,12,8
1,10,177,4,3,1
1,10,178,16,21,-5
1,10,179,8,15,-7
1,10,180,8,12,-4
1,10,181,11,3,8
1,10,182,7,10,-3
1,10,183,12,9,3
1,10,184,16,20,-4
1,10,185,12,15,-3
1,10,186,9,10,-1
1,10,187,7,13,-6
1,10,188,24,16,8
1,10,189,21,11,10
1,10,190,13,5,8
1,10,191,14,14,0
1,10,192,12,7,5
1,10,193,12,4,8
1,10,194,16,17,-1
1,10,195,9,12,-3
1,10,196,11,11,0
1,10,197,18,12,6
1,10,198,13,6,7
1,10,199,9,6,3
1,10,200,8,11,-3
1,10,201,14,17,-3
1,10,202,4,2,2
1,10,203,9,10,-1
1,10,204,11,7,4
1,10,205,3,5,-2
1,10,206,19,10,9
1,10,207,18,7,11
1,10,208,28,14,14
1,10,209,8,9,-1
1,10,210,12,8,4
1,10,211,18,10,8
1,10,212,3,7,-4
1,10,213,7,10,-3
1,10,214,13,5,8
1,10,215,2,4,-2
1,10,216,3,7,-4
1,10,217,16,11,5
1,10,218,5,13,-8
1,10,219,21,11,10
1,10,220,13,11,2
1,10,221,19,23,-4
1,10,222,9,9,0
1,10,223,9,7,2
1,10,224,12,8,4
1,10,225,18,16,2
1,10,226,18,11,7
1,10,227,10,14,-4
1,10,228,19,8,11
1,10,229,9,12,-3
1,10,230,13,17,-4
1,10,231,17,6,11
1,10,232,23,10,13
1,10,233,14,11,3
1,10,234,5,6,-1
1,10,235,9,13,-4
1,10,236,21,13,8
1,10,237,12,4,8
1,10,238,5,12,-7
1,10,239,11,13,-2
1,10,240,18,7,11
1,10,241,8,9,-1
1,10,242,17,14,3
1,10,243,8,9,-1
1,10,244,9,9,0
1,10,245,10,10,0
1,10,246,15,11,4
1,10,247,15,3,12
1,10,248,15,7,8
1,10,249,18,14,4
1,10,250,14,9,5
1,10,251,13,21,-8
1,10,252,19,13,6
1,10,253,17,8,9
1,10,254,11,19,-8
1,10,255,14,17,-3
1,10,256,10,16,-6
1,10,257,18,7,11
1,10,258,9,5,4
1,10,259,9,7,2
1,10,260,14,17,-3
1,10,261,21,17,4
1,10,262,9,12,-3
1,10,263,16,5,11
1,10,264,16,20,-4
1,10,265,15,17,-2
1,10,266,9,13,-4
1,10,267,10,7,3
1,10,268,10,10,0
1,10,269,20,9,11
1,10,270,9,12,-3
1,10,271,19,8,11
1,10,272,10,3,7
1,10,273,14,11,3
1,10,274,9,5,4
1,10,275,23,14,9
1,10,276,20,1,19
1,10,277,10,8,2
1,10,278,25,8,17
1,10,279,16,8,8
1,10,280,4,9,-5
1,10,281,1,2,-1
1,10,282,32,10,22
1,10,283,16,6,10
1,10,284,17,19,-2
1,10,285,10,7,3
1,10,286,11,8,3
1,10,287,14,15,-1
1,10,288,23,28,-5
1,10,289,12,22,-10
1,10,290,28,9,19
1,10,291,13,5,8
1,10,292,15,6,9
1,10,293,7,10,-3
1,10,294,14,12,2
1,10,295,7,4,3
1,10,296,13,8,5
1,10,297,25,10,15
1,10,298,16,22,-6
1,10,299,6,7,-1
1,11,0,12,7,5
1,11,1,10,13,-3
1,11,2,12,7,5
1,11,3,16,6,10
1,11,4,15,12,3
1,11,5,16,4,12
1,11,6,21,11,10
1,11,7,5,7,-2
1,11,8,5,8,-3
1,11,9,10,10,0
1,11,10,11,8,3
1,11,11,10,9,1
1,11,12,16,13,3
1,11,13,11,4,7
1,11,14,15,14,1
1,11,15,11,17,-6
1,11,16,10,8,2
1,11,17,21,10,11
1,11,18,4,11,-7
1,11,19,5,2,3
1,11,20,7,8,-1
1,11,21,14,7,7
1,11,22,19,12,7
1,11,23,17,12,5
1,11,24,16,8,8
1,11,25,9,7,2
1,11,26,11,10,1
1,11,27,4,3,1
1,11,28,7,13,-6
1,11,29,33,19,14
1,11,30,8,5,3
1,11,31,12,18,-6
1,11,32,16,16,0
1,11,33,12,15,-3
1,11,34,20,15,5
1,11,35,12,10,2
1,11,36,19,10,9
1,11,37,9,11,-2
1,11,38,15,12,3
1,11,39,7,13,-6
1,11,40,12,7,5
1,11,41,6,12,-6
1,11,42,17,13,4
1,11,43,6,8,-2
1,11,44,9,3,6
1,11,45,6,13,-7
1,11,46,20,13,7
1,11,47,21,7,14
1,11,48,4,14,-10
1,11,49,9,8,1
1,11,50,17,8,9
1,11,51,24,7,17
1,11,52,19,14,5
1,11,53,16,23,-7
1,11,54,13,15,-2
1,11,55,17,7,10
1,11,56,8,13,-5
1,11,57,5,3,2
1,11,58,11,5,6
1,11,59,9,6,3
1,11,60,11,18,-7
1,11,61,12,8,4
1,11,62,2,13,-11
1,11,63,17,12,5
1,11,64,21,9,12
1,11,65,16,13,3
1,11,66,5,2,3
1,11,67,8,12,-4
1,11,68,9,5,4
1,11,69,9,5,4
1,11,70,9,5,4
1,11,71,17,19,-2
1,11,72,11,13,-2
1,11,73,8,13,-5
1,11,74,14,13,1
1,11,75,27,12,15
1,11,76,17,17,0
1,11,77,3,2,1
1,11,78,6,9,-3
1,11,79,7,4,3
1,11,80,15,6,9
1,11,81,19,11,8
1,11,82,16,12,4
1,11,83,7,7,0
1,11,84,18,12,6
1,11,85,17,10,7
1,11,86,9,4,5
1,11,87,11,7,4
1,11,88,14,20,-6
1,11,89,14,10,4
1,11,90,19,15,4
1,11,91,20,13,7
1,11,92,26,23,3
1,11,93,9,6,3
1,11,94,14,18,-4
1,11,95,15,10,5
1,11,96,6,9,-3
1,11,97,18,11,7
1,11,98,12,23,-11
1,11,99,14,7,7
1,11,100,13,13,0
1,11,101,12,20,-8
1,11,102,27,16,11
1,11,103,20,14,6
1,11,104,15,12,3
1,11,105,8,12,-4
1,11,106,15,1,14
1,11,107,20,8,12
1,11,108,32,20,12
1,11,109,12,9,3
1,11,110,16,6,10
1,11,111,16,10,6
1,11,112,14,16,-2
1,11,113,16,12,4
1,11,114,12,18,-6
1,11,115,5,10,-5
1,11,116,13,13,0
1,11,117,10,6,4
1,11,118,16,10,6
1,11,119,6,2,4
1,11,120,14,16,-2
1,11,121,17,13,4
1,11,122,10,6,4
1,11,123,9,12,-3
1,11,124,29,14,15
1,11,125,15,26,-11
1,11,126,13,9,4
1,11,127,17,7,10
1,11,128,13,15,-2
1,11,129,33,9,24
1,11,130,11,9,2
1,11,131,6,7,-1
1,11,132,12,20,-8
1,11,133,20,10,10
1,11,134,8,10,-2
1,11,135,10,7,3
1,11,136,13,9,4
1,11,137,5,10,-5
1,11,138,21,4,17
1,11,139,16,25,-9
1,11,140,20,27,-7
1,11,141,7,13,-6
1,11,142,16,13,3
1,11,143,7,10,-3
1,11,144,18,25,-7
1,11,145,27,14,13
1,11,146,7,7,0
1,11,147,12,7,5
1,11,148,20,12,8
1,11,149,20,15,5
1,11,150,11,13,-2
1,11,151,19,19,0
1,11,152,10,9,1
1,11,153,12,11,1
1,11,154,11,10,1
1,11,155,6,6,0
1,11,156,9,5,4
1,11,157,15,11,4
1,11,158,16,5,11
1,11,159,24,12,12
1,11,160,8,5,3
1,11,161,21,7,14
1,11,162,13,11,2
1,11,163,18,17,1
1,11,164,17,13,4
1,11,165,11,12,-1
1,11,166,6,10,-4
1,11,167,4,2,2
1,11,168,10,17,-7
1,11,169,12,8,4
1,11,170,2,0,2
1,11,171,18,13,5
1,11,172,12,18,-6
1,11,173,13,8,5
1,11,174,11,10,1
1,11,175,21,14,7
1,11,176,16,15,1
1,11,177,17,7,10
1,11,178,10,6,4
1,11,179,27,23,4
1,11,180,19,10,9
1,11,181,18,12,6
1,11,182,10,5,5
1,11,183,23,10,13
1,11,184,3,7,-4
1,11,185,6,8,-2
1,11,186,4,11,-7
1,11,187,13,8,5
1,11,188,8,7,1
1,11,189,20,9,11
1,11,190,10,7,3
1,11,191,5,8,-3
1,11,192,15,5,10
1,11,193,19,8,11
1,11,194,15,17,-2
1,11,195,10,9,1
1,11,196,9,16,-7
1,11,197,3,2,1
1,11,198,7,15,-8
1,11,199,7,6,1
1,11,200,19,2,17
1,11,201,19,13,6
1,11,202,9,4,5
1,11,203,17,16,1
1,11,204,20,20,0
1,11,205,14,3,11
1,11,206,11,5,6
1,11,207,17,16,1
1,11,208,10,5,5
1,11,209,13,7,6
1,11,210,12,10,2
1,11,211,14,9,5
1,11,212,10,4,6
1,11,213,32,23,9
1,11,214,18,9,9
1,11,215,21,9,12
1,11,216,14,12,2
1,11,217,11,19,-8
1,11,218,7,1,6
1,11,219,6,9,-3
1,11,220,11,19,-8
1,11,221,20,13,7
1,11,222,15,15,0
1,11,223,13,8,5
1,11,224,10,6,4
1,11,225,9,12,-3
1,11,226,9,3,6
1,11,227,11,16,-5
1,11,228,10,12,-2
1,11,229,20,15,5
1,11,230,9,7,2
1,11,231,10,8,2
1,11,232,7,11,-4
1,11,233,11,9,2
1,11,234,20,14,6
1,11,235,2,11,-9
1,11,236,8,11,-3
1,11,237,10,9,1
1,11,238,8,19,-11
1,11,239,16,12,4
1,11,240,8,6,2
1,11,241,14,14,0
1,11,242,18,14,4
1,11,243,10,3,7
1,11,244,9,4,5
1,11,245,8,9,-1
1,11,246,2,0,2
1,11,247,15,29,-14
1,11,248,18,10,8
1,11,249,15,10,5
1,11,250,13,7,6
1,11,251,25,18,7
1,11,252,8,5,3
1,11,253,6,7,-1
1,11,254,14,11,3
1,11,255,13,15,-2
1,11,256,19,13,6
1,11,257,19,11,8
1,11,258,12,5,7
1,11,259,9,10,-1
1,11,260,12,13,-1
1,11,261,6,3,3
1,11,262,6,4,2
1,11,263,12,9,3
1,11,264,15,8,7
1,11,265,11,10,1
1,11,266,6,7,-1
1,11,267,24,18,6
1,11,268,10,5,5
1,11,269,7,8,-1
1,11,270,13,8,5
1,11,271,14,15,-1
1,11,272,28,10,18
1,11,273,14,8,6
1,11,274,9,11,-2
1,11,275,16,18,-2
1,11,276,12,16,-4
1,11,277,15,10,5
1,11,278,16,1,15
1,11,279,10,5,5
1,11,280,13,8,5
1,11,281,13,10,3
1,11,282,19,18,1
1,11,283,20,10,10
1,11,284,17,10,7
1,11,285,7,13,-6
1,11,286,24,6,18
1,11,287,14,7,7
1,11,288,12,9,3
1,11,289,8,5,3
1,11,290,11,14,-3
1,11,291,14,10,4
1,11,292,10,10,0
1,11,293,6,14,-8
1,11,294,13,10,3
1,11,295,16,7,9
1,11,296,14,24,-10
1,11,297,7,6,1
1,11,298,9,11,-2
1,11,299,16,11,5
1,12,0,18,15,3
1,12,1,7,4,3
1,12,2,7,8,-1
1,12,3,12,5,7
1,12,4,13,11,2
1,12,5,21,11,10
1,12,6,14,8,6
1,12,7,10,8,2
1,12,8,10,6,4
1,12,9,6,7,-1
1,12,10,20,11,9
1,12,11,22,18,4
1,12,12,11,12,-1
1,12,13,6,11,-5
1,12,14,13,8,5
1,12,15,20,8,12
1,12,16,12,4,8
1,12,17,13,9,4
1,12,18,1,9,-8
1,12,19,23,18,5
1,12,20,12,11,1
1,12,21,14,3,11
1,12,22,16,15,1
1,12,23,3,5,-2
1,12,24,5,15,-10
1,12,25,15,6,9
1,12,26,11,12,-1
1,12,27,10,8,2
1,12,28,18,5,13
1,12,29,13,13,0
1,12,30,11,5,6
1,12,31,6,7,-1
1,12,32,8,15,-7
1,12,33,20,20,0
1,12,34,19,12,7
1,12,35,24,17,7
1,12,36,11,6,5
1,12,37,12,11,1
1,12,38,11,9,2
1,12,39,26,11,15
1,12,40,15,9,6
1,12,41,13,19,-6
1,12,42,8,3,5
1,12,43,20,11,9
1,12,44,13,8,5
1,12,45,20,16,4
1,12,46,8,12,-4
1,12,47,5,5,0
1,12,48,6,5,1
1,12,49,14,9,5
1,12,50,8,8,0
1,12,51,21,13,8
1,12,52,15,11,4
1,12,53,15,13,2
1,12,54,12,5,7
1,12,55,8,4,4
1,12,56,18,10,8
1,12,57,16,0,16
1,12,58,12,5,7
1,12,59,18,9,9
1,12,60,19,10,9
1,12,61,13,12,1
1,12,62,13,19,-6
1,12,63,24,16,8
1,12,64,8,4,4
1,12,65,9,9,0
1,12,66,4,2,2
1,12,67,20,8,12
1,12,68,14,9,5
1,12,69,24,26,-2
1,12,70,7,8,-1
1,12,71,7,2,5
1,12,72,14,17,-3
1,12,73,13,11,2
1,12,74,23,13,10
1,12,75,9,5,4
1,12,76,15,13,2
1,12,77,29,18,11
1,12,78,11,9,2
1,12,79,13,6,7
1,12,80,11,4,7
1,12,81,12,9,3
1,12,82,10,7,3
1,12,83,7,3,4
1,12,84,19,18,1
1,12,85,17,4,13
1,12,86,11,7,4
1,12,87,7,6,1
1,12,88,8,16,-8
1,12,89,8,11,-3
1,12,90,16,4,12
1,12,91,8,5,3
1,12,92,8,7,1
1,12,93,17,20,-3
1,12,94,9,12,-3
1,12,95,13,9,4
1,12,96,11,8,3
1,12,97,7,6,1
1,12,98,8,16,-8
1,12,99,13,8,5
1,12,100,10,8,2
1,12,101,14,6,8
1,12,102,10,11,-1
1,12,103,9,11,-2
1,12,104,18,12,6
1,12,105,12,8,4
1,12,106,24,7,17
1,12,107,17,18,-1
1,12,108,9,3,6
1,12,109,15,10,5
1,12,110,20,22,-2
1,12,111,8,6,2
1,12,112,14,21,-7
1,12,113,18,9,9
1,12,114,13,4,9
1,12,115,11,17,-6
1,12,116,18,13,5
1,12,117,5,6,-1
1,12,118,11,15,-4
1,12,119,17,15,2
1,12,120,16,12,4
1,12,121,12,10,2
1,12,122,6,4,2
1,12,123,15,5,10
1,12,124,11,5,6
1,12,125,20,11,9
1,12,126,12,15,-3
1,12,127,4,8,-4
1,12,128,20,17,3
1,12,129,11,11,0
1,12,130,32,8,24
1,12,131,4,6,-2
1,12,132,12,15,-3
1,12,133,2,14,-12
1,12,134,14,16,-2
1,12,135,10,6,4
1,12,136,12,12,0
1,12,137,5,4,1
1,12,138,23,10,13
1,12,139,11,4,7
1,12,140,14,9,5
1,12,141,17,12,5
1,12,142,6,15,-9
1,12,143,17,14,3
1,12,144,17,8,9
1,12,145,26,4,22
1,12,146,15,6,9
1,12,147,30,14,16
1,12,148,28,16,12
1,12,149,9,9,0
1,12,150,24,9,15
1,12,151,16,17,-1
1,12,152,8,6,2
1,12,153,16,6,10
1,12,154,13,14,-1
1,12,155,16,13,3
1,12,156,18,11,7
1,12,157,11,13,-2
1,12,158,24,8,16
1,12,159,21,13,8
1,12,160,13,13,0
1,12,161,15,15,0
1,12,162,15,21,-6
1,12,163,6,3,3
1,12,164,23,10,13
1,12,165,9,10,-1
1,12,166,9,6,3
1,12,167,14,9,5
1,12,168,18,9,9
1,12,169,15,3,12
1,12,170,17,9,8
1,12,171,4,5,-1
1,12,172,18,13,5
1,12,173,18,6,12
1,12,174,16,17,-1
1,12,175,9,7,2
1,12,176,11,11,0
1,12,177,10,8,2
1,12,178,22,11,11
1,12,179,17,9,8
1,12,180,8,4,4
1,12,181,10,5,5
1,12,182,18,15,3
1,12,183,18,12,6
1,12,184,11,6,5
1,12,185,22,21,1
1,12,186,12,11,1
1,12,187,10,10,0
1,12,188,11,13,-2
1,12,189,4,3,1
1,12,190,8,13,-5
1,12,191,13,7,6
1,12,192,14,12,2
1,12,193,22,18,4
1,12,194,7,7,0
1,12,195,7,2,5
1,12,196,15,11,4
1,12,197,8,5,3
1,12,198,15,6,9
1,12,199,13,8,5
1,12,200,14,2,12
1,12,201,17,8,9
1,12,202,16,16,0
1,12,203,17,9,8
1,12,204,29,17,12
1,12,205,16,7,9
1,12,206,14,10,4
1,12,207,13,6,7
1,12,208,6,13,-7
1,12,209,12,16,-4
1,12,210,3,6,-3
1,12,211,17,18,-1
1,12,212,17,6,11
1,12,213,22,12,10
1,12,214,19,9,10
1,12,215,10,10,0
1,12,216,21,9,12
1,12,217,13,10,3
1,12,218,19,5,14
1,12,219,27,13,14
1,12,220,14,7,7
1,12,221,11,4,7
1,12,222,6,8,-2
1,12,223,16,17,-1
1,12,224,15,18,-3
1,12,225,21,12,9
1,12,226,14,9,5
1,12,227,18,15,3
1,12,228,8,4,4
1,12,229,9,12,-3
1,12,230,16,3,13
1,12,231,9,10,-1
1,12,232,28,5,23
1,12,233,23,11,12
1,12,234,14,4,10
1,12,235,12,5,7
1,12,236,13,9,4
1,12,237,16,8,8
1,12,238,35,6,29
1,12,239,18,8,10
1,12,240,9,10,-1
1,12,241,17,9,8
1,12,242,27,15,12
1,12,243,12,14,-2
1,12,244,39,11,28
1,12,245,7,4,3
1,12,246,4,7,-3
1,12,247,9,4,5
1,12,248,14,9,5
1,12,249,10,15,-5
1,12,250,14,9,5
1,12,251,11,18,-7
1,12,252,10,16,-6
1,12,253,13,5,8
1,12,254,8,9,-1
1,12,255,15,7,8
1,12,256,17,17,0
1,12,257,16,12,4
1,12,258,19,8,11
1,12,259,19,8,11
1,12,260,18,6,12
1,12,261,23,25,-2
1,12,262,8,3,5
1,12,263,20,8,12
1,12,264,30,8,22
1,12,265,7,11,-4
1,12,266,20,11,9
1,12,267,8,6,2
1,12,268,21,11,10
1,12,269,11,13,-2
1,12,270,13,7,6
1,12,271,9,12,-3
1,12,272,2,0,2
1,12,273,18,7,11
1,12,274,19,15,4
1,12,275,13,20,-7
1,12,276,10,3,7
1,12,277,17,6,11
1,12,278,6,8,-2
1,12,279,18,11,7
1,12,280,20,5,15
1,12,281,14,9,5
1,12,282,17,18,-1
1,12,283,3,5,-2
1,12,284,1,1,0
1,12,285,12,13,-1
1,12,286,8,6,2
1,12,287,20,7,13
1,12,288,4,5,-1
1,12,289,17,8,9
1,12,290,8,5,3
1,12,291,17,12,5
1,12,292,12,8,4
1,12,293,5,3,2
1,12,294,13,8,5
1,12,295,12,10,2
1,12,296,11,16,-5
1,12,297,9,6,3
1,12,298,12,10,2
1,12,299,6,4,2
1,13,0,18,13,5
1,13,1,15,13,2
1,13,2,8,4,4
1,13,3,8,9,-1
1,13,4,14,9,5
1,13,5,15,9,6
1,13,6,8,7,1
1,13,7,17,15,2
1,13,8,15,18,-3
1,13,9,31,19,12
1,13,10,8,3,5
1,13,11,12,6,6
1,13,12,20,18,2
1,13,13,20,16,4
1,13,14,19,6,13
1,13,15,26,10,16
1,13,16,19,11,8
1,13,17,19,11,8
1,13,18,21,15,6
1,13,19,26,12,14
1,13,20,5,7,-2
1,13,21,19,11,8
1,13,22,10,4,6
1,13,23,30,3,27
1,13,24,8,5,3
1,13,25,5,1,4
1,13,26,12,6,6
1,13,27,7,3,4
1,13,28,15,4,11
1,13,29,14,13,1
1,13,30,7,9,-2
1,13,31,9,15,-6
1,13,32,10,14,-4
1,13,33,14,11,3
1,13,34,9,4,5
1,13,35,20,13,7
1,13,36,10,10,0
1,13,37,27,14,13
1,13,38,15,7,8
1,13,39,4,7,-3
1,13,40,7,15,-8
1,13,41,10,6,4
1,13,42,15,7,8
1,13,43,9,5,4
1,13,44,12,11,1
1,13,45,7,2,5
1,13,46,17,14,3
1,13,47,11,9,2
1,13,48,23,2,21
1,13,49,15,23,-8
1,13,50,14,17,-3
1,13,51,21,15,6
1,13,52,21,7,14
1,13,53,14,12,2
1,13,54,7,11,-4
1,13,55,15,10,5
1,13,56,17,12,5
1,13,57,7,4,3
1,13,58,1,12,-11
1,13,59,13,7,6
1,13,60,23,17,6
1,13,61,2,7,-5
1,13,62,11,5,6
1,13,63,11,15,-4
1,13,64,17,3,14
1,13,65,15,3,12
1,13,66,10,11,-1
1,13,67,23,19,4
1,13,68,13,18,-5
1,13,69,12,13,-1
1,13,70,11,9,2
1,13,71,23,11,12
1,13,72,16,8,8
1,13,73,24,11,13
1,13,74,48,14,34
1,13,75,15,13,2
1,13,76,10,8,2
1,13,77,15,21,-6
1,13,78,18,13,5
1,13,79,20,11,9
1,13,80,18,9,9
1,13,81,8,5,3
1,13,82,16,13,3
1,13,83,14,5,9
1,13,84,11,10,1
1,13,85,15,11,4
1,13,86,18,15,3
1,13,87,17,8,9
1,13,88,12,5,7
1,13,89,24,7,17
1,13,90,26,7,19
1,13,91,10,18,-8
1,13,92,23,6,17
1,13,93,10,15,-5
1,13,94,8,9,-1
1,13,95,12,12,0
1,13,96,7,4,3
1,13,97,28,13,15
1,13,98,9,11,-2
1,13,99,9,5,4
1,13,100,7,9,-2
1,13,101,19,10,9
1,13,102,8,5,3
1,13,103,20,12,8
1,13,104,10,7,3
1,13,105,4,1,3
1,13,106,4,6,-2
1,13,107,32,16,16
1,13,108,19,5,14
1,13,109,9,5,4
1,13,110,2,5,-3
1,13,111,20,9,11
1,13,112,19,6,13
1,13,113,8,5,3
1,13,114,9,16,-7
1,13,115,16,10,6
1,13,116,19,6,13
1,13,117,1,3,-2
1,13,118,19,8,11
1,13,119,14,7,7
1,13,120,14,10,4
1,13,121,13,9,4
1,13,122,15,2,13
1,13,123,12,15,-3
1,13,124,7,9,-2
1,13,125,6,7,-1
1,13,126,7,13,-6
1,13,127,12,4,8
1,13,128,19,22,-3
1,13,129,5,7,-2
1,13,130,16,14,2
1,13,131,7,10,-3
1,13,132,6,5,1
1,13,133,12,5,7
1,13,134,14,5,9
1,13,135,6,9,-3
1,13,136,13,5,8
1,13,137,7,6,1
1,13,138,21,11,10
1,13,139,13,10,3
1,13,140,11,14,-3
1,13,141,15,13,2
1,13,142,16,9,7
1,13,143,17,6,11
1,13,144,8,8,0
1,13,145,5,4,1
1,13,146,10,16,-6
1,13,147,9,9,0
1,13,148,15,7,8
1,13,149,6,11,-5
1,13,150,21,8,13
1,13,151,16,5,11
1,13,152,6,12,-6
1,13,153,5,2,3
1,13,154,5,3,2
1,13,155,8,9,-1
1,13,156,15,12,3
1,13,157,17,12,5
1,13,158,11,13,-2
1,13,159,22,9,13
1,13,160,10,8,2
1,13,161,18,7,11
1,13,162,18,8,10
1,13,163,22,10,12
1,13,164,9,10,-1
1,13,165,8,5,3
1,13,166,3,4,-1
1,13,167,25,15,10
1,13,168,13,8,5
1,13,169,5,12,-7
1,13,170,17,5,12
1,13,171,12,13,-1
1,13,172,10,5,5
1,13,173,22,10,12
1,13,174,8,7,1
1,13,175,13,8,5
1,13,176,15,9,6
1,13,177,17,17,0
1,13,178,14,6,8
1,13,179,17,7,10
1,13,180,12,6,6
1,13,181,12,5,7
1,13,182,12,4,8
1,13,183,20,10,10
1,13,184,14,2,12
1,13,185,9,5,4
1,13,186,20,14,6
1,13,187,15,12,3
1,13,188,9,5,4
1,13,189,12,8,4
1,13,190,23,6,17
1,13,191,11,13,-2
1,13,192,16,9,7
1,13,193,16,15,1
1,13,194,21,17,4
1,13,195,10,3,7
1,13,196,16,21,-5
1,13,197,14,12,2
1,13,198,13,16,-3
1,13,199,23,18,5
1,13,200,9,13,-4
1,13,201,16,8,8
1,13,202,24,11,13
1,13,203,16,5,11
1,13,204,11,14,-3
1,13,205,13,11,2
1,13,206,28,6,22
1,13,207,15,13,2
1,13,208,21,11,10
1,13,209,12,10,2
1,13,210,9,11,-2
1,13,211,5,8,-3
1,13,212,5,2,3
1,13,213,13,9,4
1,13,214,9,9,0
1,13,215,25,6,19
1,13,216,13,13,0
1,13,217,13,11,2
1,13,218,17,13,4
1,13,219,11,5,6
1,13,220,5,7,-2
1,13,221,15,19,-4
1,13,222,20,2,18
1,13,223,12,5,7
1,13,224,12,12,0
1,13,225,8,10,-2
1,13,226,17,8,9
1,13,227,9,19,-10
1,13,228,2,3,-1
1,13,229,15,4,11
1,13,230,19,19,0
1,13,231,18,9,9
1,13,232,13,16,-3
1,13,233,13,8,5
1,13,234,8,6,2
1,13,235,15,20,-5
1,13,236,7,7,0
1,13,237,9,9,0
1,13,238,15,9,6
1,13,239,19,13,6
1,13,240,18,19,-1
1,13,241,8,8,0
1,13,242,16,10,6
1,13,243,11,11,0
1,13,244,12,13,-1
1,13,245,26,3,23
1,13,246,17,13,4
1,13,247,19,10,9
1,13,248,16,17,-1
1,13,249,20,12,8
1,13,250,12,9,3
1,13,251,26,11,15
1,13,252,16,12,4
1,13,253,19,20,-1
1,13,254,5,6,-1
1,13,255,10,13,-3
1,13,256,28,12,16
1,13,257,12,3,9
1,13,258,5,9,-4
1,13,259,10,2,8
1,13,260,11,7,4
1,13,261,31,8,23
1,13,262,10,7,3
1,13,263,24,11,13
1,13,264,19,22,-3
1,13,265,14,4,10
1,13,266,7,11,-4
1,13,267,18,10,8
1,13,268,17,10,7
1,13,269,29,13,16
1,13,270,12,15,-3
1,13,271,9,12,-3
1,13,272,9,8,1
1,13,273,18,7,11
1,13,274,4,10,-6
1,13,275,1,4,-3
1,13,276,24,17,7
1,13,277,8,10,-2
1,13,278,18,16,2
1,13,279,18,8,10
1,13,280,17,4,13
1,13,281,11,17,-6
1,13,282,12,9,3
1,13,283,11,7,4
1,13,284,8,13,-5
1,13,285,15,7,8
1,13,286,18,15,3
1,13,287,12,11,1
1,13,288,10,15,-5
1,13,289,14,13,1
1,13,290,8,4,4
1,13,291,9,7,2
1,13,292,12,5,7
1,13,293,8,5,3
1,13,294,10,7,3
1,13,295,2,3,-1
1,13,296,17,4,13
1,13,297,7,10,-3
1,13,298,16,9,7
1,13,299,10,5,5
1,14,0,27,19,8
1,14,1,5,7,-2
1,14,2,12,6,6
1,14,3,8,1,7
1,14,4,15,18,-3
1,14,5,10,6,4
1,14,6,12,6,6
1,14,7,13,9,4
1,14,8,4,5,-1
1,14,9,19,9,10
1,14,10,12,10,2
1,14,11,19,18,1
1,14,12,14,10,4
1,14,13,12,9,3
1,14,14,7,6,1
1,14,15,15,9,6
1,14,16,16,12,4
1,14,17,27,5,22
1,14,18,12,6,6
1,14,19,21,9,12
1,14,20,12,8,4
1,14,21,13,8,5
1,14,22,19,9,10
1,14,23,21,13,8
1,14,24,25,16,9
1,14,25,12,10,2
1,14,26,15,5,10
1,14,27,10,10,0
1,14,28,13,6,7
1,14,29,14,9,5
1,14,30,20,9,11
1,14,31,10,2,8
1,14,32,12,14,-2
1,14,33,12,17,-5
1,14,34,11,7,4
1,14,35,16,5,11
1,14,36,18,17,1
1,14,37,7,11,-4
1,14,38,19,7,12
1,14,39,12,5,7
1,14,40,11,8,3
1,14,41,21,6,15
1,14,42,7,16,-9
1,14,43,12,8,4
1,14,44,16,4,12
1,14,45,33,15,18
1,14,46,11,15,-4
1,14,47,10,6,4
1,14,48,19,10,9
1,14,49,29,21,8
1,14,50,14,12,2
1,14,51,19,12,7
1,14,52,13,3,10
1,14,53,21,9,12
1,14,54,4,7,-3
1,14,55,8,10,-2
1,14,56,22,12,10
1,14,57,5,7,-2
1,14,58,14,12,2
1,14,59,15,12,3
1,14,60,7,11,-4
1,14,61,15,20,-5
1,14,62,10,10,0
1,14,63,8,7,1
1,14,64,11,7,4
1,14,65,10,5,5
1,14,66,11,18,-7
1,14,67,9,7,2
1,14,68,6,8,-2
1,14,69,15,4,11
1,14,70,5,3,2
1,14,71,13,9,4
1,14,72,10,10,0
1,14,73,5,6,-1
1,14,74,11,8,3
1,14,75,21,6,15
1,14,76,10,14,-4
1,14,77,15,5,10
1,14,78,18,17,1
1,14,79,12,13,-1
1,14,80,23,14,9
1,14,81,14,5,9
1,14,82,16,6,10
1,14,83,25,7,18
1,14,84,7,6,1
1,14,85,14,9,5
1,14,86,10,3,7
1,14,87,14,18,-4
1,14,88,4,4,0
1,14,89,18,6,12
1,14,90,18,4,14
1,14,91,8,12,-4
1,14,92,15,1,14
1,14,93,4,2,2
1,14,94,13,6,7
1,14,95,20,11,9
1,14,96,24,10,14
1,14,97,20,13,7
1,14,98,9,11,-2
1,14,99,9,11,-2
1,14,100,13,13,0
1,14,101,6,3,3
1,14,102,15,5,10
1,14,103,27,8,19
1,14,104,15,11,4
1,14,105,3,9,-6
1,14,106,8,13,-5
1,14,107,8,14,-6
1,14,108,7,2,5
1,14,109,15,10,5
1,14,110,19,10,9
1,14,111,14,14,0
1,14,112,8,2,6
1,14,113,10,8,2
1,14,114,18,7,11
1,14,115,21,8,13
1,14,116,23,12,11
1,14,117,14,20,-6
1,14,118,15,16,-1
1,14,119,6,2,4
1,14,120,19,18,1
1,14,121,9,10,-1
1,14,122,6,4,2
1,14,123,8,6,2
1,14,124,17,9,8
1,14,125,15,8,7
1,14,126,12,10,2
1,14,127,12,8,4
1,14,128,21,10,11
1,14,129,12,12,0
1,14,130,4,11,-7
1,14,131,16,10,6
1,14,132,10,12,-2
1,14,133,19,18,1
1,14,134,13,9,4
1,14,135,15,15,0
1,14,136,14,6,8
1,14,137,15,1,14
1,14,138,19,9,10
1,14,139,10,10,0
1,14,140,20,16,4
1,14,141,21,12,9
1,14,142,12,7,5
1,14,143,13,16,-3
1,14,144,21,11,10
1,14,145,7,6,1
1,14,146,22,9,13
1,14,147,11,5,6
1,14,148,10,7,3
1,14,149,4,2,2
1,14,150,12,6,6
1,14,151,19,21,-2
1,14,152,7,3,4
1,14,153,20,5,15
1,14,154,12,11,1
1,14,155,23,12,11
1,14,156,20,13,7
1,14,157,21,11,10
1,14,158,16,8,8
1,14,159,19,3,16
1,14,160,15,7,8
1,14,161,5,11,-6
1,14,162,14,10,4
1,14,163,12,9,3
1,14,164,6,9,-3
1,14,165,13,19,-6
1,14,166,7,10,-3
1,14,167,13,18,-5
1,14,168,12,10,2
1,14,169,18,7,11
1,14,170,21,9,12
1,14,171,15,8,7
1,14,172,15,21,-6
1,14,173,6,3,3
1,14,174,14,6,8
1,14,175,5,11,-6
1,14,176,20,7,13
1,14,177,24,17,7
1,14,178,15,20,-5
1,14,179,5,4,1
1,14,180,21,7,14
1,14,181,21,20,1
1,14,182,10,12,-2
1,14,183,19,14,5
1,14,184,12,5,7
1,14,185,16,1,15
1,14,186,15,9,6
1,14,187,16,3,13
1,14,188,11,11,0
1,14,189,14,12,2
1,14,190,13,6,7
1,14,191,20,18,2
1,14,192,8,4,4
1,14,193,5,4,1
1,14,194,13,4,9
1,14,195,12,6,6
1,14,196,11,16,-5
1,14,197,16,6,10
1,14,198,25,11,14
1,14,199,4,6,-2
1,14,200,21,10,11
1,14,201,7,10,-3
1,14,202,25,2,23
1,14,203,16,2,14
1,14,204,8,11,-3
1,14,205,18,3,15
1,14,206,10,4,6
1,14,207,7,7,0
1,14,208,9,3,6
1,14,209,12,6,6
1,14,210,14,18,-4
1,14,211,11,10,1
1,14,212,21,16,5
1,14,213,13,4,9
1,14,214,10,6,4
1,14,215,17,9,8
1,14,216,18,6,12
1,14,217,3,2,1
1,14,218,13,9,4
1,14,219,9,7,2
1,14,220,10,5,5
1,14,221,13,13,0
1,14,222,18,20,-2
1,14,223,14,2,12
1,14,224,15,9,6
1,14,225,15,11,4
1,14,226,17,8,9
1,14,227,7,14,-7
1,14,228,17,8,9
1,14,229,19,11,8
1,14,230,18,7,11
1,14,231,13,10,3
1,14,232,7,5,2
1,14,233,12,9,3
1,14,234,23,12,11
1,14,235,16,17,-1
1,14,236,10,19,-9
1,14,237,20,9,11
1,14,238,14,7,7
1,14,239,18,6,12
1,14,240,11,9,2
1,14,241,19,12,7
1,14,242,5,8,-3
1,14,243,11,14,-3
1,14,244,10,9,1
1,14,245,17,6,11
1,14,246,8,4,4
1,14,247,14,13,1
1,14,248,18,5,13
1,14,249,19,13,6
1,14,250,9,3,6
1,14,251,10,21,-11
1,14,252,8,15,-7
1,14,253,17,17,0
1,14,254,11,2,9
1,14,255,9,8,1
1,14,256,13,11,2
1,14,257,12,6,6
1,14,258,14,5,9
1,14,259,14,6,8
1,14,260,14,14,0
1,14,261,15,14,1
1,14,262,9,6,3
1,14,263,14,18,-4
1,14,264,14,8,6
1,14,265,4,15,-11
1,14,266,21,6,15
1,14,267,12,6,6
1,14,268,15,11,4
1,14,269,16,9,7
1,14,270,13,17,-4
1,14,271,15,9,6
1,14,272,7,7,0
1,14,273,7,8,-1
1,14,274,14,13,1
1,14,275,17,7,10
1,14,276,26,20,6
1,14,277,10,10,0
1,14,278,16,12,4
1,14,279,7,10,-3
1,14,280,8,8,0
1,14,281,10,22,-12
1,14,282,6,9,-3
1,14,283,21,12,9
1,14,284,10,6,4
1,14,285,17,16,1
1,14,286,17,5,12
1,14,287,13,15,-2
1,14,288,16,16,0
1,14,289,29,16,13
1,14,290,16,24,-8
1,14,291,9,5,4
1,14,292,13,7,6
1,14,293,11,9,2
1,14,294,13,11,2
1,14,295,4,2,2
1,14,296,14,6,8
1,14,297,8,3,5
1,14,298,11,9,2
1,14,299,15,7,8
1,15,0,10,5,5
1,15,1,15,14,1
1,15,2,5,2,3
1,15,3,15,8,7
1,15,4,16,9,7
1,15,5,16,4,12
1,15,6,9,11,-2
1,15,7,16,8,8
1,15,8,21,11,10
1,15,9,18,6,12
1,15,10,16,9,7
1,15,11,8,9,-1
1,15,12,15,5,10
1,15,13,18,25,-7
1,15,14,14,11,3
1,15,15,4,4,0
1,15,16,14,10,4
1,15,17,19,9,10
1,15,18,9,6,3
1,15,19,13,13,0
1,15,20,20,12,8
1,15,21,18,12,6
1,15,22,9,9,0
1,15,23,17,14,3
1,15,24,15,6,9
1,15,25,12,14,-2
1,15,26,12,4,8
1,15,27,9,11,-2
1,15,28,18,5,13
1,15,29,14,10,4
1,15,30,4,0,4
1,15,31,15,4,11
1,15,32,12,7,5
1,15,33,10,9,1
1,15,34,21,11,10
1,15,35,9,5,4
1,15,36,23,15,8
1,15,37,13,12,1
1,15,38,12,3,9
1,15,39,11,3,8
1,15,40,8,6,2
1,15,41,17,6,11
1,15,42,27,16,11
1,15,43,9,5,4
1,15,44,8,10,-2
1,15,45,8,3,5
1,15,46,14,8,6
1,15,47,20,11,9
1,15,48,2,5,-3
1,15,49,11,9,2
1,15,50,25,18,7
1,15,51,2,1,1
1,15,52,12,9,3
1,15,53,18,16,2
1,15,54,17,3,14
1,15,55,17,7,10
1,15,56,23,16,7
1,15,57,5,10,-5
1,15,58,11,11,0
1,15,59,9,12,-3
1,15,60,20,6,14
1,15,61,12,6,6
1,15,62,9,4,5
1,15,63,26,10,16
1,15,64,27,8,19
1,15,65,15,14,1
1,15,66,15,17,-2
1,15,67,22,15,7
1,15,68,9,0,9
1,15,69,17,14,3
1,15,70,11,6,5
1,15,71,23,9,14
1,15,72,13,11,2
1,15,73,13,9,4
1,15,74,17,12,5
1,15,75,8,9,-1
1,15,76,10,18,-8
1,15,77,8,5,3
1,15,78,17,18,-1
1,15,79,10,3,7
1,15,80,34,15,19
1,15,81,11,6,5
1,15,82,18,10,8
1,15,83,9,8,1
1,15,84,24,18,6
1,15,85,9,10,-1
1,15,86,5,11,-6
1,15,87,18,8,10
1,15,88,13,9,4
1,15,89,13,15,-2
1,15,90,11,3,8
1,15,91,9,3,6
1,15,92,10,13,-3
1,15,93,6,9,-3
1,15,94,9,4,5
1,15,95,9,2,7
1,15,96,8,5,3
1,15,97,9,5,4
1,15,98,13,11,2
1,15,99,15,14,1
1,15,100,17,5,12
1,15,101,9,7,2
1,15,102,12,7,5
1,15,103,18,12,6
1,15,104,5,11,-6
1,15,105,19,10,9
1,15,106,15,5,10
1,15,107,7,14,-7
1,15,108,21,9,12
1,15,109,10,5,5
1,15,110,12,6,6
1,15,111,15,9,6
1,15,112,18,11,7
1,15,113,7,7,0
1,15,114,6,12,-6
1,15,115,7,9,-2
1,15,116,13,9,4
1,15,117,14,8,6
1,15,118,6,6,0
1,15,119,10,11,-1
1,15,120,10,13,-3
1,15,121,7,4,3
1,15,122,11,10,1
1,15,123,11,5,6
1,15,124,10,6,4
1,15,125,15,8,7
1,15,126,10,4,6
1,15,127,15,12,3
1,15,128,22,26,-4
1,15,129,17,18,-1
1,15,130,13,4,9
1,15,131,14,5,9
1,15,132,20,14,6
1,15,133,13,15,-2
1,15,134,5,8,-3
1,15,135,29,9,20
1,15,136,16,8,8
1,15,137,10,7,3
1,15,138,31,17,14
1,15,139,11,9,2
1,15,140,16,11,5
1,15,141,20,8,12
1,15,142,13,13,0
1,15,143,8,15,-7
1,15,144,21,10,11
1,15,145,13,8,5
1,15,146,10,9,1
1,15,147,9,3,6
1,15,148,10,13,-3
1,15,149,12,4,8
1,15,150,6,9,-3
1,15,151,12,6,6
1,15,152,7,16,-9
1,15,153,9,12,-3
1,15,154,9,5,4
1,15,155,20,18,2
1,15,156,12,10,2
1,15,157,10,8,2
1,15,158,25,13,12
1,15,159,18,7,11
1,15,160,9,15,-6
1,15,161,13,8,5
1,15,162,14,16,-2
1,15,163,9,9,0
1,15,164,16,5,11
1,15,165,7,7,0
1,15,166,14,3,11
1,15,167,16,12,4
1,15,168,19,4,15
1,15,169,21,11,10
1,15,170,10,12,-2
1,15,171,14,2,12
1,15,172,17,2,15
1,15,173,33,14,19
1,15,174,12,12,0
1,15,175,13,7,6
1,15,176,7,2,5
1,15,177,15,13,2
1,15,178,14,10,4
1,15,179,28,8,20
1,15,180,27,13,14
1,15,181,5,1,4
1,15,182,18,6,12
1,15,183,16,12,4
1,15,184,8,10,-2
1,15,185,14,9,5
1,15,186,9,4,5
1,15,187,10,9,1
1,15,188,17,10,7
1,15,189,14,3,11
1,15,190,17,12,5
1,15,191,9,5,4
1,15,192,19,6,13
1,15,193,20,13,7
1,15,194,4,8,-4
1,15,195,11,12,-1
1,15,196,13,16,-3
1,15,197,11,2,9
1,15,198,21,12,9
1,15,199,9,5,4
1,15,200,27,2,25
1,15,201,15,4,11
1,15,202,16,10,6
1,15,203,9,11,-2
1,15,204,19,10,9
1,15,205,19,10,9
1,15,206,16,17,-1
1,15,207,12,13,-1
1,15,208,14,2,12
1,15,209,13,4,9
1,15,210,10,6,4
1,15,211,14,11,3
1,15,212,5,10,-5
1,15,213,2,7,-5
1,15,214,8,10,-2
1,15,215,17,18,-1
1,15,216,16,5,11
1,15,217,15,16,-1
1,15,218,8,8,0
1,15,219,25,12,13
1,15,220,9,4,5
1,15,221,14,11,3
1,15,222,20,10,10
1,15,223,15,19,-4
1,15,224,4,8,-4
1,15,225,23,19,4
1,15,226,14,9,5
1,15,227,7,8,-1
1,15,228,11,5,6
1,15,229,16,5,11
1,15,230,17,6,11
1,15,231,21,10,11
1,15,232,9,9,0
1,15,233,8,3,5
1,15,234,20,6,14
1,15,235,17,9,8
1,15,236,13,5,8
1,15,237,17,12,5
1,15,238,18,21,-3
1,15,239,10,9,1
1,15,240,5,9,-4
1,15,241,9,5,4
1,15,242,13,9,4
1,15,243,18,18,0
1,15,244,19,7,12
1,15,245,15,12,3
1,15,246,8,12,-4
1,15,247,10,10,0
1,15,248,19,11,8
1,15,249,24,12,12
1,15,250,17,6,11
1,15,251,14,8,6
1,15,252,17,10,7
1,15,253,20,5,15
1,15,254,5,3,2
1,15,255,16,7,9
1,15,256,13,8,5
1,15,257,8,12,-4
1,15,258,8,6,2
1,15,259,10,3,7
1,15,260,22,5,17
1,15,261,10,4,6
1,15,262,18,7,11
1,15,263,13,9,4
1,15,264,14,10,4
1,15,265,8,1,7
1,15,266,8,9,-1
1,15,267,13,10,3
1,15,268,5,12,-7
1,15,269,4,2,2
1,15,270,18,12,6
1,15,271,22,3,19
1,15,272,8,7,1
1,15,273,11,6,5
1,15,274,15,18,-3
1,15,275,11,12,-1
1,15,276,19,10,9
1,15,277,7,3,4
1,15,278,19,16,3
1,15,279,14,17,-3
1,15,280,13,6,7
1,15,281,8,7,1
1,15,282,13,14,-1
1,15,283,15,10,5
1,15,284,15,12,3
1,15,285,5,4,1
1,15,286,14,4,10
1,15,287,14,6,8
1,15,288,9,14,-5
1,15,289,8,3,5
1,15,290,13,7,6
1,15,291,16,6,10
1,15,292,10,8,2
1,15,293,8,12,-4
1,15,294,11,13,-2
1,15,295,17,12,5
1,15,296,10,3,7
1,15,297,5,7,-2
1,15,298,23,13,10
1,15,299,8,2,6
1,16,0,6,16,-10
1,16,1,9,14,-5
1,16,2,8,8,0
1,16,3,10,5,5
1,16,4,22,12,10
1,16,5,15,11,4
1,16,6,18,15,3
1,16,7,19,16,3
1,16,8,9,13,-4
1,16,9,13,5,8
1,16,10,13,12,1
1,16,11,4,16,-12
1,16,12,15,10,5
1,16,13,5,9,-4
1,16,14,13,6,7
1,16,15,7,13,-6
1,16,16,15,5,10
1,16,17,16,13,3
1,16,18,9,13,-4
1,16,19,7,11,-4
1,16,20,7,11,-4
1,16,21,12,10,2
1,16,22,8,4,4
1,16,23,20,5,15
1,16,24,4,8,-4
1,16,25,15,10,5
1,16,26,14,8,6
1,16,27,17,5,12
1,16,28,18,12,6
1,16,29,22,23,-1
1,16,30,15,16,-1
1,16,31,25,9,16
1,16,32,24,9,15
1,16,33,8,15,-7
1,16,34,9,1,8
1,16,35,10,11,-1
1,16,36,16,3,13
1,16,37,10,4,6
1,16,38,8,11,-3
1,16,39,18,7,11
1,16,40,5,8,-3
1,16,41,22,9,13
1,16,42,18,23,-5
1,16,43,14,7,7
1,16,44,14,10,4
1,16,45,20,14,6
1,16,46,24,11,13
1,16,47,20,13,7
1,16,48,17,19,-2
1,16,49,14,8,6
1,16,50,14,6,8
1,16,51,19,4,15
1,16,52,14,7,7
1,16,53,10,12,-2
1,16,54,22,7,15
1,16,55,15,7,8
1,16,56,11,5,6
1,16,57,17,2,15
1,16,58,19,14,5
1,16,59,8,6,2
1,16,60,17,9,8
1,16,61,15,8,7
1,16,62,21,16,5
1,16,63,15,12,3
1,16,64,7,3,4
1,16,65,14,4,10
1,16,66,20,13,7
1,16,67,8,11,-3
1,16,68,10,9,1
1,16,69,25,21,4
1,16,70,20,10,10
1,16,71,19,9,10
1,16,72,32,13,19
1,16,73,9,9,0
1,16,74,19,13,6
1,16,75,10,12,-2
1,16,76,12,7,5
1,16,77,30,15,15
1,16,78,8,10,-2
1,16,79,15,7,8
1,16,80,10,11,-1
1,16,81,18,26,-8
1,16,82,20,8,12
1,16,83,17,10,7
1,16,84,22,11,11
1,16,85,7,7,0
1,16,86,11,7,4
1,16,87,10,14,-4
1,16,88,6,0,6
1,16,89,19,3,16
1,16,90,7,9,-2
1,16,91,15,8,7
1,16,92,14,11,3
1,16,93,5,5,0
1,16,94,16,5,11
1,16,95,11,5,6
1,16,96,13,7,6
1,16,97,9,5,4
1,16,98,13,10,3
1,16,99,13,11,2
1,16,100,16,9,7
1,16,101,30,18,12
1,16,102,10,6,4
1,16,103,31,16,15
1,16,104,19,8,11
1,16,105,7,6,1
1,16,106,2,0,2
1,16,107,9,8,1
1,16,108,17,9,8
1,16,109,11,8,3
1,16,110,17,12,5
1,16,111,20,9,11
1,16,112,9,11,-2
1,16,113,26,7,19
1,16,114,6,8,-2
1,16,115,6,2,4
1,16,116,6,4,2
1,16,117,26,25,1
1,16,118,8,6,2
1,16,119,31,20,11
1,16,120,15,14,1
1,16,121,22,12,10
1,16,122,9,13,-4
1,16,123,13,8,5
1,16,124,20,14,6
1,16,125,22,9,13
1,16,126,24,11,13
1,16,127,23,8,15
1,16,128,10,15,-5
1,16,129,9,3,6
1,16,130,14,2,12
1,16,131,21,18,3
1,16,132,15,20,-5
1,16,133,24,19,5
1,16,134,20,14,6
1,16,135,12,6,6
1,16,136,30,15,15
1,16,137,25,13,12
1,16,138,3,2,1
1,16,139,27,7,20
1,16,140,21,3,18
1,16,141,6,5,1
1,16,142,18,7,11
1,16,143,12,4,8
1,16,144,6,7,-1
1,16,145,14,16,-2
1,16,146,14,7,7
1,16,147,14,9,5
1,16,148,19,8,11
1,16,149,11,4,7
1,16,150,14,4,10
1,16,151,17,9,8
1,16,152,13,6,7
1,16,153,13,5,8
1,16,154,14,8,6
1,16,155,4,8,-4
1,16,156,25,19,6
1,16,157,9,4,5
1,16,158,7,5,2
1,16,159,19,9,10
1,16,160,22,13,9
1,16,161,9,10,-1
1,16,162,13,7,6
1,16,163,4,1,3
1,16,164,26,15,11
1,16,165,19,14,5
1,16,166,0,4,-4
1,16,167,17,13,4
1,16,168,32,3,29
1,16,169,10,11,-1
1,16,170,14,7,7
1,16,171,14,8,6
1,16,172,3,0,3
1,16,173,13,15,-2
1,16,174,9,16,-7
1,16,175,10,6,4
1,16,176,18,19,-1
1,16,177,23,11,12
1,16,178,12,4,8
1,16,179,13,3,10
1,16,180,22,7,15
1,16,181,5,9,-4
1,16,182,15,14,1
1,16,183,11,8,3
1,16,184,5,6,-1
1,16,185,15,8,7
1,16,186,18,12,6
1,16,187,16,7,9
1,16,188,22,12,10
1,16,189,12,9,3
1,16,190,19,6,13
1,16,191,12,3,9
1,16,192,13,3,10
1,16,193,15,10,5
1,16,194,14,8,6
1,16,195,16,9,7
1,16,196,9,7,2
1,16,197,16,10,6
1,16,198,19,9,10
1,16,199,15,16,-1
1,16,200,10,11,-1
1,16,201,7,4,3
1,16,202,11,4,7
1,16,203,9,8,1
1,16,204,11,16,-5
1,16,205,25,17,8
1,16,206,17,13,4
1,16,207,14,11,3
1,16,208,10,10,0
1,16,209,15,9,6
1,16,210,10,2,8
1,16,211,9,10,-1
1,16,212,10,7,3
1,16,213,17,18,-1
1,16,214,17,2,15
1,16,215,17,6,11
1,16,216,27,5,22
1,16,217,17,12,5
1,16,218,5,15,-10
1,16,219,13,3,10
1,16,220,21,13,8
1,16,221,20,8,12
1,16,222,19,15,4
1,16,223,13,12,1
1,16,224,9,10,-1
1,16,225,17,13,4
1,16,226,14,12,2
1,16,227,10,7,3
1,16,228,25,7,18
1,16,229,29,20,9
1,16,230,15,13,2
1,16,231,11,14,-3
1,16,232,17,6,11
1,16,233,5,4,1
1,16,234,19,18,1
1,16,235,12,12,0
1,16,236,13,6,7
1,16,237,16,6,10
1,16,238,23,11,12
1,16,239,11,9,2
1,16,240,24,11,13
1,16,241,10,10,0
1,16,242,12,11,1
1,16,243,7,5,2
1,16,244,8,8,0
1,16,245,14,9,5
1,16,246,18,9,9
1,16,247,14,8,6
1,16,248,13,10,3
1,16,249,12,10,2
1,16,250,19,4,15
1,16,251,13,3,10
1,16,252,18,10,8
1,16,253,12,5,7
1,16,254,11,6,5
1,16,255,10,3,7
1,16,256,10,9,1
1,16,257,11,10,1
1,16,258,5,4,1
1,16,259,8,10,-2
1,16,260,21,8,13
1,16,261,12,8,4
1,16,262,11,9,2
1,16,263,22,15,7
1,16,264,19,6,13
1,16,265,18,4,14
1,16,266,17,12,5
1,16,267,4,3,1
1,16,268,15,13,2
1,16,269,23,11,12
1,16,270,14,8,6
1,16,271,13,7,6
1,16,272,13,19,-6
1,16,273,5,7,-2
1,16,274,14,13,1
1,16,275,17,15,2
1,16,276,12,10,2
1,16,277,25,14,11
1,16,278,22,20,2
1,16,279,16,23,-7
1,16,280,10,3,7
1,16,281,13,19,-6
1,16,282,8,10,-2
1,16,283,26,11,15
1,16,284,17,2,15
1,16,285,17,11,6
1,16,286,5,6,-1
1,16,287,21,9,12
1,16,288,19,8,11
1,16,289,17,11,6
1,16,290,17,8,9
1,16,291,16,12,4
1,16,292,17,8,9
1,16,293,15,10,5
1,16,294,6,5,1
1,16,295,6,6,0
1,16,296,18,11,7
1,16,297,10,3,7
1,16,298,14,19,-5
1,16,299,5,4,1
1,17,0,21,10,11
1,17,1,12,6,6
1,17,2,10,8,2
1,17,3,14,6,8
1,17,4,18,8,10
1,17,5,15,6,9
1,17,6,31,10,21
1,17,7,6,4,2
1,17,8,13,13,0
1,17,9,15,6,9
1,17,10,15,17,-2
1,17,11,16,12,4
1,17,12,26,10,16
1,17,13,16,12,4
1,17,14,10,3,7
1,17,15,12,7,5
1,17,16,18,11,7
1,17,17,13,4,9
1,17,18,18,16,2
1,17,19,15,9,6
1,17,20,13,4,9
1,17,21,14,8,6
1,17,22,17,5,12
1,17,23,14,11,3
1,17,24,12,7,5
1,17,25,38,8,30
1,17,26,14,1,13
1,17,27,18,13,5
1,17,28,13,8,5
1,17,29,22,9,13
1,17,30,19,18,1
1,17,31,16,7,9
1,17,32,17,10,7
1,17,33,15,9,6
1,17,34,17,10,7
1,17,35,18,12,6
1,17,36,20,14,6
1,17,37,21,5,16
1,17,38,28,7,21
1,17,39,10,7,3
1,17,40,15,5,10
1,17,41,14,5,9
1,17,42,13,14,-1
1,17,43,17,9,8
1,17,44,22,13,9
1,17,45,24,4,20
1,17,46,16,11,5
1,17,47,9,12,-3
1,17,48,12,5,7
1,17,49,21,9,12
1,17,50,18,9,9
1,17,51,24,8,16
1,17,52,8,3,5
1,17,53,17,4,13
1,17,54,15,9,6
1,17,55,16,7,9
1,17,56,18,6,12
1,17,57,13,6,7
1,17,58,9,9,0
1,17,59,14,3,11
1,17,60,15,9,6
1,17,61,14,13,1
1,17,62,12,5,7
1,17,63,31,6,25
1,17,64,20,16,4
1,17,65,12,7,5
1,17,66,6,2,4
1,17,67,20,10,10
1,17,68,5,3,2
1,17,69,9,5,4
1,17,70,12,7,5
1,17,71,16,13,3
1,17,72,27,6,21
1,17,73,19,14,5
1,17,74,16,11,5
1,17,75,14,12,2
1,17,76,20,8,12
1,17,77,23,10,13
1,17,78,7,2,5
1,17,79,7,7,0
1,17,80,14,13,1
1,17,81,14,11,3
1,17,82,11,20,-9
1,17,83,27,16,11
1,17,84,10,7,3
1,17,85,9,9,0
1,17,86,12,6,6
1,17,87,12,9,3
1,17,88,5,3,2
1,17,89,13,2,11
1,17,90,20,6,14
1,17,91,16,5,11
1,17,92,16,8,8
1,17,93,16,16,0
1,17,94,10,10,0
1,17,95,8,2,6
1,17,96,7,8,-1
1,17,97,24,11,13
1,17,98,13,8,5
1,17,99,15,12,3
1,17,100,18,15,3
1,17,101,41,7,34
1,17,102,26,18,8
1,17,103,12,7,5
1,17,104,25,13,12
1,17,105,40,13,27
1,17,106,20,19,1
1,17,107,14,9,5
1,17,108,20,5,15
1,17,109,11,14,-3
1,17,110,19,4,15
1,17,111,10,4,6
1,17,112,6,7,-1
1,17,113,17,14,3
1,17,114,23,9,14
1,17,115,24,8,16
1,17,116,19,7,12
1,17,117,14,6,8
1,17,118,16,7,9
1,17,119,22,8,14
1,17,120,16,10,6
1,17,121,21,7,14
1,17,122,16,8,8
1,17,123,30,5,25
1,17,124,17,10,7
1,17,125,18,4,14
1,17,126,23,14,9
1,17,127,20,8,12
1,17,128,12,13,-1
1,17,129,13,14,-1
1,17,130,8,1,7
1,17,131,9,3,6
1,17,132,9,5,4
1,17,133,22,9,13
1,17,134,17,10,7
1,17,135,25,14,11
1,17,136,8,5,3
1,17,137,13,7,6
1,17,138,16,9,7
1,17,139,20,18,2
1,17,140,6,6,0
1,17,141,5,1,4
1,17,142,9,12,-3
1,17,143,9,10,-1
1,17,144,20,5,15
1,17,145,8,7,1
1,17,146,9,11,-2
1,17,147,14,6,8
1,17,148,12,9,3
1,17,149,14,20,-6
1,17,150,17,14,3
1,17,151,16,17,-1
1,17,152,13,10,3
1,17,153,12,7,5
1,17,154,14,11,3
1,17,155,6,4,2
1,17,156,16,5,11
1,17,157,13,15,-2
1,17,158,12,7,5
1,17,159,16,4,12
1,17,160,13,5,8
1,17,161,26,14,12
1,17,162,32,14,18
1,17,163,12,1,11
1,17,164,11,9,2
1,17,165,14,11,3
1,17,166,25,21,4
1,17,167,26,7,19
1,17,168,12,25,-13
1,17,169,4,5,-1
1,17,170,15,13,2
1,17,171,13,8,5
1,17,172,22,10,12
1,17,173,16,12,4
1,17,174,15,12,3
1,17,175,31,10,21
1,17,176,9,3,6
1,17,177,15,10,5
1,17,178,11,6,5
1,17,179,20,6,14
1,17,180,11,11,0
1,17,181,23,9,14
1,17,182,10,1,9
1,17,183,8,5,3
1,17,184,9,8,1
1,17,185,9,5,4
1,17,186,23,18,5
1,17,187,24,4,20
1,17,188,0,10,-10
1,17,189,7,13,-6
1,17,190,11,6,5
1,17,191,8,6,2
1,17,192,21,4,17
1,17,193,18,12,6
1,17,194,18,6,12
1,17,195,8,0,8
1,17,196,17,9,8
1,17,197,7,9,-2
1,17,198,14,17,-3
1,17,199,11,3,8
1,17,200,23,4,19
1,17,201,17,7,10
1,17,202,18,9,9
1,17,203,14,11,3
1,17,204,17,8,9
1,17,205,17,13,4
1,17,206,16,6,10
1,17,207,15,1,14
1,17,208,17,6,11
1,17,209,6,4,2
1,17,210,16,17,-1
1,17,211,20,8,12
1,17,212,13,9,4
1,17,213,10,14,-4
1,17,214,13,4,9
1,17,215,21,8,13
1,17,216,19,11,8
1,17,217,17,8,9
1,17,218,20,3,17
1,17,219,11,6,5
1,17,220,25,16,9
1,17,221,12,3,9
1,17,222,8,12,-4
1,17,223,6,3,3
1,17,224,14,6,8
1,17,225,19,5,14
1,17,226,13,9,4
1,17,227,13,10,3
1,17,228,21,13,8
1,17,229,12,8,4
1,17,230,15,17,-2
1,17,231,11,11,0
1,17,232,9,6,3
1,17,233,7,10,-3
1,17,234,14,4,10
1,17,235,12,1,11
1,17,236,14,2,12
1,17,237,21,7,14
1,17,238,35,10,25
1,17,239,10,10,0
1,17,240,18,8,10
1,17,241,13,16,-3
1,17,242,17,2,15
1,17,243,11,10,1
1,17,244,13,7,6
1,17,245,8,7,1
1,17,246,28,8,20
1,17,247,22,5,17
1,17,248,19,10,9
1,17,249,15,6,9
1,17,250,24,12,12
1,17,251,12,13,-1
1,17,252,11,4,7
1,17,253,12,6,6
1,17,254,14,10,4
1,17,255,11,13,-2
1,17,256,14,9,5
1,17,257,16,13,3
1,17,258,19,5,14
1,17,259,18,10,8
1,17,260,27,13,14
1,17,261,15,11,4
1,17,262,15,9,6
1,17,263,15,16,-1
1,17,264,15,4,11
1,17,265,20,11,9
1,17,266,18,9,9
1,17,267,16,7,9
1,17,268,24,12,12
1,17,269,23,12,11
1,17,270,19,8,11
1,17,271,17,6,11
1,17,272,22,15,7
1,17,273,19,5,14
1,17,274,11,5,6
1,17,275,13,8,5
1,17,276,18,18,0
1,17,277,7,4,3
1,17,278,20,17,3
1,17,279,13,8,5
1,17,280,8,4,4
1,17,281,3,7,-4
1,17,282,19,12,7
1,17,283,13,13,0
1,17,284,13,7,6
1,17,285,18,8,10
1,17,286,9,7,2
1,17,287,16,2,14
1,17,288,21,9,12
1,17,289,14,6,8
1,17,290,16,10,6
1,17,291,22,12,10
1,17,292,12,12,0
1,17,293,18,6,12
1,17,294,18,16,2
1,17,295,39,6,33
1,17,296,18,13,5
1,17,297,11,5,6
1,17,298,9,5,4
1,17,299,14,8,6
1,18,0,29,18,11
1,18,1,21,3,18
1,18,2,16,6,10
1,18,3,12,11,1
1,18,4,14,15,-1
1,18,5,15,13,2
1,18,6,20,9,11
1,18,7,17,4,13
1,18,8,18,9,9
1,18,9,25,17,8
1,18,10,20,7,13
1,18,11,5,6,-1
1,18,12,13,8,5
1,18,13,16,13,3
1,18,14,18,9,9
1,18,15,15,5,10
1,18,16,13,13,0
1,18,17,13,7,6
1,18,18,15,10,5
1,18,19,15,20,-5
1,18,20,11,8,3
1,18,21,10,1,9
1,18,22,12,8,4
1,18,23,23,14,9
1,18,24,6,9,-3
1,18,25,26,13,13
1,18,26,8,2,6
1,18,27,20,12,8
1,18,28,14,8,6
1,18,29,36,21,15
1,18,30,17,12,5
1,18,31,11,13,-2
1,18,32,20,9,11
1,18,33,18,9,9
1,18,34,15,5,10
1,18,35,7,8,-1
1,18,36,6,4,2
1,18,37,19,11,8
1,18,38,19,3,16
1,18,39,11,3,8
1,18,40,17,12,5
1,18,41,16,13,3
1,18,42,6,8,-2
1,18,43,21,12,9
1,18,44,23,6,17
1,18,45,12,9,3
1,18,46,17,12,5
1,18,47,14,27,-13
1,18,48,12,12,0
1,18,49,13,3,10
1,18,50,20,7,13
1,18,51,26,11,15
1,18,52,19,11,8
1,18,53,23,14,9
1,18,54,14,8,6
1,18,55,28,8,20
1,18,56,17,14,3
1,18,57,19,17,2
1,18,58,18,10,8
1,18,59,9,2,7
1,18,60,14,12,2
1,18,61,17,1,16
1,18,62,16,7,9
1,18,63,20,12,8
1,18,64,20,7,13
1,18,65,15,6,9
1,18,66,17,8,9
1,18,67,11,3,8
1,18,68,4,3,1
1,18,69,15,11,4
1,18,70,18,11,7
1,18,71,9,9,0
1,18,72,12,5,7
1,18,73,24,16,8
1,18,74,14,8,6
1,18,75,16,14,2
1,18,76,17,2,15
1,18,77,19,5,14
1,18,78,12,9,3
1,18,79,27,13,14
1,18,80,13,9,4
1,18,81,14,8,6
1,18,82,8,8,0
1,18,83,23,10,13
1,18,84,16,8,8
1,18,85,16,11,5
1,18,86,22,8,14
1,18,87,31,17,14
1,18,88,29,11,18
1,18,89,19,9,10
1,18,90,22,15,7
1,18,91,13,1,12
1,18,92,20,5,15
1,18,93,15,7,8
1,18,94,12,8,4
1,18,95,12,15,-3
1,18,96,16,7,9
1,18,97,6,4,2
1,18,98,11,7,4
1,18,99,5,5,0
1,18,100,12,12,0
1,18,101,17,6,11
1,18,102,17,15,2
1,18,103,21,8,13
1,18,104,19,10,9
1,18,105,13,3,10
1,18,106,11,4,7
1,18,107,21,7,14
1,18,108,21,18,3
1,18,109,9,7,2
1,18,110,11,11,0
1,18,111,6,3,3
1,18,112,20,10,10
1,18,113,15,15,0
1,18,114,14,8,6
1,18,115,4,6,-2
1,18,116,9,9,0
1,18,117,14,10,4
1,18,118,26,9,17
1,18,119,16,9,7
1,18,120,24,13,11
1,18,121,8,13,-5
1,18,122,11,5,6
1,18,123,19,7,12
1,18,124,7,2,5
1,18,125,22,13,9
1,18,126,4,0,4
1,18,127,9,13,-4
1,18,128,21,11,10
1,18,129,15,8,7
1,18,130,8,1,7
1,18,131,20,19,1
1,18,132,38,16,22
1,18,133,21,6,15
1,18,134,15,8,7
1,18,135,7,7,0
1,18,136,23,11,12
1,18,137,7,1,6
1,18,138,9,15,-6
1,18,139,25,11,14
1,18,140,10,5,5
1,18,141,14,6,8
1,18,142,10,7,3
1,18,143,20,4,16
1,18,144,12,12,0
1,18,145,8,7,1
1,18,146,21,16,5
1,18,147,16,5,11
1,18,148,6,11,-5
1,18,149,20,9,11
1,18,150,19,8,11
1,18,151,11,4,7
1,18,152,17,16,1
1,18,153,8,7,1
1,18,154,7,10,-3
1,18,155,22,11,11
1,18,156,4,9,-5
1,18,157,27,15,12
1,18,158,20,10,10
1,18,159,10,13,-3
1,18,160,16,22,-6
1,18,161,17,9,8
1,18,162,14,6,8
1,18,163,11,6,5
1,18,164,15,12,3
1,18,165,19,7,12
1,18,166,8,6,2
1,18,167,7,1,6
1,18,168,12,4,8
1,18,169,16,16,0
1,18,170,4,7,-3
1,18,171,17,16,1
1,18,172,29,8,21
1,18,173,17,12,5
1,18,174,10,6,4
1,18,175,15,6,9
1,18,176,26,13,13
1,18,177,20,7,13
1,18,178,8,8,0
1,18,179,13,7,6
1,18,180,17,3,14
1,18,181,19,1,18
1,18,182,17,7,10
1,18,183,22,15,7
1,18,184,19,23,-4
1,18,185,10,3,7
1,18,186,15,7,8
1,18,187,17,9,8
1,18,188,20,13,7
1,18,189,7,7,0
1,18,190,10,9,1
1,18,191,10,12,-2
1,18,192,23,8,15
1,18,193,17,7,10
1,18,194,9,6,3
1,18,195,17,4,13
1,18,196,12,5,7
1,18,197,18,5,13
1,18,198,19,4,15
1,18,199,6,5,1
1,18,200,15,4,11
1,18,201,16,6,10
1,18,202,15,9,6
1,18,203,10,9,1
1,18,204,6,12,-6
1,18,205,18,5,13
1,18,206,8,7,1
1,18,207,6,0,6
1,18,208,8,6,2
1,18,209,14,6,8
1,18,210,13,4,9
1,18,211,13,3,10
1,18,212,11,2,9
1,18,213,16,6,10
1,18,214,2,6,-4
1,18,215,14,12,2
1,18,216,13,14,-1
1,18,217,24,23,1
1,18,218,15,11,4
1,18,219,12,14,-2
1,18,220,11,6,5
1,18,221,7,11,-4
1,18,222,15,3,12
1,18,223,22,12,10
1,18,224,21,9,12
1,18,225,5,2,3
1,18,226,6,6,0
1,18,227,34,9,25
1,18,228,9,4,5
1,18,229,10,7,3
1,18,230,12,4,8
1,18,231,31,13,18
1,18,232,13,6,7
1,18,233,25,8,17
1,18,234,4,1,3
1,18,235,32,18,14
1,18,236,19,6,13
1,18,237,16,4,12
1,18,238,22,14,8
1,18,239,14,7,7
1,18,240,11,3,8
1,18,241,9,10,-1
1,18,242,5,11,-6
1,18,243,13,10,3
1,18,244,12,4,8
1,18,245,18,19,-1
1,18,246,12,6,6
1,18,247,12,3,9
1,18,248,12,12,0
1,18,249,8,6,2
1,18,250,21,6,15
1,18,251,14,14,0
1,18,252,15,6,9
1,18,253,16,6,10
1,18,254,18,10,8
1,18,255,18,6,12
1,18,256,14,3,11
1,18,257,28,10,18
1,18,258,30,15,15
1,18,259,3,7,-4
1,18,260,24,14,10
1,18,261,22,10,12
1,18,262,10,7,3
1,18,263,18,6,12
1,18,264,13,17,-4
1,18,265,14,5,9
1,18,266,15,4,11
1,18,267,18,6,12
1,18,268,14,10,4
1,18,269,8,12,-4
1,18,270,23,16,7
1,18,271,26,11,15
1,18,272,13,4,9
1,18,273,17,6,11
1,18,274,18,5,13
1,18,275,13,13,0
1,18,276,17,8,9
1,18,277,19,9,10
1,18,278,14,5,9
1,18,279,3,1,2
1,18,280,24,7,17
1,18,281,25,11,14
1,18,282,8,11,-3
1,18,283,12,7,5
1,18,284,15,6,9
1,18,285,11,4,7
1,18,286,12,10,2
1,18,287,24,7,17
1,18,288,5,6,-1
1,18,289,18,10,8
1,18,290,29,15,14
1,18,291,11,10,1
1,18,292,15,10,5
1,18,293,30,17,13
1,18,294,11,13,-2
1,18,295,14,11,3
1,18,296,16,11,5
1,18,297,7,4,3
1,18,298,8,4,4
1,18,299,15,10,5
1,19,0,14,1,13
1,19,1,9,3,6
1,19,2,14,13,1
1,19,3,24,8,16
1,19,4,17,18,-1
1,19,5,13,16,-3
1,19,6,11,8,3
1,19,7,19,11,8
1,19,8,19,14,5
1,19,9,14,4,10
1,19,10,25,13,12
1,19,11,17,10,7
1,19,12,20,10,10
1,19,13,12,6,6
1,19,14,13,11,2
1,19,15,8,4,4
1,19,16,16,9,7
1,19,17,15,11,4
1,19,18,12,7,5
1,19,19,12,4,8
1,19,20,18,10,8
1,19,21,15,10,5
1,19,22,14,4,10
1,19,23,11,5,6
1,19,24,10,12,-2
1,19,25,27,19,8
1,19,26,24,8,16
1,19,27,31,18,13
1,19,28,25,14,11
1,19,29,3,5,-2
1,19,30,14,6,8
1,19,31,8,9,-1
1,19,32,24,7,17
1,19,33,20,14,6
1,19,34,18,5,13
1,19,35,26,18,8
1,19,36,9,7,2
1,19,37,14,6,8
1,19,38,25,5,20
1,19,39,18,8,10
1,19,40,21,4,17
1,19,41,16,7,9
1,19,42,22,5,17
1,19,43,20,17,3
1,19,44,18,8,10
1,19,45,20,17,3
1,19,46,12,10,2
1,19,47,2,9,-7
1,19,48,10,7,3
1,19,49,6,9,-3
1,19,50,19,6,13
1,19,51,17,6,11
1,19,52,9,5,4
1,19,53,8,6,2
1,19,54,3,3,0
1,19,55,16,15,1
1,19,56,16,13,3
1,19,57,7,7,0
1,19,58,24,15,9
1,19,59,22,10,12
1,19,60,17,6,11
1,19,61,28,14,14
1,19,62,9,5,4
1,19,63,14,11,3
1,19,64,20,16,4
1,19,65,23,32,-9
1,19,66,2,0,2
1,19,67,15,9,6
1,19,68,34,7,27
1,19,69,12,10,2
1,19,70,6,5,1
1,19,71,12,8,4
1,19,72,3,4,-1
1,19,73,25,11,14
1,19,74,17,8,9
1,19,75,21,8,13
1,19,76,27,10,17
1,19,77,22,12,10
1,19,78,15,15,0
1,19,79,21,6,15
1,19,80,17,5,12
1,19,81,19,5,14
1,19,82,27,18,9
1,19,83,11,4,7
1,19,84,13,11,2
1,19,85,9,4,5
1,19,86,11,5,6
1,19,87,14,16,-2
1,19,88,16,7,9
1,19,89,13,2,11
1,19,90,8,2,6
1,19,91,11,20,-9
1,19,92,22,24,-2
1,19,93,7,4,3
1,19,94,10,19,-9
1,19,95,18,7,11
1,19,96,9,17,-8
1,19,97,15,16,-1
1,19,98,14,2,12
1,19,99,9,4,5
1,19,100,16,8,8
1,19,101,21,20,1
1,19,102,17,13,4
1,19,103,25,11,14
1,19,104,39,14,25
1,19,105,25,19,6
1,19,106,12,9,3
1,19,107,13,8,5
1,19,108,14,13,1
1,19,109,27,6,21
1,19,110,12,6,6
1,19,111,9,4,5
1,19,112,16,20,-4
1,19,113,20,8,12
1,19,114,26,15,11
1,19,115,17,5,12
1,19,116,11,17,-6
1,19,117,25,7,18
1,19,118,18,8,10
1,19,119,21,12,9
1,19,120,8,18,-10
1,19,121,8,6,2
1,19,122,16,10,6
1,19,123,7,4,3
1,19,124,4,11,-7
1,19,125,21,3,18
1,19,126,14,2,12
1,19,127,17,13,4
1,19,128,15,6,9
1,19,129,18,10,8
1,19,130,7,6,1
1,19,131,27,6,21
1,19,132,29,21,8
1,19,133,14,13,1
1,19,134,15,5,10
1,19,135,13,14,-1
1,19,136,16,12,4
1,19,137,20,14,6
1,19,138,18,8,10
1,19,139,21,10,11
1,19,140,48,8,40
1,19,141,19,10,9
1,19,142,7,6,1
1,19,143,9,3,6
1,19,144,18,22,-4
1,19,145,18,13,5
1,19,146,17,5,12
1,19,147,9,10,-1
1,19,148,25,6,19
1,19,149,20,3,17
1,19,150,12,10,2
1,19,151,17,5,12
1,19,152,8,5,3
1,19,153,11,8,3
1,19,154,12,11,1
1,19,155,16,4,12
1,19,156,10,1,9
1,19,157,3,10,-7
1,19,158,6,8,-2
1,19,159,14,6,8
1,19,160,15,6,9
1,19,161,16,9,7
1,19,162,28,11,17
1,19,163,16,3,13
1,19,164,11,10,1
1,19,165,14,11,3
1,19,166,19,24,-5
1,19,167,9,5,4
1,19,168,13,10,3
1,19,169,12,16,-4
1,19,170,30,13,17
1,19,171,20,6,14
1,19,172,6,6,0
1,19,173,24,14,10
1,19,174,16,11,5
1,19,175,17,9,8
1,19,176,13,11,2
1,19,177,15,10,5
1,19,178,20,8,12
1,19,179,13,6,7
1,19,180,21,11,10
1,19,181,11,15,-4
1,19,182,10,11,-1
1,19,183,23,6,17
1,19,184,18,11,7
1,19,185,24,15,9
1,19,186,11,7,4
1,19,187,16,6,10
1,19,188,14,4,10
1,19,189,24,17,7
1,19,190,9,3,6
1,19,191,17,12,5
1,19,192,8,13,-5
1,19,193,17,7,10
1,19,194,11,16,-5
1,19,195,21,9,12
1,19,196,11,17,-6
1,19,197,11,6,5
1,19,198,22,8,14
1,19,199,16,6,10
1,19,200,8,3,5
1,19,201,17,13,4
1,19,202,5,3,2
1,19,203,4,4,0
1,19,204,5,8,-3
1,19,205,16,4,12
1,19,206,24,5,19
1,19,207,23,12,11
1,19,208,13,8,5
1,19,209,17,13,4
1,19,210,8,9,-1
1,19,211,16,13,3
1,19,212,10,7,3
1,19,213,6,11,-5
1,19,214,18,11,7
1,19,215,19,13,6
1,19,216,11,15,-4
1,19,217,10,5,5
1,19,218,12,2,10
1,19,219,10,12,-2
1,19,220,16,15,1
1,19,221,25,13,12
1,19,222,21,21,0
1,19,223,15,13,2
1,19,224,17,17,0
1,19,225,17,15,2
1,19,226,29,16,13
1,19,227,8,10,-2
1,19,228,10,9,1
1,19,229,11,3,8
1,19,230,14,4,10
1,19,231,25,20,5
1,19,232,8,3,5
1,19,233,8,8,0
1,19,234,14,5,9
1,19,235,17,5,12
1,19,236,10,6,4
1,19,237,10,3,7
1,19,238,14,3,11
1,19,239,24,19,5
1,19,240,8,10,-2
1,19,241,28,12,16
1,19,242,8,12,-4
1,19,243,14,15,-1
1,19,244,13,6,7
1,19,245,6,19,-13
1,19,246,9,8,1
1,19,247,15,6,9
1,19,248,15,9,6
1,19,249,20,8,12
1,19,250,11,2,9
1,19,251,26,12,14
1,19,252,17,1,16
1,19,253,16,11,5
1,19,254,20,9,11
1,19,255,5,1,4
1,19,256,4,13,-9
1,19,257,10,5,5
1,19,258,18,19,-1
1,19,259,22,9,13
1,19,260,6,10,-4
1,19,261,22,19,3
1,19,262,8,2,6
1,19,263,29,7,22
1,19,264,14,6,8
1,19,265,10,12,-2
1,19,266,14,4,10
1,19,267,17,15,2
1,19,268,20,14,6
1,19,269,19,8,11
1,19,270,15,5,10
1,19,271,18,10,8
1,19,272,12,5,7
1,19,273,22,9,13
1,19,274,18,5,13
1,19,275,27,8,19
1,19,276,9,7,2
1,19,277,18,8,10
1,19,278,21,9,12
1,19,279,13,4,9
1,19,280,21,8,13
1,19,281,15,8,7
1,19,282,24,20,4
1,19,283,4,4,0
1,19,284,21,10,11
1,19,285,18,2,16
1,19,286,23,8,15
1,19,287,37,7,30
1,19,288,17,7,10
1,19,289,10,12,-2
1,19,290,17,14,3
1,19,291,18,7,11
1,19,292,16,7,9
1,19,293,17,5,12
1,19,294,11,7,4
1,19,295,7,9,-2
1,19,296,11,19,-8
1,19,297,6,9,-3
1,19,298,11,10,1
1,19,299,21,15,6
1,20,0,19,7,12
1,20,1,12,7,5
1,20,2,8,7,1
1,20,3,24,10,14
1,20,4,13,7,6
1,20,5,8,8,0
1,20,6,11,8,3
1,20,7,23,12,11
1,20,8,25,6,19
1,20,9,21,11,10
1,20,10,9,6,3
1,20,11,16,4,12
1,20,12,3,3,0
1,20,13,9,16,-7
1,20,14,13,9,4
1,20,15,16,8,8
1,20,16,13,7,6
1,20,17,29,21,8
1,20,18,14,7,7
1,20,19,26,19,7
1,20,20,10,7,3
1,20,21,12,9,3
1,20,22,7,8,-1
1,20,23,11,8,3
1,20,24,16,6,10
1,20,25,12,7,5
1,20,26,5,5,0
1,20,27,14,5,9
1,20,28,21,11,10
1,20,29,11,10,1
1,20,30,9,7,2
1,20,31,11,15,-4
1,20,32,12,4,8
1,20,33,9,5,4
1,20,34,13,7,6
1,20,35,23,8,15
1,20,36,20,8,12
1,20,37,20,4,16
1,20,38,11,2,9
1,20,39,18,7,11
1,20,40,16,16,0
1,20,41,12,13,-1
1,20,42,6,8,-2
1,20,43,25,11,14
1,20,44,22,11,11
1,20,45,20,16,4
1,20,46,22,14,8
1,20,47,11,12,-1
1,20,48,13,10,3
1,20,49,17,8,9
1,20,50,8,9,-1
1,20,51,12,21,-9
1,20,52,25,5,20
1,20,53,13,1,12
1,20,54,31,9,22
1,20,55,12,7,5
1,20,56,10,8,2
1,20,57,14,23,-9
1,20,58,11,7,4
1,20,59,24,15,9
1,20,60,28,25,3
1,20,61,15,10,5
1,20,62,21,14,7
1,20,63,10,13,-3
1,20,64,22,20,2
1,20,65,24,3,21
1,20,66,9,4,5
1,20,67,21,5,16
1,20,68,13,3,10
1,20,69,18,17,1
1,20,70,7,10,-3
1,20,71,15,7,8
1,20,72,15,6,9
1,20,73,10,7,3
1,20,74,14,7,7
1,20,75,7,9,-2
1,20,76,8,12,-4
1,20,77,5,6,-1
1,20,78,11,5,6
1,20,79,30,13,17
1,20,80,3,8,-5
1,20,81,27,12,15
1,20,82,24,13,11
1,20,83,11,7,4
1,20,84,26,18,8
1,20,85,10,16,-6
1,20,86,11,10,1
1,20,87,12,8,4
1,20,88,8,9,-1
1,20,89,12,4,8
1,20,90,22,6,16
1,20,91,20,6,14
1,20,92,18,7,11
1,20,93,13,8,5
1,20,94,19,9,10
1,20,95,13,14,-1
1,20,96,13,9,4
1,20,97,9,8,1
1,20,98,21,15,6
1,20,99,30,10,20
1,20,100,4,4,0
1,20,101,9,3,6
1,20,102,9,7,2
1,20,103,19,5,14
1,20,104,22,10,12
1,20,105,17,18,-1
1,20,106,18,5,13
1,20,107,10,12,-2
1,20,108,11,12,-1
1,20,109,6,7,-1
1,20,110,14,5,9
1,20,111,20,10,10
1,20,112,8,7,1
1,20,113,18,22,-4
1,20,114,7,17,-10
1,20,115,16,7,9
1,20,116,18,12,6
1,20,117,6,5,1
1,20,118,17,7,10
1,20,119,14,12,2
1,20,120,14,7,7
1,20,121,21,10,11
1,20,122,17,8,9
1,20,123,11,3,8
1,20,124,15,10,5
1,20,125,13,7,6
1,20,126,14,13,1
1,20,127,5,0,5
1,20,128,15,8,7
1,20,129,8,6,2
1,20,130,16,3,13
1,20,131,14,6,8
1,20,132,26,18,8
1,20,133,5,1,4
1,20,134,19,10,9
1,20,135,25,7,18
1,20,136,15,5,10
1,20,137,10,4,6
1,20,138,12,3,9
1,20,139,18,19,-1
1,20,140,21,12,9
1,20,141,21,7,14
1,20,142,7,4,3
1,20,143,9,7,2
1,20,144,8,4,4
1,20,145,19,9,10
1,20,146,19,6,13
1,20,147,27,8,19
1,20,148,11,9,2
1,20,149,9,4,5
1,20,150,18,6,12
1,20,151,5,14,-9
1,20,152,14,11,3
1,20,153,8,10,-2
1,20,154,17,5,12
1,20,155,20,7,13
1,20,156,14,4,10
1,20,157,22,5,17
1,20,158,6,14,-8
1,20,159,21,18,3
1,20,160,17,7,10
1,20,161,20,3,17
1,20,162,17,9,8
1,20,163,31,11,20
1,20,164,22,7,15
1,20,165,19,5,14
1,20,166,28,11,17
1,20,167,18,6,12
1,20,168,17,8,9
1,20,169,21,13,8
1,20,170,10,8,2
1,20,171,17,13,4
1,20,172,23,6,17
1,20,173,16,8,8
1,20,174,19,9,10
1,20,175,14,10,4
1,20,176,7,7,0
1,20,177,9,7,2
1,20,178,19,7,12
1,20,179,13,9,4
1,20,180,16,5,11
1,20,181,18,9,9
1,20,182,14,10,4
1,20,183,26,8,18
1,20,184,11,17,-6
1,20,185,16,14,2
1,20,186,8,4,4
1,20,187,11,6,5
1,20,188,24,10,14
1,20,189,8,10,-2
1,20,190,11,5,6
1,20,191,21,10,11
1,20,192,10,6,4
1,20,193,14,12,2
1,20,194,8,10,-2
1,20,195,16,21,-5
1,20,196,14,6,8
1,20,197,14,18,-4
1,20,198,14,12,2
1,20,199,15,17,-2
1,20,200,20,13,7
1,20,201,7,16,-9
1,20,202,18,7,11
1,20,203,15,3,12
1,20,204,8,3,5
1,20,205,17,12,5
1,20,206,21,8,13
1,20,207,11,5,6
1,20,208,20,9,11
1,20,209,12,8,4
1,20,210,21,18,3
1,20,211,16,9,7
1,20,212,19,7,12
1,20,213,17,6,11
1,20,214,17,16,1
1,20,215,14,2,12
1,20,216,23,13,10
1,20,217,9,3,6
1,20,218,13,3,10
1,20,219,14,7,7
1,20,220,17,11,6
1,20,221,12,16,-4
1,20,222,8,8,0
1,20,223,28,6,22
1,20,224,10,4,6
1,20,225,14,9,5
1,20,226,18,19,-1
1,20,227,26,13,13
1,20,228,27,14,13
1,20,229,17,3,14
1,20,230,20,15,5
1,20,231,14,8,6
1,20,232,14,3,11
1,20,233,12,12,0
1,20,234,10,7,3
1,20,235,19,12,7
1,20,236,15,4,11
1,20,237,15,9,6
1,20,238,24,18,6
1,20,239,18,17,1
1,20,240,16,21,-5
1,20,241,9,5,4
1,20,242,7,5,2
1,20,243,24,13,11
1,20,244,17,6,11
1,20,245,24,15,9
1,20,246,12,10,2
1,20,247,16,3,13
1,20,248,20,6,14
1,20,249,13,4,9
1,20,250,11,18,-7
1,20,251,9,8,1
1,20,252,6,4,2
1,20,253,20,10,10
1,20,254,13,6,7
1,20,255,15,13,2
1,20,256,18,15,3
1,20,257,12,2,10
1,20,258,29,9,20
1,20,259,9,13,-4
1,20,260,18,12,6
1,20,261,21,7,14
1,20,262,19,12,7
1,20,263,8,13,-5
1,20,264,22,9,13
1,20,265,9,9,0
1,20,266,16,3,13
1,20,267,9,4,5
1,20,268,15,12,3
1,20,269,18,9,9
1,20,270,20,15,5
1,20,271,16,4,12
1,20,272,14,16,-2
1,20,273,17,14,3
1,20,274,21,8,13
1,20,275,9,9,0
1,20,276,12,8,4
1,20,277,15,10,5
1,20,278,6,7,-1
1,20,279,30,15,15
1,20,280,11,11,0
1,20,281,8,9,-1
1,20,282,20,12,8
1,20,283,22,6,16
1,20,284,21,10,11
1,20,285,12,5,7
1,20,286,8,4,4
1,20,287,9,10,-1
1,20,288,19,9,10
1,20,289,24,9,15
1,20,290,11,6,5
1,20,291,4,2,2
1,20,292,13,8,5
1,20,293,18,5,13
1,20,294,17,3,14
1,20,295,8,11,-3
1,20,296,23,8,15
1,20,297,20,11,9
1,20,298,25,15,10
1,20,299,20,6,14
1,21,0,13,11,2
1,21,1,9,3,6
1,21,2,16,13,3
1,21,3,10,4,6
1,21,4,20,7,13
1,21,5,7,7,0
1,21,6,5,8,-3
1,21,7,10,6,4
1,21,8,9,14,-5
1,21,9,17,4,13
1,21,10,24,6,18
1,21,11,8,10,-2
1,21,12,9,3,6
1,21,13,5,8,-3
1,21,14,27,18,9
1,21,15,8,2,6
1,21,16,18,3,15
1,21,17,26,15,11
1,21,18,21,6,15
1,21,19,5,4,1
1,21,20,24,13,11
1,21,21,11,12,-1
1,21,22,35,12,23
1,21,23,26,8,18
1,21,24,11,8,3
1,21,25,16,12,4
1,21,26,28,10,18
1,21,27,16,9,7
1,21,28,5,5,0
1,21,29,18,8,10
1,21,30,21,10,11
1,21,31,7,4,3
1,21,32,11,5,6
1,21,33,21,9,12
1,21,34,26,5,21
1,21,35,20,15,5
1,21,36,26,10,16
1,21,37,27,14,13
1,21,38,15,3,12
1,21,39,14,4,10
1,21,40,24,5,19
1,21,41,22,10,12
1,21,42,18,14,4
1,21,43,3,8,-5
1,21,44,16,14,2
1,21,45,11,2,9
1,21,46,22,10,12
1,21,47,9,16,-7
1,21,48,16,1,15
1,21,49,17,12,5
1,21,50,15,8,7
1,21,51,16,12,4
1,21,52,13,3,10
1,21,53,20,25,-5
1,21,54,11,8,3
1,21,55,7,10,-3
1,21,56,14,13,1
1,21,57,8,13,-5
1,21,58,2,10,-8
1,21,59,22,14,8
1,21,60,11,12,-1
1,21,61,20,5,15
1,21,62,21,15,6
1,21,63,24,15,9
1,21,64,9,8,1
1,21,65,14,12,2
1,21,66,6,4,2
1,21,67,16,6,10
1,21,68,20,3,17
1,21,69,13,6,7
1,21,70,12,10,2
1,21,71,25,21,4
1,21,72,17,11,6
1,21,73,20,11,9
1,21,74,15,12,3
1,21,75,15,6,9
1,21,76,17,3,14
1,21,77,12,9,3
1,21,78,46,13,33
1,21,79,15,10,5
1,21,80,18,8,10
1,21,81,12,3,9
1,21,82,8,9,-1
1,21,83,32,6,26
1,21,84,12,10,2
1,21,85,31,17,14
1,21,86,12,3,9
1,21,87,18,8,10
1,21,88,1,6,-5
1,21,89,13,20,-7
1,21,90,20,12,8
1,21,91,7,5,2
1,21,92,31,12,19
1,21,93,8,8,0
1,21,94,16,7,9
1,21,95,15,9,6
1,21,96,5,11,-6
1,21,97,23,11,12
1,21,98,21,9,12
1,21,99,18,10,8
1,21,100,12,6,6
1,21,101,19,9,10
1,21,102,9,6,3
1,21,103,19,23,-4
1,21,104,20,5,15
1,21,105,23,9,14
1,21,106,8,2,6
1,21,107,9,5,4
1,21,108,15,14,1
1,21,109,15,2,13
1,21,110,10,8,2
1,21,111,10,5,5
1,21,112,9,11,-2
1,21,113,19,5,14
1,21,114,18,9,9
1,21,115,17,10,7
1,21,116,17,10,7
1,21,117,17,5,12
1,21,118,27,6,21
1,21,119,26,16,10
1,21,120,12,5,7
1,21,121,13,13,0
1,21,122,12,4,8
1,21,123,17,10,7
1,21,124,17,1,16
1,21,125,15,15,0
1,21,126,8,6,2
1,21,127,17,8,9
1,21,128,13,9,4
1,21,129,10,7,3
1,21,130,9,9,0
1,21,131,18,8,10
1,21,132,26,14,12
1,21,133,18,4,14
1,21,134,17,9,8
1,21,135,18,5,13
1,21,136,23,14,9
1,21,137,26,6,20
1,21,138,16,4,12
1,21,139,12,6,6
1,21,140,17,13,4
1,21,141,11,6,5
1,21,142,12,11,1
1,21,143,17,10,7
1,21,144,6,6,0
1,21,145,13,16,-3
1,21,146,20,14,6
1,21,147,12,8,4
1,21,148,14,3,11
1,21,149,19,11,8
1,21,150,18,4,14
1,21,151,22,11,11
1,21,152,15,6,9
1,21,153,11,8,3
1,21,154,23,9,14
1,21,155,11,11,0
1,21,156,8,7,1
1,21,157,3,6,-3
1,21,158,14,7,7
1,21,159,22,10,12
1,21,160,17,7,10
1,21,161,14,0,14
1,21,162,7,4,3
1,21,163,33,16,17
1,21,164,20,5,15
1,21,165,5,5,0
1,21,166,32,16,16
1,21,167,10,5,5
1,21,168,20,14,6
1,21,169,20,4,16
1,21,170,23,15,8
1,21,171,23,7,16
1,21,172,17,12,5
1,21,173,22,9,13
1,21,174,14,6,8
1,21,175,10,17,-7
1,21,176,23,11,12
1,21,177,22,9,13
1,21,178,7,3,4
1,21,179,17,23,-6
1,21,180,8,5,3
1,21,181,20,8,12
1,21,182,13,7,6
1,21,183,9,9,0
1,21,184,33,7,26
1,21,185,18,12,6
1,21,186,16,5,11
1,21,187,15,8,7
1,21,188,13,7,6
1,21,189,17,12,5
1,21,190,13,14,-1
1,21,191,13,4,9
1,21,192,3,3,0
1,21,193,7,3,4
1,21,194,8,8,0
1,21,195,22,19,3
1,21,196,9,11,-2
1,21,197,24,6,18
1,21,198,21,21,0
1,21,199,12,7,5
1,21,200,15,12,3
1,21,201,19,4,15
1,21,202,9,12,-3
1,21,203,17,17,0
1,21,204,9,5,4
1,21,205,33,15,18
1,21,206,22,10,12
1,21,207,9,9,0
1,21,208,12,18,-6
1,21,209,15,6,9
1,21,210,11,12,-1
1,21,211,19,14,5
1,21,212,11,18,-7
1,21,213,17,13,4
1,21,214,19,6,13
1,21,215,21,14,7
1,21,216,12,1,11
1,21,217,18,12,6
1,21,218,18,15,3
1,21,219,11,9,2
1,21,220,13,5,8
1,21,221,7,7,0
1,21,222,12,7,5
1,21,223,28,17,11
1,21,224,15,6,9
1,21,225,6,13,-7
1,21,226,13,3,10
1,21,227,16,7,9
1,21,228,15,11,4
1,21,229,22,11,11
1,21,230,19,6,13
1,21,231,27,18,9
1,21,232,15,12,3
1,21,233,10,4,6
1,21,234,27,15,12
1,21,235,23,11,12
1,21,236,23,11,12
1,21,237,19,5,14
1,21,238,12,8,4
1,21,239,22,15,7
1,21,240,4,6,-2
1,21,241,11,2,9
1,21,242,17,18,-1
1,21,243,17,7,10
1,21,244,18,9,9
1,21,245,7,2,5
1,21,246,18,6,12
1,21,247,6,9,-3
1,21,248,22,11,11
1,21,249,36,10,26
1,21,250,10,9,1
1,21,251,12,7,5
1,21,252,12,12,0
1,21,253,10,4,6
1,21,254,16,2,14
1,21,255,18,5,13
1,21,256,22,13,9
1,21,257,22,10,12
1,21,258,15,9,6
1,21,259,19,7,12
1,21,260,12,13,-1
1,21,261,16,8,8
1,21,262,16,12,4
1,21,263,6,7,-1
1,21,264,12,7,5
1,21,265,19,8,11
1,21,266,15,2,13
1,21,267,11,4,7
1,21,268,8,7,1
1,21,269,10,11,-1
1,21,270,16,8,8
1,21,271,15,3,12
1,21,272,14,6,8
1,21,273,22,16,6
1,21,274,17,12,5
1,21,275,17,4,13
1,21,276,8,3,5
1,21,277,21,17,4
1,21,278,30,10,20
1,21,279,22,11,11
1,21,280,11,2,9
1,21,281,23,10,13
1,21,282,15,11,4
1,21,283,12,4,8
1,21,284,25,20,5
1,21,285,19,14,5
1,21,286,11,5,6
1,21,287,9,11,-2
1,21,288,15,9,6
1,21,289,17,9,8
1,21,290,6,4,2
1,21,291,10,8,2
1,21,292,18,12,6
1,21,293,21,7,14
1,21,294,33,11,22
1,21,295,17,4,13
1,21,296,15,9,6
1,21,297,11,14,-3
1,21,298,15,12,3
1,21,299,11,5,6
1,22,0,6,4,2
1,22,1,26,5,21
1,22,2,18,9,9
1,22,3,23,16,7
1,22,4,15,3,12
1,22,5,19,16,3
1,22,6,29,18,11
1,22,7,8,8,0
1,22,8,15,5,10
1,22,9,27,10,17
1,22,10,16,11,5
1,22,11,19,9,10
1,22,12,19,11,8
1,22,13,14,9,5
1,22,14,15,16,-1
1,22,15,35,9,26
1,22,16,11,20,-9
1,22,17,17,11,6
1,22,18,17,5,12
1,22,19,16,11,5
1,22,20,15,14,1
1,22,21,14,8,6
1,22,22,15,6,9
1,22,23,6,10,-4
1,22,24,21,8,13
1,22,25,15,6,9
1,22,26,15,12,3
1,22,27,11,5,6
1,22,28,31,7,24
1,22,29,8,11,-3
1,22,30,13,7,6
1,22,31,3,2,1
1,22,32,15,13,2
1,22,33,9,10,-1
1,22,34,12,7,5
1,22,35,18,0,18
1,22,36,18,4,14
1,22,37,13,12,1
1,22,38,23,3,20
1,22,39,12,13,-1
1,22,40,11,7,4
1,22,41,11,5,6
1,22,42,15,7,8
1,22,43,12,8,4
1,22,44,11,4,7
1,22,45,7,5,2
1,22,46,12,8,4
1,22,47,23,4,19
1,22,48,17,9,8
1,22,49,6,8,-2
1,22,50,18,14,4
1,22,51,11,8,3
1,22,52,22,7,15
1,22,53,10,6,4
1,22,54,29,11,18
1,22,55,7,5,2
1,22,56,12,9,3
1,22,57,11,10,1
1,22,58,9,8,1
1,22,59,12,7,5
1,22,60,23,13,10
1,22,61,33,8,25
1,22,62,13,12,1
1,22,63,14,13,1
1,22,64,8,4,4
1,22,65,12,5,7
1,22,66,9,4,5
1,22,67,13,8,5
1,22,68,29,16,13
1,22,69,20,11,9
1,22,70,7,12,-5
1,22,71,10,17,-7
1,22,72,18,15,3
1,22,73,18,12,6
1,22,74,13,5,8
1,22,75,16,10,6
1,22,76,19,7,12
1,22,77,6,3,3
1,22,78,15,13,2
1,22,79,15,10,5
1,22,80,24,17,7
1,22,81,20,11,9
1,22,82,13,11,2
1,22,83,23,6,17
1,22,84,34,9,25
1,22,85,16,14,2
1,22,86,10,6,4
1,22,87,12,11,1
1,22,88,9,5,4
1,22,89,24,12,12
1,22,90,11,5,6
1,22,91,23,6,17
1,22,92,13,11,2
1,22,93,14,8,6
1,22,94,17,5,12
1,22,95,12,14,-2
1,22,96,9,3,6
1,22,97,9,4,5
1,22,98,32,8,24
1,22,99,10,6,4
1,22,100,6,6,0
1,22,101,10,9,1
1,22,102,28,7,21
1,22,103,12,2,10
1,22,104,16,5,11
1,22,105,11,10,1
1,22,106,14,20,-6
1,22,107,13,3,10
1,22,108,13,6,7
1,22,109,10,6,4
1,22,110,23,9,14
1,22,111,18,14,4
1,22,112,5,12,-7
1,22,113,11,11,0
1,22,114,13,8,5
1,22,115,11,7,4
1,22,116,13,7,6
1,22,117,11,5,6
1,22,118,25,17,8
1,22,119,9,3,6
1,22,120,22,4,18
1,22,121,20,6,14
1,22,122,13,5,8
1,22,123,11,12,-1
1,22,124,20,6,14
1,22,125,13,5,8
1,22,126,22,4,18
1,22,127,14,6,8
1,22,128,20,10,10
1,22,129,21,6,15
1,22,130,25,21,4
1,22,131,33,12,21
1,22,132,16,8,8
1,22,133,12,8,4
1,22,134,10,4,6
1,22,135,13,6,7
1,22,136,24,16,8
1,22,137,24,19,5
1,22,138,23,7,16
1,22,139,8,3,5
1,22,140,20,9,11
1,22,141,15,4,11
1,22,142,12,12,0
1,22,143,14,5,9
1,22,144,12,8,4
1,22,145,20,11,9
1,22,146,12,10,2
1,22,147,15,14,1
1,22,148,15,14,1
1,22,149,18,6,12
1,22,150,13,4,9
1,22,151,9,4,5
1,22,152,14,9,5
1,22,153,13,10,3
1,22,154,28,21,7
1,22,155,16,2,14
1,22,156,9,4,5
1,22,157,14,17,-3
1,22,158,14,10,4
1,22,159,8,7,1
1,22,160,7,12,-5
1,22,161,19,10,9
1,22,162,18,13,5
1,22,163,18,12,6
1,22,164,7,5,2
1,22,165,11,8,3
1,22,166,22,6,16
1,22,167,12,4,8
1,22,168,14,12,2
1,22,169,14,14,0
1,22,170,20,12,8
1,22,171,13,22,-9
1,22,172,13,8,5
1,22,173,13,15,-2
1,22,174,18,12,6
1,22,175,18,17,1
1,22,176,30,19,11
1,22,177,12,12,0
1,22,178,20,6,14
1,22,179,26,11,15
1,22,180,8,13,-5
1,22,181,15,4,11
1,22,182,13,22,-9
1,22,183,21,19,2
1,22,184,15,4,11
1,22,185,20,10,10
1,22,186,12,4,8
1,22,187,18,9,9
1,22,188,21,9,12
1,22,189,11,7,4
1,22,190,23,7,16
1,22,191,7,8,-1
1,22,192,13,20,-7
1,22,193,17,13,4
1,22,194,17,3,14
1,22,195,27,14,13
1,22,196,4,5,-1
1,22,197,4,10,-6
1,22,198,24,9,15
1,22,199,20,12,8
1,22,200,6,3,3
1,22,201,24,19,5
1,22,202,23,12,11
1,22,203,10,14,-4
1,22,204,14,10,4
1,22,205,11,8,3
1,22,206,8,6,2
1,22,207,22,13,9
1,22,208,9,10,-1
1,22,209,21,13,8
1,22,210,10,16,-6
1,22,211,16,16,0
1,22,212,19,2,17
1,22,213,7,6,1
1,22,214,17,7,10
1,22,215,15,12,3
1,22,216,10,7,3
1,22,217,5,3,2
1,22,218,12,10,2
1,22,219,25,8,17
1,22,220,13,12,1
1,22,221,16,13,3
1,22,222,11,4,7
1,22,223,15,9,6
1,22,224,13,2,11
1,22,225,20,14,6
1,22,226,11,7,4
1,22,227,4,4,0
1,22,228,8,10,-2
1,22,229,16,18,-2
1,22,230,15,13,2
1,22,231,13,3,10
1,22,232,6,7,-1
1,22,233,6,5,1
1,22,234,12,10,2
1,22,235,11,10,1
1,22,236,21,10,11
1,22,237,10,9,1
1,22,238,14,17,-3
1,22,239,15,6,9
1,22,240,11,3,8
1,22,241,25,17,8
1,22,242,16,4,12
1,22,243,17,12,5
1,22,244,24,13,11
1,22,245,20,11,9
1,22,246,18,7,11
1,22,247,15,9,6
1,22,248,19,13,6
1,22,249,7,5,2
1,22,250,16,7,9
1,22,251,13,8,5
1,22,252,13,7,6
1,22,253,18,10,8
1,22,254,9,10,-1
1,22,255,8,6,2
1,22,256,26,9,17
1,22,257,13,10,3
1,22,258,30,14,16
1,22,259,10,8,2
1,22,260,15,11,4
1,22,261,1,7,-6
1,22,262,15,10,5
1,22,263,14,5,9
1,22,264,10,5,5
1,22,265,21,6,15
1,22,266,14,10,4
1,22,267,27,10,17
1,22,268,13,11,2
1,22,269,15,4,11
1,22,270,19,12,7
1,22,271,13,9,4
1,22,272,16,5,11
1,22,273,20,9,11
1,22,274,24,16,8
1,22,275,20,9,11
1,22,276,5,5,0
1,22,277,19,8,11
1,22,278,13,9,4
1,22,279,5,2,3
1,22,280,13,14,-1
1,22,281,17,13,4
1,22,282,13,14,-1
1,22,283,21,8,13
1,22,284,15,9,6
1,22,285,23,17,6
1,22,286,9,10,-1
1,22,287,24,11,13
1,22,288,24,17,7
1,22,289,14,17,-3
1,22,290,21,20,1
1,22,291,3,5,-2
1,22,292,4,7,-3
1,22,293,7,8,-1
1,22,294,10,6,4
1,22,295,22,6,16
1,22,296,24,9,15
1,22,297,15,9,6
1,22,298,18,10,8
1,22,299,23,11,12
1,23,0,18,14,4
1,23,1,17,7,10
1,23,2,20,6,14
1,23,3,9,6,3
1,23,4,2,2,0
1,23,5,14,12,2
1,23,6,20,9,11
1,23,7,11,9,2
1,23,8,10,6,4
1,23,9,17,11,6
1,23,10,18,19,-1
1,23,11,7,9,-2
1,23,12,18,8,10
1,23,13,23,9,14
1,23,14,13,0,13
1,23,15,9,3,6
1,23,16,13,11,2
1,23,17,25,8,17
1,23,18,13,10,3
1,23,19,10,3,7
1,23,20,21,11,10
1,23,21,22,9,13
1,23,22,14,6,8
1,23,23,20,8,12
1,23,24,3,3,0
1,23,25,7,2,5
1,23,26,16,2,14
1,23,27,17,13,4
1,23,28,8,8,0
1,23,29,31,6,25
1,23,30,10,5,5
1,23,31,17,13,4
1,23,32,15,8,7
1,23,33,10,4,6
1,23,34,12,11,1
1,23,35,13,7,6
1,23,36,10,9,1
1,23,37,13,13,0
1,23,38,21,6,15
1,23,39,11,9,2
1,23,40,9,1,8
1,23,41,13,14,-1
1,23,42,23,9,14
1,23,43,8,5,3
1,23,44,21,7,14
1,23,45,20,20,0
1,23,46,22,11,11
1,23,47,19,5,14
1,23,48,21,13,8
1,23,49,10,7,3
1,23,50,19,18,1
1,23,51,17,15,2
1,23,52,23,15,8
1,23,53,7,8,-1
1,23,54,16,17,-1
1,23,55,28,6,22
1,23,56,12,5,7
1,23,57,15,7,8
1,23,58,9,4,5
1,23,59,13,6,7
1,23,60,17,4,13
1,23,61,14,9,5
1,23,62,12,6,6
1,23,63,11,6,5
1,23,64,12,7,5
1,23,65,13,4,9
1,23,66,23,14,9
1,23,67,14,20,-6
1,23,68,19,7,12
1,23,69,26,6,20
1,23,70,12,12,0
1,23,71,9,9,0
1,23,72,17,6,11
1,23,73,13,6,7
1,23,74,14,14,0
1,23,75,19,2,17
1,23,76,23,8,15
1,23,77,13,2,11
1,23,78,14,7,7
1,23,79,11,6,5
1,23,80,16,6,10
1,23,81,9,5,4
1,23,82,8,7,1
1,23,83,22,10,12
1,23,84,17,9,8
1,23,85,11,7,4
1,23,86,22,2,20
1,23,87,16,9,7
1,23,88,19,11,8
1,23,89,10,12,-2
1,23,90,12,12,0
1,23,91,28,11,17
1,23,92,9,9,0
1,23,93,23,8,15
1,23,94,24,10,14
1,23,95,8,2,6
1,23,96,13,4,9
1,23,97,9,4,5
1,23,98,16,3,13
1,23,99,13,9,4
1,23,100,17,15,2
1,23,101,9,10,-1
1,23,102,13,5,8
1,23,103,19,9,10
1,23,104,31,23,8
1,23,105,16,8,8
1,23,106,15,4,11
1,23,107,22,16,6
1,23,108,26,8,18
1,23,109,16,2,14
1,23,110,29,2,27
1,23,111,9,4,5
1,23,112,8,9,-1
1,23,113,18,9,9
1,23,114,26,3,23
1,23,115,9,6,3
1,23,116,24,4,20
1,23,117,5,1,4
1,23,118,19,19,0
1,23,119,13,7,6
1,23,120,19,9,10
1,23,121,22,16,6
1,23,122,7,7,0
1,23,123,9,7,2
1,23,124,14,4,10
1,23,125,11,3,8
1,23,126,16,9,7
1,23,127,17,4,13
1,23,128,6,8,-2
1,23,129,28,12,16
1,23,130,31,5,26
1,23,131,21,8,13
1,23,132,24,11,13
1,23,133,23,11,12
1,23,134,13,9,4
1,23,135,16,17,-1
1,23,136,13,13,0
1,23,137,24,11,13
1,23,138,14,3,11
1,23,139,8,15,-7
1,23,140,25,11,14
1,23,141,12,4,8
1,23,142,26,4,22
1,23,143,17,8,9
1,23,144,9,1,8
1,23,145,12,5,7
1,23,146,15,5,10
1,23,147,11,12,-1
1,23,148,26,7,19
1,23,149,13,5,8
1,23,150,20,3,17
1,23,151,12,21,-9
1,23,152,34,7,27
1,23,153,10,4,6
1,23,154,13,12,1
1,23,155,6,0,6
1,23,156,21,5,16
1,23,157,32,6,26
1,23,158,9,6,3
1,23,159,11,9,2
1,23,160,10,8,2
1,23,161,14,6,8
1,23,162,33,10,23
1,23,163,11,14,-3
1,23,164,20,4,16
1,23,165,14,7,7
1,23,166,14,10,4
1,23,167,19,9,10
1,23,168,12,5,7
1,23,169,12,7,5
1,23,170,24,3,21
1,23,171,10,8,2
1,23,172,13,7,6
1,23,173,6,6,0
1,23,174,12,4,8
1,23,175,8,6,2
1,23,176,8,6,2
1,23,177,5,6,-1
1,23,178,8,9,-1
1,23,179,13,7,6
1,23,180,10,14,-4
1,23,181,13,13,0
1,23,182,30,8,22
1,23,183,14,12,2
1,23,184,28,14,14
1,23,185,9,16,-7
1,23,186,18,7,11
1,23,187,32,8,24
1,23,188,21,13,8
1,23,189,8,13,-5
1,23,190,17,8,9
1,23,191,13,8,5
1,23,192,12,13,-1
1,23,193,25,8,17
1,23,194,13,18,-5
1,23,195,7,10,-3
1,23,196,13,11,2
1,23,197,17,10,7
1,23,198,17,8,9
1,23,199,21,13,8
1,23,200,14,4,10
1,23,201,22,8,14
1,23,202,9,4,5
1,23,203,8,2,6
1,23,204,27,16,11
1,23,205,5,2,3
1,23,206,14,7,7
1,23,207,15,7,8
1,23,208,17,6,11
1,23,209,16,7,9
1,23,210,25,13,12
1,23,211,17,6,11
1,23,212,16,7,9
1,23,213,19,6,13
1,23,214,14,5,9
1,23,215,12,13,-1
1,23,216,16,5,11
1,23,217,5,7,-2
1,23,218,16,10,6
1,23,219,10,7,3
1,23,220,6,11,-5
1,23,221,25,10,15
1,23,222,22,10,12
1,23,223,11,8,3
1,23,224,22,4,18
1,23,225,14,5,9
1,23,226,12,13,-1
1,23,227,13,12,1
1,23,228,13,4,9
1,23,229,21,8,13
1,23,230,18,10,8
1,23,231,18,16,2
1,23,232,13,11,2
1,23,233,25,16,9
1,23,234,25,9,16
1,23,235,20,9,11
1,23,236,21,6,15
1,23,237,18,10,8
1,23,238,11,13,-2
1,23,239,9,13,-4
1,23,240,15,4,11
1,23,241,18,10,8
1,23,242,12,6,6
1,23,243,17,10,7
1,23,244,22,10,12
1,23,245,16,6,10
1,23,246,4,9,-5
1,23,247,12,10,2
1,23,248,15,14,1
1,23,249,17,12,5
1,23,250,17,8,9
1,23,251,16,13,3
1,23,252,19,9,10
1,23,253,14,1,13
1,23,254,12,5,7
1,23,255,12,10,2
1,23,256,19,12,7
1,23,257,8,6,2
1,23,258,24,15,9
1,23,259,14,15,-1
1,23,260,26,21,5
1,23,261,14,13,1
1,23,262,9,10,-1
1,23,263,22,8,14
1,23,264,15,8,7
1,23,265,7,11,-4
1,23,266,8,6,2
1,23,267,8,14,-6
1,23,268,16,13,3
1,23,269,17,15,2
1,23,270,11,5,6
1,23,271,26,14,12
1,23,272,8,6,2
1,23,273,20,14,6
1,23,274,8,6,2
1,23,275,16,15,1
1,23,276,17,8,9
1,23,277,15,1,14
1,23,278,18,15,3
1,23,279,13,3,10
1,23,280,12,7,5
1,23,281,3,10,-7
1,23,282,4,8,-4
1,23,283,14,5,9
1,23,284,14,10,4
1,23,285,13,6,7
1,23,286,12,15,-3
1,23,287,7,5,2
1,23,288,19,8,11
1,23,289,12,16,-4
1,23,290,15,6,9
1,23,291,19,8,11
1,23,292,15,9,6
1,23,293,9,9,0
1,23,294,17,10,7
1,23,295,12,8,4
1,23,296,7,7,0
1,23,297,17,8,9
1,23,298,18,21,-3
1,23,299,13,10,3
1,24,0,14,6,8
1,24,1,14,9,5
1,24,2,12,2,10
1,24,3,15,8,7
1,24,4,32,20,12
1,24,5,14,9,5
1,24,6,18,7,11
1,24,7,8,13,-5
1,24,8,15,11,4
1,24,9,9,4,5
1,24,10,19,7,12
1,24,11,12,6,6
1,24,12,17,6,11
1,24,13,14,7,7
1,24,14,24,3,21
1,24,15,19,8,11
1,24,16,11,15,-4
1,24,17,23,6,17
1,24,18,17,13,4
1,24,19,8,3,5
1,24,20,23,13,10
1,24,21,16,7,9
1,24,22,15,9,6
1,24,23,17,4,13
1,24,24,13,10,3
1,24,25,22,4,18
1,24,26,11,9,2
1,24,27,18,9,9
1,24,28,18,11,7
1,24,29,15,4,11
1,24,30,7,10,-3
1,24,31,14,6,8
1,24,32,6,6,0
1,24,33,14,10,4
1,24,34,17,12,5
1,24,35,15,4,11
1,24,36,26,12,14
1,24,37,12,8,4
1,24,38,14,3,11
1,24,39,12,5,7
1,24,40,15,15,0
1,24,41,26,8,18
1,24,42,8,5,3
1,24,43,32,8,24
1,24,44,20,17,3
1,24,45,7,6,1
1,24,46,10,6,4
1,24,47,11,4,7
1,24,48,21,11,10
1,24,49,10,7,3
1,24,50,16,12,4
1,24,51,38,22,16
1,24,52,22,12,10
1,24,53,32,23,9
1,24,54,35,13,22
1,24,55,17,5,12
1,24,56,17,11,6
1,24,57,11,3,8
1,24,58,14,10,4
1,24,59,22,16,6
1,24,60,15,8,7
1,24,61,19,5,14
1,24,62,15,4,11
1,24,63,17,9,8
1,24,64,19,8,11
1,24,65,9,4,5
1,24,66,22,9,13
1,24,67,20,9,11
1,24,68,9,8,1
1,24,69,18,11,7
1,24,70,9,9,0
1,24,71,13,5,8
1,24,72,11,11,0
1,24,73,20,5,15
1,24,74,17,9,8
1,24,75,23,5,18
1,24,76,5,1,4
1,24,77,5,10,-5
1,24,78,20,9,11
1,24,79,35,8,27
1,24,80,22,10,12
1,24,81,14,4,10
1,24,82,14,1,13
1,24,83,19,9,10
1,24,84,13,9,4
1,24,85,8,7,1
1,24,86,11,1,10
1,24,87,29,0,29
1,24,88,5,1,4
1,24,89,18,17,1
1,24,90,14,10,4
1,24,91,17,14,3
1,24,92,20,9,11
1,24,93,20,7,13
1,24,94,22,11,11
1,24,95,16,7,9
1,24,96,6,6,0
1,24,97,18,12,6
1,24,98,19,6,13
1,24,99,35,11,24
1,24,100,15,15,0
1,24,101,7,4,3
1,24,102,29,3,26
1,24,103,26,5,21
1,24,104,17,6,11
1,24,105,13,7,6
1,24,106,3,4,-1
1,24,107,10,8,2
1,24,108,25,8,17
1,24,109,10,4,6
1,24,110,20,14,6
1,24,111,15,10,5
1,24,112,10,4,6
1,24,113,21,7,14
1,24,114,14,15,-1
1,24,115,21,12,9
1,24,116,14,13,1
1,24,117,9,7,2
1,24,118,15,8,7
1,24,119,10,7,3
1,24,120,15,5,10
1,24,121,5,11,-6
1,24,122,11,8,3
1,24,123,17,11,6
1,24,124,26,8,18
1,24,125,21,8,13
1,24,126,13,6,7
1,24,127,18,10,8
1,24,128,12,14,-2
1,24,129,29,5,24
1,24,130,21,4,17
1,24,131,25,5,20
1,24,132,11,6,5
1,24,133,22,16,6
1,24,134,14,8,6
1,24,135,14,13,1
1,24,136,13,7,6
1,24,137,20,9,11
1,24,138,13,12,1
1,24,139,24,3,21
1,24,140,28,15,13
1,24,141,14,5,9
1,24,142,14,3,11
1,24,143,11,3,8
1,24,144,7,10,-3
1,24,145,9,17,-8
1,24,146,29,3,26
1,24,147,12,8,4
1,24,148,18,7,11
1,24,149,15,0,15
1,24,150,16,6,10
1,24,151,17,9,8
1,24,152,16,6,10
1,24,153,7,2,5
1,24,154,28,10,18
1,24,155,10,7,3
1,24,156,8,6,2
1,24,157,5,9,-4
1,24,158,13,3,10
1,24,159,21,9,12
1,24,160,18,11,7
1,24,161,19,11,8
1,24,162,14,15,-1
1,24,163,26,12,14
1,24,164,19,7,12
1,24,165,6,12,-6
1,24,166,4,1,3
1,24,167,6,6,0
1,24,168,8,5,3
1,24,169,27,5,22
1,24,170,21,6,15
1,24,171,15,13,2
1,24,172,15,5,10
1,24,173,21,7,14
1,24,174,14,8,6
1,24,175,26,10,16
1,24,176,9,13,-4
1,24,177,16,18,-2
1,24,178,9,9,0
1,24,179,9,12,-3
1,24,180,24,8,16
1,24,181,6,4,2
1,24,182,32,10,22
1,24,183,17,7,10
1,24,184,27,12,15
1,24,185,9,7,2
1,24,186,15,6,9
1,24,187,18,9,9
1,24,188,9,12,-3
1,24,189,25,10,15
1,24,190,15,4,11
1,24,191,20,10,10
1,24,192,16,9,7
1,24,193,21,7,14
1,24,194,12,2,10
1,24,195,12,6,6
1,24,196,25,10,15
1,24,197,19,10,9
1,24,198,22,7,15
1,24,199,17,13,4
1,24,200,9,1,8
1,24,201,10,17,-7
1,24,202,7,7,0
1,24,203,21,14,7
1,24,204,26,22,4
1,24,205,26,18,8
1,24,206,16,11,5
1,24,207,18,3,15
1,24,208,9,12,-3
1,24,209,18,7,11
1,24,210,7,7,0
1,24,211,14,13,1
1,24,212,18,6,12
1,24,213,7,4,3
1,24,214,31,12,19
1,24,215,13,10,3
1,24,216,11,3,8
1,24,217,9,8,1
1,24,218,10,7,3
1,24,219,28,9,19
1,24,220,11,1,10
1,24,221,11,2,9
1,24,222,18,13,5
1,24,223,22,10,12
1,24,224,14,5,9
1,24,225,19,10,9
1,24,226,6,7,-1
1,24,227,20,8,12
1,24,228,6,4,2
1,24,229,13,8,5
1,24,230,17,5,12
1,24,231,25,20,5
1,24,232,16,5,11
1,24,233,18,12,6
1,24,234,17,11,6
1,24,235,21,14,7
1,24,236,10,2,8
1,24,237,14,13,1
1,24,238,24,7,17
1,24,239,30,14,16
1,24,240,15,8,7
1,24,241,7,11,-4
1,24,242,29,6,23
1,24,243,9,9,0
1,24,244,13,7,6
1,24,245,13,2,11
1,24,246,9,11,-2
1,24,247,12,3,9
1,24,248,16,9,7
1,24,249,12,4,8
1,24,250,10,11,-1
1,24,251,9,10,-1
1,24,252,27,8,19
1,24,253,21,9,12
1,24,254,25,5,20
1,24,255,15,8,7
1,24,256,13,7,6
1,24,257,16,12,4
1,24,258,15,8,7
1,24,259,11,6,5
1,24,260,9,2,7
1,24,261,7,9,-2
1,24,262,19,7,12
1,24,263,20,13,7
1,24,264,17,6,11
1,24,265,22,8,14
1,24,266,19,6,13
1,24,267,11,7,4
1,24,268,18,18,0
1,24,269,30,16,14
1,24,270,33,8,25
1,24,271,27,14,13
1,24,272,10,9,1
1,24,273,16,10,6
1,24,274,23,14,9
1,24,275,29,8,21
1,24,276,5,3,2
1,24,277,8,9,-1
1,24,278,7,4,3
1,24,279,28,10,18
1,24,280,10,3,7
1,24,281,20,5,15
1,24,282,13,7,6
1,24,283,9,4,5
1,24,284,16,7,9
1,24,285,9,8,1
1,24,286,17,11,6
1,24,287,15,4,11
1,24,288,18,11,7
1,24,289,10,6,4
1,24,290,13,9,4
1,24,291,27,17,10
1,24,292,9,14,-5
1,24,293,12,8,4
1,24,294,9,5,4
1,24,295,8,5,3
1,24,296,17,12,5
1,24,297,16,9,7
1,24,298,9,2,7
1,24,299,13,13,0
1,25,0,12,8,4
1,25,1,13,13,0
1,25,2,16,9,7
1,25,3,19,8,11
1,25,4,22,7,15
1,25,5,20,10,10
1,25,6,14,9,5
1,25,7,23,13,10
1,25,8,20,4,16
1,25,9,7,2,5
1,25,10,19,11,8
1,25,11,19,6,13
1,25,12,17,10,7
1,25,13,15,6,9
1,25,14,21,5,16
1,25,15,8,3,5
1,25,16,10,4,6
1,25,17,24,10,14
1,25,18,7,7,0
1,25,19,19,14,5
1,25,20,29,10,19
1,25,21,10,10,0
1,25,22,18,11,7
1,25,23,13,5,8
1,25,24,21,11,10
1,25,25,18,14,4
1,25,26,6,1,5
1,25,27,29,5,24
1,25,28,26,4,22
1,25,29,18,11,7
1,25,30,27,7,20
1,25,31,19,10,9
1,25,32,5,4,1
1,25,33,14,6,8
1,25,34,7,1,6
1,25,35,13,6,7
1,25,36,9,12,-3
1,25,37,16,19,-3
1,25,38,20,9,11
1,25,39,13,14,-1
1,25,40,10,8,2
1,25,41,18,9,9
1,25,42,19,9,10
1,25,43,12,5,7
1,25,44,5,6,-1
1,25,45,19,7,12
1,25,46,21,4,17
1,25,47,11,9,2
1,25,48,7,2,5
1,25,49,13,5,8
1,25,50,19,5,14
1,25,51,10,2,8
1,25,52,14,12,2
1,25,53,22,9,13
1,25,54,12,6,6
1,25,55,20,20,0
1,25,56,14,4,10
1,25,57,22,11,11
1,25,58,13,1,12
1,25,59,8,6,2
1,25,60,18,13,5
1,25,61,9,7,2
1,25,62,22,9,13
1,25,63,13,6,7
1,25,64,43,10,33
1,25,65,21,4,17
1,25,66,17,5,12
1,25,67,22,5,17
1,25,68,10,1,9
1,25,69,19,13,6
1,25,70,23,18,5
1,25,71,18,19,-1
1,25,72,27,17,10
1,25,73,25,7,18
1,25,74,24,5,19
1,25,75,13,11,2
1,25,76,7,3,4
1,25,77,21,14,7
1,25,78,15,7,8
1,25,79,19,4,15
1,25,80,14,7,7
1,25,81,12,10,2
1,25,82,19,9,10
1,25,83,13,8,5
1,25,84,12,7,5
1,25,85,16,6,10
1,25,86,18,10,8
1,25,87,17,7,10
1,25,88,22,4,18
1,25,89,17,5,12
1,25,90,20,13,7
1,25,91,12,11,1
1,25,92,9,1,8
1,25,93,8,8,0
1,25,94,11,9,2
1,25,95,14,6,8
1,25,96,13,1,12
1,25,97,26,2,24
1,25,98,14,10,4
1,25,99,7,8,-1
1,25,100,18,1,17
1,25,101,10,9,1
1,25,102,11,13,-2
1,25,103,16,14,2
1,25,104,27,9,18
1,25,105,4,3,1
1,25,106,17,9,8
1,25,107,22,17,5
1,25,108,10,3,7
1,25,109,10,3,7
1,25,110,7,6,1
1,25,111,33,8,25
1,25,112,9,4,5
1,25,113,13,8,5
1,25,114,16,10,6
1,25,115,15,6,9
1,25,116,18,3,15
1,25,117,22,8,14
1,25,118,21,11,10
1,25,119,8,3,5
1,25,120,8,8,0
1,25,121,13,7,6
1,25,122,8,6,2
1,25,123,17,7,10
1,25,124,17,4,13
1,25,125,13,4,9
1,25,126,19,8,11
1,25,127,20,17,3
1,25,128,19,9,10
1,25,129,15,12,3
1,25,130,19,6,13
1,25,131,13,7,6
1,25,132,16,5,11
1,25,133,17,7,10
1,25,134,7,3,4
1,25,135,14,3,11
1,25,136,25,11,14
1,25,137,10,11,-1
1,25,138,20,9,11
1,25,139,20,11,9
1,25,140,9,9,0
1,25,141,14,7,7
1,25,142,11,14,-3
1,25,143,0,3,-3
1,25,144,10,1,9
1,25,145,27,6,21
1,25,146,11,10,1
1,25,147,13,5,8
1,25,148,21,20,1
1,25,149,20,5,15
1,25,150,11,2,9
1,25,151,7,4,3
1,25,152,19,14,5
1,25,153,15,9,6
1,25,154,21,10,11
1,25,155,32,3,29
1,25,156,9,10,-1
1,25,157,14,5,9
1,25,158,7,1,6
1,25,159,20,9,11
1,25,160,16,8,8
1,25,161,12,10,2
1,25,162,12,4,8
1,25,163,12,8,4
1,25,164,12,3,9
1,25,165,11,13,-2
1,25,166,14,5,9
1,25,167,21,9,12
1,25,168,21,8,13
1,25,169,16,11,5
1,25,170,11,4,7
1,25,171,17,7,10
1,25,172,22,10,12
1,25,173,19,8,11
1,25,174,13,10,3
1,25,175,19,10,9
1,25,176,12,13,-1
1,25,177,9,10,-1
1,25,178,17,16,1
1,25,179,19,11,8
1,25,180,18,6,12
1,25,181,20,16,4
1,25,182,30,15,15
1,25,183,32,11,21
1,25,184,16,2,14
1,25,185,6,5,1
1,25,186,12,8,4
1,25,187,13,8,5
1,25,188,23,7,16
1,25,189,21,12,9
1,25,190,12,13,-1
1,25,191,10,16,-6
1,25,192,11,2,9
1,25,193,13,6,7
1,25,194,23,11,12
1,25,195,8,6,2
1,25,196,24,15,9
1,25,197,15,10,5
1,25,198,14,10,4
1,25,199,22,14,8
1,25,200,17,6,11
1,25,201,7,2,5
1,25,202,12,8,4
1,25,203,22,4,18
1,25,204,29,13,16
1,25,205,8,3,5
1,25,206,16,8,8
1,25,207,6,6,0
1,25,208,17,6,11
1,25,209,15,7,8
1,25,210,20,2,18
1,25,211,19,8,11
1,25,212,21,11,10
1,25,213,13,9,4
1,25,214,24,8,16
1,25,215,12,4,8
1,25,216,26,8,18
1,25,217,20,2,18
1,25,218,23,14,9
1,25,219,26,7,19
1,25,220,22,7,15
1,25,221,23,8,15
1,25,222,24,15,9
1,25,223,9,4,5
1,25,224,16,4,12
1,25,225,24,5,19
1,25,226,18,10,8
1,25,227,21,9,12
1,25,228,19,2,17
1,25,229,11,5,6
1,25,230,26,8,18
1,25,231,13,2,11
1,25,232,18,1,17
1,25,233,23,7,16
1,25,234,22,6,16
1,25,235,7,2,5
1,25,236,16,9,7
1,25,237,8,1,7
1,25,238,19,7,12
1,25,239,15,7,8
1,25,240,18,10,8
1,25,241,20,4,16
1,25,242,11,7,4
1,25,243,11,8,3
1,25,244,18,2,16
1,25,245,23,8,15
1,25,246,8,7,1
1,25,247,13,11,2
1,25,248,13,6,7
1,25,249,16,7,9
1,25,250,8,9,-1
1,25,251,14,10,4
1,25,252,13,15,-2
1,25,253,8,3,5
1,25,254,21,7,14
1,25,255,18,14,4
1,25,256,6,11,-5
1,25,257,17,4,13
1,25,258,16,4,12
1,25,259,26,10,16
1,25,260,2,2,0
1,25,261,18,6,12
1,25,262,37,8,29
1,25,263,14,6,8
1,25,264,28,22,6
1,25,265,18,11,7
1,25,266,22,6,16
1,25,267,9,8,1
1,25,268,24,5,19
1,25,269,18,13,5
1,25,270,30,13,17
1,25,271,12,5,7
1,25,272,17,5,12
1,25,273,16,4,12
1,25,274,21,13,8
1,25,275,11,3,8
1,25,276,22,8,14
1,25,277,8,5,3
1,25,278,12,8,4
1,25,279,19,12,7
1,25,280,6,8,-2
1,25,281,19,2,17
1,25,282,14,10,4
1,25,283,22,6,16
1,25,284,13,0,13
1,25,285,21,6,15
1,25,286,15,4,11
1,25,287,19,7,12
1,25,288,20,7,13
1,25,289,19,4,15
1,25,290,20,11,9
1,25,291,15,6,9
1,25,292,18,15,3
1,25,293,34,9,25
1,25,294,16,5,11
1,25,295,7,8,-1
1,25,296,26,3,23
1,25,297,19,14,5
1,25,298,12,5,7
1,25,299,12,7,5
1,26,0,18,7,11
1,26,1,18,0,18
1,26,2,16,7,9
1,26,3,8,5,3
1,26,4,11,4,7
1,26,5,16,8,8
1,26,6,16,5,11
1,26,7,19,4,15
1,26,8,16,6,10
1,26,9,16,6,10
1,26,10,8,5,3
1,26,11,19,5,14
1,26,12,20,2,18
1,26,13,19,6,13
1,26,14,22,3,19
1,26,15,23,10,13
1,26,16,24,19,5
1,26,17,21,7,14
1,26,18,18,8,10
1,26,19,19,13,6
1,26,20,20,12,8
1,26,21,26,10,16
1,26,22,24,17,7
1,26,23,14,0,14
1,26,24,11,3,8
1,26,25,18,8,10
1,26,26,28,19,9
1,26,27,23,14,9
1,26,28,15,7,8
1,26,29,28,15,13
1,26,30,11,5,6
1,26,31,20,15,5
1,26,32,28,8,20
1,26,33,15,7,8
1,26,34,11,4,7
1,26,35,11,6,5
1,26,36,7,11,-4
1,26,37,14,8,6
1,26,38,15,8,7
1,26,39,12,3,9
1,26,40,16,16,0
1,26,41,6,4,2
1,26,42,27,9,18
1,26,43,23,8,15
1,26,44,10,11,-1
1,26,45,11,6,5
1,26,46,25,5,20
1,26,47,26,14,12
1,26,48,25,7,18
1,26,49,24,7,17
1,26,50,11,4,7
1,26,51,8,3,5
1,26,52,18,7,11
1,26,53,20,8,12
1,26,54,14,5,9
1,26,55,13,8,5
1,26,56,21,7,14
1,26,57,25,17,8
1,26,58,21,19,2
1,26,59,17,9,8
1,26,60,12,9,3
1,26,61,26,11,15
1,26,62,5,1,4
1,26,63,18,5,13
1,26,64,21,12,9
1,26,65,9,6,3
1,26,66,24,3,21
1,26,67,4,4,0
1,26,68,22,15,7
1,26,69,11,12,-1
1,26,70,16,6,10
1,26,71,16,1,15
1,26,72,20,13,7
1,26,73,20,14,6
1,26,74,12,10,2
1,26,75,14,2,12
1,26,76,11,7,4
1,26,77,17,10,7
1,26,78,25,5,20
1,26,79,21,5,16
1,26,80,18,15,3
1,26,81,26,10,16
1,26,82,22,7,15
1,26,83,30,12,18
1,26,84,14,15,-1
1,26,85,16,11,5
1,26,86,17,1,16
1,26,87,23,2,21
1,26,88,17,12,5
1,26,89,15,10,5
1,26,90,13,4,9
1,26,91,16,10,6
1,26,92,42,8,34
1,26,93,24,14,10
1,26,94,11,21,-10
1,26,95,14,13,1
1,26,96,12,7,5
1,26,97,11,9,2
1,26,98,6,5,1
1,26,99,13,14,-1
1,26,100,29,10,19
1,26,101,13,12,1
1,26,102,13,9,4
1,26,103,16,15,1
1,26,104,10,6,4
1,26,105,5,2,3
1,26,106,18,9,9
1,26,107,15,5,10
1,26,108,13,11,2
1,26,109,27,8,19
1,26,110,16,13,3
1,26,111,16,5,11
1,26,112,16,6,10
1,26,113,20,19,1
1,26,114,14,7,7
1,26,115,9,2,7
1,26,116,17,3,14
1,26,117,9,12,-3
1,26,118,22,5,17
1,26,119,14,9,5
1,26,120,17,5,12
1,26,121,9,7,2
1,26,122,13,6,7
1,26,123,31,9,22
1,26,124,22,7,15
1,26,125,5,4,1
1,26,126,35,16,19
1,26,127,14,7,7
1,26,128,7,8,-1
1,26,129,23,7,16
1,26,130,15,6,9
1,26,131,25,4,21
1,26,132,19,6,13
1,26,133,27,17,10
1,26,134,12,7,5
1,26,135,11,2,9
1,26,136,14,8,6
1,26,137,5,4,1
1,26,138,23,14,9
1,26,139,16,9,7
1,26,140,16,6,10
1,26,141,9,4,5
1,26,142,15,8,7
1,26,143,25,5,20
1,26,144,16,6,10
1,26,145,13,14,-1
1,26,146,9,9,0
1,26,147,25,7,18
1,26,148,30,13,17
1,26,149,15,3,12
1,26,150,13,9,4
1,26,151,12,11,1
1,26,152,24,8,16
1,26,153,22,7,15
1,26,154,10,8,2
1,26,155,13,5,8
1,26,156,8,8,0
1,26,157,9,7,2
1,26,158,18,8,10
1,26,159,23,6,17
1,26,160,22,14,8
1,26,161,11,5,6
1,26,162,19,9,10
1,26,163,22,12,10
1,26,164,6,3,3
1,26,165,21,7,14
1,26,166,9,10,-1
1,26,167,35,13,22
1,26,168,13,4,9
1,26,169,8,14,-6
1,26,170,11,0,11
1,26,171,19,5,14
1,26,172,3,3,0
1,26,173,18,3,15
1,26,174,22,7,15
1,26,175,15,11,4
1,26,176,27,13,14
1,26,177,11,6,5
1,26,178,9,6,3
1,26,179,18,10,8
1,26,180,29,9,20
1,26,181,21,3,18
1,26,182,14,5,9
1,26,183,15,7,8
1,26,184,21,7,14
1,26,185,18,4,14
1,26,186,16,7,9
1,26,187,23,4,19
1,26,188,20,11,9
1,26,189,12,6,6
1,26,190,14,8,6
1,26,191,9,6,3
1,26,192,10,3,7
1,26,193,20,5,15
1,26,194,13,9,4
1,26,195,15,11,4
1,26,196,13,6,7
1,26,197,15,1,14
1,26,198,27,5,22
1,26,199,8,4,4
1,26,200,13,6,7
1,26,201,23,2,21
1,26,202,14,6,8
1,26,203,11,11,0
1,26,204,17,9,8
1,26,205,10,8,2
1,26,206,14,7,7
1,26,207,16,8,8
1,26,208,12,6,6
1,26,209,20,6,14
1,26,210,19,10,9
1,26,211,26,10,16
1,26,212,12,13,-1
1,26,213,13,5,8
1,26,214,19,21,-2
1,26,215,23,7,16
1,26,216,20,11,9
1,26,217,3,2,1
1,26,218,14,6,8
1,26,219,21,11,10
1,26,220,22,5,17
1,26,221,3,5,-2
1,26,222,23,13,10
1,26,223,4,5,-1
1,26,224,29,8,21
1,26,225,18,7,11
1,26,226,13,6,7
1,26,227,18,18,0
1,26,228,4,4,0
1,26,229,18,7,11
1,26,230,9,12,-3
1,26,231,17,12,5
1,26,232,18,10,8
1,26,233,25,8,17
1,26,234,9,3,6
1,26,235,10,7,3
1,26,236,19,5,14
1,26,237,18,3,15
1,26,238,15,9,6
1,26,239,15,6,9
1,26,240,14,7,7
1,26,241,13,7,6
1,26,242,18,3,15
1,26,243,14,5,9
1,26,244,15,17,-2
1,26,245,12,7,5
1,26,246,18,7,11
1,26,247,29,17,12
1,26,248,21,10,11
1,26,249,29,6,23
1,26,250,27,9,18
1,26,251,21,7,14
1,26,252,12,1,11
1,26,253,22,9,13
1,26,254,18,16,2
1,26,255,17,18,-1
1,26,256,19,13,6
1,26,257,26,6,20
1,26,258,16,4,12
1,26,259,14,5,9
1,26,260,12,6,6
1,26,261,14,6,8
1,26,262,18,15,3
1,26,263,18,6,12
1,26,264,11,17,-6
1,26,265,23,10,13
1,26,266,15,10,5
1,26,267,15,15,0
1,26,268,12,4,8
1,26,269,6,6,0
1,26,270,18,6,12
1,26,271,20,10,10
1,26,272,9,7,2
1,26,273,16,9,7
1,26,274,12,6,6
1,26,275,13,7,6
1,26,276,20,9,11
1,26,277,22,13,9
1,26,278,18,7,11
1,26,279,18,3,15
1,26,280,9,10,-1
1,26,281,16,13,3
1,26,282,13,10,3
1,26,283,21,4,17
1,26,284,32,10,22
1,26,285,27,8,19
1,26,286,17,17,0
1,26,287,22,9,13
1,26,288,14,16,-2
1,26,289,10,1,9
1,26,290,21,9,12
1,26,291,15,6,9
1,26,292,10,2,8
1,26,293,9,6,3
1,26,294,7,7,0
1,26,295,20,7,13
1,26,296,23,8,15
1,26,297,17,11,6
1,26,298,14,2,12
1,26,299,23,5,18
1,27,0,30,9,21
1,27,1,12,4,8
1,27,2,16,14,2
1,27,3,22,16,6
1,27,4,5,7,-2
1,27,5,7,10,-3
1,27,6,25,15,10
1,27,7,11,10,1
1,27,8,13,1,12
1,27,9,10,6,4
1,27,10,12,2,10
1,27,11,35,12,23
1,27,12,17,8,9
1,27,13,15,8,7
1,27,14,12,6,6
1,27,15,19,9,10
1,27,16,22,1,21
1,27,17,14,12,2
1,27,18,20,5,15
1,27,19,16,7,9
1,27,20,21,2,19
1,27,21,17,4,13
1,27,22,9,3,6
1,27,23,29,2,27
1,27,24,19,2,17
1,27,25,17,7,10
1,27,26,13,3,10
1,27,27,13,4,9
1,27,28,18,2,16
1,27,29,20,6,14
1,27,30,12,20,-8
1,27,31,30,8,22
1,27,32,10,6,4
1,27,33,9,12,-3
1,27,34,10,8,2
1,27,35,14,9,5
1,27,36,14,5,9
1,27,37,25,6,19
1,27,38,16,17,-1
1,27,39,13,4,9
1,27,40,13,6,7
1,27,41,25,15,10
1,27,42,11,7,4
1,27,43,29,10,19
1,27,44,19,7,12
1,27,45,19,9,10
1,27,46,15,9,6
1,27,47,18,9,9
1,27,48,21,12,9
1,27,49,3,1,2
1,27,50,9,4,5
1,27,51,10,11,-1
1,27,52,15,13,2
1,27,53,18,17,1
1,27,54,9,2,7
1,27,55,12,12,0
1,27,56,8,2,6
1,27,57,14,3,11
1,27,58,10,7,3
1,27,59,18,5,13
1,27,60,26,4,22
1,27,61,5,12,-7
1,27,62,28,8,20
1,27,63,10,5,5
1,27,64,23,9,14
1,27,65,17,17,0
1,27,66,13,3,10
1,27,67,14,3,11
1,27,68,11,10,1
1,27,69,19,12,7
1,27,70,19,10,9
1,27,71,23,16,7
1,27,72,25,12,13
1,27,73,27,7,20
1,27,74,17,9,8
1,27,75,13,1,12
1,27,76,15,8,7
1,27,77,10,5,5
1,27,78,22,8,14
1,27,79,11,6,5
1,27,80,5,5,0
1,27,81,13,15,-2
1,27,82,19,4,15
1,27,83,26,12,14
1,27,84,12,8,4
1,27,85,24,19,5
1,27,86,29,15,14
1,27,87,9,8,1
1,27,88,13,4,9
1,27,89,15,10,5
1,27,90,6,6,0
1,27,91,14,14,0
1,27,92,20,4,16
1,27,93,21,9,12
1,27,94,6,4,2
1,27,95,11,4,7
1,27,96,13,6,7
1,27,97,13,10,3
1,27,98,21,13,8
1,27,99,15,5,10
1,27,100,12,5,7
1,27,101,24,5,19
1,27,102,9,4,5
1,27,103,28,11,17
1,27,104,12,7,5
1,27,105,25,5,20
1,27,106,6,1,5
1,27,107,8,7,1
1,27,108,11,2,9
1,27,109,18,17,1
1,27,110,15,7,8
1,27,111,25,14,11
1,27,112,23,21,2
1,27,113,12,8,4
1,27,114,9,7,2
1,27,115,5,1,4
1,27,116,11,7,4
1,27,117,14,15,-1
1,27,118,20,6,14
1,27,119,17,12,5
1,27,120,16,7,9
1,27,121,9,4,5
1,27,122,21,12,9
1,27,123,12,12,0
1,27,124,18,7,11
1,27,125,12,7,5
1,27,126,8,5,3
1,27,127,11,8,3
1,27,128,18,7,11
1,27,129,9,10,-1
1,27,130,21,6,15
1,27,131,38,9,29
1,27,132,15,1,14
1,27,133,10,8,2
1,27,134,24,15,9
1,27,135,21,12,9
1,27,136,16,10,6
1,27,137,8,7,1
1,27,138,19,8,11
1,27,139,21,4,17
1,27,140,19,12,7
1,27,141,15,4,11
1,27,142,16,11,5
1,27,143,24,9,15
1,27,144,10,5,5
1,27,145,13,8,5
1,27,146,30,9,21
1,27,147,17,6,11
1,27,148,12,7,5
1,27,149,6,7,-1
1,27,150,13,5,8
1,27,151,14,9,5
1,27,152,21,11,10
1,27,153,16,2,14
1,27,154,17,10,7
1,27,155,17,10,7
1,27,156,7,8,-1
1,27,157,11,5,6
1,27,158,23,8,15
1,27,159,14,3,11
1,27,160,20,6,14
1,27,161,32,16,16
1,27,162,26,4,22
1,27,163,20,6,14
1,27,164,33,12,21
1,27,165,28,12,16
1,27,166,14,5,9
1,27,167,11,17,-6
1,27,168,16,13,3
1,27,169,18,4,14
1,27,170,24,7,17
1,27,171,23,9,14
1,27,172,30,15,15
1,27,173,20,7,13
1,27,174,29,20,9
1,27,175,8,8,0
1,27,176,27,13,14
1,27,177,18,11,7
1,27,178,16,11,5
1,27,179,14,5,9
1,27,180,8,11,-3
1,27,181,22,4,18
1,27,182,40,15,25
1,27,183,18,18,0
1,27,184,21,7,14
1,27,185,19,11,8
1,27,186,19,3,16
1,27,187,6,9,-3
1,27,188,19,7,12
1,27,189,8,13,-5
1,27,190,16,19,-3
1,27,191,13,12,1
1,27,192,33,9,24
1,27,193,17,5,12
1,27,194,4,7,-3
1,27,195,7,9,-2
1,27,196,22,18,4
1,27,197,21,16,5
1,27,198,11,4,7
1,27,199,14,11,3
1,27,200,15,5,10
1,27,201,17,2,15
1,27,202,22,11,11
1,27,203,14,9,5
1,27,204,11,15,-4
1,27,205,12,15,-3
1,27,206,20,12,8
1,27,207,19,3,16
1,27,208,6,10,-4
1,27,209,23,9,14
1,27,210,30,4,26
1,27,211,8,12,-4
1,27,212,19,6,13
1,27,213,19,12,7
1,27,214,13,5,8
1,27,215,25,11,14
1,27,216,25,9,16
1,27,217,15,3,12
1,27,218,13,5,8
1,27,219,22,5,17
1,27,220,13,9,4
1,27,221,17,2,15
1,27,222,20,10,10
1,27,223,17,10,7
1,27,224,15,15,0
1,27,225,14,8,6
1,27,226,3,4,-1
1,27,227,31,13,18
1,27,228,12,5,7
1,27,229,19,3,16
1,27,230,21,15,6
1,27,231,27,7,20
1,27,232,9,1,8
1,27,233,19,11,8
1,27,234,16,14,2
1,27,235,13,7,6
1,27,236,2,11,-9
1,27,237,19,19,0
1,27,238,9,4,5
1,27,239,24,10,14
1,27,240,7,12,-5
1,27,241,6,11,-5
1,27,242,18,4,14
1,27,243,22,5,17
1,27,244,29,11,18
1,27,245,13,6,7
1,27,246,11,3,8
1,27,247,10,2,8
1,27,248,43,5,38
1,27,249,19,9,10
1,27,250,13,7,6
1,27,251,16,10,6
1,27,252,15,6,9
1,27,253,11,4,7
1,27,254,13,11,2
1,27,255,10,12,-2
1,27,256,7,12,-5
1,27,257,31,7,24
1,27,258,11,11,0
1,27,259,13,5,8
1,27,260,10,6,4
1,27,261,4,11,-7
1,27,262,26,6,20
1,27,263,19,4,15
1,27,264,24,8,16
1,27,265,19,15,4
1,27,266,21,11,10
1,27,267,17,9,8
1,27,268,14,8,6
1,27,269,23,10,13
1,27,270,10,11,-1
1,27,271,11,4,7
1,27,272,29,7,22
1,27,273,25,11,14
1,27,274,16,9,7
1,27,275,14,9,5
1,27,276,20,5,15
1,27,277,31,4,27
1,27,278,18,0,18
1,27,279,12,6,6
1,27,280,8,3,5
1,27,281,18,10,8
1,27,282,22,5,17
1,27,283,20,11,9
1,27,284,13,6,7
1,27,285,32,5,27
1,27,286,16,7,9
1,27,287,23,5,18
1,27,288,14,6,8
1,27,289,26,13,13
1,27,290,24,9,15
1,27,291,12,9,3
1,27,292,16,9,7
1,27,293,23,18,5
1,27,294,15,14,1
1,27,295,18,9,9
1,27,296,15,4,11
1,27,297,9,1,8
1,27,298,18,6,12
1,27,299,32,9,23
1,28,0,16,12,4
1,28,1,12,6,6
1,28,2,20,1,19
1,28,3,26,10,16
1,28,4,31,2,29
1,28,5,15,4,11
1,28,6,17,9,8
1,28,7,19,15,4
1,28,8,19,3,16
1,28,9,7,4,3
1,28,10,11,1,10
1,28,11,23,7,16
1,28,12,21,10,11
1,28,13,27,13,14
1,28,14,13,7,6
1,28,15,28,15,13
1,28,16,18,6,12
1,28,17,9,11,-2
1,28,18,44,9,35
1,28,19,9,5,4
1,28,20,19,6,13
1,28,21,33,10,23
1,28,22,18,11,7
1,28,23,20,0,20
1,28,24,17,12,5
1,28,25,23,8,15
1,28,26,20,10,10
1,28,27,10,4,6
1,28,28,20,7,13
1,28,29,6,1,5
1,28,30,28,3,25
1,28,31,18,2,16
1,28,32,16,8,8
1,28,33,6,5,1
1,28,34,14,5,9
1,28,35,36,18,18
1,28,36,16,6,10
1,28,37,20,10,10
1,28,38,11,5,6
1,28,39,23,5,18
1,28,40,22,18,4
1,28,41,17,12,5
1,28,42,22,8,14
1,28,43,16,5,11
1,28,44,29,14,15
1,28,45,16,3,13
1,28,46,22,5,17
1,28,47,3,1,2
1,28,48,12,13,-1
1,28,49,33,17,16
1,28,50,12,2,10
1,28,51,18,12,6
1,28,52,5,5,0
1,28,53,12,8,4
1,28,54,14,8,6
1,28,55,6,1,5
1,28,56,6,4,2
1,28,57,10,8,2
1,28,58,17,7,10
1,28,59,9,4,5
1,28,60,6,11,-5
1,28,61,16,13,3
1,28,62,14,3,11
1,28,63,12,7,5
1,28,64,16,3,13
1,28,65,13,8,5
1,28,66,19,6,13
1,28,67,20,15,5
1,28,68,13,4,9
1,28,69,18,8,10
1,28,70,13,11,2
1,28,71,14,14,0
1,28,72,17,12,5
1,28,73,9,6,3
1,28,74,14,11,3
1,28,75,26,14,12
1,28,76,21,5,16
1,28,77,28,16,12
1,28,78,22,10,12
1,28,79,28,7,21
1,28,80,22,9,13
1,28,81,27,9,18
1,28,82,16,9,7
1,28,83,17,12,5
1,28,84,11,3,8
1,28,85,21,9,12
1,28,86,17,1,16
1,28,87,9,12,-3
1,28,88,20,10,10
1,28,89,14,9,5
1,28,90,16,4,12
1,28,91,8,7,1
1,28,92,8,2,6
1,28,93,16,9,7
1,28,94,7,4,3
1,28,95,28,9,19
1,28,96,25,3,22
1,28,97,18,5,13
1,28,98,33,13,20
1,28,99,19,6,13
1,28,100,35,7,28
1,28,101,33,17,16
1,28,102,25,6,19
1,28,103,20,8,12
1,28,104,9,0,9
1,28,105,9,2,7
1,28,106,27,10,17
1,28,107,20,3,17
1,28,108,12,6,6
1,28,109,10,2,8
1,28,110,13,8,5
1,28,111,17,8,9
1,28,112,10,4,6
1,28,113,17,10,7
1,28,114,21,12,9
1,28,115,18,6,12
1,28,116,20,9,11
1,28,117,17,18,-1
1,28,118,10,6,4
1,28,119,9,11,-2
1,28,120,20,11,9
1,28,121,12,6,6
1,28,122,14,2,12
1,28,123,23,8,15
1,28,124,14,9,5
1,28,125,12,13,-1
1,28,126,10,16,-6
1,28,127,15,6,9
1,28,128,26,13,13
1,28,129,22,3,19
1,28,130,11,2,9
1,28,131,38,11,27
1,28,132,15,6,9
1,28,133,15,8,7
1,28,134,9,0,9
1,28,135,7,7,0
1,28,136,12,6,6
1,28,137,12,6,6
1,28,138,14,7,7
1,28,139,27,5,22
1,28,140,9,9,0
1,28,141,21,11,10
1,28,142,17,12,5
1,28,143,11,8,3
1,28,144,20,2,18
1,28,145,10,3,7
1,28,146,10,4,6
1,28,147,15,3,12
1,28,148,30,5,25
1,28,149,20,11,9
1,28,150,28,13,15
1,28,151,14,4,10
1,28,152,25,4,21
1,28,153,15,3,12
1,28,154,13,5,8
1,28,155,14,3,11
1,28,156,11,1,10
1,28,157,23,5,18
1,28,158,24,12,12
1,28,159,18,4,14
1,28,160,22,4,18
1,28,161,7,1,6
1,28,162,12,8,4
1,28,163,12,3,9
1,28,164,20,4,16
1,28,165,29,9,20
1,28,166,23,5,18
1,28,167,18,8,10
1,28,168,21,12,9
1,28,169,22,3,19
1,28,170,9,11,-2
1,28,171,7,6,1
1,28,172,9,11,-2
1,28,173,27,11,16
1,28,174,11,7,4
1,28,175,22,9,13
1,28,176,30,12,18
1,28,177,7,2,5
1,28,178,30,17,13
1,28,179,15,12,3
1,28,180,16,8,8
1,28,181,38,4,34
1,28,182,21,5,16
1,28,183,7,4,3
1,28,184,19,12,7
1,28,185,11,5,6
1,28,186,8,7,1
1,28,187,10,2,8
1,28,188,12,5,7
1,28,189,32,18,14
1,28,190,15,10,5
1,28,191,28,7,21
1,28,192,20,4,16
1,28,193,12,1,11
1,28,194,5,4,1
1,28,195,7,4,3
1,28,196,18,2,16
1,28,197,44,9,35
1,28,198,10,4,6
1,28,199,6,8,-2
1,28,200,11,5,6
1,28,201,24,5,19
1,28,202,18,8,10
1,28,203,22,8,14
1,28,204,29,4,25
1,28,205,27,7,20
1,28,206,24,10,14
1,28,207,13,4,9
1,28,208,13,5,8
1,28,209,3,2,1
1,28,210,18,1,17
1,28,211,21,0,21
1,28,212,24,9,15
1,28,213,21,9,12
1,28,214,7,5,2
1,28,215,11,6,5
1,28,216,12,8,4
1,28,217,14,7,7
1,28,218,15,6,9
1,28,219,17,6,11
1,28,220,15,7,8
1,28,221,30,7,23
1,28,222,18,13,5
1,28,223,13,6,7
1,28,224,15,3,12
1,28,225,22,10,12
1,28,226,19,11,8
1,28,227,4,1,3
1,28,228,25,7,18
1,28,229,10,5,5
1,28,230,22,18,4
1,28,231,11,4,7
1,28,232,28,8,20
1,28,233,4,1,3
1,28,234,12,9,3
1,28,235,17,4,13
1,28,236,20,2,18
1,28,237,19,9,10
1,28,238,12,1,11
1,28,239,10,11,-1
1,28,240,15,6,9
1,28,241,14,21,-7
1,28,242,23,9,14
1,28,243,23,9,14
1,28,244,12,11,1
1,28,245,13,7,6
1,28,246,23,8,15
1,28,247,17,15,2
1,28,248,15,12,3
1,28,249,9,4,5
1,28,250,14,3,11
1,28,251,24,9,15
1,28,252,16,4,12
1,28,253,17,17,0
1,28,254,15,6,9
1,28,255,6,10,-4
1,28,256,11,3,8
1,28,257,17,7,10
1,28,258,26,7,19
1,28,259,17,12,5
1,28,260,13,14,-1
1,28,261,30,9,21
1,28,262,23,13,10
1,28,263,9,12,-3
1,28,264,35,19,16
1,28,265,24,5,19
1,28,266,19,9,10
1,28,267,24,7,17
1,28,268,19,9,10
1,28,269,11,5,6
1,28,270,22,5,17
1,28,271,21,9,12
1,28,272,13,1,12
1,28,273,25,12,13
1,28,274,23,8,15
1,28,275,13,5,8
1,28,276,15,7,8
1,28,277,18,5,13
1,28,278,16,8,8
1,28,279,27,10,17
1,28,280,18,5,13
1,28,281,10,3,7
1,28,282,19,22,-3
1,28,283,10,1,9
1,28,284,19,2,17
1,28,285,21,11,10
1,28,286,19,9,10
1,28,287,19,7,12
1,28,288,22,5,17
1,28,289,18,16,2
1,28,290,15,9,6
1,28,291,25,6,19
1,28,292,13,6,7
1,28,293,29,6,23
1,28,294,17,11,6
1,28,295,4,5,-1
1,28,296,11,5,6
1,28,297,14,13,1
1,28,298,14,6,8
1,28,299,16,7,9
1,29,0,14,6,8
1,29,1,17,7,10
1,29,2,27,13,14
1,29,3,12,2,10
1,29,4,15,14,1
1,29,5,20,7,13
1,29,6,20,5,15
1,29,7,9,5,4
1,29,8,13,2,11
1,29,9,29,13,16
1,29,10,13,5,8
1,29,11,17,5,12
1,29,12,21,7,14
1,29,13,11,7,4
1,29,14,23,5,18
1,29,15,13,5,8
1,29,16,19,8,11
1,29,17,11,3,8
1,29,18,12,4,8
1,29,19,7,8,-1
1,29,20,17,5,12
1,29,21,12,1,11
1,29,22,10,5,5
1,29,23,28,7,21
1,29,24,12,8,4
1,29,25,21,8,13
1,29,26,6,2,4
1,29,27,28,10,18
1,29,28,16,3,13
1,29,29,12,25,-13
1,29,30,12,16,-4
1,29,31,16,8,8
1,29,32,19,10,9
1,29,33,9,5,4
1,29,34,15,5,10
1,29,35,44,12,32
1,29,36,23,10,13
1,29,37,12,5,7
1,29,38,28,9,19
1,29,39,24,8,16
1,29,40,10,8,2
1,29,41,16,14,2
1,29,42,10,1,9
1,29,43,18,9,9
1,29,44,15,1,14
1,29,45,9,7,2
1,29,46,20,9,11
1,29,47,7,4,3
1,29,48,17,11,6
1,29,49,14,3,11
1,29,50,13,4,9
1,29,51,11,6,5
1,29,52,23,14,9
1,29,53,14,2,12
1,29,54,14,6,8
1,29,55,29,16,13
1,29,56,27,7,20
1,29,57,16,10,6
1,29,58,13,5,8
1,29,59,21,8,13
1,29,60,17,8,9
1,29,61,14,7,7
1,29,62,20,6,14
1,29,63,19,6,13
1,29,64,16,5,11
1,29,65,8,10,-2
1,29,66,10,7,3
1,29,67,31,10,21
1,29,68,11,2,9
1,29,69,14,4,10
1,29,70,5,1,4
1,29,71,16,10,6
1,29,72,29,9,20
1,29,73,7,9,-2
1,29,74,9,4,5
1,29,75,6,5,1
1,29,76,4,4,0
1,29,77,23,4,19
1,29,78,9,5,4
1,29,79,17,13,4
1,29,80,17,10,7
1,29,81,19,7,12
1,29,82,21,7,14
1,29,83,33,11,22
1,29,84,19,7,12
1,29,85,25,4,21
1,29,86,30,5,25
1,29,87,6,3,3
1,29,88,3,6,-3
1,29,89,7,5,2
1,29,90,20,9,11
1,29,91,6,2,4
1,29,92,7,7,0
1,29,93,21,7,14
1,29,94,18,14,4
1,29,95,9,12,-3
1,29,96,16,3,13
1,29,97,23,7,16
1,29,98,5,4,1
1,29,99,12,5,7
1,29,100,6,4,2
1,29,101,23,3,20
1,29,102,22,7,15
1,29,103,14,5,9
1,29,104,14,6,8
1,29,105,10,7,3
1,29,106,31,8,23
1,29,107,10,1,9
1,29,108,16,5,11
1,29,109,21,14,7
1,29,110,30,6,24
1,29,111,24,6,18
1,29,112,15,5,10
1,29,113,24,9,15
1,29,114,27,12,15
1,29,115,9,5,4
1,29,116,17,6,11
1,29,117,11,10,1
1,29,118,21,5,16
1,29,119,8,7,1
1,29,120,44,15,29
1,29,121,13,10,3
1,29,122,12,10,2
1,29,123,22,4,18
1,29,124,22,14,8
1,29,125,15,15,0
1,29,126,18,3,15
1,29,127,13,13,0
1,29,128,19,3,16
1,29,129,10,9,1
1,29,130,16,10,6
1,29,131,10,7,3
1,29,132,10,1,9
1,29,133,29,9,20
1,29,134,20,3,17
1,29,135,10,2,8
1,29,136,20,10,10
1,29,137,17,7,10
1,29,138,13,13,0
1,29,139,24,13,11
1,29,140,12,8,4
1,29,141,24,10,14
1,29,142,15,4,11
1,29,143,22,12,10
1,29,144,24,17,7
1,29,145,10,7,3
1,29,146,12,2,10
1,29,147,24,1,23
1,29,148,10,7,3
1,29,149,6,9,-3
1,29,150,19,4,15
1,29,151,34,7,27
1,29,152,19,7,12
1,29,153,21,5,16
1,29,154,15,11,4
1,29,155,14,3,11
1,29,156,16,2,14
1,29,157,1,0,1
1,29,158,19,10,9
1,29,159,18,9,9
1,29,160,22,17,5
1,29,161,23,6,17
1,29,162,12,12,0
1,29,163,23,6,17
1,29,164,26,9,17
1,29,165,15,7,8
1,29,166,24,9,15
1,29,167,23,5,18
1,29,168,22,7,15
1,29,169,10,2,8
1,29,170,15,3,12
1,29,171,25,9,16
1,29,172,4,4,0
1,29,173,37,2,35
1,29,174,21,10,11
1,29,175,16,4,12
1,29,176,22,3,19
1,29,177,20,7,13
1,29,178,20,3,17
1,29,179,21,15,6
1,29,180,9,1,8
1,29,181,8,11,-3
1,29,182,11,12,-1
1,29,183,22,11,11
1,29,184,21,12,9
1,29,185,25,9,16
1,29,186,9,7,2
1,29,187,20,12,8
1,29,188,19,4,15
1,29,189,21,8,13
1,29,190,28,8,20
1,29,191,17,6,11
1,29,192,17,15,2
1,29,193,12,4,8
1,29,194,30,1,29
1,29,195,29,23,6
1,29,196,36,18,18
1,29,197,8,1,7
1,29,198,19,4,15
1,29,199,19,13,6
1,29,200,14,5,9
1,29,201,28,14,14
1,29,202,22,16,6
1,29,203,27,3,24
1,29,204,14,3,11
1,29,205,19,7,12
1,29,206,20,8,12
1,29,207,30,5,25
1,29,208,18,5,13
1,29,209,17,5,12
1,29,210,21,2,19
1,29,211,18,8,10
1,29,212,13,15,-2
1,29,213,21,5,16
1,29,214,10,3,7
1,29,215,24,4,20
1,29,216,17,10,7
1,29,217,15,2,13
1,29,218,15,6,9
1,29,219,20,10,10
1,29,220,7,4,3
1,29,221,16,8,8
1,29,222,20,9,11
1,29,223,13,7,6
1,29,224,13,2,11
1,29,225,12,4,8
1,29,226,27,17,10
1,29,227,17,8,9
1,29,228,14,11,3
1,29,229,12,6,6
1,29,230,16,9,7
1,29,231,27,8,19
1,29,232,21,8,13
1,29,233,25,8,17
1,29,234,15,8,7
1,29,235,8,4,4
1,29,236,12,6,6
1,29,237,18,5,13
1,29,238,19,16,3
1,29,239,28,8,20
1,29,240,29,11,18
1,29,241,27,12,15
1,29,242,15,8,7
1,29,243,17,15,2
1,29,244,11,6,5
1,29,245,9,5,4
1,29,246,11,9,2
1,29,247,16,5,11
1,29,248,12,3,9
1,29,249,6,2,4
1,29,250,10,0,10
1,29,251,8,19,-11
1,29,252,13,10,3
1,29,253,27,15,12
1,29,254,27,9,18
1,29,255,22,6,16
1,29,256,20,7,13
1,29,257,25,5,20
1,29,258,18,6,12
1,29,259,29,15,14
1,29,260,12,12,0
1,29,261,19,7,12
1,29,262,14,1,13
1,29,263,19,11,8
1,29,264,25,26,-1
1,29,265,8,11,-3
1,29,266,18,0,18
1,29,267,12,6,6
1,29,268,25,12,13
1,29,269,23,16,7
1,29,270,15,4,11
1,29,271,9,6,3
1,29,272,14,10,4
1,29,273,18,5,13
1,29,274,25,5,20
1,29,275,14,5,9
1,29,276,20,14,6
1,29,277,9,14,-5
1,29,278,30,2,28
1,29,279,17,3,14
1,29,280,25,6,19
1,29,281,18,11,7
1,29,282,24,12,12
1,29,283,4,6,-2
1,29,284,12,5,7
1,29,285,8,6,2
1,29,286,18,12,6
1,29,287,13,5,8
1,29,288,8,7,1
1,29,289,18,11,7
1,29,290,14,7,7
1,29,291,14,9,5
1,29,292,12,8,4
1,29,293,10,5,5
1,29,294,24,5,19
1,29,295,13,7,6
1,29,296,15,19,-4
1,29,297,17,13,4
1,29,298,18,7,11
1,29,299,10,3,7
1,30,0,12,5,7
1,30,1,13,9,4
1,30,2,10,7,3
1,30,3,17,14,3
1,30,4,22,14,8
1,30,5,20,13,7
1,30,6,24,16,8
1,30,7,18,12,6
1,30,8,23,0,23
1,30,9,17,7,10
1,30,10,3,1,2
1,30,11,26,9,17
1,30,12,27,7,20
1,30,13,20,8,12
1,30,14,21,4,17
1,30,15,6,7,-1
1,30,16,9,11,-2
1,30,17,12,7,5
1,30,18,14,3,11
1,30,19,22,4,18
1,30,20,18,5,13
1,30,21,27,18,9
1,30,22,23,9,14
1,30,23,16,10,6
1,30,24,22,6,16
1,30,25,22,3,19
1,30,26,21,11,10
1,30,27,14,5,9
1,30,28,18,19,-1
1,30,29,24,14,10
1,30,30,23,12,11
1,30,31,19,6,13
1,30,32,19,7,12
1,30,33,24,6,18
1,30,34,14,1,13
1,30,35,5,3,2
1,30,36,9,7,2
1,30,37,31,22,9
1,30,38,15,3,12
1,30,39,13,15,-2
1,30,40,18,9,9
1,30,41,28,3,25
1,30,42,20,5,15
1,30,43,23,19,4
1,30,44,8,8,0
1,30,45,12,5,7
1,30,46,12,8,4
1,30,47,28,2,26
1,30,48,12,6,6
1,30,49,8,3,5
1,30,50,17,5,12
1,30,51,14,4,10
1,30,52,29,10,19
1,30,53,29,4,25
1,30,54,16,6,10
1,30,55,15,10,5
1,30,56,17,3,14
1,30,57,22,5,17
1,30,58,16,3,13
1,30,59,25,3,22
1,30,60,39,28,11
1,30,61,34,7,27
1,30,62,13,3,10
1,30,63,4,3,1
1,30,64,6,4,2
1,30,65,23,12,11
1,30,66,16,2,14
1,30,67,11,3,8
1,30,68,14,9,5
1,30,69,22,12,10
1,30,70,22,9,13
1,30,71,17,0,17
1,30,72,10,1,9
1,30,73,29,4,25
1,30,74,15,13,2
1,30,75,17,8,9
1,30,76,20,15,5
1,30,77,27,20,7
1,30,78,13,2,11
1,30,79,17,13,4
1,30,80,14,5,9
1,30,81,7,6,1
1,30,82,7,7,0
1,30,83,15,8,7
1,30,84,18,3,15
1,30,85,3,4,-1
1,30,86,16,6,10
1,30,87,22,11,11
1,30,88,28,4,24
1,30,89,12,3,9
1,30,90,13,5,8
1,30,91,25,7,18
1,30,92,13,6,7
1,30,93,14,5,9
1,30,94,18,6,12
1,30,95,15,10,5
1,30,96,18,11,7
1,30,97,18,1,17
1,30,98,20,6,14
1,30,99,7,6,1
1,30,100,12,0,12
1,30,101,17,3,14
1,30,102,14,6,8
1,30,103,22,6,16
1,30,104,14,8,6
1,30,105,9,7,2
1,30,106,13,5,8
1,30,107,18,18,0
1,30,108,9,2,7
1,30,109,24,2,22
1,30,110,6,11,-5
1,30,111,27,15,12
1,30,112,15,7,8
1,30,113,7,3,4
1,30,114,11,9,2
1,30,115,27,7,20
1,30,116,13,4,9
1,30,117,14,13,1
1,30,118,23,8,15
1,30,119,9,10,-1
1,30,120,32,9,23
1,30,121,15,8,7
1,30,122,18,6,12
1,30,123,8,4,4
1,30,124,14,2,12
1,30,125,22,8,14
1,30,126,10,4,6
1,30,127,12,11,1
1,30,128,11,6,5
1,30,129,18,6,12
1,30,130,29,9,20
1,30,131,22,5,17
1,30,132,16,3,13
1,30,133,16,10,6
1,30,134,11,2,9
1,30,135,18,5,13
1,30,136,9,10,-1
1,30,137,23,6,17
1,30,138,27,8,19
1,30,139,22,2,20
1,30,140,4,0,4
1,30,141,10,8,2
1,30,142,11,3,8
1,30,143,18,4,14
1,30,144,14,7,7
1,30,145,15,3,12
1,30,146,15,3,12
1,30,147,8,5,3
1,30,148,23,2,21
1,30,149,14,6,8
1,30,150,9,5,4
1,30,151,15,9,6
1,30,152,25,6,19
1,30,153,21,3,18
1,30,154,16,5,11
1,30,155,27,7,20
1,30,156,14,7,7
1,30,157,12,1,11
1,30,158,16,2,14
1,30,159,14,8,6
1,30,160,12,7,5
1,30,161,17,13,4
1,30,162,9,5,4
1,30,163,7,5,2
1,30,164,10,3,7
1,30,165,12,12,0
1,30,166,22,11,11
1,30,167,19,3,16
1,30,168,4,5,-1
1,30,169,32,4,28
1,30,170,16,11,5
1,30,171,17,3,14
1,30,172,19,4,15
1,30,173,15,10,5
1,30,174,24,9,15
1,30,175,16,2,14
1,30,176,15,11,4
1,30,177,22,5,17
1,30,178,31,15,16
1,30,179,13,10,3
1,30,180,16,5,11
1,30,181,12,1,11
1,30,182,16,11,5
1,30,183,9,1,8
1,30,184,14,5,9
1,30,185,9,6,3
1,30,186,12,7,5
1,30,187,18,8,10
1,30,188,12,4,8
1,30,189,27,7,20
1,30,190,22,5,17
1,30,191,19,2,17
1,30,192,18,2,16
1,30,193,9,4,5
1,30,194,17,3,14
1,30,195,15,8,7
1,30,196,30,12,18
1,30,197,12,6,6
1,30,198,11,5,6
1,30,199,13,15,-2
1,30,200,11,11,0
1,30,201,24,5,19
1,30,202,17,6,11
1,30,203,16,12,4
1,30,204,20,7,13
1,30,205,12,5,7
1,30,206,13,6,7
1,30,207,26,14,12
1,30,208,16,11,5
1,30,209,17,4,13
1,30,210,19,7,12
1,30,211,7,3,4
1,30,212,19,8,11
1,30,213,9,6,3
1,30,214,15,6,9
1,30,215,18,11,7
1,30,216,13,12,1
1,30,217,11,6,5
1,30,218,11,3,8
1,30,219,9,6,3
1,30,220,11,2,9
1,30,221,12,5,7
1,30,222,19,7,12
1,30,223,20,14,6
1,30,224,28,4,24
1,30,225,22,2,20
1,30,226,16,6,10
1,30,227,23,5,18
1,30,228,13,3,10
1,30,229,19,8,11
1,30,230,6,8,-2
1,30,231,17,6,11
1,30,232,5,10,-5
1,30,233,20,12,8
1,30,234,21,5,16
1,30,235,17,2,15
1,30,236,13,9,4
1,30,237,33,11,22
1,30,238,20,11,9
1,30,239,25,5,20
1,30,240,23,12,11
1,30,241,20,15,5
1,30,242,13,3,10
1,30,243,5,8,-3
1,30,244,16,6,10
1,30,245,8,11,-3
1,30,246,17,4,13
1,30,247,26,8,18
1,30,248,16,10,6
1,30,249,11,5,6
1,30,250,20,17,3
1,30,251,20,4,16
1,30,252,14,12,2
1,30,253,21,12,9
1,30,254,19,9,10
1,30,255,26,9,17
1,30,256,9,6,3
1,30,257,14,2,12
1,30,258,26,8,18
1,30,259,11,8,3
1,30,260,20,6,14
1,30,261,4,6,-2
1,30,262,14,16,-2
1,30,263,29,6,23
1,30,264,11,6,5
1,30,265,21,12,9
1,30,266,22,4,18
1,30,267,18,3,15
1,30,268,17,15,2
1,30,269,17,9,8
1,30,270,12,2,10
1,30,271,18,6,12
1,30,272,9,6,3
1,30,273,18,5,13
1,30,274,8,9,-1
1,30,275,12,6,6
1,30,276,24,4,20
1,30,277,9,6,3
1,30,278,11,3,8
1,30,279,31,20,11
1,30,280,11,6,5
1,30,281,23,9,14
1,30,282,21,10,11
1,30,283,15,3,12
1,30,284,17,16,1
1,30,285,30,1,29
1,30,286,23,11,12
1,30,287,13,7,6
1,30,288,7,4,3
1,30,289,6,7,-1
1,30,290,15,9,6
1,30,291,8,4,4
1,30,292,27,6,21
1,30,293,16,7,9
1,30,294,15,16,-1
1,30,295,7,6,1
1,30,296,12,6,6
1,30,297,26,3,23
1,30,298,19,18,1
1,30,299,27,2,25
2,1,0,7,8,-1
2,1,1,12,11,1
2,1,2,8,8,0
2,1,3,13,17,-4
2,1,4,7,11,-4
2,1,5,4,0,4
2,1,6,19,11,8
2,1,7,2,2,0
2,1,8,3,6,-3
2,1,9,16,6,10
2,1,10,0,1,-1
2,1,11,1,6,-5
2,1,12,6,3,3
2,1,13,3,8,-5
2,1,14,8,12,-4
2,1,15,4,8,-4
2,1,16,8,11,-3
2,1,17,2,4,-2
2,1,18,7,7,0
2,1,19,4,4,0
2,1,20,7,4,3
2,1,21,6,11,-5
2,1,22,8,3,5
2,1,23,6,2,4
2,1,24,5,1,4
2,1,25,16,12,4
2,1,26,7,10,-3
2,1,27,5,2,3
2,1,28,10,11,-1
2,1,29,2,2,0
2,1,30,5,7,-2
2,1,31,26,12,14
2,1,32,9,5,4
2,1,33,4,8,-4
2,1,34,8,2,6
2,1,35,14,5,9
2,1,36,17,8,9
2,1,37,2,4,-2
2,1,38,8,10,-2
2,1,39,6,9,-3
2,1,40,7,6,1
2,1,41,6,5,1
2,1,42,8,7,1
2,1,43,8,6,2
2,1,44,0,8,-8
2,1,45,5,10,-5
2,1,46,3,13,-10
2,1,47,6,18,-12
2,1,48,6,10,-4
2,1,49,7,6,1
2,1,50,6,4,2
2,1,51,8,8,0
2,1,52,0,2,-2
2,1,53,7,1,6
2,1,54,6,5,1
2,1,55,3,5,-2
2,1,56,7,11,-4
2,1,57,9,8,1
2,1,58,3,7,-4
2,1,59,1,0,1
2,1,60,8,8,0
2,1,61,7,6,1
2,1,62,3,4,-1
2,1,63,6,7,-1
2,1,64,8,2,6
2,1,65,9,7,2
2,1,66,5,1,4
2,1,67,7,15,-8
2,1,68,8,4,4
2,1,69,5,6,-1
2,1,70,2,5,-3
2,1,71,5,6,-1
2,1,72,0,3,-3
2,1,73,8,9,-1
2,1,74,1,2,-1
2,1,75,4,2,2
2,1,76,5,7,-2
2,1,77,7,8,-1
2,1,78,3,4,-1
2,1,79,3,2,1
2,1,80,8,13,-5
2,1,81,8,2,6
2,1,82,4,4,0
2,1,83,1,4,-3
2,1,84,5,3,2
2,1,85,4,4,0
2,1,86,1,0,1
2,1,87,4,16,-12
2,1,88,6,3,3
2,1,89,1,7,-6
2,1,90,0,1,-1
2,1,91,11,9,2
2,1,92,1,4,-3
2,1,93,7,6,1
2,1,94,9,6,3
2,1,95,3,6,-3
2,1,96,1,2,-1
2,1,97,9,7,2
2,1,98,1,4,-3
2,1,99,17,14,3
2,1,100,4,3,1
2,1,101,10,5,5
2,1,102,22,9,13
2,1,103,3,0,3
2,1,104,6,5,1
2,1,105,3,5,-2
2,1,106,18,16,2
2,1,107,8,7,1
2,1,108,4,14,-10
2,1,109,4,3,1
2,1,110,4,5,-1
2,1,111,2,4,-2
2,1,112,2,9,-7
2,1,113,8,6,2
2,1,114,24,9,15
2,1,115,9,15,-6
2,1,116,5,11,-6
2,1,117,7,3,4
2,1,118,9,4,5
2,1,119,1,2,-1
2,1,120,6,1,5
2,1,121,9,6,3
2,1,122,2,1,1
2,1,123,3,8,-5
2,1,124,5,8,-3
2,1,125,7,8,-1
2,1,126,5,1,4
2,1,127,2,3,-1
2,1,128,7,18,-11
2,1,129,1,5,-4
2,1,130,6,7,-1
2,1,131,5,5,0
2,1,132,20,3,17
2,1,133,7,7,0
2,1,134,3,3,0
2,1,135,11,13,-2
2,1,136,4,12,-8
2,1,137,6,11,-5
2,1,138,11,3,8
2,1,139,1,1,0
2,1,140,7,16,-9
2,1,141,3,1,2
2,1,142,0,2,-2
2,1,143,4,5,-1
2,1,144,1,4,-3
2,1,145,8,11,-3
2,1,146,4,3,1
2,1,147,5,9,-4
2,1,148,1,6,-5
2,1,149,9,8,1
2,1,150,7,5,2
2,1,151,8,11,-3
2,1,152,4,3,1
2,1,153,5,10,-5
2,1,154,12,8,4
2,1,155,5,26,-21
2,1,156,3,2,1
2,1,157,4,6,-2
2,1,158,5,0,5
2,1,159,10,12,-2
2,1,160,10,8,2
2,1,161,4,7,-3
2,1,162,6,6,0
2,1,163,7,3,4
2,1,164,3,3,0
2,1,165,6,5,1
2,1,166,6,5,1
2,1,167,5,6,-1
2,1,168,6,13,-7
2,1,169,8,10,-2
2,1,170,11,14,-3
2,1,171,12,10,2
2,1,172,5,18,-13
2,1,173,6,7,-1
2,1,174,8,9,-1
2,1,175,2,0,2
2,1,176,10,2,8
2,1,177,7,12,-5
2,1,178,8,6,2
2,1,179,5,4,1
2,1,180,5,3,2
2,1,181,5,3,2
2,1,182,10,10,0
2,1,183,10,6,4
2,1,184,16,23,-7
2,1,185,5,16,-11
2,1,186,4,9,-5
2,1,187,8,7,1
2,1,188,5,1,4
2,1,189,7,6,1
2,1,190,9,9,0
2,1,191,7,7,0
2,1,192,6,3,3
2,1,193,7,15,-8
2,1,194,4,9,-5
2,1,195,7,10,-3
2,1,196,6,7,-1
2,1,197,1,1,0
2,1,198,4,8,-4
2,1,199,5,5,0
2,1,200,5,8,-3
2,1,201,7,9,-2
2,1,202,9,6,3
2,1,203,6,5,1
2,1,204,3,6,-3
2,1,205,7,10,-3
2,1,206,4,3,1
2,1,207,10,16,-6
2,1,208,6,20,-14
2,1,209,2,3,-1
2,1,210,3,8,-5
2,1,211,6,7,-1
2,1,212,6,7,-1
2,1,213,4,4,0
2,1,214,11,8,3
2,1,215,4,13,-9
2,1,216,4,19,-15
2,1,217,3,3,0
2,1,218,5,10,-5
2,1,219,1,1,0
2,1,220,5,4,1
2,1,221,10,3,7
2,1,222,8,7,1
2,1,223,14,4,10
2,1,224,4,1,3
2,1,225,5,7,-2
2,1,226,5,2,3
2,1,227,5,4,1
2,1,228,1,5,-4
2,1,229,2,1,1
2,1,230,5,9,-4
2,1,231,15,8,7
2,1,232,6,2,4
2,1,233,12,13,-1
2,1,234,8,2,6
2,1,235,6,5,1
2,1,236,16,8,8
2,1,237,4,6,-2
2,1,238,4,6,-2
2,1,239,11,5,6
2,1,240,8,6,2
2,1,241,8,11,-3
2,1,242,2,4,-2
2,1,243,3,3,0
2,1,244,0,1,-1
2,1,245,19,9,10
2,1,246,6,9,-3
2,1,247,6,5,1
2,1,248,5,12,-7
2,1,249,10,9,1
2,1,250,15,3,12
2,1,251,14,6,8
2,1,252,7,4,3
2,1,253,3,4,-1
2,1,254,1,3,-2
2,1,255,11,15,-4
2,1,256,5,8,-3
2,1,257,6,10,-4
2,1,258,4,1,3
2,1,259,12,10,2
2,1,260,7,10,-3
2,1,261,4,1,3
2,1,262,8,2,6
2,1,263,4,10,-6
2,1,264,11,12,-1
2,1,265,7,7,0
2,1,266,7,9,-2
2,1,267,6,6,0
2,1,268,4,9,-5
2,1,269,5,9,-4
2,1,270,2,6,-4
2,1,271,14,5,9
2,1,272,3,4,-1
2,1,273,6,7,-1
2,1,274,8,12,-4
2,1,275,8,1,7
2,1,276,10,12,-2
2,1,277,8,9,-1
2,1,278,9,6,3
2,1,279,6,6,0
2,1,280,5,8,-3
2,1,281,6,5,1
2,1,282,7,14,-7
2,1,283,6,9,-3
2,1,284,6,11,-5
2,1,285,2,4,-2
2,1,286,3,8,-5
2,1,287,1,2,-1
2,1,288,10,8,2
2,1,289,2,7,-5
2,1,290,17,4,13
2,1,291,9,16,-7
2,1,292,5,5,0
2,1,293,8,16,-8
2,1,294,3,5,-2
2,1,295,8,5,3
2,1,296,2,5,-3
2,1,297,2,2,0
2,1,298,19,17,2
2,1,299,5,8,-3
2,2,0,9,8,1
2,2,1,12,8,4
2,2,2,3,2,1
2,2,3,3,4,-1
2,2,4,0,4,-4
2,2,5,3,1,2
2,2,6,5,10,-5
2,2,7,2,9,-7
2,2,8,4,11,-7
2,2,9,12,6,6
2,2,10,8,7,1
2,2,11,3,4,-1
2,2,12,9,15,-6
2,2,13,5,6,-1
2,2,14,9,5,4
2,2,15,1,9,-8
2,2,16,7,7,0
2,2,17,7,13,-6
2,2,18,10,5,5
2,2,19,5,5,0
2,2,20,2,3,-1
2,2,21,9,10,-1
2,2,22,15,16,-1
2,2,23,4,4,0
2,2,24,15,2,13
2,2,25,9,6,3
2,2,26,5,14,-9
2,2,27,2,3,-1
2,2,28,20,11,9
2,2,29,11,11,0
2,2,30,2,6,-4
2,2,31,4,8,-4
2,2,32,19,18,1
2,2,33,17,13,4
2,2,34,2,3,-1
2,2,35,9,8,1
2,2,36,12,7,5
2,2,37,7,10,-3
2,2,38,3,7,-4
2,2,39,5,2,3
2,2,40,7,0,7
2,2,41,5,6,-1
2,2,42,8,11,-3
2,2,43,1,3,-2
2,2,44,12,16,-4
2,2,45,9,10,-1
2,2,46,1,3,-2
2,2,47,11,12,-1
2,2,48,4,7,-3
2,2,49,2,6,-4
2,2,50,14,6,8
2,2,51,12,5,7
2,2,52,7,5,2
2,2,53,6,9,-3
2,2,54,9,7,2
2,2,55,5,8,-3
2,2,56,9,7,2
2,2,57,3,10,-7
2,2,58,9,20,-11
2,2,59,9,6,3
2,2,60,12,12,0
2,2,61,1,1,0
2,2,62,7,5,2
2,2,63,2,1,1
2,2,64,13,15,-2
2,2,65,29,6,23
2,2,66,4,2,2
2,2,67,4,3,1
2,2,68,4,9,-5
2,2,69,16,10,6
2,2,70,8,5,3
2,2,71,6,3,3
2,2,72,10,27,-17
2,2,73,6,6,0
2,2,74,8,2,6
2,2,75,12,16,-4
2,2,76,6,8,-2
2,2,77,6,1,5
2,2,78,5,6,-1
2,2,79,5,6,-1
2,2,80,9,5,4
2,2,81,4,9,-5
2,2,82,10,19,-9
2,2,83,13,6,7
2,2,84,2,4,-2
2,2,85,9,10,-1
2,2,86,1,1,0
2,2,87,2,1,1
2,2,88,24,14,10
2,2,89,6,12,-6
2,2,90,4,6,-2
2,2,91,9,11,-2
2,2,92,13,3,10
2,2,93,9,8,1
2,2,94,15,12,3
2,2,95,10,9,1
2,2,96,3,1,2
2,2,97,5,2,3
2,2,98,5,8,-3
2,2,99,4,6,-2
2,2,100,5,8,-3
2,2,101,9,9,0
2,2,102,13,21,-8
2,2,103,34,8,26
2,2,104,4,9,-5
2,2,105,14,21,-7
2,2,106,8,7,1
2,2,107,4,11,-7
2,2,108,7,7,0
2,2,109,9,5,4
2,2,110,3,12,-9
2,2,111,16,3,13
2,2,112,8,9,-1
2,2,113,5,14,-9
2,2,114,5,8,-3
2,2,115,11,8,3
2,2,116,5,6,-1
2,2,117,3,10,-7
2,2,118,10,7,3
2,2,119,4,8,-4
2,2,120,13,9,4
2,2,121,2,10,-8
2,2,122,6,7,-1
2,2,123,2,7,-5
2,2,124,7,11,-4
2,2,125,8,3,5
2,2,126,12,10,2
2,2,127,7,3,4
2,2,128,3,2,1
2,2,129,6,10,-4
2,2,130,3,4,-1
2,2,131,13,11,2
2,2,132,2,1,1
2,2,133,0,1,-1
2,2,134,9,5,4
2,2,135,9,5,4
2,2,136,5,5,0
2,2,137,4,4,0
2,2,138,7,15,-8
2,2,139,3,1,2
2,2,140,5,9,-4
2,2,141,8,6,2
2,2,142,4,4,0
2,2,143,7,12,-5
2,2,144,7,21,-14
2,2,145,2,3,-1
2,2,146,7,5,2
2,2,147,5,2,3
2,2,148,11,9,2
2,2,149,9,11,-2
2,2,150,8,14,-6
2,2,151,7,7,0
2,2,152,1,2,-1
2,2,153,9,16,-7
2,2,154,3,8,-5
2,2,155,6,6,0
2,2,156,4,7,-3
2,2,157,7,2,5
2,2,158,2,8,-6
2,2,159,16,22,-6
2,2,160,17,9,8
2,2,161,26,9,17
2,2,162,14,7,7
2,2,163,6,7,-1
2,2,164,9,14,-5
2,2,165,8,7,1
2,2,166,8,3,5
2,2,167,4,3,1
2,2,168,5,6,-1
2,2,169,10,9,1
2,2,170,4,6,-2
2,2,171,12,7,5
2,2,172,6,11,-5
2,2,173,3,9,-6
2,2,174,9,11,-2
2,2,175,9,5,4
2,2,176,8,8,0
2,2,177,6,9,-3
2,2,178,6,26,-20
2,2,179,5,7,-2
2,2,180,12,12,0
2,2,181,5,7,-2
2,2,182,3,8,-5
2,2,183,7,2,5
2,2,184,6,9,-3
2,2,185,3,9,-6
2,2,186,0,2,-2
2,2,187,6,10,-4
2,2,188,7,1,6
2,2,189,10,13,-3
2,2,190,9,7,2
2,2,191,2,7,-5
2,2,192,9,2,7
2,2,193,14,14,0
2,2,194,8,6,2
2,2,195,12,12,0
2,2,196,7,7,0
2,2,197,0,0,0
2,2,198,7,5,2
2,2,199,5,4,1
2,2,200,6,8,-2
2,2,201,13,8,5
2,2,202,7,5,2
2,2,203,9,10,-1
2,2,204,5,5,0
2,2,205,4,3,1
2,2,206,2,6,-4
2,2,207,7,6,1
2,2,208,6,14,-8
2,2,209,3,4,-1
2,2,210,13,1,12
2,2,211,10,17,-7
2,2,212,11,13,-2
2,2,213,9,16,-7
2,2,214,8,8,0
2,2,215,6,6,0
2,2,216,13,19,-6
2,2,217,8,36,-28
2,2,218,8,3,5
2,2,219,8,1,7
2,2,220,5,4,1
2,2,221,23,9,14
2,2,222,4,14,-10
2,2,223,13,16,-3
2,2,224,5,6,-1
2,2,225,3,5,-2
2,2,226,6,1,5
2,2,227,9,7,2
2,2,228,8,10,-2
2,2,229,4,7,-3
2,2,230,10,8,2
2,2,231,6,6,0
2,2,232,29,8,21
2,2,233,8,8,0
2,2,234,5,5,0
2,2,235,4,15,-11
2,2,236,9,4,5
2,2,237,4,5,-1
2,2,238,4,6,-2
2,2,239,13,12,1
2,2,240,10,4,6
2,2,241,10,9,1
2,2,242,4,6,-2
2,2,243,5,7,-2
2,2,244,6,7,-1
2,2,245,9,12,-3
2,2,246,11,7,4
2,2,247,7,9,-2
2,2,248,12,6,6
2,2,249,4,6,-2
2,2,250,7,3,4
2,2,251,6,9,-3
2,2,252,7,6,1
2,2,253,6,7,-1
2,2,254,7,14,-7
2,2,255,12,9,3
2,2,256,6,2,4
2,2,257,7,7,0
2,2,258,11,10,1
2,2,259,7,9,-2
2,2,260,8,12,-4
2,2,261,8,4,4
2,2,262,7,8,-1
2,2,263,10,14,-4
2,2,264,7,16,-9
2,2,265,7,5,2
2,2,266,4,1,3
2,2,267,9,14,-5
2,2,268,10,7,3
2,2,269,4,1,3
2,2,270,11,7,4
2,2,271,6,5,1
2,2,272,6,6,0
2,2,273,3,2,1
2,2,274,6,3,3
2,2,275,7,9,-2
2,2,276,8,5,3
2,2,277,1,0,1
2,2,278,6,8,-2
2,2,279,4,5,-1
2,2,280,3,5,-2
2,2,281,7,6,1
2,2,282,12,5,7
2,2,283,7,5,2
2,2,284,3,9,-6
2,2,285,5,7,-2
2,2,286,10,9,1
2,2,287,2,6,-4
2,2,288,5,5,0
2,2,289,14,10,4
2,2,290,8,15,-7
2,2,291,4,6,-2
2,2,292,1,8,-7
2,2,293,4,8,-4
2,2,294,5,3,2
2,2,295,3,6,-3
2,2,296,5,5,0
2,2,297,9,9,0
2,2,298,9,12,-3
2,2,299,4,9,-5
2,3,0,13,8,5
2,3,1,12,14,-2
2,3,2,9,12,-3
2,3,3,10,9,1
2,3,4,10,7,3
2,3,5,6,9,-3
2,3,6,14,6,8
2,3,7,4,4,0
2,3,8,5,8,-3
2,3,9,10,8,2
2,3,10,3,8,-5
2,3,11,2,11,-9
2,3,12,6,16,-10
2,3,13,8,7,1
2,3,14,9,14,-5
2,3,15,8,10,-2
2,3,16,7,21,-14
2,3,17,12,4,8
2,3,18,9,8,1
2,3,19,10,9,1
2,3,20,13,5,8
2,3,21,7,4,3
2,3,22,6,5,1
2,3,23,11,37,-26
2,3,24,7,9,-2
2,3,25,6,8,-2
2,3,26,1,4,-3
2,3,27,8,6,2
2,3,28,8,21,-13
2,3,29,6,12,-6
2,3,30,6,11,-5
2,3,31,11,11,0
2,3,32,4,4,0
2,3,33,7,10,-3
2,3,34,7,4,3
2,3,35,3,25,-22
2,3,36,9,5,4
2,3,37,7,5,2
2,3,38,11,12,-1
2,3,39,11,8,3
2,3,40,17,8,9
2,3,41,8,26,-18
2,3,42,6,9,-3
2,3,43,14,6,8
2,3,44,6,5,1
2,3,45,9,10,-1
2,3,46,11,12,-1
2,3,47,7,8,-1
2,3,48,19,8,11
2,3,49,14,6,8
2,3,50,12,10,2
2,3,51,5,9,-4
2,3,52,5,9,-4
2,3,53,4,4,0
2,3,54,16,8,8
2,3,55,2,10,-8
2,3,56,8,6,2
2,3,57,8,5,3
2,3,58,8,18,-10
2,3,59,8,8,0
2,3,60,10,11,-1
2,3,61,13,9,4
2,3,62,4,3,1
2,3,63,2,7,-5
2,3,64,9,16,-7
2,3,65,12,11,1
2,3,66,4,3,1
2,3,67,4,13,-9
2,3,68,5,8,-3
2,3,69,9,8,1
2,3,70,5,8,-3
2,3,71,9,10,-1
2,3,72,4,14,-10
2,3,73,14,15,-1
2,3,74,9,15,-6
2,3,75,13,13,0
2,3,76,12,7,5
2,3,77,6,12,-6
2,3,78,5,2,3
2,3,79,25,10,15
2,3,80,9,13,-4
2,3,81,10,8,2
2,3,82,2,2,0
2,3,83,12,8,4
2,3,84,4,5,-1
2,3,85,12,12,0
2,3,86,7,7,0
2,3,87,10,3,7
2,3,88,15,21,-6
2,3,89,22,7,15
2,3,90,6,12,-6
2,3,91,6,8,-2
2,3,92,5,15,-10
2,3,93,2,4,-2
2,3,94,10,10,0
2,3,95,4,7,-3
2,3,96,8,7,1
2,3,97,14,11,3
2,3,98,6,9,-3
2,3,99,4,5,-1
2,3,100,9,13,-4
2,3,101,7,9,-2
2,3,102,7,7,0
2,3,103,5,9,-4
2,3,104,6,14,-8
2,3,105,8,8,0
2,3,106,9,15,-6
2,3,107,7,10,-3
2,3,108,4,9,-5
2,3,109,11,9,2
2,3,110,7,9,-2
2,3,111,11,13,-2
2,3,112,8,9,-1
2,3,113,6,8,-2
2,3,114,5,8,-3
2,3,115,6,6,0
2,3,116,8,14,-6
2,3,117,8,14,-6
2,3,118,10,9,1
2,3,119,4,14,-10
2,3,120,5,6,-1
2,3,121,4,8,-4
2,3,122,8,9,-1
2,3,123,17,8,9
2,3,124,3,7,-4
2,3,125,7,10,-3
2,3,126,7,9,-2
2,3,127,5,6,-1
2,3,128,12,9,3
2,3,129,14,37,-23
2,3,130,29,18,11
2,3,131,9,5,4
2,3,132,3,5,-2
2,3,133,22,10,12
2,3,134,3,6,-3
2,3,135,7,4,3
2,3,136,13,14,-1
2,3,137,11,9,2
2,3,138,8,8,0
2,3,139,15,9,6
2,3,140,8,10,-2
2,3,141,2,6,-4
2,3,142,5,3,2
2,3,143,7,5,2
2,3,144,3,11,-8
2,3,145,18,25,-7
2,3,146,11,9,2
2,3,147,11,8,3
2,3,148,4,9,-5
2,3,149,3,5,-2
2,3,150,3,8,-5
2,3,151,7,14,-7
2,3,152,10,10,0
2,3,153,6,6,0
2,3,154,5,7,-2
2,3,155,5,14,-9
2,3,156,8,4,4
2,3,157,19,27,-8
2,3,158,12,15,-3
2,3,159,6,9,-3
2,3,160,4,4,0
2,3,161,18,23,-5
2,3,162,7,10,-3
2,3,163,3,11,-8
2,3,164,4,7,-3
2,3,165,7,4,3
2,3,166,2,3,-1
2,3,167,3,4,-1
2,3,168,9,16,-7
2,3,169,7,6,1
2,3,170,6,1,5
2,3,171,19,5,14
2,3,172,5,11,-6
2,3,173,16,7,9
2,3,174,5,5,0
2,3,175,10,9,1
2,3,176,9,7,2
2,3,177,8,15,-7
2,3,178,7,6,1
2,3,179,11,7,4
2,3,180,4,5,-1
2,3,181,5,15,-10
2,3,182,6,12,-6
2,3,183,7,14,-7
2,3,184,13,6,7
2,3,185,4,12,-8
2,3,186,8,7,1
2,3,187,5,1,4
2,3,188,7,0,7
2,3,189,13,23,-10
2,3,190,9,13,-4
2,3,191,4,17,-13
2,3,192,8,21,-13
2,3,193,8,7,1
2,3,194,9,11,-2
2,3,195,2,2,0
2,3,196,15,11,4
2,3,197,8,18,-10
2,3,198,7,8,-1
2,3,199,10,8,2
2,3,200,11,7,4
2,3,201,15,18,-3
2,3,202,14,10,4
2,3,203,7,11,-4
2,3,204,17,12,5
2,3,205,11,11,0
2,3,206,6,3,3
2,3,207,8,12,-4
2,3,208,3,2,1
2,3,209,17,9,8
2,3,210,3,13,-10
2,3,211,1,1,0
2,3,212,6,12,-6
2,3,213,7,11,-4
2,3,214,6,11,-5
2,3,215,6,5,1
2,3,216,10,5,5
2,3,217,3,2,1
2,3,218,6,8,-2
2,3,219,14,14,0
2,3,220,15,16,-1
2,3,221,6,7,-1
2,3,222,15,15,0
2,3,223,8,18,-10
2,3,224,6,3,3
2,3,225,11,14,-3
2,3,226,7,15,-8
2,3,227,10,13,-3
2,3,228,6,10,-4
2,3,229,0,1,-1
2,3,230,9,11,-2
2,3,231,6,3,3
2,3,232,9,10,-1
2,3,233,7,13,-6
2,3,234,5,10,-5
2,3,235,11,14,-3
2,3,236,10,10,0
2,3,237,12,4,8
2,3,238,10,12,-2
2,3,239,6,5,1
2,3,240,13,13,0
2,3,241,17,4,13
2,3,242,11,11,0
2,3,243,9,8,1
2,3,244,6,7,-1
2,3,245,25,23,2
2,3,246,15,12,3
2,3,247,7,8,-1
2,3,248,3,7,-4
2,3,249,7,18,-11
2,3,250,2,14,-12
2,3,251,6,7,-1
2,3,252,12,13,-1
2,3,253,11,15,-4
2,3,254,5,10,-5
2,3,255,5,2,3
2,3,256,12,11,1
2,3,257,5,9,-4
2,3,258,10,9,1
2,3,259,11,8,3
2,3,260,7,7,0
2,3,261,9,9,0
2,3,262,16,6,10
2,3,263,8,8,0
2,3,264,9,9,0
2,3,265,9,5,4
2,3,266,15,5,10
2,3,267,9,3,6
2,3,268,10,14,-4
2,3,269,7,9,-2
2,3,270,8,3,5
2,3,271,11,9,2
2,3,272,6,6,0
2,3,273,10,5,5
2,3,274,8,11,-3
2,3,275,12,3,9
2,3,276,8,8,0
2,3,277,13,8,5
2,3,278,4,8,-4
2,3,279,10,4,6
2,3,280,5,10,-5
2,3,281,12,11,1
2,3,282,9,8,1
2,3,283,6,4,2
2,3,284,5,4,1
2,3,285,7,7,0
2,3,286,15,9,6
2,3,287,10,7,3
2,3,288,4,8,-4
2,3,289,13,10,3
2,3,290,25,8,17
2,3,291,15,7,8
2,3,292,10,9,1
2,3,293,4,9,-5
2,3,294,7,5,2
2,3,295,11,8,3
2,3,296,4,1,3
2,3,297,4,8,-4
2,3,298,13,14,-1
2,3,299,9,5,4
2,4,0,6,11,-5
2,4,1,13,14,-1
2,4,2,5,9,-4
2,4,3,10,13,-3
2,4,4,2,2,0
2,4,5,5,5,0
2,4,6,12,13,-1
2,4,7,10,2,8
2,4,8,5,4,1
2,4,9,8,9,-1
2,4,10,5,5,0
2,4,11,13,2,11
2,4,12,4,3,1
2,4,13,12,15,-3
2,4,14,11,8,3
2,4,15,12,20,-8
2,4,16,3,6,-3
2,4,17,9,22,-13
2,4,18,22,11,11
2,4,19,16,7,9
2,4,20,21,14,7
2,4,21,1,5,-4
2,4,22,3,3,0
2,4,23,11,23,-12
2,4,24,10,7,3
2,4,25,7,9,-2
2,4,26,5,7,-2
2,4,27,14,13,1
2,4,28,10,15,-5
2,4,29,6,9,-3
2,4,30,9,9,0
2,4,31,16,13,3
2,4,32,6,3,3
2,4,33,1,11,-10
2,4,34,9,7,2
2,4,35,14,11,3
2,4,36,11,15,-4
2,4,37,8,10,-2
2,4,38,13,29,-16
2,4,39,11,8,3
2,4,40,4,5,-1
2,4,41,6,10,-4
2,4,42,10,13,-3
2,4,43,8,5,3
2,4,44,12,10,2
2,4,45,14,9,5
2,4,46,14,16,-2
2,4,47,17,9,8
2,4,48,11,11,0
2,4,49,6,4,2
2,4,50,16,19,-3
2,4,51,10,6,4
2,4,52,5,5,0
2,4,53,9,4,5
2,4,54,6,8,-2
2,4,55,7,5,2
2,4,56,17,21,-4
2,4,57,16,7,9
2,4,58,5,6,-1
2,4,59,9,8,1
2,4,60,8,8,0
2,4,61,9,6,3
2,4,62,7,5,2
2,4,63,10,7,3
2,4,64,8,2,6
2,4,65,15,12,3
2,4,66,5,8,-3
2,4,67,11,8,3
2,4,68,3,4,-1
2,4,69,9,8,1
2,4,70,15,10,5
2,4,71,13,24,-11
2,4,72,5,8,-3
2,4,73,8,11,-3
2,4,74,6,5,1
2,4,75,7,9,-2
2,4,76,8,11,-3
2,4,77,13,9,4
2,4,78,17,12,5
2,4,79,13,7,6
2,4,80,4,3,1
2,4,81,13,17,-4
2,4,82,12,7,5
2,4,83,7,12,-5
2,4,84,6,4,2
2,4,85,11,9,2
2,4,86,3,11,-8
2,4,87,9,9,0
2,4,88,8,7,1
2,4,89,8,17,-9
2,4,90,8,13,-5
2,4,91,18,16,2
2,4,92,3,2,1
2,4,93,10,13,-3
2,4,94,12,11,1
2,4,95,11,5,6
2,4,96,13,13,0
2,4,97,7,14,-7
2,4,98,19,12,7
2,4,99,3,12,-9
2,4,100,21,17,4
2,4,101,2,5,-3
2,4,102,13,12,1
2,4,103,10,8,2
2,4,104,2,4,-2
2,4,105,4,6,-2
2,4,106,5,10,-5
2,4,107,4,2,2
2,4,108,15,9,6
2,4,109,9,9,0
2,4,110,4,11,-7
2,4,111,3,5,-2
2,4,112,8,19,-11
2,4,113,6,5,1
2,4,114,15,10,5
2,4,115,8,7,1
2,4,116,2,1,1
2,4,117,8,10,-2
2,4,118,10,8,2
2,4,119,15,12,3
2,4,120,17,10,7
2,4,121,12,12,0
2,4,122,9,9,0
2,4,123,12,11,1
2,4,124,16,12,4
2,4,125,11,21,-10
2,4,126,19,5,14
2,4,127,7,9,-2
2,4,128,8,7,1
2,4,129,8,10,-2
2,4,130,9,13,-4
2,4,131,13,9,4
2,4,132,12,9,3
2,4,133,12,3,9
2,4,134,13,7,6
2,4,135,10,7,3
2,4,136,4,0,4
2,4,137,26,18,8
2,4,138,8,10,-2
2,4,139,15,7,8
2,4,140,5,9,-4
2,4,141,8,4,4
2,4,142,10,7,3
2,4,143,12,18,-6
2,4,144,2,5,-3
2,4,145,16,5,11
2,4,146,13,4,9
2,4,147,7,4,3
2,4,148,7,11,-4
2,4,149,6,12,-6
2,4,150,5,16,-11
2,4,151,6,14,-8
2,4,152,9,10,-1
2,4,153,8,8,0
2,4,154,8,8,0
2,4,155,7,8,-1
2,4,156,4,5,-1
2,4,157,5,5,0
2,4,158,13,11,2
2,4,159,3,10,-7
2,4,160,7,2,5
2,4,161,14,22,-8
2,4,162,6,9,-3
2,4,163,10,17,-7
2,4,164,15,22,-7
2,4,165,9,8,1
2,4,166,16,15,1
2,4,167,7,5,2
2,4,168,5,11,-6
2,4,169,7,15,-8
2,4,170,10,11,-1
2,4,171,20,14,6
2,4,172,7,6,1
2,4,173,11,10,1
2,4,174,24,16,8
2,4,175,8,5,3
2,4,176,6,9,-3
2,4,177,5,11,-6
2,4,178,6,8,-2
2,4,179,10,11,-1
2,4,180,3,3,0
2,4,181,6,5,1
2,4,182,11,4,7
2,4,183,13,7,6
2,4,184,6,7,-1
2,4,185,11,12,-1
2,4,186,5,4,1
2,4,187,8,3,5
2,4,188,6,6,0
2,4,189,15,7,8
2,4,190,17,21,-4
2,4,191,29,12,17
2,4,192,9,8,1
2,4,193,6,13,-7
2,4,194,2,3,-1
2,4,195,4,10,-6
2,4,196,9,13,-4
2,4,197,2,5,-3
2,4,198,11,12,-1
2,4,199,9,12,-3
2,4,200,16,4,12
2,4,201,8,3,5
2,4,202,6,6,0
2,4,203,20,11,9
2,4,204,6,15,-9
2,4,205,7,3,4
2,4,206,7,9,-2
2,4,207,23,11,12
2,4,208,11,15,-4
2,4,209,5,4,1
2,4,210,4,8,-4
2,4,211,2,6,-4
2,4,212,16,6,10
2,4,213,19,9,10
2,4,214,10,6,4
2,4,215,7,5,2
2,4,216,13,20,-7
2,4,217,3,5,-2
2,4,218,15,15,0
2,4,219,3,2,1
2,4,220,7,4,3
2,4,221,10,8,2
2,4,222,17,24,-7
2,4,223,15,8,7
2,4,224,12,36,-24
2,4,225,11,11,0
2,4,226,11,20,-9
2,4,227,15,13,2
2,4,228,10,9,1
2,4,229,12,22,-10
2,4,230,5,5,0
2,4,231,9,15,-6
2,4,232,10,9,1
2,4,233,6,4,2
2,4,234,12,6,6
2,4,235,6,10,-4
2,4,236,13,9,4
2,4,237,9,13,-4
2,4,238,12,14,-2
2,4,239,7,19,-12
2,4,240,6,8,-2
2,4,241,7,14,-7
2,4,242,11,8,3
2,4,243,4,3,1
2,4,244,9,6,3
2,4,245,10,6,4
2,4,246,24,12,12
2,4,247,7,13,-6
2,4,248,17,15,2
2,4,249,9,11,-2
2,4,250,5,10,-5
2,4,251,10,13,-3
2,4,252,10,6,4
2,4,253,12,7,5
2,4,254,7,7,0
2,4,255,9,8,1
2,4,256,16,4,12
2,4,257,15,6,9
2,4,258,2,5,-3
2,4,259,14,9,5
2,4,260,6,6,0
2,4,261,4,4,0
2,4,262,5,2,3
2,4,263,9,15,-6
2,4,264,9,6,3
2,4,265,10,11,-1
2,4,266,13,6,7
2,4,267,12,11,1
2,4,268,3,10,-7
2,4,269,11,9,2
2,4,270,13,5,8
2,4,271,11,10,1
2,4,272,6,5,1
2,4,273,12,7,5
2,4,274,2,4,-2
2,4,275,12,9,3
2,4,276,3,16,-13
2,4,277,7,18,-11
2,4,278,12,10,2
2,4,279,5,6,-1
2,4,280,7,7,0
2,4,281,14,8,6
2,4,282,10,6,4
2,4,283,7,2,5
2,4,284,7,11,-4
2,4,285,8,15,-7
2,4,286,7,9,-2
2,4,287,4,8,-4
2,4,288,15,30,-15
2,4,289,2,6,-4
2,4,290,12,18,-6
2,4,291,10,5,5
2,4,292,12,11,1
2,4,293,7,8,-1
2,4,294,9,8,1
2,4,295,16,13,3
2,4,296,8,12,-4
2,4,297,13,5,8
2,4,298,8,11,-3
2,4,299,1,6,-5
2,5,0,5,6,-1
2,5,1,11,8,3
2,5,2,2,8,-6
2,5,3,8,8,0
2,5,4,7,4,3
2,5,5,19,15,4
2,5,6,8,14,-6
2,5,7,8,26,-18
2,5,8,8,22,-14
2,5,9,9,9,0
2,5,10,6,3,3
2,5,11,5,3,2
2,5,12,12,5,7
2,5,13,11,10,1
2,5,14,3,2,1
2,5,15,12,12,0
2,5,16,18,12,6
2,5,17,2,9,-7
2,5,18,22,13,9
2,5,19,9,16,-7
2,5,20,15,12,3
2,5,21,10,8,2
2,5,22,2,4,-2
2,5,23,10,7,3
2,5,24,9,3,6
2,5,25,4,2,2
2,5,26,14,11,3
2,5,27,16,11,5
2,5,28,6,10,-4
2,5,29,16,5,11
2,5,30,13,7,6
2,5,31,7,3,4
2,5,32,12,17,-5
2,5,33,20,9,11
2,5,34,11,13,-2
2,5,35,7,6,1
2,5,36,11,13,-2
2,5,37,8,6,2
2,5,38,16,12,4
2,5,39,10,7,3
2,5,40,16,16,0
2,5,41,12,4,8
2,5,42,12,17,-5
2,5,43,10,13,-3
2,5,44,6,6,0
2,5,45,5,6,-1
2,5,46,20,9,11
2,5,47,12,19,-7
2,5,48,15,17,-2
2,5,49,19,8,11
2,5,50,12,12,0
2,5,51,5,8,-3
2,5,52,16,14,2
2,5,53,28,15,13
2,5,54,25,22,3
2,5,55,7,9,-2
2,5,56,1,2,-1
2,5,57,10,10,0
2,5,58,8,8,0
2,5,59,9,12,-3
2,5,60,10,4,6
2,5,61,12,18,-6
2,5,62,10,5,5
2,5,63,27,13,14
2,5,64,29,12,17
2,5,65,18,17,1
2,5,66,14,16,-2
2,5,67,4,7,-3
2,5,68,6,3,3
2,5,69,6,12,-6
2,5,70,6,5,1
2,5,71,9,8,1
2,5,72,7,10,-3
2,5,73,13,11,2
2,5,74,7,4,3
2,5,75,11,4,7
2,5,76,15,14,1
2,5,77,11,7,4
2,5,78,3,3,0
2,5,79,13,6,7
2,5,80,6,10,-4
2,5,81,11,14,-3
2,5,82,2,4,-2
2,5,83,8,15,-7
2,5,84,23,9,14
2,5,85,6,14,-8
2,5,86,7,5,2
2,5,87,16,7,9
2,5,88,5,6,-1
2,5,89,22,17,5
2,5,90,13,17,-4
2,5,91,13,10,3
2,5,92,3,2,1
2,5,93,9,12,-3
2,5,94,10,8,2
2,5,95,8,5,3
2,5,96,26,10,16
2,5,97,5,7,-2
2,5,98,16,9,7
2,5,99,5,12,-7
2,5,100,9,14,-5
2,5,101,20,11,9
2,5,102,13,13,0
2,5,103,17,14,3
2,5,104,12,8,4
2,5,105,8,10,-2
2,5,106,9,8,1
2,5,107,23,12,11
2,5,108,11,15,-4
2,5,109,23,20,3
2,5,110,7,7,0
2,5,111,19,17,2
2,5,112,22,18,4
2,5,113,13,9,4
2,5,114,3,6,-3
2,5,115,10,10,0
2,5,116,13,9,4
2,5,117,11,5,6
2,5,118,13,17,-4
2,5,119,11,14,-3
2,5,120,18,16,2
2,5,121,1,2,-1
2,5,122,9,7,2
2,5,123,26,29,-3
2,5,124,4,7,-3
2,5,125,5,8,-3
2,5,126,15,10,5
2,5,127,19,17,2
2,5,128,15,22,-7
2,5,129,13,17,-4
2,5,130,34,12,22
2,5,131,23,7,16
2,5,132,7,2,5
2,5,133,15,14,1
2,5,134,6,6,0
2,5,135,2,3,-1
2,5,136,11,8,3
2,5,137,9,6,3
2,5,138,2,10,-8
2,5,139,18,7,11
2,5,140,22,11,11
2,5,141,6,5,1
2,5,142,1,22,-21
2,5,143,14,18,-4
2,5,144,7,9,-2
2,5,145,16,13,3
2,5,146,12,7,5
2,5,147,4,2,2
2,5,148,19,11,8
2,5,149,14,11,3
2,5,150,5,9,-4
2,5,151,11,23,-12
2,5,152,4,5,-1
2,5,153,32,12,20
2,5,154,7,3,4
2,5,155,26,14,12
2,5,156,9,19,-10
2,5,157,17,16,1
2,5,158,12,20,-8
2,5,159,6,5,1
2,5,160,8,8,0
2,5,161,16,13,3
2,5,162,15,14,1
2,5,163,17,8,9
2,5,164,9,13,-4
2,5,165,9,8,1
2,5,166,9,9,0
2,5,167,3,2,1
2,5,168,20,12,8
2,5,169,14,16,-2
2,5,170,10,8,2
2,5,171,7,11,-4
2,5,172,12,14,-2
2,5,173,3,8,-5
2,5,174,10,12,-2
2,5,175,15,10,5
2,5,176,9,8,1
2,5,177,16,15,1
2,5,178,13,12,1
2,5,179,16,13,3
2,5,180,4,4,0
2,5,181,16,18,-2
2,5,182,15,13,2
2,5,183,13,16,-3
2,5,184,0,9,-9
2,5,185,10,2,8
2,5,186,17,12,5
2,5,187,10,12,-2
2,5,188,6,8,-2
2,5,189,9,3,6
2,5,190,12,9,3
2,5,191,12,13,-1
2,5,192,9,4,5
2,5,193,7,4,3
2,5,194,2,6,-4
2,5,195,8,2,6
2,5,196,7,6,1
2,5,197,5,3,2
2,5,198,10,6,4
2,5,199,10,3,7
2,5,200,8,19,-11
2,5,201,14,10,4
2,5,202,21,18,3
2,5,203,21,11,10
2,5,204,16,14,2
2,5,205,14,12,2
2,5,206,9,7,2
2,5,207,8,8,0
2,5,208,7,19,-12
2,5,209,11,5,6
2,5,210,8,12,-4
2,5,211,9,10,-1
2,5,212,8,11,-3
2,5,213,5,8,-3
2,5,214,11,13,-2
2,5,215,16,22,-6
2,5,216,8,6,2
2,5,217,16,5,11
2,5,218,4,9,-5
2,5,219,10,15,-5
2,5,220,2,1,1
2,5,221,5,7,-2
2,5,222,5,5,0
2,5,223,11,9,2
2,5,224,10,3,7
2,5,225,3,4,-1
2,5,226,9,10,-1
2,5,227,14,6,8
2,5,228,6,11,-5
2,5,229,9,8,1
2,5,230,4,8,-4
2,5,231,19,9,10
2,5,232,8,17,-9
2,5,233,12,3,9
2,5,234,8,10,-2
2,5,235,16,9,7
2,5,236,12,8,4
2,5,237,11,21,-10
2,5,238,21,15,6
2,5,239,12,6,6
2,5,240,8,9,-1
2,5,241,9,13,-4
2,5,242,9,11,-2
2,5,243,10,12,-2
2,5,244,16,13,3
2,5,245,10,2,8
2,5,246,14,9,5
2,5,247,17,12,5
2,5,248,11,18,-7
2,5,249,6,2,4
2,5,250,11,23,-12
2,5,251,18,19,-1
2,5,252,7,5,2
2,5,253,21,14,7
2,5,254,8,9,-1
2,5,255,6,11,-5
2,5,256,6,7,-1
2,5,257,7,8,-1
2,5,258,1,4,-3
2,5,259,9,6,3
2,5,260,15,14,1
2,5,261,8,7,1
2,5,262,8,7,1
2,5,263,12,28,-16
2,5,264,11,16,-5
2,5,265,17,4,13
2,5,266,11,4,7
2,5,267,3,3,0
2,5,268,8,8,0
2,5,269,15,5,10
2,5,270,16,22,-6
2,5,271,17,14,3
2,5,272,17,27,-10
2,5,273,8,6,2
2,5,274,10,2,8
2,5,275,5,7,-2
2,5,276,8,13,-5
2,5,277,11,14,-3
2,5,278,11,9,2
2,5,279,2,11,-9
2,5,280,8,7,1
2,5,281,9,3,6
2,5,282,2,2,0
2,5,283,6,4,2
2,5,284,16,20,-4
2,5,285,8,8,0
2,5,286,12,6,6
2,5,287,20,17,3
2,5,288,9,13,-4
2,5,289,17,15,2
2,5,290,17,10,7
2,5,291,15,18,-3
2,5,292,10,12,-2
2,5,293,8,7,1
2,5,294,9,15,-6
2,5,295,15,12,3
2,5,296,10,18,-8
2,5,297,8,8,0
2,5,298,11,10,1
2,5,299,1,5,-4
2,6,0,13,30,-17
2,6,1,7,5,2
2,6,2,7,11,-4
2,6,3,15,14,1
2,6,4,17,19,-2
2,6,5,7,8,-1
2,6,6,17,16,1
2,6,7,17,8,9
2,6,8,12,16,-4
2,6,9,10,15,-5
2,6,10,14,26,-12
2,6,11,13,11,2
2,6,12,21,8,13
2,6,13,9,19,-10
2,6,14,4,8,-4
2,6,15,9,8,1
2,6,16,17,16,1
2,6,17,12,3,9
2,6,18,17,7,10
2,6,19,11,10,1
2,6,20,13,7,6
2,6,21,7,12,-5
2,6,22,19,11,8
2,6,23,12,8,4
2,6,24,15,8,7
2,6,25,16,12,4
2,6,26,16,11,5
2,6,27,12,14,-2
2,6,28,8,6,2
2,6,29,21,15,6
2,6,30,15,12,3
2,6,31,19,7,12
2,6,32,20,10,10
2,6,33,1,3,-2
2,6,34,17,10,7
2,6,35,0,6,-6
2,6,36,10,6,4
2,6,37,22,21,1
2,6,38,11,7,4
2,6,39,9,11,-2
2,6,40,9,0,9
2,6,41,14,7,7
2,6,42,15,6,9
2,6,43,8,6,2
2,6,44,13,5,8
2,6,45,17,20,-3
2,6,46,10,9,1
2,6,47,11,21,-10
2,6,48,13,14,-1
2,6,49,9,4,5
2,6,50,5,13,-8
2,6,51,7,9,-2
2,6,52,10,14,-4
2,6,53,17,11,6
2,6,54,6,4,2
2,6,55,13,5,8
2,6,56,16,14,2
2,6,57,6,6,0
2,6,58,8,8,0
2,6,59,9,5,4
2,6,60,9,8,1
2,6,61,21,28,-7
2,6,62,13,5,8
2,6,63,12,13,-1
2,6,64,3,1,2
2,6,65,15,7,8
2,6,66,20,8,12
2,6,67,9,18,-9
2,6,68,22,7,15
2,6,69,11,21,-10
2,6,70,7,10,-3
2,6,71,13,12,1
2,6,72,7,17,-10
2,6,73,16,11,5
2,6,74,13,16,-3
2,6,75,16,20,-4
2,6,76,5,6,-1
2,6,77,14,5,9
2,6,78,9,11,-2
2,6,79,4,8,-4
2,6,80,6,8,-2
2,6,81,12,9,3
2,6,82,10,14,-4
2,6,83,3,14,-11
2,6,84,12,12,0
2,6,85,12,13,-1
2,6,86,10,7,3
2,6,87,8,9,-1
2,6,88,6,9,-3
2,6,89,7,14,-7
2,6,90,1,4,-3
2,6,91,6,3,3
2,6,92,19,17,2
2,6,93,13,8,5
2,6,94,8,5,3
2,6,95,2,2,0
2,6,96,20,17,3
2,6,97,5,11,-6
2,6,98,5,4,1
2,6,99,11,21,-10
2,6,100,7,14,-7
2,6,101,14,13,1
2,6,102,7,2,5
2,6,103,10,3,7
2,6,104,3,6,-3
2,6,105,5,7,-2
2,6,106,12,18,-6
2,6,107,7,13,-6
2,6,108,16,10,6
2,6,109,8,9,-1
2,6,110,7,3,4
2,6,111,4,7,-3
2,6,112,9,8,1
2,6,113,8,26,-18
2,6,114,13,1,12
2,6,115,20,10,10
2,6,116,8,6,2
2,6,117,9,12,-3
2,6,118,20,9,11
2,6,119,12,3,9
2,6,120,3,7,-4
2,6,121,7,10,-3
2,6,122,11,8,3
2,6,123,16,17,-1
2,6,124,15,9,6
2,6,125,10,10,0
2,6,126,12,6,6
2,6,127,8,6,2
2,6,128,12,14,-2
2,6,129,28,12,16
2,6,130,10,2,8
2,6,131,2,11,-9
2,6,132,11,2,9
2,6,133,20,20,0
2,6,134,11,16,-5
2,6,135,10,22,-12
2,6,136,9,18,-9
2,6,137,23,14,9
2,6,138,5,1,4
2,6,139,10,3,7
2,6,140,9,8,1
2,6,141,13,18,-5
2,6,142,8,6,2
2,6,143,6,12,-6
2,6,144,8,12,-4
2,6,145,16,15,1
2,6,146,9,16,-7
2,6,147,17,10,7
2,6,148,3,6,-3
2,6,149,8,9,-1
2,6,150,8,3,5
2,6,151,15,8,7
2,6,152,18,11,7
2,6,153,8,10,-2
2,6,154,7,6,1
2,6,155,7,8,-1
2,6,156,12,22,-10
2,6,157,20,8,12
2,6,158,5,9,-4
2,6,159,10,6,4
2,6,160,6,4,2
2,6,161,13,16,-3
2,6,162,12,9,3
2,6,163,20,17,3
2,6,164,18,17,1
2,6,165,9,10,-1
2,6,166,8,17,-9
2,6,167,22,6,16
2,6,168,17,21,-4
2,6,169,1,6,-5
2,6,170,14,5,9
2,6,171,14,18,-4
2,6,172,10,16,-6
2,6,173,8,2,6
2,6,174,8,4,4
2,6,175,9,15,-6
2,6,176,17,10,7
2,6,177,7,5,2
2,6,178,14,19,-5
2,6,179,8,1,7
2,6,180,9,17,-8
2,6,181,9,14,-5
2,6,182,8,13,-5
2,6,183,8,5,3
2,6,184,7,3,4
2,6,185,4,10,-6
2,6,186,11,7,4
2,6,187,11,10,1
2,6,188,24,20,4
2,6,189,9,3,6
2,6,190,20,19,1
2,6,191,14,9,5
2,6,192,13,14,-1
2,6,193,15,4,11
2,6,194,12,7,5
2,6,195,12,10,2
2,6,196,1,6,-5
2,6,197,11,14,-3
2,6,198,11,6,5
2,6,199,5,3,2
2,6,200,5,11,-6
2,6,201,16,11,5
2,6,202,10,5,5
2,6,203,6,2,4
2,6,204,12,12,0
2,6,205,10,11,-1
2,6,206,9,2,7
2,6,207,15,15,0
2,6,208,18,12,6
2,6,209,10,12,-2
2,6,210,15,14,1
2,6,211,9,9,0
2,6,212,10,10,0
2,6,213,10,19,-9
2,6,214,12,6,6
2,6,215,11,5,6
2,6,216,11,4,7
2,6,217,8,9,-1
2,6,218,11,6,5
2,6,219,9,14,-5
2,6,220,8,8,0
2,6,221,9,10,-1
2,6,222,20,19,1
2,6,223,3,15,-12
2,6,224,11,10,1
2,6,225,4,11,-7
2,6,226,6,13,-7
2,6,227,19,10,9
2,6,228,13,10,3
2,6,229,19,19,0
2,6,230,11,4,7
2,6,231,9,10,-1
2,6,232,13,14,-1
2,6,233,20,7,13
2,6,234,12,9,3
2,6,235,10,17,-7
2,6,236,3,6,-3
2,6,237,6,13,-7
2,6,238,15,6,9
2,6,239,7,6,1
2,6,240,20,3,17
2,6,241,10,18,-8
2,6,242,6,10,-4
2,6,243,16,17,-1
2,6,244,4,12,-8
2,6,245,7,3,4
2,6,246,7,13,-6
2,6,247,14,16,-2
2,6,248,10,17,-7
2,6,249,19,25,-6
2,6,250,8,7,1
2,6,251,11,21,-10
2,6,252,12,4,8
2,6,253,9,11,-2
2,6,254,7,19,-12
2,6,255,8,10,-2
2,6,256,12,12,0
2,6,257,14,8,6
2,6,258,16,17,-1
2,6,259,7,12,-5
2,6,260,16,10,6
2,6,261,3,2,1
2,6,262,10,20,-10
2,6,263,7,4,3
2,6,264,14,10,4
2,6,265,11,12,-1
2,6,266,18,12,6
2,6,267,7,11,-4
2,6,268,7,16,-9
2,6,269,11,10,1
2,6,270,5,8,-3
2,6,271,8,4,4
2,6,272,9,11,-2
2,6,273,13,11,2
2,6,274,21,15,6
2,6,275,5,8,-3
2,6,276,10,12,-2
2,6,277,11,14,-3
2,6,278,14,17,-3
2,6,279,7,10,-3
2,6,280,4,6,-2
2,6,281,10,8,2
2,6,282,8,12,-4
2,6,283,8,12,-4
2,6,284,10,11,-1
2,6,285,11,16,-5
2,6,286,14,7,7
2,6,287,6,12,-6
2,6,288,13,8,5
2,6,289,3,5,-2
2,6,290,12,6,6
2,6,291,10,19,-9
2,6,292,7,5,2
2,6,293,3,8,-5
2,6,294,7,2,5
2,6,295,12,15,-3
2,6,296,11,13,-2
2,6,297,10,16,-6
2,6,298,7,6,1
2,6,299,13,11,2
2,7,0,6,3,3
2,7,1,21,5,16
2,7,2,0,2,-2
2,7,3,1,2,-1
2,7,4,14,13,1
2,7,5,7,5,2
2,7,6,8,7,1
2,7,7,7,11,-4
2,7,8,20,25,-5
2,7,9,14,12,2
2,7,10,11,16,-5
2,7,11,9,8,1
2,7,12,12,12,0
2,7,13,10,14,-4
2,7,14,3,3,0
2,7,15,11,11,0
2,7,16,13,12,1
2,7,17,7,13,-6
2,7,18,10,4,6
2,7,19,4,6,-2
2,7,20,21,23,-2
2,7,21,10,3,7
2,7,22,13,4,9
2,7,23,8,7,1
2,7,24,7,19,-12
2,7,25,10,14,-4
2,7,26,10,6,4
2,7,27,14,19,-5
2,7,28,14,11,3
2,7,29,8,11,-3
2,7,30,18,13,5
2,7,31,18,3,15
2,7,32,16,10,6
2,7,33,15,29,-14
2,7,34,19,8,11
2,7,35,9,5,4
2,7,36,11,10,1
2,7,37,10,1,9
2,7,38,8,8,0
2,7,39,8,14,-6
2,7,40,15,10,5
2,7,41,5,5,0
2,7,42,7,5,2
2,7,43,19,16,3
2,7,44,15,24,-9
2,7,45,13,8,5
2,7,46,4,6,-2
2,7,47,6,7,-1
2,7,48,12,6,6
2,7,49,16,19,-3
2,7,50,19,21,-2
2,7,51,13,15,-2
2,7,52,15,29,-14
2,7,53,10,6,4
2,7,54,11,5,6
2,7,55,12,11,1
2,7,56,11,10,1
2,7,57,7,7,0
2,7,58,12,8,4
2,7,59,16,7,9
2,7,60,10,11,-1
2,7,61,5,9,-4
2,7,62,12,11,1
2,7,63,15,9,6
2,7,64,9,7,2
2,7,65,17,10,7
2,7,66,13,11,2
2,7,67,10,11,-1
2,7,68,14,7,7
2,7,69,8,5,3
2,7,70,9,7,2
2,7,71,19,13,6
2,7,72,24,6,18
2,7,73,10,16,-6
2,7,74,8,19,-11
2,7,75,15,10,5
2,7,76,15,10,5
2,7,77,18,17,1
2,7,78,9,4,5
2,7,79,7,15,-8
2,7,80,8,8,0
2,7,81,6,6,0
2,7,82,15,7,8
2,7,83,20,10,10
2,7,84,11,7,4
2,7,85,9,7,2
2,7,86,17,11,6
2,7,87,7,4,3
2,7,88,5,8,-3
2,7,89,9,5,4
2,7,90,10,7,3
2,7,91,9,8,1
2,7,92,2,4,-2
2,7,93,9,13,-4
2,7,94,19,9,10
2,7,95,12,11,1
2,7,96,15,13,2
2,7,97,9,16,-7
2,7,98,12,11,1
2,7,99,16,21,-5
2,7,100,14,10,4
2,7,101,2,5,-3
2,7,102,21,18,3
2,7,103,19,16,3
2,7,104,9,10,-1
2,7,105,11,11,0
2,7,106,2,9,-7
2,7,107,19,9,10
2,7,108,17,16,1
2,7,109,14,16,-2
2,7,110,18,7,11
2,7,111,10,14,-4
2,7,112,21,22,-1
2,7,113,9,17,-8
2,7,114,3,10,-7
2,7,115,9,1,8
2,7,116,14,10,4
2,7,117,20,12,8
2,7,118,21,14,7
2,7,119,18,10,8
2,7,120,21,15,6
2,7,121,4,10,-6
2,7,122,14,9,5
2,7,123,10,24,-14
2,7,124,11,8,3
2,7,125,13,10,3
2,7,126,13,18,-5
2,7,127,13,10,3
2,7,128,17,5,12
2,7,129,23,11,12
2,7,130,19,19,0
2,7,131,9,11,-2
2,7,132,12,15,-3
2,7,133,20,12,8
2,7,134,7,10,-3
2,7,135,6,7,-1
2,7,136,11,11,0
2,7,137,5,13,-8
2,7,138,10,12,-2
2,7,139,11,5,6
2,7,140,18,16,2
2,7,141,8,2,6
2,7,142,12,4,8
2,7,143,12,8,4
2,7,144,19,12,7
2,7,145,2,7,-5
2,7,146,11,12,-1
2,7,147,11,14,-3
2,7,148,11,6,5
2,7,149,19,13,6
2,7,150,5,8,-3
2,7,151,14,16,-2
2,7,152,5,18,-13
2,7,153,13,6,7
2,7,154,10,6,4
2,7,155,13,5,8
2,7,156,7,18,-11
2,7,157,14,9,5
2,7,158,10,4,6
2,7,159,14,2,12
2,7,160,7,10,-3
2,7,161,8,16,-8
2,7,162,8,5,3
2,7,163,6,13,-7
2,7,164,18,17,1
2,7,165,5,16,-11
2,7,166,10,13,-3
2,7,167,12,17,-5
2,7,168,9,5,4
2,7,169,2,20,-18
2,7,170,22,21,1
2,7,171,4,2,2
2,7,172,5,4,1
2,7,173,12,10,2
2,7,174,8,4,4
2,7,175,19,15,4
2,7,176,11,10,1
2,7,177,6,12,-6
2,7,178,14,5,9
2,7,179,9,3,6
2,7,180,8,8,0
2,7,181,2,5,-3
2,7,182,9,9,0
2,7,183,7,7,0
2,7,184,12,13,-1
2,7,185,20,10,10
2,7,186,3,8,-5
2,7,187,16,9,7
2,7,188,9,5,4
2,7,189,25,14,11
2,7,190,20,14,6
2,7,191,18,24,-6
2,7,192,20,3,17
2,7,193,7,11,-4
2,7,194,6,7,-1
2,7,195,9,5,4
2,7,196,8,17,-9
2,7,197,14,7,7
2,7,198,17,13,4
2,7,199,6,3,3
2,7,200,10,9,1
2,7,201,9,12,-3
2,7,202,9,6,3
2,7,203,6,5,1
2,7,204,10,12,-2
2,7,205,7,21,-14
2,7,206,6,7,-1
2,7,207,9,7,2
2,7,208,27,8,19
2,7,209,5,5,0
2,7,210,9,11,-2
2,7,211,9,13,-4
2,7,212,20,14,6
2,7,213,12,18,-6
2,7,214,7,13,-6
2,7,215,15,15,0
2,7,216,17,30,-13
2,7,217,12,9,3
2,7,218,17,20,-3
2,7,219,22,13,9
2,7,220,13,11,2
2,7,221,15,10,5
2,7,222,10,7,3
2,7,223,16,9,7
2,7,224,13,7,6
2,7,225,22,11,11
2,7,226,11,5,6
2,7,227,8,15,-7
2,7,228,6,15,-9
2,7,229,15,14,1
2,7,230,12,8,4
2,7,231,15,5,10
2,7,232,13,24,-11
2,7,233,8,0,8
2,7,234,12,4,8
2,7,235,6,11,-5
2,7,236,6,1,5
2,7,237,8,16,-8
2,7,238,17,8,9
2,7,239,12,7,5
2,7,240,17,17,0
2,7,241,27,6,21
2,7,242,15,11,4
2,7,243,19,20,-1
2,7,244,13,13,0
2,7,245,12,20,-8
2,7,246,14,19,-5
2,7,247,17,5,12
2,7,248,13,12,1
2,7,249,13,12,1
2,7,250,9,7,2
2,7,251,8,10,-2
2,7,252,10,5,5
2,7,253,10,10,0
2,7,254,7,14,-7
2,7,255,19,9,10
2,7,256,17,16,1
2,7,257,10,8,2
2,7,258,18,15,3
2,7,259,15,14,1
2,7,260,7,8,-1
2,7,261,10,14,-4
2,7,262,8,9,-1
2,7,263,13,10,3
2,7,264,18,19,-1
2,7,265,4,19,-15
2,7,266,7,10,-3
2,7,267,15,16,-1
2,7,268,14,19,-5
2,7,269,6,7,-1
2,7,270,5,17,-12
2,7,271,9,27,-18
2,7,272,6,8,-2
2,7,273,18,5,13
2,7,274,13,9,4
2,7,275,15,14,1
2,7,276,10,7,3
2,7,277,22,15,7
2,7,278,5,7,-2
2,7,279,5,11,-6
2,7,280,9,8,1
2,7,281,4,10,-6
2,7,282,23,15,8
2,7,283,16,19,-3
2,7,284,11,15,-4
2,7,285,4,2,2
2,7,286,13,26,-13
2,7,287,9,8,1
2,7,288,8,5,3
2,7,289,10,10,0
2,7,290,15,8,7
2,7,291,7,4,3
2,7,292,15,13,2
2,7,293,10,8,2
2,7,294,17,8,9
2,7,295,10,18,-8
2,7,296,15,7,8
2,7,297,12,8,4
2,7,298,8,6,2
2,7,299,5,10,-5
2,8,0,15,14,1
2,8,1,6,19,-13
2,8,2,10,13,-3
2,8,3,13,15,-2
2,8,4,21,9,12
2,8,5,19,13,6
2,8,6,7,3,4
2,8,7,11,6,5
2,8,8,4,2,2
2,8,9,20,11,9
2,8,10,11,9,2
2,8,11,5,4,1
2,8,12,10,13,-3
2,8,13,9,15,-6
2,8,14,15,10,5
2,8,15,9,9,0
2,8,16,21,16,5
2,8,17,12,12,0
2,8,18,17,20,-3
2,8,19,15,10,5
2,8,20,5,8,-3
2,8,21,10,5,5
2,8,22,11,1,10
2,8,23,19,12,7
2,8,24,11,21,-10
2,8,25,11,21,-10
2,8,26,5,14,-9
2,8,27,17,9,8
2,8,28,9,11,-2
2,8,29,16,12,4
2,8,30,13,8,5
2,8,31,22,31,-9
2,8,32,10,14,-4
2,8,33,19,13,6
2,8,34,7,11,-4
2,8,35,23,9,14
2,8,36,6,12,-6
2,8,37,26,24,2
2,8,38,32,21,11
2,8,39,7,5,2
2,8,40,21,23,-2
2,8,41,7,5,2
2,8,42,9,12,-3
2,8,43,14,4,10
2,8,44,3,6,-3
2,8,45,9,13,-4
2,8,46,16,4,12
2,8,47,12,15,-3
2,8,48,24,12,12
2,8,49,9,13,-4
2,8,50,7,8,-1
2,8,51,5,11,-6
2,8,52,7,3,4
2,8,53,8,14,-6
2,8,54,6,14,-8
2,8,55,13,7,6
2,8,56,18,15,3
2,8,57,9,6,3
2,8,58,12,8,4
2,8,59,9,12,-3
2,8,60,25,18,7
2,8,61,16,16,0
2,8,62,10,7,3
2,8,63,15,10,5
2,8,64,11,13,-2
2,8,65,20,16,4
2,8,66,3,6,-3
2,8,67,13,9,4
2,8,68,22,11,11
2,8,69,16,9,7
2,8,70,5,10,-5
2,8,71,15,7,8
2,8,72,18,15,3
2,8,73,18,6,12
2,8,74,26,24,2
2,8,75,13,24,-11
2,8,76,5,8,-3
2,8,77,13,15,-2
2,8,78,10,4,6
2,8,79,1,8,-7
2,8,80,8,13,-5
2,8,81,8,4,4
2,8,82,6,10,-4
2,8,83,22,14,8
2,8,84,15,18,-3
2,8,85,18,11,7
2,8,86,6,2,4
2,8,87,12,11,1
2,8,88,21,12,9
2,8,89,21,30,-9
2,8,90,12,12,0
2,8,91,10,16,-6
2,8,92,22,8,14
2,8,93,23,13,10
2,8,94,5,8,-3
2,8,95,9,20,-11
2,8,96,11,10,1
2,8,97,13,7,6
2,8,98,8,7,1
2,8,99,23,15,8
2,8,100,4,9,-5
2,8,101,15,11,4
2,8,102,8,5,3
2,8,103,9,19,-10
2,8,104,12,8,4
2,8,105,6,11,-5
2,8,106,6,9,-3
2,8,107,22,7,15
2,8,108,3,7,-4
2,8,109,16,9,7
2,8,110,12,11,1
2,8,111,9,8,1
2,8,112,12,16,-4
2,8,113,9,10,-1
2,8,114,4,5,-1
2,8,115,18,21,-3
2,8,116,15,9,6
2,8,117,23,19,4
2,8,118,12,8,4
2,8,119,14,12,2
2,8,120,7,10,-3
2,8,121,14,19,-5
2,8,122,9,7,2
2,8,123,6,10,-4
2,8,124,7,9,-2
2,8,125,7,5,2
2,8,126,6,5,1
2,8,127,15,11,4
2,8,128,9,6,3
2,8,129,23,14,9
2,8,130,9,11,-2
2,8,131,6,11,-5
2,8,132,28,20,8
2,8,133,17,9,8
2,8,134,21,14,7
2,8,135,9,26,-17
2,8,136,5,3,2
2,8,137,16,18,-2
2,8,138,12,21,-9
2,8,139,17,16,1
2,8,140,8,5,3
2,8,141,17,15,2
2,8,142,8,5,3
2,8,143,16,6,10
2,8,144,12,6,6
2,8,145,6,11,-5
2,8,146,6,7,-1
2,8,147,18,6,12
2,8,148,23,6,17
2,8,149,25,15,10
2,8,150,5,8,-3
2,8,151,7,9,-2
2,8,152,2,4,-2
2,8,153,8,8,0
2,8,154,14,9,5
2,8,155,11,13,-2
2,8,156,10,14,-4
2,8,157,11,22,-11
2,8,158,13,12,1
2,8,159,21,14,7
2,8,160,14,18,-4
2,8,161,18,12,6
2,8,162,8,6,2
2,8,163,8,9,-1
2,8,164,12,19,-7
2,8,165,6,10,-4
2,8,166,18,4,14
2,8,167,20,11,9
2,8,168,5,4,1
2,8,169,46,22,24
2,8,170,10,27,-17
2,8,171,8,2,6
2,8,172,14,4,10
2,8,173,7,4,3
2,8,174,22,12,10
2,8,175,15,10,5
2,8,176,14,14,0
2,8,177,15,13,2
2,8,178,13,12,1
2,8,179,12,15,-3
2,8,180,5,2,3
2,8,181,6,10,-4
2,8,182,13,8,5
2,8,183,14,13,1
2,8,184,5,3,2
2,8,185,18,12,6
2,8,186,13,31,-18
2,8,187,9,6,3
2,8,188,13,8,5
2,8,189,3,2,1
2,8,190,12,12,0
2,8,191,4,10,-6
2,8,192,8,7,1
2,8,193,10,20,-10
2,8,194,5,14,-9
2,8,195,9,12,-3
2,8,196,17,19,-2
2,8,197,21,11,10
2,8,198,13,10,3
2,8,199,14,18,-4
2,8,200,18,5,13
2,8,201,8,9,-1
2,8,202,9,10,-1
2,8,203,9,5,4
2,8,204,13,9,4
2,8,205,12,9,3
2,8,206,17,8,9
2,8,207,14,20,-6
2,8,208,14,8,6
2,8,209,11,19,-8
2,8,210,13,6,7
2,8,211,11,12,-1
2,8,212,14,8,6
2,8,213,8,8,0
2,8,214,14,9,5
2,8,215,15,12,3
2,8,216,4,7,-3
2,8,217,4,1,3
2,8,218,15,10,5
2,8,219,13,5,8
2,8,220,14,16,-2
2,8,221,13,12,1
2,8,222,11,11,0
2,8,223,9,4,5
2,8,224,16,8,8
2,8,225,12,14,-2
2,8,226,13,15,-2
2,8,227,5,5,0
2,8,228,23,13,10
2,8,229,23,16,7
2,8,230,11,12,-1
2,8,231,4,10,-6
2,8,232,9,17,-8
2,8,233,18,11,7
2,8,234,27,13,14
2,8,235,17,9,8
2,8,236,11,11,0
2,8,237,10,10,0
2,8,238,15,6,9
2,8,239,6,11,-5
2,8,240,23,7,16
2,8,241,15,10,5
2,8,242,18,12,6
2,8,243,13,14,-1
2,8,244,15,22,-7
2,8,245,19,18,1
2,8,246,6,8,-2
2,8,247,14,12,2
2,8,248,13,24,-11
2,8,249,14,3,11
2,8,250,16,11,5
2,8,251,15,14,1
2,8,252,2,3,-1
2,8,253,18,14,4
2,8,254,11,18,-7
2,8,255,24,15,9
2,8,256,9,4,5
2,8,257,11,2,9
2,8,258,14,12,2
2,8,259,20,24,-4
2,8,260,16,2,14
2,8,261,20,6,14
2,8,262,9,14,-5
2,8,263,10,8,2
2,8,264,6,18,-12
2,8,265,6,7,-1
2,8,266,12,7,5
2,8,267,8,9,-1
2,8,268,6,7,-1
2,8,269,14,16,-2
2,8,270,7,8,-1
2,8,271,8,6,2
2,8,272,15,14,1
2,8,273,28,20,8
2,8,274,12,6,6
2,8,275,12,20,-8
2,8,276,19,16,3
2,8,277,14,11,3
2,8,278,24,11,13
2,8,279,12,13,-1
2,8,280,11,23,-12
2,8,281,18,16,2
2,8,282,16,10,6
2,8,283,7,13,-6
2,8,284,22,17,5
2,8,285,10,10,0
2,8,286,4,3,1
2,8,287,10,4,6
2,8,288,18,18,0
2,8,289,20,7,13
2,8,290,13,14,-1
2,8,291,11,12,-1
2,8,292,5,17,-12
2,8,293,3,11,-8
2,8,294,11,6,5
2,8,295,10,17,-7
2,8,296,13,11,2
2,8,297,8,4,4
2,8,298,13,16,-3
2,8,299,12,16,-4
2,9,0,7,16,-9
2,9,1,15,10,5
2,9,2,24,6,18
2,9,3,26,9,17
2,9,4,15,9,6
2,9,5,13,6,7
2,9,6,9,13,-4
2,9,7,6,13,-7
2,9,8,26,14,12
2,9,9,10,6,4
2,9,10,16,15,1
2,9,11,7,1,6
2,9,12,13,9,4
2,9,13,3,8,-5
2,9,14,19,23,-4
2,9,15,10,8,2
2,9,16,12,8,4
2,9,17,21,18,3
2,9,18,4,9,-5
2,9,19,14,9,5
2,9,20,15,16,-1
2,9,21,6,5,1
2,9,22,9,14,-5
2,9,23,11,13,-2
2,9,24,24,16,8
2,9,25,11,10,1
2,9,26,17,12,5
2,9,27,21,14,7
2,9,28,15,5,10
2,9,29,15,8,7
2,9,30,14,8,6
2,9,31,8,17,-9
2,9,32,13,17,-4
2,9,33,10,16,-6
2,9,34,9,3,6
2,9,35,21,31,-10
2,9,36,6,4,2
2,9,37,8,6,2
2,9,38,18,11,7
2,9,39,11,7,4
2,9,40,15,17,-2
2,9,41,11,3,8
2,9,42,11,15,-4
2,9,43,15,3,12
2,9,44,10,10,0
2,9,45,19,18,1
2,9,46,7,3,4
2,9,47,10,6,4
2,9,48,14,10,4
2,9,49,7,14,-7
2,9,50,10,8,2
2,9,51,8,9,-1
2,9,52,11,5,6
2,9,53,17,18,-1
2,9,54,7,15,-8
2,9,55,10,10,0
2,9,56,10,10,0
2,9,57,16,16,0
2,9,58,25,12,13
2,9,59,22,13,9
2,9,60,11,11,0
2,9,61,11,7,4
2,9,62,16,3,13
2,9,63,11,19,-8
2,9,64,21,8,13
2,9,65,8,10,-2
2,9,66,12,7,5
2,9,67,26,2,24
2,9,68,9,10,-1
2,9,69,24,18,6
2,9,70,9,8,1
2,9,71,6,7,-1
2,9,72,7,7,0
2,9,73,10,12,-2
2,9,74,10,8,2
2,9,75,9,13,-4
2,9,76,21,19,2
2,9,77,6,4,2
2,9,78,4,7,-3
2,9,79,20,13,7
2,9,80,14,14,0
2,9,81,24,7,17
2,9,82,14,11,3
2,9,83,10,13,-3
2,9,84,20,19,1
2,9,85,14,21,-7
2,9,86,19,11,8
2,9,87,11,19,-8
2,9,88,10,17,-7
2,9,89,17,11,6
2,9,90,13,13,0
2,9,91,14,18,-4
2,9,92,20,20,0
2,9,93,27,5,22
2,9,94,28,22,6
2,9,95,15,19,-4
2,9,96,13,8,5
2,9,97,15,15,0
2,9,98,19,13,6
2,9,99,14,14,0
2,9,100,14,12,2
2,9,101,3,4,-1
2,9,102,6,4,2
2,9,103,8,9,-1
2,9,104,12,18,-6
2,9,105,13,18,-5
2,9,106,15,14,1
2,9,107,19,10,9
2,9,108,11,10,1
2,9,109,11,17,-6
2,9,110,11,11,0
2,9,111,29,6,23
2,9,112,11,5,6
2,9,113,6,5,1
2,9,114,16,8,8
2,9,115,12,11,1
2,9,116,22,11,11
2,9,117,9,8,1
2,9,118,11,13,-2
2,9,119,13,4,9
2,9,120,12,12,0
2,9,121,20,8,12
2,9,122,15,10,5
2,9,123,11,7,4
2,9,124,17,20,-3
2,9,125,9,12,-3
2,9,126,3,6,-3
2,9,127,5,10,-5
2,9,128,2,5,-3
2,9,129,12,10,2
2,9,130,20,19,1
2,9,131,20,12,8
2,9,132,7,10,-3
2,9,133,12,6,6
2,9,134,18,9,9
2,9,135,14,16,-2
2,9,136,15,10,5
2,9,137,16,24,-8
2,9,138,19,22,-3
2,9,139,10,6,4
2,9,140,16,6,10
2,9,141,7,16,-9
2,9,142,16,17,-1
2,9,143,12,15,-3
2,9,144,8,14,-6
2,9,145,18,11,7
2,9,146,12,13,-1
2,9,147,11,17,-6
2,9,148,5,4,1
2,9,149,3,7,-4
2,9,150,17,7,10
2,9,151,10,3,7
2,9,152,23,19,4
2,9,153,12,9,3
2,9,154,19,3,16
2,9,155,12,10,2
2,9,156,22,9,13
2,9,157,12,6,6
2,9,158,13,8,5
2,9,159,8,6,2
2,9,160,18,9,9
2,9,161,13,16,-3
2,9,162,16,25,-9
2,9,163,12,3,9
2,9,164,14,12,2
2,9,165,9,7,2
2,9,166,11,9,2
2,9,167,5,10,-5
2,9,168,15,11,4
2,9,169,31,22,9
2,9,170,11,10,1
2,9,171,17,14,3
2,9,172,12,5,7
2,9,173,6,3,3
2,9,174,11,6,5
2,9,175,16,11,5
2,9,176,13,14,-1
2,9,177,9,0,9
2,9,178,16,9,7
2,9,179,3,13,-10
2,9,180,24,18,6
2,9,181,14,10,4
2,9,182,6,5,1
2,9,183,16,18,-2
2,9,184,7,6,1
2,9,185,17,14,3
2,9,186,16,7,9
2,9,187,17,10,7
2,9,188,22,23,-1
2,9,189,24,20,4
2,9,190,12,14,-2
2,9,191,19,11,8
2,9,192,8,6,2
2,9,193,9,12,-3
2,9,194,11,8,3
2,9,195,8,7,1
2,9,196,9,10,-1
2,9,197,5,3,2
2,9,198,11,9,2
2,9,199,10,5,5
2,9,200,8,6,2
2,9,201,10,13,-3
2,9,202,13,13,0
2,9,203,14,15,-1
2,9,204,18,9,9
2,9,205,13,12,1
2,9,206,13,24,-11
2,9,207,13,13,0
2,9,208,6,13,-7
2,9,209,4,4,0
2,9,210,11,6,5
2,9,211,23,15,8
2,9,212,9,11,-2
2,9,213,9,14,-5
2,9,214,5,14,-9
2,9,215,10,5,5
2,9,216,21,11,10
2,9,217,11,3,8
2,9,218,14,11,3
2,9,219,18,21,-3
2,9,220,9,6,3
2,9,221,10,3,7
2,9,222,18,9,9
2,9,223,9,7,2
2,9,224,14,7,7
2,9,225,12,17,-5
2,9,226,18,9,9
2,9,227,17,6,11
2,9,228,21,7,14
2,9,229,16,13,3
2,9,230,15,15,0
2,9,231,5,4,1
2,9,232,23,17,6
2,9,233,10,8,2
2,9,234,19,10,9
2,9,235,22,21,1
2,9,236,5,1,4
2,9,237,11,10,1
2,9,238,16,14,2
2,9,239,10,1,9
2,9,240,13,9,4
2,9,241,10,13,-3
2,9,242,11,10,1
2,9,243,16,9,7
2,9,244,14,10,4
2,9,245,8,11,-3
2,9,246,16,21,-5
2,9,247,7,7,0
2,9,248,14,11,3
2,9,249,10,5,5
2,9,250,9,15,-6
2,9,251,17,7,10
2,9,252,9,6,3
2,9,253,20,10,10
2,9,254,16,15,1
2,9,255,3,2,1
2,9,256,2,2,0
2,9,257,18,13,5
2,9,258,9,13,-4
2,9,259,13,13,0
2,9,260,18,15,3
2,9,261,8,9,-1
2,9,262,17,12,5
2,9,263,18,4,14
2,9,264,14,22,-8
2,9,265,11,7,4
2,9,266,26,3,23
2,9,267,19,21,-2
2,9,268,9,5,4
2,9,269,25,9,16
2,9,270,8,11,-3
2,9,271,11,16,-5
2,9,272,10,7,3
2,9,273,9,2,7
2,9,274,10,10,0
2,9,275,14,17,-3
2,9,276,4,18,-14
2,9,277,16,13,3
2,9,278,12,4,8
2,9,279,13,9,4
2,9,280,19,19,0
2,9,281,16,15,1
2,9,282,7,6,1
2,9,283,1,9,-8
2,9,284,9,13,-4
2,9,285,19,14,5
2,9,286,23,10,13
2,9,287,12,11,1
2,9,288,5,8,-3
2,9,289,22,20,2
2,9,290,18,8,10
2,9,291,14,9,5
2,9,292,5,11,-6
2,9,293,18,11,7
2,9,294,6,22,-16
2,9,295,19,12,7
2,9,296,17,3,14
2,9,297,15,8,7
2,9,298,14,9,5
2,9,299,14,13,1
2,10,0,16,11,5
2,10,1,7,9,-2
2,10,2,9,14,-5
2,10,3,21,11,10
2,10,4,9,9,0
2,10,5,11,15,-4
2,10,6,13,2,11
2,10,7,16,8,8
2,10,8,9,15,-6
2,10,9,16,11,5
2,10,10,7,12,-5
2,10,11,6,8,-2
2,10,12,17,23,-6
2,10,13,10,2,8
2,10,14,24,21,3
2,10,15,14,15,-1
2,10,16,15,6,9
2,10,17,12,14,-2
2,10,18,8,4,4
2,10,19,5,8,-3
2,10,20,11,4,7
2,10,21,16,13,3
2,10,22,10,12,-2
2,10,23,9,11,-2
2,10,24,6,13,-7
2,10,25,5,4,1
2,10,26,6,9,-3
2,10,27,16,8,8
2,10,28,17,8,9
2,10,29,16,17,-1
2,10,30,24,24,0
2,10,31,13,12,1
2,10,32,18,13,5
2,10,33,5,8,-3
2,10,34,7,10,-3
2,10,35,7,11,-4
2,10,36,15,12,3
2,10,37,25,14,11
2,10,38,11,9,2
2,10,39,14,10,4
2,10,40,18,3,15
2,10,41,17,14,3
2,10,42,20,7,13
2,10,43,15,3,12
2,10,44,3,7,-4
2,10,45,6,8,-2
2,10,46,5,5,0
2,10,47,18,19,-1
2,10,48,16,17,-1
2,10,49,8,10,-2
2,10,50,3,1,2
2,10,51,18,10,8
2,10,52,15,15,0
2,10,53,19,23,-4
2,10,54,4,14,-10
2,10,55,17,11,6
2,10,56,18,12,6
2,10,57,11,5,6
2,10,58,10,7,3
2,10,59,10,11,-1
2,10,60,11,12,-1
2,10,61,3,3,0
2,10,62,14,13,1
2,10,63,11,9,2
2,10,64,15,15,0
2,10,65,14,7,7
2,10,66,22,15,7
2,10,67,7,5,2
2,10,68,9,12,-3
2,10,69,14,15,-1
2,10,70,15,13,2
2,10,71,14,10,4
2,10,72,18,17,1
2,10,73,6,11,-5
2,10,74,18,12,6
2,10,75,14,21,-7
2,10,76,19,14,5
2,10,77,16,18,-2
2,10,78,21,6,15
2,10,79,15,10,5
2,10,80,9,14,-5
2,10,81,7,10,-3
2,10,82,10,1,9
2,10,83,18,18,0
2,10,84,7,1,6
2,10,85,21,14,7
2,10,86,25,21,4
2,10,87,12,8,4
2,10,88,14,11,3
2,10,89,9,7,2
2,10,90,16,12,4
2,10,91,2,8,-6
2,10,92,18,10,8
2,10,93,13,15,-2
2,10,94,17,13,4
2,10,95,5,4,1
2,10,96,12,21,-9
2,10,97,16,13,3
2,10,98,17,5,12
2,10,99,5,4,1
2,10,100,12,15,-3
2,10,101,10,5,5
2,10,102,18,12,6
2,10,103,18,8,10
2,10,104,16,13,3
2,10,105,13,8,5
2,10,106,20,6,14
2,10,107,13,16,-3
2,10,108,16,5,11
2,10,109,11,15,-4
2,10,110,13,6,7
2,10,111,19,16,3
2,10,112,10,13,-3
2,10,113,18,20,-2
2,10,114,9,9,0
2,10,115,9,10,-1
2,10,116,13,3,10
2,10,117,23,12,11
2,10,118,7,2,5
2,10,119,13,8,5
2,10,120,20,10,10
2,10,121,16,9,7
2,10,122,11,20,-9
2,10,123,5,5,0
2,10,124,13,11,2
2,10,125,5,0,5
2,10,126,18,6,12
2,10,127,23,9,14
2,10,128,12,5,7
2,10,129,12,15,-3
2,10,130,14,10,4
2,10,131,4,5,-1
2,10,132,14,22,-8
2,10,133,23,13,10
2,10,134,20,10,10
2,10,135,3,14,-11
2,10,136,20,18,2
2,10,137,17,7,10
2,10,138,11,21,-10
2,10,139,13,8,5
2,10,140,15,16,-1
2,10,141,18,8,10
2,10,142,15,2,13
2,10,143,8,14,-6
2,10,144,10,7,3
2,10,145,6,9,-3
2,10,146,10,20,-10
2,10,147,15,8,7
2,10,148,7,11,-4
2,10,149,7,7,0
2,10,150,10,9,1
2,10,151,18,9,9
2,10,152,12,15,-3
2,10,153,25,12,13
2,10,154,9,4,5
2,10,155,15,10,5
2,10,156,7,9,-2
2,10,157,5,7,-2
2,10,158,14,14,0
2,10,159,17,17,0
2,10,160,10,7,3
2,10,161,11,7,4
2,10,162,12,10,2
2,10,163,6,8,-2
2,10,164,7,13,-6
2,10,165,12,2,10
2,10,166,23,9,14
2,10,167,21,10,11
2,10,168,18,8,10
2,10,169,7,12,-5
2,10,170,23,18,5
2,10,171,3,3,0
2,10,172,13,12,1
2,10,173,14,10,4
2,10,174,13,1,12
2,10,175,6,2,4
2,10,176,17,12,5
2,10,177,13,23,-10
2,10,178,4,3,1
2,10,179,18,17,1
2,10,180,10,12,-2
2,10,181,13,13,0
2,10,182,1,1,0
2,10,183,8,8,0
2,10,184,15,7,8
2,10,185,18,7,11
2,10,186,9,8,1
2,10,187,23,5,18
2,10,188,9,6,3
2,10,189,10,5,5
2,10,190,9,5,4
2,10,191,7,9,-2
2,10,192,21,3,18
2,10,193,6,11,-5
2,10,194,6,2,4
2,10,195,18,16,2
2,10,196,20,9,11
2,10,197,13,6,7
2,10,198,11,17,-6
2,10,199,11,9,2
2,10,200,18,9,9
2,10,201,16,13,3
2,10,202,16,15,1
2,10,203,4,9,-5
2,10,204,10,10,0
2,10,205,13,15,-2
2,10,206,10,18,-8
2,10,207,11,6,5
2,10,208,13,11,2
2,10,209,18,9,9
2,10,210,10,5,5
2,10,211,5,7,-2
2,10,212,10,11,-1
2,10,213,10,7,3
2,10,214,17,27,-10
2,10,215,17,8,9
2,10,216,12,9,3
2,10,217,3,9,-6
2,10,218,7,7,0
2,10,219,12,8,4
2,10,220,15,11,4
2,10,221,15,12,3
2,10,222,17,11,6
2,10,223,9,14,-5
2,10,224,9,5,4
2,10,225,23,16,7
2,10,226,13,20,-7
2,10,227,13,14,-1
2,10,228,19,12,7
2,10,229,16,16,0
2,10,230,6,8,-2
2,10,231,11,12,-1
2,10,232,9,11,-2
2,10,233,7,6,1
2,10,234,10,16,-6
2,10,235,25,22,3
2,10,236,31,8,23
2,10,237,10,7,3
2,10,238,9,8,1
2,10,239,13,11,2
2,10,240,16,10,6
2,10,241,15,11,4
2,10,242,12,12,0
2,10,243,5,9,-4
2,10,244,21,11,10
2,10,245,20,11,9
2,10,246,18,10,8
2,10,247,5,8,-3
2,10,248,7,8,-1
2,10,249,7,12,-5
2,10,250,14,9,5
2,10,251,13,9,4
2,10,252,12,15,-3
2,10,253,11,9,2
2,10,254,29,9,20
2,10,255,12,7,5
2,10,256,18,15,3
2,10,257,10,10,0
2,10,258,7,5,2
2,10,259,19,24,-5
2,10,260,10,5,5
2,10,261,22,12,10
2,10,262,11,3,8
2,10,263,16,16,0
2,10,264,18,11,7
2,10,265,10,12,-2
2,10,266,11,9,2
2,10,267,14,22,-8
2,10,268,12,14,-2
2,10,269,12,8,4
2,10,270,9,11,-2
2,10,271,14,14,0
2,10,272,9,4,5
2,10,273,5,7,-2
2,10,274,4,9,-5
2,10,275,22,14,8
2,10,276,14,14,0
2,10,277,12,13,-1
2,10,278,7,10,-3
2,10,279,8,8,0
2,10,280,12,11,1
2,10,281,16,14,2
2,10,282,17,15,2
2,10,283,18,18,0
2,10,284,16,7,9
2,10,285,13,7,6
2,10,286,12,11,1
2,10,287,9,7,2
2,10,288,9,5,4
2,10,289,21,17,4
2,10,290,13,10,3
2,10,291,11,12,-1
2,10,292,9,13,-4
2,10,293,13,7,6
2,10,294,5,6,-1
2,10,295,14,8,6
2,10,296,25,20,5
2,10,297,20,11,9
2,10,298,13,18,-5
2,10,299,16,14,2
2,11,0,10,16,-6
2,11,1,21,9,12
2,11,2,5,5,0
2,11,3,16,5,11
2,11,4,9,7,2
2,11,5,33,16,17
2,11,6,20,9,11
2,11,7,22,20,2
2,11,8,17,9,8
2,11,9,10,14,-4
2,11,10,13,23,-10
2,11,11,6,6,0
2,11,12,15,4,11
2,11,13,16,11,5
2,11,14,22,12,10
2,11,15,23,6,17
2,11,16,22,20,2
2,11,17,23,19,4
2,11,18,24,8,16
2,11,19,10,20,-10
2,11,20,11,8,3
2,11,21,5,15,-10
2,11,22,16,5,11
2,11,23,16,12,4
2,11,24,8,6,2
2,11,25,12,8,4
2,11,26,12,20,-8
2,11,27,7,8,-1
2,11,28,32,11,21
2,11,29,6,3,3
2,11,30,16,9,7
2,11,31,17,12,5
2,11,32,6,6,0
2,11,33,8,15,-7
2,11,34,17,12,5
2,11,35,11,10,1
2,11,36,18,19,-1
2,11,37,12,4,8
2,11,38,8,13,-5
2,11,39,17,14,3
2,11,40,18,14,4
2,11,41,15,10,5
2,11,42,14,6,8
2,11,43,13,16,-3
2,11,44,8,9,-1
2,11,45,11,12,-1
2,11,46,19,10,9
2,11,47,18,8,10
2,11,48,15,15,0
2,11,49,28,20,8
2,11,50,13,15,-2
2,11,51,16,6,10
2,11,52,14,16,-2
2,11,53,8,10,-2
2,11,54,16,11,5
2,11,55,12,7,5
2,11,56,11,5,6
2,11,57,17,9,8
2,11,58,12,5,7
2,11,59,24,12,12
2,11,60,12,7,5
2,11,61,17,5,12
2,11,62,15,10,5
2,11,63,15,11,4
2,11,64,15,8,7
2,11,65,14,11,3
2,11,66,21,27,-6
2,11,67,21,14,7
2,11,68,12,15,-3
2,11,69,9,7,2
2,11,70,16,4,12
2,11,71,7,6,1
2,11,72,13,17,-4
2,11,73,11,13,-2
2,11,74,16,6,10
2,11,75,7,7,0
2,11,76,25,21,4
2,11,77,21,7,14
2,11,78,22,18,4
2,11,79,4,9,-5
2,11,80,14,7,7
2,11,81,15,15,0
2,11,82,16,13,3
2,11,83,3,7,-4
2,11,84,18,7,11
2,11,85,11,14,-3
2,11,86,10,3,7
2,11,87,27,22,5
2,11,88,13,18,-5
2,11,89,12,7,5
2,11,90,15,3,12
2,11,91,20,17,3
2,11,92,34,14,20
2,11,93,10,7,3
2,11,94,17,9,8
2,11,95,30,20,10
2,11,96,19,14,5
2,11,97,4,4,0
2,11,98,5,7,-2
2,11,99,19,22,-3
2,11,100,13,6,7
2,11,101,12,11,1
2,11,102,7,4,3
2,11,103,1,4,-3
2,11,104,4,5,-1
2,11,105,12,17,-5
2,11,106,16,8,8
2,11,107,11,9,2
2,11,108,23,11,12
2,11,109,12,5,7
2,11,110,7,7,0
2,11,111,24,13,11
2,11,112,8,11,-3
2,11,113,15,17,-2
2,11,114,15,17,-2
2,11,115,33,14,19
2,11,116,13,14,-1
2,11,117,23,20,3
2,11,118,24,10,14
2,11,119,14,8,6
2,11,120,27,8,19
2,11,121,19,3,16
2,11,122,17,12,5
2,11,123,16,15,1
2,11,124,12,8,4
2,11,125,18,13,5
2,11,126,21,6,15
2,11,127,11,13,-2
2,11,128,7,9,-2
2,11,129,24,20,4
2,11,130,9,8,1
2,11,131,14,11,3
2,11,132,15,11,4
2,11,133,20,16,4
2,11,134,15,12,3
2,11,135,23,3,20
2,11,136,17,10,7
2,11,137,14,8,6
2,11,138,11,4,7
2,11,139,15,11,4
2,11,140,23,9,14
2,11,141,11,11,0
2,11,142,23,9,14
2,11,143,18,8,10
2,11,144,10,7,3
2,11,145,19,15,4
2,11,146,19,11,8
2,11,147,17,7,10
2,11,148,14,7,7
2,11,149,13,14,-1
2,11,150,8,16,-8
2,11,151,17,18,-1
2,11,152,9,9,0
2,11,153,9,8,1
2,11,154,14,14,0
2,11,155,9,4,5
2,11,156,13,19,-6
2,11,157,12,14,-2
2,11,158,10,3,7
2,11,159,7,9,-2
2,11,160,6,5,1
2,11,161,19,9,10
2,11,162,15,10,5
2,11,163,16,13,3
2,11,164,4,9,-5
2,11,165,21,12,9
2,11,166,10,10,0
2,11,167,20,16,4
2,11,168,3,6,-3
2,11,169,31,9,22
2,11,170,19,7,12
2,11,171,17,13,4
2,11,172,15,6,9
2,11,173,13,18,-5
2,11,174,17,13,4
2,11,175,15,11,4
2,11,176,16,19,-3
2,11,177,13,7,6
2,11,178,11,7,4
2,11,179,24,14,10
2,11,180,18,21,-3
2,11,181,12,18,-6
2,11,182,18,9,9
2,11,183,10,10,0
2,11,184,6,3,3
2,11,185,11,10,1
2,11,186,19,19,0
2,11,187,12,13,-1
2,11,188,6,5,1
2,11,189,9,10,-1
2,11,190,10,5,5
2,11,191,14,5,9
2,11,192,15,6,9
2,11,193,13,16,-3
2,11,194,17,8,9
2,11,195,12,10,2
2,11,196,23,8,15
2,11,197,7,10,-3
2,11,198,14,11,3
2,11,199,19,15,4
2,11,200,11,14,-3
2,11,201,22,24,-2
2,11,202,21,13,8
2,11,203,6,5,1
2,11,204,28,17,11
2,11,205,18,11,7
2,11,206,20,5,15
2,11,207,11,11,0
2,11,208,15,21,-6
2,11,209,25,15,10
2,11,210,21,16,5
2,11,211,15,13,2
2,11,212,14,11,3
2,11,213,16,6,10
2,11,214,18,13,5
2,11,215,16,5,11
2,11,216,19,4,15
2,11,217,14,15,-1
2,11,218,20,8,12
2,11,219,15,14,1
2,11,220,10,10,0
2,11,221,18,13,5
2,11,222,19,15,4
2,11,223,11,15,-4
2,11,224,14,11,3
2,11,225,9,14,-5
2,11,226,13,8,5
2,11,227,14,10,4
2,11,228,8,12,-4
2,11,229,14,11,3
2,11,230,28,15,13
2,11,231,16,16,0
2,11,232,16,11,5
2,11,233,8,9,-1
2,11,234,5,2,3
2,11,235,8,12,-4
2,11,236,14,19,-5
2,11,237,26,6,20
2,11,238,12,13,-1
2,11,239,13,8,5
2,11,240,8,18,-10
2,11,241,19,10,9
2,11,242,16,9,7
2,11,243,23,19,4
2,11,244,22,12,10
2,11,245,16,7,9
2,11,246,18,10,8
2,11,247,18,12,6
2,11,248,17,18,-1
2,11,249,18,10,8
2,11,250,5,10,-5
2,11,251,9,15,-6
2,11,252,11,9,2
2,11,253,10,10,0
2,11,254,14,8,6
2,11,255,22,16,6
2,11,256,12,7,5
2,11,257,14,20,-6
2,11,258,10,4,6
2,11,259,13,17,-4
2,11,260,17,13,4
2,11,261,6,5,1
2,11,262,10,7,3
2,11,263,9,7,2
2,11,264,9,9,0
2,11,265,21,11,10
2,11,266,20,8,12
2,11,267,14,14,0
2,11,268,14,12,2
2,11,269,23,8,15
2,11,270,26,9,17
2,11,271,9,14,-5
2,11,272,17,8,9
2,11,273,12,19,-7
2,11,274,13,9,4
2,11,275,11,12,-1
2,11,276,9,1,8
2,11,277,12,9,3
2,11,278,9,22,-13
2,11,279,8,15,-7
2,11,280,12,12,0
2,11,281,13,10,3
2,11,282,13,13,0
2,11,283,13,9,4
2,11,284,12,15,-3
2,11,285,18,19,-1
2,11,286,10,7,3
2,11,287,18,8,10
2,11,288,14,16,-2
2,11,289,18,16,2
2,11,290,19,17,2
2,11,291,6,11,-5
2,11,292,12,9,3
2,11,293,9,12,-3
2,11,294,16,9,7
2,11,295,16,9,7
2,11,296,21,8,13
2,11,297,11,8,3
2,11,298,17,14,3
2,11,299,5,14,-9
2,12,0,19,10,9
2,12,1,17,19,-2
2,12,2,18,11,7
2,12,3,9,3,6
2,12,4,22,14,8
2,12,5,11,26,-15
2,12,6,7,7,0
2,12,7,6,7,-1
2,12,8,17,21,-4
2,12,9,18,6,12
2,12,10,5,12,-7
2,12,11,8,11,-3
2,12,12,20,6,14
2,12,13,19,11,8
2,12,14,13,15,-2
2,12,15,20,6,14
2,12,16,14,11,3
2,12,17,13,15,-2
2,12,18,8,10,-2
2,12,19,13,9,4
2,12,20,14,10,4
2,12,21,10,8,2
2,12,22,15,7,8
2,12,23,15,30,-15
2,12,24,9,13,-4
2,12,25,10,8,2
2,12,26,14,9,5
2,12,27,26,22,4
2,12,28,13,10,3
2,12,29,17,6,11
2,12,30,16,3,13
2,12,31,11,15,-4
2,12,32,10,10,0
2,12,33,10,16,-6
2,12,34,15,4,11
2,12,35,12,10,2
2,12,36,14,15,-1
2,12,37,13,18,-5
2,12,38,10,17,-7
2,12,39,17,18,-1
2,12,40,20,4,16
2,12,41,11,9,2
2,12,42,19,5,14
2,12,43,15,17,-2
2,12,44,24,13,11
2,12,45,7,15,-8
2,12,46,10,9,1
2,12,47,10,4,6
2,12,48,18,11,7
2,12,49,20,8,12
2,12,50,12,14,-2
2,12,51,8,7,1
2,12,52,16,12,4
2,12,53,15,6,9
2,12,54,29,7,22
2,12,55,10,20,-10
2,12,56,16,22,-6
2,12,57,7,6,1
2,12,58,13,6,7
2,12,59,13,9,4
2,12,60,10,9,1
2,12,61,23,7,16
2,12,62,30,3,27
2,12,63,10,7,3
2,12,64,13,5,8
2,12,65,18,6,12
2,12,66,19,2,17
2,12,67,14,5,9
2,12,68,25,14,11
2,12,69,17,22,-5
2,12,70,21,8,13
2,12,71,24,8,16
2,12,72,21,11,10
2,12,73,21,14,7
2,12,74,7,12,-5
2,12,75,8,14,-6
2,12,76,24,15,9
2,12,77,9,8,1
2,12,78,13,8,5
2,12,79,6,7,-1
2,12,80,17,15,2
2,12,81,11,14,-3
2,12,82,11,7,4
2,12,83,16,12,4
2,12,84,27,8,19
2,12,85,14,10,4
2,12,86,4,11,-7
2,12,87,19,10,9
2,12,88,19,18,1
2,12,89,33,15,18
2,12,90,19,11,8
2,12,91,11,10,1
2,12,92,18,13,5
2,12,93,10,9,1
2,12,94,4,15,-11
2,12,95,18,11,7
2,12,96,16,15,1
2,12,97,7,1,6
2,12,98,12,5,7
2,12,99,16,13,3
2,12,100,11,9,2
2,12,101,5,8,-3
2,12,102,15,13,2
2,12,103,14,18,-4
2,12,104,5,8,-3
2,12,105,18,6,12
2,12,106,15,21,-6
2,12,107,19,12,7
2,12,108,11,11,0
2,12,109,13,7,6
2,12,110,14,4,10
2,12,111,16,13,3
2,12,112,22,15,7
2,12,113,10,8,2
2,12,114,21,7,14
2,12,115,19,7,12
2,12,116,8,7,1
2,12,117,12,11,1
2,12,118,19,12,7
2,12,119,22,20,2
2,12,120,19,10,9
2,12,121,14,16,-2
2,12,122,12,6,6
2,12,123,13,8,5
2,12,124,22,10,12
2,12,125,12,6,6
2,12,126,20,17,3
2,12,127,20,25,-5
2,12,128,20,5,15
2,12,129,8,6,2
2,12,130,13,9,4
2,12,131,16,14,2
2,12,132,20,8,12
2,12,133,17,13,4
2,12,134,16,13,3
2,12,135,29,12,17
2,12,136,7,11,-4
2,12,137,7,5,2
2,12,138,16,4,12
2,12,139,9,21,-12
2,12,140,13,5,8
2,12,141,17,9,8
2,12,142,17,16,1
2,12,143,4,7,-3
2,12,144,9,9,0
2,12,145,20,11,9
2,12,146,16,16,0
2,12,147,15,6,9
2,12,148,13,13,0
2,12,149,13,3,10
2,12,150,19,9,10
2,12,151,18,11,7
2,12,152,9,10,-1
2,12,153,20,5,15
2,12,154,17,10,7
2,12,155,7,8,-1
2,12,156,9,14,-5
2,12,157,21,19,2
2,12,158,23,14,9
2,12,159,14,16,-2
2,12,160,23,18,5
2,12,161,19,12,7
2,12,162,7,14,-7
2,12,163,20,3,17
2,12,164,13,12,1
2,12,165,12,20,-8
2,12,166,5,11,-6
2,12,167,19,2,17
2,12,168,15,14,1
2,12,169,21,12,9
2,12,170,6,13,-7
2,12,171,1,4,-3
2,12,172,13,14,-1
2,12,173,33,19,14
2,12,174,9,11,-2
2,12,175,10,14,-4
2,12,176,19,13,6
2,12,177,15,11,4
2,12,178,15,6,9
2,12,179,11,10,1
2,12,180,24,12,12
2,12,181,8,9,-1
2,12,182,6,8,-2
2,12,183,17,11,6
2,12,184,11,12,-1
2,12,185,11,9,2
2,12,186,16,15,1
2,12,187,20,14,6
2,12,188,21,7,14
2,12,189,14,6,8
2,12,190,9,10,-1
2,12,191,16,11,5
2,12,192,5,5,0
2,12,193,2,6,-4
2,12,194,16,13,3
2,12,195,23,16,7
2,12,196,11,9,2
2,12,197,10,10,0
2,12,198,16,6,10
2,12,199,9,10,-1
2,12,200,11,4,7
2,12,201,7,10,-3
2,12,202,7,5,2
2,12,203,25,23,2
2,12,204,24,10,14
2,12,205,17,9,8
2,12,206,12,16,-4
2,12,207,15,13,2
2,12,208,5,6,-1
2,12,209,14,14,0
2,12,210,15,19,-4
2,12,211,29,9,20
2,12,212,11,6,5
2,12,213,19,9,10
2,12,214,10,9,1
2,12,215,23,11,12
2,12,216,4,10,-6
2,12,217,16,5,11
2,12,218,26,14,12
2,12,219,12,17,-5
2,12,220,14,18,-4
2,12,221,12,7,5
2,12,222,15,10,5
2,12,223,20,14,6
2,12,224,26,14,12
2,12,225,13,11,2
2,12,226,5,5,0
2,12,227,26,18,8
2,12,228,9,10,-1
2,12,229,15,11,4
2,12,230,16,11,5
2,12,231,22,12,10
2,12,232,11,17,-6
2,12,233,15,9,6
2,12,234,10,7,3
2,12,235,11,7,4
2,12,236,15,9,6
2,12,237,18,14,4
2,12,238,10,8,2
2,12,239,11,11,0
2,12,240,12,9,3
2,12,241,15,21,-6
2,12,242,26,9,17
2,12,243,16,13,3
2,12,244,6,9,-3
2,12,245,13,7,6
2,12,246,15,11,4
2,12,247,16,24,-8
2,12,248,27,13,14
2,12,249,11,9,2
2,12,250,11,11,0
2,12,251,12,11,1
2,12,252,19,12,7
2,12,253,8,5,3
2,12,254,11,10,1
2,12,255,8,8,0
2,12,256,10,9,1
2,12,257,22,4,18
2,12,258,6,11,-5
2,12,259,14,6,8
2,12,260,11,10,1
2,12,261,8,12,-4
2,12,262,17,9,8
2,12,263,14,4,10
2,12,264,5,2,3
2,12,265,6,3,3
2,12,266,15,6,9
2,12,267,11,6,5
2,12,268,4,5,-1
2,12,269,14,12,2
2,12,270,11,5,6
2,12,271,17,13,4
2,12,272,19,11,8
2,12,273,14,7,7
2,12,274,16,10,6
2,12,275,15,13,2
2,12,276,16,8,8
2,12,277,15,2,13
2,12,278,12,17,-5
2,12,279,9,5,4
2,12,280,14,8,6
2,12,281,8,14,-6
2,12,282,19,16,3
2,12,283,11,11,0
2,12,284,9,19,-10
2,12,285,11,3,8
2,12,286,11,15,-4
2,12,287,5,5,0
2,12,288,16,9,7
2,12,289,9,9,0
2,12,290,4,12,-8
2,12,291,15,20,-5
2,12,292,13,11,2
2,12,293,8,8,0
2,12,294,10,1,9
2,12,295,12,8,4
2,12,296,6,5,1
2,12,297,12,7,5
2,12,298,11,6,5
2,12,299,13,7,6
2,13,0,16,13,3
2,13,1,16,15,1
2,13,2,14,18,-4
2,13,3,15,17,-2
2,13,4,5,6,-1
2,13,5,17,19,-2
2,13,6,13,12,1
2,13,7,15,18,-3
2,13,8,18,8,10
2,13,9,12,10,2
2,13,10,11,10,1
2,13,11,15,8,7
2,13,12,16,12,4
2,13,13,19,8,11
2,13,14,18,10,8
2,13,15,17,12,5
2,13,16,16,7,9
2,13,17,14,3,11
2,13,18,15,9,6
2,13,19,8,10,-2
2,13,20,12,11,1
2,13,21,11,9,2
2,13,22,19,10,9
2,13,23,27,20,7
2,13,24,17,7,10
2,13,25,7,5,2
2,13,26,8,7,1
2,13,27,14,10,4
2,13,28,13,14,-1
2,13,29,11,1,10
2,13,30,9,5,4
2,13,31,28,12,16
2,13,32,17,6,11
2,13,33,20,9,11
2,13,34,23,9,14
2,13,35,17,7,10
2,13,36,13,16,-3
2,13,37,6,1,5
2,13,38,20,6,14
2,13,39,25,10,15
2,13,40,18,6,12
2,13,41,20,16,4
2,13,42,21,7,14
2,13,43,20,16,4
2,13,44,22,14,8
2,13,45,9,5,4
2,13,46,22,14,8
2,13,47,14,13,1
2,13,48,30,16,14
2,13,49,7,3,4
2,13,50,16,7,9
2,13,51,15,24,-9
2,13,52,22,15,7
2,13,53,20,5,15
2,13,54,16,23,-7
2,13,55,12,12,0
2,13,56,17,20,-3
2,13,57,12,4,8
2,13,58,6,9,-3
2,13,59,16,4,12
2,13,60,25,26,-1
2,13,61,11,6,5
2,13,62,13,7,6
2,13,63,32,15,17
2,13,64,14,13,1
2,13,65,12,11,1
2,13,66,14,8,6
2,13,67,10,15,-5
2,13,68,16,21,-5
2,13,69,16,9,7
2,13,70,11,12,-1
2,13,71,19,11,8
2,13,72,27,6,21
2,13,73,10,24,-14
2,13,74,21,6,15
2,13,75,10,18,-8
2,13,76,19,17,2
2,13,77,15,14,1
2,13,78,26,7,19
2,13,79,25,9,16
2,13,80,4,6,-2
2,13,81,14,9,5
2,13,82,28,12,16
2,13,83,17,13,4
2,13,84,23,10,13
2,13,85,23,8,15
2,13,86,19,13,6
2,13,87,12,13,-1
2,13,88,7,5,2
2,13,89,3,15,-12
2,13,90,31,15,16
2,13,91,14,7,7
2,13,92,18,17,1
2,13,93,24,5,19
2,13,94,13,12,1
2,13,95,6,13,-7
2,13,96,19,8,11
2,13,97,22,15,7
2,13,98,19,13,6
2,13,99,19,9,10
2,13,100,7,0,7
2,13,101,10,14,-4
2,13,102,17,11,6
2,13,103,9,12,-3
2,13,104,13,14,-1
2,13,105,11,5,6
2,13,106,5,1,4
2,13,107,11,8,3
2,13,108,12,12,0
2,13,109,28,22,6
2,13,110,9,17,-8
2,13,111,19,9,10
2,13,112,15,11,4
2,13,113,18,5,13
2,13,114,17,8,9
2,13,115,18,8,10
2,13,116,4,9,-5
2,13,117,10,6,4
2,13,118,14,6,8
2,13,119,10,11,-1
2,13,120,5,3,2
2,13,121,14,6,8
2,13,122,10,2,8
2,13,123,21,18,3
2,13,124,18,4,14
2,13,125,22,9,13
2,13,126,15,11,4
2,13,127,4,8,-4
2,13,128,36,15,21
2,13,129,5,4,1
2,13,130,11,15,-4
2,13,131,9,1,8
2,13,132,16,7,9
2,13,133,17,9,8
2,13,134,12,15,-3
2,13,135,10,4,6
2,13,136,27,7,20
2,13,137,11,9,2
2,13,138,6,8,-2
2,13,139,8,13,-5
2,13,140,15,12,3
2,13,141,18,1,17
2,13,142,10,4,6
2,13,143,12,17,-5
2,13,144,14,9,5
2,13,145,8,10,-2
2,13,146,18,15,3
2,13,147,16,14,2
2,13,148,6,10,-4
2,13,149,7,6,1
2,13,150,21,9,12
2,13,151,13,12,1
2,13,152,19,13,6
2,13,153,16,8,8
2,13,154,20,11,9
2,13,155,22,12,10
2,13,156,13,5,8
2,13,157,5,13,-8
2,13,158,12,20,-8
2,13,159,13,6,7
2,13,160,31,12,19
2,13,161,21,16,5
2,13,162,22,11,11
2,13,163,15,15,0
2,13,164,19,5,14
2,13,165,3,12,-9
2,13,166,18,10,8
2,13,167,13,8,5
2,13,168,7,12,-5
2,13,169,2,9,-7
2,13,170,17,11,6
2,13,171,14,13,1
2,13,172,15,14,1
2,13,173,10,10,0
2,13,174,10,12,-2
2,13,175,12,12,0
2,13,176,8,5,3
2,13,177,8,5,3
2,13,178,6,4,2
2,13,179,24,19,5
2,13,180,11,5,6
2,13,181,8,14,-6
2,13,182,13,6,7
2,13,183,14,9,5
2,13,184,12,16,-4
2,13,185,14,17,-3
2,13,186,17,8,9
2,13,187,5,8,-3
2,13,188,18,13,5
2,13,189,10,10,0
2,13,190,10,24,-14
2,13,191,13,16,-3
2,13,192,6,10,-4
2,13,193,18,18,0
2,13,194,17,7,10
2,13,195,19,16,3
2,13,196,12,20,-8
2,13,197,14,4,10
2,13,198,14,17,-3
2,13,199,10,11,-1
2,13,200,8,11,-3
2,13,201,9,7,2
2,13,202,13,9,4
2,13,203,15,10,5
2,13,204,16,22,-6
2,13,205,20,16,4
2,13,206,24,13,11
2,13,207,3,7,-4
2,13,208,16,9,7
2,13,209,11,13,-2
2,13,210,9,14,-5
2,13,211,23,10,13
2,13,212,9,3,6
2,13,213,21,20,1
2,13,214,14,14,0
2,13,215,13,6,7
2,13,216,10,3,7
2,13,217,9,4,5
2,13,218,24,6,18
2,13,219,21,8,13
2,13,220,9,13,-4
2,13,221,16,21,-5
2,13,222,18,11,7
2,13,223,14,13,1
2,13,224,14,12,2
2,13,225,20,21,-1
2,13,226,17,23,-6
2,13,227,4,4,0
2,13,228,5,2,3
2,13,229,13,4,9
2,13,230,9,2,7
2,13,231,17,25,-8
2,13,232,15,6,9
2,13,233,14,13,1
2,13,234,9,9,0
2,13,235,25,17,8
2,13,236,25,10,15
2,13,237,10,5,5
2,13,238,24,29,-5
2,13,239,16,9,7
2,13,240,22,15,7
2,13,241,16,19,-3
2,13,242,20,9,11
2,13,243,13,12,1
2,13,244,10,9,1
2,13,245,10,14,-4
2,13,246,26,17,9
2,13,247,12,17,-5
2,13,248,15,5,10
2,13,249,4,8,-4
2,13,250,15,7,8
2,13,251,14,17,-3
2,13,252,19,17,2
2,13,253,15,12,3
2,13,254,33,11,22
2,13,255,18,8,10
2,13,256,10,10,0
2,13,257,14,13,1
2,13,258,14,10,4
2,13,259,8,8,0
2,13,260,15,12,3
2,13,261,5,4,1
2,13,262,9,16,-7
2,13,263,15,15,0
2,13,264,11,10,1
2,13,265,6,6,0
2,13,266,20,9,11
2,13,267,20,6,14
2,13,268,11,13,-2
2,13,269,22,9,13
2,13,270,11,8,3
2,13,271,11,9,2
2,13,272,7,4,3
2,13,273,14,7,7
2,13,274,9,6,3
2,13,275,14,10,4
2,13,276,12,5,7
2,13,277,16,3,13
2,13,278,23,8,15
2,13,279,15,7,8
2,13,280,15,4,11
2,13,281,18,12,6
2,13,282,11,9,2
2,13,283,24,16,8
2,13,284,21,12,9
2,13,285,13,20,-7
2,13,286,15,15,0
2,13,287,18,4,14
2,13,288,15,13,2
2,13,289,14,10,4
2,13,290,9,13,-4
2,13,291,15,16,-1
2,13,292,12,8,4
2,13,293,4,3,1
2,13,294,25,17,8
2,13,295,7,5,2
2,13,296,12,13,-1
2,13,297,18,6,12
2,13,298,24,8,16
2,13,299,9,13,-4
2,14,0,25,14,11
2,14,1,31,20,11
2,14,2,10,5,5
2,14,3,16,10,6
2,14,4,10,8,2
2,14,5,24,24,0
2,14,6,20,7,13
2,14,7,15,6,9
2,14,8,19,7,12
2,14,9,22,8,14
2,14,10,24,17,7
2,14,11,15,11,4
2,14,12,16,16,0
2,14,13,13,5,8
2,14,14,8,14,-6
2,14,15,23,13,10
2,14,16,12,11,1
2,14,17,12,14,-2
2,14,18,25,13,12
2,14,19,13,19,-6
2,14,20,14,3,11
2,14,21,13,9,4
2,14,22,17,9,8
2,14,23,13,16,-3
2,14,24,26,18,8
2,14,25,22,21,1
2,14,26,21,6,15
2,14,27,17,12,5
2,14,28,18,19,-1
2,14,29,6,10,-4
2,14,30,23,18,5
2,14,31,19,15,4
2,14,32,17,9,8
2,14,33,25,8,17
2,14,34,14,23,-9
2,14,35,14,12,2
2,14,36,17,2,15
2,14,37,12,14,-2
2,14,38,17,17,0
2,14,39,12,7,5
2,14,40,15,22,-7
2,14,41,7,10,-3
2,14,42,21,19,2
2,14,43,28,15,13
2,14,44,34,13,21
2,14,45,16,18,-2
2,14,46,16,17,-1
2,14,47,7,12,-5
2,14,48,20,12,8
2,14,49,16,13,3
2,14,50,4,7,-3
2,14,51,10,6,4
2,14,52,16,9,7
2,14,53,16,11,5
2,14,54,15,3,12
2,14,55,12,12,0
2,14,56,14,9,5
2,14,57,8,11,-3
2,14,58,9,7,2
2,14,59,12,14,-2
2,14,60,24,16,8
2,14,61,15,6,9
2,14,62,13,5,8
2,14,63,13,4,9
2,14,64,6,15,-9
2,14,65,24,19,5
2,14,66,13,15,-2
2,14,67,10,9,1
2,14,68,21,6,15
2,14,69,19,13,6
2,14,70,11,9,2
2,14,71,25,3,22
2,14,72,21,13,8
2,14,73,13,8,5
2,14,74,21,13,8
2,14,75,21,6,15
2,14,76,23,6,17
2,14,77,16,12,4
2,14,78,20,6,14
2,14,79,11,11,0
2,14,80,11,5,6
2,14,81,16,10,6
2,14,82,15,6,9
2,14,83,5,9,-4
2,14,84,4,5,-1
2,14,85,16,10,6
2,14,86,10,8,2
2,14,87,7,3,4
2,14,88,33,8,25
2,14,89,18,11,7
2,14,90,10,9,1
2,14,91,19,11,8
2,14,92,7,12,-5
2,14,93,12,4,8
2,14,94,10,12,-2
2,14,95,18,7,11
2,14,96,8,7,1
2,14,97,24,13,11
2,14,98,6,4,2
2,14,99,33,12,21
2,14,100,19,14,5
2,14,101,6,9,-3
2,14,102,27,14,13
2,14,103,12,8,4
2,14,104,10,9,1
2,14,105,20,13,7
2,14,106,15,7,8
2,14,107,9,0,9
2,14,108,14,16,-2
2,14,109,18,7,11
2,14,110,25,18,7
2,14,111,18,14,4
2,14,112,13,11,2
2,14,113,11,20,-9
2,14,114,15,11,4
2,14,115,14,8,6
2,14,116,6,9,-3
2,14,117,7,5,2
2,14,118,15,16,-1
2,14,119,12,14,-2
2,14,120,19,10,9
2,14,121,11,10,1
2,14,122,19,13,6
2,14,123,29,12,17
2,14,124,14,5,9
2,14,125,8,9,-1
2,14,126,13,9,4
2,14,127,15,6,9
2,14,128,8,6,2
2,14,129,21,18,3
2,14,130,8,15,-7
2,14,131,26,11,15
2,14,132,11,15,-4
2,14,133,7,6,1
2,14,134,12,10,2
2,14,135,30,13,17
2,14,136,43,22,21
2,14,137,18,15,3
2,14,138,18,9,9
2,14,139,17,15,2
2,14,140,17,5,12
2,14,141,14,13,1
2,14,142,15,13,2
2,14,143,19,12,7
2,14,144,8,10,-2
2,14,145,14,14,0
2,14,146,5,3,2
2,14,147,19,5,14
2,14,148,19,18,1
2,14,149,13,7,6
2,14,150,20,15,5
2,14,151,16,7,9
2,14,152,23,6,17
2,14,153,5,2,3
2,14,154,17,17,0
2,14,155,16,7,9
2,14,156,15,6,9
2,14,157,18,18,0
2,14,158,11,9,2
2,14,159,21,14,7
2,14,160,12,5,7
2,14,161,15,8,7
2,14,162,17,9,8
2,14,163,13,13,0
2,14,164,13,9,4
2,14,165,17,14,3
2,14,166,17,12,5
2,14,167,26,18,8
2,14,168,15,13,2
2,14,169,15,8,7
2,14,170,7,9,-2
2,14,171,6,8,-2
2,14,172,6,8,-2
2,14,173,24,20,4
2,14,174,26,10,16
2,14,175,30,9,21
2,14,176,16,6,10
2,14,177,23,15,8
2,14,178,23,8,15
2,14,179,5,8,-3
2,14,180,11,8,3
2,14,181,9,5,4
2,14,182,17,10,7
2,14,183,6,5,1
2,14,184,13,6,7
2,14,185,14,1,13
2,14,186,14,16,-2
2,14,187,15,10,5
2,14,188,10,4,6
2,14,189,11,13,-2
2,14,190,16,19,-3
2,14,191,16,2,14
2,14,192,3,10,-7
2,14,193,8,11,-3
2,14,194,7,9,-2
2,14,195,18,9,9
2,14,196,25,9,16
2,14,197,12,12,0
2,14,198,17,11,6
2,14,199,11,14,-3
2,14,200,16,8,8
2,14,201,8,12,-4
2,14,202,26,7,19
2,14,203,3,2,1
2,14,204,12,6,6
2,14,205,16,15,1
2,14,206,13,15,-2
2,14,207,24,8,16
2,14,208,7,3,4
2,14,209,11,8,3
2,14,210,6,1,5
2,14,211,8,7,1
2,14,212,15,11,4
2,14,213,11,2,9
2,14,214,21,13,8
2,14,215,23,15,8
2,14,216,13,6,7
2,14,217,12,5,7
2,14,218,20,9,11
2,14,219,15,15,0
2,14,220,21,12,9
2,14,221,5,13,-8
2,14,222,13,4,9
2,14,223,14,9,5
2,14,224,10,12,-2
2,14,225,20,12,8
2,14,226,4,5,-1
2,14,227,18,7,11
2,14,228,14,13,1
2,14,229,17,15,2
2,14,230,15,12,3
2,14,231,21,17,4
2,14,232,3,3,0
2,14,233,23,14,9
2,14,234,25,18,7
2,14,235,22,19,3
2,14,236,13,11,2
2,14,237,10,14,-4
2,14,238,8,7,1
2,14,239,32,20,12
2,14,240,7,5,2
2,14,241,14,6,8
2,14,242,10,9,1
2,14,243,19,13,6
2,14,244,14,7,7
2,14,245,20,13,7
2,14,246,11,6,5
2,14,247,14,11,3
2,14,248,13,19,-6
2,14,249,10,16,-6
2,14,250,24,28,-4
2,14,251,17,13,4
2,14,252,9,6,3
2,14,253,12,7,5
2,14,254,5,2,3
2,14,255,19,14,5
2,14,256,15,13,2
2,14,257,13,2,11
2,14,258,20,6,14
2,14,259,16,14,2
2,14,260,11,10,1
2,14,261,17,5,12
2,14,262,13,8,5
2,14,263,16,5,11
2,14,264,13,3,10
2,14,265,11,14,-3
2,14,266,7,7,0
2,14,267,13,7,6
2,14,268,14,6,8
2,14,269,16,8,8
2,14,270,7,2,5
2,14,271,21,19,2
2,14,272,14,16,-2
2,14,273,20,15,5
2,14,274,12,2,10
2,14,275,15,14,1
2,14,276,22,6,16
2,14,277,15,7,8
2,14,278,17,16,1
2,14,279,10,1,9
2,14,280,19,6,13
2,14,281,29,11,18
2,14,282,18,15,3
2,14,283,19,5,14
2,14,284,10,10,0
2,14,285,20,14,6
2,14,286,13,5,8
2,14,287,11,10,1
2,14,288,22,29,-7
2,14,289,17,8,9
2,14,290,16,15,1
2,14,291,11,5,6
2,14,292,22,12,10
2,14,293,4,6,-2
2,14,294,16,6,10
2,14,295,40,19,21
2,14,296,22,5,17
2,14,297,13,5,8
2,14,298,14,12,2
2,14,299,10,13,-3
2,15,0,24,6,18
2,15,1,10,15,-5
2,15,2,9,5,4
2,15,3,16,9,7
2,15,4,9,11,-2
2,15,5,10,12,-2
2,15,6,27,14,13
2,15,7,13,7,6
2,15,8,17,14,3
2,15,9,12,10,2
2,15,10,26,20,6
2,15,11,22,19,3
2,15,12,12,10,2
2,15,13,9,14,-5
2,15,14,9,7,2
2,15,15,21,11,10
2,15,16,11,6,5
2,15,17,19,14,5
2,15,18,19,14,5
2,15,19,16,4,12
2,15,20,19,19,0
2,15,21,10,13,-3
2,15,22,22,12,10
2,15,23,27,11,16
2,15,24,15,7,8
2,15,25,15,9,6
2,15,26,13,11,2
2,15,27,25,11,14
2,15,28,11,13,-2
2,15,29,10,12,-2
2,15,30,17,27,-10
2,15,31,32,21,11
2,15,32,17,10,7
2,15,33,12,6,6
2,15,34,15,8,7
2,15,35,10,6,4
2,15,36,16,21,-5
2,15,37,18,13,5
2,15,38,7,11,-4
2,15,39,9,11,-2
2,15,40,17,14,3
2,15,41,18,13,5
2,15,42,27,13,14
2,15,43,25,15,10
2,15,44,17,19,-2
2,15,45,27,16,11
2,15,46,9,11,-2
2,15,47,15,8,7
2,15,48,19,10,9
2,15,49,22,10,12
2,15,50,21,15,6
2,15,51,15,10,5
2,15,52,15,12,3
2,15,53,9,3,6
2,15,54,9,13,-4
2,15,55,22,11,11
2,15,56,6,11,-5
2,15,57,14,11,3
2,15,58,11,14,-3
2,15,59,13,4,9
2,15,60,7,14,-7
2,15,61,17,7,10
2,15,62,16,14,2
2,15,63,16,11,5
2,15,64,20,5,15
2,15,65,21,9,12
2,15,66,7,11,-4
2,15,67,22,11,11
2,15,68,11,8,3
2,15,69,28,18,10
2,15,70,21,5,16
2,15,71,32,10,22
2,15,72,22,8,14
2,15,73,16,2,14
2,15,74,4,5,-1
2,15,75,13,12,1
2,15,76,19,6,13
2,15,77,23,14,9
2,15,78,28,10,18
2,15,79,11,2,9
2,15,80,18,22,-4
2,15,81,17,5,12
2,15,82,13,11,2
2,15,83,14,10,4
2,15,84,10,8,2
2,15,85,22,12,10
2,15,86,18,11,7
2,15,87,29,9,20
2,15,88,9,6,3
2,15,89,13,5,8
2,15,90,13,16,-3
2,15,91,17,16,1
2,15,92,15,14,1
2,15,93,21,21,0
2,15,94,27,18,9
2,15,95,12,9,3
2,15,96,4,8,-4
2,15,97,8,13,-5
2,15,98,25,25,0
2,15,99,19,9,10
2,15,100,15,12,3
2,15,101,6,9,-3
2,15,102,13,6,7
2,15,103,9,12,-3
2,15,104,18,13,5
2,15,105,17,6,11
2,15,106,17,3,14
2,15,107,13,9,4
2,15,108,14,15,-1
2,15,109,14,13,1
2,15,110,19,11,8
2,15,111,13,14,-1
2,15,112,10,8,2
2,15,113,10,7,3
2,15,114,16,12,4
2,15,115,5,3,2
2,15,116,19,16,3
2,15,117,4,12,-8
2,15,118,19,16,3
2,15,119,19,16,3
2,15,120,8,8,0
2,15,121,19,4,15
2,15,122,5,10,-5
2,15,123,11,4,7
2,15,124,18,13,5
2,15,125,11,14,-3
2,15,126,6,8,-2
2,15,127,21,19,2
2,15,128,25,14,11
2,15,129,17,21,-4
2,15,130,8,4,4
2,15,131,14,20,-6
2,15,132,3,8,-5
2,15,133,14,9,5
2,15,134,5,7,-2
2,15,135,10,2,8
2,15,136,16,11,5
2,15,137,24,10,14
2,15,138,14,16,-2
2,15,139,11,5,6
2,15,140,21,12,9
2,15,141,19,14,5
2,15,142,6,3,3
2,15,143,10,10,0
2,15,144,10,6,4
2,15,145,26,16,10
2,15,146,8,7,1
2,15,147,15,11,4
2,15,148,9,8,1
2,15,149,23,11,12
2,15,150,4,10,-6
2,15,151,18,4,14
2,15,152,17,13,4
2,15,153,11,18,-7
2,15,154,8,8,0
2,15,155,11,13,-2
2,15,156,14,13,1
2,15,157,13,11,2
2,15,158,10,11,-1
2,15,159,14,11,3
2,15,160,23,8,15
2,15,161,15,13,2
2,15,162,17,10,7
2,15,163,11,9,2
2,15,164,9,13,-4
2,15,165,17,5,12
2,15,166,21,7,14
2,15,167,14,7,7
2,15,168,6,6,0
2,15,169,13,9,4
2,15,170,16,21,-5
2,15,171,13,14,-1
2,15,172,19,11,8
2,15,173,15,5,10
2,15,174,7,11,-4
2,15,175,3,3,0
2,15,176,6,2,4
2,15,177,6,8,-2
2,15,178,14,7,7
2,15,179,13,6,7
2,15,180,7,9,-2
2,15,181,18,9,9
2,15,182,9,5,4
2,15,183,4,4,0
2,15,184,12,15,-3
2,15,185,23,12,11
2,15,186,5,8,-3
2,15,187,20,9,11
2,15,188,8,11,-3
2,15,189,24,20,4
2,15,190,16,7,9
2,15,191,26,16,10
2,15,192,16,7,9
2,15,193,21,21,0
2,15,194,13,15,-2
2,15,195,12,10,2
2,15,196,14,10,4
2,15,197,22,10,12
2,15,198,31,16,15
2,15,199,6,6,0
2,15,200,7,6,1
2,15,201,16,12,4
2,15,202,14,17,-3
2,15,203,27,20,7
2,15,204,15,13,2
2,15,205,18,14,4
2,15,206,10,8,2
2,15,207,20,8,12
2,15,208,20,15,5
2,15,209,5,2,3
2,15,210,4,14,-10
2,15,211,14,13,1
2,15,212,9,0,9
2,15,213,15,28,-13
2,15,214,13,9,4
2,15,215,21,5,16
2,15,216,19,7,12
2,15,217,0,9,-9
2,15,218,12,8,4
2,15,219,17,6,11
2,15,220,22,14,8
2,15,221,18,4,14
2,15,222,17,5,12
2,15,223,8,6,2
2,15,224,10,7,3
2,15,225,8,11,-3
2,15,226,13,10,3
2,15,227,15,7,8
2,15,228,25,20,5
2,15,229,14,4,10
2,15,230,16,18,-2
2,15,231,3,6,-3
2,15,232,12,9,3
2,15,233,17,19,-2
2,15,234,19,14,5
2,15,235,11,18,-7
2,15,236,18,15,3
2,15,237,18,14,4
2,15,238,9,10,-1
2,15,239,13,5,8
2,15,240,11,8,3
2,15,241,17,9,8
2,15,242,23,10,13
2,15,243,23,13,10
2,15,244,13,2,11
2,15,245,21,10,11
2,15,246,9,5,4
2,15,247,24,12,12
2,15,248,23,9,14
2,15,249,17,17,0
2,15,250,21,8,13
2,15,251,20,7,13
2,15,252,16,7,9
2,15,253,17,5,12
2,15,254,15,15,0
2,15,255,13,6,7
2,15,256,13,6,7
2,15,257,15,6,9
2,15,258,23,14,9
2,15,259,9,12,-3
2,15,260,17,7,10
2,15,261,18,18,0
2,15,262,19,9,10
2,15,263,21,11,10
2,15,264,9,8,1
2,15,265,13,12,1
2,15,266,16,7,9
2,15,267,4,8,-4
2,15,268,16,15,1
2,15,269,19,6,13
2,15,270,18,20,-2
2,15,271,8,6,2
2,15,272,13,8,5
2,15,273,17,14,3
2,15,274,18,16,2
2,15,275,12,5,7
2,15,276,17,11,6
2,15,277,24,20,4
2,15,278,26,19,7
2,15,279,22,19,3
2,15,280,15,7,8
2,15,281,5,7,-2
2,15,282,28,18,10
2,15,283,10,15,-5
2,15,284,11,11,0
2,15,285,10,6,4
2,15,286,5,8,-3
2,15,287,21,14,7
2,15,288,12,8,4
2,15,289,19,8,11
2,15,290,14,8,6
2,15,291,23,19,4
2,15,292,12,6,6
2,15,293,13,17,-4
2,15,294,11,7,4
2,15,295,2,4,-2
2,15,296,16,19,-3
2,15,297,21,13,8
2,15,298,11,7,4
2,15,299,14,15,-1
2,16,0,7,6,1
2,16,1,8,1,7
2,16,2,8,10,-2
2,16,3,21,13,8
2,16,4,12,9,3
2,16,5,13,4,9
2,16,6,26,11,15
2,16,7,20,5,15
2,16,8,18,13,5
2,16,9,10,7,3
2,16,10,7,9,-2
2,16,11,6,9,-3
2,16,12,18,15,3
2,16,13,15,12,3
2,16,14,19,7,12
2,16,15,9,12,-3
2,16,16,8,4,4
2,16,17,14,9,5
2,16,18,19,8,11
2,16,19,4,4,0
2,16,20,25,4,21
2,16,21,17,6,11
2,16,22,14,11,3
2,16,23,17,19,-2
2,16,24,13,5,8
2,16,25,9,6,3
2,16,26,9,9,0
2,16,27,10,4,6
2,16,28,32,6,26
2,16,29,23,6,17
2,16,30,26,1,25
2,16,31,13,10,3
2,16,32,13,9,4
2,16,33,15,12,3
2,16,34,29,7,22
2,16,35,14,7,7
2,16,36,13,9,4
2,16,37,8,12,-4
2,16,38,6,17,-11
2,16,39,18,6,12
2,16,40,18,3,15
2,16,41,22,13,9
2,16,42,23,7,16
2,16,43,18,9,9
2,16,44,5,4,1
2,16,45,12,12,0
2,16,46,11,8,3
2,16,47,17,12,5
2,16,48,17,5,12
2,16,49,9,10,-1
2,16,50,11,8,3
2,16,51,17,11,6
2,16,52,35,21,14
2,16,53,22,22,0
2,16,54,22,17,5
2,16,55,13,9,4
2,16,56,22,14,8
2,16,57,27,11,16
2,16,58,12,11,1
2,16,59,13,14,-1
2,16,60,22,12,10
2,16,61,6,6,0
2,16,62,16,17,-1
2,16,63,12,10,2
2,16,64,10,11,-1
2,16,65,22,24,-2
2,16,66,26,6,20
2,16,67,22,7,15
2,16,68,6,6,0
2,16,69,15,13,2
2,16,70,22,19,3
2,16,71,17,10,7
2,16,72,10,6,4
2,16,73,19,20,-1
2,16,74,11,9,2
2,16,75,15,9,6
2,16,76,4,7,-3
2,16,77,10,4,6
2,16,78,22,5,17
2,16,79,14,7,7
2,16,80,10,10,0
2,16,81,35,23,12
2,16,82,9,8,1
2,16,83,10,18,-8
2,16,84,16,7,9
2,16,85,6,2,4
2,16,86,13,5,8
2,16,87,11,13,-2
2,16,88,11,16,-5
2,16,89,19,21,-2
2,16,90,16,10,6
2,16,91,13,5,8
2,16,92,38,13,25
2,16,93,19,14,5
2,16,94,19,12,7
2,16,95,7,6,1
2,16,96,9,10,-1
2,16,97,12,14,-2
2,16,98,11,14,-3
2,16,99,13,16,-3
2,16,100,15,7,8
2,16,101,17,15,2
2,16,102,12,7,5
2,16,103,15,13,2
2,16,104,20,24,-4
2,16,105,8,7,1
2,16,106,16,5,11
2,16,107,10,8,2
2,16,108,19,7,12
2,16,109,27,10,17
2,16,110,15,8,7
2,16,111,26,12,14
2,16,112,17,4,13
2,16,113,15,4,11
2,16,114,20,7,13
2,16,115,19,16,3
2,16,116,5,4,1
2,16,117,32,4,28
2,16,118,25,10,15
2,16,119,20,19,1
2,16,120,4,7,-3
2,16,121,4,3,1
2,16,122,12,10,2
2,16,123,20,15,5
2,16,124,16,9,7
2,16,125,29,16,13
2,16,126,14,11,3
2,16,127,7,5,2
2,16,128,11,3,8
2,16,129,15,11,4
2,16,130,19,12,7
2,16,131,10,1,9
2,16,132,13,7,6
2,16,133,22,17,5
2,16,134,20,16,4
2,16,135,20,9,11
2,16,136,27,10,17
2,16,137,16,19,-3
2,16,138,15,17,-2
2,16,139,17,7,10
2,16,140,16,5,11
2,16,141,19,12,7
2,16,142,6,2,4
2,16,143,12,6,6
2,16,144,8,8,0
2,16,145,14,10,4
2,16,146,16,6,10
2,16,147,12,8,4
2,16,148,19,7,12
2,16,149,17,16,1
2,16,150,11,11,0
2,16,151,15,15,0
2,16,152,21,15,6
2,16,153,5,6,-1
2,16,154,12,8,4
2,16,155,15,8,7
2,16,156,14,11,3
2,16,157,19,12,7
2,16,158,26,10,16
2,16,159,18,6,12
2,16,160,20,13,7
2,16,161,9,10,-1
2,16,162,15,2,13
2,16,163,5,14,-9
2,16,164,12,14,-2
2,16,165,17,8,9
2,16,166,14,5,9
2,16,167,15,5,10
2,16,168,16,10,6
2,16,169,17,11,6
2,16,170,8,6,2
2,16,171,23,16,7
2,16,172,21,9,12
2,16,173,14,13,1
2,16,174,23,10,13
2,16,175,8,5,3
2,16,176,13,18,-5
2,16,177,11,3,8
2,16,178,8,6,2
2,16,179,11,2,9
2,16,180,5,7,-2
2,16,181,10,7,3
2,16,182,20,18,2
2,16,183,26,11,15
2,16,184,14,7,7
2,16,185,9,6,3
2,16,186,10,0,10
2,16,187,17,6,11
2,16,188,15,13,2
2,16,189,16,11,5
2,16,190,22,9,13
2,16,191,15,10,5
2,16,192,21,5,16
2,16,193,12,20,-8
2,16,194,5,6,-1
2,16,195,14,13,1
2,16,196,10,15,-5
2,16,197,27,15,12
2,16,198,10,9,1
2,16,199,10,15,-5
2,16,200,8,8,0
2,16,201,9,8,1
2,16,202,19,3,16
2,16,203,14,8,6
2,16,204,9,8,1
2,16,205,21,22,-1
2,16,206,12,3,9
2,16,207,34,12,22
2,16,208,16,8,8
2,16,209,15,3,12
2,16,210,12,7,5
2,16,211,9,5,4
2,16,212,9,6,3
2,16,213,13,2,11
2,16,214,36,9,27
2,16,215,18,9,9
2,16,216,16,24,-8
2,16,217,10,4,6
2,16,218,15,10,5
2,16,219,9,7,2
2,16,220,3,5,-2
2,16,221,16,5,11
2,16,222,21,7,14
2,16,223,11,7,4
2,16,224,14,14,0
2,16,225,11,13,-2
2,16,226,20,22,-2
2,16,227,9,8,1
2,16,228,12,12,0
2,16,229,24,10,14
2,16,230,12,5,7
2,16,231,8,5,3
2,16,232,8,5,3
2,16,233,16,6,10
2,16,234,14,9,5
2,16,235,21,11,10
2,16,236,19,9,10
2,16,237,13,7,6
2,16,238,11,7,4
2,16,239,19,9,10
2,16,240,19,6,13
2,16,241,20,8,12
2,16,242,23,8,15
2,16,243,17,11,6
2,16,244,18,17,1
2,16,245,14,13,1
2,16,246,11,10,1
2,16,247,16,10,6
2,16,248,30,13,17
2,16,249,24,6,18
2,16,250,14,7,7
2,16,251,27,15,12
2,16,252,19,13,6
2,16,253,14,6,8
2,16,254,13,14,-1
2,16,255,15,12,3
2,16,256,2,3,-1
2,16,257,8,4,4
2,16,258,24,14,10
2,16,259,12,6,6
2,16,260,6,6,0
2,16,261,21,11,10
2,16,262,19,11,8
2,16,263,20,4,16
2,16,264,8,2,6
2,16,265,12,2,10
2,16,266,9,5,4
2,16,267,5,6,-1
2,16,268,26,15,11
2,16,269,21,15,6
2,16,270,13,15,-2
2,16,271,13,5,8
2,16,272,19,8,11
2,16,273,10,15,-5
2,16,274,16,18,-2
2,16,275,20,14,6
2,16,276,8,19,-11
2,16,277,4,16,-12
2,16,278,20,8,12
2,16,279,20,18,2
2,16,280,12,14,-2
2,16,281,10,11,-1
2,16,282,15,10,5
2,16,283,16,9,7
2,16,284,15,2,13
2,16,285,9,8,1
2,16,286,8,6,2
2,16,287,17,12,5
2,16,288,23,11,12
2,16,289,21,20,1
2,16,290,14,6,8
2,16,291,14,8,6
2,16,292,22,10,12
2,16,293,17,14,3
2,16,294,11,5,6
2,16,295,17,12,5
2,16,296,19,11,8
2,16,297,24,22,2
2,16,298,15,23,-8
2,16,299,12,15,-3
2,17,0,18,24,-6
2,17,1,5,5,0
2,17,2,10,6,4
2,17,3,16,7,9
2,17,4,5,7,-2
2,17,5,23,14,9
2,17,6,29,17,12
2,17,7,13,19,-6
2,17,8,8,6,2
2,17,9,16,6,10
2,17,10,4,4,0
2,17,11,14,9,5
2,17,12,8,7,1
2,17,13,26,17,9
2,17,14,7,18,-11
2,17,15,21,10,11
2,17,16,24,14,10
2,17,17,6,5,1
2,17,18,17,6,11
2,17,19,25,15,10
2,17,20,27,3,24
2,17,21,10,4,6
2,17,22,6,11,-5
2,17,23,13,12,1
2,17,24,7,5,2
2,17,25,30,13,17
2,17,26,11,14,-3
2,17,27,5,5,0
2,17,28,24,11,13
2,17,29,11,2,9
2,17,30,10,6,4
2,17,31,6,4,2
2,17,32,14,8,6
2,17,33,11,5,6
2,17,34,23,16,7
2,17,35,21,8,13
2,17,36,11,10,1
2,17,37,12,11,1
2,17,38,11,10,1
2,17,39,14,8,6
2,17,40,8,7,1
2,17,41,10,9,1
2,17,42,3,2,1
2,17,43,12,5,7
2,17,44,15,6,9
2,17,45,20,19,1
2,17,46,17,10,7
2,17,47,14,14,0
2,17,48,19,4,15
2,17,49,16,14,2
2,17,50,16,2,14
2,17,51,21,16,5
2,17,52,24,11,13
2,17,53,16,9,7
2,17,54,17,15,2
2,17,55,4,11,-7
2,17,56,14,11,3
2,17,57,7,4,3
2,17,58,26,14,12
2,17,59,17,7,10
2,17,60,13,9,4
2,17,61,24,7,17
2,17,62,10,19,-9
2,17,63,9,4,5
2,17,64,37,16,21
2,17,65,5,10,-5
2,17,66,18,11,7
2,17,67,23,10,13
2,17,68,14,16,-2
2,17,69,14,2,12
2,17,70,9,5,4
2,17,71,4,9,-5
2,17,72,19,15,4
2,17,73,16,5,11
2,17,74,13,10,3
2,17,75,13,7,6
2,17,76,21,9,12
2,17,77,15,5,10
2,17,78,23,15,8
2,17,79,29,11,18
2,17,80,21,4,17
2,17,81,21,10,11
2,17,82,8,1,7
2,17,83,21,17,4
2,17,84,28,10,18
2,17,85,12,8,4
2,17,86,5,6,-1
2,17,87,21,11,10
2,17,88,41,14,27
2,17,89,14,12,2
2,17,90,12,11,1
2,17,91,34,10,24
2,17,92,3,5,-2
2,17,93,25,14,11
2,17,94,10,7,3
2,17,95,16,25,-9
2,17,96,24,6,18
2,17,97,14,5,9
2,17,98,17,15,2
2,17,99,16,11,5
2,17,100,20,4,16
2,17,101,17,8,9
2,17,102,20,12,8
2,17,103,14,10,4
2,17,104,25,13,12
2,17,105,18,10,8
2,17,106,13,14,-1
2,17,107,14,8,6
2,17,108,10,9,1
2,17,109,4,6,-2
2,17,110,13,3,10
2,17,111,8,12,-4
2,17,112,14,13,1
2,17,113,28,12,16
2,17,114,24,12,12
2,17,115,15,10,5
2,17,116,13,19,-6
2,17,117,10,7,3
2,17,118,9,10,-1
2,17,119,8,15,-7
2,17,120,17,13,4
2,17,121,21,7,14
2,17,122,9,5,4
2,17,123,15,5,10
2,17,124,10,11,-1
2,17,125,24,9,15
2,17,126,9,8,1
2,17,127,16,5,11
2,17,128,18,11,7
2,17,129,13,13,0
2,17,130,21,11,10
2,17,131,23,12,11
2,17,132,30,6,24
2,17,133,9,13,-4
2,17,134,18,7,11
2,17,135,21,14,7
2,17,136,26,8,18
2,17,137,15,20,-5
2,17,138,9,6,3
2,17,139,13,4,9
2,17,140,8,11,-3
2,17,141,17,2,15
2,17,142,28,15,13
2,17,143,11,10,1
2,17,144,11,11,0
2,17,145,13,19,-6
2,17,146,8,9,-1
2,17,147,26,4,22
2,17,148,10,8,2
2,17,149,16,6,10
2,17,150,16,8,8
2,17,151,10,7,3
2,17,152,11,7,4
2,17,153,19,7,12
2,17,154,24,11,13
2,17,155,34,9,25
2,17,156,18,12,6
2,17,157,11,5,6
2,17,158,11,3,8
2,17,159,10,5,5
2,17,160,5,7,-2
2,17,161,10,11,-1
2,17,162,21,15,6
2,17,163,17,5,12
2,17,164,31,24,7
2,17,165,21,14,7
2,17,166,21,7,14
2,17,167,13,7,6
2,17,168,7,7,0
2,17,169,13,9,4
2,17,170,15,7,8
2,17,171,13,10,3
2,17,172,28,13,15
2,17,173,20,12,8
2,17,174,15,11,4
2,17,175,23,21,2
2,17,176,4,6,-2
2,17,177,22,13,9
2,17,178,17,8,9
2,17,179,14,8,6
2,17,180,14,7,7
2,17,181,12,12,0
2,17,182,16,3,13
2,17,183,23,8,15
2,17,184,19,5,14
2,17,185,17,4,13
2,17,186,11,9,2
2,17,187,18,12,6
2,17,188,13,4,9
2,17,189,18,17,1
2,17,190,29,25,4
2,17,191,12,3,9
2,17,192,10,8,2
2,17,193,4,4,0
2,17,194,9,4,5
2,17,195,17,10,7
2,17,196,3,9,-6
2,17,197,24,4,20
2,17,198,8,5,3
2,17,199,14,11,3
2,17,200,10,10,0
2,17,201,9,5,4
2,17,202,19,18,1
2,17,203,22,8,14
2,17,204,18,12,6
2,17,205,16,7,9
2,17,206,12,6,6
2,17,207,11,11,0
2,17,208,24,14,10
2,17,209,13,5,8
2,17,210,15,11,4
2,17,211,11,12,-1
2,17,212,17,11,6
2,17,213,4,5,-1
2,17,214,20,10,10
2,17,215,17,11,6
2,17,216,17,2,15
2,17,217,10,9,1
2,17,218,14,1,13
2,17,219,5,3,2
2,17,220,17,13,4
2,17,221,19,14,5
2,17,222,22,20,2
2,17,223,19,6,13
2,17,224,23,7,16
2,17,225,12,8,4
2,17,226,11,8,3
2,17,227,8,2,6
2,17,228,27,10,17
2,17,229,21,6,15
2,17,230,19,10,9
2,17,231,16,15,1
2,17,232,9,7,2
2,17,233,23,5,18
2,17,234,29,4,25
2,17,235,14,10,4
2,17,236,11,7,4
2,17,237,17,8,9
2,17,238,4,17,-13
2,17,239,9,13,-4
2,17,240,24,9,15
2,17,241,25,11,14
2,17,242,25,17,8
2,17,243,14,8,6
2,17,244,33,20,13
2,17,245,13,7,6
2,17,246,8,16,-8
2,17,247,23,18,5
2,17,248,15,7,8
2,17,249,14,18,-4
2,17,250,8,10,-2
2,17,251,13,16,-3
2,17,252,30,16,14
2,17,253,14,7,7
2,17,254,21,18,3
2,17,255,18,30,-12
2,17,256,28,14,14
2,17,257,21,5,16
2,17,258,11,22,-11
2,17,259,20,6,14
2,17,260,19,7,12
2,17,261,17,14,3
2,17,262,5,10,-5
2,17,263,14,6,8
2,17,264,20,12,8
2,17,265,7,7,0
2,17,266,21,11,10
2,17,267,13,7,6
2,17,268,6,9,-3
2,17,269,14,12,2
2,17,270,15,8,7
2,17,271,12,5,7
2,17,272,9,8,1
2,17,273,15,12,3
2,17,274,12,17,-5
2,17,275,20,9,11
2,17,276,5,7,-2
2,17,277,4,2,2
2,17,278,16,13,3
2,17,279,23,8,15
2,17,280,20,4,16
2,17,281,20,11,9
2,17,282,12,14,-2
2,17,283,20,8,12
2,17,284,20,6,14
2,17,285,9,6,3
2,17,286,12,12,0
2,17,287,18,7,11
2,17,288,17,10,7
2,17,289,22,7,15
2,17,290,11,6,5
2,17,291,9,5,4
2,17,292,13,18,-5
2,17,293,6,9,-3
2,17,294,16,7,9
2,17,295,18,9,9
2,17,296,9,3,6
2,17,297,13,5,8
2,17,298,21,19,2
2,17,299,5,7,-2
2,18,0,13,11,2
2,18,1,11,5,6
2,18,2,19,11,8
2,18,3,31,8,23
2,18,4,6,10,-4
2,18,5,10,4,6
2,18,6,11,2,9
2,18,7,18,0,18
2,18,8,20,9,11
2,18,9,10,16,-6
2,18,10,15,10,5
2,18,11,16,7,9
2,18,12,10,6,4
2,18,13,30,18,12
2,18,14,10,7,3
2,18,15,9,6,3
2,18,16,34,9,25
2,18,17,6,7,-1
2,18,18,20,6,14
2,18,19,16,14,2
2,18,20,7,13,-6
2,18,21,23,11,12
2,18,22,11,14,-3
2,18,23,12,12,0
2,18,24,15,8,7
2,18,25,19,13,6
2,18,26,12,2,10
2,18,27,12,12,0
2,18,28,17,9,8
2,18,29,20,9,11
2,18,30,6,7,-1
2,18,31,21,13,8
2,18,32,17,15,2
2,18,33,20,5,15
2,18,34,12,6,6
2,18,35,18,15,3
2,18,36,13,3,10
2,18,37,21,18,3
2,18,38,17,12,5
2,18,39,18,8,10
2,18,40,9,4,5
2,18,41,23,7,16
2,18,42,8,7,1
2,18,43,26,20,6
2,18,44,19,14,5
2,18,45,26,16,10
2,18,46,17,13,4
2,18,47,8,7,1
2,18,48,6,3,3
2,18,49,39,13,26
2,18,50,16,3,13
2,18,51,23,11,12
2,18,52,23,12,11
2,18,53,26,11,15
2,18,54,32,13,19
2,18,55,4,5,-1
2,18,56,20,19,1
2,18,57,13,10,3
2,18,58,17,7,10
2,18,59,13,18,-5
2,18,60,19,10,9
2,18,61,15,14,1
2,18,62,10,15,-5
2,18,63,19,7,12
2,18,64,30,10,20
2,18,65,12,7,5
2,18,66,12,3,9
2,18,67,16,20,-4
2,18,68,17,15,2
2,18,69,7,13,-6
2,18,70,18,9,9
2,18,71,13,3,10
2,18,72,17,4,13
2,18,73,16,18,-2
2,18,74,22,7,15
2,18,75,9,9,0
2,18,76,8,1,7
2,18,77,23,9,14
2,18,78,17,11,6
2,18,79,23,14,9
2,18,80,9,7,2
2,18,81,17,20,-3
2,18,82,23,11,12
2,18,83,5,4,1
2,18,84,15,8,7
2,18,85,16,7,9
2,18,86,21,11,10
2,18,87,10,20,-10
2,18,88,27,9,18
2,18,89,13,5,8
2,18,90,12,9,3
2,18,91,13,16,-3
2,18,92,9,7,2
2,18,93,11,7,4
2,18,94,26,8,18
2,18,95,11,8,3
2,18,96,20,8,12
2,18,97,15,6,9
2,18,98,23,6,17
2,18,99,36,27,9
2,18,100,14,15,-1
2,18,101,8,5,3
2,18,102,11,8,3
2,18,103,15,2,13
2,18,104,20,11,9
2,18,105,10,16,-6
2,18,106,13,7,6
2,18,107,39,16,23
2,18,108,13,14,-1
2,18,109,21,8,13
2,18,110,14,5,9
2,18,111,6,2,4
2,18,112,16,8,8
2,18,113,8,2,6
2,18,114,11,3,8
2,18,115,10,4,6
2,18,116,6,6,0
2,18,117,19,16,3
2,18,118,17,21,-4
2,18,119,14,3,11
2,18,120,18,24,-6
2,18,121,20,16,4
2,18,122,19,13,6
2,18,123,23,6,17
2,18,124,29,7,22
2,18,125,23,9,14
2,18,126,18,22,-4
2,18,127,26,14,12
2,18,128,28,13,15
2,18,129,13,14,-1
2,18,130,17,12,5
2,18,131,12,10,2
2,18,132,13,8,5
2,18,133,12,15,-3
2,18,134,8,8,0
2,18,135,16,10,6
2,18,136,23,5,18
2,18,137,26,20,6
2,18,138,18,8,10
2,18,139,31,12,19
2,18,140,17,13,4
2,18,141,14,0,14
2,18,142,14,10,4
2,18,143,9,14,-5
2,18,144,18,3,15
2,18,145,17,5,12
2,18,146,23,9,14
2,18,147,18,12,6
2,18,148,18,14,4
2,18,149,15,11,4
2,18,150,24,24,0
2,18,151,18,16,2
2,18,152,23,18,5
2,18,153,21,14,7
2,18,154,18,6,12
2,18,155,13,14,-1
2,18,156,10,14,-4
2,18,157,6,5,1
2,18,158,19,6,13
2,18,159,20,27,-7
2,18,160,8,10,-2
2,18,161,11,3,8
2,18,162,15,15,0
2,18,163,21,3,18
2,18,164,16,1,15
2,18,165,14,17,-3
2,18,166,21,10,11
2,18,167,13,4,9
2,18,168,12,18,-6
2,18,169,8,10,-2
2,18,170,12,13,-1
2,18,171,18,11,7
2,18,172,14,8,6
2,18,173,14,4,10
2,18,174,19,4,15
2,18,175,13,5,8
2,18,176,18,5,13
2,18,177,37,22,15
2,18,178,13,6,7
2,18,179,26,5,21
2,18,180,13,15,-2
2,18,181,17,8,9
2,18,182,24,10,14
2,18,183,9,11,-2
2,18,184,43,1,42
2,18,185,26,15,11
2,18,186,13,9,4
2,18,187,17,11,6
2,18,188,24,18,6
2,18,189,23,11,12
2,18,190,16,5,11
2,18,191,19,6,13
2,18,192,18,9,9
2,18,193,10,11,-1
2,18,194,8,9,-1
2,18,195,17,12,5
2,18,196,16,11,5
2,18,197,23,34,-11
2,18,198,13,4,9
2,18,199,12,4,8
2,18,200,24,12,12
2,18,201,6,3,3
2,18,202,16,13,3
2,18,203,23,23,0
2,18,204,19,9,10
2,18,205,15,10,5
2,18,206,12,4,8
2,18,207,29,14,15
2,18,208,29,13,16
2,18,209,13,11,2
2,18,210,25,9,16
2,18,211,14,6,8
2,18,212,12,5,7
2,18,213,10,7,3
2,18,214,20,6,14
2,18,215,26,12,14
2,18,216,23,14,9
2,18,217,10,12,-2
2,18,218,17,3,14
2,18,219,24,13,11
2,18,220,19,8,11
2,18,221,16,11,5
2,18,222,14,3,11
2,18,223,22,13,9
2,18,224,24,11,13
2,18,225,22,9,13
2,18,226,13,12,1
2,18,227,15,6,9
2,18,228,26,10,16
2,18,229,22,13,9
2,18,230,13,4,9
2,18,231,13,4,9
2,18,232,11,10,1
2,18,233,16,4,12
2,18,234,20,12,8
2,18,235,9,5,4
2,18,236,9,10,-1
2,18,237,14,10,4
2,18,238,29,16,13
2,18,239,27,15,12
2,18,240,9,5,4
2,18,241,23,12,11
2,18,242,8,11,-3
2,18,243,24,16,8
2,18,244,8,6,2
2,18,245,26,9,17
2,18,246,18,4,14
2,18,247,22,13,9
2,18,248,20,5,15
2,18,249,6,8,-2
2,18,250,15,8,7
2,18,251,19,15,4
2,18,252,21,2,19
2,18,253,5,0,5
2,18,254,10,13,-3
2,18,255,2,1,1
2,18,256,17,14,3
2,18,257,23,9,14
2,18,258,20,4,16
2,18,259,26,10,16
2,18,260,11,8,3
2,18,261,7,17,-10
2,18,262,20,12,8
2,18,263,33,14,19
2,18,264,13,7,6
2,18,265,19,10,9
2,18,266,16,5,11
2,18,267,18,6,12
2,18,268,22,7,15
2,18,269,22,23,-1
2,18,270,11,8,3
2,18,271,20,9,11
2,18,272,26,20,6
2,18,273,13,9,4
2,18,274,14,12,2
2,18,275,13,9,4
2,18,276,8,7,1
2,18,277,13,4,9
2,18,278,25,17,8
2,18,279,12,7,5
2,18,280,20,15,5
2,18,281,20,12,8
2,18,282,12,10,2
2,18,283,16,5,11
2,18,284,17,22,-5
2,18,285,23,6,17
2,18,286,18,21,-3
2,18,287,9,11,-2
2,18,288,7,19,-12
2,18,289,5,8,-3
2,18,290,11,7,4
2,18,291,17,4,13
2,18,292,12,5,7
2,18,293,13,8,5
2,18,294,9,16,-7
2,18,295,23,9,14
2,18,296,26,5,21
2,18,297,13,10,3
2,18,298,14,5,9
2,18,299,17,11,6
2,19,0,12,10,2
2,19,1,16,11,5
2,19,2,10,7,3
2,19,3,11,5,6
2,19,4,14,20,-6
2,19,5,12,21,-9
2,19,6,4,2,2
2,19,7,31,10,21
2,19,8,6,13,-7
2,19,9,16,3,13
2,19,10,15,6,9
2,19,11,16,4,12
2,19,12,15,10,5
2,19,13,21,13,8
2,19,14,17,18,-1
2,19,15,13,8,5
2,19,16,22,4,18
2,19,17,23,9,14
2,19,18,19,13,6
2,19,19,24,8,16
2,19,20,11,11,0
2,19,21,17,7,10
2,19,22,6,8,-2
2,19,23,34,29,5
2,19,24,14,7,7
2,19,25,12,9,3
2,19,26,19,7,12
2,19,27,19,13,6
2,19,28,24,11,13
2,19,29,13,3,10
2,19,30,13,3,10
2,19,31,8,5,3
2,19,32,26,15,11
2,19,33,14,5,9
2,19,34,13,13,0
2,19,35,12,8,4
2,19,36,17,19,-2
2,19,37,17,11,6
2,19,38,11,11,0
2,19,39,19,15,4
2,19,40,8,6,2
2,19,41,26,10,16
2,19,42,18,10,8
2,19,43,13,5,8
2,19,44,13,18,-5
2,19,45,16,6,10
2,19,46,13,11,2
2,19,47,20,11,9
2,19,48,17,24,-7
2,19,49,26,5,21
2,19,50,13,14,-1
2,19,51,10,8,2
2,19,52,13,6,7
2,19,53,24,15,9
2,19,54,20,12,8
2,19,55,14,8,6
2,19,56,20,10,10
2,19,57,15,5,10
2,19,58,14,6,8
2,19,59,12,3,9
2,19,60,22,12,10
2,19,61,25,13,12
2,19,62,21,6,15
2,19,63,14,10,4
2,19,64,20,7,13
2,19,65,16,23,-7
2,19,66,24,15,9
2,19,67,8,4,4
2,19,68,18,23,-5
2,19,69,8,9,-1
2,19,70,21,10,11
2,19,71,12,10,2
2,19,72,8,18,-10
2,19,73,14,10,4
2,19,74,14,7,7
2,19,75,20,14,6
2,19,76,24,19,5
2,19,77,18,10,8
2,19,78,19,13,6
2,19,79,17,9,8
2,19,80,13,23,-10
2,19,81,20,19,1
2,19,82,18,13,5
2,19,83,19,12,7
2,19,84,11,3,8
2,19,85,19,13,6
2,19,86,17,10,7
2,19,87,25,13,12
2,19,88,10,9,1
2,19,89,20,12,8
2,19,90,14,14,0
2,19,91,12,9,3
2,19,92,15,18,-3
2,19,93,20,10,10
2,19,94,14,21,-7
2,19,95,14,7,7
2,19,96,19,10,9
2,19,97,17,12,5
2,19,98,9,6,3
2,19,99,11,5,6
2,19,100,12,11,1
2,19,101,27,17,10
2,19,102,29,10,19
2,19,103,22,7,15
2,19,104,10,17,-7
2,19,105,20,10,10
2,19,106,26,10,16
2,19,107,8,10,-2
2,19,108,13,8,5
2,19,109,16,10,6
2,19,110,17,13,4
2,19,111,14,11,3
2,19,112,20,4,16
2,19,113,22,20,2
2,19,114,21,6,15
2,19,115,14,9,5
2,19,116,9,11,-2
2,19,117,34,22,12
2,19,118,22,4,18
2,19,119,19,11,8
2,19,120,30,3,27
2,19,121,23,14,9
2,19,122,22,19,3
2,19,123,24,18,6
2,19,124,23,15,8
2,19,125,20,10,10
2,19,126,21,3,18
2,19,127,9,12,-3
2,19,128,29,8,21
2,19,129,12,22,-10
2,19,130,20,2,18
2,19,131,26,10,16
2,19,132,7,4,3
2,19,133,19,15,4
2,19,134,23,14,9
2,19,135,10,3,7
2,19,136,24,14,10
2,19,137,13,12,1
2,19,138,16,7,9
2,19,139,25,14,11
2,19,140,16,8,8
2,19,141,15,9,6
2,19,142,22,14,8
2,19,143,29,5,24
2,19,144,8,10,-2
2,19,145,12,11,1
2,19,146,10,3,7
2,19,147,12,10,2
2,19,148,30,5,25
2,19,149,11,4,7
2,19,150,19,9,10
2,19,151,23,12,11
2,19,152,25,10,15
2,19,153,15,5,10
2,19,154,16,15,1
2,19,155,18,7,11
2,19,156,17,11,6
2,19,157,14,8,6
2,19,158,21,14,7
2,19,159,9,6,3
2,19,160,6,6,0
2,19,161,22,18,4
2,19,162,7,10,-3
2,19,163,16,9,7
2,19,164,9,15,-6
2,19,165,13,6,7
2,19,166,16,3,13
2,19,167,16,4,12
2,19,168,23,16,7
2,19,169,12,12,0
2,19,170,8,5,3
2,19,171,14,8,6
2,19,172,16,8,8
2,19,173,16,4,12
2,19,174,24,11,13
2,19,175,13,10,3
2,19,176,17,14,3
2,19,177,9,3,6
2,19,178,13,11,2
2,19,179,12,10,2
2,19,180,5,13,-8
2,19,181,17,17,0
2,19,182,12,7,5
2,19,183,13,6,7
2,19,184,9,10,-1
2,19,185,10,12,-2
2,19,186,17,14,3
2,19,187,9,2,7
2,19,188,21,10,11
2,19,189,10,6,4
2,19,190,15,10,5
2,19,191,7,9,-2
2,19,192,23,6,17
2,19,193,21,20,1
2,19,194,12,18,-6
2,19,195,28,15,13
2,19,196,17,7,10
2,19,197,18,7,11
2,19,198,15,9,6
2,19,199,11,6,5
2,19,200,17,11,6
2,19,201,17,9,8
2,19,202,15,9,6
2,19,203,14,3,11
2,19,204,17,10,7
2,19,205,17,7,10
2,19,206,22,6,16
2,19,207,22,9,13
2,19,208,9,13,-4
2,19,209,10,2,8
2,19,210,14,10,4
2,19,211,11,9,2
2,19,212,12,11,1
2,19,213,35,11,24
2,19,214,8,6,2
2,19,215,17,14,3
2,19,216,10,3,7
2,19,217,4,3,1
2,19,218,19,23,-4
2,19,219,14,7,7
2,19,220,18,4,14
2,19,221,13,6,7
2,19,222,12,7,5
2,19,223,14,3,11
2,19,224,26,14,12
2,19,225,21,6,15
2,19,226,14,13,1
2,19,227,17,9,8
2,19,228,7,12,-5
2,19,229,16,11,5
2,19,230,17,10,7
2,19,231,9,9,0
2,19,232,32,15,17
2,19,233,25,13,12
2,19,234,16,8,8
2,19,235,18,11,7
2,19,236,21,10,11
2,19,237,7,2,5
2,19,238,21,16,5
2,19,239,10,17,-7
2,19,240,17,7,10
2,19,241,11,11,0
2,19,242,7,1,6
2,19,243,18,12,6
2,19,244,18,9,9
2,19,245,16,14,2
2,19,246,11,18,-7
2,19,247,21,13,8
2,19,248,16,12,4
2,19,249,17,11,6
2,19,250,17,8,9
2,19,251,9,12,-3
2,19,252,8,7,1
2,19,253,14,12,2
2,19,254,25,13,12
2,19,255,21,12,9
2,19,256,24,11,13
2,19,257,9,10,-1
2,19,258,10,3,7
2,19,259,15,14,1
2,19,260,11,8,3
2,19,261,29,19,10
2,19,262,14,11,3
2,19,263,21,11,10
2,19,264,8,7,1
2,19,265,20,17,3
2,19,266,31,13,18
2,19,267,18,17,1
2,19,268,10,13,-3
2,19,269,25,14,11
2,19,270,17,6,11
2,19,271,18,22,-4
2,19,272,21,13,8
2,19,273,19,3,16
2,19,274,18,6,12
2,19,275,8,6,2
2,19,276,17,10,7
2,19,277,28,9,19
2,19,278,11,9,2
2,19,279,9,13,-4
2,19,280,15,10,5
2,19,281,13,15,-2
2,19,282,16,11,5
2,19,283,8,16,-8
2,19,284,12,4,8
2,19,285,13,5,8
2,19,286,6,5,1
2,19,287,18,10,8
2,19,288,19,13,6
2,19,289,9,10,-1
2,19,290,13,9,4
2,19,291,15,16,-1
2,19,292,18,13,5
2,19,293,21,10,11
2,19,294,24,8,16
2,19,295,17,8,9
2,19,296,21,10,11
2,19,297,12,1,11
2,19,298,23,9,14
2,19,299,16,9,7
2,20,0,18,12,6
2,20,1,10,14,-4
2,20,2,9,2,7
2,20,3,5,2,3
2,20,4,27,16,11
2,20,5,6,11,-5
2,20,6,9,5,4
2,20,7,13,1,12
2,20,8,21,11,10
2,20,9,26,8,18
2,20,10,19,18,1
2,20,11,17,11,6
2,20,12,18,5,13
2,20,13,19,9,10
2,20,14,29,12,17
2,20,15,8,8,0
2,20,16,18,8,10
2,20,17,19,9,10
2,20,18,18,10,8
2,20,19,21,1,20
2,20,20,15,5,10
2,20,21,12,7,5
2,20,22,17,15,2
2,20,23,12,9,3
2,20,24,15,7,8
2,20,25,8,2,6
2,20,26,10,7,3
2,20,27,27,12,15
2,20,28,22,2,20
2,20,29,26,10,16
2,20,30,16,5,11
2,20,31,18,8,10
2,20,32,15,9,6
2,20,33,16,11,5
2,20,34,20,6,14
2,20,35,16,12,4
2,20,36,15,5,10
2,20,37,29,10,19
2,20,38,17,8,9
2,20,39,9,8,1
2,20,40,10,8,2
2,20,41,7,9,-2
2,20,42,34,14,20
2,20,43,21,7,14
2,20,44,28,28,0
2,20,45,17,7,10
2,20,46,19,6,13
2,20,47,17,6,11
2,20,48,18,4,14
2,20,49,4,6,-2
2,20,50,21,13,8
2,20,51,23,7,16
2,20,52,17,9,8
2,20,53,9,10,-1
2,20,54,19,17,2
2,20,55,14,10,4
2,20,56,19,12,7
2,20,57,14,10,4
2,20,58,30,10,20
2,20,59,10,13,-3
2,20,60,22,14,8
2,20,61,21,14,7
2,20,62,9,12,-3
2,20,63,15,7,8
2,20,64,20,10,10
2,20,65,23,13,10
2,20,66,12,9,3
2,20,67,7,4,3
2,20,68,15,7,8
2,20,69,19,7,12
2,20,70,26,8,18
2,20,71,8,11,-3
2,20,72,16,1,15
2,20,73,14,8,6
2,20,74,16,10,6
2,20,75,19,12,7
2,20,76,32,8,24
2,20,77,24,3,21
2,20,78,11,0,11
2,20,79,18,10,8
2,20,80,12,2,10
2,20,81,5,11,-6
2,20,82,17,10,7
2,20,83,20,5,15
2,20,84,11,11,0
2,20,85,17,21,-4
2,20,86,26,10,16
2,20,87,13,4,9
2,20,88,27,22,5
2,20,89,16,7,9
2,20,90,12,14,-2
2,20,91,8,0,8
2,20,92,13,10,3
2,20,93,13,11,2
2,20,94,10,3,7
2,20,95,20,5,15
2,20,96,23,11,12
2,20,97,27,12,15
2,20,98,8,8,0
2,20,99,20,7,13
2,20,100,11,8,3
2,20,101,16,6,10
2,20,102,24,15,9
2,20,103,22,15,7
2,20,104,8,10,-2
2,20,105,16,14,2
2,20,106,15,8,7
2,20,107,13,12,1
2,20,108,11,12,-1
2,20,109,16,14,2
2,20,110,13,14,-1
2,20,111,19,4,15
2,20,112,13,6,7
2,20,113,26,17,9
2,20,114,7,4,3
2,20,115,12,6,6
2,20,116,31,19,12
2,20,117,12,8,4
2,20,118,10,6,4
2,20,119,17,10,7
2,20,120,23,7,16
2,20,121,9,2,7
2,20,122,15,4,11
2,20,123,18,12,6
2,20,124,11,14,-3
2,20,125,13,9,4
2,20,126,27,7,20
2,20,127,19,11,8
2,20,128,10,2,8
2,20,129,19,4,15
2,20,130,17,12,5
2,20,131,16,18,-2
2,20,132,7,9,-2
2,20,133,30,10,20
2,20,134,20,16,4
2,20,135,3,1,2
2,20,136,32,14,18
2,20,137,24,10,14
2,20,138,22,12,10
2,20,139,19,15,4
2,20,140,16,10,6
2,20,141,19,5,14
2,20,142,19,8,11
2,20,143,10,24,-14
2,20,144,40,6,34
2,20,145,13,11,2
2,20,146,12,9,3
2,20,147,8,2,6
2,20,148,11,3,8
2,20,149,25,5,20
2,20,150,21,13,8
2,20,151,8,13,-5
2,20,152,8,6,2
2,20,153,7,10,-3
2,20,154,9,1,8
2,20,155,23,7,16
2,20,156,25,13,12
2,20,157,13,11,2
2,20,158,25,8,17
2,20,159,28,6,22
2,20,160,13,12,1
2,20,161,18,17,1
2,20,162,7,8,-1
2,20,163,20,12,8
2,20,164,17,10,7
2,20,165,10,15,-5
2,20,166,20,9,11
2,20,167,6,7,-1
2,20,168,9,9,0
2,20,169,16,13,3
2,20,170,20,16,4
2,20,171,17,12,5
2,20,172,4,8,-4
2,20,173,23,15,8
2,20,174,18,8,10
2,20,175,13,15,-2
2,20,176,21,9,12
2,20,177,24,17,7
2,20,178,15,8,7
2,20,179,16,8,8
2,20,180,2,4,-2
2,20,181,10,10,0
2,20,182,13,9,4
2,20,183,11,6,5
2,20,184,27,10,17
2,20,185,13,8,5
2,20,186,18,12,6
2,20,187,20,19,1
2,20,188,15,8,7
2,20,189,29,15,14
2,20,190,13,15,-2
2,20,191,35,23,12
2,20,192,19,16,3
2,20,193,14,10,4
2,20,194,19,8,11
2,20,195,17,5,12
2,20,196,17,12,5
2,20,197,23,6,17
2,20,198,16,6,10
2,20,199,10,6,4
2,20,200,11,16,-5
2,20,201,7,11,-4
2,20,202,21,8,13
2,20,203,4,3,1
2,20,204,18,10,8
2,20,205,17,17,0
2,20,206,12,8,4
2,20,207,6,13,-7
2,20,208,11,5,6
2,20,209,21,10,11
2,20,210,13,7,6
2,20,211,13,16,-3
2,20,212,9,4,5
2,20,213,22,11,11
2,20,214,24,12,12
2,20,215,12,7,5
2,20,216,23,4,19
2,20,217,4,11,-7
2,20,218,9,18,-9
2,20,219,12,3,9
2,20,220,20,3,17
2,20,221,23,13,10
2,20,222,12,13,-1
2,20,223,13,15,-2
2,20,224,24,9,15
2,20,225,12,1,11
2,20,226,16,10,6
2,20,227,17,3,14
2,20,228,10,8,2
2,20,229,16,8,8
2,20,230,15,13,2
2,20,231,33,11,22
2,20,232,13,12,1
2,20,233,6,3,3
2,20,234,8,7,1
2,20,235,8,14,-6
2,20,236,12,9,3
2,20,237,21,13,8
2,20,238,16,14,2
2,20,239,7,10,-3
2,20,240,10,8,2
2,20,241,23,11,12
2,20,242,24,15,9
2,20,243,27,16,11
2,20,244,13,10,3
2,20,245,24,11,13
2,20,246,22,16,6
2,20,247,8,7,1
2,20,248,12,2,10
2,20,249,14,9,5
2,20,250,20,20,0
2,20,251,20,3,17
2,20,252,9,4,5
2,20,253,10,8,2
2,20,254,18,12,6
2,20,255,18,9,9
2,20,256,9,12,-3
2,20,257,19,11,8
2,20,258,10,5,5
2,20,259,25,12,13
2,20,260,28,11,17
2,20,261,29,10,19
2,20,262,28,8,20
2,20,263,14,6,8
2,20,264,24,8,16
2,20,265,19,6,13
2,20,266,16,6,10
2,20,267,26,14,12
2,20,268,30,25,5
2,20,269,11,18,-7
2,20,270,40,6,34
2,20,271,15,16,-1
2,20,272,35,16,19
2,20,273,22,7,15
2,20,274,21,13,8
2,20,275,18,22,-4
2,20,276,21,15,6
2,20,277,17,23,-6
2,20,278,14,13,1
2,20,279,14,4,10
2,20,280,10,5,5
2,20,281,9,5,4
2,20,282,21,9,12
2,20,283,14,12,2
2,20,284,7,3,4
2,20,285,13,7,6
2,20,286,12,13,-1
2,20,287,4,2,2
2,20,288,24,10,14
2,20,289,28,14,14
2,20,290,20,7,13
2,20,291,15,9,6
2,20,292,8,7,1
2,20,293,17,7,10
2,20,294,19,14,5
2,20,295,8,6,2
2,20,296,8,7,1
2,20,297,17,3,14
2,20,298,18,9,9
2,20,299,23,10,13
2,21,0,7,5,2
2,21,1,20,6,14
2,21,2,27,19,8
2,21,3,13,5,8
2,21,4,27,4,23
2,21,5,16,8,8
2,21,6,13,10,3
2,21,7,12,18,-6
2,21,8,13,11,2
2,21,9,17,13,4
2,21,10,20,13,7
2,21,11,17,8,9
2,21,12,8,8,0
2,21,13,22,20,2
2,21,14,7,3,4
2,21,15,11,9,2
2,21,16,26,7,19
2,21,17,14,8,6
2,21,18,17,6,11
2,21,19,14,11,3
2,21,20,11,5,6
2,21,21,15,11,4
2,21,22,10,11,-1
2,21,23,25,2,23
2,21,24,21,16,5
2,21,25,15,8,7
2,21,26,17,4,13
2,21,27,9,6,3
2,21,28,15,8,7
2,21,29,11,11,0
2,21,30,16,9,7
2,21,31,17,8,9
2,21,32,43,16,27
2,21,33,7,6,1
2,21,34,16,11,5
2,21,35,23,10,13
2,21,36,9,6,3
2,21,37,8,14,-6
2,21,38,12,6,6
2,21,39,14,6,8
2,21,40,9,5,4
2,21,41,6,8,-2
2,21,42,20,20,0
2,21,43,23,7,16
2,21,44,14,6,8
2,21,45,20,8,12
2,21,46,21,9,12
2,21,47,13,21,-8
2,21,48,11,18,-7
2,21,49,22,14,8
2,21,50,14,7,7
2,21,51,33,12,21
2,21,52,9,5,4
2,21,53,9,9,0
2,21,54,21,13,8
2,21,55,11,10,1
2,21,56,24,7,17
2,21,57,20,2,18
2,21,58,13,15,-2
2,21,59,17,5,12
2,21,60,15,13,2
2,21,61,24,13,11
2,21,62,17,5,12
2,21,63,17,6,11
2,21,64,24,9,15
2,21,65,13,12,1
2,21,66,7,5,2
2,21,67,16,16,0
2,21,68,17,11,6
2,21,69,31,13,18
2,21,70,24,12,12
2,21,71,22,12,10
2,21,72,12,8,4
2,21,73,26,7,19
2,21,74,4,13,-9
2,21,75,16,3,13
2,21,76,18,18,0
2,21,77,23,15,8
2,21,78,6,4,2
2,21,79,22,15,7
2,21,80,13,5,8
2,21,81,12,12,0
2,21,82,19,12,7
2,21,83,20,17,3
2,21,84,19,2,17
2,21,85,22,7,15
2,21,86,25,12,13
2,21,87,10,4,6
2,21,88,14,8,6
2,21,89,19,8,11
2,21,90,18,13,5
2,21,91,8,0,8
2,21,92,12,3,9
2,21,93,10,7,3
2,21,94,17,19,-2
2,21,95,22,13,9
2,21,96,6,11,-5
2,21,97,11,2,9
2,21,98,12,7,5
2,21,99,3,6,-3
2,21,100,27,5,22
2,21,101,15,8,7
2,21,102,3,9,-6
2,21,103,9,1,8
2,21,104,21,9,12
2,21,105,9,8,1
2,21,106,22,8,14
2,21,107,12,5,7
2,21,108,27,9,18
2,21,109,21,4,17
2,21,110,7,10,-3
2,21,111,16,8,8
2,21,112,17,15,2
2,21,113,29,13,16
2,21,114,17,12,5
2,21,115,17,11,6
2,21,116,29,28,1
2,21,117,11,3,8
2,21,118,11,0,11
2,21,119,19,8,11
2,21,120,14,2,12
2,21,121,32,12,20
2,21,122,28,20,8
2,21,123,9,5,4
2,21,124,1,2,-1
2,21,125,14,8,6
2,21,126,11,2,9
2,21,127,11,7,4
2,21,128,24,16,8
2,21,129,12,7,5
2,21,130,17,8,9
2,21,131,13,13,0
2,21,132,24,9,15
2,21,133,18,5,13
2,21,134,21,8,13
2,21,135,12,9,3
2,21,136,10,11,-1
2,21,137,17,9,8
2,21,138,33,12,21
2,21,139,20,2,18
2,21,140,16,9,7
2,21,141,10,5,5
2,21,142,7,5,2
2,21,143,6,20,-14
2,21,144,12,7,5
2,21,145,6,4,2
2,21,146,12,7,5
2,21,147,25,7,18
2,21,148,24,18,6
2,21,149,18,9,9
2,21,150,19,4,15
2,21,151,13,16,-3
2,21,152,17,9,8
2,21,153,17,7,10
2,21,154,21,18,3
2,21,155,22,13,9
2,21,156,34,22,12
2,21,157,17,5,12
2,21,158,13,3,10
2,21,159,12,16,-4
2,21,160,6,4,2
2,21,161,12,15,-3
2,21,162,14,19,-5
2,21,163,13,8,5
2,21,164,11,6,5
2,21,165,5,4,1
2,21,166,16,11,5
2,21,167,18,10,8
2,21,168,18,9,9
2,21,169,10,7,3
2,21,170,27,14,13
2,21,171,15,11,4
2,21,172,15,6,9
2,21,173,24,14,10
2,21,174,28,14,14
2,21,175,9,1,8
2,21,176,7,4,3
2,21,177,14,9,5
2,21,178,8,7,1
2,21,179,39,12,27
2,21,180,27,19,8
2,21,181,28,6,22
2,21,182,26,16,10
2,21,183,19,13,6
2,21,184,21,11,10
2,21,185,17,9,8
2,21,186,5,5,0
2,21,187,33,14,19
2,21,188,19,13,6
2,21,189,7,2,5
2,21,190,7,2,5
2,21,191,26,2,24
2,21,192,18,10,8
2,21,193,26,20,6
2,21,194,20,9,11
2,21,195,9,4,5
2,21,196,19,13,6
2,21,197,17,9,8
2,21,198,11,4,7
2,21,199,16,8,8
2,21,200,9,9,0
2,21,201,24,7,17
2,21,202,18,11,7
2,21,203,11,2,9
2,21,204,28,16,12
2,21,205,10,5,5
2,21,206,18,9,9
2,21,207,22,7,15
2,21,208,19,6,13
2,21,209,12,7,5
2,21,210,9,5,4
2,21,211,11,7,4
2,21,212,8,8,0
2,21,213,26,15,11
2,21,214,14,10,4
2,21,215,32,13,19
2,21,216,15,10,5
2,21,217,41,14,27
2,21,218,11,7,4
2,21,219,16,15,1
2,21,220,16,10,6
2,21,221,22,10,12
2,21,222,20,12,8
2,21,223,10,6,4
2,21,224,18,4,14
2,21,225,10,4,6
2,21,226,6,11,-5
2,21,227,24,9,15
2,21,228,22,16,6
2,21,229,20,12,8
2,21,230,24,17,7
2,21,231,16,11,5
2,21,232,9,8,1
2,21,233,19,7,12
2,21,234,36,32,4
2,21,235,5,7,-2
2,21,236,14,2,12
2,21,237,16,5,11
2,21,238,14,15,-1
2,21,239,5,8,-3
2,21,240,16,15,1
2,21,241,19,7,12
2,21,242,20,6,14
2,21,243,17,7,10
2,21,244,16,7,9
2,21,245,15,11,4
2,21,246,17,15,2
2,21,247,2,3,-1
2,21,248,21,16,5
2,21,249,22,11,11
2,21,250,3,3,0
2,21,251,19,11,8
2,21,252,15,11,4
2,21,253,21,11,10
2,21,254,11,8,3
2,21,255,16,9,7
2,21,256,7,2,5
2,21,257,19,10,9
2,21,258,31,18,13
2,21,259,31,15,16
2,21,260,6,13,-7
2,21,261,10,4,6
2,21,262,27,13,14
2,21,263,7,12,-5
2,21,264,18,19,-1
2,21,265,23,11,12
2,21,266,26,9,17
2,21,267,13,10,3
2,21,268,16,5,11
2,21,269,12,5,7
2,21,270,19,21,-2
2,21,271,18,9,9
2,21,272,12,6,6
2,21,273,19,12,7
2,21,274,3,6,-3
2,21,275,22,8,14
2,21,276,9,12,-3
2,21,277,20,11,9
2,21,278,21,9,12
2,21,279,19,9,10
2,21,280,18,12,6
2,21,281,8,7,1
2,21,282,19,5,14
2,21,283,13,10,3
2,21,284,17,6,11
2,21,285,24,16,8
2,21,286,19,7,12
2,21,287,8,7,1
2,21,288,14,5,9
2,21,289,5,0,5
2,21,290,22,8,14
2,21,291,24,7,17
2,21,292,20,3,17
2,21,293,12,13,-1
2,21,294,16,7,9
2,21,295,11,13,-2
2,21,296,21,9,12
2,21,297,15,7,8
2,21,298,26,8,18
2,21,299,17,8,9
2,22,0,16,13,3
2,22,1,25,9,16
2,22,2,27,11,16
2,22,3,12,22,-10
2,22,4,24,7,17
2,22,5,8,17,-9
2,22,6,26,11,15
2,22,7,23,7,16
2,22,8,22,5,17
2,22,9,22,10,12
2,22,10,12,6,6
2,22,11,7,1,6
2,22,12,21,16,5
2,22,13,16,15,1
2,22,14,31,6,25
2,22,15,16,6,10
2,22,16,15,7,8
2,22,17,20,7,13
2,22,18,22,8,14
2,22,19,32,12,20
2,22,20,12,9,3
2,22,21,25,5,20
2,22,22,13,11,2
2,22,23,14,8,6
2,22,24,16,11,5
2,22,25,15,10,5
2,22,26,24,16,8
2,22,27,9,15,-6
2,22,28,11,11,0
2,22,29,8,8,0
2,22,30,15,8,7
2,22,31,23,5,18
2,22,32,18,14,4
2,22,33,16,18,-2
2,22,34,6,5,1
2,22,35,11,7,4
2,22,36,15,9,6
2,22,37,15,6,9
2,22,38,20,10,10
2,22,39,23,11,12
2,22,40,7,4,3
2,22,41,8,7,1
2,22,42,17,8,9
2,22,43,6,9,-3
2,22,44,25,16,9
2,22,45,11,12,-1
2,22,46,14,14,0
2,22,47,6,5,1
2,22,48,8,6,2
2,22,49,16,25,-9
2,22,50,25,11,14
2,22,51,10,0,10
2,22,52,19,7,12
2,22,53,10,6,4
2,22,54,33,5,28
2,22,55,21,11,10
2,22,56,27,10,17
2,22,57,18,9,9
2,22,58,11,8,3
2,22,59,14,6,8
2,22,60,14,13,1
2,22,61,28,6,22
2,22,62,16,6,10
2,22,63,10,10,0
2,22,64,7,7,0
2,22,65,19,7,12
2,22,66,21,12,9
2,22,67,23,2,21
2,22,68,12,10,2
2,22,69,13,13,0
2,22,70,16,3,13
2,22,71,15,3,12
2,22,72,14,8,6
2,22,73,19,20,-1
2,22,74,15,8,7
2,22,75,4,12,-8
2,22,76,12,5,7
2,22,77,9,8,1
2,22,78,25,14,11
2,22,79,16,2,14
2,22,80,24,8,16
2,22,81,11,13,-2
2,22,82,9,7,2
2,22,83,19,10,9
2,22,84,16,10,6
2,22,85,16,10,6
2,22,86,22,8,14
2,22,87,21,10,11
2,22,88,19,4,15
2,22,89,15,3,12
2,22,90,13,2,11
2,22,91,9,4,5
2,22,92,12,4,8
2,22,93,31,27,4
2,22,94,11,9,2
2,22,95,11,10,1
2,22,96,5,11,-6
2,22,97,34,24,10
2,22,98,13,6,7
2,22,99,19,16,3
2,22,100,23,10,13
2,22,101,15,8,7
2,22,102,21,18,3
2,22,103,17,16,1
2,22,104,14,15,-1
2,22,105,17,20,-3
2,22,106,11,4,7
2,22,107,11,15,-4
2,22,108,15,9,6
2,22,109,31,12,19
2,22,110,15,12,3
2,22,111,23,9,14
2,22,112,13,5,8
2,22,113,25,11,14
2,22,114,25,9,16
2,22,115,19,3,16
2,22,116,24,19,5
2,22,117,23,13,10
2,22,118,14,15,-1
2,22,119,18,2,16
2,22,120,11,8,3
2,22,121,22,11,11
2,22,122,20,17,3
2,22,123,22,14,8
2,22,124,12,14,-2
2,22,125,18,14,4
2,22,126,13,5,8
2,22,127,24,5,19
2,22,128,20,11,9
2,22,129,15,13,2
2,22,130,14,12,2
2,22,131,27,12,15
2,22,132,2,6,-4
2,22,133,26,14,12
2,22,134,10,10,0
2,22,135,18,15,3
2,22,136,12,9,3
2,22,137,11,8,3
2,22,138,9,15,-6
2,22,139,10,9,1
2,22,140,14,6,8
2,22,141,16,2,14
2,22,142,17,7,10
2,22,143,11,8,3
2,22,144,41,13,28
2,22,145,22,15,7
2,22,146,14,12,2
2,22,147,10,12,-2
2,22,148,11,7,4
2,22,149,20,8,12
2,22,150,16,19,-3
2,22,151,6,3,3
2,22,152,16,8,8
2,22,153,10,5,5
2,22,154,15,6,9
2,22,155,20,14,6
2,22,156,19,10,9
2,22,157,9,7,2
2,22,158,6,11,-5
2,22,159,6,13,-7
2,22,160,15,6,9
2,22,161,18,9,9
2,22,162,27,14,13
2,22,163,12,13,-1
2,22,164,12,7,5
2,22,165,18,8,10
2,22,166,21,8,13
2,22,167,10,12,-2
2,22,168,14,6,8
2,22,169,8,2,6
2,22,170,14,14,0
2,22,171,11,5,6
2,22,172,14,7,7
2,22,173,12,13,-1
2,22,174,11,12,-1
2,22,175,17,11,6
2,22,176,15,9,6
2,22,177,31,12,19
2,22,178,30,6,24
2,22,179,17,6,11
2,22,180,19,7,12
2,22,181,17,9,8
2,22,182,28,8,20
2,22,183,8,0,8
2,22,184,16,3,13
2,22,185,15,6,9
2,22,186,13,5,8
2,22,187,4,5,-1
2,22,188,20,7,13
2,22,189,10,9,1
2,22,190,12,7,5
2,22,191,20,17,3
2,22,192,11,13,-2
2,22,193,26,7,19
2,22,194,26,15,11
2,22,195,16,10,6
2,22,196,19,15,4
2,22,197,16,6,10
2,22,198,5,8,-3
2,22,199,20,15,5
2,22,200,12,9,3
2,22,201,23,15,8
2,22,202,2,5,-3
2,22,203,28,19,9
2,22,204,10,2,8
2,22,205,18,13,5
2,22,206,15,4,11
2,22,207,24,14,10
2,22,208,12,7,5
2,22,209,17,14,3
2,22,210,15,13,2
2,22,211,16,14,2
2,22,212,31,8,23
2,22,213,46,16,30
2,22,214,15,11,4
2,22,215,19,10,9
2,22,216,11,10,1
2,22,217,16,8,8
2,22,218,14,4,10
2,22,219,18,11,7
2,22,220,8,1,7
2,22,221,15,15,0
2,22,222,11,14,-3
2,22,223,18,13,5
2,22,224,12,7,5
2,22,225,16,9,7
2,22,226,31,8,23
2,22,227,21,3,18
2,22,228,10,9,1
2,22,229,7,12,-5
2,22,230,11,15,-4
2,22,231,16,11,5
2,22,232,13,14,-1
2,22,233,20,4,16
2,22,234,13,14,-1
2,22,235,9,7,2
2,22,236,15,15,0
2,22,237,13,7,6
2,22,238,33,10,23
2,22,239,21,10,11
2,22,240,21,5,16
2,22,241,27,11,16
2,22,242,10,16,-6
2,22,243,17,5,12
2,22,244,17,14,3
2,22,245,22,15,7
2,22,246,9,5,4
2,22,247,21,16,5
2,22,248,24,14,10
2,22,249,17,13,4
2,22,250,31,8,23
2,22,251,15,16,-1
2,22,252,5,5,0
2,22,253,14,9,5
2,22,254,6,4,2
2,22,255,11,9,2
2,22,256,16,5,11
2,22,257,21,3,18
2,22,258,28,5,23
2,22,259,17,5,12
2,22,260,16,14,2
2,22,261,15,12,3
2,22,262,19,10,9
2,22,263,22,4,18
2,22,264,17,24,-7
2,22,265,17,8,9
2,22,266,17,17,0
2,22,267,11,6,5
2,22,268,8,8,0
2,22,269,15,9,6
2,22,270,25,11,14
2,22,271,35,12,23
2,22,272,8,10,-2
2,22,273,7,7,0
2,22,274,5,5,0
2,22,275,6,8,-2
2,22,276,13,5,8
2,22,277,10,4,6
2,22,278,13,16,-3
2,22,279,10,10,0
2,22,280,12,4,8
2,22,281,27,9,18
2,22,282,11,5,6
2,22,283,16,7,9
2,22,284,18,11,7
2,22,285,18,11,7
2,22,286,6,10,-4
2,22,287,29,12,17
2,22,288,17,7,10
2,22,289,9,5,4
2,22,290,22,21,1
2,22,291,14,10,4
2,22,292,22,9,13
2,22,293,16,6,10
2,22,294,10,13,-3
2,22,295,14,5,9
2,22,296,15,14,1
2,22,297,12,14,-2
2,22,298,17,9,8
2,22,299,16,2,14
2,23,0,24,17,7
2,23,1,22,22,0
2,23,2,16,10,6
2,23,3,18,8,10
2,23,4,22,10,12
2,23,5,10,6,4
2,23,6,16,9,7
2,23,7,13,6,7
2,23,8,24,12,12
2,23,9,12,5,7
2,23,10,11,4,7
2,23,11,22,2,20
2,23,12,9,16,-7
2,23,13,9,5,4
2,23,14,19,1,18
2,23,15,14,10,4
2,23,16,13,6,7
2,23,17,25,5,20
2,23,18,13,9,4
2,23,19,8,4,4
2,23,20,10,7,3
2,23,21,8,6,2
2,23,22,15,4,11
2,23,23,11,15,-4
2,23,24,28,16,12
2,23,25,18,14,4
2,23,26,21,14,7
2,23,27,15,11,4
2,23,28,28,8,20
2,23,29,16,10,6
2,23,30,19,6,13
2,23,31,22,21,1
2,23,32,7,1,6
2,23,33,13,7,6
2,23,34,14,12,2
2,23,35,14,9,5
2,23,36,20,7,13
2,23,37,17,14,3
2,23,38,20,11,9
2,23,39,13,10,3
2,23,40,9,7,2
2,23,41,16,12,4
2,23,42,16,3,13
2,23,43,14,15,-1
2,23,44,21,15,6
2,23,45,17,13,4
2,23,46,15,8,7
2,23,47,25,8,17
2,23,48,21,8,13
2,23,49,14,8,6
2,23,50,12,12,0
2,23,51,11,4,7
2,23,52,18,10,8
2,23,53,27,10,17
2,23,54,24,10,14
2,23,55,12,10,2
2,23,56,17,12,5
2,23,57,9,11,-2
2,23,58,19,12,7
2,23,59,28,18,10
2,23,60,16,2,14
2,23,61,13,7,6
2,23,62,16,9,7
2,23,63,15,11,4
2,23,64,32,14,18
2,23,65,13,14,-1
2,23,66,29,13,16
2,23,67,15,5,10
2,23,68,16,17,-1
2,23,69,21,7,14
2,23,70,16,12,4
2,23,71,25,10,15
2,23,72,22,11,11
2,23,73,17,10,7
2,23,74,12,4,8
2,23,75,13,6,7
2,23,76,12,2,10
2,23,77,17,11,6
2,23,78,4,3,1
2,23,79,10,11,-1
2,23,80,14,5,9
2,23,81,18,5,13
2,23,82,17,9,8
2,23,83,28,8,20
2,23,84,6,4,2
2,23,85,27,6,21
2,23,86,24,13,11
2,23,87,10,9,1
2,23,88,18,17,1
2,23,89,12,14,-2
2,23,90,33,9,24
2,23,91,12,7,5
2,23,92,18,7,11
2,23,93,26,13,13
2,23,94,19,8,11
2,23,95,27,3,24
2,23,96,20,11,9
2,23,97,11,8,3
2,23,98,19,13,6
2,23,99,30,8,22
2,23,100,28,11,17
2,23,101,14,9,5
2,23,102,32,9,23
2,23,103,21,17,4
2,23,104,17,17,0
2,23,105,22,9,13
2,23,106,20,5,15
2,23,107,24,16,8
2,23,108,29,5,24
2,23,109,41,10,31
2,23,110,13,12,1
2,23,111,20,11,9
2,23,112,13,4,9
2,23,113,17,12,5
2,23,114,25,7,18
2,23,115,14,13,1
2,23,116,26,11,15
2,23,117,12,4,8
2,23,118,32,15,17
2,23,119,15,6,9
2,23,120,15,7,8
2,23,121,16,11,5
2,23,122,20,5,15
2,23,123,14,17,-3
2,23,124,22,10,12
2,23,125,13,12,1
2,23,126,15,2,13
2,23,127,34,10,24
2,23,128,19,7,12
2,23,129,6,7,-1
2,23,130,14,13,1
2,23,131,8,7,1
2,23,132,21,15,6
2,23,133,12,3,9
2,23,134,12,11,1
2,23,135,11,10,1
2,23,136,16,9,7
2,23,137,42,14,28
2,23,138,11,2,9
2,23,139,19,9,10
2,23,140,21,1,20
2,23,141,16,5,11
2,23,142,6,3,3
2,23,143,29,13,16
2,23,144,14,12,2
2,23,145,19,21,-2
2,23,146,18,5,13
2,23,147,19,9,10
2,23,148,23,11,12
2,23,149,17,0,17
2,23,150,7,7,0
2,23,151,17,7,10
2,23,152,10,11,-1
2,23,153,21,8,13
2,23,154,16,8,8
2,23,155,8,4,4
2,23,156,22,11,11
2,23,157,15,7,8
2,23,158,10,2,8
2,23,159,19,12,7
2,23,160,11,7,4
2,23,161,14,4,10
2,23,162,14,8,6
2,23,163,17,11,6
2,23,164,25,16,9
2,23,165,10,7,3
2,23,166,13,6,7
2,23,167,21,6,15
2,23,168,42,7,35
2,23,169,14,8,6
2,23,170,14,8,6
2,23,171,17,11,6
2,23,172,13,2,11
2,23,173,13,9,4
2,23,174,12,5,7
2,23,175,21,14,7
2,23,176,23,7,16
2,23,177,20,4,16
2,23,178,15,12,3
2,23,179,15,19,-4
2,23,180,18,7,11
2,23,181,18,9,9
2,23,182,10,12,-2
2,23,183,15,4,11
2,23,184,28,9,19
2,23,185,9,11,-2
2,23,186,14,7,7
2,23,187,34,10,24
2,23,188,17,9,8
2,23,189,12,9,3
2,23,190,14,9,5
2,23,191,29,16,13
2,23,192,12,11,1
2,23,193,11,16,-5
2,23,194,16,12,4
2,23,195,19,8,11
2,23,196,9,4,5
2,23,197,14,7,7
2,23,198,9,9,0
2,23,199,19,6,13
2,23,200,14,9,5
2,23,201,27,10,17
2,23,202,21,5,16
2,23,203,20,15,5
2,23,204,19,10,9
2,23,205,14,12,2
2,23,206,20,7,13
2,23,207,34,11,23
2,23,208,18,3,15
2,23,209,8,10,-2
2,23,210,16,7,9
2,23,211,15,7,8
2,23,212,19,7,12
2,23,213,32,16,16
2,23,214,20,14,6
2,23,215,20,18,2
2,23,216,24,11,13
2,23,217,15,17,-2
2,23,218,25,8,17
2,23,219,14,9,5
2,23,220,15,8,7
2,23,221,19,8,11
2,23,222,4,9,-5
2,23,223,16,13,3
2,23,224,17,6,11
2,23,225,39,10,29
2,23,226,25,13,12
2,23,227,21,6,15
2,23,228,6,8,-2
2,23,229,31,12,19
2,23,230,16,12,4
2,23,231,8,4,4
2,23,232,13,11,2
2,23,233,18,5,13
2,23,234,36,20,16
2,23,235,11,0,11
2,23,236,26,10,16
2,23,237,8,7,1
2,23,238,12,6,6
2,23,239,29,11,18
2,23,240,20,9,11
2,23,241,15,10,5
2,23,242,21,9,12
2,23,243,18,10,8
2,23,244,26,25,1
2,23,245,14,14,0
2,23,246,22,16,6
2,23,247,18,8,10
2,23,248,15,6,9
2,23,249,6,4,2
2,23,250,14,14,0
2,23,251,7,2,5
2,23,252,15,9,6
2,23,253,29,12,17
2,23,254,14,8,6
2,23,255,16,6,10
2,23,256,11,11,0
2,23,257,14,4,10
2,23,258,11,5,6
2,23,259,19,6,13
2,23,260,23,9,14
2,23,261,26,14,12
2,23,262,21,4,17
2,23,263,5,1,4
2,23,264,17,13,4
2,23,265,13,8,5
2,23,266,26,7,19
2,23,267,15,6,9
2,23,268,8,6,2
2,23,269,8,6,2
2,23,270,16,9,7
2,23,271,7,5,2
2,23,272,13,10,3
2,23,273,13,13,0
2,23,274,10,4,6
2,23,275,25,10,15
2,23,276,15,18,-3
2,23,277,19,8,11
2,23,278,23,12,11
2,23,279,20,11,9
2,23,280,17,9,8
2,23,281,8,11,-3
2,23,282,27,19,8
2,23,283,25,4,21
2,23,284,19,8,11
2,23,285,12,4,8
2,23,286,21,11,10
2,23,287,13,8,5
2,23,288,11,5,6
2,23,289,22,16,6
2,23,290,23,19,4
2,23,291,10,7,3
2,23,292,12,10,2
2,23,293,16,6,10
2,23,294,14,14,0
2,23,295,14,10,4
2,23,296,13,5,8
2,23,297,15,13,2
2,23,298,26,7,19
2,23,299,14,15,-1
2,24,0,25,12,13
2,24,1,6,3,3
2,24,2,5,5,0
2,24,3,29,11,18
2,24,4,21,9,12
2,24,5,24,8,16
2,24,6,23,9,14
2,24,7,10,7,3
2,24,8,19,16,3
2,24,9,9,6,3
2,24,10,26,10,16
2,24,11,13,5,8
2,24,12,20,8,12
2,24,13,17,9,8
2,24,14,31,10,21
2,24,15,21,7,14
2,24,16,14,5,9
2,24,17,7,2,5
2,24,18,10,5,5
2,24,19,12,7,5
2,24,20,9,3,6
2,24,21,18,6,12
2,24,22,24,5,19
2,24,23,20,4,16
2,24,24,25,10,15
2,24,25,29,7,22
2,24,26,7,2,5
2,24,27,11,12,-1
2,24,28,23,17,6
2,24,29,19,8,11
2,24,30,16,12,4
2,24,31,16,7,9
2,24,32,28,9,19
2,24,33,19,11,8
2,24,34,16,8,8
2,24,35,20,7,13
2,24,36,12,3,9
2,24,37,17,6,11
2,24,38,23,19,4
2,24,39,31,12,19
2,24,40,19,7,12
2,24,41,32,9,23
2,24,42,13,11,2
2,24,43,23,5,18
2,24,44,11,15,-4
2,24,45,21,6,15
2,24,46,10,8,2
2,24,47,15,10,5
2,24,48,23,10,13
2,24,49,13,11,2
2,24,50,15,13,2
2,24,51,14,2,12
2,24,52,12,4,8
2,24,53,15,13,2
2,24,54,27,6,21
2,24,55,24,2,22
2,24,56,23,13,10
2,24,57,9,5,4
2,24,58,12,14,-2
2,24,59,8,2,6
2,24,60,6,5,1
2,24,61,22,12,10
2,24,62,13,2,11
2,24,63,15,12,3
2,24,64,30,4,26
2,24,65,18,9,9
2,24,66,12,7,5
2,24,67,16,11,5
2,24,68,32,11,21
2,24,69,8,3,5
2,24,70,20,10,10
2,24,71,9,11,-2
2,24,72,26,10,16
2,24,73,13,6,7
2,24,74,18,6,12
2,24,75,19,10,9
2,24,76,25,6,19
2,24,77,31,16,15
2,24,78,17,3,14
2,24,79,12,4,8
2,24,80,13,11,2
2,24,81,21,7,14
2,24,82,7,8,-1
2,24,83,36,16,20
2,24,84,5,4,1
2,24,85,21,16,5
2,24,86,13,7,6
2,24,87,13,5,8
2,24,88,16,12,4
2,24,89,9,13,-4
2,24,90,7,6,1
2,24,91,30,10,20
2,24,92,36,25,11
2,24,93,19,6,13
2,24,94,22,3,19
2,24,95,5,4,1
2,24,96,19,6,13
2,24,97,31,8,23
2,24,98,32,7,25
2,24,99,23,17,6
2,24,100,16,12,4
2,24,101,15,15,0
2,24,102,30,6,24
2,24,103,18,16,2
2,24,104,15,8,7
2,24,105,11,11,0
2,24,106,7,5,2
2,24,107,21,13,8
2,24,108,12,7,5
2,24,109,21,6,15
2,24,110,13,6,7
2,24,111,17,6,11
2,24,112,13,9,4
2,24,113,15,3,12
2,24,114,17,8,9
2,24,115,14,7,7
2,24,116,17,7,10
2,24,117,8,9,-1
2,24,118,25,5,20
2,24,119,21,11,10
2,24,120,20,4,16
2,24,121,16,10,6
2,24,122,13,6,7
2,24,123,16,18,-2
2,24,124,14,15,-1
2,24,125,22,12,10
2,24,126,20,18,2
2,24,127,20,9,11
2,24,128,16,11,5
2,24,129,28,11,17
2,24,130,12,8,4
2,24,131,25,11,14
2,24,132,16,11,5
2,24,133,14,11,3
2,24,134,15,13,2
2,24,135,14,9,5
2,24,136,18,17,1
2,24,137,19,6,13
2,24,138,12,9,3
2,24,139,20,4,16
2,24,140,16,5,11
2,24,141,26,8,18
2,24,142,12,4,8
2,24,143,15,16,-1
2,24,144,20,23,-3
2,24,145,21,11,10
2,24,146,22,13,9
2,24,147,10,11,-1
2,24,148,10,12,-2
2,24,149,20,9,11
2,24,150,17,8,9
2,24,151,7,4,3
2,24,152,26,17,9
2,24,153,16,8,8
2,24,154,17,11,6
2,24,155,21,12,9
2,24,156,12,1,11
2,24,157,18,9,9
2,24,158,18,9,9
2,24,159,25,7,18
2,24,160,23,5,18
2,24,161,29,8,21
2,24,162,9,3,6
2,24,163,20,10,10
2,24,164,18,13,5
2,24,165,6,9,-3
2,24,166,8,4,4
2,24,167,27,11,16
2,24,168,20,7,13
2,24,169,24,6,18
2,24,170,14,15,-1
2,24,171,25,13,12
2,24,172,10,11,-1
2,24,173,21,13,8
2,24,174,10,5,5
2,24,175,15,12,3
2,24,176,40,11,29
2,24,177,17,14,3
2,24,178,10,4,6
2,24,179,16,7,9
2,24,180,6,5,1
2,24,181,22,10,12
2,24,182,18,8,10
2,24,183,15,8,7
2,24,184,25,11,14
2,24,185,16,10,6
2,24,186,13,12,1
2,24,187,17,7,10
2,24,188,7,9,-2
2,24,189,24,6,18
2,24,190,19,14,5
2,24,191,24,23,1
2,24,192,13,10,3
2,24,193,22,11,11
2,24,194,30,21,9
2,24,195,23,7,16
2,24,196,26,13,13
2,24,197,21,10,11
2,24,198,15,1,14
2,24,199,15,6,9
2,24,200,24,25,-1
2,24,201,9,4,5
2,24,202,20,22,-2
2,24,203,20,9,11
2,24,204,11,5,6
2,24,205,15,4,11
2,24,206,29,15,14
2,24,207,27,4,23
2,24,208,27,10,17
2,24,209,12,8,4
2,24,210,22,9,13
2,24,211,21,10,11
2,24,212,11,14,-3
2,24,213,20,12,8
2,24,214,24,10,14
2,24,215,12,8,4
2,24,216,17,5,12
2,24,217,34,14,20
2,24,218,20,11,9
2,24,219,32,8,24
2,24,220,17,3,14
2,24,221,32,16,16
2,24,222,22,4,18
2,24,223,17,7,10
2,24,224,20,3,17
2,24,225,26,8,18
2,24,226,14,9,5
2,24,227,19,16,3
2,24,228,23,12,11
2,24,229,27,14,13
2,24,230,12,3,9
2,24,231,4,8,-4
2,24,232,24,12,12
2,24,233,14,5,9
2,24,234,18,14,4
2,24,235,8,11,-3
2,24,236,30,8,22
2,24,237,24,13,11
2,24,238,13,6,7
2,24,239,18,9,9
2,24,240,16,24,-8
2,24,241,13,5,8
2,24,242,15,5,10
2,24,243,13,8,5
2,24,244,22,13,9
2,24,245,7,10,-3
2,24,246,16,16,0
2,24,247,7,12,-5
2,24,248,18,7,11
2,24,249,10,3,7
2,24,250,25,4,21
2,24,251,18,7,11
2,24,252,19,14,5
2,24,253,12,10,2
2,24,254,21,12,9
2,24,255,2,13,-11
2,24,256,23,9,14
2,24,257,17,15,2
2,24,258,26,21,5
2,24,259,8,14,-6
2,24,260,22,10,12
2,24,261,20,16,4
2,24,262,21,14,7
2,24,263,21,18,3
2,24,264,21,9,12
2,24,265,17,12,5
2,24,266,23,9,14
2,24,267,19,12,7
2,24,268,17,17,0
2,24,269,41,10,31
2,24,270,12,6,6
2,24,271,16,7,9
2,24,272,29,11,18
2,24,273,30,5,25
2,24,274,19,6,13
2,24,275,9,16,-7
2,24,276,16,6,10
2,24,277,25,7,18
2,24,278,20,7,13
2,24,279,12,13,-1
2,24,280,14,3,11
2,24,281,14,16,-2
2,24,282,16,17,-1
2,24,283,12,3,9
2,24,284,8,9,-1
2,24,285,13,6,7
2,24,286,26,4,22
2,24,287,23,12,11
2,24,288,28,6,22
2,24,289,14,9,5
2,24,290,28,13,15
2,24,291,29,15,14
2,24,292,15,3,12
2,24,293,13,8,5
2,24,294,20,8,12
2,24,295,10,12,-2
2,24,296,13,7,6
2,24,297,20,7,13
2,24,298,23,11,12
2,24,299,21,14,7
2,25,0,29,8,21
2,25,1,13,8,5
2,25,2,15,11,4
2,25,3,9,8,1
2,25,4,17,3,14
2,25,5,9,6,3
2,25,6,8,10,-2
2,25,7,32,10,22
2,25,8,20,10,10
2,25,9,18,3,15
2,25,10,18,4,14
2,25,11,16,6,10
2,25,12,23,8,15
2,25,13,13,6,7
2,25,14,13,8,5
2,25,15,7,2,5
2,25,16,23,7,16
2,25,17,13,12,1
2,25,18,6,13,-7
2,25,19,9,2,7
2,25,20,16,10,6
2,25,21,9,4,5
2,25,22,24,21,3
2,25,23,8,3,5
2,25,24,10,3,7
2,25,25,23,19,4
2,25,26,20,8,12
2,25,27,32,8,24
2,25,28,21,13,8
2,25,29,17,15,2
2,25,30,22,9,13
2,25,31,10,2,8
2,25,32,13,4,9
2,25,33,27,7,20
2,25,34,12,13,-1
2,25,35,11,10,1
2,25,36,13,9,4
2,25,37,20,15,5
2,25,38,23,12,11
2,25,39,11,10,1
2,25,40,10,9,1
2,25,41,13,14,-1
2,25,42,11,7,4
2,25,43,20,12,8
2,25,44,18,11,7
2,25,45,13,12,1
2,25,46,23,14,9
2,25,47,8,3,5
2,25,48,20,13,7
2,25,49,31,15,16
2,25,50,21,5,16
2,25,51,25,6,19
2,25,52,13,10,3
2,25,53,24,13,11
2,25,54,12,8,4
2,25,55,23,13,10
2,25,56,12,2,10
2,25,57,23,12,11
2,25,58,13,5,8
2,25,59,24,8,16
2,25,60,25,5,20
2,25,61,12,4,8
2,25,62,20,16,4
2,25,63,25,16,9
2,25,64,16,6,10
2,25,65,19,14,5
2,25,66,18,10,8
2,25,67,15,9,6
2,25,68,28,16,12
2,25,69,12,5,7
2,25,70,18,8,10
2,25,71,28,10,18
2,25,72,15,4,11
2,25,73,20,11,9
2,25,74,22,19,3
2,25,75,18,13,5
2,25,76,23,6,17
2,25,77,25,8,17
2,25,78,16,5,11
2,25,79,13,5,8
2,25,80,21,6,15
2,25,81,23,14,9
2,25,82,21,15,6
2,25,83,34,2,32
2,25,84,31,13,18
2,25,85,10,5,5
2,25,86,16,15,1
2,25,87,14,8,6
2,25,88,28,16,12
2,25,89,23,7,16
2,25,90,27,16,11
2,25,91,13,9,4
2,25,92,26,7,19
2,25,93,16,4,12
2,25,94,25,11,14
2,25,95,9,8,1
2,25,96,28,5,23
2,25,97,12,2,10
2,25,98,10,7,3
2,25,99,16,8,8
2,25,100,8,14,-6
2,25,101,19,10,9
2,25,102,26,3,23
2,25,103,17,15,2
2,25,104,21,4,17
2,25,105,26,9,17
2,25,106,14,7,7
2,25,107,6,8,-2
2,25,108,22,9,13
2,25,109,13,11,2
2,25,110,18,17,1
2,25,111,16,18,-2
2,25,112,12,11,1
2,25,113,18,14,4
2,25,114,20,8,12
2,25,115,8,3,5
2,25,116,15,7,8
2,25,117,22,9,13
2,25,118,22,7,15
2,25,119,22,11,11
2,25,120,9,3,6
2,25,121,17,4,13
2,25,122,14,14,0
2,25,123,18,9,9
2,25,124,15,13,2
2,25,125,26,9,17
2,25,126,8,5,3
2,25,127,16,5,11
2,25,128,19,4,15
2,25,129,17,12,5
2,25,130,23,14,9
2,25,131,18,15,3
2,25,132,12,15,-3
2,25,133,24,13,11
2,25,134,13,7,6
2,25,135,15,12,3
2,25,136,14,6,8
2,25,137,25,10,15
2,25,138,16,9,7
2,25,139,19,6,13
2,25,140,20,9,11
2,25,141,16,12,4
2,25,142,13,3,10
2,25,143,16,15,1
2,25,144,20,5,15
2,25,145,12,3,9
2,25,146,28,14,14
2,25,147,14,4,10
2,25,148,33,14,19
2,25,149,12,3,9
2,25,150,10,8,2
2,25,151,20,1,19
2,25,152,28,11,17
2,25,153,25,13,12
2,25,154,19,11,8
2,25,155,14,3,11
2,25,156,20,6,14
2,25,157,17,8,9
2,25,158,12,7,5
2,25,159,17,11,6
2,25,160,25,13,12
2,25,161,17,10,7
2,25,162,17,11,6
2,25,163,13,8,5
2,25,164,29,11,18
2,25,165,27,6,21
2,25,166,16,7,9
2,25,167,16,14,2
2,25,168,21,10,11
2,25,169,18,7,11
2,25,170,13,9,4
2,25,171,8,11,-3
2,25,172,29,9,20
2,25,173,12,14,-2
2,25,174,26,4,22
2,25,175,11,4,7
2,25,176,15,7,8
2,25,177,29,12,17
2,25,178,7,7,0
2,25,179,24,5,19
2,25,180,29,6,23
2,25,181,10,5,5
2,25,182,12,8,4
2,25,183,22,23,-1
2,25,184,20,6,14
2,25,185,16,5,11
2,25,186,11,9,2
2,25,187,31,8,23
2,25,188,9,11,-2
2,25,189,22,6,16
2,25,190,12,12,0
2,25,191,19,4,15
2,25,192,20,9,11
2,25,193,21,6,15
2,25,194,20,18,2
2,25,195,25,7,18
2,25,196,7,2,5
2,25,197,10,7,3
2,25,198,14,6,8
2,25,199,11,6,5
2,25,200,24,17,7
2,25,201,28,6,22
2,25,202,15,11,4
2,25,203,26,7,19
2,25,204,10,5,5
2,25,205,6,15,-9
2,25,206,13,2,11
2,25,207,22,13,9
2,25,208,11,0,11
2,25,209,23,9,14
2,25,210,16,4,12
2,25,211,11,12,-1
2,25,212,17,12,5
2,25,213,16,7,9
2,25,214,19,9,10
2,25,215,28,9,19
2,25,216,15,8,7
2,25,217,8,9,-1
2,25,218,28,9,19
2,25,219,23,9,14
2,25,220,8,5,3
2,25,221,13,6,7
2,25,222,23,12,11
2,25,223,20,12,8
2,25,224,19,22,-3
2,25,225,18,9,9
2,25,226,11,6,5
2,25,227,13,7,6
2,25,228,15,7,8
2,25,229,15,5,10
2,25,230,25,17,8
2,25,231,23,11,12
2,25,232,10,4,6
2,25,233,13,3,10
2,25,234,16,15,1
2,25,235,30,14,16
2,25,236,17,10,7
2,25,237,15,4,11
2,25,238,20,6,14
2,25,239,14,11,3
2,25,240,17,4,13
2,25,241,22,4,18
2,25,242,26,7,19
2,25,243,25,23,2
2,25,244,29,19,10
2,25,245,25,10,15
2,25,246,21,13,8
2,25,247,20,10,10
2,25,248,18,17,1
2,25,249,11,8,3
2,25,250,22,15,7
2,25,251,20,5,15
2,25,252,20,13,7
2,25,253,13,9,4
2,25,254,29,7,22
2,25,255,11,6,5
2,25,256,22,17,5
2,25,257,19,7,12
2,25,258,10,7,3
2,25,259,25,8,17
2,25,260,11,4,7
2,25,261,17,7,10
2,25,262,16,5,11
2,25,263,19,15,4
2,25,264,21,4,17
2,25,265,11,2,9
2,25,266,32,13,19
2,25,267,31,15,16
2,25,268,23,10,13
2,25,269,12,2,10
2,25,270,12,2,10
2,25,271,27,13,14
2,25,272,19,7,12
2,25,273,18,7,11
2,25,274,14,7,7
2,25,275,9,6,3
2,25,276,19,4,15
2,25,277,7,7,0
2,25,278,8,1,7
2,25,279,19,11,8
2,25,280,24,6,18
2,25,281,18,2,16
2,25,282,26,10,16
2,25,283,18,10,8
2,25,284,22,7,15
2,25,285,15,10,5
2,25,286,21,12,9
2,25,287,29,12,17
2,25,288,15,11,4
2,25,289,12,13,-1
2,25,290,17,2,15
2,25,291,20,6,14
2,25,292,15,7,8
2,25,293,14,4,10
2,25,294,15,11,4
2,25,295,5,6,-1
2,25,296,15,16,-1
2,25,297,31,13,18
2,25,298,30,18,12
2,25,299,20,12,8
2,26,0,20,14,6
2,26,1,21,6,15
2,26,2,22,9,13
2,26,3,12,6,6
2,26,4,13,8,5
2,26,5,11,6,5
2,26,6,13,5,8
2,26,7,10,7,3
2,26,8,24,8,16
2,26,9,22,10,12
2,26,10,21,7,14
2,26,11,17,5,12
2,26,12,12,20,-8
2,26,13,28,7,21
2,26,14,9,2,7
2,26,15,18,10,8
2,26,16,9,8,1
2,26,17,15,3,12
2,26,18,21,5,16
2,26,19,16,4,12
2,26,20,25,8,17
2,26,21,9,5,4
2,26,22,28,12,16
2,26,23,28,6,22
2,26,24,12,9,3
2,26,25,18,9,9
2,26,26,21,12,9
2,26,27,30,18,12
2,26,28,19,7,12
2,26,29,15,10,5
2,26,30,22,9,13
2,26,31,17,11,6
2,26,32,28,10,18
2,26,33,12,8,4
2,26,34,12,5,7
2,26,35,8,6,2
2,26,36,31,10,21
2,26,37,19,6,13
2,26,38,11,16,-5
2,26,39,15,7,8
2,26,40,20,10,10
2,26,41,5,4,1
2,26,42,19,2,17
2,26,43,7,12,-5
2,26,44,13,5,8
2,26,45,10,5,5
2,26,46,13,4,9
2,26,47,25,16,9
2,26,48,16,17,-1
2,26,49,12,2,10
2,26,50,20,7,13
2,26,51,22,11,11
2,26,52,14,6,8
2,26,53,9,7,2
2,26,54,23,12,11
2,26,55,19,7,12
2,26,56,10,6,4
2,26,57,26,7,19
2,26,58,20,12,8
2,26,59,10,13,-3
2,26,60,19,9,10
2,26,61,14,15,-1
2,26,62,22,9,13
2,26,63,21,14,7
2,26,64,30,14,16
2,26,65,24,9,15
2,26,66,5,3,2
2,26,67,8,23,-15
2,26,68,30,10,20
2,26,69,28,11,17
2,26,70,15,5,10
2,26,71,12,9,3
2,26,72,21,5,16
2,26,73,24,16,8
2,26,74,18,6,12
2,26,75,31,8,23
2,26,76,21,6,15
2,26,77,13,7,6
2,26,78,23,8,15
2,26,79,34,12,22
2,26,80,18,7,11
2,26,81,21,10,11
2,26,82,14,6,8
2,26,83,29,5,24
2,26,84,24,10,14
2,26,85,8,4,4
2,26,86,24,9,15
2,26,87,16,20,-4
2,26,88,22,14,8
2,26,89,16,4,12
2,26,90,15,16,-1
2,26,91,18,9,9
2,26,92,17,17,0
2,26,93,14,6,8
2,26,94,23,10,13
2,26,95,25,6,19
2,26,96,13,14,-1
2,26,97,31,3,28
2,26,98,8,7,1
2,26,99,36,17,19
2,26,100,12,7,5
2,26,101,13,7,6
2,26,102,10,5,5
2,26,103,13,13,0
2,26,104,19,10,9
2,26,105,14,5,9
2,26,106,11,5,6
2,26,107,23,10,13
2,26,108,13,3,10
2,26,109,7,1,6
2,26,110,15,4,11
2,26,111,10,7,3
2,26,112,15,7,8
2,26,113,18,2,16
2,26,114,11,12,-1
2,26,115,27,15,12
2,26,116,23,5,18
2,26,117,20,9,11
2,26,118,20,16,4
2,26,119,11,12,-1
2,26,120,21,9,12
2,26,121,29,7,22
2,26,122,14,6,8
2,26,123,28,14,14
2,26,124,9,6,3
2,26,125,9,2,7
2,26,126,23,11,12
2,26,127,20,3,17
2,26,128,15,11,4
2,26,129,27,10,17
2,26,130,27,5,22
2,26,131,27,8,19
2,26,132,11,10,1
2,26,133,14,16,-2
2,26,134,20,9,11
2,26,135,16,12,4
2,26,136,12,6,6
2,26,137,15,10,5
2,26,138,24,9,15
2,26,139,15,5,10
2,26,140,15,8,7
2,26,141,9,14,-5
2,26,142,15,6,9
2,26,143,21,9,12
2,26,144,19,7,12
2,26,145,16,10,6
2,26,146,17,8,9
2,26,147,15,6,9
2,26,148,23,13,10
2,26,149,10,13,-3
2,26,150,15,11,4
2,26,151,16,12,4
2,26,152,16,15,1
2,26,153,12,11,1
2,26,154,13,6,7
2,26,155,18,11,7
2,26,156,11,5,6
2,26,157,27,11,16
2,26,158,15,6,9
2,26,159,11,4,7
2,26,160,11,9,2
2,26,161,9,5,4
2,26,162,13,8,5
2,26,163,5,3,2
2,26,164,19,8,11
2,26,165,13,3,10
2,26,166,20,8,12
2,26,167,20,6,14
2,26,168,12,5,7
2,26,169,17,11,6
2,26,170,24,12,12
2,26,171,12,11,1
2,26,172,13,8,5
2,26,173,10,11,-1
2,26,174,18,7,11
2,26,175,26,10,16
2,26,176,14,15,-1
2,26,177,10,2,8
2,26,178,17,10,7
2,26,179,21,11,10
2,26,180,7,4,3
2,26,181,17,11,6
2,26,182,29,13,16
2,26,183,17,16,1
2,26,184,21,9,12
2,26,185,19,6,13
2,26,186,17,12,5
2,26,187,19,2,17
2,26,188,20,6,14
2,26,189,28,11,17
2,26,190,20,10,10
2,26,191,11,14,-3
2,26,192,14,5,9
2,26,193,18,13,5
2,26,194,13,7,6
2,26,195,15,12,3
2,26,196,7,9,-2
2,26,197,13,3,10
2,26,198,18,9,9
2,26,199,9,6,3
2,26,200,29,9,20
2,26,201,17,7,10
2,26,202,21,7,14
2,26,203,16,13,3
2,26,204,15,10,5
2,26,205,11,5,6
2,26,206,17,4,13
2,26,207,25,14,11
2,26,208,14,8,6
2,26,209,6,6,0
2,26,210,21,5,16
2,26,211,18,9,9
2,26,212,16,7,9
2,26,213,12,11,1
2,26,214,20,2,18
2,26,215,39,10,29
2,26,216,30,16,14
2,26,217,13,2,11
2,26,218,10,4,6
2,26,219,27,7,20
2,26,220,24,7,17
2,26,221,11,7,4
2,26,222,16,2,14
2,26,223,13,17,-4
2,26,224,19,11,8
2,26,225,22,7,15
2,26,226,27,9,18
2,26,227,10,12,-2
2,26,228,30,10,20
2,26,229,29,14,15
2,26,230,10,11,-1
2,26,231,15,5,10
2,26,232,14,1,13
2,26,233,19,7,12
2,26,234,25,3,22
2,26,235,31,11,20
2,26,236,15,6,9
2,26,237,22,8,14
2,26,238,26,11,15
2,26,239,20,14,6
2,26,240,11,8,3
2,26,241,27,7,20
2,26,242,16,11,5
2,26,243,18,11,7
2,26,244,21,3,18
2,26,245,17,10,7
2,26,246,16,3,13
2,26,247,24,6,18
2,26,248,15,6,9
2,26,249,40,6,34
2,26,250,27,16,11
2,26,251,13,14,-1
2,26,252,24,16,8
2,26,253,17,2,15
2,26,254,24,7,17
2,26,255,20,2,18
2,26,256,21,17,4
2,26,257,23,9,14
2,26,258,18,4,14
2,26,259,25,8,17
2,26,260,13,5,8
2,26,261,41,4,37
2,26,262,15,0,15
2,26,263,10,3,7
2,26,264,26,16,10
2,26,265,24,6,18
2,26,266,26,20,6
2,26,267,16,4,12
2,26,268,25,18,7
2,26,269,14,17,-3
2,26,270,18,5,13
2,26,271,16,7,9
2,26,272,11,6,5
2,26,273,13,6,7
2,26,274,21,9,12
2,26,275,13,8,5
2,26,276,12,8,4
2,26,277,32,11,21
2,26,278,21,9,12
2,26,279,33,12,21
2,26,280,11,7,4
2,26,281,13,9,4
2,26,282,18,7,11
2,26,283,15,4,11
2,26,284,11,4,7
2,26,285,19,10,9
2,26,286,19,9,10
2,26,287,26,8,18
2,26,288,12,14,-2
2,26,289,20,8,12
2,26,290,22,8,14
2,26,291,27,14,13
2,26,292,21,12,9
2,26,293,14,3,11
2,26,294,14,11,3
2,26,295,12,7,5
2,26,296,18,8,10
2,26,297,20,10,10
2,26,298,15,21,-6
2,26,299,26,14,12
2,27,0,18,7,11
2,27,1,20,9,11
2,27,2,19,15,4
2,27,3,22,11,11
2,27,4,34,13,21
2,27,5,14,13,1
2,27,6,8,8,0
2,27,7,14,8,6
2,27,8,12,4,8
2,27,9,19,12,7
2,27,10,8,3,5
2,27,11,8,7,1
2,27,12,24,7,17
2,27,13,12,1,11
2,27,14,19,4,15
2,27,15,33,13,20
2,27,16,16,15,1
2,27,17,9,10,-1
2,27,18,10,8,2
2,27,19,14,10,4
2,27,20,13,7,6
2,27,21,30,4,26
2,27,22,18,7,11
2,27,23,11,13,-2
2,27,24,13,4,9
2,27,25,19,6,13
2,27,26,11,6,5
2,27,27,17,13,4
2,27,28,17,16,1
2,27,29,14,7,7
2,27,30,19,16,3
2,27,31,14,4,10
2,27,32,14,7,7
2,27,33,17,12,5
2,27,34,15,10,5
2,27,35,21,3,18
2,27,36,19,3,16
2,27,37,11,2,9
2,27,38,7,2,5
2,27,39,9,4,5
2,27,40,12,7,5
2,27,41,20,8,12
2,27,42,9,3,6
2,27,43,23,9,14
2,27,44,9,4,5
2,27,45,17,6,11
2,27,46,19,10,9
2,27,47,8,12,-4
2,27,48,17,5,12
2,27,49,24,4,20
2,27,50,11,7,4
2,27,51,13,7,6
2,27,52,10,4,6
2,27,53,13,6,7
2,27,54,17,13,4
2,27,55,14,6,8
2,27,56,18,13,5
2,27,57,16,12,4
2,27,58,20,16,4
2,27,59,22,19,3
2,27,60,12,12,0
2,27,61,23,8,15
2,27,62,16,3,13
2,27,63,25,5,20
2,27,64,29,10,19
2,27,65,18,6,12
2,27,66,17,17,0
2,27,67,25,7,18
2,27,68,20,6,14
2,27,69,15,6,9
2,27,70,15,12,3
2,27,71,20,10,10
2,27,72,35,10,25
2,27,73,10,3,7
2,27,74,20,9,11
2,27,75,35,18,17
2,27,76,20,8,12
2,27,77,22,8,14
2,27,78,12,8,4
2,27,79,6,6,0
2,27,80,19,7,12
2,27,81,8,8,0
2,27,82,9,8,1
2,27,83,15,3,12
2,27,84,21,7,14
2,27,85,12,2,10
2,27,86,15,10,5
2,27,87,34,12,22
2,27,88,13,2,11
2,27,89,19,6,13
2,27,90,22,14,8
2,27,91,7,9,-2
2,27,92,21,7,14
2,27,93,13,10,3
2,27,94,28,16,12
2,27,95,22,20,2
2,27,96,19,6,13
2,27,97,15,11,4
2,27,98,32,4,28
2,27,99,19,10,9
2,27,100,23,13,10
2,27,101,12,8,4
2,27,102,16,5,11
2,27,103,19,22,-3
2,27,104,28,10,18
2,27,105,39,6,33
2,27,106,18,8,10
2,27,107,35,6,29
2,27,108,13,8,5
2,27,109,13,12,1
2,27,110,8,5,3
2,27,111,19,9,10
2,27,112,15,11,4
2,27,113,13,4,9
2,27,114,15,2,13
2,27,115,15,22,-7
2,27,116,3,4,-1
2,27,117,17,8,9
2,27,118,11,5,6
2,27,119,14,13,1
2,27,120,8,4,4
2,27,121,4,0,4
2,27,122,18,6,12
2,27,123,24,3,21
2,27,124,17,17,0
2,27,125,32,11,21
2,27,126,8,13,-5
2,27,127,28,7,21
2,27,128,25,8,17
2,27,129,28,0,28
2,27,130,16,6,10
2,27,131,20,6,14
2,27,132,26,8,18
2,27,133,17,4,13
2,27,134,20,8,12
2,27,135,20,10,10
2,27,136,24,13,11
2,27,137,23,8,15
2,27,138,14,6,8
2,27,139,27,6,21
2,27,140,16,11,5
2,27,141,21,6,15
2,27,142,11,7,4
2,27,143,26,8,18
2,27,144,14,7,7
2,27,145,32,6,26
2,27,146,18,10,8
2,27,147,8,5,3
2,27,148,28,20,8
2,27,149,19,9,10
2,27,150,14,4,10
2,27,151,20,7,13
2,27,152,15,11,4
2,27,153,14,12,2
2,27,154,7,7,0
2,27,155,21,3,18
2,27,156,12,1,11
2,27,157,17,8,9
2,27,158,14,4,10
2,27,159,19,6,13
2,27,160,14,9,5
2,27,161,15,12,3
2,27,162,18,10,8
2,27,163,11,14,-3
2,27,164,34,6,28
2,27,165,9,11,-2
2,27,166,14,7,7
2,27,167,25,3,22
2,27,168,14,4,10
2,27,169,15,17,-2
2,27,170,12,14,-2
2,27,171,12,8,4
2,27,172,11,6,5
2,27,173,29,9,20
2,27,174,21,3,18
2,27,175,23,1,22
2,27,176,27,5,22
2,27,177,26,11,15
2,27,178,28,16,12
2,27,179,21,5,16
2,27,180,21,9,12
2,27,181,20,10,10
2,27,182,15,14,1
2,27,183,16,6,10
2,27,184,13,6,7
2,27,185,25,9,16
2,27,186,14,1,13
2,27,187,17,6,11
2,27,188,24,7,17
2,27,189,14,15,-1
2,27,190,24,9,15
2,27,191,19,18,1
2,27,192,15,9,6
2,27,193,26,16,10
2,27,194,17,9,8
2,27,195,5,4,1
2,27,196,19,14,5
2,27,197,5,5,0
2,27,198,13,4,9
2,27,199,18,9,9
2,27,200,23,17,6
2,27,201,17,12,5
2,27,202,13,8,5
2,27,203,22,5,17
2,27,204,25,16,9
2,27,205,26,10,16
2,27,206,29,8,21
2,27,207,17,5,12
2,27,208,18,5,13
2,27,209,24,20,4
2,27,210,26,12,14
2,27,211,13,12,1
2,27,212,18,10,8
2,27,213,25,11,14
2,27,214,18,8,10
2,27,215,14,6,8
2,27,216,14,12,2
2,27,217,10,11,-1
2,27,218,26,9,17
2,27,219,20,4,16
2,27,220,14,12,2
2,27,221,13,11,2
2,27,222,17,10,7
2,27,223,20,15,5
2,27,224,14,12,2
2,27,225,10,3,7
2,27,226,12,2,10
2,27,227,18,6,12
2,27,228,19,6,13
2,27,229,9,5,4
2,27,230,19,4,15
2,27,231,28,3,25
2,27,232,18,10,8
2,27,233,14,1,13
2,27,234,20,4,16
2,27,235,5,6,-1
2,27,236,22,15,7
2,27,237,16,6,10
2,27,238,32,8,24
2,27,239,17,3,14
2,27,240,13,9,4
2,27,241,11,5,6
2,27,242,13,5,8
2,27,243,24,14,10
2,27,244,21,5,16
2,27,245,7,2,5
2,27,246,14,9,5
2,27,247,29,8,21
2,27,248,20,16,4
2,27,249,14,6,8
2,27,250,25,10,15
2,27,251,15,10,5
2,27,252,28,8,20
2,27,253,20,4,16
2,27,254,20,0,20
2,27,255,28,13,15
2,27,256,21,7,14
2,27,257,20,6,14
2,27,258,11,4,7
2,27,259,15,7,8
2,27,260,16,5,11
2,27,261,20,6,14
2,27,262,20,6,14
2,27,263,12,4,8
2,27,264,34,17,17
2,27,265,15,12,3
2,27,266,14,11,3
2,27,267,10,8,2
2,27,268,15,10,5
2,27,269,35,9,26
2,27,270,16,7,9
2,27,271,17,12,5
2,27,272,17,7,10
2,27,273,12,4,8
2,27,274,28,5,23
2,27,275,18,15,3
2,27,276,18,6,12
2,27,277,11,4,7
2,27,278,13,14,-1
2,27,279,34,17,17
2,27,280,18,5,13
2,27,281,7,11,-4
2,27,282,24,11,13
2,27,283,14,7,7
2,27,284,5,5,0
2,27,285,29,5,24
2,27,286,14,11,3
2,27,287,22,24,-2
2,27,288,21,4,17
2,27,289,15,10,5
2,27,290,23,10,13
2,27,291,20,13,7
2,27,292,7,11,-4
2,27,293,28,9,19
2,27,294,15,9,6
2,27,295,16,10,6
2,27,296,18,9,9
2,27,297,32,10,22
2,27,298,31,9,22
2,27,299,26,8,18
2,28,0,16,7,9
2,28,1,19,12,7
2,28,2,11,4,7
2,28,3,13,9,4
2,28,4,10,14,-4
2,28,5,12,13,-1
2,28,6,13,7,6
2,28,7,21,11,10
2,28,8,30,8,22
2,28,9,29,11,18
2,28,10,16,4,12
2,28,11,14,6,8
2,28,12,19,7,12
2,28,13,7,12,-5
2,28,14,10,1,9
2,28,15,13,2,11
2,28,16,23,2,21
2,28,17,15,7,8
2,28,18,23,3,20
2,28,19,17,9,8
2,28,20,20,12,8
2,28,21,29,8,21
2,28,22,18,8,10
2,28,23,25,6,19
2,28,24,17,19,-2
2,28,25,24,13,11
2,28,26,17,8,9
2,28,27,19,10,9
2,28,28,9,7,2
2,28,29,20,8,12
2,28,30,22,12,10
2,28,31,14,14,0
2,28,32,13,5,8
2,28,33,16,10,6
2,28,34,31,12,19
2,28,35,24,14,10
2,28,36,12,11,1
2,28,37,22,8,14
2,28,38,12,3,9
2,28,39,22,6,16
2,28,40,28,11,17
2,28,41,19,8,11
2,28,42,10,4,6
2,28,43,13,3,10
2,28,44,27,12,15
2,28,45,23,9,14
2,28,46,10,5,5
2,28,47,28,9,19
2,28,48,22,6,16
2,28,49,21,9,12
2,28,50,19,10,9
2,28,51,23,11,12
2,28,52,14,4,10
2,28,53,8,3,5
2,28,54,11,5,6
2,28,55,12,10,2
2,28,56,22,6,16
2,28,57,26,5,21
2,28,58,35,16,19
2,28,59,19,10,9
2,28,60,24,9,15
2,28,61,29,5,24
2,28,62,19,9,10
2,28,63,21,10,11
2,28,64,29,12,17
2,28,65,19,12,7
2,28,66,14,5,9
2,28,67,12,9,3
2,28,68,11,5,6
2,28,69,9,9,0
2,28,70,22,5,17
2,28,71,5,4,1
2,28,72,18,5,13
2,28,73,22,10,12
2,28,74,13,6,7
2,28,75,22,10,12
2,28,76,22,9,13
2,28,77,13,2,11
2,28,78,12,10,2
2,28,79,15,11,4
2,28,80,14,10,4
2,28,81,14,11,3
2,28,82,23,7,16
2,28,83,21,10,11
2,28,84,28,11,17
2,28,85,22,13,9
2,28,86,23,12,11
2,28,87,24,6,18
2,28,88,16,9,7
2,28,89,13,4,9
2,28,90,30,7,23
2,28,91,21,14,7
2,28,92,12,5,7
2,28,93,20,13,7
2,28,94,26,10,16
2,28,95,30,18,12
2,28,96,20,7,13
2,28,97,15,14,1
2,28,98,19,17,2
2,28,99,17,10,7
2,28,100,17,6,11
2,28,101,20,4,16
2,28,102,26,16,10
2,28,103,21,9,12
2,28,104,31,7,24
2,28,105,19,12,7
2,28,106,19,5,14
2,28,107,17,5,12
2,28,108,27,8,19
2,28,109,20,6,14
2,28,110,20,7,13
2,28,111,10,7,3
2,28,112,18,9,9
2,28,113,24,12,12
2,28,114,20,7,13
2,28,115,15,10,5
2,28,116,10,8,2
2,28,117,12,8,4
2,28,118,15,14,1
2,28,119,22,11,11
2,28,120,30,7,23
2,28,121,19,11,8
2,28,122,11,9,2
2,28,123,19,4,15
2,28,124,9,6,3
2,28,125,9,4,5
2,28,126,10,6,4
2,28,127,24,7,17
2,28,128,19,15,4
2,28,129,20,9,11
2,28,130,16,6,10
2,28,131,24,22,2
2,28,132,20,10,10
2,28,133,17,8,9
2,28,134,13,11,2
2,28,135,13,7,6
2,28,136,21,9,12
2,28,137,11,3,8
2,28,138,20,12,8
2,28,139,11,8,3
2,28,140,10,7,3
2,28,141,38,7,31
2,28,142,14,7,7
2,28,143,15,5,10
2,28,144,16,7,9
2,28,145,20,4,16
2,28,146,30,8,22
2,28,147,15,11,4
2,28,148,29,10,19
2,28,149,23,13,10
2,28,150,15,8,7
2,28,151,25,8,17
2,28,152,14,7,7
2,28,153,15,1,14
2,28,154,11,9,2
2,28,155,35,11,24
2,28,156,18,4,14
2,28,157,15,6,9
2,28,158,23,10,13
2,28,159,29,8,21
2,28,160,34,10,24
2,28,161,21,6,15
2,28,162,27,5,22
2,28,163,23,11,12
2,28,164,14,8,6
2,28,165,11,7,4
2,28,166,24,8,16
2,28,167,15,7,8
2,28,168,25,12,13
2,28,169,14,9,5
2,28,170,12,5,7
2,28,171,8,2,6
2,28,172,30,2,28
2,28,173,21,10,11
2,28,174,14,4,10
2,28,175,6,8,-2
2,28,176,26,9,17
2,28,177,25,14,11
2,28,178,9,9,0
2,28,179,20,17,3
2,28,180,24,8,16
2,28,181,30,9,21
2,28,182,19,12,7
2,28,183,21,7,14
2,28,184,23,5,18
2,28,185,18,7,11
2,28,186,10,6,4
2,28,187,13,7,6
2,28,188,9,9,0
2,28,189,20,9,11
2,28,190,25,15,10
2,28,191,24,15,9
2,28,192,12,11,1
2,28,193,18,12,6
2,28,194,5,8,-3
2,28,195,7,6,1
2,28,196,9,2,7
2,28,197,30,7,23
2,28,198,25,3,22
2,28,199,28,5,23
2,28,200,30,7,23
2,28,201,22,5,17
2,28,202,11,13,-2
2,28,203,25,10,15
2,28,204,23,4,19
2,28,205,10,6,4
2,28,206,16,13,3
2,28,207,18,16,2
2,28,208,28,11,17
2,28,209,26,4,22
2,28,210,23,14,9
2,28,211,12,3,9
2,28,212,7,4,3
2,28,213,26,10,16
2,28,214,11,3,8
2,28,215,15,7,8
2,28,216,19,13,6
2,28,217,15,5,10
2,28,218,17,4,13
2,28,219,17,4,13
2,28,220,22,6,16
2,28,221,11,6,5
2,28,222,25,7,18
2,28,223,27,19,8
2,28,224,22,10,12
2,28,225,7,8,-1
2,28,226,11,7,4
2,28,227,14,4,10
2,28,228,28,7,21
2,28,229,19,12,7
2,28,230,36,13,23
2,28,231,19,9,10
2,28,232,19,9,10
2,28,233,20,8,12
2,28,234,2,12,-10
2,28,235,31,7,24
2,28,236,17,9,8
2,28,237,10,3,7
2,28,238,7,2,5
2,28,239,20,8,12
2,28,240,3,5,-2
2,28,241,34,7,27
2,28,242,24,10,14
2,28,243,5,4,1
2,28,244,14,0,14
2,28,245,24,8,16
2,28,246,11,2,9
2,28,247,13,3,10
2,28,248,11,7,4
2,28,249,18,1,17
2,28,250,16,1,15
2,28,251,13,8,5
2,28,252,14,5,9
2,28,253,23,14,9
2,28,254,20,14,6
2,28,255,16,9,7
2,28,256,22,2,20
2,28,257,27,7,20
2,28,258,24,4,20
2,28,259,32,12,20
2,28,260,16,18,-2
2,28,261,16,8,8
2,28,262,12,6,6
2,28,263,12,6,6
2,28,264,25,10,15
2,28,265,10,6,4
2,28,266,24,4,20
2,28,267,22,8,14
2,28,268,19,7,12
2,28,269,14,8,6
2,28,270,20,12,8
2,28,271,16,5,11
2,28,272,14,3,11
2,28,273,16,9,7
2,28,274,16,18,-2
2,28,275,20,6,14
2,28,276,18,21,-3
2,28,277,20,10,10
2,28,278,14,2,12
2,28,279,19,6,13
2,28,280,12,2,10
2,28,281,24,13,11
2,28,282,9,5,4
2,28,283,15,9,6
2,28,284,14,9,5
2,28,285,24,15,9
2,28,286,25,12,13
2,28,287,14,7,7
2,28,288,19,7,12
2,28,289,21,12,9
2,28,290,13,10,3
2,28,291,22,10,12
2,28,292,21,3,18
2,28,293,21,7,14
2,28,294,17,7,10
2,28,295,10,4,6
2,28,296,10,2,8
2,28,297,18,6,12
2,28,298,9,13,-4
2,28,299,13,8,5
2,29,0,14,15,-1
2,29,1,4,6,-2
2,29,2,6,7,-1
2,29,3,24,11,13
2,29,4,22,6,16
2,29,5,21,13,8
2,29,6,8,10,-2
2,29,7,21,4,17
2,29,8,24,9,15
2,29,9,20,9,11
2,29,10,14,12,2
2,29,11,15,8,7
2,29,12,18,14,4
2,29,13,32,13,19
2,29,14,12,1,11
2,29,15,22,6,16
2,29,16,19,4,15
2,29,17,37,17,20
2,29,18,22,2,20
2,29,19,13,6,7
2,29,20,15,13,2
2,29,21,14,8,6
2,29,22,14,4,10
2,29,23,23,4,19
2,29,24,15,8,7
2,29,25,13,3,10
2,29,26,8,1,7
2,29,27,13,5,8
2,29,28,24,5,19
2,29,29,22,7,15
2,29,30,23,6,17
2,29,31,22,15,7
2,29,32,25,8,17
2,29,33,15,10,5
2,29,34,24,13,11
2,29,35,13,12,1
2,29,36,27,8,19
2,29,37,31,9,22
2,29,38,25,10,15
2,29,39,31,6,25
2,29,40,11,2,9
2,29,41,15,10,5
2,29,42,14,7,7
2,29,43,20,5,15
2,29,44,21,12,9
2,29,45,26,5,21
2,29,46,20,4,16
2,29,47,11,3,8
2,29,48,26,10,16
2,29,49,13,4,9
2,29,50,14,6,8
2,29,51,27,9,18
2,29,52,14,6,8
2,29,53,6,3,3
2,29,54,14,4,10
2,29,55,17,4,13
2,29,56,20,11,9
2,29,57,32,14,18
2,29,58,19,7,12
2,29,59,20,5,15
2,29,60,13,5,8
2,29,61,14,12,2
2,29,62,17,5,12
2,29,63,22,4,18
2,29,64,18,12,6
2,29,65,27,6,21
2,29,66,8,5,3
2,29,67,20,2,18
2,29,68,16,9,7
2,29,69,15,16,-1
2,29,70,19,7,12
2,29,71,42,6,36
2,29,72,21,5,16
2,29,73,13,7,6
2,29,74,11,7,4
2,29,75,18,8,10
2,29,76,16,7,9
2,29,77,34,11,23
2,29,78,21,5,16
2,29,79,11,3,8
2,29,80,4,2,2
2,29,81,20,13,7
2,29,82,16,7,9
2,29,83,15,3,12
2,29,84,25,3,22
2,29,85,34,7,27
2,29,86,17,7,10
2,29,87,19,3,16
2,29,88,27,14,13
2,29,89,20,4,16
2,29,90,25,9,16
2,29,91,19,10,9
2,29,92,6,4,2
2,29,93,29,7,22
2,29,94,14,4,10
2,29,95,18,7,11
2,29,96,31,14,17
2,29,97,20,13,7
2,29,98,21,10,11
2,29,99,30,16,14
2,29,100,13,4,9
2,29,101,33,12,21
2,29,102,19,12,7
2,29,103,18,11,7
2,29,104,27,6,21
2,29,105,29,21,8
2,29,106,18,8,10
2,29,107,9,5,4
2,29,108,19,12,7
2,29,109,15,16,-1
2,29,110,13,9,4
2,29,111,14,8,6
2,29,112,20,2,18
2,29,113,16,4,12
2,29,114,18,5,13
2,29,115,22,12,10
2,29,116,22,5,17
2,29,117,9,6,3
2,29,118,25,8,17
2,29,119,22,9,13
2,29,120,12,7,5
2,29,121,27,16,11
2,29,122,36,14,22
2,29,123,21,7,14
2,29,124,14,9,5
2,29,125,12,1,11
2,29,126,11,10,1
2,29,127,17,4,13
2,29,128,35,8,27
2,29,129,29,10,19
2,29,130,35,14,21
2,29,131,18,6,12
2,29,132,22,7,15
2,29,133,19,7,12
2,29,134,16,3,13
2,29,135,22,5,17
2,29,136,14,12,2
2,29,137,33,8,25
2,29,138,23,8,15
2,29,139,8,2,6
2,29,140,21,16,5
2,29,141,24,11,13
2,29,142,15,10,5
2,29,143,18,13,5
2,29,144,23,16,7
2,29,145,14,6,8
2,29,146,14,7,7
2,29,147,18,8,10
2,29,148,19,15,4
2,29,149,6,2,4
2,29,150,24,11,13
2,29,151,20,7,13
2,29,152,11,6,5
2,29,153,10,8,2
2,29,154,24,9,15
2,29,155,11,15,-4
2,29,156,9,3,6
2,29,157,10,7,3
2,29,158,15,8,7
2,29,159,20,2,18
2,29,160,13,8,5
2,29,161,16,2,14
2,29,162,5,4,1
2,29,163,13,10,3
2,29,164,19,11,8
2,29,165,18,4,14
2,29,166,21,9,12
2,29,167,18,13,5
2,29,168,23,6,17
2,29,169,31,10,21
2,29,170,15,0,15
2,29,171,18,10,8
2,29,172,30,13,17
2,29,173,31,11,20
2,29,174,9,5,4
2,29,175,17,4,13
2,29,176,18,13,5
2,29,177,15,18,-3
2,29,178,31,7,24
2,29,179,25,5,20
2,29,180,13,8,5
2,29,181,13,12,1
2,29,182,22,15,7
2,29,183,21,6,15
2,29,184,30,13,17
2,29,185,42,15,27
2,29,186,18,8,10
2,29,187,21,21,0
2,29,188,21,11,10
2,29,189,17,10,7
2,29,190,12,6,6
2,29,191,10,4,6
2,29,192,31,10,21
2,29,193,38,9,29
2,29,194,15,3,12
2,29,195,16,7,9
2,29,196,9,5,4
2,29,197,24,11,13
2,29,198,19,6,13
2,29,199,15,9,6
2,29,200,23,4,19
2,29,201,11,5,6
2,29,202,32,16,16
2,29,203,13,10,3
2,29,204,16,7,9
2,29,205,14,12,2
2,29,206,26,9,17
2,29,207,18,9,9
2,29,208,17,7,10
2,29,209,23,2,21
2,29,210,22,17,5
2,29,211,23,6,17
2,29,212,12,3,9
2,29,213,15,7,8
2,29,214,29,18,11
2,29,215,29,12,17
2,29,216,16,9,7
2,29,217,20,13,7
2,29,218,19,4,15
2,29,219,8,10,-2
2,29,220,11,5,6
2,29,221,12,4,8
2,29,222,11,9,2
2,29,223,15,10,5
2,29,224,24,7,17
2,29,225,9,5,4
2,29,226,22,3,19
2,29,227,23,8,15
2,29,228,8,7,1
2,29,229,15,12,3
2,29,230,27,6,21
2,29,231,33,11,22
2,29,232,28,12,16
2,29,233,18,10,8
2,29,234,25,6,19
2,29,235,17,15,2
2,29,236,6,4,2
2,29,237,20,9,11
2,29,238,19,6,13
2,29,239,20,6,14
2,29,240,18,12,6
2,29,241,11,4,7
2,29,242,13,10,3
2,29,243,10,5,5
2,29,244,18,11,7
2,29,245,17,8,9
2,29,246,26,5,21
2,29,247,21,4,17
2,29,248,14,7,7
2,29,249,28,15,13
2,29,250,22,9,13
2,29,251,23,10,13
2,29,252,24,17,7
2,29,253,11,1,10
2,29,254,22,6,16
2,29,255,20,8,12
2,29,256,20,5,15
2,29,257,16,1,15
2,29,258,14,6,8
2,29,259,21,15,6
2,29,260,20,16,4
2,29,261,9,8,1
2,29,262,36,13,23
2,29,263,12,4,8
2,29,264,17,11,6
2,29,265,19,7,12
2,29,266,8,13,-5
2,29,267,7,9,-2
2,29,268,15,1,14
2,29,269,27,15,12
2,29,270,8,5,3
2,29,271,24,12,12
2,29,272,26,4,22
2,29,273,26,12,14
2,29,274,12,6,6
2,29,275,31,11,20
2,29,276,16,10,6
2,29,277,22,13,9
2,29,278,25,22,3
2,29,279,17,8,9
2,29,280,13,6,7
2,29,281,39,7,32
2,29,282,12,6,6
2,29,283,16,17,-1
2,29,284,20,19,1
2,29,285,22,12,10
2,29,286,7,6,1
2,29,287,20,2,18
2,29,288,8,9,-1
2,29,289,15,23,-8
2,29,290,20,10,10
2,29,291,17,7,10
2,29,292,20,3,17
2,29,293,28,12,16
2,29,294,29,11,18
2,29,295,19,6,13
2,29,296,9,3,6
2,29,297,6,3,3
2,29,298,16,2,14
2,29,299,10,6,4
2,30,0,9,7,2
2,30,1,15,9,6
2,30,2,14,6,8
2,30,3,15,9,6
2,30,4,5,5,0
2,30,5,17,4,13
2,30,6,29,7,22
2,30,7,28,8,20
2,30,8,33,14,19
2,30,9,23,2,21
2,30,10,13,6,7
2,30,11,19,3,16
2,30,12,22,6,16
2,30,13,18,6,12
2,30,14,16,3,13
2,30,15,21,11,10
2,30,16,11,7,4
2,30,17,28,8,20
2,30,18,18,9,9
2,30,19,10,3,7
2,30,20,20,9,11
2,30,21,25,10,15
2,30,22,13,7,6
2,30,23,17,5,12
2,30,24,12,4,8
2,30,25,12,4,8
2,30,26,15,3,12
2,30,27,19,11,8
2,30,28,13,5,8
2,30,29,13,4,9
2,30,30,28,8,20
2,30,31,21,10,11
2,30,32,18,7,11
2,30,33,11,10,1
2,30,34,14,4,10
2,30,35,6,11,-5
2,30,36,24,7,17
2,30,37,11,5,6
2,30,38,27,10,17
2,30,39,28,14,14
2,30,40,15,5,10
2,30,41,17,4,13
2,30,42,15,7,8
2,30,43,19,7,12
2,30,44,10,5,5
2,30,45,15,9,6
2,30,46,12,11,1
2,30,47,11,3,8
2,30,48,10,12,-2
2,30,49,15,2,13
2,30,50,19,12,7
2,30,51,32,13,19
2,30,52,21,9,12
2,30,53,20,11,9
2,30,54,20,11,9
2,30,55,31,8,23
2,30,56,17,2,15
2,30,57,23,13,10
2,30,58,11,8,3
2,30,59,32,9,23
2,30,60,23,10,13
2,30,61,19,11,8
2,30,62,15,12,3
2,30,63,19,11,8
2,30,64,15,13,2
2,30,65,17,1,16
2,30,66,27,4,23
2,30,67,17,6,11
2,30,68,11,4,7
2,30,69,10,4,6
2,30,70,17,5,12
2,30,71,15,6,9
2,30,72,37,18,19
2,30,73,5,1,4
2,30,74,13,24,-11
2,30,75,10,9,1
2,30,76,11,4,7
2,30,77,15,8,7
2,30,78,18,16,2
2,30,79,22,4,18
2,30,80,13,4,9
2,30,81,39,10,29
2,30,82,10,5,5
2,30,83,12,4,8
2,30,84,9,4,5
2,30,85,27,10,17
2,30,86,28,9,19
2,30,87,13,12,1
2,30,88,6,6,0
2,30,89,14,9,5
2,30,90,49,9,40
2,30,91,9,7,2
2,30,92,23,15,8
2,30,93,23,5,18
2,30,94,11,4,7
2,30,95,18,9,9
2,30,96,23,15,8
2,30,97,15,9,6
2,30,98,20,8,12
2,30,99,19,2,17
2,30,100,16,10,6
2,30,101,22,6,16
2,30,102,23,7,16
2,30,103,36,13,23
2,30,104,16,7,9
2,30,105,24,8,16
2,30,106,28,10,18
2,30,107,41,9,32
2,30,108,21,3,18
2,30,109,14,3,11
2,30,110,16,1,15
2,30,111,15,3,12
2,30,112,14,9,5
2,30,113,20,10,10
2,30,114,29,12,17
2,30,115,7,5,2
2,30,116,37,3,34
2,30,117,9,7,2
2,30,118,9,13,-4
2,30,119,11,3,8
2,30,120,14,5,9
2,30,121,22,7,15
2,30,122,24,12,12
2,30,123,8,7,1
2,30,124,11,7,4
2,30,125,17,4,13
2,30,126,10,4,6
2,30,127,24,10,14
2,30,128,26,10,16
2,30,129,17,6,11
2,30,130,21,18,3
2,30,131,24,2,22
2,30,132,12,7,5
2,30,133,29,11,18
2,30,134,25,12,13
2,30,135,12,3,9
2,30,136,17,5,12
2,30,137,25,11,14
2,30,138,46,17,29
2,30,139,17,6,11
2,30,140,27,9,18
2,30,141,10,5,5
2,30,142,11,6,5
2,30,143,28,12,16
2,30,144,15,8,7
2,30,145,15,6,9
2,30,146,13,12,1
2,30,147,11,10,1
2,30,148,15,4,11
2,30,149,16,11,5
2,30,150,16,6,10
2,30,151,20,4,16
2,30,152,23,14,9
2,30,153,16,12,4
2,30,154,19,10,9
2,30,155,21,10,11
2,30,156,21,3,18
2,30,157,12,4,8
2,30,158,15,3,12
2,30,159,43,20,23
2,30,160,21,11,10
2,30,161,19,8,11
2,30,162,24,7,17
2,30,163,27,6,21
2,30,164,16,13,3
2,30,165,20,7,13
2,30,166,16,6,10
2,30,167,14,7,7
2,30,168,9,7,2
2,30,169,13,7,6
2,30,170,15,4,11
2,30,171,20,10,10
2,30,172,10,3,7
2,30,173,10,9,1
2,30,174,12,7,5
2,30,175,11,2,9
2,30,176,9,2,7
2,30,177,11,17,-6
2,30,178,15,4,11
2,30,179,19,9,10
2,30,180,7,10,-3
2,30,181,13,4,9
2,30,182,12,4,8
2,30,183,4,5,-1
2,30,184,33,14,19
2,30,185,23,0,23
2,30,186,18,8,10
2,30,187,16,12,4
2,30,188,20,7,13
2,30,189,25,5,20
2,30,190,20,12,8
2,30,191,10,6,4
2,30,192,27,8,19
2,30,193,20,5,15
2,30,194,14,17,-3
2,30,195,13,12,1
2,30,196,11,0,11
2,30,197,14,6,8
2,30,198,7,5,2
2,30,199,20,12,8
2,30,200,18,5,13
2,30,201,33,8,25
2,30,202,12,5,7
2,30,203,22,13,9
2,30,204,17,6,11
2,30,205,22,5,17
2,30,206,14,4,10
2,30,207,34,10,24
2,30,208,11,6,5
2,30,209,18,7,11
2,30,210,13,6,7
2,30,211,17,3,14
2,30,212,9,10,-1
2,30,213,12,8,4
2,30,214,16,3,13
2,30,215,6,5,1
2,30,216,33,11,22
2,30,217,18,8,10
2,30,218,22,12,10
2,30,219,8,11,-3
2,30,220,13,6,7
2,30,221,24,13,11
2,30,222,10,4,6
2,30,223,16,15,1
2,30,224,29,8,21
2,30,225,25,4,21
2,30,226,17,10,7
2,30,227,17,13,4
2,30,228,37,17,20
2,30,229,28,15,13
2,30,230,31,4,27
2,30,231,10,8,2
2,30,232,25,10,15
2,30,233,18,10,8
2,30,234,23,6,17
2,30,235,20,12,8
2,30,236,23,3,20
2,30,237,28,8,20
2,30,238,14,13,1
2,30,239,10,7,3
2,30,240,16,5,11
2,30,241,14,5,9
2,30,242,16,7,9
2,30,243,20,2,18
2,30,244,15,8,7
2,30,245,12,3,9
2,30,246,12,8,4
2,30,247,11,14,-3
2,30,248,21,5,16
2,30,249,11,5,6
2,30,250,24,10,14
2,30,251,16,11,5
2,30,252,12,5,7
2,30,253,15,2,13
2,30,254,12,5,7
2,30,255,21,3,18
2,30,256,10,11,-1
2,30,257,17,5,12
2,30,258,23,7,16
2,30,259,32,11,21
2,30,260,27,3,24
2,30,261,14,4,10
2,30,262,15,11,4
2,30,263,13,7,6
2,30,264,12,10,2
2,30,265,15,14,1
2,30,266,25,10,15
2,30,267,14,8,6
2,30,268,12,8,4
2,30,269,16,8,8
2,30,270,9,2,7
2,30,271,19,7,12
2,30,272,6,3,3
2,30,273,15,9,6
2,30,274,19,8,11
2,30,275,35,5,30
2,30,276,21,2,19
2,30,277,18,7,11
2,30,278,16,5,11
2,30,279,11,8,3
2,30,280,14,13,1
2,30,281,18,6,12
2,30,282,14,4,10
2,30,283,19,9,10
2,30,284,12,8,4
2,30,285,9,6,3
2,30,286,27,10,17
2,30,287,13,1,12
2,30,288,31,14,17
2,30,289,12,9,3
2,30,290,24,5,19
2,30,291,3,5,-2
2,30,292,10,9,1
2,30,293,25,14,11
2,30,294,25,5,20
2,30,295,13,9,4
2,30,296,20,14,6
2,30,297,18,9,9
2,30,298,24,7,17
2,30,299,21,4,17
3,1,0,5,9,-4
3,1,1,9,10,-1
3,1,2,7,17,-10
3,1,3,1,17,-16
3,1,4,15,6,9
3,1,5,10,12,-2
3,1,6,9,12,-3
3,1,7,18,14,4
3,1,8,0,4,-4
3,1,9,4,3,1
3,1,10,2,7,-5
3,1,11,0,5,-5
3,1,12,3,7,-4
3,1,13,17,10,7
3,1,14,15,11,4
3,1,15,5,4,1
3,1,16,13,10,3
3,1,17,7,1,6
3,1,18,10,9,1
3,1,19,10,12,-2
3,1,20,7,7,0
3,1,21,19,10,9
3,1,22,10,3,7
3,1,23,7,6,1
3,1,24,2,4,-2
3,1,25,3,18,-15
3,1,26,14,10,4
3,1,27,5,3,2
3,1,28,10,12,-2
3,1,29,12,6,6
3,1,30,17,13,4
3,1,31,3,9,-6
3,1,32,4,4,0
3,1,33,1,2,-1
3,1,34,12,7,5
3,1,35,8,13,-5
3,1,36,5,8,-3
3,1,37,6,6,0
3,1,38,5,6,-1
3,1,39,5,9,-4
3,1,40,13,9,4
3,1,41,6,7,-1
3,1,42,2,2,0
3,1,43,8,11,-3
3,1,44,15,10,5
3,1,45,2,9,-7
3,1,46,1,2,-1
3,1,47,6,14,-8
3,1,48,12,4,8
3,1,49,3,9,-6
3,1,50,10,11,-1
3,1,51,8,11,-3
3,1,52,5,5,0
3,1,53,10,7,3
3,1,54,4,15,-11
3,1,55,2,1,1
3,1,56,5,2,3
3,1,57,4,6,-2
3,1,58,8,11,-3
3,1,59,10,11,-1
3,1,60,9,10,-1
3,1,61,10,5,5
3,1,62,5,10,-5
3,1,63,8,9,-1
3,1,64,20,13,7
3,1,65,9,5,4
3,1,66,12,12,0
3,1,67,4,7,-3
3,1,68,9,6,3
3,1,69,1,8,-7
3,1,70,5,6,-1
3,1,71,11,15,-4
3,1,72,3,12,-9
3,1,73,6,16,-10
3,1,74,5,6,-1
3,1,75,12,11,1
3,1,76,10,4,6
3,1,77,8,10,-2
3,1,78,3,2,1
3,1,79,9,9,0
3,1,80,9,12,-3
3,1,81,21,13,8
3,1,82,6,10,-4
3,1,83,8,3,5
3,1,84,8,13,-5
3,1,85,20,16,4
3,1,86,15,22,-7
3,1,87,10,7,3
3,1,88,6,6,0
3,1,89,6,11,-5
3,1,90,13,11,2
3,1,91,5,10,-5
3,1,92,2,10,-8
3,1,93,5,2,3
3,1,94,15,10,5
3,1,95,13,11,2
3,1,96,16,9,7
3,1,97,3,8,-5
3,1,98,6,12,-6
3,1,99,6,1,5
3,1,100,5,10,-5
3,1,101,5,1,4
3,1,102,2,8,-6
3,1,103,5,7,-2
3,1,104,0,4,-4
3,1,105,7,4,3
3,1,106,2,6,-4
3,1,107,13,10,3
3,1,108,1,1,0
3,1,109,5,2,3
3,1,110,10,13,-3
3,1,111,5,4,1
3,1,112,6,16,-10
3,1,113,6,10,-4
3,1,114,2,4,-2
3,1,115,1,4,-3
3,1,116,1,5,-4
3,1,117,8,11,-3
3,1,118,3,2,1
3,1,119,10,6,4
3,1,120,25,15,10
3,1,121,6,4,2
3,1,122,2,9,-7
3,1,123,5,6,-1
3,1,124,4,6,-2
3,1,125,4,5,-1
3,1,126,7,12,-5
3,1,127,5,6,-1
3,1,128,9,15,-6
3,1,129,3,4,-1
3,1,130,7,2,5
3,1,131,10,2,8
3,1,132,7,5,2
3,1,133,4,12,-8
3,1,134,5,34,-29
3,1,135,4,10,-6
3,1,136,7,10,-3
3,1,137,12,5,7
3,1,138,6,9,-3
3,1,139,7,4,3
3,1,140,7,8,-1
3,1,141,8,7,1
3,1,142,4,16,-12
3,1,143,4,10,-6
3,1,144,6,6,0
3,1,145,0,10,-10
3,1,146,6,10,-4
3,1,147,5,7,-2
3,1,148,14,13,1
3,1,149,8,8,0
3,1,150,9,6,3
3,1,151,8,4,4
3,1,152,13,10,3
3,1,153,5,3,2
3,1,154,4,2,2
3,1,155,7,9,-2
3,1,156,11,9,2
3,1,157,3,9,-6
3,1,158,8,15,-7
3,1,159,6,5,1
3,1,160,7,8,-1
3,1,161,13,11,2
3,1,162,11,9,2
3,1,163,1,4,-3
3,1,164,3,6,-3
3,1,165,13,10,3
3,1,166,8,5,3
3,1,167,7,11,-4
3,1,168,14,20,-6
3,1,169,7,6,1
3,1,170,14,8,6
3,1,171,4,3,1
3,1,172,14,4,10
3,1,173,8,5,3
3,1,174,6,10,-4
3,1,175,6,7,-1
3,1,176,4,21,-17
3,1,177,4,14,-10
3,1,178,5,10,-5
3,1,179,1,4,-3
3,1,180,6,3,3
3,1,181,17,19,-2
3,1,182,7,17,-10
3,1,183,7,2,5
3,1,184,7,9,-2
3,1,185,8,6,2
3,1,186,19,8,11
3,1,187,11,6,5
3,1,188,7,8,-1
3,1,189,4,5,-1
3,1,190,10,24,-14
3,1,191,12,6,6
3,1,192,9,11,-2
3,1,193,5,7,-2
3,1,194,9,9,0
3,1,195,9,6,3
3,1,196,11,12,-1
3,1,197,4,4,0
3,1,198,6,5,1
3,1,199,5,8,-3
3,1,200,4,23,-19
3,1,201,4,3,1
3,1,202,7,3,4
3,1,203,13,14,-1
3,1,204,2,4,-2
3,1,205,5,8,-3
3,1,206,8,13,-5
3,1,207,7,7,0
3,1,208,5,6,-1
3,1,209,9,7,2
3,1,210,4,9,-5
3,1,211,2,10,-8
3,1,212,8,12,-4
3,1,213,4,3,1
3,1,214,14,9,5
3,1,215,11,15,-4
3,1,216,16,10,6
3,1,217,6,5,1
3,1,218,2,11,-9
3,1,219,16,11,5
3,1,220,9,14,-5
3,1,221,2,3,-1
3,1,222,3,11,-8
3,1,223,7,6,1
3,1,224,3,8,-5
3,1,225,7,2,5
3,1,226,6,3,3
3,1,227,12,19,-7
3,1,228,2,3,-1
3,1,229,7,8,-1
3,1,230,6,19,-13
3,1,231,0,9,-9
3,1,232,2,7,-5
3,1,233,6,5,1
3,1,234,4,8,-4
3,1,235,8,21,-13
3,1,236,7,31,-24
3,1,237,2,6,-4
3,1,238,2,13,-11
3,1,239,12,14,-2
3,1,240,4,5,-1
3,1,241,5,2,3
3,1,242,7,10,-3
3,1,243,5,5,0
3,1,244,9,12,-3
3,1,245,7,12,-5
3,1,246,7,4,3
3,1,247,8,3,5
3,1,248,5,9,-4
3,1,249,8,7,1
3,1,250,7,9,-2
3,1,251,9,5,4
3,1,252,6,7,-1
3,1,253,1,10,-9
3,1,254,7,8,-1
3,1,255,4,4,0
3,1,256,7,15,-8
3,1,257,8,5,3
3,1,258,3,6,-3
3,1,259,10,7,3
3,1,260,3,1,2
3,1,261,10,4,6
3,1,262,7,12,-5
3,1,263,4,5,-1
3,1,264,1,0,1
3,1,265,12,6,6
3,1,266,8,11,-3
3,1,267,1,3,-2
3,1,268,6,7,-1
3,1,269,6,6,0
3,1,270,2,6,-4
3,1,271,8,6,2
3,1,272,13,6,7
3,1,273,11,9,2
3,1,274,6,5,1
3,1,275,9,7,2
3,1,276,15,13,2
3,1,277,9,8,1
3,1,278,7,11,-4
3,1,279,6,11,-5
3,1,280,8,15,-7
3,1,281,6,9,-3
3,1,282,5,9,-4
3,1,283,2,6,-4
3,1,284,9,8,1
3,1,285,7,9,-2
3,1,286,10,13,-3
3,1,287,8,10,-2
3,1,288,9,10,-1
3,1,289,7,21,-14
3,1,290,13,15,-2
3,1,291,12,11,1
3,1,292,13,13,0
3,1,293,5,11,-6
3,1,294,3,13,-10
3,1,295,9,11,-2
3,1,296,9,6,3
3,1,297,4,5,-1
3,1,298,8,12,-4
3,1,299,9,10,-1
3,2,0,9,6,3
3,2,1,7,10,-3
3,2,2,5,5,0
3,2,3,4,2,2
3,2,4,2,3,-1
3,2,5,5,9,-4
3,2,6,6,13,-7
3,2,7,5,3,2
3,2,8,10,9,1
3,2,9,7,14,-7
3,2,10,9,12,-3
3,2,11,7,10,-3
3,2,12,4,6,-2
3,2,13,11,10,1
3,2,14,15,13,2
3,2,15,10,16,-6
3,2,16,12,9,3
3,2,17,3,3,0
3,2,18,2,4,-2
3,2,19,13,15,-2
3,2,20,6,9,-3
3,2,21,5,10,-5
3,2,22,6,5,1
3,2,23,18,16,2
3,2,24,10,7,3
3,2,25,5,10,-5
3,2,26,3,6,-3
3,2,27,4,7,-3
3,2,28,18,19,-1
3,2,29,6,9,-3
3,2,30,7,9,-2
3,2,31,15,7,8
3,2,32,6,4,2
3,2,33,3,7,-4
3,2,34,4,7,-3
3,2,35,7,12,-5
3,2,36,11,9,2
3,2,37,3,4,-1
3,2,38,1,11,-10
3,2,39,19,9,10
3,2,40,3,2,1
3,2,41,20,15,5
3,2,42,14,14,0
3,2,43,8,13,-5
3,2,44,7,14,-7
3,2,45,3,4,-1
3,2,46,11,3,8
3,2,47,11,7,4
3,2,48,5,16,-11
3,2,49,10,15,-5
3,2,50,4,9,-5
3,2,51,12,7,5
3,2,52,12,7,5
3,2,53,4,6,-2
3,2,54,9,12,-3
3,2,55,7,17,-10
3,2,56,10,8,2
3,2,57,0,0,0
3,2,58,9,7,2
3,2,59,15,23,-8
3,2,60,6,8,-2
3,2,61,9,7,2
3,2,62,5,3,2
3,2,63,5,18,-13
3,2,64,16,18,-2
3,2,65,11,28,-17
3,2,66,5,7,-2
3,2,67,0,5,-5
3,2,68,8,5,3
3,2,69,12,9,3
3,2,70,2,7,-5
3,2,71,9,7,2
3,2,72,10,17,-7
3,2,73,10,17,-7
3,2,74,10,7,3
3,2,75,10,4,6
3,2,76,8,7,1
3,2,77,7,5,2
3,2,78,0,1,-1
3,2,79,7,1,6
3,2,80,16,7,9
3,2,81,6,5,1
3,2,82,5,3,2
3,2,83,6,3,3
3,2,84,5,11,-6
3,2,85,4,2,2
3,2,86,4,8,-4
3,2,87,16,15,1
3,2,88,12,11,1
3,2,89,3,5,-2
3,2,90,14,8,6
3,2,91,11,8,3
3,2,92,7,6,1
3,2,93,8,10,-2
3,2,94,6,8,-2
3,2,95,10,10,0
3,2,96,14,7,7
3,2,97,8,5,3
3,2,98,2,4,-2
3,2,99,6,21,-15
3,2,100,5,6,-1
3,2,101,7,7,0
3,2,102,6,11,-5
3,2,103,10,20,-10
3,2,104,13,21,-8
3,2,105,10,10,0
3,2,106,5,6,-1
3,2,107,17,14,3
3,2,108,6,3,3
3,2,109,15,12,3
3,2,110,4,14,-10
3,2,111,9,9,0
3,2,112,10,16,-6
3,2,113,3,4,-1
3,2,114,4,12,-8
3,2,115,12,11,1
3,2,116,8,6,2
3,2,117,5,5,0
3,2,118,12,7,5
3,2,119,1,0,1
3,2,120,16,15,1
3,2,121,11,18,-7
3,2,122,6,8,-2
3,2,123,10,8,2
3,2,124,9,9,0
3,2,125,7,9,-2
3,2,126,3,7,-4
3,2,127,26,17,9
3,2,128,4,6,-2
3,2,129,11,5,6
3,2,130,11,3,8
3,2,131,13,14,-1
3,2,132,7,12,-5
3,2,133,15,5,10
3,2,134,6,8,-2
3,2,135,3,7,-4
3,2,136,9,14,-5
3,2,137,6,3,3
3,2,138,11,18,-7
3,2,139,13,10,3
3,2,140,13,6,7
3,2,141,6,8,-2
3,2,142,7,13,-6
3,2,143,5,7,-2
3,2,144,11,6,5
3,2,145,3,11,-8
3,2,146,6,5,1
3,2,147,13,14,-1
3,2,148,8,7,1
3,2,149,10,6,4
3,2,150,7,9,-2
3,2,151,16,32,-16
3,2,152,1,4,-3
3,2,153,5,8,-3
3,2,154,3,11,-8
3,2,155,1,7,-6
3,2,156,7,10,-3
3,2,157,4,6,-2
3,2,158,10,11,-1
3,2,159,13,9,4
3,2,160,13,14,-1
3,2,161,2,7,-5
3,2,162,10,10,0
3,2,163,8,10,-2
3,2,164,10,13,-3
3,2,165,13,10,3
3,2,166,4,12,-8
3,2,167,17,20,-3
3,2,168,1,3,-2
3,2,169,0,2,-2
3,2,170,4,5,-1
3,2,171,9,9,0
3,2,172,10,5,5
3,2,173,9,11,-2
3,2,174,9,8,1
3,2,175,6,5,1
3,2,176,11,16,-5
3,2,177,9,2,7
3,2,178,19,10,9
3,2,179,10,13,-3
3,2,180,3,3,0
3,2,181,17,15,2
3,2,182,12,8,4
3,2,183,8,9,-1
3,2,184,5,5,0
3,2,185,10,4,6
3,2,186,11,17,-6
3,2,187,5,6,-1
3,2,188,3,4,-1
3,2,189,4,3,1
3,2,190,4,10,-6
3,2,191,14,14,0
3,2,192,5,6,-1
3,2,193,8,4,4
3,2,194,7,28,-21
3,2,195,9,4,5
3,2,196,9,11,-2
3,2,197,2,4,-2
3,2,198,10,9,1
3,2,199,5,7,-2
3,2,200,16,5,11
3,2,201,11,19,-8
3,2,202,5,7,-2
3,2,203,1,2,-1
3,2,204,3,6,-3
3,2,205,12,8,4
3,2,206,6,15,-9
3,2,207,9,4,5
3,2,208,7,8,-1
3,2,209,8,9,-1
3,2,210,9,8,1
3,2,211,10,16,-6
3,2,212,11,20,-9
3,2,213,0,9,-9
3,2,214,2,2,0
3,2,215,7,8,-1
3,2,216,11,16,-5
3,2,217,10,20,-10
3,2,218,8,11,-3
3,2,219,8,9,-1
3,2,220,5,6,-1
3,2,221,3,9,-6
3,2,222,13,8,5
3,2,223,3,5,-2
3,2,224,9,5,4
3,2,225,5,4,1
3,2,226,9,7,2
3,2,227,5,22,-17
3,2,228,7,13,-6
3,2,229,12,9,3
3,2,230,1,10,-9
3,2,231,3,11,-8
3,2,232,9,5,4
3,2,233,4,8,-4
3,2,234,6,9,-3
3,2,235,6,10,-4
3,2,236,1,3,-2
3,2,237,10,16,-6
3,2,238,14,5,9
3,2,239,7,9,-2
3,2,240,7,18,-11
3,2,241,9,4,5
3,2,242,8,10,-2
3,2,243,7,12,-5
3,2,244,10,14,-4
3,2,245,7,15,-8
3,2,246,6,5,1
3,2,247,4,6,-2
3,2,248,9,15,-6
3,2,249,9,10,-1
3,2,250,7,4,3
3,2,251,2,3,-1
3,2,252,14,19,-5
3,2,253,2,1,1
3,2,254,7,9,-2
3,2,255,18,14,4
3,2,256,19,8,11
3,2,257,2,7,-5
3,2,258,13,12,1
3,2,259,16,9,7
3,2,260,14,16,-2
3,2,261,5,14,-9
3,2,262,8,8,0
3,2,263,5,5,0
3,2,264,14,9,5
3,2,265,13,6,7
3,2,266,8,6,2
3,2,267,6,7,-1
3,2,268,7,8,-1
3,2,269,7,4,3
3,2,270,7,6,1
3,2,271,6,3,3
3,2,272,10,11,-1
3,2,273,4,9,-5
3,2,274,14,4,10
3,2,275,15,19,-4
3,2,276,1,7,-6
3,2,277,7,12,-5
3,2,278,10,8,2
3,2,279,7,7,0
3,2,280,4,8,-4
3,2,281,7,9,-2
3,2,282,5,3,2
3,2,283,5,6,-1
3,2,284,0,14,-14
3,2,285,17,11,6
3,2,286,6,11,-5
3,2,287,10,7,3
3,2,288,11,6,5
3,2,289,4,6,-2
3,2,290,4,5,-1
3,2,291,3,1,2
3,2,292,13,7,6
3,2,293,7,2,5
3,2,294,13,15,-2
3,2,295,6,2,4
3,2,296,15,10,5
3,2,297,4,2,2
3,2,298,4,6,-2
3,2,299,5,6,-1
3,3,0,1,8,-7
3,3,1,13,13,0
3,3,2,13,8,5
3,3,3,22,18,4
3,3,4,8,11,-3
3,3,5,7,5,2
3,3,6,16,18,-2
3,3,7,11,16,-5
3,3,8,5,3,2
3,3,9,5,2,3
3,3,10,20,4,16
3,3,11,7,9,-2
3,3,12,13,6,7
3,3,13,9,4,5
3,3,14,6,8,-2
3,3,15,9,11,-2
3,3,16,5,14,-9
3,3,17,10,16,-6
3,3,18,12,9,3
3,3,19,3,8,-5
3,3,20,7,10,-3
3,3,21,5,8,-3
3,3,22,9,18,-9
3,3,23,13,14,-1
3,3,24,7,9,-2
3,3,25,7,14,-7
3,3,26,7,8,-1
3,3,27,12,14,-2
3,3,28,5,5,0
3,3,29,8,12,-4
3,3,30,5,6,-1
3,3,31,11,15,-4
3,3,32,10,11,-1
3,3,33,5,4,1
3,3,34,0,3,-3
3,3,35,3,4,-1
3,3,36,12,22,-10
3,3,37,11,5,6
3,3,38,5,13,-8
3,3,39,9,10,-1
3,3,40,3,14,-11
3,3,41,13,8,5
3,3,42,2,2,0
3,3,43,6,5,1
3,3,44,5,6,-1
3,3,45,16,11,5
3,3,46,4,6,-2
3,3,47,4,9,-5
3,3,48,18,12,6
3,3,49,27,4,23
3,3,50,13,14,-1
3,3,51,9,6,3
3,3,52,18,20,-2
3,3,53,13,20,-7
3,3,54,7,8,-1
3,3,55,16,5,11
3,3,56,21,13,8
3,3,57,5,3,2
3,3,58,7,11,-4
3,3,59,10,8,2
3,3,60,23,7,16
3,3,61,20,9,11
3,3,62,20,9,11
3,3,63,7,11,-4
3,3,64,5,14,-9
3,3,65,12,4,8
3,3,66,16,23,-7
3,3,67,14,13,1
3,3,68,14,14,0
3,3,69,16,10,6
3,3,70,8,11,-3
3,3,71,7,13,-6
3,3,72,9,7,2
3,3,73,8,6,2
3,3,74,7,20,-13
3,3,75,5,15,-10
3,3,76,4,10,-6
3,3,77,10,11,-1
3,3,78,10,16,-6
3,3,79,15,14,1
3,3,80,8,22,-14
3,3,81,7,10,-3
3,3,82,9,9,0
3,3,83,17,23,-6
3,3,84,2,3,-1
3,3,85,9,6,3
3,3,86,7,9,-2
3,3,87,8,17,-9
3,3,88,14,9,5
3,3,89,5,10,-5
3,3,90,15,21,-6
3,3,91,10,10,0
3,3,92,12,10,2
3,3,93,23,20,3
3,3,94,1,6,-5
3,3,95,3,3,0
3,3,96,4,13,-9
3,3,97,10,9,1
3,3,98,16,17,-1
3,3,99,10,7,3
3,3,100,8,9,-1
3,3,101,6,9,-3
3,3,102,8,14,-6
3,3,103,8,10,-2
3,3,104,2,3,-1
3,3,105,4,7,-3
3,3,106,4,9,-5
3,3,107,8,11,-3
3,3,108,13,12,1
3,3,109,8,7,1
3,3,110,6,4,2
3,3,111,15,17,-2
3,3,112,11,14,-3
3,3,113,5,11,-6
3,3,114,11,8,3
3,3,115,11,40,-29
3,3,116,9,8,1
3,3,117,3,7,-4
3,3,118,6,19,-13
3,3,119,11,9,2
3,3,120,18,16,2
3,3,121,16,10,6
3,3,122,13,12,1
3,3,123,8,10,-2
3,3,124,17,14,3
3,3,125,11,16,-5
3,3,126,14,10,4
3,3,127,3,1,2
3,3,128,4,12,-8
3,3,129,10,3,7
3,3,130,6,10,-4
3,3,131,13,12,1
3,3,132,9,20,-11
3,3,133,12,10,2
3,3,134,7,3,4
3,3,135,8,8,0
3,3,136,4,5,-1
3,3,137,12,15,-3
3,3,138,9,12,-3
3,3,139,16,18,-2
3,3,140,1,7,-6
3,3,141,9,2,7
3,3,142,2,5,-3
3,3,143,6,8,-2
3,3,144,8,13,-5
3,3,145,15,24,-9
3,3,146,11,9,2
3,3,147,10,22,-12
3,3,148,14,5,9
3,3,149,8,8,0
3,3,150,27,14,13
3,3,151,5,3,2
3,3,152,13,23,-10
3,3,153,16,18,-2
3,3,154,4,4,0
3,3,155,13,14,-1
3,3,156,7,0,7
3,3,157,9,23,-14
3,3,158,17,14,3
3,3,159,6,10,-4
3,3,160,22,10,12
3,3,161,4,1,3
3,3,162,7,15,-8
3,3,163,16,6,10
3,3,164,24,20,4
3,3,165,12,6,6
3,3,166,6,12,-6
3,3,167,32,21,11
3,3,168,8,4,4
3,3,169,13,23,-10
3,3,170,14,5,9
3,3,171,8,6,2
3,3,172,8,13,-5
3,3,173,7,6,1
3,3,174,16,6,10
3,3,175,15,16,-1
3,3,176,18,16,2
3,3,177,12,17,-5
3,3,178,10,22,-12
3,3,179,5,9,-4
3,3,180,10,9,1
3,3,181,11,5,6
3,3,182,5,9,-4
3,3,183,12,2,10
3,3,184,13,10,3
3,3,185,3,3,0
3,3,186,16,21,-5
3,3,187,5,16,-11
3,3,188,9,9,0
3,3,189,5,5,0
3,3,190,7,2,5
3,3,191,13,1,12
3,3,192,13,7,6
3,3,193,13,21,-8
3,3,194,7,11,-4
3,3,195,7,6,1
3,3,196,11,5,6
3,3,197,9,9,0
3,3,198,5,5,0
3,3,199,4,9,-5
3,3,200,3,8,-5
3,3,201,14,11,3
3,3,202,4,14,-10
3,3,203,20,12,8
3,3,204,39,9,30
3,3,205,12,10,2
3,3,206,8,7,1
3,3,207,7,13,-6
3,3,208,8,14,-6
3,3,209,6,8,-2
3,3,210,11,9,2
3,3,211,4,13,-9
3,3,212,0,2,-2
3,3,213,5,6,-1
3,3,214,9,7,2
3,3,215,10,9,1
3,3,216,8,5,3
3,3,217,11,8,3
3,3,218,10,8,2
3,3,219,16,12,4
3,3,220,13,18,-5
3,3,221,8,13,-5
3,3,222,10,13,-3
3,3,223,13,14,-1
3,3,224,8,10,-2
3,3,225,11,14,-3
3,3,226,10,13,-3
3,3,227,8,6,2
3,3,228,10,9,1
3,3,229,15,18,-3
3,3,230,6,3,3
3,3,231,7,6,1
3,3,232,25,10,15
3,3,233,8,9,-1
3,3,234,5,4,1
3,3,235,1,14,-13
3,3,236,27,13,14
3,3,237,20,16,4
3,3,238,9,13,-4
3,3,239,7,5,2
3,3,240,11,13,-2
3,3,241,11,18,-7
3,3,242,2,17,-15
3,3,243,15,11,4
3,3,244,9,9,0
3,3,245,8,10,-2
3,3,246,0,3,-3
3,3,247,7,9,-2
3,3,248,15,5,10
3,3,249,8,5,3
3,3,250,1,0,1
3,3,251,11,5,6
3,3,252,18,7,11
3,3,253,12,8,4
3,3,254,1,5,-4
3,3,255,3,6,-3
3,3,256,8,9,-1
3,3,257,6,9,-3
3,3,258,4,16,-12
3,3,259,9,9,0
3,3,260,8,7,1
3,3,261,3,5,-2
3,3,262,5,25,-20
3,3,263,8,10,-2
3,3,264,5,6,-1
3,3,265,14,8,6
3,3,266,8,17,-9
3,3,267,12,10,2
3,3,268,12,12,0
3,3,269,2,13,-11
3,3,270,7,5,2
3,3,271,8,16,-8
3,3,272,12,12,0
3,3,273,6,13,-7
3,3,274,6,7,-1
3,3,275,9,9,0
3,3,276,9,5,4
3,3,277,8,17,-9
3,3,278,16,12,4
3,3,279,13,12,1
3,3,280,14,9,5
3,3,281,11,6,5
3,3,282,5,5,0
3,3,283,15,12,3
3,3,284,9,6,3
3,3,285,12,5,7
3,3,286,10,13,-3
3,3,287,5,14,-9
3,3,288,6,9,-3
3,3,289,15,15,0
3,3,290,10,7,3
3,3,291,19,9,10
3,3,292,8,6,2
3,3,293,15,17,-2
3,3,294,2,7,-5
3,3,295,11,5,6
3,3,296,5,2,3
3,3,297,7,5,2
3,3,298,16,8,8
3,3,299,21,16,5
3,4,0,7,10,-3
3,4,1,5,15,-10
3,4,2,11,11,0
3,4,3,10,12,-2
3,4,4,16,15,1
3,4,5,16,11,5
3,4,6,4,10,-6
3,4,7,7,10,-3
3,4,8,8,14,-6
3,4,9,15,18,-3
3,4,10,4,7,-3
3,4,11,16,16,0
3,4,12,19,23,-4
3,4,13,6,7,-1
3,4,14,7,2,5
3,4,15,3,9,-6
3,4,16,8,9,-1
3,4,17,11,8,3
3,4,18,14,6,8
3,4,19,9,17,-8
3,4,20,18,10,8
3,4,21,7,21,-14
3,4,22,5,6,-1
3,4,23,11,18,-7
3,4,24,14,9,5
3,4,25,5,8,-3
3,4,26,2,6,-4
3,4,27,11,10,1
3,4,28,12,10,2
3,4,29,10,16,-6
3,4,30,12,21,-9
3,4,31,5,1,4
3,4,32,13,11,2
3,4,33,17,9,8
3,4,34,7,5,2
3,4,35,7,14,-7
3,4,36,18,11,7
3,4,37,3,2,1
3,4,38,12,11,1
3,4,39,14,6,8
3,4,40,3,6,-3
3,4,41,8,10,-2
3,4,42,6,10,-4
3,4,43,0,2,-2
3,4,44,25,17,8
3,4,45,14,7,7
3,4,46,10,14,-4
3,4,47,10,5,5
3,4,48,14,10,4
3,4,49,15,12,3
3,4,50,4,9,-5
3,4,51,11,11,0
3,4,52,12,4,8
3,4,53,4,2,2
3,4,54,11,13,-2
3,4,55,22,9,13
3,4,56,2,5,-3
3,4,57,13,9,4
3,4,58,8,6,2
3,4,59,7,16,-9
3,4,60,10,11,-1
3,4,61,7,9,-2
3,4,62,10,19,-9
3,4,63,16,21,-5
3,4,64,5,7,-2
3,4,65,15,11,4
3,4,66,9,10,-1
3,4,67,8,8,0
3,4,68,6,13,-7
3,4,69,11,9,2
3,4,70,1,2,-1
3,4,71,12,24,-12
3,4,72,7,13,-6
3,4,73,24,14,10
3,4,74,5,5,0
3,4,75,11,12,-1
3,4,76,6,17,-11
3,4,77,14,12,2
3,4,78,3,15,-12
3,4,79,6,16,-10
3,4,80,12,8,4
3,4,81,12,17,-5
3,4,82,8,9,-1
3,4,83,11,7,4
3,4,84,15,13,2
3,4,85,2,4,-2
3,4,86,13,15,-2
3,4,87,10,17,-7
3,4,88,5,16,-11
3,4,89,10,7,3
3,4,90,14,11,3
3,4,91,4,9,-5
3,4,92,14,7,7
3,4,93,6,5,1
3,4,94,8,8,0
3,4,95,1,3,-2
3,4,96,6,6,0
3,4,97,9,6,3
3,4,98,1,10,-9
3,4,99,8,9,-1
3,4,100,8,12,-4
3,4,101,7,5,2
3,4,102,8,12,-4
3,4,103,6,1,5
3,4,104,8,7,1
3,4,105,12,14,-2
3,4,106,9,8,1
3,4,107,9,8,1
3,4,108,22,30,-8
3,4,109,3,11,-8
3,4,110,3,7,-4
3,4,111,9,2,7
3,4,112,7,12,-5
3,4,113,4,13,-9
3,4,114,16,20,-4
3,4,115,10,17,-7
3,4,116,25,21,4
3,4,117,10,8,2
3,4,118,10,10,0
3,4,119,12,22,-10
3,4,120,9,13,-4
3,4,121,1,2,-1
3,4,122,7,3,4
3,4,123,5,10,-5
3,4,124,10,1,9
3,4,125,4,8,-4
3,4,126,10,12,-2
3,4,127,5,9,-4
3,4,128,8,11,-3
3,4,129,9,12,-3
3,4,130,13,8,5
3,4,131,4,16,-12
3,4,132,28,15,13
3,4,133,1,0,1
3,4,134,7,9,-2
3,4,135,11,7,4
3,4,136,15,19,-4
3,4,137,7,5,2
3,4,138,18,14,4
3,4,139,19,10,9
3,4,140,11,14,-3
3,4,141,10,8,2
3,4,142,18,12,6
3,4,143,13,7,6
3,4,144,7,4,3
3,4,145,8,7,1
3,4,146,12,12,0
3,4,147,10,8,2
3,4,148,4,4,0
3,4,149,12,18,-6
3,4,150,3,2,1
3,4,151,8,9,-1
3,4,152,9,26,-17
3,4,153,8,9,-1
3,4,154,10,10,0
3,4,155,6,14,-8
3,4,156,19,15,4
3,4,157,7,15,-8
3,4,158,11,15,-4
3,4,159,10,18,-8
3,4,160,11,7,4
3,4,161,18,8,10
3,4,162,15,17,-2
3,4,163,8,8,0
3,4,164,14,28,-14
3,4,165,11,16,-5
3,4,166,15,16,-1
3,4,167,4,12,-8
3,4,168,24,24,0
3,4,169,9,3,6
3,4,170,12,19,-7
3,4,171,3,4,-1
3,4,172,9,25,-16
3,4,173,9,7,2
3,4,174,9,9,0
3,4,175,21,12,9
3,4,176,7,3,4
3,4,177,10,8,2
3,4,178,7,5,2
3,4,179,5,27,-22
3,4,180,13,5,8
3,4,181,6,5,1
3,4,182,6,17,-11
3,4,183,16,8,8
3,4,184,12,6,6
3,4,185,16,7,9
3,4,186,3,1,2
3,4,187,9,12,-3
3,4,188,4,18,-14
3,4,189,14,11,3
3,4,190,10,11,-1
3,4,191,6,11,-5
3,4,192,7,12,-5
3,4,193,10,11,-1
3,4,194,14,9,5
3,4,195,4,4,0
3,4,196,15,14,1
3,4,197,13,8,5
3,4,198,13,16,-3
3,4,199,13,18,-5
3,4,200,15,14,1
3,4,201,5,1,4
3,4,202,12,13,-1
3,4,203,15,9,6
3,4,204,9,13,-4
3,4,205,6,14,-8
3,4,206,17,10,7
3,4,207,9,6,3
3,4,208,13,5,8
3,4,209,22,14,8
3,4,210,11,16,-5
3,4,211,8,12,-4
3,4,212,12,20,-8
3,4,213,15,15,0
3,4,214,8,5,3
3,4,215,5,5,0
3,4,216,16,10,6
3,4,217,13,13,0
3,4,218,5,14,-9
3,4,219,8,11,-3
3,4,220,6,7,-1
3,4,221,3,6,-3
3,4,222,6,14,-8
3,4,223,12,16,-4
3,4,224,7,13,-6
3,4,225,5,18,-13
3,4,226,15,17,-2
3,4,227,7,4,3
3,4,228,4,7,-3
3,4,229,7,5,2
3,4,230,13,14,-1
3,4,231,9,10,-1
3,4,232,8,7,1
3,4,233,5,22,-17
3,4,234,12,9,3
3,4,235,10,13,-3
3,4,236,23,11,12
3,4,237,12,4,8
3,4,238,9,9,0
3,4,239,2,5,-3
3,4,240,11,8,3
3,4,241,8,12,-4
3,4,242,11,11,0
3,4,243,5,9,-4
3,4,244,2,6,-4
3,4,245,12,8,4
3,4,246,6,9,-3
3,4,247,13,13,0
3,4,248,12,13,-1
3,4,249,13,15,-2
3,4,250,8,15,-7
3,4,251,14,9,5
3,4,252,7,5,2
3,4,253,10,7,3
3,4,254,10,7,3
3,4,255,14,13,1
3,4,256,12,13,-1
3,4,257,10,16,-6
3,4,258,9,18,-9
3,4,259,9,11,-2
3,4,260,9,11,-2
3,4,261,9,12,-3
3,4,262,14,15,-1
3,4,263,9,6,3
3,4,264,17,20,-3
3,4,265,19,5,14
3,4,266,8,8,0
3,4,267,16,7,9
3,4,268,0,1,-1
3,4,269,21,12,9
3,4,270,4,8,-4
3,4,271,11,12,-1
3,4,272,11,10,1
3,4,273,9,8,1
3,4,274,10,4,6
3,4,275,12,11,1
3,4,276,5,6,-1
3,4,277,3,8,-5
3,4,278,10,12,-2
3,4,279,11,24,-13
3,4,280,16,8,8
3,4,281,10,11,-1
3,4,282,7,1,6
3,4,283,8,1,7
3,4,284,24,6,18
3,4,285,15,8,7
3,4,286,23,20,3
3,4,287,13,7,6
3,4,288,17,8,9
3,4,289,6,14,-8
3,4,290,7,6,1
3,4,291,9,5,4
3,4,292,3,11,-8
3,4,293,16,13,3
3,4,294,14,16,-2
3,4,295,3,7,-4
3,4,296,24,20,4
3,4,297,10,14,-4
3,4,298,11,8,3
3,4,299,9,17,-8
3,5,0,26,13,13
3,5,1,24,10,14
3,5,2,17,12,5
3,5,3,11,11,0
3,5,4,11,18,-7
3,5,5,15,15,0
3,5,6,8,22,-14
3,5,7,15,22,-7
3,5,8,2,11,-9
3,5,9,10,3,7
3,5,10,8,9,-1
3,5,11,14,23,-9
3,5,12,15,18,-3
3,5,13,4,5,-1
3,5,14,7,15,-8
3,5,15,9,7,2
3,5,16,8,7,1
3,5,17,2,4,-2
3,5,18,9,13,-4
3,5,19,12,16,-4
3,5,20,3,6,-3
3,5,21,20,6,14
3,5,22,12,12,0
3,5,23,8,6,2
3,5,24,13,9,4
3,5,25,4,7,-3
3,5,26,13,17,-4
3,5,27,5,12,-7
3,5,28,6,8,-2
3,5,29,6,16,-10
3,5,30,21,15,6
3,5,31,5,10,-5
3,5,32,2,10,-8
3,5,33,14,9,5
3,5,34,7,14,-7
3,5,35,19,22,-3
3,5,36,7,12,-5
3,5,37,9,0,9
3,5,38,15,8,7
3,5,39,8,12,-4
3,5,40,11,12,-1
3,5,41,17,15,2
3,5,42,11,6,5
3,5,43,18,8,10
3,5,44,24,14,10
3,5,45,8,6,2
3,5,46,9,11,-2
3,5,47,6,8,-2
3,5,48,13,4,9
3,5,49,14,12,2
3,5,50,8,9,-1
3,5,51,6,6,0
3,5,52,6,11,-5
3,5,53,13,16,-3
3,5,54,6,17,-11
3,5,55,17,9,8
3,5,56,1,10,-9
3,5,57,7,19,-12
3,5,58,24,17,7
3,5,59,18,14,4
3,5,60,3,11,-8
3,5,61,9,13,-4
3,5,62,4,5,-1
3,5,63,10,21,-11
3,5,64,18,8,10
3,5,65,17,9,8
3,5,66,14,9,5
3,5,67,17,8,9
3,5,68,22,23,-1
3,5,69,18,15,3
3,5,70,6,3,3
3,5,71,10,7,3
3,5,72,13,7,6
3,5,73,11,10,1
3,5,74,21,10,11
3,5,75,18,22,-4
3,5,76,6,6,0
3,5,77,3,14,-11
3,5,78,12,16,-4
3,5,79,3,5,-2
3,5,80,22,11,11
3,5,81,13,16,-3
3,5,82,14,15,-1
3,5,83,9,15,-6
3,5,84,15,9,6
3,5,85,9,5,4
3,5,86,9,12,-3
3,5,87,8,1,7
3,5,88,15,11,4
3,5,89,9,7,2
3,5,90,14,10,4
3,5,91,11,13,-2
3,5,92,13,14,-1
3,5,93,5,5,0
3,5,94,17,19,-2
3,5,95,16,13,3
3,5,96,6,5,1
3,5,97,5,3,2
3,5,98,12,10,2
3,5,99,11,11,0
3,5,100,17,15,2
3,5,101,8,4,4
3,5,102,7,22,-15
3,5,103,11,18,-7
3,5,104,19,6,13
3,5,105,2,8,-6
3,5,106,12,4,8
3,5,107,21,13,8
3,5,108,17,25,-8
3,5,109,7,9,-2
3,5,110,12,17,-5
3,5,111,9,9,0
3,5,112,9,12,-3
3,5,113,10,21,-11
3,5,114,12,9,3
3,5,115,13,16,-3
3,5,116,24,18,6
3,5,117,10,11,-1
3,5,118,9,10,-1
3,5,119,10,9,1
3,5,120,18,8,10
3,5,121,1,7,-6
3,5,122,17,15,2
3,5,123,14,5,9
3,5,124,29,11,18
3,5,125,7,14,-7
3,5,126,10,9,1
3,5,127,6,15,-9
3,5,128,14,11,3
3,5,129,13,3,10
3,5,130,3,11,-8
3,5,131,16,8,8
3,5,132,2,1,1
3,5,133,10,13,-3
3,5,134,17,9,8
3,5,135,25,15,10
3,5,136,9,20,-11
3,5,137,5,7,-2
3,5,138,19,12,7
3,5,139,11,13,-2
3,5,140,17,4,13
3,5,141,10,9,1
3,5,142,5,6,-1
3,5,143,14,19,-5
3,5,144,12,9,3
3,5,145,5,7,-2
3,5,146,5,6,-1
3,5,147,3,4,-1
3,5,148,16,5,11
3,5,149,15,17,-2
3,5,150,12,4,8
3,5,151,11,9,2
3,5,152,5,14,-9
3,5,153,16,13,3
3,5,154,9,6,3
3,5,155,5,7,-2
3,5,156,17,11,6
3,5,157,20,13,7
3,5,158,7,3,4
3,5,159,16,16,0
3,5,160,18,15,3
3,5,161,16,23,-7
3,5,162,30,20,10
3,5,163,9,18,-9
3,5,164,17,12,5
3,5,165,8,9,-1
3,5,166,8,3,5
3,5,167,2,16,-14
3,5,168,7,16,-9
3,5,169,12,11,1
3,5,170,13,2,11
3,5,171,6,14,-8
3,5,172,11,8,3
3,5,173,11,8,3
3,5,174,11,17,-6
3,5,175,8,3,5
3,5,176,19,20,-1
3,5,177,8,7,1
3,5,178,15,10,5
3,5,179,11,9,2
3,5,180,9,7,2
3,5,181,9,11,-2
3,5,182,13,24,-11
3,5,183,3,13,-10
3,5,184,16,10,6
3,5,185,8,3,5
3,5,186,8,12,-4
3,5,187,10,17,-7
3,5,188,13,12,1
3,5,189,16,6,10
3,5,190,6,13,-7
3,5,191,18,7,11
3,5,192,10,13,-3
3,5,193,8,10,-2
3,5,194,12,5,7
3,5,195,8,14,-6
3,5,196,10,18,-8
3,5,197,9,22,-13
3,5,198,15,18,-3
3,5,199,18,12,6
3,5,200,7,7,0
3,5,201,16,5,11
3,5,202,4,3,1
3,5,203,6,7,-1
3,5,204,15,9,6
3,5,205,8,33,-25
3,5,206,11,8,3
3,5,207,3,4,-1
3,5,208,11,5,6
3,5,209,13,10,3
3,5,210,12,6,6
3,5,211,9,6,3
3,5,212,26,8,18
3,5,213,11,5,6
3,5,214,29,10,19
3,5,215,8,16,-8
3,5,216,7,7,0
3,5,217,20,18,2
3,5,218,12,13,-1
3,5,219,11,9,2
3,5,220,7,10,-3
3,5,221,8,7,1
3,5,222,2,11,-9
3,5,223,11,16,-5
3,5,224,26,7,19
3,5,225,18,25,-7
3,5,226,11,9,2
3,5,227,11,5,6
3,5,228,9,7,2
3,5,229,6,4,2
3,5,230,8,7,1
3,5,231,10,11,-1
3,5,232,16,16,0
3,5,233,11,13,-2
3,5,234,9,14,-5
3,5,235,24,18,6
3,5,236,9,12,-3
3,5,237,15,15,0
3,5,238,14,22,-8
3,5,239,13,9,4
3,5,240,16,7,9
3,5,241,13,7,6
3,5,242,12,10,2
3,5,243,5,11,-6
3,5,244,6,12,-6
3,5,245,14,10,4
3,5,246,11,6,5
3,5,247,15,9,6
3,5,248,8,6,2
3,5,249,17,21,-4
3,5,250,15,15,0
3,5,251,5,13,-8
3,5,252,7,23,-16
3,5,253,19,16,3
3,5,254,7,17,-10
3,5,255,9,11,-2
3,5,256,5,12,-7
3,5,257,8,13,-5
3,5,258,2,7,-5
3,5,259,10,15,-5
3,5,260,11,7,4
3,5,261,18,12,6
3,5,262,9,7,2
3,5,263,8,4,4
3,5,264,15,13,2
3,5,265,5,7,-2
3,5,266,6,3,3
3,5,267,13,6,7
3,5,268,15,12,3
3,5,269,16,16,0
3,5,270,6,12,-6
3,5,271,20,17,3
3,5,272,15,6,9
3,5,273,9,10,-1
3,5,274,14,14,0
3,5,275,8,15,-7
3,5,276,21,8,13
3,5,277,1,5,-4
3,5,278,5,13,-8
3,5,279,9,13,-4
3,5,280,4,8,-4
3,5,281,11,8,3
3,5,282,11,11,0
3,5,283,19,8,11
3,5,284,5,9,-4
3,5,285,4,1,3
3,5,286,17,16,1
3,5,287,6,10,-4
3,5,288,4,4,0
3,5,289,15,15,0
3,5,290,11,10,1
3,5,291,5,6,-1
3,5,292,8,19,-11
3,5,293,21,6,15
3,5,294,9,10,-1
3,5,295,20,13,7
3,5,296,15,11,4
3,5,297,10,7,3
3,5,298,19,11,8
3,5,299,14,5,9
3,6,0,15,13,2
3,6,1,12,19,-7
3,6,2,10,13,-3
3,6,3,9,8,1
3,6,4,24,16,8
3,6,5,19,24,-5
3,6,6,27,8,19
3,6,7,10,16,-6
3,6,8,11,13,-2
3,6,9,8,18,-10
3,6,10,14,16,-2
3,6,11,5,7,-2
3,6,12,14,7,7
3,6,13,16,10,6
3,6,14,16,15,1
3,6,15,11,11,0
3,6,16,12,12,0
3,6,17,6,6,0
3,6,18,17,19,-2
3,6,19,17,24,-7
3,6,20,11,13,-2
3,6,21,11,16,-5
3,6,22,22,16,6
3,6,23,9,17,-8
3,6,24,5,4,1
3,6,25,9,8,1
3,6,26,12,11,1
3,6,27,3,6,-3
3,6,28,13,12,1
3,6,29,13,18,-5
3,6,30,18,11,7
3,6,31,19,11,8
3,6,32,6,16,-10
3,6,33,21,17,4
3,6,34,19,16,3
3,6,35,17,14,3
3,6,36,3,11,-8
3,6,37,18,16,2
3,6,38,21,10,11
3,6,39,13,15,-2
3,6,40,13,28,-15
3,6,41,3,8,-5
3,6,42,13,12,1
3,6,43,16,8,8
3,6,44,13,17,-4
3,6,45,9,9,0
3,6,46,2,10,-8
3,6,47,15,20,-5
3,6,48,15,10,5
3,6,49,11,17,-6
3,6,50,13,8,5
3,6,51,7,13,-6
3,6,52,16,7,9
3,6,53,5,6,-1
3,6,54,10,8,2
3,6,55,22,17,5
3,6,56,9,14,-5
3,6,57,15,10,5
3,6,58,7,12,-5
3,6,59,14,8,6
3,6,60,15,15,0
3,6,61,3,8,-5
3,6,62,10,27,-17
3,6,63,6,16,-10
3,6,64,4,10,-6
3,6,65,14,16,-2
3,6,66,14,15,-1
3,6,67,7,9,-2
3,6,68,2,3,-1
3,6,69,11,4,7
3,6,70,20,24,-4
3,6,71,18,23,-5
3,6,72,5,6,-1
3,6,73,10,7,3
3,6,74,21,9,12
3,6,75,17,11,6
3,6,76,7,2,5
3,6,77,14,20,-6
3,6,78,16,20,-4
3,6,79,10,11,-1
3,6,80,17,10,7
3,6,81,6,0,6
3,6,82,11,12,-1
3,6,83,14,9,5
3,6,84,10,17,-7
3,6,85,8,7,1
3,6,86,6,9,-3
3,6,87,9,16,-7
3,6,88,8,4,4
3,6,89,9,6,3
3,6,90,10,13,-3
3,6,91,10,9,1
3,6,92,7,5,2
3,6,93,12,10,2
3,6,94,21,10,11
3,6,95,34,19,15
3,6,96,14,7,7
3,6,97,5,10,-5
3,6,98,13,6,7
3,6,99,11,6,5
3,6,100,8,7,1
3,6,101,10,10,0
3,6,102,19,18,1
3,6,103,10,8,2
3,6,104,16,3,13
3,6,105,18,10,8
3,6,106,19,13,6
3,6,107,18,22,-4
3,6,108,9,15,-6
3,6,109,12,9,3
3,6,110,12,10,2
3,6,111,9,8,1
3,6,112,14,17,-3
3,6,113,14,10,4
3,6,114,7,10,-3
3,6,115,16,4,12
3,6,116,11,16,-5
3,6,117,9,13,-4
3,6,118,6,16,-10
3,6,119,8,10,-2
3,6,120,10,9,1
3,6,121,10,6,4
3,6,122,12,17,-5
3,6,123,10,14,-4
3,6,124,14,16,-2
3,6,125,11,12,-1
3,6,126,15,8,7
3,6,127,12,21,-9
3,6,128,10,14,-4
3,6,129,21,16,5
3,6,130,12,7,5
3,6,131,10,18,-8
3,6,132,3,8,-5
3,6,133,8,5,3
3,6,134,16,16,0
3,6,135,17,11,6
3,6,136,11,6,5
3,6,137,19,12,7
3,6,138,20,9,11
3,6,139,10,30,-20
3,6,140,13,20,-7
3,6,141,18,12,6
3,6,142,11,7,4
3,6,143,13,7,6
3,6,144,5,7,-2
3,6,145,11,10,1
3,6,146,16,10,6
3,6,147,12,6,6
3,6,148,21,14,7
3,6,149,24,14,10
3,6,150,15,10,5
3,6,151,12,9,3
3,6,152,8,9,-1
3,6,153,23,12,11
3,6,154,9,12,-3
3,6,155,12,14,-2
3,6,156,15,7,8
3,6,157,10,7,3
3,6,158,2,2,0
3,6,159,20,13,7
3,6,160,20,21,-1
3,6,161,12,13,-1
3,6,162,19,12,7
3,6,163,8,6,2
3,6,164,11,10,1
3,6,165,18,15,3
3,6,166,7,17,-10
3,6,167,7,15,-8
3,6,168,10,9,1
3,6,169,9,9,0
3,6,170,7,9,-2
3,6,171,5,10,-5
3,6,172,13,16,-3
3,6,173,12,17,-5
3,6,174,14,21,-7
3,6,175,15,14,1
3,6,176,5,10,-5
3,6,177,13,16,-3
3,6,178,7,12,-5
3,6,179,8,3,5
3,6,180,14,11,3
3,6,181,4,6,-2
3,6,182,11,3,8
3,6,183,10,11,-1
3,6,184,9,18,-9
3,6,185,28,10,18
3,6,186,6,10,-4
3,6,187,10,10,0
3,6,188,15,10,5
3,6,189,7,9,-2
3,6,190,20,8,12
3,6,191,10,15,-5
3,6,192,16,5,11
3,6,193,5,8,-3
3,6,194,17,12,5
3,6,195,7,14,-7
3,6,196,4,7,-3
3,6,197,15,8,7
3,6,198,6,19,-13
3,6,199,16,6,10
3,6,200,8,8,0
3,6,201,7,11,-4
3,6,202,11,18,-7
3,6,203,12,8,4
3,6,204,6,8,-2
3,6,205,8,10,-2
3,6,206,12,13,-1
3,6,207,8,15,-7
3,6,208,19,17,2
3,6,209,18,9,9
3,6,210,9,5,4
3,6,211,4,9,-5
3,6,212,15,8,7
3,6,213,9,16,-7
3,6,214,20,14,6
3,6,215,5,9,-4
3,6,216,9,13,-4
3,6,217,11,14,-3
3,6,218,15,13,2
3,6,219,7,6,1
3,6,220,18,24,-6
3,6,221,14,13,1
3,6,222,12,15,-3
3,6,223,17,9,8
3,6,224,13,13,0
3,6,225,11,3,8
3,6,226,8,5,3
3,6,227,11,19,-8
3,6,228,14,13,1
3,6,229,10,17,-7
3,6,230,25,16,9
3,6,231,18,19,-1
3,6,232,19,10,9
3,6,233,1,12,-11
3,6,234,7,4,3
3,6,235,5,4,1
3,6,236,17,21,-4
3,6,237,5,3,2
3,6,238,17,29,-12
3,6,239,9,4,5
3,6,240,6,15,-9
3,6,241,4,11,-7
3,6,242,18,12,6
3,6,243,7,13,-6
3,6,244,14,13,1
3,6,245,12,12,0
3,6,246,8,15,-7
3,6,247,13,9,4
3,6,248,11,9,2
3,6,249,5,2,3
3,6,250,8,10,-2
3,6,251,2,6,-4
3,6,252,11,11,0
3,6,253,11,9,2
3,6,254,18,8,10
3,6,255,32,18,14
3,6,256,16,38,-22
3,6,257,13,24,-11
3,6,258,17,7,10
3,6,259,9,10,-1
3,6,260,3,6,-3
3,6,261,30,13,17
3,6,262,12,19,-7
3,6,263,9,11,-2
3,6,264,7,16,-9
3,6,265,7,5,2
3,6,266,10,13,-3
3,6,267,16,20,-4
3,6,268,17,13,4
3,6,269,14,12,2
3,6,270,20,17,3
3,6,271,27,18,9
3,6,272,8,6,2
3,6,273,14,20,-6
3,6,274,19,9,10
3,6,275,13,16,-3
3,6,276,9,14,-5
3,6,277,7,9,-2
3,6,278,7,9,-2
3,6,279,6,8,-2
3,6,280,14,29,-15
3,6,281,6,12,-6
3,6,282,11,17,-6
3,6,283,12,16,-4
3,6,284,10,7,3
3,6,285,9,7,2
3,6,286,10,15,-5
3,6,287,13,10,3
3,6,288,18,17,1
3,6,289,13,11,2
3,6,290,13,8,5
3,6,291,15,14,1
3,6,292,9,14,-5
3,6,293,10,11,-1
3,6,294,12,10,2
3,6,295,9,7,2
3,6,296,6,7,-1
3,6,297,12,22,-10
3,6,298,4,7,-3
3,6,299,5,3,2
3,7,0,12,10,2
3,7,1,5,6,-1
3,7,2,22,9,13
3,7,3,14,11,3
3,7,4,8,9,-1
3,7,5,20,15,5
3,7,6,15,18,-3
3,7,7,13,12,1
3,7,8,17,22,-5
3,7,9,11,11,0
3,7,10,9,10,-1
3,7,11,11,5,6
3,7,12,8,17,-9
3,7,13,19,13,6
3,7,14,9,22,-13
3,7,15,20,12,8
3,7,16,9,18,-9
3,7,17,13,12,1
3,7,18,12,10,2
3,7,19,18,3,15
3,7,20,10,7,3
3,7,21,13,12,1
3,7,22,17,19,-2
3,7,23,9,6,3
3,7,24,18,12,6
3,7,25,5,10,-5
3,7,26,8,19,-11
3,7,27,15,9,6
3,7,28,18,9,9
3,7,29,19,21,-2
3,7,30,27,16,11
3,7,31,14,6,8
3,7,32,12,18,-6
3,7,33,12,17,-5
3,7,34,8,5,3
3,7,35,16,16,0
3,7,36,5,10,-5
3,7,37,20,11,9
3,7,38,13,20,-7
3,7,39,7,12,-5
3,7,40,14,16,-2
3,7,41,12,7,5
3,7,42,20,11,9
3,7,43,17,16,1
3,7,44,5,20,-15
3,7,45,21,11,10
3,7,46,29,11,18
3,7,47,15,14,1
3,7,48,12,9,3
3,7,49,18,20,-2
3,7,50,8,21,-13
3,7,51,15,9,6
3,7,52,13,10,3
3,7,53,9,5,4
3,7,54,22,15,7
3,7,55,12,13,-1
3,7,56,10,7,3
3,7,57,23,21,2
3,7,58,12,12,0
3,7,59,15,21,-6
3,7,60,7,14,-7
3,7,61,16,12,4
3,7,62,6,14,-8
3,7,63,18,10,8
3,7,64,8,19,-11
3,7,65,10,12,-2
3,7,66,20,13,7
3,7,67,15,13,2
3,7,68,8,10,-2
3,7,69,10,9,1
3,7,70,14,12,2
3,7,71,21,14,7
3,7,72,17,11,6
3,7,73,11,13,-2
3,7,74,16,14,2
3,7,75,15,15,0
3,7,76,10,12,-2
3,7,77,15,6,9
3,7,78,13,11,2
3,7,79,17,15,2
3,7,80,7,6,1
3,7,81,20,11,9
3,7,82,13,24,-11
3,7,83,23,27,-4
3,7,84,10,10,0
3,7,85,10,16,-6
3,7,86,12,7,5
3,7,87,22,8,14
3,7,88,10,22,-12
3,7,89,8,7,1
3,7,90,13,23,-10
3,7,91,19,12,7
3,7,92,12,12,0
3,7,93,4,8,-4
3,7,94,19,19,0
3,7,95,9,17,-8
3,7,96,6,2,4
3,7,97,8,13,-5
3,7,98,10,6,4
3,7,99,17,16,1
3,7,100,13,8,5
3,7,101,10,6,4
3,7,102,5,9,-4
3,7,103,14,13,1
3,7,104,8,9,-1
3,7,105,3,19,-16
3,7,106,13,8,5
3,7,107,8,10,-2
3,7,108,4,1,3
3,7,109,24,12,12
3,7,110,21,14,7
3,7,111,9,13,-4
3,7,112,11,20,-9
3,7,113,24,8,16
3,7,114,32,15,17
3,7,115,5,8,-3
3,7,116,7,16,-9
3,7,117,18,31,-13
3,7,118,1,5,-4
3,7,119,12,11,1
3,7,120,9,15,-6
3,7,121,11,7,4
3,7,122,22,22,0
3,7,123,13,14,-1
3,7,124,12,14,-2
3,7,125,10,8,2
3,7,126,13,18,-5
3,7,127,1,6,-5
3,7,128,21,14,7
3,7,129,7,15,-8
3,7,130,12,17,-5
3,7,131,18,21,-3
3,7,132,15,7,8
3,7,133,20,7,13
3,7,134,27,10,17
3,7,135,17,12,5
3,7,136,15,11,4
3,7,137,11,10,1
3,7,138,15,8,7
3,7,139,15,19,-4
3,7,140,18,13,5
3,7,141,7,8,-1
3,7,142,15,15,0
3,7,143,9,10,-1
3,7,144,11,12,-1
3,7,145,37,13,24
3,7,146,16,11,5
3,7,147,9,13,-4
3,7,148,10,6,4
3,7,149,12,11,1
3,7,150,8,1,7
3,7,151,9,4,5
3,7,152,8,16,-8
3,7,153,7,5,2
3,7,154,9,9,0
3,7,155,14,12,2
3,7,156,22,7,15
3,7,157,5,3,2
3,7,158,11,8,3
3,7,159,15,13,2
3,7,160,12,11,1
3,7,161,8,10,-2
3,7,162,6,17,-11
3,7,163,11,10,1
3,7,164,10,13,-3
3,7,165,6,5,1
3,7,166,18,8,10
3,7,167,22,30,-8
3,7,168,17,5,12
3,7,169,7,15,-8
3,7,170,27,14,13
3,7,171,10,15,-5
3,7,172,10,6,4
3,7,173,0,0,0
3,7,174,2,14,-12
3,7,175,13,9,4
3,7,176,7,11,-4
3,7,177,14,6,8
3,7,178,9,25,-16
3,7,179,15,7,8
3,7,180,24,12,12
3,7,181,18,12,6
3,7,182,16,10,6
3,7,183,8,9,-1
3,7,184,24,19,5
3,7,185,18,17,1
3,7,186,15,17,-2
3,7,187,8,9,-1
3,7,188,19,13,6
3,7,189,18,16,2
3,7,190,13,7,6
3,7,191,11,9,2
3,7,192,14,5,9
3,7,193,17,25,-8
3,7,194,22,19,3
3,7,195,4,6,-2
3,7,196,6,4,2
3,7,197,16,20,-4
3,7,198,7,6,1
3,7,199,11,11,0
3,7,200,16,11,5
3,7,201,10,3,7
3,7,202,9,16,-7
3,7,203,16,18,-2
3,7,204,9,10,-1
3,7,205,5,4,1
3,7,206,4,10,-6
3,7,207,12,10,2
3,7,208,22,14,8
3,7,209,22,13,9
3,7,210,12,21,-9
3,7,211,13,15,-2
3,7,212,19,11,8
3,7,213,9,12,-3
3,7,214,22,22,0
3,7,215,10,6,4
3,7,216,9,7,2
3,7,217,10,12,-2
3,7,218,13,22,-9
3,7,219,13,21,-8
3,7,220,9,9,0
3,7,221,13,16,-3
3,7,222,17,22,-5
3,7,223,11,12,-1
3,7,224,12,15,-3
3,7,225,9,10,-1
3,7,226,28,21,7
3,7,227,7,8,-1
3,7,228,21,18,3
3,7,229,9,16,-7
3,7,230,5,16,-11
3,7,231,16,14,2
3,7,232,12,9,3
3,7,233,5,3,2
3,7,234,18,20,-2
3,7,235,9,5,4
3,7,236,15,16,-1
3,7,237,10,9,1
3,7,238,10,14,-4
3,7,239,13,15,-2
3,7,240,13,20,-7
3,7,241,8,3,5
3,7,242,7,12,-5
3,7,243,9,11,-2
3,7,244,11,11,0
3,7,245,13,17,-4
3,7,246,9,15,-6
3,7,247,9,12,-3
3,7,248,18,13,5
3,7,249,11,15,-4
3,7,250,20,10,10
3,7,251,3,20,-17
3,7,252,11,15,-4
3,7,253,16,24,-8
3,7,254,21,12,9
3,7,255,7,34,-27
3,7,256,12,13,-1
3,7,257,7,7,0
3,7,258,10,15,-5
3,7,259,6,10,-4
3,7,260,12,8,4
3,7,261,11,7,4
3,7,262,12,8,4
3,7,263,8,8,0
3,7,264,16,15,1
3,7,265,14,18,-4
3,7,266,3,3,0
3,7,267,7,15,-8
3,7,268,20,16,4
3,7,269,20,14,6
3,7,270,7,18,-11
3,7,271,11,9,2
3,7,272,10,8,2
3,7,273,18,6,12
3,7,274,19,14,5
3,7,275,13,17,-4
3,7,276,5,3,2
3,7,277,14,32,-18
3,7,278,11,10,1
3,7,279,14,11,3
3,7,280,12,6,6
3,7,281,3,12,-9
3,7,282,6,3,3
3,7,283,19,22,-3
3,7,284,19,18,1
3,7,285,3,4,-1
3,7,286,8,12,-4
3,7,287,6,8,-2
3,7,288,31,15,16
3,7,289,14,16,-2
3,7,290,5,10,-5
3,7,291,13,5,8
3,7,292,12,12,0
3,7,293,3,4,-1
3,7,294,9,20,-11
3,7,295,8,9,-1
3,7,296,22,10,12
3,7,297,6,1,5
3,7,298,15,8,7
3,7,299,3,9,-6
3,8,0,11,31,-20
3,8,1,4,9,-5
3,8,2,4,8,-4
3,8,3,15,11,4
3,8,4,15,16,-1
3,8,5,18,11,7
3,8,6,23,14,9
3,8,7,16,8,8
3,8,8,1,10,-9
3,8,9,8,5,3
3,8,10,13,8,5
3,8,11,13,6,7
3,8,12,17,15,2
3,8,13,19,11,8
3,8,14,10,15,-5
3,8,15,14,10,4
3,8,16,11,3,8
3,8,17,13,9,4
3,8,18,13,13,0
3,8,19,9,7,2
3,8,20,7,14,-7
3,8,21,10,13,-3
3,8,22,13,9,4
3,8,23,10,7,3
3,8,24,6,9,-3
3,8,25,16,19,-3
3,8,26,8,14,-6
3,8,27,17,14,3
3,8,28,12,2,10
3,8,29,4,15,-11
3,8,30,11,15,-4
3,8,31,7,13,-6
3,8,32,13,15,-2
3,8,33,4,8,-4
3,8,34,19,10,9
3,8,35,8,10,-2
3,8,36,14,12,2
3,8,37,21,9,12
3,8,38,13,8,5
3,8,39,12,18,-6
3,8,40,41,8,33
3,8,41,10,8,2
3,8,42,16,18,-2
3,8,43,21,17,4
3,8,44,9,15,-6
3,8,45,5,17,-12
3,8,46,11,8,3
3,8,47,11,6,5
3,8,48,9,9,0
3,8,49,14,6,8
3,8,50,10,3,7
3,8,51,13,21,-8
3,8,52,5,3,2
3,8,53,17,8,9
3,8,54,14,15,-1
3,8,55,5,12,-7
3,8,56,11,15,-4
3,8,57,25,12,13
3,8,58,10,6,4
3,8,59,16,13,3
3,8,60,10,18,-8
3,8,61,23,12,11
3,8,62,17,21,-4
3,8,63,9,2,7
3,8,64,17,12,5
3,8,65,11,16,-5
3,8,66,7,26,-19
3,8,67,16,7,9
3,8,68,25,18,7
3,8,69,19,8,11
3,8,70,19,11,8
3,8,71,17,12,5
3,8,72,17,11,6
3,8,73,20,23,-3
3,8,74,9,3,6
3,8,75,23,13,10
3,8,76,16,13,3
3,8,77,11,11,0
3,8,78,25,12,13
3,8,79,15,10,5
3,8,80,23,12,11
3,8,81,21,16,5
3,8,82,14,12,2
3,8,83,16,14,2
3,8,84,9,12,-3
3,8,85,15,14,1
3,8,86,16,5,11
3,8,87,11,20,-9
3,8,88,13,13,0
3,8,89,6,5,1
3,8,90,10,6,4
3,8,91,10,16,-6
3,8,92,27,14,13
3,8,93,14,16,-2
3,8,94,24,22,2
3,8,95,15,12,3
3,8,96,27,16,11
3,8,97,12,6,6
3,8,98,8,6,2
3,8,99,27,7,20
3,8,100,15,16,-1
3,8,101,8,12,-4
3,8,102,17,16,1
3,8,103,13,10,3
3,8,104,13,17,-4
3,8,105,23,15,8
3,8,106,7,9,-2
3,8,107,11,7,4
3,8,108,6,13,-7
3,8,109,15,6,9
3,8,110,11,7,4
3,8,111,31,21,10
3,8,112,14,8,6
3,8,113,14,12,2
3,8,114,20,14,6
3,8,115,9,8,1
3,8,116,13,12,1
3,8,117,23,21,2
3,8,118,19,5,14
3,8,119,17,12,5
3,8,120,16,12,4
3,8,121,8,15,-7
3,8,122,16,25,-9
3,8,123,10,6,4
3,8,124,3,7,-4
3,8,125,5,15,-10
3,8,126,15,3,12
3,8,127,11,26,-15
3,8,128,7,5,2
3,8,129,15,12,3
3,8,130,20,10,10
3,8,131,14,8,6
3,8,132,22,24,-2
3,8,133,8,21,-13
3,8,134,7,11,-4
3,8,135,14,13,1
3,8,136,9,14,-5
3,8,137,18,23,-5
3,8,138,15,21,-6
3,8,139,14,10,4
3,8,140,8,11,-3
3,8,141,16,19,-3
3,8,142,8,10,-2
3,8,143,15,8,7
3,8,144,28,13,15
3,8,145,14,32,-18
3,8,146,14,12,2
3,8,147,13,14,-1
3,8,148,5,7,-2
3,8,149,23,13,10
3,8,150,12,5,7
3,8,151,15,7,8
3,8,152,11,14,-3
3,8,153,10,8,2
3,8,154,10,7,3
3,8,155,7,7,0
3,8,156,9,4,5
3,8,157,8,8,0
3,8,158,7,7,0
3,8,159,18,10,8
3,8,160,10,14,-4
3,8,161,18,18,0
3,8,162,10,9,1
3,8,163,16,21,-5
3,8,164,2,7,-5
3,8,165,6,0,6
3,8,166,13,10,3
3,8,167,21,15,6
3,8,168,13,16,-3
3,8,169,11,14,-3
3,8,170,10,7,3
3,8,171,7,11,-4
3,8,172,20,13,7
3,8,173,13,25,-12
3,8,174,18,10,8
3,8,175,4,7,-3
3,8,176,6,7,-1
3,8,177,11,13,-2
3,8,178,17,15,2
3,8,179,13,9,4
3,8,180,11,6,5
3,8,181,15,9,6
3,8,182,19,12,7
3,8,183,10,9,1
3,8,184,12,11,1
3,8,185,5,10,-5
3,8,186,17,16,1
3,8,187,21,15,6
3,8,188,18,16,2
3,8,189,15,12,3
3,8,190,4,4,0
3,8,191,8,18,-10
3,8,192,12,14,-2
3,8,193,6,4,2
3,8,194,21,16,5
3,8,195,5,5,0
3,8,196,9,11,-2
3,8,197,5,7,-2
3,8,198,7,5,2
3,8,199,10,4,6
3,8,200,13,7,6
3,8,201,6,7,-1
3,8,202,9,13,-4
3,8,203,12,8,4
3,8,204,15,5,10
3,8,205,6,3,3
3,8,206,15,9,6
3,8,207,17,15,2
3,8,208,4,9,-5
3,8,209,6,8,-2
3,8,210,14,12,2
3,8,211,7,7,0
3,8,212,5,16,-11
3,8,213,13,20,-7
3,8,214,8,13,-5
3,8,215,10,17,-7
3,8,216,19,9,10
3,8,217,11,5,6
3,8,218,11,6,5
3,8,219,21,16,5
3,8,220,21,14,7
3,8,221,7,8,-1
3,8,222,6,9,-3
3,8,223,9,10,-1
3,8,224,24,7,17
3,8,225,9,17,-8
3,8,226,13,14,-1
3,8,227,19,23,-4
3,8,228,6,9,-3
3,8,229,25,23,2
3,8,230,10,7,3
3,8,231,4,13,-9
3,8,232,10,11,-1
3,8,233,28,12,16
3,8,234,7,22,-15
3,8,235,19,17,2
3,8,236,13,22,-9
3,8,237,13,11,2
3,8,238,15,23,-8
3,8,239,22,6,16
3,8,240,11,13,-2
3,8,241,15,12,3
3,8,242,23,10,13
3,8,243,18,8,10
3,8,244,15,10,5
3,8,245,9,12,-3
3,8,246,22,17,5
3,8,247,9,19,-10
3,8,248,13,19,-6
3,8,249,4,6,-2
3,8,250,13,10,3
3,8,251,14,10,4
3,8,252,7,3,4
3,8,253,21,27,-6
3,8,254,17,20,-3
3,8,255,10,9,1
3,8,256,9,11,-2
3,8,257,18,21,-3
3,8,258,24,22,2
3,8,259,9,16,-7
3,8,260,10,11,-1
3,8,261,16,17,-1
3,8,262,9,31,-22
3,8,263,18,20,-2
3,8,264,8,9,-1
3,8,265,27,20,7
3,8,266,12,14,-2
3,8,267,28,11,17
3,8,268,16,11,5
3,8,269,16,18,-2
3,8,270,11,16,-5
3,8,271,11,15,-4
3,8,272,15,7,8
3,8,273,9,11,-2
3,8,274,22,10,12
3,8,275,13,11,2
3,8,276,24,19,5
3,8,277,7,5,2
3,8,278,14,13,1
3,8,279,23,17,6
3,8,280,13,14,-1
3,8,281,16,9,7
3,8,282,8,6,2
3,8,283,3,6,-3
3,8,284,28,12,16
3,8,285,17,6,11
3,8,286,17,5,12
3,8,287,31,8,23
3,8,288,13,6,7
3,8,289,8,11,-3
3,8,290,17,12,5
3,8,291,14,16,-2
3,8,292,8,13,-5
3,8,293,15,9,6
3,8,294,6,11,-5
3,8,295,16,7,9
3,8,296,15,6,9
3,8,297,18,18,0
3,8,298,17,24,-7
3,8,299,5,10,-5
3,9,0,18,5,13
3,9,1,9,17,-8
3,9,2,15,24,-9
3,9,3,15,20,-5
3,9,4,10,2,8
3,9,5,6,5,1
3,9,6,13,18,-5
3,9,7,20,24,-4
3,9,8,7,4,3
3,9,9,6,13,-7
3,9,10,13,6,7
3,9,11,12,11,1
3,9,12,11,13,-2
3,9,13,22,16,6
3,9,14,11,2,9
3,9,15,7,9,-2
3,9,16,7,10,-3
3,9,17,8,7,1
3,9,18,30,17,13
3,9,19,18,13,5
3,9,20,2,16,-14
3,9,21,7,11,-4
3,9,22,19,13,6
3,9,23,26,18,8
3,9,24,15,15,0
3,9,25,18,20,-2
3,9,26,10,8,2
3,9,27,24,25,-1
3,9,28,6,6,0
3,9,29,31,28,3
3,9,30,16,5,11
3,9,31,18,9,9
3,9,32,9,14,-5
3,9,33,8,5,3
3,9,34,12,12,0
3,9,35,2,4,-2
3,9,36,29,40,-11
3,9,37,14,15,-1
3,9,38,10,19,-9
3,9,39,17,11,6
3,9,40,11,16,-5
3,9,41,6,12,-6
3,9,42,11,13,-2
3,9,43,9,13,-4
3,9,44,6,17,-11
3,9,45,13,17,-4
3,9,46,14,13,1
3,9,47,17,15,2
3,9,48,13,8,5
3,9,49,21,12,9
3,9,50,9,14,-5
3,9,51,12,9,3
3,9,52,12,10,2
3,9,53,17,9,8
3,9,54,13,9,4
3,9,55,11,14,-3
3,9,56,17,7,10
3,9,57,15,8,7
3,9,58,9,9,0
3,9,59,20,11,9
3,9,60,6,13,-7
3,9,61,16,10,6
3,9,62,11,8,3
3,9,63,16,5,11
3,9,64,11,9,2
3,9,65,14,10,4
3,9,66,11,16,-5
3,9,67,16,16,0
3,9,68,15,5,10
3,9,69,24,14,10
3,9,70,24,11,13
3,9,71,18,16,2
3,9,72,14,5,9
3,9,73,9,13,-4
3,9,74,24,14,10
3,9,75,16,10,6
3,9,76,12,6,6
3,9,77,14,15,-1
3,9,78,12,12,0
3,9,79,5,8,-3
3,9,80,19,9,10
3,9,81,15,6,9
3,9,82,26,8,18
3,9,83,19,15,4
3,9,84,18,15,3
3,9,85,21,26,-5
3,9,86,20,19,1
3,9,87,8,7,1
3,9,88,18,19,-1
3,9,89,8,10,-2
3,9,90,7,6,1
3,9,91,16,16,0
3,9,92,8,15,-7
3,9,93,11,10,1
3,9,94,12,9,3
3,9,95,10,12,-2
3,9,96,19,12,7
3,9,97,10,14,-4
3,9,98,27,10,17
3,9,99,18,7,11
3,9,100,12,15,-3
3,9,101,6,5,1
3,9,102,12,10,2
3,9,103,7,9,-2
3,9,104,13,6,7
3,9,105,19,12,7
3,9,106,16,14,2
3,9,107,9,4,5
3,9,108,19,16,3
3,9,109,8,4,4
3,9,110,9,13,-4
3,9,111,17,13,4
3,9,112,25,7,18
3,9,113,8,13,-5
3,9,114,7,6,1
3,9,115,29,13,16
3,9,116,11,6,5
3,9,117,29,17,12
3,9,118,19,32,-13
3,9,119,19,14,5
3,9,120,20,16,4
3,9,121,15,12,3
3,9,122,5,10,-5
3,9,123,18,24,-6
3,9,124,6,8,-2
3,9,125,12,7,5
3,9,126,15,10,5
3,9,127,5,10,-5
3,9,128,20,19,1
3,9,129,20,10,10
3,9,130,7,10,-3
3,9,131,7,11,-4
3,9,132,3,6,-3
3,9,133,9,7,2
3,9,134,12,9,3
3,9,135,9,14,-5
3,9,136,11,14,-3
3,9,137,5,11,-6
3,9,138,14,13,1
3,9,139,10,5,5
3,9,140,17,10,7
3,9,141,6,16,-10
3,9,142,9,17,-8
3,9,143,13,10,3
3,9,144,3,3,0
3,9,145,13,15,-2
3,9,146,17,14,3
3,9,147,12,15,-3
3,9,148,22,9,13
3,9,149,13,8,5
3,9,150,21,13,8
3,9,151,15,23,-8
3,9,152,17,16,1
3,9,153,19,16,3
3,9,154,13,23,-10
3,9,155,11,8,3
3,9,156,19,20,-1
3,9,157,13,3,10
3,9,158,12,18,-6
3,9,159,14,5,9
3,9,160,6,10,-4
3,9,161,18,14,4
3,9,162,11,15,-4
3,9,163,8,7,1
3,9,164,8,12,-4
3,9,165,24,18,6
3,9,166,18,16,2
3,9,167,9,21,-12
3,9,168,13,23,-10
3,9,169,22,21,1
3,9,170,10,15,-5
3,9,171,21,10,11
3,9,172,11,11,0
3,9,173,17,6,11
3,9,174,13,7,6
3,9,175,15,12,3
3,9,176,22,8,14
3,9,177,11,8,3
3,9,178,11,8,3
3,9,179,18,15,3
3,9,180,15,17,-2
3,9,181,8,19,-11
3,9,182,10,10,0
3,9,183,22,19,3
3,9,184,15,19,-4
3,9,185,11,10,1
3,9,186,5,7,-2
3,9,187,15,12,3
3,9,188,5,13,-8
3,9,189,3,3,0
3,9,190,20,13,7
3,9,191,13,15,-2
3,9,192,29,22,7
3,9,193,17,16,1
3,9,194,16,9,7
3,9,195,18,12,6
3,9,196,13,17,-4
3,9,197,6,14,-8
3,9,198,3,7,-4
3,9,199,7,18,-11
3,9,200,19,17,2
3,9,201,12,7,5
3,9,202,22,21,1
3,9,203,16,6,10
3,9,204,17,9,8
3,9,205,17,26,-9
3,9,206,6,6,0
3,9,207,15,13,2
3,9,208,19,15,4
3,9,209,22,17,5
3,9,210,23,22,1
3,9,211,20,16,4
3,9,212,8,15,-7
3,9,213,18,6,12
3,9,214,10,18,-8
3,9,215,21,12,9
3,9,216,13,14,-1
3,9,217,17,15,2
3,9,218,23,13,10
3,9,219,5,3,2
3,9,220,12,15,-3
3,9,221,13,8,5
3,9,222,9,12,-3
3,9,223,18,12,6
3,9,224,5,9,-4
3,9,225,11,10,1
3,9,226,17,5,12
3,9,227,11,16,-5
3,9,228,20,10,10
3,9,229,8,22,-14
3,9,230,10,5,5
3,9,231,18,7,11
3,9,232,11,9,2
3,9,233,7,12,-5
3,9,234,10,15,-5
3,9,235,15,15,0
3,9,236,22,17,5
3,9,237,12,12,0
3,9,238,19,12,7
3,9,239,18,6,12
3,9,240,8,3,5
3,9,241,16,8,8
3,9,242,17,18,-1
3,9,243,10,9,1
3,9,244,13,9,4
3,9,245,18,8,10
3,9,246,16,14,2
3,9,247,6,2,4
3,9,248,9,12,-3
3,9,249,5,11,-6
3,9,250,15,16,-1
3,9,251,12,7,5
3,9,252,8,6,2
3,9,253,5,10,-5
3,9,254,12,16,-4
3,9,255,8,9,-1
3,9,256,10,3,7
3,9,257,8,6,2
3,9,258,20,10,10
3,9,259,38,9,29
3,9,260,8,11,-3
3,9,261,17,6,11
3,9,262,21,13,8
3,9,263,8,11,-3
3,9,264,9,20,-11
3,9,265,14,7,7
3,9,266,16,14,2
3,9,267,15,13,2
3,9,268,13,24,-11
3,9,269,35,14,21
3,9,270,23,19,4
3,9,271,8,10,-2
3,9,272,5,6,-1
3,9,273,17,10,7
3,9,274,5,2,3
3,9,275,8,13,-5
3,9,276,15,13,2
3,9,277,18,12,6
3,9,278,11,6,5
3,9,279,17,19,-2
3,9,280,20,4,16
3,9,281,12,11,1
3,9,282,4,1,3
3,9,283,10,8,2
3,9,284,22,9,13
3,9,285,11,9,2
3,9,286,12,7,5
3,9,287,1,13,-12
3,9,288,27,12,15
3,9,289,22,12,10
3,9,290,9,16,-7
3,9,291,17,12,5
3,9,292,21,15,6
3,9,293,10,12,-2
3,9,294,15,3,12
3,9,295,20,13,7
3,9,296,9,10,-1
3,9,297,16,10,6
3,9,298,22,13,9
3,9,299,17,11,6
3,10,0,9,11,-2
3,10,1,13,13,0
3,10,2,9,6,3
3,10,3,4,5,-1
3,10,4,11,7,4
3,10,5,24,8,16
3,10,6,10,14,-4
3,10,7,27,10,17
3,10,8,13,20,-7
3,10,9,15,11,4
3,10,10,19,9,10
3,10,11,13,10,3
3,10,12,16,26,-10
3,10,13,10,10,0
3,10,14,22,13,9
3,10,15,15,16,-1
3,10,16,5,7,-2
3,10,17,24,7,17
3,10,18,7,5,2
3,10,19,16,12,4
3,10,20,22,15,7
3,10,21,14,12,2
3,10,22,9,17,-8
3,10,23,7,11,-4
3,10,24,12,11,1
3,10,25,6,7,-1
3,10,26,6,5,1
3,10,27,18,22,-4
3,10,28,25,11,14
3,10,29,17,22,-5
3,10,30,33,12,21
3,10,31,14,8,6
3,10,32,14,12,2
3,10,33,12,14,-2
3,10,34,10,3,7
3,10,35,10,1,9
3,10,36,10,16,-6
3,10,37,3,3,0
3,10,38,13,9,4
3,10,39,6,13,-7
3,10,40,6,10,-4
3,10,41,18,10,8
3,10,42,12,9,3
3,10,43,17,11,6
3,10,44,8,4,4
3,10,45,13,8,5
3,10,46,22,9,13
3,10,47,10,19,-9
3,10,48,13,14,-1
3,10,49,10,32,-22
3,10,50,19,17,2
3,10,51,12,8,4
3,10,52,4,7,-3
3,10,53,15,2,13
3,10,54,12,8,4
3,10,55,15,15,0
3,10,56,13,13,0
3,10,57,14,4,10
3,10,58,10,11,-1
3,10,59,22,18,4
3,10,60,8,12,-4
3,10,61,14,13,1
3,10,62,11,3,8
3,10,63,9,16,-7
3,10,64,6,12,-6
3,10,65,15,8,7
3,10,66,6,6,0
3,10,67,10,8,2
3,10,68,13,14,-1
3,10,69,26,17,9
3,10,70,21,18,3
3,10,71,14,9,5
3,10,72,10,5,5
3,10,73,16,19,-3
3,10,74,15,21,-6
3,10,75,20,13,7
3,10,76,11,11,0
3,10,77,12,9,3
3,10,78,31,20,11
3,10,79,13,15,-2
3,10,80,13,3,10
3,10,81,16,15,1
3,10,82,15,13,2
3,10,83,22,13,9
3,10,84,6,9,-3
3,10,85,15,0,15
3,10,86,5,8,-3
3,10,87,17,10,7
3,10,88,13,11,2
3,10,89,9,15,-6
3,10,90,16,13,3
3,10,91,8,5,3
3,10,92,3,8,-5
3,10,93,8,6,2
3,10,94,11,15,-4
3,10,95,24,11,13
3,10,96,6,8,-2
3,10,97,18,25,-7
3,10,98,21,10,11
3,10,99,16,14,2
3,10,100,23,18,5
3,10,101,30,20,10
3,10,102,27,9,18
3,10,103,9,4,5
3,10,104,29,14,15
3,10,105,23,7,16
3,10,106,31,16,15
3,10,107,11,4,7
3,10,108,24,10,14
3,10,109,3,10,-7
3,10,110,10,3,7
3,10,111,19,23,-4
3,10,112,13,15,-2
3,10,113,23,7,16
3,10,114,17,28,-11
3,10,115,7,14,-7
3,10,116,7,10,-3
3,10,117,11,9,2
3,10,118,10,18,-8
3,10,119,28,10,18
3,10,120,16,12,4
3,10,121,8,11,-3
3,10,122,13,11,2
3,10,123,11,9,2
3,10,124,11,9,2
3,10,125,6,6,0
3,10,126,16,7,9
3,10,127,7,10,-3
3,10,128,26,22,4
3,10,129,15,18,-3
3,10,130,10,12,-2
3,10,131,9,10,-1
3,10,132,17,10,7
3,10,133,8,12,-4
3,10,134,7,5,2
3,10,135,23,10,13
3,10,136,15,10,5
3,10,137,12,22,-10
3,10,138,16,3,13
3,10,139,5,17,-12
3,10,140,14,9,5
3,10,141,16,12,4
3,10,142,12,6,6
3,10,143,24,7,17
3,10,144,13,7,6
3,10,145,16,6,10
3,10,146,14,8,6
3,10,147,10,16,-6
3,10,148,6,5,1
3,10,149,19,11,8
3,10,150,17,17,0
3,10,151,6,12,-6
3,10,152,7,6,1
3,10,153,6,13,-7
3,10,154,13,5,8
3,10,155,13,8,5
3,10,156,5,2,3
3,10,157,6,5,1
3,10,158,12,7,5
3,10,159,9,9,0
3,10,160,20,17,3
3,10,161,16,22,-6
3,10,162,21,25,-4
3,10,163,12,3,9
3,10,164,3,1,2
3,10,165,12,11,1
3,10,166,13,7,6
3,10,167,23,22,1
3,10,168,23,14,9
3,10,169,14,9,5
3,10,170,14,13,1
3,10,171,14,7,7
3,10,172,14,14,0
3,10,173,19,12,7
3,10,174,21,20,1
3,10,175,18,11,7
3,10,176,16,7,9
3,10,177,23,7,16
3,10,178,16,15,1
3,10,179,14,10,4
3,10,180,7,3,4
3,10,181,17,9,8
3,10,182,13,6,7
3,10,183,18,6,12
3,10,184,14,15,-1
3,10,185,16,7,9
3,10,186,10,4,6
3,10,187,15,12,3
3,10,188,11,10,1
3,10,189,7,11,-4
3,10,190,20,19,1
3,10,191,4,7,-3
3,10,192,14,11,3
3,10,193,11,9,2
3,10,194,9,8,1
3,10,195,12,10,2
3,10,196,43,14,29
3,10,197,10,5,5
3,10,198,22,6,16
3,10,199,22,7,15
3,10,200,11,7,4
3,10,201,14,5,9
3,10,202,14,10,4
3,10,203,23,15,8
3,10,204,11,8,3
3,10,205,17,11,6
3,10,206,12,10,2
3,10,207,13,7,6
3,10,208,8,16,-8
3,10,209,32,9,23
3,10,210,20,24,-4
3,10,211,11,9,2
3,10,212,15,22,-7
3,10,213,17,9,8
3,10,214,14,7,7
3,10,215,16,11,5
3,10,216,6,7,-1
3,10,217,15,10,5
3,10,218,12,13,-1
3,10,219,21,9,12
3,10,220,18,9,9
3,10,221,11,14,-3
3,10,222,10,13,-3
3,10,223,20,11,9
3,10,224,14,11,3
3,10,225,14,7,7
3,10,226,15,22,-7
3,10,227,18,20,-2
3,10,228,23,16,7
3,10,229,8,7,1
3,10,230,8,7,1
3,10,231,28,17,11
3,10,232,16,17,-1
3,10,233,18,10,8
3,10,234,20,16,4
3,10,235,11,11,0
3,10,236,10,11,-1
3,10,237,8,13,-5
3,10,238,12,8,4
3,10,239,17,23,-6
3,10,240,14,3,11
3,10,241,15,11,4
3,10,242,15,8,7
3,10,243,8,6,2
3,10,244,17,6,11
3,10,245,11,15,-4
3,10,246,8,14,-6
3,10,247,6,11,-5
3,10,248,17,10,7
3,10,249,16,20,-4
3,10,250,11,7,4
3,10,251,12,6,6
3,10,252,20,7,13
3,10,253,7,17,-10
3,10,254,10,26,-16
3,10,255,9,10,-1
3,10,256,24,17,7
3,10,257,23,10,13
3,10,258,9,9,0
3,10,259,15,17,-2
3,10,260,11,11,0
3,10,261,22,8,14
3,10,262,12,20,-8
3,10,263,4,3,1
3,10,264,26,12,14
3,10,265,12,19,-7
3,10,266,10,11,-1
3,10,267,32,22,10
3,10,268,14,11,3
3,10,269,11,8,3
3,10,270,13,21,-8
3,10,271,12,7,5
3,10,272,21,10,11
3,10,273,11,22,-11
3,10,274,10,19,-9
3,10,275,10,7,3
3,10,276,13,23,-10
3,10,277,12,8,4
3,10,278,14,6,8
3,10,279,15,8,7
3,10,280,5,9,-4
3,10,281,4,3,1
3,10,282,19,12,7
3,10,283,13,15,-2
3,10,284,14,7,7
3,10,285,12,4,8
3,10,286,6,1,5
3,10,287,8,11,-3
3,10,288,16,10,6
3,10,289,8,7,1
3,10,290,10,15,-5
3,10,291,3,21,-18
3,10,292,26,12,14
3,10,293,3,11,-8
3,10,294,13,12,1
3,10,295,11,13,-2
3,10,296,23,16,7
3,10,297,11,5,6
3,10,298,15,8,7
3,10,299,19,19,0
3,11,0,6,11,-5
3,11,1,16,6,10
3,11,2,16,11,5
3,11,3,23,7,16
3,11,4,12,11,1
3,11,5,15,11,4
3,11,6,19,15,4
3,11,7,15,17,-2
3,11,8,19,20,-1
3,11,9,13,3,10
3,11,10,12,9,3
3,11,11,13,14,-1
3,11,12,17,8,9
3,11,13,16,13,3
3,11,14,17,11,6
3,11,15,20,18,2
3,11,16,8,6,2
3,11,17,14,8,6
3,11,18,6,6,0
3,11,19,12,22,-10
3,11,20,8,10,-2
3,11,21,7,12,-5
3,11,22,14,7,7
3,11,23,4,9,-5
3,11,24,17,9,8
3,11,25,7,15,-8
3,11,26,17,11,6
3,11,27,5,7,-2
3,11,28,5,13,-8
3,11,29,13,14,-1
3,11,30,16,17,-1
3,11,31,18,7,11
3,11,32,13,8,5
3,11,33,11,12,-1
3,11,34,14,13,1
3,11,35,13,7,6
3,11,36,20,15,5
3,11,37,19,4,15
3,11,38,10,20,-10
3,11,39,18,17,1
3,11,40,7,13,-6
3,11,41,15,11,4
3,11,42,15,10,5
3,11,43,15,15,0
3,11,44,9,6,3
3,11,45,9,1,8
3,11,46,14,12,2
3,11,47,9,8,1
3,11,48,10,16,-6
3,11,49,16,9,7
3,11,50,8,4,4
3,11,51,15,17,-2
3,11,52,15,11,4
3,11,53,21,16,5
3,11,54,12,11,1
3,11,55,17,20,-3
3,11,56,7,4,3
3,11,57,14,23,-9
3,11,58,9,6,3
3,11,59,15,8,7
3,11,60,12,4,8
3,11,61,18,14,4
3,11,62,10,7,3
3,11,63,21,23,-2
3,11,64,2,1,1
3,11,65,24,18,6
3,11,66,19,11,8
3,11,67,15,18,-3
3,11,68,14,7,7
3,11,69,14,10,4
3,11,70,12,8,4
3,11,71,17,6,11
3,11,72,20,19,1
3,11,73,17,15,2
3,11,74,15,17,-2
3,11,75,17,9,8
3,11,76,20,16,4
3,11,77,16,15,1
3,11,78,24,15,9
3,11,79,14,14,0
3,11,80,15,8,7
3,11,81,19,17,2
3,11,82,15,7,8
3,11,83,21,11,10
3,11,84,7,10,-3
3,11,85,16,17,-1
3,11,86,18,18,0
3,11,87,7,8,-1
3,11,88,17,10,7
3,11,89,10,6,4
3,11,90,19,9,10
3,11,91,21,10,11
3,11,92,17,22,-5
3,11,93,4,2,2
3,11,94,13,16,-3
3,11,95,16,15,1
3,11,96,8,11,-3
3,11,97,16,21,-5
3,11,98,14,2,12
3,11,99,15,6,9
3,11,100,2,8,-6
3,11,101,22,22,0
3,11,102,14,12,2
3,11,103,17,10,7
3,11,104,7,7,0
3,11,105,20,8,12
3,11,106,19,15,4
3,11,107,13,19,-6
3,11,108,10,8,2
3,11,109,23,14,9
3,11,110,17,18,-1
3,11,111,14,12,2
3,11,112,12,8,4
3,11,113,19,11,8
3,11,114,18,11,7
3,11,115,9,20,-11
3,11,116,9,4,5
3,11,117,15,12,3
3,11,118,13,16,-3
3,11,119,19,14,5
3,11,120,14,5,9
3,11,121,15,20,-5
3,11,122,14,3,11
3,11,123,11,5,6
3,11,124,23,18,5
3,11,125,6,8,-2
3,11,126,14,8,6
3,11,127,19,11,8
3,11,128,13,6,7
3,11,129,13,6,7
3,11,130,12,15,-3
3,11,131,11,23,-12
3,11,132,20,12,8
3,11,133,8,12,-4
3,11,134,12,9,3
3,11,135,13,5,8
3,11,136,17,9,8
3,11,137,8,12,-4
3,11,138,22,18,4
3,11,139,7,17,-10
3,11,140,14,7,7
3,11,141,20,15,5
3,11,142,21,10,11
3,11,143,18,9,9
3,11,144,8,5,3
3,11,145,15,17,-2
3,11,146,19,12,7
3,11,147,28,17,11
3,11,148,21,8,13
3,11,149,12,10,2
3,11,150,12,6,6
3,11,151,18,11,7
3,11,152,12,11,1
3,11,153,20,18,2
3,11,154,11,12,-1
3,11,155,8,2,6
3,11,156,18,15,3
3,11,157,24,7,17
3,11,158,15,15,0
3,11,159,24,10,14
3,11,160,19,9,10
3,11,161,14,3,11
3,11,162,14,11,3
3,11,163,13,21,-8
3,11,164,17,22,-5
3,11,165,15,9,6
3,11,166,8,8,0
3,11,167,16,9,7
3,11,168,17,24,-7
3,11,169,14,17,-3
3,11,170,10,17,-7
3,11,171,4,4,0
3,11,172,16,8,8
3,11,173,10,21,-11
3,11,174,31,12,19
3,11,175,15,7,8
3,11,176,6,17,-11
3,11,177,16,9,7
3,11,178,12,19,-7
3,11,179,7,17,-10
3,11,180,21,7,14
3,11,181,13,7,6
3,11,182,8,18,-10
3,11,183,19,6,13
3,11,184,10,6,4
3,11,185,27,5,22
3,11,186,11,2,9
3,11,187,17,16,1
3,11,188,14,10,4
3,11,189,16,13,3
3,11,190,19,16,3
3,11,191,13,4,9
3,11,192,14,18,-4
3,11,193,5,14,-9
3,11,194,14,7,7
3,11,195,20,19,1
3,11,196,12,21,-9
3,11,197,13,9,4
3,11,198,16,14,2
3,11,199,20,13,7
3,11,200,19,17,2
3,11,201,21,14,7
3,11,202,15,6,9
3,11,203,19,12,7
3,11,204,26,24,2
3,11,205,22,13,9
3,11,206,22,13,9
3,11,207,13,15,-2
3,11,208,23,12,11
3,11,209,15,12,3
3,11,210,18,16,2
3,11,211,13,15,-2
3,11,212,16,11,5
3,11,213,17,16,1
3,11,214,15,12,3
3,11,215,21,13,8
3,11,216,4,6,-2
3,11,217,10,8,2
3,11,218,17,16,1
3,11,219,16,9,7
3,11,220,23,12,11
3,11,221,7,10,-3
3,11,222,13,18,-5
3,11,223,10,13,-3
3,11,224,17,7,10
3,11,225,10,13,-3
3,11,226,17,10,7
3,11,227,12,18,-6
3,11,228,12,9,3
3,11,229,33,10,23
3,11,230,6,12,-6
3,11,231,13,14,-1
3,11,232,17,13,4
3,11,233,20,14,6
3,11,234,5,6,-1
3,11,235,17,6,11
3,11,236,13,9,4
3,11,237,13,9,4
3,11,238,15,19,-4
3,11,239,14,22,-8
3,11,240,19,8,11
3,11,241,12,5,7
3,11,242,19,15,4
3,11,243,12,12,0
3,11,244,4,12,-8
3,11,245,14,12,2
3,11,246,25,10,15
3,11,247,14,7,7
3,11,248,11,3,8
3,11,249,17,10,7
3,11,250,30,12,18
3,11,251,19,10,9
3,11,252,32,17,15
3,11,253,14,19,-5
3,11,254,5,4,1
3,11,255,15,12,3
3,11,256,21,16,5
3,11,257,19,14,5
3,11,258,19,8,11
3,11,259,8,6,2
3,11,260,8,10,-2
3,11,261,25,10,15
3,11,262,18,11,7
3,11,263,13,8,5
3,11,264,22,3,19
3,11,265,21,7,14
3,11,266,15,13,2
3,11,267,13,14,-1
3,11,268,15,17,-2
3,11,269,7,8,-1
3,11,270,14,8,6
3,11,271,24,8,16
3,11,272,4,10,-6
3,11,273,13,12,1
3,11,274,12,12,0
3,11,275,13,9,4
3,11,276,9,19,-10
3,11,277,22,11,11
3,11,278,23,5,18
3,11,279,23,11,12
3,11,280,22,3,19
3,11,281,27,7,20
3,11,282,10,3,7
3,11,283,23,13,10
3,11,284,17,12,5
3,11,285,11,4,7
3,11,286,21,12,9
3,11,287,8,6,2
3,11,288,5,7,-2
3,11,289,24,9,15
3,11,290,15,4,11
3,11,291,23,19,4
3,11,292,13,7,6
3,11,293,15,12,3
3,11,294,6,9,-3
3,11,295,18,12,6
3,11,296,7,13,-6
3,11,297,7,13,-6
3,11,298,13,10,3
3,11,299,18,10,8
3,12,0,8,12,-4
3,12,1,14,9,5
3,12,2,17,9,8
3,12,3,18,4,14
3,12,4,7,13,-6
3,12,5,10,8,2
3,12,6,15,7,8
3,12,7,10,6,4
3,12,8,8,14,-6
3,12,9,18,8,10
3,12,10,18,6,12
3,12,11,4,10,-6
3,12,12,24,9,15
3,12,13,14,9,5
3,12,14,15,14,1
3,12,15,23,14,9
3,12,16,12,12,0
3,12,17,16,10,6
3,12,18,35,18,17
3,12,19,13,9,4
3,12,20,13,15,-2
3,12,21,14,27,-13
3,12,22,13,7,6
3,12,23,27,22,5
3,12,24,14,10,4
3,12,25,25,13,12
3,12,26,18,11,7
3,12,27,21,13,8
3,12,28,15,21,-6
3,12,29,7,13,-6
3,12,30,13,19,-6
3,12,31,14,9,5
3,12,32,12,7,5
3,12,33,16,9,7
3,12,34,6,5,1
3,12,35,20,17,3
3,12,36,17,15,2
3,12,37,10,6,4
3,12,38,9,3,6
3,12,39,24,14,10
3,12,40,17,19,-2
3,12,41,31,17,14
3,12,42,11,7,4
3,12,43,18,3,15
3,12,44,14,21,-7
3,12,45,18,14,4
3,12,46,13,11,2
3,12,47,18,15,3
3,12,48,16,24,-8
3,12,49,8,6,2
3,12,50,9,8,1
3,12,51,16,8,8
3,12,52,21,12,9
3,12,53,12,9,3
3,12,54,20,20,0
3,12,55,15,7,8
3,12,56,14,10,4
3,12,57,19,11,8
3,12,58,39,16,23
3,12,59,14,5,9
3,12,60,22,12,10
3,12,61,21,9,12
3,12,62,15,16,-1
3,12,63,10,10,0
3,12,64,12,9,3
3,12,65,13,10,3
3,12,66,8,11,-3
3,12,67,11,8,3
3,12,68,17,4,13
3,12,69,10,13,-3
3,12,70,10,11,-1
3,12,71,9,14,-5
3,12,72,10,12,-2
3,12,73,10,14,-4
3,12,74,17,10,7
3,12,75,12,8,4
3,12,76,15,5,10
3,12,77,20,4,16
3,12,78,18,12,6
3,12,79,19,15,4
3,12,80,33,19,14
3,12,81,7,7,0
3,12,82,24,12,12
3,12,83,8,5,3
3,12,84,25,17,8
3,12,85,4,10,-6
3,12,86,20,4,16
3,12,87,15,12,3
3,12,88,7,11,-4
3,12,89,23,20,3
3,12,90,18,12,6
3,12,91,8,7,1
3,12,92,13,22,-9
3,12,93,5,11,-6
3,12,94,12,10,2
3,12,95,27,15,12
3,12,96,19,12,7
3,12,97,13,13,0
3,12,98,16,2,14
3,12,99,9,12,-3
3,12,100,7,3,4
3,12,101,21,12,9
3,12,102,15,7,8
3,12,103,16,10,6
3,12,104,15,1,14
3,12,105,8,13,-5
3,12,106,11,14,-3
3,12,107,21,24,-3
3,12,108,16,19,-3
3,12,109,16,17,-1
3,12,110,13,11,2
3,12,111,11,9,2
3,12,112,13,6,7
3,12,113,7,4,3
3,12,114,13,11,2
3,12,115,7,5,2
3,12,116,20,13,7
3,12,117,10,8,2
3,12,118,6,9,-3
3,12,119,15,13,2
3,12,120,23,12,11
3,12,121,17,12,5
3,12,122,12,9,3
3,12,123,10,5,5
3,12,124,16,3,13
3,12,125,14,21,-7
3,12,126,20,20,0
3,12,127,19,6,13
3,12,128,15,5,10
3,12,129,13,6,7
3,12,130,12,9,3
3,12,131,9,10,-1
3,12,132,16,12,4
3,12,133,26,25,1
3,12,134,10,12,-2
3,12,135,8,13,-5
3,12,136,25,11,14
3,12,137,17,18,-1
3,12,138,11,13,-2
3,12,139,12,22,-10
3,12,140,13,25,-12
3,12,141,22,12,10
3,12,142,4,4,0
3,12,143,10,1,9
3,12,144,9,3,6
3,12,145,12,18,-6
3,12,146,12,14,-2
3,12,147,18,8,10
3,12,148,29,7,22
3,12,149,14,14,0
3,12,150,9,9,0
3,12,151,22,21,1
3,12,152,22,14,8
3,12,153,18,17,1
3,12,154,9,7,2
3,12,155,8,9,-1
3,12,156,17,12,5
3,12,157,10,6,4
3,12,158,6,7,-1
3,12,159,17,6,11
3,12,160,24,14,10
3,12,161,13,3,10
3,12,162,30,25,5
3,12,163,19,12,7
3,12,164,5,7,-2
3,12,165,9,4,5
3,12,166,24,7,17
3,12,167,28,12,16
3,12,168,19,14,5
3,12,169,21,15,6
3,12,170,14,12,2
3,12,171,12,3,9
3,12,172,11,5,6
3,12,173,16,16,0
3,12,174,29,12,17
3,12,175,14,10,4
3,12,176,16,11,5
3,12,177,6,11,-5
3,12,178,6,4,2
3,12,179,5,4,1
3,12,180,6,3,3
3,12,181,23,19,4
3,12,182,9,7,2
3,12,183,23,35,-12
3,12,184,28,16,12
3,12,185,8,5,3
3,12,186,17,6,11
3,12,187,13,8,5
3,12,188,13,4,9
3,12,189,6,6,0
3,12,190,18,18,0
3,12,191,7,8,-1
3,12,192,15,10,5
3,12,193,13,5,8
3,12,194,14,11,3
3,12,195,34,13,21
3,12,196,19,11,8
3,12,197,9,11,-2
3,12,198,19,16,3
3,12,199,9,18,-9
3,12,200,14,19,-5
3,12,201,14,16,-2
3,12,202,17,16,1
3,12,203,14,17,-3
3,12,204,21,9,12
3,12,205,17,5,12
3,12,206,28,10,18
3,12,207,28,24,4
3,12,208,7,7,0
3,12,209,19,18,1
3,12,210,5,7,-2
3,12,211,8,13,-5
3,12,212,13,8,5
3,12,213,16,6,10
3,12,214,17,5,12
3,12,215,17,11,6
3,12,216,16,27,-11
3,12,217,8,21,-13
3,12,218,15,13,2
3,12,219,27,26,1
3,12,220,3,1,2
3,12,221,8,11,-3
3,12,222,15,13,2
3,12,223,13,11,2
3,12,224,13,4,9
3,12,225,21,15,6
3,12,226,8,16,-8
3,12,227,10,13,-3
3,12,228,23,15,8
3,12,229,16,16,0
3,12,230,22,1,21
3,12,231,21,20,1
3,12,232,16,14,2
3,12,233,9,8,1
3,12,234,11,11,0
3,12,235,13,7,6
3,12,236,10,14,-4
3,12,237,16,7,9
3,12,238,16,11,5
3,12,239,9,8,1
3,12,240,12,8,4
3,12,241,5,7,-2
3,12,242,19,17,2
3,12,243,29,19,10
3,12,244,13,24,-11
3,12,245,13,5,8
3,12,246,23,11,12
3,12,247,11,7,4
3,12,248,28,24,4
3,12,249,23,13,10
3,12,250,13,7,6
3,12,251,21,7,14
3,12,252,7,6,1
3,12,253,17,11,6
3,12,254,11,4,7
3,12,255,11,13,-2
3,12,256,21,23,-2
3,12,257,31,12,19
3,12,258,40,18,22
3,12,259,11,12,-1
3,12,260,13,7,6
3,12,261,25,12,13
3,12,262,10,22,-12
3,12,263,23,22,1
3,12,264,12,10,2
3,12,265,15,12,3
3,12,266,13,7,6
3,12,267,15,11,4
3,12,268,12,14,-2
3,12,269,25,12,13
3,12,270,15,6,9
3,12,271,14,11,3
3,12,272,19,4,15
3,12,273,16,10,6
3,12,274,18,13,5
3,12,275,28,13,15
3,12,276,12,7,5
3,12,277,12,10,2
3,12,278,20,14,6
3,12,279,16,24,-8
3,12,280,16,20,-4
3,12,281,10,2,8
3,12,282,13,16,-3
3,12,283,25,20,5
3,12,284,9,6,3
3,12,285,7,7,0
3,12,286,19,11,8
3,12,287,14,4,10
3,12,288,16,7,9
3,12,289,10,11,-1
3,12,290,20,14,6
3,12,291,9,14,-5
3,12,292,14,8,6
3,12,293,15,9,6
3,12,294,12,13,-1
3,12,295,19,16,3
3,12,296,32,12,20
3,12,297,5,1,4
3,12,298,10,10,0
3,12,299,17,2,15
3,13,0,13,14,-1
3,13,1,11,13,-2
3,13,2,8,9,-1
3,13,3,19,8,11
3,13,4,4,7,-3
3,13,5,8,8,0
3,13,6,15,3,12
3,13,7,20,6,14
3,13,8,13,9,4
3,13,9,11,14,-3
3,13,10,11,9,2
3,13,11,14,3,11
3,13,12,18,12,6
3,13,13,18,15,3
3,13,14,11,12,-1
3,13,15,12,9,3
3,13,16,9,4,5
3,13,17,28,28,0
3,13,18,8,5,3
3,13,19,20,3,17
3,13,20,13,16,-3
3,13,21,15,23,-8
3,13,22,10,6,4
3,13,23,18,26,-8
3,13,24,13,5,8
3,13,25,13,10,3
3,13,26,21,23,-2
3,13,27,30,18,12
3,13,28,16,16,0
3,13,29,12,13,-1
3,13,30,8,20,-12
3,13,31,15,15,0
3,13,32,8,8,0
3,13,33,14,15,-1
3,13,34,13,16,-3
3,13,35,15,9,6
3,13,36,12,12,0
3,13,37,23,19,4
3,13,38,19,22,-3
3,13,39,12,12,0
3,13,40,4,5,-1
3,13,41,10,10,0
3,13,42,19,21,-2
3,13,43,10,8,2
3,13,44,19,28,-9
3,13,45,12,11,1
3,13,46,6,13,-7
3,13,47,18,14,4
3,13,48,5,6,-1
3,13,49,18,13,5
3,13,50,27,16,11
3,13,51,9,6,3
3,13,52,7,16,-9
3,13,53,13,8,5
3,13,54,17,8,9
3,13,55,7,9,-2
3,13,56,22,14,8
3,13,57,33,16,17
3,13,58,17,12,5
3,13,59,13,13,0
3,13,60,9,13,-4
3,13,61,19,15,4
3,13,62,9,13,-4
3,13,63,10,8,2
3,13,64,9,2,7
3,13,65,13,14,-1
3,13,66,26,17,9
3,13,67,26,12,14
3,13,68,12,14,-2
3,13,69,14,9,5
3,13,70,15,13,2
3,13,71,15,20,-5
3,13,72,13,12,1
3,13,73,5,9,-4
3,13,74,17,12,5
3,13,75,13,16,-3
3,13,76,10,9,1
3,13,77,15,14,1
3,13,78,3,8,-5
3,13,79,12,7,5
3,13,80,19,28,-9
3,13,81,19,12,7
3,13,82,3,11,-8
3,13,83,18,15,3
3,13,84,18,14,4
3,13,85,10,6,4
3,13,86,8,24,-16
3,13,87,13,7,6
3,13,88,21,10,11
3,13,89,8,10,-2
3,13,90,28,14,14
3,13,91,13,9,4
3,13,92,16,9,7
3,13,93,15,12,3
3,13,94,27,22,5
3,13,95,10,16,-6
3,13,96,10,3,7
3,13,97,16,14,2
3,13,98,15,9,6
3,13,99,11,3,8
3,13,100,9,4,5
3,13,101,16,8,8
3,13,102,20,15,5
3,13,103,23,5,18
3,13,104,10,2,8
3,13,105,9,5,4
3,13,106,17,5,12
3,13,107,11,13,-2
3,13,108,5,6,-1
3,13,109,23,21,2
3,13,110,20,8,12
3,13,111,27,16,11
3,13,112,10,7,3
3,13,113,19,8,11
3,13,114,18,10,8
3,13,115,17,14,3
3,13,116,10,14,-4
3,13,117,12,11,1
3,13,118,15,7,8
3,13,119,19,17,2
3,13,120,17,23,-6
3,13,121,15,17,-2
3,13,122,7,12,-5
3,13,123,5,8,-3
3,13,124,27,26,1
3,13,125,27,18,9
3,13,126,9,5,4
3,13,127,10,13,-3
3,13,128,18,27,-9
3,13,129,19,18,1
3,13,130,14,10,4
3,13,131,14,18,-4
3,13,132,16,16,0
3,13,133,16,5,11
3,13,134,33,24,9
3,13,135,19,15,4
3,13,136,6,13,-7
3,13,137,23,15,8
3,13,138,15,13,2
3,13,139,29,17,12
3,13,140,13,19,-6
3,13,141,13,16,-3
3,13,142,13,16,-3
3,13,143,14,15,-1
3,13,144,11,25,-14
3,13,145,18,7,11
3,13,146,21,12,9
3,13,147,28,14,14
3,13,148,12,13,-1
3,13,149,18,15,3
3,13,150,15,12,3
3,13,151,14,20,-6
3,13,152,12,9,3
3,13,153,20,9,11
3,13,154,9,9,0
3,13,155,32,21,11
3,13,156,18,9,9
3,13,157,16,12,4
3,13,158,12,9,3
3,13,159,11,16,-5
3,13,160,17,11,6
3,13,161,20,17,3
3,13,162,9,12,-3
3,13,163,20,14,6
3,13,164,10,9,1
3,13,165,18,6,12
3,13,166,13,13,0
3,13,167,12,13,-1
3,13,168,16,14,2
3,13,169,13,12,1
3,13,170,18,21,-3
3,13,171,18,8,10
3,13,172,10,7,3
3,13,173,15,6,9
3,13,174,5,9,-4
3,13,175,25,8,17
3,13,176,15,6,9
3,13,177,16,12,4
3,13,178,13,13,0
3,13,179,7,4,3
3,13,180,24,14,10
3,13,181,9,4,5
3,13,182,32,15,17
3,13,183,8,3,5
3,13,184,15,14,1
3,13,185,19,9,10
3,13,186,20,14,6
3,13,187,15,10,5
3,13,188,11,4,7
3,13,189,27,11,16
3,13,190,27,12,15
3,13,191,10,10,0
3,13,192,22,16,6
3,13,193,11,4,7
3,13,194,12,10,2
3,13,195,31,17,14
3,13,196,16,18,-2
3,13,197,15,10,5
3,13,198,9,8,1
3,13,199,23,14,9
3,13,200,16,14,2
3,13,201,16,8,8
3,13,202,20,6,14
3,13,203,13,9,4
3,13,204,16,5,11
3,13,205,24,11,13
3,13,206,19,17,2
3,13,207,14,16,-2
3,13,208,18,5,13
3,13,209,13,12,1
3,13,210,13,6,7
3,13,211,17,11,6
3,13,212,19,17,2
3,13,213,17,6,11
3,13,214,7,8,-1
3,13,215,11,5,6
3,13,216,18,8,10
3,13,217,16,10,6
3,13,218,20,12,8
3,13,219,18,13,5
3,13,220,11,7,4
3,13,221,10,14,-4
3,13,222,8,8,0
3,13,223,22,7,15
3,13,224,8,8,0
3,13,225,13,17,-4
3,13,226,12,10,2
3,13,227,16,9,7
3,13,228,22,12,10
3,13,229,14,7,7
3,13,230,10,13,-3
3,13,231,15,13,2
3,13,232,22,16,6
3,13,233,32,19,13
3,13,234,15,18,-3
3,13,235,10,17,-7
3,13,236,10,8,2
3,13,237,11,3,8
3,13,238,11,7,4
3,13,239,8,8,0
3,13,240,19,15,4
3,13,241,14,25,-11
3,13,242,21,12,9
3,13,243,25,3,22
3,13,244,17,13,4
3,13,245,16,23,-7
3,13,246,16,9,7
3,13,247,27,19,8
3,13,248,13,12,1
3,13,249,9,0,9
3,13,250,7,3,4
3,13,251,18,14,4
3,13,252,6,12,-6
3,13,253,14,13,1
3,13,254,15,6,9
3,13,255,22,17,5
3,13,256,23,10,13
3,13,257,4,11,-7
3,13,258,17,11,6
3,13,259,9,9,0
3,13,260,13,4,9
3,13,261,14,13,1
3,13,262,3,11,-8
3,13,263,8,22,-14
3,13,264,17,5,12
3,13,265,11,7,4
3,13,266,25,12,13
3,13,267,19,12,7
3,13,268,8,7,1
3,13,269,27,14,13
3,13,270,23,14,9
3,13,271,15,4,11
3,13,272,15,8,7
3,13,273,6,6,0
3,13,274,13,8,5
3,13,275,20,7,13
3,13,276,7,13,-6
3,13,277,19,13,6
3,13,278,24,11,13
3,13,279,8,12,-4
3,13,280,12,4,8
3,13,281,14,10,4
3,13,282,18,11,7
3,13,283,15,11,4
3,13,284,10,5,5
3,13,285,10,16,-6
3,13,286,13,9,4
3,13,287,10,4,6
3,13,288,9,19,-10
3,13,289,12,5,7
3,13,290,18,13,5
3,13,291,28,13,15
3,13,292,19,12,7
3,13,293,18,10,8
3,13,294,13,7,6
3,13,295,16,12,4
3,13,296,16,15,1
3,13,297,10,5,5
3,13,298,21,10,11
3,13,299,19,14,5
3,14,0,15,10,5
3,14,1,7,16,-9
3,14,2,15,17,-2
3,14,3,8,8,0
3,14,4,18,10,8
3,14,5,16,11,5
3,14,6,16,20,-4
3,14,7,10,8,2
3,14,8,15,13,2
3,14,9,9,23,-14
3,14,10,9,13,-4
3,14,11,16,11,5
3,14,12,11,11,0
3,14,13,11,13,-2
3,14,14,13,6,7
3,14,15,16,9,7
3,14,16,28,17,11
3,14,17,16,6,10
3,14,18,19,10,9
3,14,19,41,7,34
3,14,20,8,13,-5
3,14,21,9,3,6
3,14,22,16,13,3
3,14,23,10,17,-7
3,14,24,17,12,5
3,14,25,14,6,8
3,14,26,18,7,11
3,14,27,10,12,-2
3,14,28,10,17,-7
3,14,29,18,18,0
3,14,30,23,12,11
3,14,31,4,10,-6
3,14,32,14,18,-4
3,14,33,15,6,9
3,14,34,29,13,16
3,14,35,20,15,5
3,14,36,18,12,6
3,14,37,14,9,5
3,14,38,22,7,15
3,14,39,14,13,1
3,14,40,19,6,13
3,14,41,6,7,-1
3,14,42,10,13,-3
3,14,43,11,9,2
3,14,44,15,12,3
3,14,45,18,10,8
3,14,46,30,15,15
3,14,47,16,11,5
3,14,48,20,12,8
3,14,49,9,6,3
3,14,50,18,10,8
3,14,51,32,12,20
3,14,52,15,9,6
3,14,53,11,9,2
3,14,54,18,11,7
3,14,55,15,5,10
3,14,56,25,17,8
3,14,57,25,21,4
3,14,58,19,9,10
3,14,59,30,16,14
3,14,60,9,8,1
3,14,61,14,12,2
3,14,62,12,15,-3
3,14,63,22,13,9
3,14,64,11,11,0
3,14,65,17,19,-2
3,14,66,11,6,5
3,14,67,23,11,12
3,14,68,23,7,16
3,14,69,7,11,-4
3,14,70,23,17,6
3,14,71,8,5,3
3,14,72,11,10,1
3,14,73,14,9,5
3,14,74,19,13,6
3,14,75,13,3,10
3,14,76,19,14,5
3,14,77,28,9,19
3,14,78,31,13,18
3,14,79,14,2,12
3,14,80,25,7,18
3,14,81,15,7,8
3,14,82,9,14,-5
3,14,83,24,10,14
3,14,84,15,8,7
3,14,85,14,16,-2
3,14,86,17,14,3
3,14,87,18,19,-1
3,14,88,29,6,23
3,14,89,22,10,12
3,14,90,19,9,10
3,14,91,7,12,-5
3,14,92,10,11,-1
3,14,93,24,5,19
3,14,94,15,12,3
3,14,95,16,5,11
3,14,96,16,14,2
3,14,97,15,15,0
3,14,98,13,6,7
3,14,99,14,10,4
3,14,100,11,13,-2
3,14,101,20,12,8
3,14,102,14,13,1
3,14,103,14,12,2
3,14,104,17,14,3
3,14,105,11,4,7
3,14,106,12,16,-4
3,14,107,14,16,-2
3,14,108,12,11,1
3,14,109,13,12,1
3,14,110,22,14,8
3,14,111,16,11,5
3,14,112,18,7,11
3,14,113,15,11,4
3,14,114,8,9,-1
3,14,115,28,17,11
3,14,116,9,2,7
3,14,117,29,4,25
3,14,118,12,7,5
3,14,119,11,8,3
3,14,120,15,12,3
3,14,121,5,14,-9
3,14,122,21,15,6
3,14,123,17,11,6
3,14,124,11,7,4
3,14,125,17,7,10
3,14,126,16,17,-1
3,14,127,21,7,14
3,14,128,24,18,6
3,14,129,9,10,-1
3,14,130,14,9,5
3,14,131,26,23,3
3,14,132,13,11,2
3,14,133,18,16,2
3,14,134,8,10,-2
3,14,135,13,1,12
3,14,136,24,18,6
3,14,137,14,12,2
3,14,138,16,10,6
3,14,139,10,6,4
3,14,140,12,12,0
3,14,141,29,9,20
3,14,142,15,7,8
3,14,143,20,20,0
3,14,144,18,9,9
3,14,145,18,10,8
3,14,146,20,16,4
3,14,147,21,14,7
3,14,148,9,24,-15
3,14,149,10,8,2
3,14,150,15,9,6
3,14,151,16,9,7
3,14,152,16,15,1
3,14,153,22,20,2
3,14,154,8,6,2
3,14,155,4,12,-8
3,14,156,11,2,9
3,14,157,9,12,-3
3,14,158,28,12,16
3,14,159,21,24,-3
3,14,160,20,13,7
3,14,161,12,13,-1
3,14,162,14,11,3
3,14,163,15,4,11
3,14,164,22,6,16
3,14,165,12,4,8
3,14,166,32,16,16
3,14,167,32,12,20
3,14,168,18,18,0
3,14,169,8,9,-1
3,14,170,16,6,10
3,14,171,17,7,10
3,14,172,19,5,14
3,14,173,2,11,-9
3,14,174,10,5,5
3,14,175,10,8,2
3,14,176,10,12,-2
3,14,177,13,5,8
3,14,178,8,4,4
3,14,179,21,14,7
3,14,180,14,9,5
3,14,181,13,4,9
3,14,182,23,18,5
3,14,183,35,18,17
3,14,184,10,11,-1
3,14,185,18,9,9
3,14,186,11,14,-3
3,14,187,7,7,0
3,14,188,33,15,18
3,14,189,9,19,-10
3,14,190,19,23,-4
3,14,191,8,6,2
3,14,192,8,1,7
3,14,193,16,13,3
3,14,194,18,11,7
3,14,195,9,15,-6
3,14,196,22,8,14
3,14,197,26,14,12
3,14,198,18,13,5
3,14,199,21,15,6
3,14,200,20,13,7
3,14,201,18,16,2
3,14,202,11,17,-6
3,14,203,6,5,1
3,14,204,17,14,3
3,14,205,11,1,10
3,14,206,9,12,-3
3,14,207,14,5,9
3,14,208,10,7,3
3,14,209,15,3,12
3,14,210,12,17,-5
3,14,211,11,6,5
3,14,212,27,12,15
3,14,213,11,9,2
3,14,214,19,6,13
3,14,215,5,5,0
3,14,216,28,19,9
3,14,217,19,13,6
3,14,218,12,10,2
3,14,219,21,6,15
3,14,220,15,4,11
3,14,221,16,9,7
3,14,222,17,3,14
3,14,223,23,15,8
3,14,224,24,12,12
3,14,225,14,6,8
3,14,226,19,10,9
3,14,227,11,11,0
3,14,228,22,17,5
3,14,229,11,17,-6
3,14,230,12,11,1
3,14,231,14,10,4
3,14,232,7,4,3
3,14,233,5,8,-3
3,14,234,10,11,-1
3,14,235,12,8,4
3,14,236,14,14,0
3,14,237,12,13,-1
3,14,238,9,12,-3
3,14,239,10,14,-4
3,14,240,14,16,-2
3,14,241,19,30,-11
3,14,242,14,9,5
3,14,243,14,12,2
3,14,244,29,9,20
3,14,245,18,11,7
3,14,246,17,9,8
3,14,247,13,17,-4
3,14,248,25,7,18
3,14,249,9,14,-5
3,14,250,24,25,-1
3,14,251,16,20,-4
3,14,252,22,14,8
3,14,253,9,7,2
3,14,254,13,17,-4
3,14,255,14,5,9
3,14,256,19,16,3
3,14,257,15,9,6
3,14,258,12,8,4
3,14,259,16,16,0
3,14,260,6,2,4
3,14,261,17,25,-8
3,14,262,21,15,6
3,14,263,15,14,1
3,14,264,13,8,5
3,14,265,17,16,1
3,14,266,12,14,-2
3,14,267,15,5,10
3,14,268,18,10,8
3,14,269,14,8,6
3,14,270,5,4,1
3,14,271,12,9,3
3,14,272,21,10,11
3,14,273,26,14,12
3,14,274,20,8,12
3,14,275,16,4,12
3,14,276,21,6,15
3,14,277,16,18,-2
3,14,278,23,20,3
3,14,279,12,7,5
3,14,280,25,5,20
3,14,281,8,5,3
3,14,282,18,16,2
3,14,283,25,24,1
3,14,284,27,18,9
3,14,285,17,9,8
3,14,286,12,15,-3
3,14,287,3,8,-5
3,14,288,12,8,4
3,14,289,26,10,16
3,14,290,19,6,13
3,14,291,16,7,9
3,14,292,11,12,-1
3,14,293,24,5,19
3,14,294,6,6,0
3,14,295,26,11,15
3,14,296,19,7,12
3,14,297,20,13,7
3,14,298,9,16,-7
3,14,299,17,9,8
3,15,0,18,8,10
3,15,1,22,15,7
3,15,2,11,11,0
3,15,3,20,7,13
3,15,4,18,12,6
3,15,5,22,17,5
3,15,6,10,7,3
3,15,7,19,9,10
3,15,8,14,13,1
3,15,9,13,12,1
3,15,10,10,13,-3
3,15,11,14,7,7
3,15,12,13,10,3
3,15,13,23,2,21
3,15,14,6,7,-1
3,15,15,25,15,10
3,15,16,13,23,-10
3,15,17,27,9,18
3,15,18,14,9,5
3,15,19,8,13,-5
3,15,20,11,7,4
3,15,21,12,14,-2
3,15,22,15,17,-2
3,15,23,14,7,7
3,15,24,20,18,2
3,15,25,3,4,-1
3,15,26,22,5,17
3,15,27,14,10,4
3,15,28,13,6,7
3,15,29,28,7,21
3,15,30,18,12,6
3,15,31,27,13,14
3,15,32,23,25,-2
3,15,33,17,6,11
3,15,34,11,14,-3
3,15,35,30,6,24
3,15,36,7,4,3
3,15,37,15,19,-4
3,15,38,14,12,2
3,15,39,15,4,11
3,15,40,14,12,2
3,15,41,19,25,-6
3,15,42,10,14,-4
3,15,43,35,16,19
3,15,44,16,25,-9
3,15,45,11,10,1
3,15,46,25,18,7
3,15,47,25,11,14
3,15,48,16,14,2
3,15,49,25,14,11
3,15,50,19,5,14
3,15,51,12,4,8
3,15,52,18,21,-3
3,15,53,11,8,3
3,15,54,20,9,11
3,15,55,18,8,10
3,15,56,13,13,0
3,15,57,6,7,-1
3,15,58,23,26,-3
3,15,59,17,13,4
3,15,60,24,13,11
3,15,61,17,14,3
3,15,62,15,10,5
3,15,63,12,10,2
3,15,64,14,15,-1
3,15,65,11,7,4
3,15,66,24,9,15
3,15,67,19,16,3
3,15,68,15,6,9
3,15,69,18,15,3
3,15,70,16,10,6
3,15,71,12,12,0
3,15,72,18,9,9
3,15,73,17,15,2
3,15,74,20,9,11
3,15,75,30,13,17
3,15,76,25,10,15
3,15,77,11,15,-4
3,15,78,21,9,12
3,15,79,15,17,-2
3,15,80,16,10,6
3,15,81,24,13,11
3,15,82,16,9,7
3,15,83,18,5,13
3,15,84,33,11,22
3,15,85,24,12,12
3,15,86,9,9,0
3,15,87,18,16,2
3,15,88,22,12,10
3,15,89,16,14,2
3,15,90,13,10,3
3,15,91,14,13,1
3,15,92,7,12,-5
3,15,93,17,12,5
3,15,94,8,11,-3
3,15,95,14,11,3
3,15,96,4,4,0
3,15,97,9,9,0
3,15,98,18,23,-5
3,15,99,19,15,4
3,15,100,14,17,-3
3,15,101,12,15,-3
3,15,102,9,11,-2
3,15,103,21,13,8
3,15,104,24,10,14
3,15,105,16,7,9
3,15,106,20,15,5
3,15,107,7,10,-3
3,15,108,9,15,-6
3,15,109,14,12,2
3,15,110,28,7,21
3,15,111,23,8,15
3,15,112,14,14,0
3,15,113,28,13,15
3,15,114,15,16,-1
3,15,115,11,15,-4
3,15,116,15,11,4
3,15,117,9,7,2
3,15,118,9,6,3
3,15,119,22,14,8
3,15,120,11,6,5
3,15,121,17,6,11
3,15,122,15,5,10
3,15,123,12,10,2
3,15,124,17,6,11
3,15,125,18,15,3
3,15,126,11,7,4
3,15,127,11,8,3
3,15,128,17,26,-9
3,15,129,25,10,15
3,15,130,19,6,13
3,15,131,8,13,-5
3,15,132,13,14,-1
3,15,133,7,11,-4
3,15,134,18,2,16
3,15,135,12,11,1
3,15,136,8,4,4
3,15,137,29,15,14
3,15,138,13,6,7
3,15,139,23,9,14
3,15,140,7,11,-4
3,15,141,17,6,11
3,15,142,21,5,16
3,15,143,13,20,-7
3,15,144,4,0,4
3,15,145,8,6,2
3,15,146,10,20,-10
3,15,147,14,9,5
3,15,148,10,9,1
3,15,149,20,14,6
3,15,150,23,12,11
3,15,151,23,7,16
3,15,152,18,16,2
3,15,153,14,14,0
3,15,154,11,12,-1
3,15,155,20,20,0
3,15,156,33,9,24
3,15,157,7,6,1
3,15,158,10,10,0
3,15,159,17,9,8
3,15,160,18,7,11
3,15,161,29,19,10
3,15,162,23,17,6
3,15,163,14,23,-9
3,15,164,15,14,1
3,15,165,13,14,-1
3,15,166,21,12,9
3,15,167,21,4,17
3,15,168,10,8,2
3,15,169,22,12,10
3,15,170,15,6,9
3,15,171,19,13,6
3,15,172,15,11,4
3,15,173,20,13,7
3,15,174,15,9,6
3,15,175,11,6,5
3,15,176,23,10,13
3,15,177,24,8,16
3,15,178,29,13,16
3,15,179,10,12,-2
3,15,180,13,14,-1
3,15,181,18,19,-1
3,15,182,14,13,1
3,15,183,14,5,9
3,15,184,15,13,2
3,15,185,10,13,-3
3,15,186,21,19,2
3,15,187,12,17,-5
3,15,188,12,5,7
3,15,189,19,19,0
3,15,190,20,8,12
3,15,191,22,20,2
3,15,192,17,11,6
3,15,193,8,11,-3
3,15,194,24,12,12
3,15,195,23,14,9
3,15,196,27,16,11
3,15,197,20,8,12
3,15,198,10,7,3
3,15,199,13,7,6
3,15,200,20,11,9
3,15,201,31,18,13
3,15,202,30,9,21
3,15,203,31,16,15
3,15,204,13,16,-3
3,15,205,8,7,1
3,15,206,13,10,3
3,15,207,20,9,11
3,15,208,9,8,1
3,15,209,19,11,8
3,15,210,15,14,1
3,15,211,19,12,7
3,15,212,33,11,22
3,15,213,12,5,7
3,15,214,9,7,2
3,15,215,8,12,-4
3,15,216,21,15,6
3,15,217,19,9,10
3,15,218,8,6,2
3,15,219,15,11,4
3,15,220,19,8,11
3,15,221,16,11,5
3,15,222,11,16,-5
3,15,223,10,13,-3
3,15,224,9,10,-1
3,15,225,10,11,-1
3,15,226,13,7,6
3,15,227,6,6,0
3,15,228,16,9,7
3,15,229,14,10,4
3,15,230,13,4,9
3,15,231,4,12,-8
3,15,232,8,3,5
3,15,233,18,5,13
3,15,234,11,20,-9
3,15,235,15,10,5
3,15,236,18,10,8
3,15,237,17,5,12
3,15,238,18,13,5
3,15,239,23,5,18
3,15,240,23,19,4
3,15,241,23,20,3
3,15,242,6,1,5
3,15,243,9,11,-2
3,15,244,12,14,-2
3,15,245,8,15,-7
3,15,246,15,13,2
3,15,247,6,13,-7
3,15,248,25,23,2
3,15,249,22,12,10
3,15,250,25,14,11
3,15,251,22,12,10
3,15,252,16,15,1
3,15,253,15,34,-19
3,15,254,13,12,1
3,15,255,19,16,3
3,15,256,11,21,-10
3,15,257,15,8,7
3,15,258,11,11,0
3,15,259,34,21,13
3,15,260,20,7,13
3,15,261,22,24,-2
3,15,262,23,17,6
3,15,263,18,21,-3
3,15,264,2,10,-8
3,15,265,22,18,4
3,15,266,10,5,5
3,15,267,15,5,10
3,15,268,28,16,12
3,15,269,31,9,22
3,15,270,13,1,12
3,15,271,19,16,3
3,15,272,27,15,12
3,15,273,0,6,-6
3,15,274,20,15,5
3,15,275,23,5,18
3,15,276,14,8,6
3,15,277,19,16,3
3,15,278,11,4,7
3,15,279,14,17,-3
3,15,280,18,8,10
3,15,281,15,12,3
3,15,282,15,19,-4
3,15,283,23,20,3
3,15,284,10,10,0
3,15,285,20,23,-3
3,15,286,13,10,3
3,15,287,19,8,11
3,15,288,17,6,11
3,15,289,29,13,16
3,15,290,6,14,-8
3,15,291,18,8,10
3,15,292,25,15,10
3,15,293,18,13,5
3,15,294,18,15,3
3,15,295,17,11,6
3,15,296,15,4,11
3,15,297,22,22,0
3,15,298,8,18,-10
3,15,299,2,3,-1
3,16,0,19,16,3
3,16,1,4,6,-2
3,16,2,15,11,4
3,16,3,15,8,7
3,16,4,14,7,7
3,16,5,21,11,10
3,16,6,16,19,-3
3,16,7,21,13,8
3,16,8,20,12,8
3,16,9,18,11,7
3,16,10,26,4,22
3,16,11,24,7,17
3,16,12,23,6,17
3,16,13,18,4,14
3,16,14,24,6,18
3,16,15,15,12,3
3,16,16,12,15,-3
3,16,17,11,7,4
3,16,18,25,12,13
3,16,19,4,17,-13
3,16,20,17,9,8
3,16,21,29,14,15
3,16,22,11,9,2
3,16,23,19,7,12
3,16,24,14,9,5
3,16,25,20,10,10
3,16,26,19,11,8
3,16,27,20,12,8
3,16,28,11,9,2
3,16,29,12,4,8
3,16,30,12,22,-10
3,16,31,11,6,5
3,16,32,15,7,8
3,16,33,16,19,-3
3,16,34,16,7,9
3,16,35,5,12,-7
3,16,36,12,10,2
3,16,37,17,17,0
3,16,38,22,12,10
3,16,39,8,1,7
3,16,40,12,15,-3
3,16,41,14,13,1
3,16,42,9,13,-4
3,16,43,16,5,11
3,16,44,20,8,12
3,16,45,8,3,5
3,16,46,13,16,-3
3,16,47,9,3,6
3,16,48,20,9,11
3,16,49,9,10,-1
3,16,50,14,8,6
3,16,51,26,11,15
3,16,52,12,3,9
3,16,53,16,12,4
3,16,54,21,10,11
3,16,55,17,10,7
3,16,56,16,8,8
3,16,57,9,10,-1
3,16,58,12,9,3
3,16,59,15,13,2
3,16,60,23,10,13
3,16,61,19,7,12
3,16,62,16,19,-3
3,16,63,13,5,8
3,16,64,12,22,-10
3,16,65,23,19,4
3,16,66,12,7,5
3,16,67,8,7,1
3,16,68,3,5,-2
3,16,69,13,13,0
3,16,70,21,14,7
3,16,71,17,14,3
3,16,72,13,12,1
3,16,73,17,12,5
3,16,74,17,13,4
3,16,75,18,7,11
3,16,76,17,14,3
3,16,77,27,4,23
3,16,78,22,6,16
3,16,79,8,9,-1
3,16,80,9,8,1
3,16,81,24,15,9
3,16,82,18,10,8
3,16,83,8,17,-9
3,16,84,32,10,22
3,16,85,14,7,7
3,16,86,18,12,6
3,16,87,16,11,5
3,16,88,16,12,4
3,16,89,10,5,5
3,16,90,44,15,29
3,16,91,16,5,11
3,16,92,16,12,4
3,16,93,27,15,12
3,16,94,6,9,-3
3,16,95,17,11,6
3,16,96,27,10,17
3,16,97,34,14,20
3,16,98,16,10,6
3,16,99,20,11,9
3,16,100,21,14,7
3,16,101,24,16,8
3,16,102,20,7,13
3,16,103,12,7,5
3,16,104,9,10,-1
3,16,105,21,12,9
3,16,106,19,17,2
3,16,107,9,6,3
3,16,108,26,4,22
3,16,109,24,9,15
3,16,110,9,17,-8
3,16,111,17,8,9
3,16,112,10,9,1
3,16,113,15,15,0
3,16,114,35,5,30
3,16,115,14,9,5
3,16,116,15,9,6
3,16,117,15,9,6
3,16,118,12,9,3
3,16,119,17,13,4
3,16,120,25,7,18
3,16,121,15,19,-4
3,16,122,9,8,1
3,16,123,17,8,9
3,16,124,26,14,12
3,16,125,3,5,-2
3,16,126,16,6,10
3,16,127,5,6,-1
3,16,128,18,10,8
3,16,129,3,9,-6
3,16,130,18,17,1
3,16,131,20,20,0
3,16,132,40,34,6
3,16,133,26,9,17
3,16,134,11,12,-1
3,16,135,14,10,4
3,16,136,13,5,8
3,16,137,22,10,12
3,16,138,23,18,5
3,16,139,13,23,-10
3,16,140,12,12,0
3,16,141,13,6,7
3,16,142,25,17,8
3,16,143,8,11,-3
3,16,144,12,20,-8
3,16,145,14,8,6
3,16,146,27,13,14
3,16,147,13,10,3
3,16,148,23,9,14
3,16,149,21,13,8
3,16,150,9,4,5
3,16,151,24,10,14
3,16,152,13,9,4
3,16,153,22,15,7
3,16,154,7,6,1
3,16,155,16,18,-2
3,16,156,20,14,6
3,16,157,8,6,2
3,16,158,14,11,3
3,16,159,29,20,9
3,16,160,16,18,-2
3,16,161,5,4,1
3,16,162,9,5,4
3,16,163,10,17,-7
3,16,164,17,13,4
3,16,165,18,10,8
3,16,166,11,8,3
3,16,167,12,9,3
3,16,168,15,14,1
3,16,169,20,3,17
3,16,170,16,15,1
3,16,171,19,10,9
3,16,172,19,16,3
3,16,173,13,7,6
3,16,174,7,20,-13
3,16,175,12,9,3
3,16,176,26,18,8
3,16,177,14,20,-6
3,16,178,20,11,9
3,16,179,28,14,14
3,16,180,13,8,5
3,16,181,18,16,2
3,16,182,13,10,3
3,16,183,5,6,-1
3,16,184,14,13,1
3,16,185,22,18,4
3,16,186,9,1,8
3,16,187,18,12,6
3,16,188,17,6,11
3,16,189,9,17,-8
3,16,190,8,8,0
3,16,191,24,16,8
3,16,192,12,8,4
3,16,193,23,12,11
3,16,194,4,7,-3
3,16,195,11,25,-14
3,16,196,14,8,6
3,16,197,32,7,25
3,16,198,11,4,7
3,16,199,17,8,9
3,16,200,9,5,4
3,16,201,11,6,5
3,16,202,7,7,0
3,16,203,18,10,8
3,16,204,3,4,-1
3,16,205,34,19,15
3,16,206,27,14,13
3,16,207,14,15,-1
3,16,208,30,11,19
3,16,209,17,12,5
3,16,210,22,3,19
3,16,211,28,11,17
3,16,212,12,10,2
3,16,213,17,9,8
3,16,214,19,14,5
3,16,215,16,9,7
3,16,216,15,5,10
3,16,217,11,21,-10
3,16,218,15,15,0
3,16,219,7,5,2
3,16,220,25,20,5
3,16,221,21,5,16
3,16,222,17,6,11
3,16,223,9,12,-3
3,16,224,38,10,28
3,16,225,11,9,2
3,16,226,10,5,5
3,16,227,14,10,4
3,16,228,13,5,8
3,16,229,22,20,2
3,16,230,10,7,3
3,16,231,15,13,2
3,16,232,13,9,4
3,16,233,21,9,12
3,16,234,19,6,13
3,16,235,16,13,3
3,16,236,7,6,1
3,16,237,17,8,9
3,16,238,18,15,3
3,16,239,10,4,6
3,16,240,13,7,6
3,16,241,22,8,14
3,16,242,12,4,8
3,16,243,12,12,0
3,16,244,10,10,0
3,16,245,17,12,5
3,16,246,28,19,9
3,16,247,17,11,6
3,16,248,38,5,33
3,16,249,23,15,8
3,16,250,19,10,9
3,16,251,19,19,0
3,16,252,8,18,-10
3,16,253,12,4,8
3,16,254,15,18,-3
3,16,255,11,5,6
3,16,256,17,5,12
3,16,257,28,20,8
3,16,258,19,13,6
3,16,259,10,11,-1
3,16,260,11,15,-4
3,16,261,19,19,0
3,16,262,22,13,9
3,16,263,11,12,-1
3,16,264,16,10,6
3,16,265,13,4,9
3,16,266,21,16,5
3,16,267,8,10,-2
3,16,268,8,3,5
3,16,269,2,6,-4
3,16,270,17,13,4
3,16,271,18,24,-6
3,16,272,21,12,9
3,16,273,16,6,10
3,16,274,23,10,13
3,16,275,11,9,2
3,16,276,7,6,1
3,16,277,9,12,-3
3,16,278,11,5,6
3,16,279,24,15,9
3,16,280,21,17,4
3,16,281,26,19,7
3,16,282,15,7,8
3,16,283,7,3,4
3,16,284,16,11,5
3,16,285,20,15,5
3,16,286,18,10,8
3,16,287,8,7,1
3,16,288,25,15,10
3,16,289,18,5,13
3,16,290,5,18,-13
3,16,291,6,9,-3
3,16,292,28,11,17
3,16,293,12,3,9
3,16,294,8,6,2
3,16,295,18,18,0
3,16,296,16,17,-1
3,16,297,13,12,1
3,16,298,8,3,5
3,16,299,27,14,13
3,17,0,17,8,9
3,17,1,11,6,5
3,17,2,24,14,10
3,17,3,20,8,12
3,17,4,14,14,0
3,17,5,24,17,7
3,17,6,31,14,17
3,17,7,19,18,1
3,17,8,29,18,11
3,17,9,14,10,4
3,17,10,32,14,18
3,17,11,14,10,4
3,17,12,20,29,-9
3,17,13,11,18,-7
3,17,14,25,8,17
3,17,15,16,11,5
3,17,16,16,8,8
3,17,17,11,11,0
3,17,18,11,21,-10
3,17,19,17,6,11
3,17,20,10,7,3
3,17,21,20,19,1
3,17,22,21,6,15
3,17,23,17,9,8
3,17,24,16,12,4
3,17,25,13,12,1
3,17,26,14,10,4
3,17,27,10,15,-5
3,17,28,8,3,5
3,17,29,18,6,12
3,17,30,18,7,11
3,17,31,30,12,18
3,17,32,19,20,-1
3,17,33,12,9,3
3,17,34,23,16,7
3,17,35,13,16,-3
3,17,36,25,14,11
3,17,37,11,4,7
3,17,38,27,13,14
3,17,39,19,16,3
3,17,40,5,7,-2
3,17,41,30,13,17
3,17,42,15,6,9
3,17,43,20,11,9
3,17,44,31,6,25
3,17,45,15,16,-1
3,17,46,5,13,-8
3,17,47,23,11,12
3,17,48,25,11,14
3,17,49,12,8,4
3,17,50,28,8,20
3,17,51,16,13,3
3,17,52,11,9,2
3,17,53,15,16,-1
3,17,54,17,11,6
3,17,55,20,12,8
3,17,56,10,18,-8
3,17,57,5,10,-5
3,17,58,16,14,2
3,17,59,10,22,-12
3,17,60,15,7,8
3,17,61,16,8,8
3,17,62,16,17,-1
3,17,63,27,15,12
3,17,64,15,14,1
3,17,65,17,18,-1
3,17,66,18,11,7
3,17,67,8,10,-2
3,17,68,10,3,7
3,17,69,22,5,17
3,17,70,13,9,4
3,17,71,20,9,11
3,17,72,12,10,2
3,17,73,28,11,17
3,17,74,23,5,18
3,17,75,7,15,-8
3,17,76,22,7,15
3,17,77,19,9,10
3,17,78,16,6,10
3,17,79,16,10,6
3,17,80,18,11,7
3,17,81,22,14,8
3,17,82,28,7,21
3,17,83,26,7,19
3,17,84,8,9,-1
3,17,85,32,14,18
3,17,86,13,13,0
3,17,87,15,13,2
3,17,88,14,7,7
3,17,89,10,6,4
3,17,90,15,9,6
3,17,91,11,6,5
3,17,92,9,2,7
3,17,93,28,13,15
3,17,94,19,9,10
3,17,95,25,11,14
3,17,96,16,4,12
3,17,97,21,21,0
3,17,98,20,6,14
3,17,99,14,12,2
3,17,100,13,9,4
3,17,101,16,15,1
3,17,102,17,7,10
3,17,103,22,7,15
3,17,104,11,4,7
3,17,105,12,16,-4
3,17,106,16,13,3
3,17,107,17,11,6
3,17,108,20,10,10
3,17,109,11,13,-2
3,17,110,15,3,12
3,17,111,17,5,12
3,17,112,20,9,11
3,17,113,13,4,9
3,17,114,17,9,8
3,17,115,14,10,4
3,17,116,14,11,3
3,17,117,22,9,13
3,17,118,16,9,7
3,17,119,31,15,16
3,17,120,21,5,16
3,17,121,19,15,4
3,17,122,24,16,8
3,17,123,17,6,11
3,17,124,15,14,1
3,17,125,23,17,6
3,17,126,13,8,5
3,17,127,8,10,-2
3,17,128,5,10,-5
3,17,129,20,12,8
3,17,130,30,6,24
3,17,131,8,7,1
3,17,132,18,20,-2
3,17,133,11,10,1
3,17,134,8,4,4
3,17,135,14,5,9
3,17,136,12,11,1
3,17,137,21,10,11
3,17,138,14,19,-5
3,17,139,17,17,0
3,17,140,25,12,13
3,17,141,15,9,6
3,17,142,23,8,15
3,17,143,22,15,7
3,17,144,12,5,7
3,17,145,20,12,8
3,17,146,18,11,7
3,17,147,9,8,1
3,17,148,17,12,5
3,17,149,15,14,1
3,17,150,5,5,0
3,17,151,14,6,8
3,17,152,14,22,-8
3,17,153,12,12,0
3,17,154,15,6,9
3,17,155,10,9,1
3,17,156,9,8,1
3,17,157,21,13,8
3,17,158,17,8,9
3,17,159,19,4,15
3,17,160,13,17,-4
3,17,161,17,10,7
3,17,162,15,15,0
3,17,163,16,10,6
3,17,164,11,10,1
3,17,165,23,19,4
3,17,166,15,13,2
3,17,167,24,11,13
3,17,168,16,19,-3
3,17,169,24,18,6
3,17,170,13,11,2
3,17,171,19,10,9
3,17,172,31,7,24
3,17,173,9,12,-3
3,17,174,23,27,-4
3,17,175,13,17,-4
3,17,176,19,8,11
3,17,177,12,4,8
3,17,178,19,17,2
3,17,179,16,20,-4
3,17,180,6,6,0
3,17,181,13,21,-8
3,17,182,24,8,16
3,17,183,24,6,18
3,17,184,6,6,0
3,17,185,17,9,8
3,17,186,12,16,-4
3,17,187,20,18,2
3,17,188,17,24,-7
3,17,189,7,4,3
3,17,190,42,5,37
3,17,191,15,8,7
3,17,192,27,17,10
3,17,193,14,10,4
3,17,194,4,12,-8
3,17,195,22,4,18
3,17,196,12,6,6
3,17,197,24,17,7
3,17,198,21,14,7
3,17,199,5,7,-2
3,17,200,18,17,1
3,17,201,10,16,-6
3,17,202,12,10,2
3,17,203,6,11,-5
3,17,204,17,9,8
3,17,205,22,9,13
3,17,206,13,7,6
3,17,207,13,11,2
3,17,208,22,6,16
3,17,209,8,8,0
3,17,210,21,10,11
3,17,211,12,9,3
3,17,212,10,9,1
3,17,213,10,30,-20
3,17,214,17,18,-1
3,17,215,16,8,8
3,17,216,23,12,11
3,17,217,26,8,18
3,17,218,17,4,13
3,17,219,17,11,6
3,17,220,18,8,10
3,17,221,25,15,10
3,17,222,10,3,7
3,17,223,30,14,16
3,17,224,16,12,4
3,17,225,14,14,0
3,17,226,7,7,0
3,17,227,22,10,12
3,17,228,18,13,5
3,17,229,15,9,6
3,17,230,8,12,-4
3,17,231,26,10,16
3,17,232,13,11,2
3,17,233,11,4,7
3,17,234,13,9,4
3,17,235,8,7,1
3,17,236,28,15,13
3,17,237,24,8,16
3,17,238,8,13,-5
3,17,239,15,8,7
3,17,240,16,18,-2
3,17,241,10,18,-8
3,17,242,18,15,3
3,17,243,14,5,9
3,17,244,11,15,-4
3,17,245,12,9,3
3,17,246,14,8,6
3,17,247,9,9,0
3,17,248,20,12,8
3,17,249,8,6,2
3,17,250,7,7,0
3,17,251,13,8,5
3,17,252,15,13,2
3,17,253,20,16,4
3,17,254,17,10,7
3,17,255,11,6,5
3,17,256,7,9,-2
3,17,257,24,16,8
3,17,258,8,13,-5
3,17,259,13,20,-7
3,17,260,23,14,9
3,17,261,13,10,3
3,17,262,23,15,8
3,17,263,10,5,5
3,17,264,23,15,8
3,17,265,21,9,12
3,17,266,16,9,7
3,17,267,27,11,16
3,17,268,17,20,-3
3,17,269,8,13,-5
3,17,270,9,9,0
3,17,271,9,10,-1
3,17,272,16,10,6
3,17,273,12,7,5
3,17,274,10,6,4
3,17,275,19,13,6
3,17,276,9,5,4
3,17,277,14,7,7
3,17,278,23,6,17
3,17,279,11,6,5
3,17,280,11,7,4
3,17,281,30,15,15
3,17,282,16,16,0
3,17,283,23,5,18
3,17,284,11,11,0
3,17,285,11,4,7
3,17,286,23,11,12
3,17,287,16,13,3
3,17,288,16,13,3
3,17,289,11,13,-2
3,17,290,15,9,6
3,17,291,17,9,8
3,17,292,16,7,9
3,17,293,16,8,8
3,17,294,13,2,11
3,17,295,17,11,6
3,17,296,32,19,13
3,17,297,23,13,10
3,17,298,23,14,9
3,17,299,6,4,2
3,18,0,23,11,12
3,18,1,22,9,13
3,18,2,18,12,6
3,18,3,18,8,10
3,18,4,17,13,4
3,18,5,25,9,16
3,18,6,11,9,2
3,18,7,23,14,9
3,18,8,18,14,4
3,18,9,14,2,12
3,18,10,20,3,17
3,18,11,23,11,12
3,18,12,9,11,-2
3,18,13,17,4,13
3,18,14,27,8,19
3,18,15,15,7,8
3,18,16,16,12,4
3,18,17,14,10,4
3,18,18,16,9,7
3,18,19,18,5,13
3,18,20,12,11,1
3,18,21,17,2,15
3,18,22,20,12,8
3,18,23,12,3,9
3,18,24,14,9,5
3,18,25,23,16,7
3,18,26,22,8,14
3,18,27,15,15,0
3,18,28,15,9,6
3,18,29,19,14,5
3,18,30,25,18,7
3,18,31,27,10,17
3,18,32,19,12,7
3,18,33,16,9,7
3,18,34,18,11,7
3,18,35,19,10,9
3,18,36,18,8,10
3,18,37,19,17,2
3,18,38,16,17,-1
3,18,39,22,9,13
3,18,40,20,20,0
3,18,41,22,13,9
3,18,42,13,7,6
3,18,43,12,7,5
3,18,44,15,8,7
3,18,45,30,12,18
3,18,46,22,5,17
3,18,47,14,10,4
3,18,48,14,10,4
3,18,49,10,8,2
3,18,50,14,9,5
3,18,51,10,9,1
3,18,52,15,16,-1
3,18,53,18,13,5
3,18,54,16,8,8
3,18,55,16,10,6
3,18,56,6,2,4
3,18,57,9,7,2
3,18,58,12,7,5
3,18,59,26,12,14
3,18,60,16,9,7
3,18,61,16,10,6
3,18,62,5,8,-3
3,18,63,27,7,20
3,18,64,24,8,16
3,18,65,23,15,8
3,18,66,15,11,4
3,18,67,21,15,6
3,18,68,30,7,23
3,18,69,18,15,3
3,18,70,23,8,15
3,18,71,18,8,10
3,18,72,20,5,15
3,18,73,14,4,10
3,18,74,18,9,9
3,18,75,9,12,-3
3,18,76,26,21,5
3,18,77,27,14,13
3,18,78,13,10,3
3,18,79,22,6,16
3,18,80,11,4,7
3,18,81,11,11,0
3,18,82,20,6,14
3,18,83,15,4,11
3,18,84,21,9,12
3,18,85,15,17,-2
3,18,86,22,7,15
3,18,87,14,11,3
3,18,88,25,12,13
3,18,89,24,12,12
3,18,90,14,13,1
3,18,91,14,3,11
3,18,92,16,6,10
3,18,93,7,10,-3
3,18,94,14,6,8
3,18,95,9,14,-5
3,18,96,18,6,12
3,18,97,16,14,2
3,18,98,13,13,0
3,18,99,14,9,5
3,18,100,15,16,-1
3,18,101,35,10,25
3,18,102,17,11,6
3,18,103,30,7,23
3,18,104,18,12,6
3,18,105,26,5,21
3,18,106,29,18,11
3,18,107,17,19,-2
3,18,108,23,9,14
3,18,109,4,1,3
3,18,110,15,9,6
3,18,111,19,16,3
3,18,112,16,28,-12
3,18,113,20,14,6
3,18,114,14,9,5
3,18,115,14,3,11
3,18,116,22,7,15
3,18,117,17,12,5
3,18,118,10,3,7
3,18,119,14,3,11
3,18,120,27,14,13
3,18,121,13,6,7
3,18,122,10,10,0
3,18,123,17,20,-3
3,18,124,24,17,7
3,18,125,18,9,9
3,18,126,1,2,-1
3,18,127,16,4,12
3,18,128,7,12,-5
3,18,129,25,8,17
3,18,130,8,8,0
3,18,131,21,22,-1
3,18,132,8,7,1
3,18,133,15,5,10
3,18,134,24,6,18
3,18,135,27,13,14
3,18,136,13,9,4
3,18,137,14,3,11
3,18,138,20,19,1
3,18,139,17,4,13
3,18,140,10,7,3
3,18,141,14,18,-4
3,18,142,8,3,5
3,18,143,13,11,2
3,18,144,8,8,0
3,18,145,26,11,15
3,18,146,5,11,-6
3,18,147,9,7,2
3,18,148,21,10,11
3,18,149,29,16,13
3,18,150,15,8,7
3,18,151,11,10,1
3,18,152,17,6,11
3,18,153,4,3,1
3,18,154,21,5,16
3,18,155,13,8,5
3,18,156,12,8,4
3,18,157,12,12,0
3,18,158,17,6,11
3,18,159,10,10,0
3,18,160,23,22,1
3,18,161,19,11,8
3,18,162,13,6,7
3,18,163,16,11,5
3,18,164,6,4,2
3,18,165,16,7,9
3,18,166,20,10,10
3,18,167,16,16,0
3,18,168,16,4,12
3,18,169,18,10,8
3,18,170,19,14,5
3,18,171,21,8,13
3,18,172,18,16,2
3,18,173,23,9,14
3,18,174,11,4,7
3,18,175,33,19,14
3,18,176,24,13,11
3,18,177,20,11,9
3,18,178,7,2,5
3,18,179,26,10,16
3,18,180,19,11,8
3,18,181,6,9,-3
3,18,182,9,4,5
3,18,183,23,6,17
3,18,184,20,14,6
3,18,185,4,10,-6
3,18,186,8,11,-3
3,18,187,14,11,3
3,18,188,12,10,2
3,18,189,21,9,12
3,18,190,22,9,13
3,18,191,18,12,6
3,18,192,19,10,9
3,18,193,18,6,12
3,18,194,9,16,-7
3,18,195,32,14,18
3,18,196,20,9,11
3,18,197,15,8,7
3,18,198,18,13,5
3,18,199,17,15,2
3,18,200,20,6,14
3,18,201,15,8,7
3,18,202,27,15,12
3,18,203,9,8,1
3,18,204,37,14,23
3,18,205,9,5,4
3,18,206,24,14,10
3,18,207,5,2,3
3,18,208,23,10,13
3,18,209,19,6,13
3,18,210,14,12,2
3,18,211,10,11,-1
3,18,212,20,17,3
3,18,213,14,5,9
3,18,214,12,4,8
3,18,215,13,15,-2
3,18,216,26,18,8
3,18,217,6,8,-2
3,18,218,28,14,14
3,18,219,14,4,10
3,18,220,5,20,-15
3,18,221,15,6,9
3,18,222,22,14,8
3,18,223,18,20,-2
3,18,224,22,16,6
3,18,225,12,4,8
3,18,226,13,13,0
3,18,227,10,7,3
3,18,228,12,12,0
3,18,229,15,8,7
3,18,230,27,7,20
3,18,231,14,15,-1
3,18,232,15,9,6
3,18,233,9,11,-2
3,18,234,12,4,8
3,18,235,16,16,0
3,18,236,23,19,4
3,18,237,19,12,7
3,18,238,23,9,14
3,18,239,14,7,7
3,18,240,25,14,11
3,18,241,21,11,10
3,18,242,8,17,-9
3,18,243,14,13,1
3,18,244,21,12,9
3,18,245,15,8,7
3,18,246,16,7,9
3,18,247,12,15,-3
3,18,248,13,7,6
3,18,249,24,10,14
3,18,250,20,7,13
3,18,251,22,16,6
3,18,252,27,19,8
3,18,253,14,7,7
3,18,254,18,18,0
3,18,255,24,4,20
3,18,256,15,8,7
3,18,257,10,1,9
3,18,258,28,10,18
3,18,259,13,2,11
3,18,260,7,10,-3
3,18,261,11,8,3
3,18,262,16,9,7
3,18,263,22,22,0
3,18,264,23,8,15
3,18,265,20,10,10
3,18,266,5,3,2
3,18,267,14,22,-8
3,18,268,11,21,-10
3,18,269,17,7,10
3,18,270,18,5,13
3,18,271,27,28,-1
3,18,272,16,15,1
3,18,273,5,10,-5
3,18,274,27,10,17
3,18,275,11,11,0
3,18,276,19,9,10
3,18,277,14,9,5
3,18,278,13,12,1
3,18,279,30,18,12
3,18,280,14,12,2
3,18,281,12,7,5
3,18,282,11,23,-12
3,18,283,21,19,2
3,18,284,24,17,7
3,18,285,25,11,14
3,18,286,20,5,15
3,18,287,15,8,7
3,18,288,22,11,11
3,18,289,21,12,9
3,18,290,16,8,8
3,18,291,11,4,7
3,18,292,31,10,21
3,18,293,16,12,4
3,18,294,16,8,8
3,18,295,20,19,1
3,18,296,27,13,14
3,18,297,9,10,-1
3,18,298,10,6,4
3,18,299,14,12,2
3,19,0,28,11,17
3,19,1,12,10,2
3,19,2,10,13,-3
3,19,3,19,12,7
3,19,4,17,11,6
3,19,5,14,13,1
3,19,6,3,2,1
3,19,7,26,15,11
3,19,8,29,10,19
3,19,9,18,12,6
3,19,10,25,14,11
3,19,11,17,7,10
3,19,12,18,5,13
3,19,13,14,8,6
3,19,14,17,8,9
3,19,15,31,8,23
3,19,16,16,18,-2
3,19,17,25,9,16
3,19,18,16,5,11
3,19,19,14,13,1
3,19,20,16,9,7
3,19,21,23,17,6
3,19,22,25,6,19
3,19,23,14,9,5
3,19,24,15,11,4
3,19,25,22,16,6
3,19,26,13,12,1
3,19,27,11,8,3
3,19,28,14,16,-2
3,19,29,13,11,2
3,19,30,13,14,-1
3,19,31,27,19,8
3,19,32,21,9,12
3,19,33,16,17,-1
3,19,34,19,12,7
3,19,35,13,7,6
3,19,36,24,20,4
3,19,37,25,12,13
3,19,38,9,5,4
3,19,39,15,16,-1
3,19,40,7,4,3
3,19,41,16,10,6
3,19,42,35,8,27
3,19,43,15,27,-12
3,19,44,17,7,10
3,19,45,29,15,14
3,19,46,19,11,8
3,19,47,17,16,1
3,19,48,10,9,1
3,19,49,22,15,7
3,19,50,28,18,10
3,19,51,26,12,14
3,19,52,19,19,0
3,19,53,11,14,-3
3,19,54,18,8,10
3,19,55,15,15,0
3,19,56,15,9,6
3,19,57,17,9,8
3,19,58,17,10,7
3,19,59,29,14,15
3,19,60,27,7,20
3,19,61,14,16,-2
3,19,62,12,4,8
3,19,63,16,18,-2
3,19,64,17,13,4
3,19,65,26,9,17
3,19,66,19,8,11
3,19,67,21,13,8
3,19,68,19,11,8
3,19,69,15,20,-5
3,19,70,22,15,7
3,19,71,29,11,18
3,19,72,16,8,8
3,19,73,5,4,1
3,19,74,7,10,-3
3,19,75,17,12,5
3,19,76,15,6,9
3,19,77,14,1,13
3,19,78,18,7,11
3,19,79,32,16,16
3,19,80,16,8,8
3,19,81,4,12,-8
3,19,82,17,3,14
3,19,83,11,4,7
3,19,84,16,12,4
3,19,85,23,21,2
3,19,86,7,10,-3
3,19,87,11,12,-1
3,19,88,8,13,-5
3,19,89,23,25,-2
3,19,90,8,10,-2
3,19,91,31,9,22
3,19,92,15,12,3
3,19,93,26,14,12
3,19,94,9,12,-3
3,19,95,17,9,8
3,19,96,14,4,10
3,19,97,23,15,8
3,19,98,17,9,8
3,19,99,12,12,0
3,19,100,13,10,3
3,19,101,12,9,3
3,19,102,13,10,3
3,19,103,9,9,0
3,19,104,29,13,16
3,19,105,9,1,8
3,19,106,25,12,13
3,19,107,12,4,8
3,19,108,19,11,8
3,19,109,14,10,4
3,19,110,27,13,14
3,19,111,15,13,2
3,19,112,19,20,-1
3,19,113,19,7,12
3,19,114,13,21,-8
3,19,115,27,5,22
3,19,116,19,9,10
3,19,117,17,10,7
3,19,118,13,10,3
3,19,119,12,11,1
3,19,120,10,3,7
3,19,121,10,7,3
3,19,122,16,10,6
3,19,123,18,15,3
3,19,124,18,8,10
3,19,125,16,9,7
3,19,126,31,14,17
3,19,127,26,29,-3
3,19,128,9,4,5
3,19,129,8,6,2
3,19,130,14,22,-8
3,19,131,26,4,22
3,19,132,16,11,5
3,19,133,8,14,-6
3,19,134,18,8,10
3,19,135,21,17,4
3,19,136,25,13,12
3,19,137,18,7,11
3,19,138,22,7,15
3,19,139,10,17,-7
3,19,140,13,7,6
3,19,141,19,14,5
3,19,142,21,12,9
3,19,143,20,19,1
3,19,144,15,14,1
3,19,145,10,13,-3
3,19,146,22,12,10
3,19,147,19,18,1
3,19,148,13,4,9
3,19,149,22,17,5
3,19,150,0,5,-5
3,19,151,15,8,7
3,19,152,8,5,3
3,19,153,19,8,11
3,19,154,11,11,0
3,19,155,28,19,9
3,19,156,36,12,24
3,19,157,25,6,19
3,19,158,32,5,27
3,19,159,18,9,9
3,19,160,23,15,8
3,19,161,20,10,10
3,19,162,10,9,1
3,19,163,17,5,12
3,19,164,14,14,0
3,19,165,6,9,-3
3,19,166,26,12,14
3,19,167,17,8,9
3,19,168,12,2,10
3,19,169,16,6,10
3,19,170,21,9,12
3,19,171,10,9,1
3,19,172,14,9,5
3,19,173,20,23,-3
3,19,174,19,4,15
3,19,175,18,18,0
3,19,176,25,11,14
3,19,177,17,13,4
3,19,178,16,17,-1
3,19,179,21,8,13
3,19,180,24,6,18
3,19,181,21,25,-4
3,19,182,11,13,-2
3,19,183,13,11,2
3,19,184,17,25,-8
3,19,185,9,11,-2
3,19,186,16,10,6
3,19,187,11,4,7
3,19,188,9,8,1
3,19,189,12,5,7
3,19,190,16,24,-8
3,19,191,26,12,14
3,19,192,22,11,11
3,19,193,14,11,3
3,19,194,24,10,14
3,19,195,18,7,11
3,19,196,19,12,7
3,19,197,9,6,3
3,19,198,16,2,14
3,19,199,15,11,4
3,19,200,22,16,6
3,19,201,15,7,8
3,19,202,14,11,3
3,19,203,14,8,6
3,19,204,9,2,7
3,19,205,9,11,-2
3,19,206,16,13,3
3,19,207,16,13,3
3,19,208,9,3,6
3,19,209,14,7,7
3,19,210,23,18,5
3,19,211,18,11,7
3,19,212,11,4,7
3,19,213,35,9,26
3,19,214,12,9,3
3,19,215,15,11,4
3,19,216,18,5,13
3,19,217,23,7,16
3,19,218,32,11,21
3,19,219,22,12,10
3,19,220,20,10,10
3,19,221,24,15,9
3,19,222,23,8,15
3,19,223,15,18,-3
3,19,224,25,10,15
3,19,225,17,9,8
3,19,226,23,19,4
3,19,227,20,15,5
3,19,228,25,14,11
3,19,229,21,9,12
3,19,230,25,7,18
3,19,231,22,11,11
3,19,232,27,13,14
3,19,233,20,12,8
3,19,234,17,13,4
3,19,235,11,7,4
3,19,236,15,13,2
3,19,237,32,9,23
3,19,238,25,6,19
3,19,239,15,15,0
3,19,240,22,14,8
3,19,241,11,14,-3
3,19,242,8,5,3
3,19,243,18,7,11
3,19,244,18,20,-2
3,19,245,23,12,11
3,19,246,16,9,7
3,19,247,18,4,14
3,19,248,40,17,23
3,19,249,18,16,2
3,19,250,23,11,12
3,19,251,13,7,6
3,19,252,18,17,1
3,19,253,29,12,17
3,19,254,11,3,8
3,19,255,20,16,4
3,19,256,23,9,14
3,19,257,16,10,6
3,19,258,16,16,0
3,19,259,12,4,8
3,19,260,4,8,-4
3,19,261,19,18,1
3,19,262,9,14,-5
3,19,263,24,17,7
3,19,264,25,10,15
3,19,265,11,13,-2
3,19,266,6,16,-10
3,19,267,21,13,8
3,19,268,15,8,7
3,19,269,16,11,5
3,19,270,18,15,3
3,19,271,11,17,-6
3,19,272,15,11,4
3,19,273,10,9,1
3,19,274,21,6,15
3,19,275,21,8,13
3,19,276,12,13,-1
3,19,277,18,6,12
3,19,278,12,12,0
3,19,279,16,7,9
3,19,280,20,10,10
3,19,281,13,11,2
3,19,282,16,3,13
3,19,283,27,18,9
3,19,284,14,10,4
3,19,285,17,3,14
3,19,286,35,12,23
3,19,287,21,9,12
3,19,288,23,8,15
3,19,289,21,17,4
3,19,290,27,34,-7
3,19,291,19,4,15
3,19,292,19,5,14
3,19,293,18,12,6
3,19,294,20,12,8
3,19,295,2,12,-10
3,19,296,30,21,9
3,19,297,23,16,7
3,19,298,17,5,12
3,19,299,15,4,11
3,20,0,26,15,11
3,20,1,30,17,13
3,20,2,14,25,-11
3,20,3,22,13,9
3,20,4,13,6,7
3,20,5,17,9,8
3,20,6,20,7,13
3,20,7,20,17,3
3,20,8,13,5,8
3,20,9,10,10,0
3,20,10,19,9,10
3,20,11,16,14,2
3,20,12,20,12,8
3,20,13,12,6,6
3,20,14,12,7,5
3,20,15,32,13,19
3,20,16,16,8,8
3,20,17,20,12,8
3,20,18,18,14,4
3,20,19,13,7,6
3,20,20,9,12,-3
3,20,21,18,5,13
3,20,22,22,25,-3
3,20,23,10,8,2
3,20,24,10,6,4
3,20,25,6,6,0
3,20,26,19,18,1
3,20,27,17,22,-5
3,20,28,22,13,9
3,20,29,30,13,17
3,20,30,10,6,4
3,20,31,15,9,6
3,20,32,5,2,3
3,20,33,22,12,10
3,20,34,12,14,-2
3,20,35,27,9,18
3,20,36,13,12,1
3,20,37,26,7,19
3,20,38,23,8,15
3,20,39,22,15,7
3,20,40,9,15,-6
3,20,41,16,3,13
3,20,42,32,5,27
3,20,43,23,14,9
3,20,44,23,15,8
3,20,45,18,20,-2
3,20,46,20,5,15
3,20,47,3,2,1
3,20,48,24,12,12
3,20,49,12,8,4
3,20,50,16,15,1
3,20,51,16,10,6
3,20,52,13,9,4
3,20,53,16,13,3
3,20,54,7,5,2
3,20,55,17,6,11
3,20,56,4,5,-1
3,20,57,10,3,7
3,20,58,22,12,10
3,20,59,28,15,13
3,20,60,37,9,28
3,20,61,22,17,5
3,20,62,25,8,17
3,20,63,14,8,6
3,20,64,20,12,8
3,20,65,17,9,8
3,20,66,11,8,3
3,20,67,20,8,12
3,20,68,23,7,16
3,20,69,11,3,8
3,20,70,17,10,7
3,20,71,5,12,-7
3,20,72,23,12,11
3,20,73,19,16,3
3,20,74,14,8,6
3,20,75,18,10,8
3,20,76,18,5,13
3,20,77,21,24,-3
3,20,78,10,4,6
3,20,79,11,4,7
3,20,80,27,23,4
3,20,81,20,11,9
3,20,82,12,13,-1
3,20,83,14,17,-3
3,20,84,13,14,-1
3,20,85,18,2,16
3,20,86,22,10,12
3,20,87,8,10,-2
3,20,88,15,6,9
3,20,89,13,0,13
3,20,90,13,9,4
3,20,91,15,5,10
3,20,92,20,7,13
3,20,93,11,4,7
3,20,94,17,11,6
3,20,95,9,5,4
3,20,96,13,7,6
3,20,97,23,3,20
3,20,98,26,13,13
3,20,99,23,14,9
3,20,100,8,10,-2
3,20,101,23,15,8
3,20,102,6,4,2
3,20,103,14,7,7
3,20,104,27,16,11
3,20,105,20,8,12
3,20,106,28,8,20
3,20,107,18,10,8
3,20,108,26,12,14
3,20,109,7,5,2
3,20,110,24,19,5
3,20,111,35,7,28
3,20,112,18,4,14
3,20,113,26,18,8
3,20,114,21,5,16
3,20,115,40,17,23
3,20,116,17,12,5
3,20,117,7,5,2
3,20,118,12,5,7
3,20,119,24,7,17
3,20,120,23,8,15
3,20,121,15,6,9
3,20,122,17,6,11
3,20,123,20,17,3
3,20,124,11,13,-2
3,20,125,16,14,2
3,20,126,16,11,5
3,20,127,12,8,4
3,20,128,19,13,6
3,20,129,26,19,7
3,20,130,11,14,-3
3,20,131,9,9,0
3,20,132,19,11,8
3,20,133,8,14,-6
3,20,134,24,20,4
3,20,135,22,13,9
3,20,136,10,9,1
3,20,137,17,7,10
3,20,138,24,9,15
3,20,139,18,17,1
3,20,140,37,18,19
3,20,141,29,22,7
3,20,142,15,12,3
3,20,143,21,12,9
3,20,144,17,19,-2
3,20,145,19,12,7
3,20,146,13,3,10
3,20,147,18,8,10
3,20,148,6,8,-2
3,20,149,18,4,14
3,20,150,30,20,10
3,20,151,6,6,0
3,20,152,26,10,16
3,20,153,11,10,1
3,20,154,16,7,9
3,20,155,12,11,1
3,20,156,23,14,9
3,20,157,14,11,3
3,20,158,11,13,-2
3,20,159,24,33,-9
3,20,160,32,18,14
3,20,161,22,10,12
3,20,162,14,9,5
3,20,163,44,24,20
3,20,164,17,7,10
3,20,165,9,7,2
3,20,166,18,18,0
3,20,167,26,12,14
3,20,168,13,8,5
3,20,169,23,15,8
3,20,170,19,23,-4
3,20,171,14,9,5
3,20,172,8,4,4
3,20,173,12,34,-22
3,20,174,15,15,0
3,20,175,19,10,9
3,20,176,36,17,19
3,20,177,16,14,2
3,20,178,18,5,13
3,20,179,21,8,13
3,20,180,15,4,11
3,20,181,8,3,5
3,20,182,9,4,5
3,20,183,18,8,10
3,20,184,16,12,4
3,20,185,16,12,4
3,20,186,23,21,2
3,20,187,13,3,10
3,20,188,14,5,9
3,20,189,15,8,7
3,20,190,18,8,10
3,20,191,23,7,16
3,20,192,12,16,-4
3,20,193,17,3,14
3,20,194,15,15,0
3,20,195,8,4,4
3,20,196,11,6,5
3,20,197,13,6,7
3,20,198,28,18,10
3,20,199,7,5,2
3,20,200,15,9,6
3,20,201,18,12,6
3,20,202,7,6,1
3,20,203,24,12,12
3,20,204,15,11,4
3,20,205,28,15,13
3,20,206,36,8,28
3,20,207,17,9,8
3,20,208,14,13,1
3,20,209,11,12,-1
3,20,210,22,9,13
3,20,211,18,9,9
3,20,212,8,1,7
3,20,213,11,6,5
3,20,214,14,14,0
3,20,215,9,2,7
3,20,216,12,7,5
3,20,217,12,10,2
3,20,218,22,8,14
3,20,219,17,9,8
3,20,220,26,5,21
3,20,221,27,15,12
3,20,222,26,15,11
3,20,223,12,13,-1
3,20,224,25,14,11
3,20,225,17,8,9
3,20,226,7,14,-7
3,20,227,26,10,16
3,20,228,20,14,6
3,20,229,10,3,7
3,20,230,11,10,1
3,20,231,9,3,6
3,20,232,16,8,8
3,20,233,28,5,23
3,20,234,14,7,7
3,20,235,13,10,3
3,20,236,19,7,12
3,20,237,14,6,8
3,20,238,14,1,13
3,20,239,11,5,6
3,20,240,6,7,-1
3,20,241,16,11,5
3,20,242,22,8,14
3,20,243,23,21,2
3,20,244,11,15,-4
3,20,245,11,8,3
3,20,246,25,8,17
3,20,247,21,6,15
3,20,248,21,6,15
3,20,249,20,9,11
3,20,250,17,12,5
3,20,251,15,5,10
3,20,252,18,8,10
3,20,253,14,5,9
3,20,254,13,9,4
3,20,255,27,18,9
3,20,256,16,3,13
3,20,257,8,6,2
3,20,258,17,9,8
3,20,259,22,4,18
3,20,260,17,8,9
3,20,261,20,12,8
3,20,262,21,14,7
3,20,263,20,15,5
3,20,264,27,5,22
3,20,265,33,16,17
3,20,266,14,11,3
3,20,267,19,13,6
3,20,268,13,8,5
3,20,269,26,22,4
3,20,270,21,4,17
3,20,271,25,8,17
3,20,272,30,14,16
3,20,273,11,9,2
3,20,274,11,8,3
3,20,275,14,2,12
3,20,276,52,12,40
3,20,277,17,15,2
3,20,278,8,13,-5
3,20,279,6,4,2
3,20,280,21,15,6
3,20,281,10,12,-2
3,20,282,10,5,5
3,20,283,14,5,9
3,20,284,12,6,6
3,20,285,19,6,13
3,20,286,15,8,7
3,20,287,13,10,3
3,20,288,4,8,-4
3,20,289,11,9,2
3,20,290,18,12,6
3,20,291,24,14,10
3,20,292,22,9,13
3,20,293,15,16,-1
3,20,294,14,11,3
3,20,295,12,9,3
3,20,296,11,10,1
3,20,297,15,19,-4
3,20,298,16,4,12
3,20,299,22,9,13
3,21,0,19,10,9
3,21,1,33,9,24
3,21,2,18,11,7
3,21,3,22,8,14
3,21,4,19,6,13
3,21,5,23,15,8
3,21,6,13,6,7
3,21,7,16,10,6
3,21,8,22,12,10
3,21,9,15,9,6
3,21,10,10,21,-11
3,21,11,13,7,6
3,21,12,17,2,15
3,21,13,19,16,3
3,21,14,22,11,11
3,21,15,27,7,20
3,21,16,15,5,10
3,21,17,8,10,-2
3,21,18,8,13,-5
3,21,19,20,14,6
3,21,20,23,5,18
3,21,21,12,2,10
3,21,22,7,5,2
3,21,23,15,14,1
3,21,24,16,6,10
3,21,25,10,2,8
3,21,26,23,8,15
3,21,27,16,14,2
3,21,28,34,19,15
3,21,29,20,11,9
3,21,30,14,7,7
3,21,31,21,4,17
3,21,32,10,12,-2
3,21,33,19,8,11
3,21,34,18,18,0
3,21,35,25,9,16
3,21,36,2,2,0
3,21,37,14,15,-1
3,21,38,12,8,4
3,21,39,12,3,9
3,21,40,22,3,19
3,21,41,13,7,6
3,21,42,20,13,7
3,21,43,21,9,12
3,21,44,24,15,9
3,21,45,21,17,4
3,21,46,14,4,10
3,21,47,15,15,0
3,21,48,23,13,10
3,21,49,22,11,11
3,21,50,27,4,23
3,21,51,19,9,10
3,21,52,14,8,6
3,21,53,7,6,1
3,21,54,20,10,10
3,21,55,35,17,18
3,21,56,27,6,21
3,21,57,15,18,-3
3,21,58,16,23,-7
3,21,59,21,7,14
3,21,60,24,16,8
3,21,61,28,6,22
3,21,62,14,12,2
3,21,63,46,6,40
3,21,64,19,17,2
3,21,65,27,7,20
3,21,66,19,5,14
3,21,67,5,14,-9
3,21,68,18,15,3
3,21,69,18,12,6
3,21,70,13,3,10
3,21,71,7,7,0
3,21,72,21,16,5
3,21,73,15,4,11
3,21,74,17,7,10
3,21,75,29,10,19
3,21,76,21,14,7
3,21,77,14,10,4
3,21,78,12,12,0
3,21,79,20,8,12
3,21,80,18,9,9
3,21,81,31,16,15
3,21,82,30,7,23
3,21,83,16,12,4
3,21,84,28,10,18
3,21,85,23,5,18
3,21,86,30,17,13
3,21,87,18,7,11
3,21,88,14,10,4
3,21,89,7,5,2
3,21,90,19,7,12
3,21,91,11,15,-4
3,21,92,21,8,13
3,21,93,27,16,11
3,21,94,12,4,8
3,21,95,20,5,15
3,21,96,11,6,5
3,21,97,12,9,3
3,21,98,10,7,3
3,21,99,18,10,8
3,21,100,19,21,-2
3,21,101,9,5,4
3,21,102,26,11,15
3,21,103,29,11,18
3,21,104,20,12,8
3,21,105,12,20,-8
3,21,106,12,4,8
3,21,107,20,9,11
3,21,108,24,22,2
3,21,109,21,4,17
3,21,110,26,18,8
3,21,111,11,11,0
3,21,112,24,13,11
3,21,113,12,7,5
3,21,114,17,10,7
3,21,115,17,10,7
3,21,116,17,7,10
3,21,117,24,13,11
3,21,118,24,15,9
3,21,119,27,14,13
3,21,120,15,5,10
3,21,121,26,15,11
3,21,122,37,12,25
3,21,123,22,7,15
3,21,124,12,19,-7
3,21,125,15,7,8
3,21,126,21,21,0
3,21,127,19,14,5
3,21,128,14,10,4
3,21,129,17,7,10
3,21,130,26,14,12
3,21,131,4,6,-2
3,21,132,23,13,10
3,21,133,16,13,3
3,21,134,15,11,4
3,21,135,20,14,6
3,21,136,19,16,3
3,21,137,18,9,9
3,21,138,12,8,4
3,21,139,26,20,6
3,21,140,13,11,2
3,21,141,10,1,9
3,21,142,29,18,11
3,21,143,3,3,0
3,21,144,23,13,10
3,21,145,13,17,-4
3,21,146,22,14,8
3,21,147,21,10,11
3,21,148,20,8,12
3,21,149,17,14,3
3,21,150,15,19,-4
3,21,151,13,7,6
3,21,152,8,10,-2
3,21,153,24,7,17
3,21,154,14,6,8
3,21,155,21,11,10
3,21,156,20,11,9
3,21,157,19,8,11
3,21,158,5,4,1
3,21,159,15,17,-2
3,21,160,26,11,15
3,21,161,14,14,0
3,21,162,17,15,2
3,21,163,20,13,7
3,21,164,15,5,10
3,21,165,6,4,2
3,21,166,11,13,-2
3,21,167,26,18,8
3,21,168,11,13,-2
3,21,169,27,15,12
3,21,170,10,11,-1
3,21,171,8,7,1
3,21,172,4,13,-9
3,21,173,20,19,1
3,21,174,16,7,9
3,21,175,17,9,8
3,21,176,22,15,7
3,21,177,17,6,11
3,21,178,9,7,2
3,21,179,28,1,27
3,21,180,16,6,10
3,21,181,23,7,16
3,21,182,15,6,9
3,21,183,27,17,10
3,21,184,19,9,10
3,21,185,17,8,9
3,21,186,13,4,9
3,21,187,29,15,14
3,21,188,17,8,9
3,21,189,23,10,13
3,21,190,21,2,19
3,21,191,12,6,6
3,21,192,15,13,2
3,21,193,6,4,2
3,21,194,29,16,13
3,21,195,34,19,15
3,21,196,17,12,5
3,21,197,14,6,8
3,21,198,38,7,31
3,21,199,10,5,5
3,21,200,23,9,14
3,21,201,30,21,9
3,21,202,12,8,4
3,21,203,14,9,5
3,21,204,7,18,-11
3,21,205,12,6,6
3,21,206,16,15,1
3,21,207,18,24,-6
3,21,208,12,12,0
3,21,209,22,12,10
3,21,210,19,8,11
3,21,211,31,9,22
3,21,212,23,8,15
3,21,213,21,10,11
3,21,214,18,17,1
3,21,215,21,15,6
3,21,216,15,10,5
3,21,217,13,4,9
3,21,218,14,13,1
3,21,219,30,14,16
3,21,220,13,6,7
3,21,221,18,9,9
3,21,222,36,4,32
3,21,223,23,15,8
3,21,224,21,10,11
3,21,225,11,8,3
3,21,226,20,16,4
3,21,227,23,8,15
3,21,228,20,14,6
3,21,229,22,10,12
3,21,230,18,12,6
3,21,231,14,15,-1
3,21,232,12,9,3
3,21,233,8,3,5
3,21,234,14,10,4
3,21,235,34,11,23
3,21,236,32,13,19
3,21,237,14,5,9
3,21,238,29,4,25
3,21,239,9,6,3
3,21,240,25,10,15
3,21,241,15,10,5
3,21,242,24,6,18
3,21,243,10,10,0
3,21,244,32,21,11
3,21,245,14,5,9
3,21,246,29,6,23
3,21,247,10,7,3
3,21,248,22,10,12
3,21,249,6,17,-11
3,21,250,31,22,9
3,21,251,14,14,0
3,21,252,10,10,0
3,21,253,15,7,8
3,21,254,8,9,-1
3,21,255,25,14,11
3,21,256,36,15,21
3,21,257,12,9,3
3,21,258,7,6,1
3,21,259,16,13,3
3,21,260,26,15,11
3,21,261,19,17,2
3,21,262,32,15,17
3,21,263,11,7,4
3,21,264,18,13,5
3,21,265,27,8,19
3,21,266,8,7,1
3,21,267,14,16,-2
3,21,268,13,7,6
3,21,269,19,14,5
3,21,270,13,5,8
3,21,271,25,4,21
3,21,272,18,10,8
3,21,273,22,10,12
3,21,274,16,9,7
3,21,275,15,10,5
3,21,276,13,0,13
3,21,277,13,4,9
3,21,278,22,9,13
3,21,279,24,5,19
3,21,280,12,8,4
3,21,281,9,14,-5
3,21,282,17,10,7
3,21,283,27,7,20
3,21,284,15,6,9
3,21,285,20,7,13
3,21,286,14,10,4
3,21,287,14,4,10
3,21,288,25,8,17
3,21,289,14,8,6
3,21,290,18,11,7
3,21,291,17,18,-1
3,21,292,10,7,3
3,21,293,17,10,7
3,21,294,22,13,9
3,21,295,20,11,9
3,21,296,17,10,7
3,21,297,32,9,23
3,21,298,19,16,3
3,21,299,12,18,-6
3,22,0,18,6,12
3,22,1,19,7,12
3,22,2,12,17,-5
3,22,3,12,5,7
3,22,4,12,14,-2
3,22,5,22,8,14
3,22,6,10,9,1
3,22,7,16,11,5
3,22,8,10,15,-5
3,22,9,12,3,9
3,22,10,15,4,11
3,22,11,22,12,10
3,22,12,18,12,6
3,22,13,17,6,11
3,22,14,12,14,-2
3,22,15,16,11,5
3,22,16,40,22,18
3,22,17,25,2,23
3,22,18,15,11,4
3,22,19,16,6,10
3,22,20,10,11,-1
3,22,21,15,5,10
3,22,22,27,8,19
3,22,23,13,6,7
3,22,24,20,19,1
3,22,25,9,12,-3
3,22,26,28,15,13
3,22,27,21,7,14
3,22,28,15,8,7
3,22,29,10,8,2
3,22,30,8,3,5
3,22,31,2,3,-1
3,22,32,18,14,4
3,22,33,22,8,14
3,22,34,24,14,10
3,22,35,20,4,16
3,22,36,45,4,41
3,22,37,15,15,0
3,22,38,23,9,14
3,22,39,19,19,0
3,22,40,15,4,11
3,22,41,15,4,11
3,22,42,22,14,8
3,22,43,25,12,13
3,22,44,16,1,15
3,22,45,19,8,11
3,22,46,18,9,9
3,22,47,16,3,13
3,22,48,32,11,21
3,22,49,8,4,4
3,22,50,20,6,14
3,22,51,10,2,8
3,22,52,31,14,17
3,22,53,29,11,18
3,22,54,20,18,2
3,22,55,20,13,7
3,22,56,23,9,14
3,22,57,10,7,3
3,22,58,26,14,12
3,22,59,32,21,11
3,22,60,6,1,5
3,22,61,29,20,9
3,22,62,12,3,9
3,22,63,13,6,7
3,22,64,26,11,15
3,22,65,26,17,9
3,22,66,8,14,-6
3,22,67,19,14,5
3,22,68,12,11,1
3,22,69,24,9,15
3,22,70,32,10,22
3,22,71,19,18,1
3,22,72,9,12,-3
3,22,73,19,10,9
3,22,74,23,15,8
3,22,75,25,14,11
3,22,76,18,9,9
3,22,77,18,8,10
3,22,78,16,14,2
3,22,79,20,15,5
3,22,80,21,14,7
3,22,81,19,12,7
3,22,82,13,4,9
3,22,83,31,5,26
3,22,84,37,13,24
3,22,85,23,13,10
3,22,86,12,6,6
3,22,87,19,5,14
3,22,88,18,10,8
3,22,89,20,15,5
3,22,90,17,12,5
3,22,91,10,12,-2
3,22,92,22,11,11
3,22,93,6,9,-3
3,22,94,34,13,21
3,22,95,10,9,1
3,22,96,20,10,10
3,22,97,7,6,1
3,22,98,13,11,2
3,22,99,13,19,-6
3,22,100,21,10,11
3,22,101,16,10,6
3,22,102,25,16,9
3,22,103,22,9,13
3,22,104,10,6,4
3,22,105,25,7,18
3,22,106,17,6,11
3,22,107,11,15,-4
3,22,108,11,12,-1
3,22,109,11,13,-2
3,22,110,22,5,17
3,22,111,28,21,7
3,22,112,18,11,7
3,22,113,9,16,-7
3,22,114,10,5,5
3,22,115,13,10,3
3,22,116,32,14,18
3,22,117,16,10,6
3,22,118,14,4,10
3,22,119,26,10,16
3,22,120,15,13,2
3,22,121,18,21,-3
3,22,122,28,12,16
3,22,123,17,12,5
3,22,124,23,8,15
3,22,125,13,12,1
3,22,126,12,8,4
3,22,127,12,16,-4
3,22,128,18,8,10
3,22,129,10,9,1
3,22,130,15,15,0
3,22,131,20,7,13
3,22,132,12,12,0
3,22,133,18,8,10
3,22,134,11,12,-1
3,22,135,19,12,7
3,22,136,7,9,-2
3,22,137,33,11,22
3,22,138,19,19,0
3,22,139,23,13,10
3,22,140,32,3,29
3,22,141,19,13,6
3,22,142,11,5,6
3,22,143,25,14,11
3,22,144,26,15,11
3,22,145,12,5,7
3,22,146,24,9,15
3,22,147,18,10,8
3,22,148,18,6,12
3,22,149,33,9,24
3,22,150,10,4,6
3,22,151,20,8,12
3,22,152,17,18,-1
3,22,153,12,10,2
3,22,154,16,13,3
3,22,155,13,9,4
3,22,156,16,11,5
3,22,157,13,13,0
3,22,158,27,8,19
3,22,159,22,8,14
3,22,160,7,8,-1
3,22,161,25,20,5
3,22,162,29,18,11
3,22,163,28,14,14
3,22,164,8,9,-1
3,22,165,21,11,10
3,22,166,19,10,9
3,22,167,17,13,4
3,22,168,4,3,1
3,22,169,18,10,8
3,22,170,30,17,13
3,22,171,20,10,10
3,22,172,16,5,11
3,22,173,23,9,14
3,22,174,20,10,10
3,22,175,16,21,-5
3,22,176,10,8,2
3,22,177,31,12,19
3,22,178,20,10,10
3,22,179,23,7,16
3,22,180,18,16,2
3,22,181,20,8,12
3,22,182,16,6,10
3,22,183,19,6,13
3,22,184,9,8,1
3,22,185,22,6,16
3,22,186,12,5,7
3,22,187,22,14,8
3,22,188,14,12,2
3,22,189,16,11,5
3,22,190,22,12,10
3,22,191,27,9,18
3,22,192,27,7,20
3,22,193,21,4,17
3,22,194,15,5,10
3,22,195,16,9,7
3,22,196,22,15,7
3,22,197,15,13,2
3,22,198,20,8,12
3,22,199,29,13,16
3,22,200,15,9,6
3,22,201,15,9,6
3,22,202,21,16,5
3,22,203,20,13,7
3,22,204,6,15,-9
3,22,205,23,8,15
3,22,206,11,9,2
3,22,207,20,10,10
3,22,208,22,14,8
3,22,209,8,2,6
3,22,210,17,15,2
3,22,211,18,7,11
3,22,212,19,6,13
3,22,213,17,4,13
3,22,214,14,9,5
3,22,215,12,9,3
3,22,216,18,22,-4
3,22,217,19,8,11
3,22,218,7,4,3
3,22,219,38,10,28
3,22,220,26,15,11
3,22,221,16,8,8
3,22,222,18,6,12
3,22,223,12,14,-2
3,22,224,21,10,11
3,22,225,13,9,4
3,22,226,17,5,12
3,22,227,21,14,7
3,22,228,22,10,12
3,22,229,21,1,20
3,22,230,26,13,13
3,22,231,31,23,8
3,22,232,9,9,0
3,22,233,14,13,1
3,22,234,18,11,7
3,22,235,9,8,1
3,22,236,14,12,2
3,22,237,26,15,11
3,22,238,14,9,5
3,22,239,27,11,16
3,22,240,10,6,4
3,22,241,6,8,-2
3,22,242,30,6,24
3,22,243,30,9,21
3,22,244,30,13,17
3,22,245,28,10,18
3,22,246,30,10,20
3,22,247,17,3,14
3,22,248,11,11,0
3,22,249,17,12,5
3,22,250,16,3,13
3,22,251,15,12,3
3,22,252,12,11,1
3,22,253,20,7,13
3,22,254,19,9,10
3,22,255,23,8,15
3,22,256,25,18,7
3,22,257,31,17,14
3,22,258,25,4,21
3,22,259,12,4,8
3,22,260,10,6,4
3,22,261,30,20,10
3,22,262,13,5,8
3,22,263,18,20,-2
3,22,264,16,11,5
3,22,265,10,9,1
3,22,266,21,4,17
3,22,267,24,5,19
3,22,268,13,4,9
3,22,269,29,6,23
3,22,270,20,7,13
3,22,271,12,7,5
3,22,272,10,11,-1
3,22,273,15,13,2
3,22,274,9,8,1
3,22,275,29,18,11
3,22,276,21,10,11
3,22,277,13,6,7
3,22,278,15,13,2
3,22,279,20,10,10
3,22,280,19,6,13
3,22,281,18,12,6
3,22,282,19,7,12
3,22,283,24,7,17
3,22,284,17,9,8
3,22,285,28,8,20
3,22,286,16,19,-3
3,22,287,14,3,11
3,22,288,15,7,8
3,22,289,5,5,0
3,22,290,13,4,9
3,22,291,13,9,4
3,22,292,22,12,10
3,22,293,35,7,28
3,22,294,13,10,3
3,22,295,20,8,12
3,22,296,20,2,18
3,22,297,10,1,9
3,22,298,8,12,-4
3,22,299,11,3,8
3,23,0,19,12,7
3,23,1,20,8,12
3,23,2,20,15,5
3,23,3,5,4,1
3,23,4,14,4,10
3,23,5,17,11,6
3,23,6,39,15,24
3,23,7,18,2,16
3,23,8,21,11,10
3,23,9,10,10,0
3,23,10,16,9,7
3,23,11,30,14,16
3,23,12,8,3,5
3,23,13,11,4,7
3,23,14,20,10,10
3,23,15,14,6,8
3,23,16,18,12,6
3,23,17,36,21,15
3,23,18,17,13,4
3,23,19,10,18,-8
3,23,20,12,4,8
3,23,21,3,7,-4
3,23,22,28,12,16
3,23,23,20,6,14
3,23,24,9,8,1
3,23,25,20,17,3
3,23,26,20,17,3
3,23,27,9,9,0
3,23,28,5,2,3
3,23,29,14,14,0
3,23,30,18,15,3
3,23,31,15,11,4
3,23,32,24,17,7
3,23,33,18,6,12
3,23,34,7,15,-8
3,23,35,16,13,3
3,23,36,14,5,9
3,23,37,10,4,6
3,23,38,24,13,11
3,23,39,17,9,8
3,23,40,12,6,6
3,23,41,31,18,13
3,23,42,13,9,4
3,23,43,16,8,8
3,23,44,18,17,1
3,23,45,29,16,13
3,23,46,23,5,18
3,23,47,14,4,10
3,23,48,27,10,17
3,23,49,14,16,-2
3,23,50,15,11,4
3,23,51,12,10,2
3,23,52,19,1,18
3,23,53,7,4,3
3,23,54,20,9,11
3,23,55,19,16,3
3,23,56,13,7,6
3,23,57,10,8,2
3,23,58,22,8,14
3,23,59,17,7,10
3,23,60,30,4,26
3,23,61,14,14,0
3,23,62,17,5,12
3,23,63,20,15,5
3,23,64,12,9,3
3,23,65,13,8,5
3,23,66,18,9,9
3,23,67,13,13,0
3,23,68,22,13,9
3,23,69,23,21,2
3,23,70,22,10,12
3,23,71,19,13,6
3,23,72,12,15,-3
3,23,73,13,6,7
3,23,74,9,7,2
3,23,75,29,5,24
3,23,76,18,14,4
3,23,77,16,9,7
3,23,78,11,10,1
3,23,79,13,11,2
3,23,80,35,11,24
3,23,81,20,11,9
3,23,82,17,6,11
3,23,83,19,18,1
3,23,84,17,18,-1
3,23,85,17,3,14
3,23,86,14,4,10
3,23,87,15,7,8
3,23,88,16,18,-2
3,23,89,12,5,7
3,23,90,28,8,20
3,23,91,19,8,11
3,23,92,25,7,18
3,23,93,22,24,-2
3,23,94,15,3,12
3,23,95,30,9,21
3,23,96,32,8,24
3,23,97,21,14,7
3,23,98,26,14,12
3,23,99,22,11,11
3,23,100,22,9,13
3,23,101,21,1,20
3,23,102,23,6,17
3,23,103,6,10,-4
3,23,104,25,16,9
3,23,105,21,10,11
3,23,106,8,5,3
3,23,107,12,7,5
3,23,108,12,8,4
3,23,109,22,8,14
3,23,110,3,4,-1
3,23,111,20,7,13
3,23,112,13,7,6
3,23,113,17,2,15
3,23,114,22,7,15
3,23,115,25,17,8
3,23,116,13,22,-9
3,23,117,22,13,9
3,23,118,17,13,4
3,23,119,19,8,11
3,23,120,15,5,10
3,23,121,22,11,11
3,23,122,22,7,15
3,23,123,18,3,15
3,23,124,18,12,6
3,23,125,16,19,-3
3,23,126,22,3,19
3,23,127,31,9,22
3,23,128,39,18,21
3,23,129,17,11,6
3,23,130,18,4,14
3,23,131,15,15,0
3,23,132,19,13,6
3,23,133,17,9,8
3,23,134,7,11,-4
3,23,135,11,15,-4
3,23,136,7,6,1
3,23,137,22,5,17
3,23,138,38,10,28
3,23,139,23,15,8
3,23,140,12,6,6
3,23,141,14,14,0
3,23,142,25,7,18
3,23,143,17,5,12
3,23,144,22,9,13
3,23,145,24,13,11
3,23,146,12,5,7
3,23,147,7,1,6
3,23,148,16,7,9
3,23,149,14,7,7
3,23,150,17,8,9
3,23,151,19,7,12
3,23,152,29,23,6
3,23,153,22,3,19
3,23,154,24,5,19
3,23,155,24,20,4
3,23,156,30,16,14
3,23,157,15,8,7
3,23,158,27,9,18
3,23,159,19,6,13
3,23,160,17,10,7
3,23,161,18,11,7
3,23,162,16,3,13
3,23,163,29,1,28
3,23,164,22,10,12
3,23,165,18,9,9
3,23,166,13,7,6
3,23,167,29,19,10
3,23,168,20,5,15
3,23,169,16,7,9
3,23,170,16,9,7
3,23,171,9,9,0
3,23,172,19,11,8
3,23,173,19,6,13
3,23,174,20,9,11
3,23,175,15,10,5
3,23,176,27,15,12
3,23,177,21,11,10
3,23,178,22,8,14
3,23,179,22,18,4
3,23,180,2,6,-4
3,23,181,27,4,23
3,23,182,21,7,14
3,23,183,29,8,21
3,23,184,22,6,16
3,23,185,19,13,6
3,23,186,39,15,24
3,23,187,21,16,5
3,23,188,16,7,9
3,23,189,17,13,4
3,23,190,29,7,22
3,23,191,24,8,16
3,23,192,27,7,20
3,23,193,18,5,13
3,23,194,21,9,12
3,23,195,32,13,19
3,23,196,8,5,3
3,23,197,14,12,2
3,23,198,14,10,4
3,23,199,27,6,21
3,23,200,14,15,-1
3,23,201,23,9,14
3,23,202,13,9,4
3,23,203,14,6,8
3,23,204,12,6,6
3,23,205,21,14,7
3,23,206,15,10,5
3,23,207,19,12,7
3,23,208,14,14,0
3,23,209,20,18,2
3,23,210,28,11,17
3,23,211,14,6,8
3,23,212,20,9,11
3,23,213,24,10,14
3,23,214,17,6,11
3,23,215,19,9,10
3,23,216,20,5,15
3,23,217,18,4,14
3,23,218,12,10,2
3,23,219,20,8,12
3,23,220,17,3,14
3,23,221,15,8,7
3,23,222,25,15,10
3,23,223,14,8,6
3,23,224,13,5,8
3,23,225,35,12,23
3,23,226,14,14,0
3,23,227,26,10,16
3,23,228,29,9,20
3,23,229,21,5,16
3,23,230,10,12,-2
3,23,231,18,6,12
3,23,232,23,21,2
3,23,233,17,11,6
3,23,234,13,15,-2
3,23,235,14,6,8
3,23,236,27,10,17
3,23,237,18,7,11
3,23,238,18,6,12
3,23,239,24,7,17
3,23,240,19,6,13
3,23,241,10,6,4
3,23,242,13,9,4
3,23,243,34,12,22
3,23,244,24,12,12
3,23,245,5,9,-4
3,23,246,16,5,11
3,23,247,37,11,26
3,23,248,13,11,2
3,23,249,17,9,8
3,23,250,11,4,7
3,23,251,17,14,3
3,23,252,22,7,15
3,23,253,20,4,16
3,23,254,24,5,19
3,23,255,19,8,11
3,23,256,24,9,15
3,23,257,25,11,14
3,23,258,6,3,3
3,23,259,11,10,1
3,23,260,19,14,5
3,23,261,24,13,11
3,23,262,16,19,-3
3,23,263,19,3,16
3,23,264,20,6,14
3,23,265,13,19,-6
3,23,266,5,9,-4
3,23,267,7,11,-4
3,23,268,25,2,23
3,23,269,21,4,17
3,23,270,23,21,2
3,23,271,17,8,9
3,23,272,29,8,21
3,23,273,29,15,14
3,23,274,21,9,12
3,23,275,25,7,18
3,23,276,20,7,13
3,23,277,15,3,12
3,23,278,29,8,21
3,23,279,21,12,9
3,23,280,20,11,9
3,23,281,23,9,14
3,23,282,17,6,11
3,23,283,21,11,10
3,23,284,19,7,12
3,23,285,23,15,8
3,23,286,21,8,13
3,23,287,19,2,17
3,23,288,29,21,8
3,23,289,23,12,11
3,23,290,14,5,9
3,23,291,22,17,5
3,23,292,21,5,16
3,23,293,26,23,3
3,23,294,24,9,15
3,23,295,15,16,-1
3,23,296,21,23,-2
3,23,297,7,4,3
3,23,298,11,6,5
3,23,299,21,10,11
3,24,0,17,10,7
3,24,1,18,13,5
3,24,2,9,5,4
3,24,3,15,7,8
3,24,4,14,11,3
3,24,5,10,8,2
3,24,6,15,3,12
3,24,7,16,11,5
3,24,8,6,7,-1
3,24,9,19,15,4
3,24,10,8,4,4
3,24,11,12,11,1
3,24,12,20,17,3
3,24,13,12,6,6
3,24,14,18,9,9
3,24,15,17,7,10
3,24,16,13,13,0
3,24,17,9,12,-3
3,24,18,16,13,3
3,24,19,22,6,16
3,24,20,16,6,10
3,24,21,33,13,20
3,24,22,22,11,11
3,24,23,11,5,6
3,24,24,9,6,3
3,24,25,13,2,11
3,24,26,12,10,2
3,24,27,17,6,11
3,24,28,7,9,-2
3,24,29,15,9,6
3,24,30,28,11,17
3,24,31,14,7,7
3,24,32,28,10,18
3,24,33,16,11,5
3,24,34,23,6,17
3,24,35,24,11,13
3,24,36,25,13,12
3,24,37,14,3,11
3,24,38,12,12,0
3,24,39,14,7,7
3,24,40,11,9,2
3,24,41,21,7,14
3,24,42,21,8,13
3,24,43,19,10,9
3,24,44,15,13,2
3,24,45,20,9,11
3,24,46,11,3,8
3,24,47,28,5,23
3,24,48,19,6,13
3,24,49,13,7,6
3,24,50,10,12,-2
3,24,51,21,5,16
3,24,52,14,7,7
3,24,53,19,12,7
3,24,54,27,16,11
3,24,55,12,4,8
3,24,56,23,4,19
3,24,57,37,13,24
3,24,58,15,7,8
3,24,59,11,7,4
3,24,60,15,2,13
3,24,61,25,10,15
3,24,62,16,14,2
3,24,63,21,10,11
3,24,64,24,9,15
3,24,65,28,12,16
3,24,66,17,8,9
3,24,67,18,8,10
3,24,68,17,20,-3
3,24,69,19,6,13
3,24,70,20,4,16
3,24,71,9,8,1
3,24,72,18,6,12
3,24,73,25,3,22
3,24,74,19,8,11
3,24,75,10,6,4
3,24,76,12,12,0
3,24,77,20,4,16
3,24,78,20,12,8
3,24,79,19,7,12
3,24,80,11,3,8
3,24,81,19,10,9
3,24,82,21,6,15
3,24,83,27,14,13
3,24,84,18,10,8
3,24,85,21,10,11
3,24,86,20,10,10
3,24,87,17,6,11
3,24,88,24,14,10
3,24,89,10,3,7
3,24,90,27,2,25
3,24,91,22,10,12
3,24,92,16,9,7
3,24,93,5,8,-3
3,24,94,16,5,11
3,24,95,33,13,20
3,24,96,13,9,4
3,24,97,10,0,10
3,24,98,26,17,9
3,24,99,26,6,20
3,24,100,6,8,-2
3,24,101,14,11,3
3,24,102,27,10,17
3,24,103,24,6,18
3,24,104,20,7,13
3,24,105,5,16,-11
3,24,106,18,15,3
3,24,107,33,12,21
3,24,108,25,11,14
3,24,109,20,9,11
3,24,110,15,8,7
3,24,111,14,9,5
3,24,112,12,7,5
3,24,113,12,2,10
3,24,114,42,15,27
3,24,115,16,9,7
3,24,116,8,3,5
3,24,117,20,6,14
3,24,118,12,15,-3
3,24,119,14,4,10
3,24,120,37,6,31
3,24,121,13,12,1
3,24,122,19,13,6
3,24,123,10,8,2
3,24,124,16,6,10
3,24,125,12,1,11
3,24,126,35,9,26
3,24,127,16,5,11
3,24,128,7,9,-2
3,24,129,20,15,5
3,24,130,21,20,1
3,24,131,17,10,7
3,24,132,20,10,10
3,24,133,16,12,4
3,24,134,26,13,13
3,24,135,30,14,16
3,24,136,15,17,-2
3,24,137,21,9,12
3,24,138,14,8,6
3,24,139,21,8,13
3,24,140,18,12,6
3,24,141,16,7,9
3,24,142,15,7,8
3,24,143,32,14,18
3,24,144,11,11,0
3,24,145,17,12,5
3,24,146,19,8,11
3,24,147,18,14,4
3,24,148,17,9,8
3,24,149,11,15,-4
3,24,150,33,8,25
3,24,151,27,10,17
3,24,152,22,6,16
3,24,153,19,11,8
3,24,154,20,16,4
3,24,155,16,14,2
3,24,156,20,9,11
3,24,157,14,9,5
3,24,158,17,12,5
3,24,159,18,10,8
3,24,160,7,15,-8
3,24,161,21,13,8
3,24,162,19,8,11
3,24,163,24,8,16
3,24,164,16,17,-1
3,24,165,22,14,8
3,24,166,26,15,11
3,24,167,9,10,-1
3,24,168,24,9,15
3,24,169,9,12,-3
3,24,170,30,8,22
3,24,171,16,4,12
3,24,172,11,6,5
3,24,173,11,2,9
3,24,174,8,3,5
3,24,175,9,23,-14
3,24,176,16,8,8
3,24,177,24,9,15
3,24,178,8,1,7
3,24,179,16,17,-1
3,24,180,28,19,9
3,24,181,16,16,0
3,24,182,27,8,19
3,24,183,22,7,15
3,24,184,24,7,17
3,24,185,27,15,12
3,24,186,20,7,13
3,24,187,23,6,17
3,24,188,7,8,-1
3,24,189,15,9,6
3,24,190,14,13,1
3,24,191,8,11,-3
3,24,192,14,12,2
3,24,193,36,16,20
3,24,194,11,6,5
3,24,195,11,8,3
3,24,196,20,10,10
3,24,197,20,10,10
3,24,198,20,6,14
3,24,199,19,20,-1
3,24,200,18,10,8
3,24,201,36,16,20
3,24,202,10,2,8
3,24,203,14,9,5
3,24,204,17,9,8
3,24,205,14,14,0
3,24,206,47,19,28
3,24,207,12,16,-4
3,24,208,23,8,15
3,24,209,17,9,8
3,24,210,15,9,6
3,24,211,15,4,11
3,24,212,8,8,0
3,24,213,12,5,7
3,24,214,11,6,5
3,24,215,20,17,3
3,24,216,13,7,6
3,24,217,16,16,0
3,24,218,23,20,3
3,24,219,8,14,-6
3,24,220,6,5,1
3,24,221,12,7,5
3,24,222,24,11,13
3,24,223,22,10,12
3,24,224,14,5,9
3,24,225,12,9,3
3,24,226,15,19,-4
3,24,227,13,3,10
3,24,228,22,8,14
3,24,229,31,11,20
3,24,230,15,13,2
3,24,231,6,3,3
3,24,232,9,6,3
3,24,233,26,16,10
3,24,234,31,12,19
3,24,235,25,11,14
3,24,236,9,7,2
3,24,237,14,14,0
3,24,238,26,6,20
3,24,239,26,8,18
3,24,240,23,17,6
3,24,241,14,16,-2
3,24,242,20,12,8
3,24,243,25,18,7
3,24,244,16,2,14
3,24,245,32,3,29
3,24,246,29,12,17
3,24,247,23,11,12
3,24,248,24,6,18
3,24,249,11,4,7
3,24,250,17,5,12
3,24,251,15,6,9
3,24,252,20,14,6
3,24,253,9,9,0
3,24,254,41,3,38
3,24,255,14,7,7
3,24,256,22,10,12
3,24,257,20,11,9
3,24,258,15,11,4
3,24,259,25,6,19
3,24,260,18,8,10
3,24,261,17,13,4
3,24,262,8,10,-2
3,24,263,14,12,2
3,24,264,24,12,12
3,24,265,15,11,4
3,24,266,19,7,12
3,24,267,22,8,14
3,24,268,12,4,8
3,24,269,18,11,7
3,24,270,7,9,-2
3,24,271,22,15,7
3,24,272,17,7,10
3,24,273,15,14,1
3,24,274,28,6,22
3,24,275,13,4,9
3,24,276,6,11,-5
3,24,277,25,10,15
3,24,278,33,10,23
3,24,279,21,11,10
3,24,280,14,6,8
3,24,281,7,10,-3
3,24,282,27,16,11
3,24,283,28,15,13
3,24,284,12,7,5
3,24,285,29,16,13
3,24,286,16,7,9
3,24,287,12,10,2
3,24,288,14,9,5
3,24,289,26,20,6
3,24,290,12,7,5
3,24,291,19,13,6
3,24,292,19,9,10
3,24,293,16,4,12
3,24,294,21,15,6
3,24,295,16,3,13
3,24,296,12,11,1
3,24,297,18,10,8
3,24,298,24,12,12
3,24,299,29,13,16
3,25,0,25,14,11
3,25,1,22,11,11
3,25,2,35,8,27
3,25,3,13,9,4
3,25,4,14,15,-1
3,25,5,21,9,12
3,25,6,24,8,16
3,25,7,17,12,5
3,25,8,20,2,18
3,25,9,17,8,9
3,25,10,30,4,26
3,25,11,10,10,0
3,25,12,6,1,5
3,25,13,19,1,18
3,25,14,23,9,14
3,25,15,18,11,7
3,25,16,19,16,3
3,25,17,20,4,16
3,25,18,22,5,17
3,25,19,22,9,13
3,25,20,17,10,7
3,25,21,22,20,2
3,25,22,17,12,5
3,25,23,15,14,1
3,25,24,27,5,22
3,25,25,10,5,5
3,25,26,15,10,5
3,25,27,19,10,9
3,25,28,24,14,10
3,25,29,21,24,-3
3,25,30,8,1,7
3,25,31,21,10,11
3,25,32,8,9,-1
3,25,33,33,10,23
3,25,34,25,8,17
3,25,35,31,9,22
3,25,36,26,8,18
3,25,37,18,10,8
3,25,38,7,16,-9
3,25,39,20,9,11
3,25,40,10,11,-1
3,25,41,31,6,25
3,25,42,28,6,22
3,25,43,32,13,19
3,25,44,15,10,5
3,25,45,13,11,2
3,25,46,10,4,6
3,25,47,28,10,18
3,25,48,18,7,11
3,25,49,21,5,16
3,25,50,12,6,6
3,25,51,9,10,-1
3,25,52,20,6,14
3,25,53,17,8,9
3,25,54,13,3,10
3,25,55,6,12,-6
3,25,56,21,12,9
3,25,57,19,4,15
3,25,58,18,14,4
3,25,59,30,11,19
3,25,60,18,7,11
3,25,61,17,8,9
3,25,62,7,4,3
3,25,63,21,9,12
3,25,64,10,9,1
3,25,65,19,6,13
3,25,66,15,10,5
3,25,67,18,13,5
3,25,68,12,8,4
3,25,69,15,1,14
3,25,70,18,10,8
3,25,71,13,7,6
3,25,72,17,9,8
3,25,73,21,8,13
3,25,74,22,19,3
3,25,75,19,12,7
3,25,76,18,13,5
3,25,77,10,5,5
3,25,78,15,8,7
3,25,79,13,5,8
3,25,80,22,6,16
3,25,81,15,8,7
3,25,82,25,20,5
3,25,83,19,6,13
3,25,84,20,13,7
3,25,85,12,9,3
3,25,86,23,16,7
3,25,87,18,6,12
3,25,88,14,4,10
3,25,89,24,9,15
3,25,90,6,5,1
3,25,91,28,13,15
3,25,92,13,13,0
3,25,93,22,4,18
3,25,94,18,4,14
3,25,95,15,11,4
3,25,96,29,12,17
3,25,97,3,9,-6
3,25,98,18,12,6
3,25,99,24,12,12
3,25,100,21,6,15
3,25,101,16,11,5
3,25,102,12,8,4
3,25,103,8,5,3
3,25,104,15,4,11
3,25,105,14,11,3
3,25,106,14,10,4
3,25,107,23,11,12
3,25,108,23,15,8
3,25,109,11,6,5
3,25,110,20,16,4
3,25,111,11,7,4
3,25,112,19,9,10
3,25,113,18,12,6
3,25,114,18,7,11
3,25,115,30,14,16
3,25,116,29,15,14
3,25,117,20,9,11
3,25,118,16,4,12
3,25,119,29,8,21
3,25,120,23,8,15
3,25,121,17,10,7
3,25,122,13,7,6
3,25,123,14,13,1
3,25,124,14,12,2
3,25,125,8,3,5
3,25,126,23,11,12
3,25,127,28,11,17
3,25,128,26,11,15
3,25,129,24,19,5
3,25,130,12,12,0
3,25,131,14,12,2
3,25,132,16,7,9
3,25,133,9,4,5
3,25,134,6,11,-5
3,25,135,22,20,2
3,25,136,44,15,29
3,25,137,18,6,12
3,25,138,20,19,1
3,25,139,20,5,15
3,25,140,22,6,16
3,25,141,13,6,7
3,25,142,13,3,10
3,25,143,12,11,1
3,25,144,15,11,4
3,25,145,16,5,11
3,25,146,6,8,-2
3,25,147,17,10,7
3,25,148,14,17,-3
3,25,149,19,7,12
3,25,150,10,3,7
3,25,151,20,3,17
3,25,152,15,4,11
3,25,153,11,10,1
3,25,154,25,17,8
3,25,155,11,5,6
3,25,156,15,4,11
3,25,157,15,12,3
3,25,158,19,8,11
3,25,159,21,21,0
3,25,160,14,6,8
3,25,161,27,4,23
3,25,162,14,9,5
3,25,163,21,14,7
3,25,164,37,7,30
3,25,165,20,19,1
3,25,166,14,6,8
3,25,167,25,6,19
3,25,168,23,3,20
3,25,169,15,8,7
3,25,170,13,5,8
3,25,171,13,8,5
3,25,172,20,10,10
3,25,173,12,9,3
3,25,174,37,10,27
3,25,175,13,6,7
3,25,176,20,5,15
3,25,177,24,15,9
3,25,178,9,9,0
3,25,179,22,8,14
3,25,180,14,13,1
3,25,181,23,15,8
3,25,182,7,15,-8
3,25,183,10,10,0
3,25,184,20,14,6
3,25,185,15,8,7
3,25,186,19,12,7
3,25,187,19,5,14
3,25,188,30,13,17
3,25,189,15,17,-2
3,25,190,25,10,15
3,25,191,24,4,20
3,25,192,17,10,7
3,25,193,28,10,18
3,25,194,18,7,11
3,25,195,11,10,1
3,25,196,19,4,15
3,25,197,13,18,-5
3,25,198,23,10,13
3,25,199,8,12,-4
3,25,200,26,15,11
3,25,201,18,9,9
3,25,202,22,15,7
3,25,203,26,10,16
3,25,204,16,10,6
3,25,205,30,13,17
3,25,206,17,5,12
3,25,207,28,6,22
3,25,208,24,18,6
3,25,209,15,9,6
3,25,210,18,9,9
3,25,211,25,13,12
3,25,212,8,2,6
3,25,213,32,9,23
3,25,214,9,6,3
3,25,215,11,16,-5
3,25,216,15,12,3
3,25,217,17,3,14
3,25,218,17,15,2
3,25,219,25,9,16
3,25,220,24,14,10
3,25,221,23,6,17
3,25,222,24,10,14
3,25,223,7,9,-2
3,25,224,15,11,4
3,25,225,9,5,4
3,25,226,19,10,9
3,25,227,36,11,25
3,25,228,21,11,10
3,25,229,22,6,16
3,25,230,17,7,10
3,25,231,13,15,-2
3,25,232,14,9,5
3,25,233,40,14,26
3,25,234,18,7,11
3,25,235,33,15,18
3,25,236,23,11,12
3,25,237,8,5,3
3,25,238,27,7,20
3,25,239,16,3,13
3,25,240,12,8,4
3,25,241,23,8,15
3,25,242,17,9,8
3,25,243,13,8,5
3,25,244,18,8,10
3,25,245,31,8,23
3,25,246,15,2,13
3,25,247,17,10,7
3,25,248,23,6,17
3,25,249,6,5,1
3,25,250,25,9,16
3,25,251,34,25,9
3,25,252,19,9,10
3,25,253,16,9,7
3,25,254,15,14,1
3,25,255,14,11,3
3,25,256,24,11,13
3,25,257,22,16,6
3,25,258,15,6,9
3,25,259,7,4,3
3,25,260,14,7,7
3,25,261,8,7,1
3,25,262,15,3,12
3,25,263,19,10,9
3,25,264,28,12,16
3,25,265,30,4,26
3,25,266,22,10,12
3,25,267,14,8,6
3,25,268,34,8,26
3,25,269,31,17,14
3,25,270,14,0,14
3,25,271,12,11,1
3,25,272,21,10,11
3,25,273,24,14,10
3,25,274,12,6,6
3,25,275,14,12,2
3,25,276,17,12,5
3,25,277,20,9,11
3,25,278,18,6,12
3,25,279,21,16,5
3,25,280,16,8,8
3,25,281,24,14,10
3,25,282,29,11,18
3,25,283,28,6,22
3,25,284,20,8,12
3,25,285,21,8,13
3,25,286,21,5,16
3,25,287,21,13,8
3,25,288,35,9,26
3,25,289,36,11,25
3,25,290,17,1,16
3,25,291,7,20,-13
3,25,292,16,8,8
3,25,293,18,9,9
3,25,294,12,11,1
3,25,295,17,12,5
3,25,296,14,9,5
3,25,297,15,9,6
3,25,298,13,2,11
3,25,299,26,19,7
3,26,0,25,3,22
3,26,1,28,12,16
3,26,2,41,17,24
3,26,3,18,8,10
3,26,4,25,11,14
3,26,5,16,7,9
3,26,6,9,9,0
3,26,7,27,14,13
3,26,8,29,8,21
3,26,9,26,6,20
3,26,10,20,9,11
3,26,11,12,1,11
3,26,12,18,8,10
3,26,13,24,8,16
3,26,14,23,7,16
3,26,15,15,12,3
3,26,16,20,11,9
3,26,17,20,11,9
3,26,18,18,5,13
3,26,19,19,5,14
3,26,20,15,12,3
3,26,21,20,9,11
3,26,22,31,8,23
3,26,23,9,8,1
3,26,24,33,11,22
3,26,25,6,6,0
3,26,26,26,6,20
3,26,27,21,12,9
3,26,28,22,13,9
3,26,29,13,6,7
3,26,30,20,13,7
3,26,31,18,20,-2
3,26,32,9,7,2
3,26,33,15,5,10
3,26,34,25,8,17
3,26,35,12,9,3
3,26,36,17,6,11
3,26,37,35,11,24
3,26,38,17,13,4
3,26,39,24,12,12
3,26,40,16,9,7
3,26,41,21,11,10
3,26,42,3,5,-2
3,26,43,25,24,1
3,26,44,12,4,8
3,26,45,9,6,3
3,26,46,21,11,10
3,26,47,23,11,12
3,26,48,27,6,21
3,26,49,18,11,7
3,26,50,33,8,25
3,26,51,19,17,2
3,26,52,13,2,11
3,26,53,28,13,15
3,26,54,17,13,4
3,26,55,10,3,7
3,26,56,14,0,14
3,26,57,22,12,10
3,26,58,10,10,0
3,26,59,25,11,14
3,26,60,14,6,8
3,26,61,14,18,-4
3,26,62,27,10,17
3,26,63,19,4,15
3,26,64,13,6,7
3,26,65,4,5,-1
3,26,66,15,11,4
3,26,67,11,11,0
3,26,68,20,17,3
3,26,69,14,7,7
3,26,70,25,10,15
3,26,71,11,4,7
3,26,72,26,7,19
3,26,73,12,14,-2
3,26,74,33,11,22
3,26,75,16,13,3
3,26,76,16,11,5
3,26,77,14,6,8
3,26,78,28,7,21
3,26,79,23,15,8
3,26,80,18,9,9
3,26,81,9,9,0
3,26,82,18,19,-1
3,26,83,15,7,8
3,26,84,16,8,8
3,26,85,36,8,28
3,26,86,31,6,25
3,26,87,19,9,10
3,26,88,21,12,9
3,26,89,19,4,15
3,26,90,32,12,20
3,26,91,27,5,22
3,26,92,15,7,8
3,26,93,13,3,10
3,26,94,12,16,-4
3,26,95,21,4,17
3,26,96,13,13,0
3,26,97,26,8,18
3,26,98,14,5,9
3,26,99,17,10,7
3,26,100,21,12,9
3,26,101,13,15,-2
3,26,102,20,5,15
3,26,103,23,11,12
3,26,104,27,14,13
3,26,105,28,14,14
3,26,106,18,4,14
3,26,107,9,4,5
3,26,108,20,6,14
3,26,109,21,10,11
3,26,110,17,9,8
3,26,111,17,11,6
3,26,112,21,10,11
3,26,113,14,10,4
3,26,114,19,11,8
3,26,115,16,11,5
3,26,116,21,10,11
3,26,117,21,16,5
3,26,118,24,10,14
3,26,119,13,2,11
3,26,120,25,7,18
3,26,121,13,9,4
3,26,122,16,8,8
3,26,123,21,6,15
3,26,124,11,8,3
3,26,125,9,3,6
3,26,126,21,6,15
3,26,127,14,5,9
3,26,128,20,7,13
3,26,129,11,4,7
3,26,130,17,10,7
3,26,131,35,21,14
3,26,132,12,15,-3
3,26,133,20,7,13
3,26,134,24,8,16
3,26,135,25,2,23
3,26,136,13,11,2
3,26,137,26,15,11
3,26,138,26,10,16
3,26,139,21,7,14
3,26,140,26,15,11
3,26,141,14,8,6
3,26,142,24,10,14
3,26,143,8,9,-1
3,26,144,12,8,4
3,26,145,16,8,8
3,26,146,13,8,5
3,26,147,17,9,8
3,26,148,32,10,22
3,26,149,21,12,9
3,26,150,16,4,12
3,26,151,33,8,25
3,26,152,28,17,11
3,26,153,16,7,9
3,26,154,20,6,14
3,26,155,17,5,12
3,26,156,23,5,18
3,26,157,19,3,16
3,26,158,26,7,19
3,26,159,22,14,8
3,26,160,20,12,8
3,26,161,9,2,7
3,26,162,11,7,4
3,26,163,15,9,6
3,26,164,18,7,11
3,26,165,23,3,20
3,26,166,16,11,5
3,26,167,12,5,7
3,26,168,27,5,22
3,26,169,34,15,19
3,26,170,14,15,-1
3,26,171,28,16,12
3,26,172,12,13,-1
3,26,173,22,7,15
3,26,174,6,6,0
3,26,175,17,6,11
3,26,176,24,19,5
3,26,177,31,8,23
3,26,178,14,11,3
3,26,179,9,10,-1
3,26,180,22,8,14
3,26,181,15,8,7
3,26,182,26,15,11
3,26,183,15,8,7
3,26,184,21,13,8
3,26,185,10,8,2
3,26,186,27,9,18
3,26,187,27,8,19
3,26,188,17,4,13
3,26,189,17,10,7
3,26,190,10,13,-3
3,26,191,17,8,9
3,26,192,16,4,12
3,26,193,13,4,9
3,26,194,40,6,34
3,26,195,13,4,9
3,26,196,20,5,15
3,26,197,23,10,13
3,26,198,18,10,8
3,26,199,20,3,17
3,26,200,17,15,2
3,26,201,36,9,27
3,26,202,17,15,2
3,26,203,4,11,-7
3,26,204,14,8,6
3,26,205,23,8,15
3,26,206,19,12,7
3,26,207,13,7,6
3,26,208,27,8,19
3,26,209,24,14,10
3,26,210,12,4,8
3,26,211,21,13,8
3,26,212,21,10,11
3,26,213,22,7,15
3,26,214,29,8,21
3,26,215,31,10,21
3,26,216,16,9,7
3,26,217,23,6,17
3,26,218,12,2,10
3,26,219,15,2,13
3,26,220,26,27,-1
3,26,221,27,16,11
3,26,222,17,3,14
3,26,223,16,6,10
3,26,224,21,11,10
3,26,225,13,13,0
3,26,226,11,7,4
3,26,227,17,6,11
3,26,228,23,9,14
3,26,229,10,7,3
3,26,230,14,7,7
3,26,231,19,14,5
3,26,232,10,12,-2
3,26,233,26,12,14
3,26,234,16,7,9
3,26,235,5,11,-6
3,26,236,30,8,22
3,26,237,39,12,27
3,26,238,24,7,17
3,26,239,19,12,7
3,26,240,21,8,13
3,26,241,16,5,11
3,26,242,20,3,17
3,26,243,21,7,14
3,26,244,18,13,5
3,26,245,26,9,17
3,26,246,19,4,15
3,26,247,14,10,4
3,26,248,29,10,19
3,26,249,16,8,8
3,26,250,16,10,6
3,26,251,22,5,17
3,26,252,16,12,4
3,26,253,22,9,13
3,26,254,14,8,6
3,26,255,35,12,23
3,26,256,10,8,2
3,26,257,13,7,6
3,26,258,18,7,11
3,26,259,15,7,8
3,26,260,13,8,5
3,26,261,22,4,18
3,26,262,8,11,-3
3,26,263,24,11,13
3,26,264,29,15,14
3,26,265,28,14,14
3,26,266,25,13,12
3,26,267,13,16,-3
3,26,268,23,5,18
3,26,269,26,12,14
3,26,270,12,8,4
3,26,271,6,2,4
3,26,272,13,3,10
3,26,273,26,14,12
3,26,274,16,14,2
3,26,275,20,11,9
3,26,276,12,9,3
3,26,277,30,4,26
3,26,278,17,2,15
3,26,279,12,8,4
3,26,280,18,7,11
3,26,281,19,11,8
3,26,282,16,13,3
3,26,283,16,14,2
3,26,284,29,8,21
3,26,285,12,5,7
3,26,286,27,15,12
3,26,287,22,5,17
3,26,288,27,16,11
3,26,289,18,5,13
3,26,290,14,1,13
3,26,291,43,11,32
3,26,292,13,9,4
3,26,293,10,7,3
3,26,294,13,11,2
3,26,295,19,10,9
3,26,296,18,3,15
3,26,297,20,12,8
3,26,298,35,8,27
3,26,299,15,10,5
3,27,0,27,5,22
3,27,1,33,16,17
3,27,2,18,10,8
3,27,3,15,7,8
3,27,4,10,5,5
3,27,5,19,17,2
3,27,6,13,12,1
3,27,7,8,4,4
3,27,8,13,10,3
3,27,9,37,8,29
3,27,10,23,12,11
3,27,11,11,6,5
3,27,12,28,18,10
3,27,13,39,11,28
3,27,14,13,14,-1
3,27,15,23,10,13
3,27,16,9,10,-1
3,27,17,29,5,24
3,27,18,19,7,12
3,27,19,17,13,4
3,27,20,16,10,6
3,27,21,17,3,14
3,27,22,12,9,3
3,27,23,16,8,8
3,27,24,32,12,20
3,27,25,8,8,0
3,27,26,15,9,6
3,27,27,18,9,9
3,27,28,21,1,20
3,27,29,15,10,5
3,27,30,21,6,15
3,27,31,28,9,19
3,27,32,15,3,12
3,27,33,20,10,10
3,27,34,16,7,9
3,27,35,25,13,12
3,27,36,16,3,13
3,27,37,10,3,7
3,27,38,11,7,4
3,27,39,19,10,9
3,27,40,21,7,14
3,27,41,19,1,18
3,27,42,20,10,10
3,27,43,19,13,6
3,27,44,26,19,7
3,27,45,12,9,3
3,27,46,9,7,2
3,27,47,9,8,1
3,27,48,17,5,12
3,27,49,19,11,8
3,27,50,10,6,4
3,27,51,21,10,11
3,27,52,14,5,9
3,27,53,38,18,20
3,27,54,25,16,9
3,27,55,41,6,35
3,27,56,26,5,21
3,27,57,26,14,12
3,27,58,31,5,26
3,27,59,14,10,4
3,27,60,20,6,14
3,27,61,9,4,5
3,27,62,15,11,4
3,27,63,15,9,6
3,27,64,15,4,11
3,27,65,14,9,5
3,27,66,21,10,11
3,27,67,22,14,8
3,27,68,13,7,6
3,27,69,13,16,-3
3,27,70,21,8,13
3,27,71,21,13,8
3,27,72,30,12,18
3,27,73,26,12,14
3,27,74,15,12,3
3,27,75,24,7,17
3,27,76,22,11,11
3,27,77,29,10,19
3,27,78,16,6,10
3,27,79,18,10,8
3,27,80,16,3,13
3,27,81,32,10,22
3,27,82,15,17,-2
3,27,83,11,2,9
3,27,84,19,6,13
3,27,85,21,7,14
3,27,86,19,5,14
3,27,87,15,14,1
3,27,88,12,4,8
3,27,89,25,20,5
3,27,90,13,11,2
3,27,91,23,15,8
3,27,92,22,5,17
3,27,93,14,6,8
3,27,94,27,11,16
3,27,95,15,4,11
3,27,96,18,8,10
3,27,97,25,11,14
3,27,98,29,15,14
3,27,99,25,16,9
3,27,100,13,5,8
3,27,101,39,9,30
3,27,102,17,5,12
3,27,103,17,12,5
3,27,104,6,18,-12
3,27,105,17,5,12
3,27,106,12,4,8
3,27,107,13,10,3
3,27,108,12,4,8
3,27,109,19,11,8
3,27,110,27,10,17
3,27,111,17,5,12
3,27,112,24,10,14
3,27,113,17,18,-1
3,27,114,33,19,14
3,27,115,27,6,21
3,27,116,23,5,18
3,27,117,17,14,3
3,27,118,40,16,24
3,27,119,22,6,16
3,27,120,13,9,4
3,27,121,23,5,18
3,27,122,25,4,21
3,27,123,21,23,-2
3,27,124,26,6,20
3,27,125,14,11,3
3,27,126,30,11,19
3,27,127,19,3,16
3,27,128,28,9,19
3,27,129,14,6,8
3,27,130,20,6,14
3,27,131,26,9,17
3,27,132,10,5,5
3,27,133,19,8,11
3,27,134,25,5,20
3,27,135,16,3,13
3,27,136,14,4,10
3,27,137,18,4,14
3,27,138,30,11,19
3,27,139,25,15,10
3,27,140,29,15,14
3,27,141,20,6,14
3,27,142,9,6,3
3,27,143,26,10,16
3,27,144,11,5,6
3,27,145,15,2,13
3,27,146,19,16,3
3,27,147,11,5,6
3,27,148,13,5,8
3,27,149,24,13,11
3,27,150,24,7,17
3,27,151,13,10,3
3,27,152,29,10,19
3,27,153,24,7,17
3,27,154,13,17,-4
3,27,155,19,12,7
3,27,156,24,9,15
3,27,157,19,3,16
3,27,158,14,6,8
3,27,159,21,8,13
3,27,160,26,16,10
3,27,161,7,6,1
3,27,162,19,1,18
3,27,163,19,5,14
3,27,164,20,9,11
3,27,165,26,4,22
3,27,166,16,15,1
3,27,167,24,14,10
3,27,168,13,3,10
3,27,169,12,11,1
3,27,170,15,7,8
3,27,171,18,2,16
3,27,172,20,11,9
3,27,173,15,5,10
3,27,174,36,4,32
3,27,175,27,10,17
3,27,176,28,11,17
3,27,177,16,6,10
3,27,178,20,12,8
3,27,179,18,6,12
3,27,180,20,12,8
3,27,181,27,12,15
3,27,182,20,16,4
3,27,183,38,12,26
3,27,184,15,10,5
3,27,185,16,4,12
3,27,186,18,6,12
3,27,187,30,14,16
3,27,188,17,25,-8
3,27,189,12,9,3
3,27,190,22,7,15
3,27,191,24,5,19
3,27,192,14,12,2
3,27,193,19,5,14
3,27,194,15,4,11
3,27,195,8,6,2
3,27,196,16,17,-1
3,27,197,19,14,5
3,27,198,29,11,18
3,27,199,25,15,10
3,27,200,13,18,-5
3,27,201,24,4,20
3,27,202,20,11,9
3,27,203,4,7,-3
3,27,204,21,2,19
3,27,205,7,4,3
3,27,206,23,4,19
3,27,207,11,10,1
3,27,208,28,9,19
3,27,209,17,4,13
3,27,210,16,7,9
3,27,211,24,6,18
3,27,212,18,18,0
3,27,213,30,15,15
3,27,214,13,6,7
3,27,215,16,2,14
3,27,216,18,5,13
3,27,217,27,9,18
3,27,218,9,6,3
3,27,219,19,2,17
3,27,220,34,8,26
3,27,221,15,8,7
3,27,222,25,9,16
3,27,223,19,5,14
3,27,224,12,12,0
3,27,225,17,11,6
3,27,226,15,9,6
3,27,227,9,11,-2
3,27,228,13,9,4
3,27,229,23,11,12
3,27,230,26,9,17
3,27,231,20,12,8
3,27,232,15,6,9
3,27,233,13,8,5
3,27,234,23,8,15
3,27,235,21,13,8
3,27,236,20,16,4
3,27,237,13,26,-13
3,27,238,22,11,11
3,27,239,31,17,14
3,27,240,15,11,4
3,27,241,18,13,5
3,27,242,17,8,9
3,27,243,12,7,5
3,27,244,19,6,13
3,27,245,18,15,3
3,27,246,31,22,9
3,27,247,15,5,10
3,27,248,14,11,3
3,27,249,11,11,0
3,27,250,24,17,7
3,27,251,17,24,-7
3,27,252,26,9,17
3,27,253,19,5,14
3,27,254,9,14,-5
3,27,255,13,8,5
3,27,256,10,9,1
3,27,257,18,11,7
3,27,258,23,6,17
3,27,259,27,16,11
3,27,260,19,12,7
3,27,261,19,11,8
3,27,262,7,7,0
3,27,263,28,10,18
3,27,264,31,18,13
3,27,265,30,12,18
3,27,266,8,3,5
3,27,267,18,7,11
3,27,268,15,6,9
3,27,269,22,7,15
3,27,270,21,3,18
3,27,271,22,6,16
3,27,272,11,6,5
3,27,273,20,8,12
3,27,274,5,9,-4
3,27,275,10,5,5
3,27,276,4,10,-6
3,27,277,15,7,8
3,27,278,8,9,-1
3,27,279,24,11,13
3,27,280,38,4,34
3,27,281,18,9,9
3,27,282,20,6,14
3,27,283,28,12,16
3,27,284,17,15,2
3,27,285,25,10,15
3,27,286,27,2,25
3,27,287,35,11,24
3,27,288,20,7,13
3,27,289,19,7,12
3,27,290,33,10,23
3,27,291,24,15,9
3,27,292,19,4,15
3,27,293,19,4,15
3,27,294,10,16,-6
3,27,295,8,11,-3
3,27,296,21,8,13
3,27,297,13,8,5
3,27,298,13,8,5
3,27,299,21,9,12
3,28,0,14,13,1
3,28,1,14,7,7
3,28,2,25,9,16
3,28,3,18,6,12
3,28,4,10,8,2
3,28,5,15,3,12
3,28,6,11,1,10
3,28,7,5,4,1
3,28,8,15,6,9
3,28,9,7,3,4
3,28,10,11,10,1
3,28,11,14,4,10
3,28,12,14,9,5
3,28,13,17,12,5
3,28,14,22,9,13
3,28,15,10,7,3
3,28,16,19,17,2
3,28,17,16,7,9
3,28,18,18,11,7
3,28,19,17,11,6
3,28,20,20,9,11
3,28,21,27,15,12
3,28,22,20,7,13
3,28,23,30,13,17
3,28,24,21,12,9
3,28,25,26,5,21
3,28,26,21,7,14
3,28,27,12,6,6
3,28,28,11,9,2
3,28,29,5,3,2
3,28,30,24,3,21
3,28,31,11,5,6
3,28,32,17,11,6
3,28,33,16,6,10
3,28,34,13,7,6
3,28,35,18,4,14
3,28,36,24,6,18
3,28,37,27,8,19
3,28,38,12,5,7
3,28,39,21,8,13
3,28,40,20,11,9
3,28,41,20,14,6
3,28,42,6,3,3
3,28,43,17,3,14
3,28,44,15,4,11
3,28,45,19,15,4
3,28,46,14,1,13
3,28,47,18,1,17
3,28,48,15,11,4
3,28,49,19,9,10
3,28,50,16,7,9
3,28,51,19,11,8
3,28,52,15,7,8
3,28,53,18,12,6
3,28,54,39,10,29
3,28,55,12,2,10
3,28,56,14,2,12
3,28,57,15,11,4
3,28,58,26,20,6
3,28,59,27,13,14
3,28,60,15,4,11
3,28,61,24,18,6
3,28,62,31,12,19
3,28,63,18,12,6
3,28,64,17,7,10
3,28,65,18,7,11
3,28,66,17,9,8
3,28,67,16,5,11
3,28,68,14,16,-2
3,28,69,15,3,12
3,28,70,20,6,14
3,28,71,8,7,1
3,28,72,21,6,15
3,28,73,18,5,13
3,28,74,19,7,12
3,28,75,9,2,7
3,28,76,25,16,9
3,28,77,10,6,4
3,28,78,13,4,9
3,28,79,20,9,11
3,28,80,23,20,3
3,28,81,17,7,10
3,28,82,21,8,13
3,28,83,16,20,-4
3,28,84,14,7,7
3,28,85,26,13,13
3,28,86,20,10,10
3,28,87,26,2,24
3,28,88,34,5,29
3,28,89,15,1,14
3,28,90,17,11,6
3,28,91,21,12,9
3,28,92,27,8,19
3,28,93,27,5,22
3,28,94,22,12,10
3,28,95,12,8,4
3,28,96,20,7,13
3,28,97,15,8,7
3,28,98,18,4,14
3,28,99,32,18,14
3,28,100,29,10,19
3,28,101,30,17,13
3,28,102,13,19,-6
3,28,103,20,6,14
3,28,104,22,10,12
3,28,105,27,14,13
3,28,106,10,5,5
3,28,107,21,16,5
3,28,108,15,7,8
3,28,109,18,10,8
3,28,110,18,7,11
3,28,111,12,7,5
3,28,112,20,19,1
3,28,113,9,2,7
3,28,114,21,7,14
3,28,115,22,8,14
3,28,116,16,13,3
3,28,117,10,9,1
3,28,118,25,9,16
3,28,119,24,7,17
3,28,120,15,7,8
3,28,121,15,3,12
3,28,122,11,9,2
3,28,123,6,6,0
3,28,124,21,9,12
3,28,125,6,1,5
3,28,126,25,6,19
3,28,127,15,16,-1
3,28,128,14,12,2
3,28,129,13,8,5
3,28,130,19,12,7
3,28,131,19,9,10
3,28,132,12,10,2
3,28,133,21,6,15
3,28,134,8,1,7
3,28,135,25,16,9
3,28,136,13,10,3
3,28,137,11,8,3
3,28,138,21,6,15
3,28,139,25,13,12
3,28,140,26,10,16
3,28,141,18,3,15
3,28,142,28,13,15
3,28,143,10,10,0
3,28,144,14,9,5
3,28,145,27,7,20
3,28,146,18,8,10
3,28,147,22,11,11
3,28,148,30,10,20
3,28,149,5,3,2
3,28,150,24,10,14
3,28,151,20,12,8
3,28,152,18,7,11
3,28,153,16,7,9
3,28,154,14,12,2
3,28,155,20,5,15
3,28,156,12,5,7
3,28,157,17,9,8
3,28,158,37,16,21
3,28,159,35,14,21
3,28,160,20,6,14
3,28,161,6,0,6
3,28,162,13,6,7
3,28,163,21,6,15
3,28,164,21,10,11
3,28,165,11,4,7
3,28,166,23,9,14
3,28,167,15,5,10
3,28,168,28,13,15
3,28,169,29,4,25
3,28,170,28,9,19
3,28,171,25,13,12
3,28,172,13,9,4
3,28,173,19,11,8
3,28,174,19,6,13
3,28,175,21,8,13
3,28,176,29,6,23
3,28,177,16,3,13
3,28,178,8,9,-1
3,28,179,10,5,5
3,28,180,23,13,10
3,28,181,18,7,11
3,28,182,20,4,16
3,28,183,17,6,11
3,28,184,20,3,17
3,28,185,12,10,2
3,28,186,26,10,16
3,28,187,22,6,16
3,28,188,16,5,11
3,28,189,14,8,6
3,28,190,30,14,16
3,28,191,6,10,-4
3,28,192,13,6,7
3,28,193,25,10,15
3,28,194,16,11,5
3,28,195,12,9,3
3,28,196,5,9,-4
3,28,197,52,3,49
3,28,198,20,12,8
3,28,199,10,5,5
3,28,200,23,8,15
3,28,201,20,7,13
3,28,202,12,5,7
3,28,203,10,11,-1
3,28,204,7,13,-6
3,28,205,16,15,1
3,28,206,30,11,19
3,28,207,26,8,18
3,28,208,23,14,9
3,28,209,32,11,21
3,28,210,15,6,9
3,28,211,12,7,5
3,28,212,17,11,6
3,28,213,15,10,5
3,28,214,23,10,13
3,28,215,36,11,25
3,28,216,11,4,7
3,28,217,14,7,7
3,28,218,24,13,11
3,28,219,28,11,17
3,28,220,13,18,-5
3,28,221,16,17,-1
3,28,222,16,7,9
3,28,223,17,0,17
3,28,224,19,7,12
3,28,225,11,20,-9
3,28,226,25,7,18
3,28,227,21,3,18
3,28,228,14,9,5
3,28,229,23,9,14
3,28,230,21,2,19
3,28,231,15,3,12
3,28,232,16,6,10
3,28,233,25,7,18
3,28,234,18,5,13
3,28,235,12,5,7
3,28,236,23,8,15
3,28,237,14,17,-3
3,28,238,16,9,7
3,28,239,22,12,10
3,28,240,24,15,9
3,28,241,23,13,10
3,28,242,8,9,-1
3,28,243,31,8,23
3,28,244,16,4,12
3,28,245,23,11,12
3,28,246,33,9,24
3,28,247,21,4,17
3,28,248,22,9,13
3,28,249,18,4,14
3,28,250,13,6,7
3,28,251,19,9,10
3,28,252,21,14,7
3,28,253,12,2,10
3,28,254,20,9,11
3,28,255,19,7,12
3,28,256,15,2,13
3,28,257,25,16,9
3,28,258,8,4,4
3,28,259,15,6,9
3,28,260,19,9,10
3,28,261,21,10,11
3,28,262,6,11,-5
3,28,263,20,7,13
3,28,264,26,7,19
3,28,265,25,5,20
3,28,266,12,8,4
3,28,267,17,9,8
3,28,268,17,20,-3
3,28,269,18,6,12
3,28,270,26,7,19
3,28,271,10,10,0
3,28,272,14,8,6
3,28,273,23,11,12
3,28,274,20,13,7
3,28,275,11,4,7
3,28,276,22,14,8
3,28,277,26,5,21
3,28,278,20,13,7
3,28,279,35,12,23
3,28,280,23,7,16
3,28,281,10,7,3
3,28,282,36,7,29
3,28,283,22,6,16
3,28,284,31,11,20
3,28,285,16,11,5
3,28,286,29,4,25
3,28,287,9,4,5
3,28,288,18,19,-1
3,28,289,8,8,0
3,28,290,21,2,19
3,28,291,19,10,9
3,28,292,15,10,5
3,28,293,10,9,1
3,28,294,28,11,17
3,28,295,25,10,15
3,28,296,17,9,8
3,28,297,29,10,19
3,28,298,6,3,3
3,28,299,16,7,9
3,29,0,24,10,14
3,29,1,16,8,8
3,29,2,26,2,24
3,29,3,29,3,26
3,29,4,22,4,18
3,29,5,21,7,14
3,29,6,25,17,8
3,29,7,14,11,3
3,29,8,29,6,23
3,29,9,38,20,18
3,29,10,14,8,6
3,29,11,19,12,7
3,29,12,22,9,13
3,29,13,13,13,0
3,29,14,15,0,15
3,29,15,16,2,14
3,29,16,25,9,16
3,29,17,21,17,4
3,29,18,12,12,0
3,29,19,36,4,32
3,29,20,24,9,15
3,29,21,10,8,2
3,29,22,21,5,16
3,29,23,12,5,7
3,29,24,22,8,14
3,29,25,31,16,15
3,29,26,30,3,27
3,29,27,22,8,14
3,29,28,21,13,8
3,29,29,18,3,15
3,29,30,19,9,10
3,29,31,21,4,17
3,29,32,10,3,7
3,29,33,27,6,21
3,29,34,14,11,3
3,29,35,32,13,19
3,29,36,23,14,9
3,29,37,21,14,7
3,29,38,12,8,4
3,29,39,20,11,9
3,29,40,7,3,4
3,29,41,18,13,5
3,29,42,14,5,9
3,29,43,8,9,-1
3,29,44,36,12,24
3,29,45,31,12,19
3,29,46,18,6,12
3,29,47,22,2,20
3,29,48,14,9,5
3,29,49,13,7,6
3,29,50,17,10,7
3,29,51,18,5,13
3,29,52,19,7,12
3,29,53,20,5,15
3,29,54,19,17,2
3,29,55,21,18,3
3,29,56,18,17,1
3,29,57,23,18,5
3,29,58,16,4,12
3,29,59,19,7,12
3,29,60,23,6,17
3,29,61,24,3,21
3,29,62,21,15,6
3,29,63,13,13,0
3,29,64,22,2,20
3,29,65,18,6,12
3,29,66,27,7,20
3,29,67,28,4,24
3,29,68,14,14,0
3,29,69,26,14,12
3,29,70,8,10,-2
3,29,71,13,8,5
3,29,72,25,8,17
3,29,73,27,11,16
3,29,74,23,3,20
3,29,75,5,3,2
3,29,76,21,5,16
3,29,77,38,13,25
3,29,78,18,5,13
3,29,79,18,3,15
3,29,80,33,21,12
3,29,81,28,3,25
3,29,82,20,13,7
3,29,83,27,13,14
3,29,84,24,10,14
3,29,85,29,9,20
3,29,86,9,6,3
3,29,87,21,5,16
3,29,88,32,7,25
3,29,89,13,19,-6
3,29,90,21,8,13
3,29,91,15,5,10
3,29,92,16,9,7
3,29,93,21,16,5
3,29,94,12,4,8
3,29,95,24,6,18
3,29,96,27,9,18
3,29,97,18,9,9
3,29,98,15,4,11
3,29,99,7,3,4
3,29,100,23,7,16
3,29,101,25,10,15
3,29,102,15,6,9
3,29,103,18,4,14
3,29,104,10,5,5
3,29,105,20,14,6
3,29,106,15,8,7
3,29,107,19,8,11
3,29,108,29,9,20
3,29,109,10,8,2
3,29,110,25,13,12
3,29,111,19,9,10
3,29,112,11,16,-5
3,29,113,18,8,10
3,29,114,24,8,16
3,29,115,25,6,19
3,29,116,15,5,10
3,29,117,31,10,21
3,29,118,27,5,22
3,29,119,11,2,9
3,29,120,11,5,6
3,29,121,20,11,9
3,29,122,29,11,18
3,29,123,28,15,13
3,29,124,18,3,15
3,29,125,37,7,30
3,29,126,14,6,8
3,29,127,31,8,23
3,29,128,31,13,18
3,29,129,20,3,17
3,29,130,26,9,17
3,29,131,27,10,17
3,29,132,32,5,27
3,29,133,12,12,0
3,29,134,25,5,20
3,29,135,16,7,9
3,29,136,13,14,-1
3,29,137,21,6,15
3,29,138,31,19,12
3,29,139,16,6,10
3,29,140,17,10,7
3,29,141,16,5,11
3,29,142,19,7,12
3,29,143,14,11,3
3,29,144,18,8,10
3,29,145,12,16,-4
3,29,146,18,9,9
3,29,147,21,14,7
3,29,148,31,5,26
3,29,149,18,12,6
3,29,150,24,10,14
3,29,151,27,8,19
3,29,152,21,7,14
3,29,153,21,7,14
3,29,154,20,4,16
3,29,155,16,6,10
3,29,156,27,8,19
3,29,157,18,12,6
3,29,158,13,7,6
3,29,159,7,3,4
3,29,160,13,10,3
3,29,161,34,12,22
3,29,162,23,13,10
3,29,163,15,8,7
3,29,164,21,14,7
3,29,165,20,8,12
3,29,166,15,4,11
3,29,167,13,7,6
3,29,168,11,4,7
3,29,169,33,6,27
3,29,170,12,5,7
3,29,171,18,6,12
3,29,172,32,5,27
3,29,173,21,12,9
3,29,174,44,11,33
3,29,175,26,6,20
3,29,176,16,16,0
3,29,177,8,3,5
3,29,178,26,20,6
3,29,179,16,5,11
3,29,180,11,10,1
3,29,181,23,3,20
3,29,182,18,6,12
3,29,183,25,16,9
3,29,184,11,6,5
3,29,185,20,9,11
3,29,186,26,6,20
3,29,187,6,1,5
3,29,188,18,2,16
3,29,189,12,9,3
3,29,190,4,10,-6
3,29,191,9,8,1
3,29,192,29,15,14
3,29,193,15,5,10
3,29,194,20,3,17
3,29,195,19,11,8
3,29,196,14,6,8
3,29,197,17,26,-9
3,29,198,23,5,18
3,29,199,13,2,11
3,29,200,14,3,11
3,29,201,17,11,6
3,29,202,8,4,4
3,29,203,25,13,12
3,29,204,9,11,-2
3,29,205,21,13,8
3,29,206,9,6,3
3,29,207,8,11,-3
3,29,208,24,11,13
3,29,209,37,7,30
3,29,210,11,7,4
3,29,211,30,3,27
3,29,212,13,1,12
3,29,213,27,7,20
3,29,214,17,9,8
3,29,215,39,21,18
3,29,216,25,6,19
3,29,217,16,6,10
3,29,218,6,5,1
3,29,219,6,6,0
3,29,220,14,17,-3
3,29,221,14,13,1
3,29,222,23,11,12
3,29,223,30,10,20
3,29,224,15,13,2
3,29,225,22,12,10
3,29,226,21,8,13
3,29,227,30,17,13
3,29,228,25,10,15
3,29,229,9,5,4
3,29,230,7,13,-6
3,29,231,27,5,22
3,29,232,21,6,15
3,29,233,20,5,15
3,29,234,19,8,11
3,29,235,19,13,6
3,29,236,15,6,9
3,29,237,17,10,7
3,29,238,19,8,11
3,29,239,10,3,7
3,29,240,26,8,18
3,29,241,28,13,15
3,29,242,18,10,8
3,29,243,26,8,18
3,29,244,28,9,19
3,29,245,9,6,3
3,29,246,15,6,9
3,29,247,24,15,9
3,29,248,11,4,7
3,29,249,22,5,17
3,29,250,16,3,13
3,29,251,4,5,-1
3,29,252,8,9,-1
3,29,253,6,2,4
3,29,254,13,2,11
3,29,255,21,10,11
3,29,256,17,11,6
3,29,257,27,19,8
3,29,258,13,3,10
3,29,259,19,11,8
3,29,260,16,9,7
3,29,261,21,5,16
3,29,262,9,10,-1
3,29,263,13,7,6
3,29,264,33,6,27
3,29,265,16,9,7
3,29,266,14,5,9
3,29,267,15,10,5
3,29,268,20,7,13
3,29,269,28,4,24
3,29,270,11,8,3
3,29,271,31,9,22
3,29,272,19,6,13
3,29,273,15,1,14
3,29,274,16,13,3
3,29,275,15,5,10
3,29,276,12,1,11
3,29,277,10,14,-4
3,29,278,35,14,21
3,29,279,20,6,14
3,29,280,17,6,11
3,29,281,29,9,20
3,29,282,17,11,6
3,29,283,27,10,17
3,29,284,19,13,6
3,29,285,16,7,9
3,29,286,21,15,6
3,29,287,20,4,16
3,29,288,21,17,4
3,29,289,21,3,18
3,29,290,11,6,5
3,29,291,20,11,9
3,29,292,14,6,8
3,29,293,27,11,16
3,29,294,9,3,6
3,29,295,22,8,14
3,29,296,19,14,5
3,29,297,25,13,12
3,29,298,10,6,4
3,29,299,6,6,0
3,30,0,15,4,11
3,30,1,16,4,12
3,30,2,11,7,4
3,30,3,24,8,16
3,30,4,18,8,10
3,30,5,11,5,6
3,30,6,28,7,21
3,30,7,15,6,9
3,30,8,16,8,8
3,30,9,27,19,8
3,30,10,6,6,0
3,30,11,22,7,15
3,30,12,13,12,1
3,30,13,32,14,18
3,30,14,11,10,1
3,30,15,12,7,5
3,30,16,3,0,3
3,30,17,21,7,14
3,30,18,26,16,10
3,30,19,14,8,6
3,30,20,18,5,13
3,30,21,5,5,0
3,30,22,21,8,13
3,30,23,18,7,11
3,30,24,20,4,16
3,30,25,9,10,-1
3,30,26,24,10,14
3,30,27,15,11,4
3,30,28,24,4,20
3,30,29,14,7,7
3,30,30,14,13,1
3,30,31,17,5,12
3,30,32,29,7,22
3,30,33,5,2,3
3,30,34,17,7,10
3,30,35,14,5,9
3,30,36,26,14,12
3,30,37,19,11,8
3,30,38,14,9,5
3,30,39,29,3,26
3,30,40,14,8,6
3,30,41,19,9,10
3,30,42,23,6,17
3,30,43,17,12,5
3,30,44,18,11,7
3,30,45,10,10,0
3,30,46,21,5,16
3,30,47,5,4,1
3,30,48,29,3,26
3,30,49,7,7,0
3,30,50,24,6,18
3,30,51,20,19,1
3,30,52,19,17,2
3,30,53,19,10,9
3,30,54,14,5,9
3,30,55,11,4,7
3,30,56,21,14,7
3,30,57,18,4,14
3,30,58,11,0,11
3,30,59,26,9,17
3,30,60,21,5,16
3,30,61,27,7,20
3,30,62,29,6,23
3,30,63,12,9,3
3,30,64,11,12,-1
3,30,65,24,16,8
3,30,66,27,12,15
3,30,67,24,5,19
3,30,68,30,11,19
3,30,69,17,8,9
3,30,70,10,2,8
3,30,71,13,7,6
3,30,72,25,4,21
3,30,73,26,9,17
3,30,74,26,8,18
3,30,75,21,6,15
3,30,76,7,4,3
3,30,77,19,8,11
3,30,78,24,3,21
3,30,79,25,13,12
3,30,80,23,9,14
3,30,81,30,14,16
3,30,82,15,9,6
3,30,83,9,11,-2
3,30,84,28,7,21
3,30,85,29,5,24
3,30,86,10,4,6
3,30,87,16,9,7
3,30,88,15,8,7
3,30,89,28,5,23
3,30,90,14,11,3
3,30,91,25,5,20
3,30,92,21,11,10
3,30,93,21,6,15
3,30,94,19,2,17
3,30,95,9,8,1
3,30,96,13,12,1
3,30,97,26,11,15
3,30,98,15,12,3
3,30,99,24,9,15
3,30,100,17,8,9
3,30,101,20,5,15
3,30,102,24,15,9
3,30,103,25,10,15
3,30,104,15,9,6
3,30,105,9,9,0
3,30,106,15,8,7
3,30,107,9,10,-1
3,30,108,17,9,8
3,30,109,17,4,13
3,30,110,22,19,3
3,30,111,16,14,2
3,30,112,21,4,17
3,30,113,35,9,26
3,30,114,14,5,9
3,30,115,16,6,10
3,30,116,37,15,22
3,30,117,16,4,12
3,30,118,22,1,21
3,30,119,23,5,18
3,30,120,9,8,1
3,30,121,19,1,18
3,30,122,20,10,10
3,30,123,33,6,27
3,30,124,30,19,11
3,30,125,6,5,1
3,30,126,16,9,7
3,30,127,25,7,18
3,30,128,26,13,13
3,30,129,9,1,8
3,30,130,17,10,7
3,30,131,12,8,4
3,30,132,31,20,11
3,30,133,31,6,25
3,30,134,10,6,4
3,30,135,17,18,-1
3,30,136,25,8,17
3,30,137,17,3,14
3,30,138,17,7,10
3,30,139,18,12,6
3,30,140,21,14,7
3,30,141,34,4,30
3,30,142,14,11,3
3,30,143,22,5,17
3,30,144,30,16,14
3,30,145,26,11,15
3,30,146,18,5,13
3,30,147,16,11,5
3,30,148,10,7,3
3,30,149,9,9,0
3,30,150,14,8,6
3,30,151,11,7,4
3,30,152,17,10,7
3,30,153,19,4,15
3,30,154,38,8,30
3,30,155,16,4,12
3,30,156,35,25,10
3,30,157,21,5,16
3,30,158,8,0,8
3,30,159,12,7,5
3,30,160,33,10,23
3,30,161,7,1,6
3,30,162,22,8,14
3,30,163,17,11,6
3,30,164,13,5,8
3,30,165,25,3,22
3,30,166,10,0,10
3,30,167,18,14,4
3,30,168,8,2,6
3,30,169,19,11,8
3,30,170,23,6,17
3,30,171,8,11,-3
3,30,172,22,9,13
3,30,173,15,0,15
3,30,174,28,8,20
3,30,175,22,17,5
3,30,176,12,12,0
3,30,177,26,15,11
3,30,178,25,7,18
3,30,179,12,7,5
3,30,180,10,3,7
3,30,181,16,9,7
3,30,182,15,5,10
3,30,183,22,10,12
3,30,184,19,14,5
3,30,185,17,11,6
3,30,186,20,8,12
3,30,187,8,4,4
3,30,188,13,6,7
3,30,189,25,9,16
3,30,190,14,5,9
3,30,191,25,8,17
3,30,192,33,5,28
3,30,193,13,11,2
3,30,194,8,4,4
3,30,195,19,10,9
3,30,196,20,5,15
3,30,197,30,7,23
3,30,198,10,3,7
3,30,199,34,8,26
3,30,200,13,3,10
3,30,201,9,3,6
3,30,202,23,6,17
3,30,203,31,7,24
3,30,204,10,16,-6
3,30,205,22,6,16
3,30,206,17,7,10
3,30,207,23,11,12
3,30,208,15,11,4
3,30,209,14,3,11
3,30,210,11,3,8
3,30,211,19,4,15
3,30,212,22,11,11
3,30,213,11,8,3
3,30,214,26,15,11
3,30,215,19,12,7
3,30,216,24,8,16
3,30,217,6,17,-11
3,30,218,28,11,17
3,30,219,10,5,5
3,30,220,8,7,1
3,30,221,24,14,10
3,30,222,20,8,12
3,30,223,9,6,3
3,30,224,30,5,25
3,30,225,18,12,6
3,30,226,25,8,17
3,30,227,24,4,20
3,30,228,22,14,8
3,30,229,16,5,11
3,30,230,14,16,-2
3,30,231,25,13,12
3,30,232,8,9,-1
3,30,233,30,10,20
3,30,234,14,10,4
3,30,235,13,10,3
3,30,236,15,10,5
3,30,237,20,3,17
3,30,238,21,9,12
3,30,239,15,3,12
3,30,240,7,11,-4
3,30,241,18,5,13
3,30,242,36,13,23
3,30,243,17,10,7
3,30,244,8,4,4
3,30,245,26,7,19
3,30,246,16,2,14
3,30,247,17,1,16
3,30,248,13,2,11
3,30,249,30,8,22
3,30,250,20,10,10
3,30,251,9,7,2
3,30,252,11,1,10
3,30,253,29,5,24
3,30,254,29,4,25
3,30,255,21,15,6
3,30,256,15,3,12
3,30,257,11,6,5
3,30,258,11,7,4
3,30,259,26,22,4
3,30,260,28,6,22
3,30,261,16,4,12
3,30,262,17,1,16
3,30,263,12,2,10
3,30,264,26,12,14
3,30,265,22,3,19
3,30,266,14,10,4
3,30,267,14,2,12
3,30,268,16,16,0
3,30,269,23,10,13
3,30,270,25,11,14
3,30,271,21,5,16
3,30,272,35,12,23
3,30,273,15,6,9
3,30,274,15,6,9
3,30,275,4,12,-8
3,30,276,28,10,18
3,30,277,15,0,15
3,30,278,25,14,11
3,30,279,23,10,13
3,30,280,13,4,9
3,30,281,12,10,2
3,30,282,19,9,10
3,30,283,20,12,8
3,30,284,24,7,17
3,30,285,10,4,6
3,30,286,18,8,10
3,30,287,10,6,4
3,30,288,16,7,9
3,30,289,16,14,2
3,30,290,15,12,3
3,30,291,24,7,17
3,30,292,19,0,19
3,30,293,10,9,1
3,30,294,25,6,19
3,30,295,11,6,5
3,30,296,37,9,28
3,30,297,13,5,8
3,30,298,27,14,13
3,30,299,21,10,11
4,1,0,11,8,3
4,1,1,5,6,-1
4,1,2,19,16,3
4,1,3,14,20,-6
4,1,4,6,4,2
4,1,5,9,5,4
4,1,6,11,14,-3
4,1,7,12,12,0
4,1,8,10,23,-13
4,1,9,4,9,-5
4,1,10,7,7,0
4,1,11,2,6,-4
4,1,12,26,14,12
4,1,13,4,19,-15
4,1,14,4,8,-4
4,1,15,4,8,-4
4,1,16,8,11,-3
4,1,17,10,18,-8
4,1,18,5,9,-4
4,1,19,6,14,-8
4,1,20,7,10,-3
4,1,21,14,7,7
4,1,22,9,18,-9
4,1,23,7,10,-3
4,1,24,10,11,-1
4,1,25,6,5,1
4,1,26,8,9,-1
4,1,27,3,3,0
4,1,28,8,13,-5
4,1,29,8,15,-7
4,1,30,8,6,2
4,1,31,12,11,1
4,1,32,4,8,-4
4,1,33,12,7,5
4,1,34,12,16,-4
4,1,35,7,6,1
4,1,36,10,11,-1
4,1,37,10,8,2
4,1,38,4,7,-3
4,1,39,16,11,5
4,1,40,10,12,-2
4,1,41,9,10,-1
4,1,42,5,16,-11
4,1,43,7,10,-3
4,1,44,12,10,2
4,1,45,6,6,0
4,1,46,25,10,15
4,1,47,11,12,-1
4,1,48,4,10,-6
4,1,49,4,2,2
4,1,50,8,5,3
4,1,51,8,5,3
4,1,52,3,9,-6
4,1,53,16,11,5
4,1,54,7,6,1
4,1,55,5,11,-6
4,1,56,7,14,-7
4,1,57,10,12,-2
4,1,58,13,14,-1
4,1,59,4,10,-6
4,1,60,8,11,-3
4,1,61,7,17,-10
4,1,62,7,14,-7
4,1,63,14,8,6
4,1,64,16,18,-2
4,1,65,7,6,1
4,1,66,5,11,-6
4,1,67,8,6,2
4,1,68,5,8,-3
4,1,69,12,6,6
4,1,70,9,5,4
4,1,71,7,7,0
4,1,72,7,9,-2
4,1,73,5,7,-2
4,1,74,12,16,-4
4,1,75,7,4,3
4,1,76,2,7,-5
4,1,77,9,10,-1
4,1,78,10,16,-6
4,1,79,5,11,-6
4,1,80,8,7,1
4,1,81,6,9,-3
4,1,82,4,7,-3
4,1,83,9,9,0
4,1,84,9,7,2
4,1,85,2,4,-2
4,1,86,14,9,5
4,1,87,11,8,3
4,1,88,3,5,-2
4,1,89,6,14,-8
4,1,90,11,9,2
4,1,91,6,12,-6
4,1,92,13,13,0
4,1,93,4,3,1
4,1,94,3,14,-11
4,1,95,11,12,-1
4,1,96,5,6,-1
4,1,97,5,7,-2
4,1,98,12,20,-8
4,1,99,6,13,-7
4,1,100,11,11,0
4,1,101,2,4,-2
4,1,102,4,9,-5
4,1,103,15,4,11
4,1,104,6,24,-18
4,1,105,7,3,4
4,1,106,7,10,-3
4,1,107,13,10,3
4,1,108,10,13,-3
4,1,109,6,17,-11
4,1,110,9,10,-1
4,1,111,6,12,-6
4,1,112,7,4,3
4,1,113,6,7,-1
4,1,114,4,1,3
4,1,115,5,8,-3
4,1,116,16,2,14
4,1,117,3,7,-4
4,1,118,5,12,-7
4,1,119,10,6,4
4,1,120,9,6,3
4,1,121,5,4,1
4,1,122,13,12,1
4,1,123,13,15,-2
4,1,124,6,9,-3
4,1,125,4,1,3
4,1,126,8,9,-1
4,1,127,2,3,-1
4,1,128,10,12,-2
4,1,129,0,1,-1
4,1,130,12,13,-1
4,1,131,7,5,2
4,1,132,12,9,3
4,1,133,11,16,-5
4,1,134,4,6,-2
4,1,135,8,13,-5
4,1,136,6,6,0
4,1,137,0,3,-3
4,1,138,14,11,3
4,1,139,6,11,-5
4,1,140,2,9,-7
4,1,141,6,13,-7
4,1,142,3,4,-1
4,1,143,8,8,0
4,1,144,13,11,2
4,1,145,11,7,4
4,1,146,17,4,13
4,1,147,17,6,11
4,1,148,2,7,-5
4,1,149,7,7,0
4,1,150,5,9,-4
4,1,151,5,8,-3
4,1,152,8,14,-6
4,1,153,11,4,7
4,1,154,7,8,-1
4,1,155,7,6,1
4,1,156,4,17,-13
4,1,157,3,6,-3
4,1,158,19,26,-7
4,1,159,6,8,-2
4,1,160,12,5,7
4,1,161,7,11,-4
4,1,162,7,6,1
4,1,163,2,3,-1
4,1,164,9,24,-15
4,1,165,3,4,-1
4,1,166,6,5,1
4,1,167,14,12,2
4,1,168,9,12,-3
4,1,169,5,13,-8
4,1,170,9,8,1
4,1,171,17,5,12
4,1,172,5,13,-8
4,1,173,6,10,-4
4,1,174,2,10,-8
4,1,175,7,4,3
4,1,176,7,7,0
4,1,177,5,17,-12
4,1,178,6,7,-1
4,1,179,11,22,-11
4,1,180,9,9,0
4,1,181,7,6,1
4,1,182,4,18,-14
4,1,183,15,6,9
4,1,184,11,9,2
4,1,185,9,16,-7
4,1,186,10,7,3
4,1,187,4,9,-5
4,1,188,3,7,-4
4,1,189,22,6,16
4,1,190,7,12,-5
4,1,191,12,7,5
4,1,192,6,6,0
4,1,193,3,3,0
4,1,194,9,11,-2
4,1,195,4,23,-19
4,1,196,16,12,4
4,1,197,7,15,-8
4,1,198,9,14,-5
4,1,199,4,14,-10
4,1,200,7,7,0
4,1,201,5,10,-5
4,1,202,8,12,-4
4,1,203,2,7,-5
4,1,204,8,15,-7
4,1,205,6,13,-7
4,1,206,8,16,-8
4,1,207,6,10,-4
4,1,208,12,12,0
4,1,209,12,11,1
4,1,210,9,11,-2
4,1,211,2,3,-1
4,1,212,3,13,-10
4,1,213,5,11,-6
4,1,214,4,7,-3
4,1,215,5,1,4
4,1,216,9,8,1
4,1,217,6,6,0
4,1,218,8,13,-5
4,1,219,5,10,-5
4,1,220,12,13,-1
4,1,221,6,5,1
4,1,222,6,8,-2
4,1,223,2,4,-2
4,1,224,5,9,-4
4,1,225,10,12,-2
4,1,226,4,23,-19
4,1,227,10,10,0
4,1,228,5,7,-2
4,1,229,2,0,2
4,1,230,2,7,-5
4,1,231,9,12,-3
4,1,232,11,17,-6
4,1,233,10,15,-5
4,1,234,4,12,-8
4,1,235,8,11,-3
4,1,236,10,7,3
4,1,237,6,10,-4
4,1,238,6,26,-20
4,1,239,7,26,-19
4,1,240,7,18,-11
4,1,241,8,9,-1
4,1,242,0,0,0
4,1,243,4,6,-2
4,1,244,3,10,-7
4,1,245,5,17,-12
4,1,246,9,3,6
4,1,247,7,9,-2
4,1,248,9,6,3
4,1,249,4,4,0
4,1,250,14,27,-13
4,1,251,5,20,-15
4,1,252,1,3,-2
4,1,253,14,7,7
4,1,254,4,5,-1
4,1,255,3,11,-8
4,1,256,9,6,3
4,1,257,9,14,-5
4,1,258,11,7,4
4,1,259,20,19,1
4,1,260,9,10,-1
4,1,261,1,1,0
4,1,262,10,26,-16
4,1,263,6,5,1
4,1,264,9,14,-5
4,1,265,9,7,2
4,1,266,9,7,2
4,1,267,10,10,0
4,1,268,22,14,8
4,1,269,6,9,-3
4,1,270,15,10,5
4,1,271,6,11,-5
4,1,272,3,4,-1
4,1,273,14,14,0
4,1,274,3,25,-22
4,1,275,15,9,6
4,1,276,5,6,-1
4,1,277,2,4,-2
4,1,278,8,7,1
4,1,279,5,6,-1
4,1,280,11,7,4
4,1,281,16,7,9
4,1,282,9,15,-6
4,1,283,8,10,-2
4,1,284,5,19,-14
4,1,285,16,12,4
4,1,286,3,10,-7
4,1,287,9,11,-2
4,1,288,2,12,-10
4,1,289,5,39,-34
4,1,290,3,6,-3
4,1,291,3,2,1
4,1,292,5,5,0
4,1,293,13,8,5
4,1,294,5,7,-2
4,1,295,10,5,5
4,1,296,2,3,-1
4,1,297,9,10,-1
4,1,298,10,15,-5
4,1,299,6,4,2
4,2,0,7,14,-7
4,2,1,12,10,2
4,2,2,5,11,-6
4,2,3,6,8,-2
4,2,4,5,7,-2
4,2,5,7,6,1
4,2,6,8,8,0
4,2,7,10,8,2
4,2,8,12,8,4
4,2,9,4,1,3
4,2,10,14,17,-3
4,2,11,14,13,1
4,2,12,8,9,-1
4,2,13,9,11,-2
4,2,14,8,6,2
4,2,15,6,6,0
4,2,16,4,6,-2
4,2,17,13,18,-5
4,2,18,2,5,-3
4,2,19,6,10,-4
4,2,20,9,17,-8
4,2,21,8,7,1
4,2,22,7,2,5
4,2,23,7,8,-1
4,2,24,10,17,-7
4,2,25,7,4,3
4,2,26,9,9,0
4,2,27,9,4,5
4,2,28,8,5,3
4,2,29,16,10,6
4,2,30,10,10,0
4,2,31,4,7,-3
4,2,32,17,10,7
4,2,33,10,16,-6
4,2,34,12,6,6
4,2,35,4,7,-3
4,2,36,8,5,3
4,2,37,7,33,-26
4,2,38,14,13,1
4,2,39,19,15,4
4,2,40,9,10,-1
4,2,41,10,8,2
4,2,42,1,5,-4
4,2,43,17,26,-9
4,2,44,6,14,-8
4,2,45,5,12,-7
4,2,46,10,8,2
4,2,47,14,21,-7
4,2,48,6,1,5
4,2,49,8,13,-5
4,2,50,15,13,2
4,2,51,8,14,-6
4,2,52,5,2,3
4,2,53,7,8,-1
4,2,54,6,5,1
4,2,55,4,12,-8
4,2,56,19,4,15
4,2,57,8,10,-2
4,2,58,12,14,-2
4,2,59,9,12,-3
4,2,60,7,11,-4
4,2,61,5,10,-5
4,2,62,7,7,0
4,2,63,12,12,0
4,2,64,1,3,-2
4,2,65,2,6,-4
4,2,66,6,16,-10
4,2,67,5,15,-10
4,2,68,4,8,-4
4,2,69,6,12,-6
4,2,70,7,10,-3
4,2,71,7,13,-6
4,2,72,5,12,-7
4,2,73,4,15,-11
4,2,74,2,2,0
4,2,75,4,4,0
4,2,76,7,4,3
4,2,77,5,5,0
4,2,78,15,12,3
4,2,79,5,3,2
4,2,80,4,9,-5
4,2,81,7,17,-10
4,2,82,13,13,0
4,2,83,4,6,-2
4,2,84,21,6,15
4,2,85,15,12,3
4,2,86,7,17,-10
4,2,87,10,9,1
4,2,88,11,6,5
4,2,89,3,4,-1
4,2,90,9,15,-6
4,2,91,12,8,4
4,2,92,5,2,3
4,2,93,12,22,-10
4,2,94,18,13,5
4,2,95,7,5,2
4,2,96,13,8,5
4,2,97,6,3,3
4,2,98,10,9,1
4,2,99,16,13,3
4,2,100,2,11,-9
4,2,101,6,6,0
4,2,102,5,13,-8
4,2,103,6,11,-5
4,2,104,7,15,-8
4,2,105,7,14,-7
4,2,106,12,11,1
4,2,107,18,13,5
4,2,108,9,6,3
4,2,109,9,8,1
4,2,110,6,6,0
4,2,111,13,7,6
4,2,112,1,4,-3
4,2,113,6,10,-4
4,2,114,20,15,5
4,2,115,10,13,-3
4,2,116,6,8,-2
4,2,117,20,14,6
4,2,118,14,8,6
4,2,119,5,20,-15
4,2,120,6,13,-7
4,2,121,8,12,-4
4,2,122,9,24,-15
4,2,123,3,9,-6
4,2,124,9,17,-8
4,2,125,15,19,-4
4,2,126,11,9,2
4,2,127,4,9,-5
4,2,128,6,3,3
4,2,129,2,6,-4
4,2,130,11,17,-6
4,2,131,15,15,0
4,2,132,9,12,-3
4,2,133,12,10,2
4,2,134,12,9,3
4,2,135,14,15,-1
4,2,136,8,12,-4
4,2,137,9,14,-5
4,2,138,12,16,-4
4,2,139,13,16,-3
4,2,140,7,7,0
4,2,141,7,4,3
4,2,142,7,5,2
4,2,143,7,14,-7
4,2,144,9,4,5
4,2,145,17,10,7
4,2,146,10,4,6
4,2,147,4,1,3
4,2,148,8,14,-6
4,2,149,19,18,1
4,2,150,7,10,-3
4,2,151,8,5,3
4,2,152,5,7,-2
4,2,153,20,11,9
4,2,154,9,8,1
4,2,155,10,9,1
4,2,156,4,6,-2
4,2,157,9,21,-12
4,2,158,12,16,-4
4,2,159,3,10,-7
4,2,160,7,10,-3
4,2,161,14,17,-3
4,2,162,6,6,0
4,2,163,6,12,-6
4,2,164,0,1,-1
4,2,165,21,11,10
4,2,166,7,8,-1
4,2,167,5,5,0
4,2,168,9,18,-9
4,2,169,6,8,-2
4,2,170,16,11,5
4,2,171,9,10,-1
4,2,172,8,10,-2
4,2,173,4,5,-1
4,2,174,5,4,1
4,2,175,10,9,1
4,2,176,8,9,-1
4,2,177,9,17,-8
4,2,178,12,11,1
4,2,179,8,15,-7
4,2,180,8,6,2
4,2,181,4,7,-3
4,2,182,1,5,-4
4,2,183,17,9,8
4,2,184,15,14,1
4,2,185,4,17,-13
4,2,186,10,8,2
4,2,187,9,16,-7
4,2,188,1,3,-2
4,2,189,6,1,5
4,2,190,2,16,-14
4,2,191,15,17,-2
4,2,192,7,5,2
4,2,193,9,12,-3
4,2,194,14,12,2
4,2,195,9,8,1
4,2,196,13,8,5
4,2,197,4,4,0
4,2,198,4,9,-5
4,2,199,12,14,-2
4,2,200,9,14,-5
4,2,201,8,4,4
4,2,202,3,1,2
4,2,203,2,4,-2
4,2,204,5,5,0
4,2,205,10,22,-12
4,2,206,4,6,-2
4,2,207,3,2,1
4,2,208,15,15,0
4,2,209,8,9,-1
4,2,210,6,5,1
4,2,211,17,5,12
4,2,212,12,10,2
4,2,213,13,8,5
4,2,214,7,7,0
4,2,215,8,20,-12
4,2,216,7,16,-9
4,2,217,15,7,8
4,2,218,15,13,2
4,2,219,6,10,-4
4,2,220,7,10,-3
4,2,221,10,9,1
4,2,222,8,8,0
4,2,223,8,11,-3
4,2,224,10,1,9
4,2,225,7,10,-3
4,2,226,5,10,-5
4,2,227,9,12,-3
4,2,228,6,11,-5
4,2,229,6,3,3
4,2,230,9,6,3
4,2,231,1,2,-1
4,2,232,23,14,9
4,2,233,3,12,-9
4,2,234,3,0,3
4,2,235,7,5,2
4,2,236,10,10,0
4,2,237,7,9,-2
4,2,238,7,4,3
4,2,239,6,10,-4
4,2,240,6,2,4
4,2,241,7,8,-1
4,2,242,12,8,4
4,2,243,18,15,3
4,2,244,12,12,0
4,2,245,9,19,-10
4,2,246,10,9,1
4,2,247,9,13,-4
4,2,248,3,5,-2
4,2,249,17,23,-6
4,2,250,9,11,-2
4,2,251,15,12,3
4,2,252,10,6,4
4,2,253,10,12,-2
4,2,254,5,3,2
4,2,255,9,9,0
4,2,256,17,19,-2
4,2,257,2,8,-6
4,2,258,9,25,-16
4,2,259,1,3,-2
4,2,260,11,10,1
4,2,261,8,13,-5
4,2,262,9,17,-8
4,2,263,9,12,-3
4,2,264,3,4,-1
4,2,265,13,19,-6
4,2,266,13,7,6
4,2,267,18,13,5
4,2,268,18,13,5
4,2,269,5,4,1
4,2,270,8,6,2
4,2,271,9,22,-13
4,2,272,13,12,1
4,2,273,10,6,4
4,2,274,5,16,-11
4,2,275,16,18,-2
4,2,276,4,10,-6
4,2,277,7,12,-5
4,2,278,5,8,-3
4,2,279,8,3,5
4,2,280,2,4,-2
4,2,281,10,12,-2
4,2,282,7,12,-5
4,2,283,7,7,0
4,2,284,4,8,-4
4,2,285,7,8,-1
4,2,286,16,18,-2
4,2,287,5,6,-1
4,2,288,8,10,-2
4,2,289,6,6,0
4,2,290,8,7,1
4,2,291,4,10,-6
4,2,292,6,0,6
4,2,293,2,8,-6
4,2,294,7,6,1
4,2,295,16,17,-1
4,2,296,12,7,5
4,2,297,3,10,-7
4,2,298,4,4,0
4,2,299,17,11,6
4,3,0,6,14,-8
4,3,1,8,14,-6
4,3,2,4,5,-1
4,3,3,12,12,0
4,3,4,15,18,-3
4,3,5,10,5,5
4,3,6,18,25,-7
4,3,7,3,4,-1
4,3,8,20,17,3
4,3,9,16,11,5
4,3,10,2,9,-7
4,3,11,17,2,15
4,3,12,13,13,0
4,3,13,17,20,-3
4,3,14,6,11,-5
4,3,15,14,4,10
4,3,16,5,9,-4
4,3,17,10,6,4
4,3,18,11,5,6
4,3,19,0,4,-4
4,3,20,7,5,2
4,3,21,7,12,-5
4,3,22,14,6,8
4,3,23,5,6,-1
4,3,24,8,14,-6
4,3,25,9,3,6
4,3,26,27,21,6
4,3,27,4,6,-2
4,3,28,13,13,0
4,3,29,11,19,-8
4,3,30,8,12,-4
4,3,31,4,18,-14
4,3,32,9,4,5
4,3,33,22,13,9
4,3,34,13,17,-4
4,3,35,3,7,-4
4,3,36,10,12,-2
4,3,37,10,6,4
4,3,38,7,11,-4
4,3,39,10,3,7
4,3,40,14,15,-1
4,3,41,16,5,11
4,3,42,11,16,-5
4,3,43,11,13,-2
4,3,44,9,10,-1
4,3,45,13,16,-3
4,3,46,8,7,1
4,3,47,6,4,2
4,3,48,14,10,4
4,3,49,9,15,-6
4,3,50,18,6,12
4,3,51,10,4,6
4,3,52,5,7,-2
4,3,53,6,8,-2
4,3,54,17,23,-6
4,3,55,9,5,4
4,3,56,18,16,2
4,3,57,12,14,-2
4,3,58,6,11,-5
4,3,59,3,6,-3
4,3,60,12,6,6
4,3,61,9,5,4
4,3,62,12,14,-2
4,3,63,8,9,-1
4,3,64,13,9,4
4,3,65,14,6,8
4,3,66,12,13,-1
4,3,67,4,7,-3
4,3,68,10,22,-12
4,3,69,7,2,5
4,3,70,7,9,-2
4,3,71,11,7,4
4,3,72,12,11,1
4,3,73,10,10,0
4,3,74,10,9,1
4,3,75,6,3,3
4,3,76,21,15,6
4,3,77,11,18,-7
4,3,78,3,6,-3
4,3,79,16,34,-18
4,3,80,8,4,4
4,3,81,7,11,-4
4,3,82,7,1,6
4,3,83,4,5,-1
4,3,84,3,4,-1
4,3,85,15,7,8
4,3,86,11,18,-7
4,3,87,10,7,3
4,3,88,11,10,1
4,3,89,9,10,-1
4,3,90,19,16,3
4,3,91,9,13,-4
4,3,92,14,12,2
4,3,93,8,15,-7
4,3,94,6,7,-1
4,3,95,6,6,0
4,3,96,9,5,4
4,3,97,13,18,-5
4,3,98,5,6,-1
4,3,99,12,6,6
4,3,100,10,5,5
4,3,101,10,9,1
4,3,102,3,9,-6
4,3,103,9,19,-10
4,3,104,9,11,-2
4,3,105,9,5,4
4,3,106,7,5,2
4,3,107,27,17,10
4,3,108,15,8,7
4,3,109,8,15,-7
4,3,110,10,24,-14
4,3,111,14,10,4
4,3,112,5,8,-3
4,3,113,8,11,-3
4,3,114,5,5,0
4,3,115,16,13,3
4,3,116,9,7,2
4,3,117,6,9,-3
4,3,118,12,15,-3
4,3,119,12,7,5
4,3,120,6,9,-3
4,3,121,12,9,3
4,3,122,7,12,-5
4,3,123,17,13,4
4,3,124,9,6,3
4,3,125,13,13,0
4,3,126,7,16,-9
4,3,127,7,10,-3
4,3,128,10,11,-1
4,3,129,6,10,-4
4,3,130,16,9,7
4,3,131,18,7,11
4,3,132,13,24,-11
4,3,133,9,7,2
4,3,134,8,7,1
4,3,135,11,6,5
4,3,136,5,10,-5
4,3,137,18,15,3
4,3,138,13,9,4
4,3,139,4,8,-4
4,3,140,5,5,0
4,3,141,1,14,-13
4,3,142,14,19,-5
4,3,143,15,12,3
4,3,144,23,14,9
4,3,145,8,13,-5
4,3,146,7,2,5
4,3,147,12,11,1
4,3,148,3,5,-2
4,3,149,5,14,-9
4,3,150,11,10,1
4,3,151,11,18,-7
4,3,152,20,11,9
4,3,153,11,13,-2
4,3,154,15,7,8
4,3,155,14,12,2
4,3,156,10,16,-6
4,3,157,12,12,0
4,3,158,15,21,-6
4,3,159,6,20,-14
4,3,160,8,11,-3
4,3,161,7,18,-11
4,3,162,6,12,-6
4,3,163,10,11,-1
4,3,164,10,7,3
4,3,165,9,8,1
4,3,166,6,9,-3
4,3,167,7,13,-6
4,3,168,12,11,1
4,3,169,12,12,0
4,3,170,11,1,10
4,3,171,7,11,-4
4,3,172,19,5,14
4,3,173,5,11,-6
4,3,174,3,2,1
4,3,175,11,19,-8
4,3,176,13,14,-1
4,3,177,10,12,-2
4,3,178,6,4,2
4,3,179,13,17,-4
4,3,180,7,20,-13
4,3,181,7,12,-5
4,3,182,12,7,5
4,3,183,7,2,5
4,3,184,8,12,-4
4,3,185,5,4,1
4,3,186,7,9,-2
4,3,187,10,18,-8
4,3,188,15,11,4
4,3,189,7,9,-2
4,3,190,6,5,1
4,3,191,9,4,5
4,3,192,10,6,4
4,3,193,1,3,-2
4,3,194,3,2,1
4,3,195,22,19,3
4,3,196,14,11,3
4,3,197,13,5,8
4,3,198,9,16,-7
4,3,199,4,5,-1
4,3,200,11,7,4
4,3,201,8,10,-2
4,3,202,7,11,-4
4,3,203,14,11,3
4,3,204,7,26,-19
4,3,205,7,5,2
4,3,206,15,11,4
4,3,207,15,14,1
4,3,208,9,7,2
4,3,209,3,5,-2
4,3,210,13,13,0
4,3,211,18,16,2
4,3,212,18,13,5
4,3,213,11,6,5
4,3,214,7,6,1
4,3,215,16,22,-6
4,3,216,11,10,1
4,3,217,10,12,-2
4,3,218,8,11,-3
4,3,219,13,8,5
4,3,220,3,23,-20
4,3,221,22,11,11
4,3,222,11,16,-5
4,3,223,12,6,6
4,3,224,17,3,14
4,3,225,6,12,-6
4,3,226,9,7,2
4,3,227,13,17,-4
4,3,228,10,12,-2
4,3,229,4,11,-7
4,3,230,6,7,-1
4,3,231,8,8,0
4,3,232,2,9,-7
4,3,233,19,13,6
4,3,234,6,7,-1
4,3,235,13,8,5
4,3,236,5,8,-3
4,3,237,11,12,-1
4,3,238,18,11,7
4,3,239,5,2,3
4,3,240,9,8,1
4,3,241,5,18,-13
4,3,242,9,20,-11
4,3,243,14,11,3
4,3,244,5,5,0
4,3,245,7,8,-1
4,3,246,14,15,-1
4,3,247,17,7,10
4,3,248,10,4,6
4,3,249,15,17,-2
4,3,250,19,17,2
4,3,251,9,15,-6
4,3,252,5,7,-2
4,3,253,3,16,-13
4,3,254,13,14,-1
4,3,255,12,13,-1
4,3,256,6,4,2
4,3,257,22,17,5
4,3,258,24,14,10
4,3,259,10,13,-3
4,3,260,17,11,6
4,3,261,8,15,-7
4,3,262,8,9,-1
4,3,263,16,19,-3
4,3,264,11,10,1
4,3,265,12,12,0
4,3,266,11,8,3
4,3,267,20,10,10
4,3,268,13,11,2
4,3,269,28,17,11
4,3,270,7,6,1
4,3,271,10,8,2
4,3,272,12,5,7
4,3,273,9,6,3
4,3,274,11,14,-3
4,3,275,10,23,-13
4,3,276,14,8,6
4,3,277,21,20,1
4,3,278,10,23,-13
4,3,279,11,22,-11
4,3,280,18,14,4
4,3,281,8,9,-1
4,3,282,5,13,-8
4,3,283,6,13,-7
4,3,284,8,12,-4
4,3,285,4,17,-13
4,3,286,11,17,-6
4,3,287,10,11,-1
4,3,288,3,10,-7
4,3,289,17,11,6
4,3,290,8,12,-4
4,3,291,5,4,1
4,3,292,13,12,1
4,3,293,5,8,-3
4,3,294,19,16,3
4,3,295,8,15,-7
4,3,296,7,17,-10
4,3,297,10,26,-16
4,3,298,17,10,7
4,3,299,20,10,10
4,4,0,10,6,4
4,4,1,8,5,3
4,4,2,30,7,23
4,4,3,18,6,12
4,4,4,17,12,5
4,4,5,13,8,5
4,4,6,22,28,-6
4,4,7,8,13,-5
4,4,8,9,6,3
4,4,9,10,7,3
4,4,10,16,19,-3
4,4,11,8,11,-3
4,4,12,5,1,4
4,4,13,8,4,4
4,4,14,7,7,0
4,4,15,14,6,8
4,4,16,17,6,11
4,4,17,1,6,-5
4,4,18,7,3,4
4,4,19,9,8,1
4,4,20,14,13,1
4,4,21,8,13,-5
4,4,22,6,4,2
4,4,23,13,11,2
4,4,24,8,11,-3
4,4,25,13,15,-2
4,4,26,10,10,0
4,4,27,7,9,-2
4,4,28,15,10,5
4,4,29,9,3,6
4,4,30,8,11,-3
4,4,31,1,3,-2
4,4,32,13,23,-10
4,4,33,10,13,-3
4,4,34,4,7,-3
4,4,35,10,16,-6
4,4,36,6,21,-15
4,4,37,9,6,3
4,4,38,22,13,9
4,4,39,8,3,5
4,4,40,10,15,-5
4,4,41,15,12,3
4,4,42,4,13,-9
4,4,43,6,11,-5
4,4,44,11,20,-9
4,4,45,9,15,-6
4,4,46,5,14,-9
4,4,47,2,5,-3
4,4,48,8,9,-1
4,4,49,11,13,-2
4,4,50,12,16,-4
4,4,51,11,8,3
4,4,52,14,17,-3
4,4,53,10,15,-5
4,4,54,4,6,-2
4,4,55,5,8,-3
4,4,56,6,5,1
4,4,57,20,15,5
4,4,58,16,19,-3
4,4,59,6,6,0
4,4,60,6,10,-4
4,4,61,7,5,2
4,4,62,10,16,-6
4,4,63,10,8,2
4,4,64,9,12,-3
4,4,65,10,12,-2
4,4,66,17,7,10
4,4,67,15,16,-1
4,4,68,17,13,4
4,4,69,11,11,0
4,4,70,17,23,-6
4,4,71,5,5,0
4,4,72,12,8,4
4,4,73,12,12,0
4,4,74,20,18,2
4,4,75,6,12,-6
4,4,76,5,7,-2
4,4,77,5,4,1
4,4,78,20,17,3
4,4,79,7,16,-9
4,4,80,12,10,2
4,4,81,2,2,0
4,4,82,6,12,-6
4,4,83,15,21,-6
4,4,84,7,8,-1
4,4,85,21,18,3
4,4,86,23,22,1
4,4,87,14,7,7
4,4,88,7,13,-6
4,4,89,11,9,2
4,4,90,3,5,-2
4,4,91,11,14,-3
4,4,92,4,5,-1
4,4,93,13,15,-2
4,4,94,12,15,-3
4,4,95,8,13,-5
4,4,96,11,22,-11
4,4,97,4,8,-4
4,4,98,8,17,-9
4,4,99,28,15,13
4,4,100,10,12,-2
4,4,101,12,10,2
4,4,102,8,10,-2
4,4,103,13,17,-4
4,4,104,16,15,1
4,4,105,3,11,-8
4,4,106,15,21,-6
4,4,107,13,12,1
4,4,108,9,9,0
4,4,109,1,8,-7
4,4,110,6,11,-5
4,4,111,8,9,-1
4,4,112,18,20,-2
4,4,113,3,7,-4
4,4,114,28,11,17
4,4,115,16,13,3
4,4,116,12,14,-2
4,4,117,16,15,1
4,4,118,7,9,-2
4,4,119,8,11,-3
4,4,120,19,19,0
4,4,121,18,9,9
4,4,122,9,5,4
4,4,123,15,20,-5
4,4,124,11,18,-7
4,4,125,4,6,-2
4,4,126,9,11,-2
4,4,127,4,6,-2
4,4,128,6,11,-5
4,4,129,7,12,-5
4,4,130,18,17,1
4,4,131,16,16,0
4,4,132,8,25,-17
4,4,133,14,19,-5
4,4,134,13,6,7
4,4,135,10,9,1
4,4,136,13,20,-7
4,4,137,14,9,5
4,4,138,10,11,-1
4,4,139,4,7,-3
4,4,140,8,13,-5
4,4,141,3,10,-7
4,4,142,9,9,0
4,4,143,2,6,-4
4,4,144,15,17,-2
4,4,145,6,13,-7
4,4,146,21,11,10
4,4,147,6,15,-9
4,4,148,5,6,-1
4,4,149,8,10,-2
4,4,150,9,10,-1
4,4,151,3,13,-10
4,4,152,9,12,-3
4,4,153,10,14,-4
4,4,154,13,14,-1
4,4,155,9,5,4
4,4,156,4,6,-2
4,4,157,3,6,-3
4,4,158,7,12,-5
4,4,159,12,16,-4
4,4,160,17,7,10
4,4,161,9,1,8
4,4,162,8,10,-2
4,4,163,9,5,4
4,4,164,14,21,-7
4,4,165,4,8,-4
4,4,166,10,7,3
4,4,167,14,16,-2
4,4,168,18,15,3
4,4,169,5,4,1
4,4,170,10,18,-8
4,4,171,18,16,2
4,4,172,15,15,0
4,4,173,9,15,-6
4,4,174,18,7,11
4,4,175,7,7,0
4,4,176,14,12,2
4,4,177,4,16,-12
4,4,178,5,11,-6
4,4,179,15,11,4
4,4,180,18,17,1
4,4,181,6,4,2
4,4,182,4,16,-12
4,4,183,16,15,1
4,4,184,7,12,-5
4,4,185,10,12,-2
4,4,186,3,7,-4
4,4,187,14,5,9
4,4,188,19,14,5
4,4,189,8,12,-4
4,4,190,12,8,4
4,4,191,5,12,-7
4,4,192,19,11,8
4,4,193,9,12,-3
4,4,194,5,12,-7
4,4,195,14,7,7
4,4,196,8,10,-2
4,4,197,9,9,0
4,4,198,15,15,0
4,4,199,8,13,-5
4,4,200,12,15,-3
4,4,201,8,23,-15
4,4,202,18,17,1
4,4,203,5,6,-1
4,4,204,10,9,1
4,4,205,7,8,-1
4,4,206,19,17,2
4,4,207,11,15,-4
4,4,208,13,11,2
4,4,209,4,8,-4
4,4,210,8,13,-5
4,4,211,12,17,-5
4,4,212,12,6,6
4,4,213,5,8,-3
4,4,214,12,21,-9
4,4,215,14,5,9
4,4,216,6,4,2
4,4,217,13,14,-1
4,4,218,0,8,-8
4,4,219,11,21,-10
4,4,220,8,5,3
4,4,221,20,11,9
4,4,222,22,13,9
4,4,223,4,2,2
4,4,224,14,19,-5
4,4,225,12,11,1
4,4,226,9,9,0
4,4,227,10,5,5
4,4,228,7,15,-8
4,4,229,11,13,-2
4,4,230,7,23,-16
4,4,231,7,13,-6
4,4,232,11,11,0
4,4,233,15,18,-3
4,4,234,8,8,0
4,4,235,17,16,1
4,4,236,18,13,5
4,4,237,10,15,-5
4,4,238,11,16,-5
4,4,239,6,4,2
4,4,240,14,9,5
4,4,241,13,16,-3
4,4,242,10,10,0
4,4,243,9,6,3
4,4,244,6,5,1
4,4,245,10,18,-8
4,4,246,6,9,-3
4,4,247,5,9,-4
4,4,248,17,9,8
4,4,249,13,19,-6
4,4,250,10,8,2
4,4,251,12,12,0
4,4,252,3,10,-7
4,4,253,8,3,5
4,4,254,3,6,-3
4,4,255,9,9,0
4,4,256,8,8,0
4,4,257,11,18,-7
4,4,258,14,13,1
4,4,259,10,7,3
4,4,260,19,24,-5
4,4,261,2,6,-4
4,4,262,11,14,-3
4,4,263,18,20,-2
4,4,264,15,12,3
4,4,265,24,8,16
4,4,266,2,3,-1
4,4,267,5,17,-12
4,4,268,10,9,1
4,4,269,11,13,-2
4,4,270,7,21,-14
4,4,271,7,7,0
4,4,272,12,6,6
4,4,273,10,7,3
4,4,274,25,13,12
4,4,275,10,7,3
4,4,276,17,17,0
4,4,277,4,7,-3
4,4,278,8,9,-1
4,4,279,10,7,3
4,4,280,14,15,-1
4,4,281,22,27,-5
4,4,282,21,23,-2
4,4,283,10,11,-1
4,4,284,11,7,4
4,4,285,8,3,5
4,4,286,16,11,5
4,4,287,11,11,0
4,4,288,9,11,-2
4,4,289,5,3,2
4,4,290,15,14,1
4,4,291,12,18,-6
4,4,292,11,14,-3
4,4,293,12,4,8
4,4,294,15,6,9
4,4,295,6,5,1
4,4,296,12,15,-3
4,4,297,1,4,-3
4,4,298,4,9,-5
4,4,299,24,25,-1
4,5,0,19,19,0
4,5,1,12,13,-1
4,5,2,4,13,-9
4,5,3,9,7,2
4,5,4,11,11,0
4,5,5,5,3,2
4,5,6,7,18,-11
4,5,7,12,15,-3
4,5,8,10,16,-6
4,5,9,11,11,0
4,5,10,6,12,-6
4,5,11,7,18,-11
4,5,12,7,12,-5
4,5,13,5,5,0
4,5,14,17,11,6
4,5,15,3,2,1
4,5,16,10,25,-15
4,5,17,9,10,-1
4,5,18,8,8,0
4,5,19,15,31,-16
4,5,20,9,22,-13
4,5,21,9,22,-13
4,5,22,5,4,1
4,5,23,11,16,-5
4,5,24,16,10,6
4,5,25,7,16,-9
4,5,26,12,4,8
4,5,27,12,21,-9
4,5,28,9,9,0
4,5,29,23,13,10
4,5,30,21,11,10
4,5,31,12,10,2
4,5,32,17,8,9
4,5,33,10,8,2
4,5,34,13,13,0
4,5,35,11,9,2
4,5,36,10,15,-5
4,5,37,7,12,-5
4,5,38,15,12,3
4,5,39,10,6,4
4,5,40,22,9,13
4,5,41,14,17,-3
4,5,42,6,4,2
4,5,43,10,17,-7
4,5,44,8,23,-15
4,5,45,4,1,3
4,5,46,6,10,-4
4,5,47,20,14,6
4,5,48,13,16,-3
4,5,49,8,6,2
4,5,50,14,10,4
4,5,51,17,17,0
4,5,52,7,27,-20
4,5,53,6,4,2
4,5,54,19,21,-2
4,5,55,17,19,-2
4,5,56,8,14,-6
4,5,57,20,4,16
4,5,58,8,10,-2
4,5,59,21,15,6
4,5,60,10,6,4
4,5,61,17,4,13
4,5,62,15,17,-2
4,5,63,14,12,2
4,5,64,14,8,6
4,5,65,17,26,-9
4,5,66,15,6,9
4,5,67,6,22,-16
4,5,68,13,23,-10
4,5,69,3,9,-6
4,5,70,6,15,-9
4,5,71,4,17,-13
4,5,72,9,8,1
4,5,73,6,12,-6
4,5,74,12,12,0
4,5,75,3,2,1
4,5,76,20,15,5
4,5,77,16,10,6
4,5,78,7,8,-1
4,5,79,19,14,5
4,5,80,9,11,-2
4,5,81,8,18,-10
4,5,82,14,11,3
4,5,83,13,18,-5
4,5,84,12,8,4
4,5,85,15,15,0
4,5,86,2,5,-3
4,5,87,11,23,-12
4,5,88,20,13,7
4,5,89,12,15,-3
4,5,90,21,18,3
4,5,91,13,13,0
4,5,92,13,23,-10
4,5,93,2,13,-11
4,5,94,14,7,7
4,5,95,12,18,-6
4,5,96,10,7,3
4,5,97,5,21,-16
4,5,98,8,8,0
4,5,99,12,14,-2
4,5,100,10,10,0
4,5,101,12,12,0
4,5,102,11,8,3
4,5,103,11,10,1
4,5,104,12,9,3
4,5,105,28,7,21
4,5,106,11,5,6
4,5,107,13,26,-13
4,5,108,17,13,4
4,5,109,25,30,-5
4,5,110,9,17,-8
4,5,111,13,11,2
4,5,112,7,10,-3
4,5,113,17,16,1
4,5,114,10,28,-18
4,5,115,7,5,2
4,5,116,23,12,11
4,5,117,11,13,-2
4,5,118,15,16,-1
4,5,119,18,26,-8
4,5,120,20,10,10
4,5,121,6,18,-12
4,5,122,14,13,1
4,5,123,4,7,-3
4,5,124,13,15,-2
4,5,125,10,12,-2
4,5,126,23,14,9
4,5,127,8,12,-4
4,5,128,10,21,-11
4,5,129,11,8,3
4,5,130,13,9,4
4,5,131,9,11,-2
4,5,132,11,12,-1
4,5,133,11,8,3
4,5,134,7,12,-5
4,5,135,8,12,-4
4,5,136,9,11,-2
4,5,137,11,17,-6
4,5,138,17,14,3
4,5,139,13,8,5
4,5,140,5,3,2
4,5,141,7,13,-6
4,5,142,8,14,-6
4,5,143,21,15,6
4,5,144,8,8,0
4,5,145,9,4,5
4,5,146,22,9,13
4,5,147,13,9,4
4,5,148,15,10,5
4,5,149,6,8,-2
4,5,150,4,7,-3
4,5,151,8,16,-8
4,5,152,9,21,-12
4,5,153,12,19,-7
4,5,154,2,6,-4
4,5,155,13,19,-6
4,5,156,24,13,11
4,5,157,13,7,6
4,5,158,7,14,-7
4,5,159,11,18,-7
4,5,160,11,16,-5
4,5,161,13,17,-4
4,5,162,14,14,0
4,5,163,8,17,-9
4,5,164,13,9,4
4,5,165,12,8,4
4,5,166,16,21,-5
4,5,167,2,6,-4
4,5,168,10,6,4
4,5,169,13,8,5
4,5,170,14,25,-11
4,5,171,4,3,1
4,5,172,9,14,-5
4,5,173,5,11,-6
4,5,174,9,6,3
4,5,175,12,13,-1
4,5,176,14,6,8
4,5,177,19,5,14
4,5,178,8,4,4
4,5,179,12,11,1
4,5,180,8,6,2
4,5,181,8,5,3
4,5,182,10,7,3
4,5,183,21,8,13
4,5,184,16,22,-6
4,5,185,15,14,1
4,5,186,9,4,5
4,5,187,12,12,0
4,5,188,8,7,1
4,5,189,6,15,-9
4,5,190,14,12,2
4,5,191,8,10,-2
4,5,192,12,13,-1
4,5,193,7,9,-2
4,5,194,9,8,1
4,5,195,8,3,5
4,5,196,16,18,-2
4,5,197,14,14,0
4,5,198,17,16,1
4,5,199,12,10,2
4,5,200,11,21,-10
4,5,201,16,11,5
4,5,202,14,10,4
4,5,203,16,13,3
4,5,204,13,10,3
4,5,205,12,27,-15
4,5,206,18,14,4
4,5,207,17,23,-6
4,5,208,18,23,-5
4,5,209,2,9,-7
4,5,210,25,14,11
4,5,211,16,14,2
4,5,212,10,12,-2
4,5,213,15,15,0
4,5,214,5,7,-2
4,5,215,13,10,3
4,5,216,17,14,3
4,5,217,9,14,-5
4,5,218,8,5,3
4,5,219,7,16,-9
4,5,220,11,8,3
4,5,221,1,5,-4
4,5,222,7,12,-5
4,5,223,5,10,-5
4,5,224,11,12,-1
4,5,225,12,14,-2
4,5,226,3,10,-7
4,5,227,9,5,4
4,5,228,13,15,-2
4,5,229,17,24,-7
4,5,230,12,8,4
4,5,231,7,8,-1
4,5,232,14,15,-1
4,5,233,12,8,4
4,5,234,13,8,5
4,5,235,13,14,-1
4,5,236,2,9,-7
4,5,237,6,6,0
4,5,238,3,6,-3
4,5,239,4,2,2
4,5,240,10,21,-11
4,5,241,12,9,3
4,5,242,7,18,-11
4,5,243,6,8,-2
4,5,244,18,13,5
4,5,245,22,6,16
4,5,246,12,11,1
4,5,247,17,14,3
4,5,248,10,14,-4
4,5,249,7,6,1
4,5,250,18,10,8
4,5,251,19,16,3
4,5,252,11,13,-2
4,5,253,6,8,-2
4,5,254,14,11,3
4,5,255,6,9,-3
4,5,256,8,13,-5
4,5,257,16,12,4
4,5,258,13,22,-9
4,5,259,6,4,2
4,5,260,9,12,-3
4,5,261,13,14,-1
4,5,262,5,9,-4
4,5,263,13,9,4
4,5,264,23,12,11
4,5,265,7,7,0
4,5,266,10,11,-1
4,5,267,3,5,-2
4,5,268,6,10,-4
4,5,269,11,12,-1
4,5,270,7,10,-3
4,5,271,27,20,7
4,5,272,11,13,-2
4,5,273,20,9,11
4,5,274,18,10,8
4,5,275,2,5,-3
4,5,276,10,11,-1
4,5,277,12,20,-8
4,5,278,7,13,-6
4,5,279,8,19,-11
4,5,280,12,22,-10
4,5,281,5,4,1
4,5,282,16,18,-2
4,5,283,8,3,5
4,5,284,12,21,-9
4,5,285,13,19,-6
4,5,286,13,15,-2
4,5,287,14,19,-5
4,5,288,13,11,2
4,5,289,10,5,5
4,5,290,19,21,-2
4,5,291,19,8,11
4,5,292,11,12,-1
4,5,293,14,2,12
4,5,294,4,8,-4
4,5,295,14,17,-3
4,5,296,11,11,0
4,5,297,18,7,11
4,5,298,15,26,-11
4,5,299,11,9,2
4,6,0,12,4,8
4,6,1,5,11,-6
4,6,2,9,6,3
4,6,3,8,5,3
4,6,4,13,4,9
4,6,5,17,25,-8
4,6,6,8,11,-3
4,6,7,12,8,4
4,6,8,17,14,3
4,6,9,23,10,13
4,6,10,14,28,-14
4,6,11,15,17,-2
4,6,12,9,6,3
4,6,13,12,12,0
4,6,14,18,15,3
4,6,15,14,20,-6
4,6,16,14,9,5
4,6,17,12,12,0
4,6,18,18,21,-3
4,6,19,11,22,-11
4,6,20,14,7,7
4,6,21,22,17,5
4,6,22,21,13,8
4,6,23,13,19,-6
4,6,24,26,12,14
4,6,25,8,14,-6
4,6,26,15,11,4
4,6,27,5,0,5
4,6,28,6,5,1
4,6,29,12,22,-10
4,6,30,13,14,-1
4,6,31,2,7,-5
4,6,32,12,12,0
4,6,33,6,26,-20
4,6,34,6,5,1
4,6,35,19,4,15
4,6,36,19,17,2
4,6,37,9,18,-9
4,6,38,19,6,13
4,6,39,12,14,-2
4,6,40,10,11,-1
4,6,41,7,11,-4
4,6,42,5,10,-5
4,6,43,14,11,3
4,6,44,10,9,1
4,6,45,4,4,0
4,6,46,13,18,-5
4,6,47,9,3,6
4,6,48,7,5,2
4,6,49,7,28,-21
4,6,50,10,22,-12
4,6,51,16,17,-1
4,6,52,20,13,7
4,6,53,13,9,4
4,6,54,5,11,-6
4,6,55,12,14,-2
4,6,56,4,10,-6
4,6,57,12,11,1
4,6,58,6,7,-1
4,6,59,12,14,-2
4,6,60,2,11,-9
4,6,61,20,25,-5
4,6,62,6,3,3
4,6,63,15,19,-4
4,6,64,8,8,0
4,6,65,14,21,-7
4,6,66,9,6,3
4,6,67,15,36,-21
4,6,68,9,7,2
4,6,69,16,16,0
4,6,70,22,10,12
4,6,71,11,5,6
4,6,72,16,11,5
4,6,73,22,16,6
4,6,74,8,7,1
4,6,75,15,13,2
4,6,76,11,8,3
4,6,77,17,17,0
4,6,78,6,13,-7
4,6,79,16,6,10
4,6,80,20,9,11
4,6,81,19,14,5
4,6,82,10,9,1
4,6,83,14,16,-2
4,6,84,17,14,3
4,6,85,12,14,-2
4,6,86,7,13,-6
4,6,87,13,17,-4
4,6,88,19,18,1
4,6,89,15,11,4
4,6,90,14,10,4
4,6,91,17,14,3
4,6,92,12,11,1
4,6,93,14,17,-3
4,6,94,10,8,2
4,6,95,15,8,7
4,6,96,28,15,13
4,6,97,11,6,5
4,6,98,10,32,-22
4,6,99,22,15,7
4,6,100,7,6,1
4,6,101,21,14,7
4,6,102,7,19,-12
4,6,103,13,16,-3
4,6,104,17,15,2
4,6,105,4,3,1
4,6,106,30,15,15
4,6,107,15,8,7
4,6,108,17,12,5
4,6,109,24,22,2
4,6,110,16,10,6
4,6,111,13,11,2
4,6,112,14,11,3
4,6,113,7,12,-5
4,6,114,11,16,-5
4,6,115,11,16,-5
4,6,116,4,7,-3
4,6,117,18,19,-1
4,6,118,8,18,-10
4,6,119,13,8,5
4,6,120,15,8,7
4,6,121,8,19,-11
4,6,122,11,16,-5
4,6,123,17,24,-7
4,6,124,14,6,8
4,6,125,15,6,9
4,6,126,8,6,2
4,6,127,15,11,4
4,6,128,13,13,0
4,6,129,6,4,2
4,6,130,13,18,-5
4,6,131,11,24,-13
4,6,132,8,5,3
4,6,133,16,10,6
4,6,134,20,19,1
4,6,135,4,6,-2
4,6,136,17,24,-7
4,6,137,14,10,4
4,6,138,22,10,12
4,6,139,12,4,8
4,6,140,11,23,-12
4,6,141,6,2,4
4,6,142,10,9,1
4,6,143,12,13,-1
4,6,144,11,6,5
4,6,145,6,10,-4
4,6,146,14,6,8
4,6,147,12,5,7
4,6,148,8,16,-8
4,6,149,7,12,-5
4,6,150,15,12,3
4,6,151,11,5,6
4,6,152,7,15,-8
4,6,153,7,5,2
4,6,154,13,17,-4
4,6,155,16,10,6
4,6,156,19,19,0
4,6,157,4,10,-6
4,6,158,15,8,7
4,6,159,5,4,1
4,6,160,17,14,3
4,6,161,5,4,1
4,6,162,6,14,-8
4,6,163,23,25,-2
4,6,164,24,13,11
4,6,165,9,3,6
4,6,166,17,18,-1
4,6,167,8,9,-1
4,6,168,6,10,-4
4,6,169,7,11,-4
4,6,170,14,12,2
4,6,171,8,4,4
4,6,172,17,18,-1
4,6,173,3,17,-14
4,6,174,9,12,-3
4,6,175,5,6,-1
4,6,176,17,31,-14
4,6,177,17,19,-2
4,6,178,17,14,3
4,6,179,6,15,-9
4,6,180,11,7,4
4,6,181,8,19,-11
4,6,182,8,11,-3
4,6,183,17,15,2
4,6,184,12,13,-1
4,6,185,9,1,8
4,6,186,9,10,-1
4,6,187,2,6,-4
4,6,188,10,4,6
4,6,189,25,17,8
4,6,190,4,9,-5
4,6,191,19,14,5
4,6,192,8,11,-3
4,6,193,27,8,19
4,6,194,14,23,-9
4,6,195,15,7,8
4,6,196,11,7,4
4,6,197,12,5,7
4,6,198,19,10,9
4,6,199,4,6,-2
4,6,200,2,7,-5
4,6,201,9,8,1
4,6,202,14,13,1
4,6,203,11,21,-10
4,6,204,18,17,1
4,6,205,6,24,-18
4,6,206,6,6,0
4,6,207,6,7,-1
4,6,208,14,13,1
4,6,209,11,16,-5
4,6,210,14,11,3
4,6,211,17,17,0
4,6,212,14,13,1
4,6,213,17,7,10
4,6,214,15,18,-3
4,6,215,20,15,5
4,6,216,15,11,4
4,6,217,7,7,0
4,6,218,5,5,0
4,6,219,9,14,-5
4,6,220,7,10,-3
4,6,221,8,14,-6
4,6,222,28,15,13
4,6,223,14,12,2
4,6,224,8,11,-3
4,6,225,6,6,0
4,6,226,8,5,3
4,6,227,13,15,-2
4,6,228,7,17,-10
4,6,229,19,13,6
4,6,230,19,9,10
4,6,231,14,29,-15
4,6,232,2,7,-5
4,6,233,23,10,13
4,6,234,17,14,3
4,6,235,9,9,0
4,6,236,13,10,3
4,6,237,11,17,-6
4,6,238,13,17,-4
4,6,239,6,0,6
4,6,240,9,6,3
4,6,241,6,15,-9
4,6,242,7,10,-3
4,6,243,1,3,-2
4,6,244,12,22,-10
4,6,245,16,9,7
4,6,246,6,15,-9
4,6,247,9,10,-1
4,6,248,13,15,-2
4,6,249,16,8,8
4,6,250,8,19,-11
4,6,251,12,12,0
4,6,252,6,9,-3
4,6,253,11,16,-5
4,6,254,18,7,11
4,6,255,8,4,4
4,6,256,14,10,4
4,6,257,20,6,14
4,6,258,12,7,5
4,6,259,26,16,10
4,6,260,2,5,-3
4,6,261,12,16,-4
4,6,262,6,17,-11
4,6,263,13,8,5
4,6,264,14,23,-9
4,6,265,20,8,12
4,6,266,6,3,3
4,6,267,18,14,4
4,6,268,3,6,-3
4,6,269,14,26,-12
4,6,270,7,12,-5
4,6,271,10,15,-5
4,6,272,13,5,8
4,6,273,13,17,-4
4,6,274,11,11,0
4,6,275,6,15,-9
4,6,276,16,21,-5
4,6,277,16,1,15
4,6,278,13,12,1
4,6,279,10,6,4
4,6,280,23,27,-4
4,6,281,2,5,-3
4,6,282,13,13,0
4,6,283,15,20,-5
4,6,284,7,5,2
4,6,285,9,8,1
4,6,286,11,13,-2
4,6,287,8,7,1
4,6,288,29,9,20
4,6,289,12,17,-5
4,6,290,14,10,4
4,6,291,10,17,-7
4,6,292,17,24,-7
4,6,293,8,16,-8
4,6,294,11,8,3
4,6,295,8,11,-3
4,6,296,16,23,-7
4,6,297,14,22,-8
4,6,298,9,12,-3
4,6,299,9,4,5
4,7,0,13,15,-2
4,7,1,7,11,-4
4,7,2,7,28,-21
4,7,3,11,9,2
4,7,4,9,13,-4
4,7,5,12,19,-7
4,7,6,16,13,3
4,7,7,28,22,6
4,7,8,23,25,-2
4,7,9,11,14,-3
4,7,10,17,23,-6
4,7,11,4,5,-1
4,7,12,9,9,0
4,7,13,21,19,2
4,7,14,18,20,-2
4,7,15,13,22,-9
4,7,16,21,21,0
4,7,17,21,5,16
4,7,18,14,6,8
4,7,19,12,21,-9
4,7,20,15,14,1
4,7,21,16,20,-4
4,7,22,22,14,8
4,7,23,19,9,10
4,7,24,31,30,1
4,7,25,2,15,-13
4,7,26,11,19,-8
4,7,27,16,14,2
4,7,28,14,19,-5
4,7,29,14,19,-5
4,7,30,15,1,14
4,7,31,5,11,-6
4,7,32,15,8,7
4,7,33,12,15,-3
4,7,34,8,13,-5
4,7,35,5,13,-8
4,7,36,16,12,4
4,7,37,11,5,6
4,7,38,12,7,5
4,7,39,18,3,15
4,7,40,9,16,-7
4,7,41,3,2,1
4,7,42,30,26,4
4,7,43,21,6,15
4,7,44,18,24,-6
4,7,45,23,11,12
4,7,46,9,10,-1
4,7,47,8,12,-4
4,7,48,11,22,-11
4,7,49,9,15,-6
4,7,50,23,22,1
4,7,51,23,16,7
4,7,52,12,4,8
4,7,53,16,10,6
4,7,54,15,23,-8
4,7,55,20,8,12
4,7,56,6,9,-3
4,7,57,24,20,4
4,7,58,9,5,4
4,7,59,28,18,10
4,7,60,11,13,-2
4,7,61,28,17,11
4,7,62,18,12,6
4,7,63,15,26,-11
4,7,64,14,11,3
4,7,65,23,10,13
4,7,66,6,3,3
4,7,67,10,6,4
4,7,68,16,10,6
4,7,69,15,12,3
4,7,70,22,18,4
4,7,71,6,9,-3
4,7,72,9,14,-5
4,7,73,9,27,-18
4,7,74,10,5,5
4,7,75,13,18,-5
4,7,76,16,19,-3
4,7,77,15,5,10
4,7,78,13,12,1
4,7,79,6,8,-2
4,7,80,11,21,-10
4,7,81,15,8,7
4,7,82,19,6,13
4,7,83,18,20,-2
4,7,84,17,16,1
4,7,85,27,17,10
4,7,86,18,10,8
4,7,87,17,23,-6
4,7,88,14,16,-2
4,7,89,21,20,1
4,7,90,14,11,3
4,7,91,13,10,3
4,7,92,8,8,0
4,7,93,21,7,14
4,7,94,8,9,-1
4,7,95,19,18,1
4,7,96,8,15,-7
4,7,97,16,20,-4
4,7,98,8,9,-1
4,7,99,23,20,3
4,7,100,20,12,8
4,7,101,13,14,-1
4,7,102,20,11,9
4,7,103,8,6,2
4,7,104,9,20,-11
4,7,105,19,6,13
4,7,106,21,24,-3
4,7,107,14,5,9
4,7,108,12,16,-4
4,7,109,4,7,-3
4,7,110,8,7,1
4,7,111,21,29,-8
4,7,112,12,11,1
4,7,113,9,10,-1
4,7,114,13,12,1
4,7,115,16,12,4
4,7,116,16,5,11
4,7,117,14,13,1
4,7,118,25,13,12
4,7,119,12,14,-2
4,7,120,9,15,-6
4,7,121,11,13,-2
4,7,122,8,15,-7
4,7,123,15,15,0
4,7,124,19,21,-2
4,7,125,15,12,3
4,7,126,7,11,-4
4,7,127,13,8,5
4,7,128,12,7,5
4,7,129,8,14,-6
4,7,130,21,14,7
4,7,131,20,14,6
4,7,132,12,14,-2
4,7,133,13,6,7
4,7,134,15,18,-3
4,7,135,11,7,4
4,7,136,16,14,2
4,7,137,13,9,4
4,7,138,13,11,2
4,7,139,11,10,1
4,7,140,6,12,-6
4,7,141,5,6,-1
4,7,142,4,8,-4
4,7,143,13,11,2
4,7,144,6,10,-4
4,7,145,16,14,2
4,7,146,6,8,-2
4,7,147,24,18,6
4,7,148,15,10,5
4,7,149,10,11,-1
4,7,150,15,16,-1
4,7,151,3,7,-4
4,7,152,19,16,3
4,7,153,5,5,0
4,7,154,12,17,-5
4,7,155,7,15,-8
4,7,156,2,2,0
4,7,157,9,23,-14
4,7,158,15,20,-5
4,7,159,19,17,2
4,7,160,8,5,3
4,7,161,12,13,-1
4,7,162,17,10,7
4,7,163,13,10,3
4,7,164,14,18,-4
4,7,165,16,10,6
4,7,166,20,5,15
4,7,167,18,12,6
4,7,168,33,11,22
4,7,169,9,13,-4
4,7,170,12,5,7
4,7,171,6,7,-1
4,7,172,10,3,7
4,7,173,14,10,4
4,7,174,9,16,-7
4,7,175,10,7,3
4,7,176,18,26,-8
4,7,177,8,12,-4
4,7,178,30,15,15
4,7,179,12,6,6
4,7,180,15,8,7
4,7,181,12,14,-2
4,7,182,18,25,-7
4,7,183,14,9,5
4,7,184,10,21,-11
4,7,185,22,26,-4
4,7,186,16,17,-1
4,7,187,14,15,-1
4,7,188,16,7,9
4,7,189,9,15,-6
4,7,190,10,9,1
4,7,191,14,15,-1
4,7,192,16,16,0
4,7,193,8,14,-6
4,7,194,10,14,-4
4,7,195,10,17,-7
4,7,196,14,10,4
4,7,197,9,15,-6
4,7,198,16,10,6
4,7,199,6,5,1
4,7,200,9,12,-3
4,7,201,15,14,1
4,7,202,12,9,3
4,7,203,24,14,10
4,7,204,11,14,-3
4,7,205,12,12,0
4,7,206,17,10,7
4,7,207,24,14,10
4,7,208,13,10,3
4,7,209,18,9,9
4,7,210,17,8,9
4,7,211,13,14,-1
4,7,212,9,6,3
4,7,213,17,24,-7
4,7,214,16,11,5
4,7,215,19,17,2
4,7,216,19,19,0
4,7,217,11,15,-4
4,7,218,11,21,-10
4,7,219,20,18,2
4,7,220,11,2,9
4,7,221,16,10,6
4,7,222,4,10,-6
4,7,223,13,10,3
4,7,224,12,5,7
4,7,225,11,10,1
4,7,226,6,5,1
4,7,227,15,17,-2
4,7,228,4,7,-3
4,7,229,13,0,13
4,7,230,13,9,4
4,7,231,12,13,-1
4,7,232,16,12,4
4,7,233,16,14,2
4,7,234,9,10,-1
4,7,235,5,16,-11
4,7,236,28,15,13
4,7,237,8,15,-7
4,7,238,13,12,1
4,7,239,15,6,9
4,7,240,11,10,1
4,7,241,9,5,4
4,7,242,20,15,5
4,7,243,17,8,9
4,7,244,15,10,5
4,7,245,13,24,-11
4,7,246,12,11,1
4,7,247,13,6,7
4,7,248,12,10,2
4,7,249,13,20,-7
4,7,250,9,13,-4
4,7,251,6,10,-4
4,7,252,13,10,3
4,7,253,12,18,-6
4,7,254,2,2,0
4,7,255,11,11,0
4,7,256,11,17,-6
4,7,257,9,21,-12
4,7,258,21,13,8
4,7,259,12,22,-10
4,7,260,14,13,1
4,7,261,13,6,7
4,7,262,9,14,-5
4,7,263,22,9,13
4,7,264,6,10,-4
4,7,265,7,18,-11
4,7,266,21,26,-5
4,7,267,11,13,-2
4,7,268,30,11,19
4,7,269,11,8,3
4,7,270,9,13,-4
4,7,271,11,8,3
4,7,272,5,9,-4
4,7,273,11,6,5
4,7,274,7,5,2
4,7,275,12,14,-2
4,7,276,18,17,1
4,7,277,12,17,-5
4,7,278,19,12,7
4,7,279,4,4,0
4,7,280,13,7,6
4,7,281,5,7,-2
4,7,282,13,15,-2
4,7,283,5,13,-8
4,7,284,6,8,-2
4,7,285,14,17,-3
4,7,286,17,11,6
4,7,287,6,12,-6
4,7,288,7,8,-1
4,7,289,15,17,-2
4,7,290,11,9,2
4,7,291,21,18,3
4,7,292,21,10,11
4,7,293,9,6,3
4,7,294,5,6,-1
4,7,295,15,30,-15
4,7,296,25,14,11
4,7,297,14,14,0
4,7,298,19,21,-2
4,7,299,6,7,-1
4,8,0,15,9,6
4,8,1,10,8,2
4,8,2,18,11,7
4,8,3,16,17,-1
4,8,4,17,13,4
4,8,5,11,18,-7
4,8,6,9,15,-6
4,8,7,19,16,3
4,8,8,8,10,-2
4,8,9,23,11,12
4,8,10,10,8,2
4,8,11,12,7,5
4,8,12,8,16,-8
4,8,13,5,12,-7
4,8,14,10,10,0
4,8,15,10,4,6
4,8,16,12,20,-8
4,8,17,21,16,5
4,8,18,9,19,-10
4,8,19,19,9,10
4,8,20,13,14,-1
4,8,21,9,9,0
4,8,22,3,6,-3
4,8,23,19,13,6
4,8,24,14,18,-4
4,8,25,20,30,-10
4,8,26,18,11,7
4,8,27,9,11,-2
4,8,28,11,9,2
4,8,29,28,12,16
4,8,30,18,9,9
4,8,31,15,21,-6
4,8,32,14,10,4
4,8,33,8,9,-1
4,8,34,10,9,1
4,8,35,15,5,10
4,8,36,17,22,-5
4,8,37,3,8,-5
4,8,38,13,9,4
4,8,39,6,16,-10
4,8,40,12,13,-1
4,8,41,14,10,4
4,8,42,5,12,-7
4,8,43,9,15,-6
4,8,44,11,16,-5
4,8,45,17,13,4
4,8,46,11,14,-3
4,8,47,13,5,8
4,8,48,10,7,3
4,8,49,10,11,-1
4,8,50,13,6,7
4,8,51,12,11,1
4,8,52,10,10,0
4,8,53,15,18,-3
4,8,54,8,13,-5
4,8,55,16,11,5
4,8,56,20,15,5
4,8,57,15,17,-2
4,8,58,11,14,-3
4,8,59,25,18,7
4,8,60,21,28,-7
4,8,61,16,3,13
4,8,62,7,8,-1
4,8,63,14,10,4
4,8,64,11,11,0
4,8,65,11,14,-3
4,8,66,10,8,2
4,8,67,23,12,11
4,8,68,19,12,7
4,8,69,19,17,2
4,8,70,15,9,6
4,8,71,14,7,7
4,8,72,9,2,7
4,8,73,19,15,4
4,8,74,18,13,5
4,8,75,14,19,-5
4,8,76,19,15,4
4,8,77,12,23,-11
4,8,78,13,17,-4
4,8,79,3,4,-1
4,8,80,21,9,12
4,8,81,1,5,-4
4,8,82,7,15,-8
4,8,83,17,10,7
4,8,84,16,12,4
4,8,85,19,13,6
4,8,86,10,7,3
4,8,87,16,14,2
4,8,88,29,10,19
4,8,89,17,15,2
4,8,90,20,14,6
4,8,91,10,8,2
4,8,92,14,17,-3
4,8,93,17,23,-6
4,8,94,10,13,-3
4,8,95,5,12,-7
4,8,96,19,12,7
4,8,97,23,20,3
4,8,98,13,8,5
4,8,99,8,17,-9
4,8,100,11,12,-1
4,8,101,9,18,-9
4,8,102,3,6,-3
4,8,103,17,10,7
4,8,104,18,9,9
4,8,105,26,11,15
4,8,106,21,25,-4
4,8,107,11,12,-1
4,8,108,6,10,-4
4,8,109,15,14,1
4,8,110,9,10,-1
4,8,111,18,17,1
4,8,112,12,12,0
4,8,113,13,7,6
4,8,114,23,18,5
4,8,115,15,10,5
4,8,116,5,5,0
4,8,117,12,14,-2
4,8,118,8,15,-7
4,8,119,7,11,-4
4,8,120,7,9,-2
4,8,121,18,9,9
4,8,122,2,11,-9
4,8,123,5,7,-2
4,8,124,21,21,0
4,8,125,8,27,-19
4,8,126,17,14,3
4,8,127,11,15,-4
4,8,128,16,16,0
4,8,129,14,10,4
4,8,130,18,26,-8
4,8,131,10,12,-2
4,8,132,12,12,0
4,8,133,19,12,7
4,8,134,6,13,-7
4,8,135,29,21,8
4,8,136,17,7,10
4,8,137,15,15,0
4,8,138,22,25,-3
4,8,139,11,8,3
4,8,140,10,18,-8
4,8,141,10,8,2
4,8,142,10,9,1
4,8,143,5,15,-10
4,8,144,13,7,6
4,8,145,15,13,2
4,8,146,25,17,8
4,8,147,16,9,7
4,8,148,12,14,-2
4,8,149,13,8,5
4,8,150,17,21,-4
4,8,151,23,15,8
4,8,152,16,11,5
4,8,153,33,18,15
4,8,154,19,14,5
4,8,155,13,21,-8
4,8,156,12,14,-2
4,8,157,7,13,-6
4,8,158,18,13,5
4,8,159,16,10,6
4,8,160,10,8,2
4,8,161,4,10,-6
4,8,162,13,12,1
4,8,163,11,17,-6
4,8,164,4,16,-12
4,8,165,4,6,-2
4,8,166,13,20,-7
4,8,167,15,16,-1
4,8,168,12,11,1
4,8,169,12,27,-15
4,8,170,12,19,-7
4,8,171,17,11,6
4,8,172,28,21,7
4,8,173,17,12,5
4,8,174,26,22,4
4,8,175,6,4,2
4,8,176,21,13,8
4,8,177,6,11,-5
4,8,178,13,7,6
4,8,179,22,8,14
4,8,180,11,13,-2
4,8,181,4,4,0
4,8,182,23,11,12
4,8,183,16,7,9
4,8,184,6,11,-5
4,8,185,10,15,-5
4,8,186,11,7,4
4,8,187,18,15,3
4,8,188,7,7,0
4,8,189,9,8,1
4,8,190,5,8,-3
4,8,191,13,8,5
4,8,192,9,14,-5
4,8,193,11,11,0
4,8,194,16,20,-4
4,8,195,13,12,1
4,8,196,11,4,7
4,8,197,10,9,1
4,8,198,6,0,6
4,8,199,28,16,12
4,8,200,14,15,-1
4,8,201,13,13,0
4,8,202,20,21,-1
4,8,203,15,21,-6
4,8,204,22,9,13
4,8,205,10,3,7
4,8,206,15,11,4
4,8,207,5,6,-1
4,8,208,5,3,2
4,8,209,10,11,-1
4,8,210,10,14,-4
4,8,211,5,10,-5
4,8,212,16,13,3
4,8,213,11,25,-14
4,8,214,10,9,1
4,8,215,13,11,2
4,8,216,6,13,-7
4,8,217,14,21,-7
4,8,218,27,14,13
4,8,219,18,9,9
4,8,220,12,11,1
4,8,221,12,26,-14
4,8,222,13,10,3
4,8,223,5,10,-5
4,8,224,7,12,-5
4,8,225,5,7,-2
4,8,226,12,20,-8
4,8,227,8,19,-11
4,8,228,27,19,8
4,8,229,10,15,-5
4,8,230,15,18,-3
4,8,231,15,11,4
4,8,232,15,11,4
4,8,233,27,8,19
4,8,234,24,15,9
4,8,235,17,15,2
4,8,236,12,5,7
4,8,237,6,9,-3
4,8,238,20,13,7
4,8,239,12,5,7
4,8,240,13,10,3
4,8,241,17,16,1
4,8,242,6,25,-19
4,8,243,9,19,-10
4,8,244,20,16,4
4,8,245,20,2,18
4,8,246,5,15,-10
4,8,247,22,11,11
4,8,248,11,8,3
4,8,249,5,14,-9
4,8,250,11,12,-1
4,8,251,13,7,6
4,8,252,6,17,-11
4,8,253,9,12,-3
4,8,254,11,12,-1
4,8,255,12,10,2
4,8,256,11,19,-8
4,8,257,14,14,0
4,8,258,9,8,1
4,8,259,8,11,-3
4,8,260,22,9,13
4,8,261,7,17,-10
4,8,262,3,10,-7
4,8,263,11,22,-11
4,8,264,15,8,7
4,8,265,13,9,4
4,8,266,15,28,-13
4,8,267,14,11,3
4,8,268,11,17,-6
4,8,269,15,22,-7
4,8,270,14,9,5
4,8,271,6,11,-5
4,8,272,20,16,4
4,8,273,31,12,19
4,8,274,12,17,-5
4,8,275,10,9,1
4,8,276,16,19,-3
4,8,277,11,12,-1
4,8,278,14,10,4
4,8,279,11,15,-4
4,8,280,15,17,-2
4,8,281,11,8,3
4,8,282,8,9,-1
4,8,283,12,13,-1
4,8,284,12,23,-11
4,8,285,13,10,3
4,8,286,17,16,1
4,8,287,11,21,-10
4,8,288,10,13,-3
4,8,289,13,12,1
4,8,290,8,21,-13
4,8,291,17,15,2
4,8,292,11,11,0
4,8,293,19,9,10
4,8,294,4,6,-2
4,8,295,16,6,10
4,8,296,15,12,3
4,8,297,7,0,7
4,8,298,15,9,6
4,8,299,10,12,-2
4,9,0,35,22,13
4,9,1,10,13,-3
4,9,2,14,9,5
4,9,3,6,16,-10
4,9,4,14,13,1
4,9,5,3,12,-9
4,9,6,10,21,-11
4,9,7,12,9,3
4,9,8,24,22,2
4,9,9,12,11,1
4,9,10,10,11,-1
4,9,11,21,11,10
4,9,12,15,17,-2
4,9,13,16,15,1
4,9,14,12,7,5
4,9,15,16,6,10
4,9,16,17,27,-10
4,9,17,3,5,-2
4,9,18,8,9,-1
4,9,19,20,12,8
4,9,20,6,15,-9
4,9,21,14,10,4
4,9,22,8,6,2
4,9,23,30,21,9
4,9,24,16,4,12
4,9,25,11,16,-5
4,9,26,9,14,-5
4,9,27,24,16,8
4,9,28,28,14,14
4,9,29,7,27,-20
4,9,30,12,10,2
4,9,31,15,15,0
4,9,32,5,14,-9
4,9,33,19,15,4
4,9,34,18,13,5
4,9,35,15,21,-6
4,9,36,21,20,1
4,9,37,4,15,-11
4,9,38,21,13,8
4,9,39,14,15,-1
4,9,40,13,14,-1
4,9,41,16,17,-1
4,9,42,14,7,7
4,9,43,16,15,1
4,9,44,10,8,2
4,9,45,8,5,3
4,9,46,25,21,4
4,9,47,28,14,14
4,9,48,12,11,1
4,9,49,10,10,0
4,9,50,14,10,4
4,9,51,12,10,2
4,9,52,12,11,1
4,9,53,22,15,7
4,9,54,17,18,-1
4,9,55,10,13,-3
4,9,56,26,31,-5
4,9,57,12,4,8
4,9,58,20,6,14
4,9,59,19,10,9
4,9,60,14,13,1
4,9,61,21,16,5
4,9,62,14,14,0
4,9,63,15,13,2
4,9,64,12,10,2
4,9,65,4,5,-1
4,9,66,13,29,-16
4,9,67,11,7,4
4,9,68,30,14,16
4,9,69,23,20,3
4,9,70,10,16,-6
4,9,71,5,10,-5
4,9,72,16,4,12
4,9,73,8,6,2
4,9,74,12,19,-7
4,9,75,13,21,-8
4,9,76,14,14,0
4,9,77,17,17,0
4,9,78,7,12,-5
4,9,79,11,12,-1
4,9,80,12,10,2
4,9,81,16,11,5
4,9,82,19,28,-9
4,9,83,8,13,-5
4,9,84,14,8,6
4,9,85,28,18,10
4,9,86,16,10,6
4,9,87,21,14,7
4,9,88,23,15,8
4,9,89,20,22,-2
4,9,90,18,11,7
4,9,91,10,13,-3
4,9,92,8,13,-5
4,9,93,27,25,2
4,9,94,13,25,-12
4,9,95,7,15,-8
4,9,96,9,18,-9
4,9,97,15,13,2
4,9,98,14,13,1
4,9,99,16,13,3
4,9,100,21,25,-4
4,9,101,24,14,10
4,9,102,10,10,0
4,9,103,14,17,-3
4,9,104,27,14,13
4,9,105,21,17,4
4,9,106,11,6,5
4,9,107,13,7,6
4,9,108,13,7,6
4,9,109,26,17,9
4,9,110,29,14,15
4,9,111,11,12,-1
4,9,112,20,14,6
4,9,113,14,23,-9
4,9,114,13,8,5
4,9,115,18,5,13
4,9,116,11,12,-1
4,9,117,14,9,5
4,9,118,21,25,-4
4,9,119,10,16,-6
4,9,120,4,10,-6
4,9,121,5,13,-8
4,9,122,25,9,16
4,9,123,15,7,8
4,9,124,10,7,3
4,9,125,6,7,-1
4,9,126,20,25,-5
4,9,127,14,7,7
4,9,128,15,8,7
4,9,129,2,3,-1
4,9,130,23,25,-2
4,9,131,10,9,1
4,9,132,21,26,-5
4,9,133,14,7,7
4,9,134,22,6,16
4,9,135,20,11,9
4,9,136,9,30,-21
4,9,137,14,21,-7
4,9,138,25,16,9
4,9,139,23,25,-2
4,9,140,42,15,27
4,9,141,10,16,-6
4,9,142,9,8,1
4,9,143,34,14,20
4,9,144,13,16,-3
4,9,145,18,11,7
4,9,146,11,13,-2
4,9,147,6,9,-3
4,9,148,7,5,2
4,9,149,10,6,4
4,9,150,20,16,4
4,9,151,18,5,13
4,9,152,16,12,4
4,9,153,16,5,11
4,9,154,2,4,-2
4,9,155,14,15,-1
4,9,156,21,11,10
4,9,157,13,15,-2
4,9,158,9,7,2
4,9,159,16,17,-1
4,9,160,20,18,2
4,9,161,18,7,11
4,9,162,10,16,-6
4,9,163,12,10,2
4,9,164,18,27,-9
4,9,165,8,9,-1
4,9,166,15,12,3
4,9,167,13,6,7
4,9,168,13,10,3
4,9,169,12,9,3
4,9,170,8,13,-5
4,9,171,21,15,6
4,9,172,15,19,-4
4,9,173,15,9,6
4,9,174,10,11,-1
4,9,175,23,19,4
4,9,176,24,20,4
4,9,177,35,11,24
4,9,178,15,19,-4
4,9,179,14,12,2
4,9,180,10,10,0
4,9,181,16,18,-2
4,9,182,18,12,6
4,9,183,12,27,-15
4,9,184,24,19,5
4,9,185,21,13,8
4,9,186,15,13,2
4,9,187,7,10,-3
4,9,188,29,11,18
4,9,189,18,11,7
4,9,190,12,12,0
4,9,191,15,19,-4
4,9,192,13,10,3
4,9,193,9,14,-5
4,9,194,7,8,-1
4,9,195,20,13,7
4,9,196,13,22,-9
4,9,197,15,18,-3
4,9,198,19,13,6
4,9,199,13,18,-5
4,9,200,18,13,5
4,9,201,18,16,2
4,9,202,16,13,3
4,9,203,17,15,2
4,9,204,11,15,-4
4,9,205,16,9,7
4,9,206,19,26,-7
4,9,207,12,13,-1
4,9,208,12,9,3
4,9,209,27,12,15
4,9,210,21,23,-2
4,9,211,11,7,4
4,9,212,14,18,-4
4,9,213,22,12,10
4,9,214,15,14,1
4,9,215,11,10,1
4,9,216,12,15,-3
4,9,217,4,10,-6
4,9,218,11,11,0
4,9,219,23,22,1
4,9,220,10,4,6
4,9,221,20,17,3
4,9,222,20,15,5
4,9,223,17,29,-12
4,9,224,24,16,8
4,9,225,18,20,-2
4,9,226,16,13,3
4,9,227,11,7,4
4,9,228,7,15,-8
4,9,229,13,23,-10
4,9,230,17,17,0
4,9,231,18,21,-3
4,9,232,20,18,2
4,9,233,17,23,-6
4,9,234,12,13,-1
4,9,235,6,12,-6
4,9,236,25,19,6
4,9,237,15,13,2
4,9,238,19,5,14
4,9,239,21,15,6
4,9,240,15,14,1
4,9,241,6,11,-5
4,9,242,18,16,2
4,9,243,26,10,16
4,9,244,15,11,4
4,9,245,22,15,7
4,9,246,26,8,18
4,9,247,11,22,-11
4,9,248,14,14,0
4,9,249,12,19,-7
4,9,250,10,9,1
4,9,251,18,14,4
4,9,252,24,11,13
4,9,253,17,10,7
4,9,254,7,12,-5
4,9,255,19,4,15
4,9,256,13,12,1
4,9,257,12,16,-4
4,9,258,21,17,4
4,9,259,11,8,3
4,9,260,3,5,-2
4,9,261,8,15,-7
4,9,262,10,5,5
4,9,263,19,19,0
4,9,264,6,4,2
4,9,265,7,9,-2
4,9,266,19,15,4
4,9,267,18,16,2
4,9,268,6,17,-11
4,9,269,10,17,-7
4,9,270,16,23,-7
4,9,271,14,10,4
4,9,272,5,4,1
4,9,273,23,8,15
4,9,274,17,16,1
4,9,275,16,10,6
4,9,276,13,13,0
4,9,277,21,21,0
4,9,278,13,17,-4
4,9,279,12,20,-8
4,9,280,12,12,0
4,9,281,11,7,4
4,9,282,10,9,1
4,9,283,13,16,-3
4,9,284,11,16,-5
4,9,285,4,10,-6
4,9,286,12,9,3
4,9,287,16,13,3
4,9,288,26,14,12
4,9,289,13,16,-3
4,9,290,18,18,0
4,9,291,20,6,14
4,9,292,20,13,7
4,9,293,10,13,-3
4,9,294,15,14,1
4,9,295,25,18,7
4,9,296,5,12,-7
4,9,297,23,16,7
4,9,298,28,11,17
4,9,299,10,14,-4
4,10,0,22,13,9
4,10,1,19,13,6
4,10,2,13,4,9
4,10,3,15,7,8
4,10,4,29,7,22
4,10,5,19,14,5
4,10,6,25,8,17
4,10,7,11,13,-2
4,10,8,11,27,-16
4,10,9,12,6,6
4,10,10,13,16,-3
4,10,11,9,25,-16
4,10,12,13,12,1
4,10,13,20,14,6
4,10,14,18,22,-4
4,10,15,26,14,12
4,10,16,24,24,0
4,10,17,22,10,12
4,10,18,15,20,-5
4,10,19,13,11,2
4,10,20,13,8,5
4,10,21,14,19,-5
4,10,22,22,17,5
4,10,23,30,17,13
4,10,24,9,4,5
4,10,25,12,20,-8
4,10,26,18,11,7
4,10,27,17,12,5
4,10,28,7,7,0
4,10,29,11,11,0
4,10,30,6,6,0
4,10,31,21,14,7
4,10,32,9,9,0
4,10,33,25,9,16
4,10,34,17,18,-1
4,10,35,17,18,-1
4,10,36,22,21,1
4,10,37,13,4,9
4,10,38,12,12,0
4,10,39,30,22,8
4,10,40,9,5,4
4,10,41,5,3,2
4,10,42,14,17,-3
4,10,43,10,14,-4
4,10,44,32,12,20
4,10,45,10,8,2
4,10,46,8,15,-7
4,10,47,12,9,3
4,10,48,18,8,10
4,10,49,26,16,10
4,10,50,9,5,4
4,10,51,10,7,3
4,10,52,13,16,-3
4,10,53,27,21,6
4,10,54,10,4,6
4,10,55,9,12,-3
4,10,56,11,16,-5
4,10,57,16,20,-4
4,10,58,21,7,14
4,10,59,14,10,4
4,10,60,11,8,3
4,10,61,14,6,8
4,10,62,13,20,-7
4,10,63,20,11,9
4,10,64,25,19,6
4,10,65,22,15,7
4,10,66,17,14,3
4,10,67,16,22,-6
4,10,68,8,14,-6
4,10,69,14,8,6
4,10,70,10,18,-8
4,10,71,13,7,6
4,10,72,19,12,7
4,10,73,4,4,0
4,10,74,12,10,2
4,10,75,17,17,0
4,10,76,15,24,-9
4,10,77,7,9,-2
4,10,78,13,7,6
4,10,79,21,11,10
4,10,80,11,9,2
4,10,81,12,6,6
4,10,82,19,11,8
4,10,83,15,16,-1
4,10,84,4,10,-6
4,10,85,10,15,-5
4,10,86,21,15,6
4,10,87,15,20,-5
4,10,88,25,23,2
4,10,89,11,6,5
4,10,90,8,12,-4
4,10,91,16,9,7
4,10,92,16,11,5
4,10,93,10,21,-11
4,10,94,14,21,-7
4,10,95,12,20,-8
4,10,96,16,21,-5
4,10,97,8,17,-9
4,10,98,10,5,5
4,10,99,18,5,13
4,10,100,17,18,-1
4,10,101,9,11,-2
4,10,102,17,15,2
4,10,103,18,11,7
4,10,104,17,9,8
4,10,105,16,17,-1
4,10,106,15,13,2
4,10,107,25,12,13
4,10,108,10,7,3
4,10,109,15,8,7
4,10,110,11,15,-4
4,10,111,9,8,1
4,10,112,34,11,23
4,10,113,11,13,-2
4,10,114,8,14,-6
4,10,115,15,11,4
4,10,116,11,10,1
4,10,117,14,24,-10
4,10,118,3,7,-4
4,10,119,15,13,2
4,10,120,18,10,8
4,10,121,5,7,-2
4,10,122,9,14,-5
4,10,123,13,20,-7
4,10,124,17,12,5
4,10,125,24,18,6
4,10,126,16,9,7
4,10,127,19,9,10
4,10,128,6,15,-9
4,10,129,41,22,19
4,10,130,24,8,16
4,10,131,11,11,0
4,10,132,12,10,2
4,10,133,10,12,-2
4,10,134,11,17,-6
4,10,135,16,15,1
4,10,136,29,13,16
4,10,137,19,14,5
4,10,138,9,7,2
4,10,139,12,9,3
4,10,140,22,16,6
4,10,141,23,16,7
4,10,142,8,17,-9
4,10,143,10,15,-5
4,10,144,14,11,3
4,10,145,18,9,9
4,10,146,13,16,-3
4,10,147,10,12,-2
4,10,148,25,13,12
4,10,149,8,14,-6
4,10,150,15,27,-12
4,10,151,13,15,-2
4,10,152,14,14,0
4,10,153,6,3,3
4,10,154,12,7,5
4,10,155,14,16,-2
4,10,156,13,11,2
4,10,157,19,15,4
4,10,158,16,19,-3
4,10,159,12,2,10
4,10,160,18,8,10
4,10,161,30,21,9
4,10,162,17,24,-7
4,10,163,16,7,9
4,10,164,8,10,-2
4,10,165,10,14,-4
4,10,166,20,14,6
4,10,167,25,11,14
4,10,168,8,10,-2
4,10,169,15,14,1
4,10,170,28,15,13
4,10,171,23,12,11
4,10,172,16,22,-6
4,10,173,24,22,2
4,10,174,14,17,-3
4,10,175,4,10,-6
4,10,176,19,6,13
4,10,177,9,9,0
4,10,178,21,4,17
4,10,179,20,24,-4
4,10,180,13,6,7
4,10,181,13,21,-8
4,10,182,13,7,6
4,10,183,22,16,6
4,10,184,6,7,-1
4,10,185,19,22,-3
4,10,186,28,11,17
4,10,187,11,22,-11
4,10,188,8,3,5
4,10,189,20,28,-8
4,10,190,29,8,21
4,10,191,32,13,19
4,10,192,4,18,-14
4,10,193,14,10,4
4,10,194,18,8,10
4,10,195,25,19,6
4,10,196,22,17,5
4,10,197,9,9,0
4,10,198,8,16,-8
4,10,199,10,4,6
4,10,200,7,7,0
4,10,201,18,16,2
4,10,202,11,10,1
4,10,203,11,7,4
4,10,204,10,5,5
4,10,205,20,12,8
4,10,206,18,5,13
4,10,207,21,8,13
4,10,208,22,19,3
4,10,209,19,10,9
4,10,210,15,22,-7
4,10,211,8,4,4
4,10,212,12,16,-4
4,10,213,13,23,-10
4,10,214,15,8,7
4,10,215,14,9,5
4,10,216,15,7,8
4,10,217,10,11,-1
4,10,218,17,10,7
4,10,219,12,6,6
4,10,220,3,11,-8
4,10,221,9,10,-1
4,10,222,7,11,-4
4,10,223,17,8,9
4,10,224,8,10,-2
4,10,225,12,4,8
4,10,226,18,23,-5
4,10,227,3,1,2
4,10,228,14,7,7
4,10,229,21,9,12
4,10,230,16,11,5
4,10,231,13,9,4
4,10,232,14,5,9
4,10,233,12,4,8
4,10,234,17,25,-8
4,10,235,18,7,11
4,10,236,15,8,7
4,10,237,9,3,6
4,10,238,7,6,1
4,10,239,21,13,8
4,10,240,17,17,0
4,10,241,12,16,-4
4,10,242,8,25,-17
4,10,243,17,13,4
4,10,244,13,7,6
4,10,245,15,23,-8
4,10,246,11,22,-11
4,10,247,9,13,-4
4,10,248,21,11,10
4,10,249,21,12,9
4,10,250,10,12,-2
4,10,251,14,17,-3
4,10,252,18,8,10
4,10,253,18,13,5
4,10,254,12,15,-3
4,10,255,24,23,1
4,10,256,13,14,-1
4,10,257,14,7,7
4,10,258,2,9,-7
4,10,259,3,14,-11
4,10,260,18,10,8
4,10,261,12,7,5
4,10,262,14,12,2
4,10,263,14,10,4
4,10,264,7,16,-9
4,10,265,9,7,2
4,10,266,30,8,22
4,10,267,14,9,5
4,10,268,20,10,10
4,10,269,5,4,1
4,10,270,13,17,-4
4,10,271,19,9,10
4,10,272,21,9,12
4,10,273,22,10,12
4,10,274,15,16,-1
4,10,275,19,10,9
4,10,276,11,5,6
4,10,277,8,7,1
4,10,278,16,9,7
4,10,279,15,19,-4
4,10,280,15,15,0
4,10,281,14,4,10
4,10,282,8,5,3
4,10,283,27,11,16
4,10,284,13,13,0
4,10,285,15,19,-4
4,10,286,21,23,-2
4,10,287,12,8,4
4,10,288,25,18,7
4,10,289,16,7,9
4,10,290,11,17,-6
4,10,291,27,17,10
4,10,292,11,10,1
4,10,293,21,14,7
4,10,294,12,18,-6
4,10,295,12,4,8
4,10,296,17,8,9
4,10,297,15,15,0
4,10,298,13,16,-3
4,10,299,14,8,6
4,11,0,20,12,8
4,11,1,20,5,15
4,11,2,19,11,8
4,11,3,18,13,5
4,11,4,15,22,-7
4,11,5,12,10,2
4,11,6,23,10,13
4,11,7,12,9,3
4,11,8,14,10,4
4,11,9,12,6,6
4,11,10,19,18,1
4,11,11,19,19,0
4,11,12,11,12,-1
4,11,13,21,16,5
4,11,14,7,9,-2
4,11,15,17,17,0
4,11,16,26,16,10
4,11,17,15,10,5
4,11,18,12,16,-4
4,11,19,9,13,-4
4,11,20,28,19,9
4,11,21,14,16,-2
4,11,22,23,8,15
4,11,23,12,15,-3
4,11,24,18,11,7
4,11,25,12,13,-1
4,11,26,19,12,7
4,11,27,22,8,14
4,11,28,8,15,-7
4,11,29,13,12,1
4,11,30,12,8,4
4,11,31,16,14,2
4,11,32,12,15,-3
4,11,33,24,16,8
4,11,34,16,9,7
4,11,35,8,5,3
4,11,36,15,13,2
4,11,37,20,17,3
4,11,38,14,7,7
4,11,39,8,6,2
4,11,40,10,6,4
4,11,41,9,13,-4
4,11,42,7,9,-2
4,11,43,18,4,14
4,11,44,22,9,13
4,11,45,7,17,-10
4,11,46,8,10,-2
4,11,47,10,26,-16
4,11,48,4,13,-9
4,11,49,14,6,8
4,11,50,18,8,10
4,11,51,13,12,1
4,11,52,12,12,0
4,11,53,16,16,0
4,11,54,9,6,3
4,11,55,19,10,9
4,11,56,20,9,11
4,11,57,15,9,6
4,11,58,29,15,14
4,11,59,15,8,7
4,11,60,12,13,-1
4,11,61,16,16,0
4,11,62,7,11,-4
4,11,63,19,13,6
4,11,64,15,20,-5
4,11,65,18,17,1
4,11,66,17,18,-1
4,11,67,7,7,0
4,11,68,17,37,-20
4,11,69,5,7,-2
4,11,70,13,10,3
4,11,71,17,5,12
4,11,72,20,12,8
4,11,73,15,5,10
4,11,74,11,18,-7
4,11,75,21,17,4
4,11,76,14,12,2
4,11,77,7,6,1
4,11,78,4,7,-3
4,11,79,26,13,13
4,11,80,20,8,12
4,11,81,7,7,0
4,11,82,8,22,-14
4,11,83,21,5,16
4,11,84,16,18,-2
4,11,85,20,20,0
4,11,86,21,18,3
4,11,87,13,12,1
4,11,88,24,14,10
4,11,89,10,11,-1
4,11,90,7,3,4
4,11,91,13,15,-2
4,11,92,18,4,14
4,11,93,14,12,2
4,11,94,19,29,-10
4,11,95,14,7,7
4,11,96,20,13,7
4,11,97,20,12,8
4,11,98,16,12,4
4,11,99,18,10,8
4,11,100,14,13,1
4,11,101,26,14,12
4,11,102,33,31,2
4,11,103,13,20,-7
4,11,104,20,10,10
4,11,105,9,20,-11
4,11,106,19,10,9
4,11,107,20,3,17
4,11,108,20,9,11
4,11,109,18,26,-8
4,11,110,26,32,-6
4,11,111,11,18,-7
4,11,112,14,16,-2
4,11,113,9,14,-5
4,11,114,20,7,13
4,11,115,1,11,-10
4,11,116,17,14,3
4,11,117,8,11,-3
4,11,118,16,10,6
4,11,119,6,3,3
4,11,120,17,18,-1
4,11,121,17,7,10
4,11,122,9,7,2
4,11,123,6,11,-5
4,11,124,14,11,3
4,11,125,3,12,-9
4,11,126,12,3,9
4,11,127,22,23,-1
4,11,128,25,20,5
4,11,129,5,4,1
4,11,130,15,14,1
4,11,131,16,11,5
4,11,132,11,12,-1
4,11,133,12,13,-1
4,11,134,8,11,-3
4,11,135,24,8,16
4,11,136,15,8,7
4,11,137,19,17,2
4,11,138,17,14,3
4,11,139,16,8,8
4,11,140,8,17,-9
4,11,141,21,15,6
4,11,142,11,26,-15
4,11,143,37,19,18
4,11,144,14,16,-2
4,11,145,23,15,8
4,11,146,16,9,7
4,11,147,8,11,-3
4,11,148,17,8,9
4,11,149,10,17,-7
4,11,150,13,7,6
4,11,151,12,10,2
4,11,152,7,2,5
4,11,153,17,17,0
4,11,154,19,18,1
4,11,155,13,14,-1
4,11,156,21,9,12
4,11,157,13,6,7
4,11,158,8,13,-5
4,11,159,20,17,3
4,11,160,12,2,10
4,11,161,18,17,1
4,11,162,17,8,9
4,11,163,23,14,9
4,11,164,20,20,0
4,11,165,7,10,-3
4,11,166,18,15,3
4,11,167,14,8,6
4,11,168,17,11,6
4,11,169,18,11,7
4,11,170,13,9,4
4,11,171,18,9,9
4,11,172,30,15,15
4,11,173,10,3,7
4,11,174,24,11,13
4,11,175,14,6,8
4,11,176,25,13,12
4,11,177,19,14,5
4,11,178,1,4,-3
4,11,179,17,5,12
4,11,180,14,16,-2
4,11,181,39,3,36
4,11,182,34,29,5
4,11,183,9,10,-1
4,11,184,8,19,-11
4,11,185,19,12,7
4,11,186,23,15,8
4,11,187,18,12,6
4,11,188,13,12,1
4,11,189,15,10,5
4,11,190,29,32,-3
4,11,191,14,22,-8
4,11,192,14,22,-8
4,11,193,15,11,4
4,11,194,19,8,11
4,11,195,8,9,-1
4,11,196,10,7,3
4,11,197,20,10,10
4,11,198,12,12,0
4,11,199,15,28,-13
4,11,200,19,26,-7
4,11,201,17,13,4
4,11,202,8,8,0
4,11,203,14,10,4
4,11,204,13,17,-4
4,11,205,24,14,10
4,11,206,14,12,2
4,11,207,23,26,-3
4,11,208,25,18,7
4,11,209,17,15,2
4,11,210,19,3,16
4,11,211,11,8,3
4,11,212,18,4,14
4,11,213,17,15,2
4,11,214,19,15,4
4,11,215,7,11,-4
4,11,216,14,17,-3
4,11,217,14,9,5
4,11,218,12,9,3
4,11,219,17,14,3
4,11,220,21,17,4
4,11,221,12,8,4
4,11,222,14,17,-3
4,11,223,14,12,2
4,11,224,16,20,-4
4,11,225,19,15,4
4,11,226,7,4,3
4,11,227,14,7,7
4,11,228,4,12,-8
4,11,229,20,19,1
4,11,230,16,26,-10
4,11,231,12,8,4
4,11,232,16,15,1
4,11,233,29,6,23
4,11,234,15,12,3
4,11,235,10,11,-1
4,11,236,8,5,3
4,11,237,10,9,1
4,11,238,19,18,1
4,11,239,13,16,-3
4,11,240,18,7,11
4,11,241,11,6,5
4,11,242,30,15,15
4,11,243,14,13,1
4,11,244,30,18,12
4,11,245,17,13,4
4,11,246,18,18,0
4,11,247,18,14,4
4,11,248,17,11,6
4,11,249,26,24,2
4,11,250,4,1,3
4,11,251,13,8,5
4,11,252,12,1,11
4,11,253,22,15,7
4,11,254,20,14,6
4,11,255,17,27,-10
4,11,256,8,8,0
4,11,257,12,8,4
4,11,258,13,18,-5
4,11,259,21,9,12
4,11,260,10,10,0
4,11,261,12,10,2
4,11,262,12,8,4
4,11,263,10,13,-3
4,11,264,18,6,12
4,11,265,18,20,-2
4,11,266,9,11,-2
4,11,267,16,13,3
4,11,268,9,13,-4
4,11,269,24,15,9
4,11,270,26,16,10
4,11,271,10,7,3
4,11,272,17,19,-2
4,11,273,12,13,-1
4,11,274,15,7,8
4,11,275,17,12,5
4,11,276,22,14,8
4,11,277,15,23,-8
4,11,278,11,12,-1
4,11,279,19,4,15
4,11,280,6,18,-12
4,11,281,12,7,5
4,11,282,12,4,8
4,11,283,18,20,-2
4,11,284,19,14,5
4,11,285,10,15,-5
4,11,286,4,7,-3
4,11,287,16,7,9
4,11,288,14,18,-4
4,11,289,20,16,4
4,11,290,8,12,-4
4,11,291,16,15,1
4,11,292,15,13,2
4,11,293,16,6,10
4,11,294,18,29,-11
4,11,295,8,15,-7
4,11,296,12,13,-1
4,11,297,20,13,7
4,11,298,12,11,1
4,11,299,14,8,6
4,12,0,12,7,5
4,12,1,16,19,-3
4,12,2,16,5,11
4,12,3,21,14,7
4,12,4,24,5,19
4,12,5,16,17,-1
4,12,6,7,3,4
4,12,7,22,14,8
4,12,8,9,14,-5
4,12,9,5,15,-10
4,12,10,6,8,-2
4,12,11,20,14,6
4,12,12,13,9,4
4,12,13,9,12,-3
4,12,14,32,6,26
4,12,15,28,10,18
4,12,16,28,13,15
4,12,17,15,18,-3
4,12,18,14,10,4
4,12,19,11,5,6
4,12,20,19,21,-2
4,12,21,21,8,13
4,12,22,9,4,5
4,12,23,17,6,11
4,12,24,9,8,1
4,12,25,14,14,0
4,12,26,13,11,2
4,12,27,20,7,13
4,12,28,21,10,11
4,12,29,18,15,3
4,12,30,13,24,-11
4,12,31,20,9,11
4,12,32,17,19,-2
4,12,33,10,10,0
4,12,34,13,8,5
4,12,35,19,5,14
4,12,36,7,17,-10
4,12,37,9,12,-3
4,12,38,12,14,-2
4,12,39,19,4,15
4,12,40,5,13,-8
4,12,41,12,18,-6
4,12,42,14,16,-2
4,12,43,21,12,9
4,12,44,28,9,19
4,12,45,17,9,8
4,12,46,15,4,11
4,12,47,13,16,-3
4,12,48,8,11,-3
4,12,49,14,8,6
4,12,50,9,12,-3
4,12,51,19,15,4
4,12,52,23,7,16
4,12,53,26,13,13
4,12,54,15,18,-3
4,12,55,14,15,-1
4,12,56,16,4,12
4,12,57,13,7,6
4,12,58,27,22,5
4,12,59,8,14,-6
4,12,60,11,9,2
4,12,61,5,7,-2
4,12,62,17,13,4
4,12,63,20,14,6
4,12,64,12,11,1
4,12,65,14,14,0
4,12,66,10,7,3
4,12,67,15,15,0
4,12,68,15,11,4
4,12,69,13,16,-3
4,12,70,17,14,3
4,12,71,14,7,7
4,12,72,18,9,9
4,12,73,14,5,9
4,12,74,19,13,6
4,12,75,11,9,2
4,12,76,14,11,3
4,12,77,16,10,6
4,12,78,20,7,13
4,12,79,15,13,2
4,12,80,11,13,-2
4,12,81,13,17,-4
4,12,82,13,12,1
4,12,83,9,8,1
4,12,84,12,24,-12
4,12,85,15,10,5
4,12,86,23,7,16
4,12,87,10,9,1
4,12,88,14,13,1
4,12,89,8,7,1
4,12,90,17,20,-3
4,12,91,16,12,4
4,12,92,14,26,-12
4,12,93,16,12,4
4,12,94,10,11,-1
4,12,95,11,6,5
4,12,96,22,9,13
4,12,97,11,4,7
4,12,98,12,9,3
4,12,99,16,14,2
4,12,100,32,19,13
4,12,101,18,8,10
4,12,102,12,2,10
4,12,103,23,18,5
4,12,104,19,10,9
4,12,105,10,9,1
4,12,106,14,16,-2
4,12,107,14,13,1
4,12,108,7,11,-4
4,12,109,30,8,22
4,12,110,11,11,0
4,12,111,20,17,3
4,12,112,15,12,3
4,12,113,10,16,-6
4,12,114,17,16,1
4,12,115,22,18,4
4,12,116,8,5,3
4,12,117,15,10,5
4,12,118,25,20,5
4,12,119,10,3,7
4,12,120,5,11,-6
4,12,121,13,11,2
4,12,122,12,7,5
4,12,123,15,13,2
4,12,124,22,5,17
4,12,125,19,18,1
4,12,126,1,6,-5
4,12,127,11,5,6
4,12,128,15,12,3
4,12,129,18,10,8
4,12,130,15,12,3
4,12,131,17,13,4
4,12,132,16,9,7
4,12,133,9,8,1
4,12,134,20,12,8
4,12,135,24,17,7
4,12,136,17,13,4
4,12,137,16,8,8
4,12,138,8,18,-10
4,12,139,18,3,15
4,12,140,11,20,-9
4,12,141,25,23,2
4,12,142,17,13,4
4,12,143,19,16,3
4,12,144,20,18,2
4,12,145,13,9,4
4,12,146,19,11,8
4,12,147,12,25,-13
4,12,148,13,9,4
4,12,149,13,15,-2
4,12,150,30,20,10
4,12,151,19,3,16
4,12,152,15,17,-2
4,12,153,6,10,-4
4,12,154,12,10,2
4,12,155,32,8,24
4,12,156,12,12,0
4,12,157,10,5,5
4,12,158,16,15,1
4,12,159,12,10,2
4,12,160,22,15,7
4,12,161,3,6,-3
4,12,162,12,8,4
4,12,163,7,2,5
4,12,164,17,27,-10
4,12,165,30,19,11
4,12,166,17,21,-4
4,12,167,21,8,13
4,12,168,9,3,6
4,12,169,14,16,-2
4,12,170,11,11,0
4,12,171,7,10,-3
4,12,172,8,16,-8
4,12,173,16,14,2
4,12,174,27,21,6
4,12,175,16,9,7
4,12,176,12,6,6
4,12,177,11,9,2
4,12,178,13,8,5
4,12,179,16,11,5
4,12,180,18,12,6
4,12,181,20,12,8
4,12,182,24,19,5
4,12,183,8,7,1
4,12,184,9,14,-5
4,12,185,28,16,12
4,12,186,23,13,10
4,12,187,14,7,7
4,12,188,16,19,-3
4,12,189,11,9,2
4,12,190,5,11,-6
4,12,191,13,12,1
4,12,192,17,7,10
4,12,193,10,7,3
4,12,194,16,11,5
4,12,195,14,7,7
4,12,196,26,26,0
4,12,197,17,7,10
4,12,198,18,14,4
4,12,199,29,11,18
4,12,200,21,9,12
4,12,201,16,15,1
4,12,202,17,10,7
4,12,203,12,12,0
4,12,204,12,11,1
4,12,205,18,23,-5
4,12,206,18,14,4
4,12,207,20,19,1
4,12,208,12,8,4
4,12,209,16,7,9
4,12,210,20,23,-3
4,12,211,20,16,4
4,12,212,12,10,2
4,12,213,12,22,-10
4,12,214,16,23,-7
4,12,215,21,12,9
4,12,216,11,9,2
4,12,217,8,10,-2
4,12,218,15,7,8
4,12,219,8,11,-3
4,12,220,28,2,26
4,12,221,20,8,12
4,12,222,15,12,3
4,12,223,16,8,8
4,12,224,19,12,7
4,12,225,20,7,13
4,12,226,15,10,5
4,12,227,4,12,-8
4,12,228,22,20,2
4,12,229,27,18,9
4,12,230,9,11,-2
4,12,231,21,28,-7
4,12,232,11,9,2
4,12,233,18,10,8
4,12,234,13,9,4
4,12,235,20,29,-9
4,12,236,13,9,4
4,12,237,12,3,9
4,12,238,25,23,2
4,12,239,9,11,-2
4,12,240,17,8,9
4,12,241,13,5,8
4,12,242,12,6,6
4,12,243,14,30,-16
4,12,244,22,13,9
4,12,245,9,6,3
4,12,246,14,15,-1
4,12,247,12,18,-6
4,12,248,14,12,2
4,12,249,12,16,-4
4,12,250,27,12,15
4,12,251,21,10,11
4,12,252,15,15,0
4,12,253,26,8,18
4,12,254,18,12,6
4,12,255,10,18,-8
4,12,256,24,10,14
4,12,257,29,19,10
4,12,258,17,13,4
4,12,259,5,3,2
4,12,260,13,11,2
4,12,261,21,13,8
4,12,262,18,13,5
4,12,263,18,17,1
4,12,264,14,14,0
4,12,265,15,7,8
4,12,266,23,10,13
4,12,267,12,4,8
4,12,268,19,28,-9
4,12,269,15,20,-5
4,12,270,22,23,-1
4,12,271,8,10,-2
4,12,272,14,9,5
4,12,273,21,8,13
4,12,274,8,21,-13
4,12,275,16,17,-1
4,12,276,14,15,-1
4,12,277,14,12,2
4,12,278,13,18,-5
4,12,279,13,15,-2
4,12,280,19,11,8
4,12,281,12,14,-2
4,12,282,25,9,16
4,12,283,11,17,-6
4,12,284,14,18,-4
4,12,285,14,8,6
4,12,286,8,5,3
4,12,287,35,11,24
4,12,288,18,14,4
4,12,289,7,11,-4
4,12,290,9,13,-4
4,12,291,18,7,11
4,12,292,21,11,10
4,12,293,12,11,1
4,12,294,24,6,18
4,12,295,22,10,12
4,12,296,27,6,21
4,12,297,10,9,1
4,12,298,13,13,0
4,12,299,9,16,-7
4,13,0,19,9,10
4,13,1,8,15,-7
4,13,2,14,6,8
4,13,3,14,7,7
4,13,4,13,6,7
4,13,5,15,4,11
4,13,6,22,18,4
4,13,7,13,5,8
4,13,8,7,10,-3
4,13,9,16,13,3
4,13,10,19,9,10
4,13,11,19,17,2
4,13,12,15,11,4
4,13,13,18,4,14
4,13,14,25,14,11
4,13,15,9,1,8
4,13,16,22,12,10
4,13,17,11,13,-2
4,13,18,15,10,5
4,13,19,6,14,-8
4,13,20,26,16,10
4,13,21,12,10,2
4,13,22,19,14,5
4,13,23,19,5,14
4,13,24,16,16,0
4,13,25,18,12,6
4,13,26,16,18,-2
4,13,27,14,10,4
4,13,28,12,7,5
4,13,29,23,10,13
4,13,30,26,3,23
4,13,31,13,4,9
4,13,32,25,11,14
4,13,33,8,9,-1
4,13,34,5,9,-4
4,13,35,13,14,-1
4,13,36,9,15,-6
4,13,37,15,14,1
4,13,38,24,20,4
4,13,39,21,13,8
4,13,40,16,23,-7
4,13,41,16,9,7
4,13,42,26,16,10
4,13,43,2,7,-5
4,13,44,24,7,17
4,13,45,10,20,-10
4,13,46,24,7,17
4,13,47,15,8,7
4,13,48,13,9,4
4,13,49,16,16,0
4,13,50,29,18,11
4,13,51,7,17,-10
4,13,52,9,6,3
4,13,53,8,13,-5
4,13,54,9,6,3
4,13,55,16,18,-2
4,13,56,12,11,1
4,13,57,23,20,3
4,13,58,7,13,-6
4,13,59,11,19,-8
4,13,60,14,12,2
4,13,61,19,14,5
4,13,62,9,9,0
4,13,63,19,21,-2
4,13,64,16,9,7
4,13,65,17,14,3
4,13,66,17,16,1
4,13,67,16,20,-4
4,13,68,18,19,-1
4,13,69,8,8,0
4,13,70,13,21,-8
4,13,71,17,11,6
4,13,72,12,8,4
4,13,73,13,10,3
4,13,74,20,10,10
4,13,75,19,14,5
4,13,76,18,23,-5
4,13,77,7,8,-1
4,13,78,14,11,3
4,13,79,20,13,7
4,13,80,16,23,-7
4,13,81,17,20,-3
4,13,82,12,7,5
4,13,83,16,5,11
4,13,84,18,23,-5
4,13,85,29,12,17
4,13,86,12,8,4
4,13,87,15,18,-3
4,13,88,5,10,-5
4,13,89,16,15,1
4,13,90,10,12,-2
4,13,91,32,38,-6
4,13,92,36,11,25
4,13,93,4,5,-1
4,13,94,13,13,0
4,13,95,13,11,2
4,13,96,17,24,-7
4,13,97,15,11,4
4,13,98,21,13,8
4,13,99,24,12,12
4,13,100,28,24,4
4,13,101,10,10,0
4,13,102,23,18,5
4,13,103,11,7,4
4,13,104,12,14,-2
4,13,105,33,12,21
4,13,106,15,21,-6
4,13,107,10,10,0
4,13,108,7,15,-8
4,13,109,14,14,0
4,13,110,9,10,-1
4,13,111,12,11,1
4,13,112,17,28,-11
4,13,113,17,23,-6
4,13,114,26,8,18
4,13,115,23,13,10
4,13,116,19,16,3
4,13,117,18,14,4
4,13,118,19,14,5
4,13,119,16,11,5
4,13,120,10,10,0
4,13,121,8,8,0
4,13,122,14,13,1
4,13,123,22,18,4
4,13,124,18,22,-4
4,13,125,20,14,6
4,13,126,20,19,1
4,13,127,20,10,10
4,13,128,12,15,-3
4,13,129,16,8,8
4,13,130,20,13,7
4,13,131,14,14,0
4,13,132,17,11,6
4,13,133,22,8,14
4,13,134,26,18,8
4,13,135,21,28,-7
4,13,136,8,12,-4
4,13,137,20,8,12
4,13,138,9,14,-5
4,13,139,4,15,-11
4,13,140,24,8,16
4,13,141,14,10,4
4,13,142,10,18,-8
4,13,143,8,5,3
4,13,144,4,11,-7
4,13,145,11,11,0
4,13,146,20,11,9
4,13,147,13,3,10
4,13,148,9,7,2
4,13,149,16,11,5
4,13,150,20,15,5
4,13,151,4,8,-4
4,13,152,8,9,-1
4,13,153,25,22,3
4,13,154,12,20,-8
4,13,155,17,7,10
4,13,156,22,13,9
4,13,157,16,8,8
4,13,158,16,7,9
4,13,159,15,18,-3
4,13,160,27,8,19
4,13,161,10,8,2
4,13,162,16,9,7
4,13,163,17,4,13
4,13,164,16,17,-1
4,13,165,22,8,14
4,13,166,17,25,-8
4,13,167,23,14,9
4,13,168,12,13,-1
4,13,169,7,5,2
4,13,170,24,13,11
4,13,171,21,16,5
4,13,172,26,17,9
4,13,173,11,6,5
4,13,174,28,5,23
4,13,175,13,13,0
4,13,176,24,9,15
4,13,177,9,6,3
4,13,178,10,17,-7
4,13,179,9,8,1
4,13,180,34,9,25
4,13,181,15,19,-4
4,13,182,14,12,2
4,13,183,21,14,7
4,13,184,8,7,1
4,13,185,6,11,-5
4,13,186,19,11,8
4,13,187,14,10,4
4,13,188,14,11,3
4,13,189,11,8,3
4,13,190,26,14,12
4,13,191,19,10,9
4,13,192,16,18,-2
4,13,193,16,14,2
4,13,194,24,10,14
4,13,195,18,8,10
4,13,196,9,10,-1
4,13,197,11,10,1
4,13,198,32,10,22
4,13,199,11,11,0
4,13,200,20,13,7
4,13,201,12,12,0
4,13,202,18,18,0
4,13,203,18,8,10
4,13,204,18,17,1
4,13,205,13,20,-7
4,13,206,23,14,9
4,13,207,17,12,5
4,13,208,19,21,-2
4,13,209,20,5,15
4,13,210,18,14,4
4,13,211,20,13,7
4,13,212,12,18,-6
4,13,213,23,11,12
4,13,214,14,2,12
4,13,215,20,20,0
4,13,216,11,12,-1
4,13,217,18,9,9
4,13,218,12,11,1
4,13,219,8,10,-2
4,13,220,18,13,5
4,13,221,16,12,4
4,13,222,19,14,5
4,13,223,10,1,9
4,13,224,14,17,-3
4,13,225,27,20,7
4,13,226,20,12,8
4,13,227,19,13,6
4,13,228,16,13,3
4,13,229,20,19,1
4,13,230,11,6,5
4,13,231,18,4,14
4,13,232,13,11,2
4,13,233,21,12,9
4,13,234,14,14,0
4,13,235,10,8,2
4,13,236,21,18,3
4,13,237,9,4,5
4,13,238,13,9,4
4,13,239,3,11,-8
4,13,240,14,21,-7
4,13,241,10,8,2
4,13,242,7,8,-1
4,13,243,17,7,10
4,13,244,23,17,6
4,13,245,21,13,8
4,13,246,14,7,7
4,13,247,25,21,4
4,13,248,15,12,3
4,13,249,9,8,1
4,13,250,5,17,-12
4,13,251,17,12,5
4,13,252,9,10,-1
4,13,253,16,7,9
4,13,254,15,18,-3
4,13,255,8,5,3
4,13,256,18,12,6
4,13,257,33,10,23
4,13,258,11,19,-8
4,13,259,15,16,-1
4,13,260,22,7,15
4,13,261,14,9,5
4,13,262,21,25,-4
4,13,263,11,10,1
4,13,264,13,14,-1
4,13,265,13,7,6
4,13,266,23,16,7
4,13,267,14,18,-4
4,13,268,21,4,17
4,13,269,16,20,-4
4,13,270,20,16,4
4,13,271,23,7,16
4,13,272,4,8,-4
4,13,273,23,14,9
4,13,274,16,8,8
4,13,275,17,4,13
4,13,276,12,6,6
4,13,277,22,6,16
4,13,278,20,11,9
4,13,279,17,18,-1
4,13,280,18,15,3
4,13,281,13,5,8
4,13,282,21,9,12
4,13,283,19,12,7
4,13,284,14,6,8
4,13,285,31,23,8
4,13,286,11,18,-7
4,13,287,14,6,8
4,13,288,16,14,2
4,13,289,20,10,10
4,13,290,10,18,-8
4,13,291,19,13,6
4,13,292,16,12,4
4,13,293,22,13,9
4,13,294,13,8,5
4,13,295,14,10,4
4,13,296,9,6,3
4,13,297,19,2,17
4,13,298,22,5,17
4,13,299,18,13,5
4,14,0,22,12,10
4,14,1,30,10,20
4,14,2,11,6,5
4,14,3,23,20,3
4,14,4,8,8,0
4,14,5,12,9,3
4,14,6,34,24,10
4,14,7,12,16,-4
4,14,8,26,21,5
4,14,9,7,13,-6
4,14,10,5,5,0
4,14,11,18,17,1
4,14,12,8,11,-3
4,14,13,12,11,1
4,14,14,23,21,2
4,14,15,23,9,14
4,14,16,31,13,18
4,14,17,12,7,5
4,14,18,16,14,2
4,14,19,27,12,15
4,14,20,22,16,6
4,14,21,9,12,-3
4,14,22,15,24,-9
4,14,23,13,5,8
4,14,24,23,5,18
4,14,25,15,9,6
4,14,26,22,19,3
4,14,27,14,15,-1
4,14,28,14,9,5
4,14,29,15,11,4
4,14,30,11,15,-4
4,14,31,10,19,-9
4,14,32,16,6,10
4,14,33,18,9,9
4,14,34,17,14,3
4,14,35,23,15,8
4,14,36,13,21,-8
4,14,37,16,12,4
4,14,38,24,15,9
4,14,39,20,9,11
4,14,40,23,26,-3
4,14,41,19,5,14
4,14,42,16,23,-7
4,14,43,15,15,0
4,14,44,20,17,3
4,14,45,12,11,1
4,14,46,25,6,19
4,14,47,14,6,8
4,14,48,21,13,8
4,14,49,17,7,10
4,14,50,25,20,5
4,14,51,19,20,-1
4,14,52,21,7,14
4,14,53,6,10,-4
4,14,54,17,17,0
4,14,55,15,10,5
4,14,56,21,20,1
4,14,57,22,9,13
4,14,58,27,11,16
4,14,59,17,11,6
4,14,60,24,7,17
4,14,61,15,10,5
4,14,62,17,7,10
4,14,63,7,4,3
4,14,64,22,2,20
4,14,65,12,11,1
4,14,66,25,10,15
4,14,67,13,16,-3
4,14,68,25,9,16
4,14,69,24,23,1
4,14,70,15,15,0
4,14,71,11,17,-6
4,14,72,12,8,4
4,14,73,29,19,10
4,14,74,16,7,9
4,14,75,11,5,6
4,14,76,12,16,-4
4,14,77,13,11,2
4,14,78,8,7,1
4,14,79,17,9,8
4,14,80,11,5,6
4,14,81,12,33,-21
4,14,82,23,6,17
4,14,83,29,21,8
4,14,84,13,14,-1
4,14,85,15,16,-1
4,14,86,18,22,-4
4,14,87,26,18,8
4,14,88,18,9,9
4,14,89,9,13,-4
4,14,90,19,10,9
4,14,91,16,5,11
4,14,92,18,15,3
4,14,93,18,16,2
4,14,94,17,15,2
4,14,95,15,1,14
4,14,96,10,8,2
4,14,97,11,6,5
4,14,98,17,31,-14
4,14,99,15,12,3
4,14,100,19,15,4
4,14,101,19,8,11
4,14,102,12,8,4
4,14,103,18,11,7
4,14,104,11,14,-3
4,14,105,20,22,-2
4,14,106,14,7,7
4,14,107,6,5,1
4,14,108,4,14,-10
4,14,109,15,8,7
4,14,110,11,9,2
4,14,111,22,13,9
4,14,112,12,10,2
4,14,113,19,16,3
4,14,114,18,19,-1
4,14,115,15,30,-15
4,14,116,13,11,2
4,14,117,22,11,11
4,14,118,12,17,-5
4,14,119,36,11,25
4,14,120,14,19,-5
4,14,121,15,22,-7
4,14,122,17,16,1
4,14,123,15,5,10
4,14,124,35,5,30
4,14,125,15,3,12
4,14,126,19,18,1
4,14,127,18,7,11
4,14,128,9,14,-5
4,14,129,30,24,6
4,14,130,15,14,1
4,14,131,12,6,6
4,14,132,18,18,0
4,14,133,13,8,5
4,14,134,34,12,22
4,14,135,21,22,-1
4,14,136,21,9,12
4,14,137,13,11,2
4,14,138,19,15,4
4,14,139,20,15,5
4,14,140,17,25,-8
4,14,141,14,20,-6
4,14,142,18,11,7
4,14,143,12,17,-5
4,14,144,5,2,3
4,14,145,20,14,6
4,14,146,14,7,7
4,14,147,11,6,5
4,14,148,23,15,8
4,14,149,11,10,1
4,14,150,14,11,3
4,14,151,23,5,18
4,14,152,14,11,3
4,14,153,21,5,16
4,14,154,7,19,-12
4,14,155,28,18,10
4,14,156,25,8,17
4,14,157,10,6,4
4,14,158,25,20,5
4,14,159,9,11,-2
4,14,160,14,14,0
4,14,161,25,12,13
4,14,162,19,17,2
4,14,163,14,11,3
4,14,164,10,15,-5
4,14,165,19,11,8
4,14,166,18,13,5
4,14,167,17,7,10
4,14,168,15,8,7
4,14,169,19,8,11
4,14,170,22,12,10
4,14,171,10,4,6
4,14,172,22,12,10
4,14,173,25,15,10
4,14,174,13,18,-5
4,14,175,9,20,-11
4,14,176,15,13,2
4,14,177,24,5,19
4,14,178,16,18,-2
4,14,179,8,9,-1
4,14,180,11,15,-4
4,14,181,14,13,1
4,14,182,13,11,2
4,14,183,15,9,6
4,14,184,16,5,11
4,14,185,14,15,-1
4,14,186,11,9,2
4,14,187,13,8,5
4,14,188,9,14,-5
4,14,189,7,6,1
4,14,190,13,11,2
4,14,191,3,13,-10
4,14,192,11,12,-1
4,14,193,15,14,1
4,14,194,27,24,3
4,14,195,16,12,4
4,14,196,14,14,0
4,14,197,12,10,2
4,14,198,15,20,-5
4,14,199,12,6,6
4,14,200,14,16,-2
4,14,201,16,7,9
4,14,202,21,10,11
4,14,203,8,10,-2
4,14,204,12,18,-6
4,14,205,21,2,19
4,14,206,17,13,4
4,14,207,19,15,4
4,14,208,36,12,24
4,14,209,23,17,6
4,14,210,13,4,9
4,14,211,14,20,-6
4,14,212,17,13,4
4,14,213,18,14,4
4,14,214,11,10,1
4,14,215,18,14,4
4,14,216,13,7,6
4,14,217,14,10,4
4,14,218,7,9,-2
4,14,219,32,20,12
4,14,220,12,9,3
4,14,221,17,9,8
4,14,222,9,3,6
4,14,223,12,12,0
4,14,224,16,17,-1
4,14,225,19,14,5
4,14,226,27,14,13
4,14,227,10,14,-4
4,14,228,9,9,0
4,14,229,14,9,5
4,14,230,19,11,8
4,14,231,19,11,8
4,14,232,22,24,-2
4,14,233,19,5,14
4,14,234,17,13,4
4,14,235,21,17,4
4,14,236,8,13,-5
4,14,237,11,8,3
4,14,238,20,3,17
4,14,239,10,11,-1
4,14,240,20,16,4
4,14,241,12,8,4
4,14,242,17,17,0
4,14,243,10,11,-1
4,14,244,17,11,6
4,14,245,20,16,4
4,14,246,17,9,8
4,14,247,14,22,-8
4,14,248,16,23,-7
4,14,249,16,13,3
4,14,250,11,15,-4
4,14,251,25,7,18
4,14,252,30,1,29
4,14,253,11,2,9
4,14,254,13,13,0
4,14,255,14,5,9
4,14,256,22,11,11
4,14,257,16,11,5
4,14,258,23,5,18
4,14,259,12,6,6
4,14,260,21,16,5
4,14,261,10,11,-1
4,14,262,19,15,4
4,14,263,4,6,-2
4,14,264,7,5,2
4,14,265,19,9,10
4,14,266,14,8,6
4,14,267,13,20,-7
4,14,268,12,13,-1
4,14,269,14,13,1
4,14,270,8,10,-2
4,14,271,20,6,14
4,14,272,25,10,15
4,14,273,9,11,-2
4,14,274,10,13,-3
4,14,275,25,14,11
4,14,276,9,17,-8
4,14,277,13,15,-2
4,14,278,12,14,-2
4,14,279,11,8,3
4,14,280,8,9,-1
4,14,281,20,17,3
4,14,282,13,11,2
4,14,283,14,8,6
4,14,284,20,7,13
4,14,285,21,11,10
4,14,286,24,5,19
4,14,287,15,21,-6
4,14,288,16,6,10
4,14,289,15,9,6
4,14,290,16,16,0
4,14,291,29,19,10
4,14,292,17,22,-5
4,14,293,10,8,2
4,14,294,17,6,11
4,14,295,19,8,11
4,14,296,22,16,6
4,14,297,20,22,-2
4,14,298,16,10,6
4,14,299,18,6,12
4,15,0,20,15,5
4,15,1,25,14,11
4,15,2,8,2,6
4,15,3,22,13,9
4,15,4,17,14,3
4,15,5,20,13,7
4,15,6,5,7,-2
4,15,7,16,13,3
4,15,8,35,11,24
4,15,9,11,11,0
4,15,10,8,7,1
4,15,11,18,5,13
4,15,12,16,16,0
4,15,13,33,10,23
4,15,14,16,11,5
4,15,15,12,13,-1
4,15,16,9,11,-2
4,15,17,15,17,-2
4,15,18,16,8,8
4,15,19,20,7,13
4,15,20,8,7,1
4,15,21,10,4,6
4,15,22,35,17,18
4,15,23,15,12,3
4,15,24,12,4,8
4,15,25,9,7,2
4,15,26,11,5,6
4,15,27,14,16,-2
4,15,28,38,10,28
4,15,29,26,17,9
4,15,30,17,9,8
4,15,31,26,21,5
4,15,32,36,16,20
4,15,33,11,10,1
4,15,34,26,14,12
4,15,35,10,8,2
4,15,36,13,15,-2
4,15,37,23,16,7
4,15,38,9,14,-5
4,15,39,25,11,14
4,15,40,19,4,15
4,15,41,9,14,-5
4,15,42,18,8,10
4,15,43,11,6,5
4,15,44,15,7,8
4,15,45,7,12,-5
4,15,46,11,15,-4
4,15,47,7,3,4
4,15,48,24,16,8
4,15,49,18,8,10
4,15,50,23,5,18
4,15,51,11,15,-4
4,15,52,19,18,1
4,15,53,11,8,3
4,15,54,17,6,11
4,15,55,14,6,8
4,15,56,32,25,7
4,15,57,14,2,12
4,15,58,23,16,7
4,15,59,26,14,12
4,15,60,26,18,8
4,15,61,11,6,5
4,15,62,20,14,6
4,15,63,20,9,11
4,15,64,14,6,8
4,15,65,11,23,-12
4,15,66,7,9,-2
4,15,67,26,13,13
4,15,68,11,3,8
4,15,69,16,14,2
4,15,70,8,15,-7
4,15,71,18,8,10
4,15,72,31,19,12
4,15,73,23,17,6
4,15,74,12,11,1
4,15,75,19,9,10
4,15,76,26,13,13
4,15,77,16,8,8
4,15,78,16,10,6
4,15,79,10,19,-9
4,15,80,14,20,-6
4,15,81,21,10,11
4,15,82,36,12,24
4,15,83,22,16,6
4,15,84,16,6,10
4,15,85,12,17,-5
4,15,86,12,15,-3
4,15,87,27,20,7
4,15,88,15,5,10
4,15,89,8,5,3
4,15,90,8,5,3
4,15,91,10,4,6
4,15,92,15,11,4
4,15,93,15,9,6
4,15,94,8,12,-4
4,15,95,28,12,16
4,15,96,17,15,2
4,15,97,18,9,9
4,15,98,29,25,4
4,15,99,20,15,5
4,15,100,9,6,3
4,15,101,16,8,8
4,15,102,13,6,7
4,15,103,8,10,-2
4,15,104,22,9,13
4,15,105,20,16,4
4,15,106,18,9,9
4,15,107,29,13,16
4,15,108,14,10,4
4,15,109,18,18,0
4,15,110,9,8,1
4,15,111,17,9,8
4,15,112,22,7,15
4,15,113,14,10,4
4,15,114,26,14,12
4,15,115,27,6,21
4,15,116,14,11,3
4,15,117,7,6,1
4,15,118,12,16,-4
4,15,119,19,10,9
4,15,120,9,6,3
4,15,121,4,3,1
4,15,122,17,8,9
4,15,123,13,28,-15
4,15,124,13,13,0
4,15,125,17,15,2
4,15,126,24,8,16
4,15,127,18,3,15
4,15,128,16,8,8
4,15,129,27,9,18
4,15,130,16,6,10
4,15,131,2,7,-5
4,15,132,16,16,0
4,15,133,16,15,1
4,15,134,9,11,-2
4,15,135,21,19,2
4,15,136,22,6,16
4,15,137,13,15,-2
4,15,138,16,22,-6
4,15,139,11,12,-1
4,15,140,15,6,9
4,15,141,14,12,2
4,15,142,10,15,-5
4,15,143,14,11,3
4,15,144,11,11,0
4,15,145,18,9,9
4,15,146,24,14,10
4,15,147,14,11,3
4,15,148,10,14,-4
4,15,149,17,21,-4
4,15,150,7,3,4
4,15,151,20,23,-3
4,15,152,24,17,7
4,15,153,18,17,1
4,15,154,19,15,4
4,15,155,13,6,7
4,15,156,25,19,6
4,15,157,21,8,13
4,15,158,11,7,4
4,15,159,9,10,-1
4,15,160,19,17,2
4,15,161,22,26,-4
4,15,162,24,17,7
4,15,163,4,4,0
4,15,164,10,10,0
4,15,165,20,11,9
4,15,166,11,9,2
4,15,167,19,6,13
4,15,168,22,15,7
4,15,169,33,20,13
4,15,170,13,26,-13
4,15,171,15,15,0
4,15,172,24,8,16
4,15,173,17,11,6
4,15,174,22,15,7
4,15,175,21,14,7
4,15,176,20,14,6
4,15,177,13,2,11
4,15,178,23,15,8
4,15,179,25,13,12
4,15,180,15,9,6
4,15,181,11,15,-4
4,15,182,30,14,16
4,15,183,23,8,15
4,15,184,11,21,-10
4,15,185,11,9,2
4,15,186,10,10,0
4,15,187,17,11,6
4,15,188,6,11,-5
4,15,189,17,11,6
4,15,190,14,0,14
4,15,191,21,13,8
4,15,192,12,13,-1
4,15,193,22,20,2
4,15,194,22,10,12
4,15,195,19,23,-4
4,15,196,25,14,11
4,15,197,20,9,11
4,15,198,21,13,8
4,15,199,6,9,-3
4,15,200,18,16,2
4,15,201,2,14,-12
4,15,202,20,4,16
4,15,203,21,8,13
4,15,204,16,5,11
4,15,205,16,15,1
4,15,206,13,12,1
4,15,207,20,16,4
4,15,208,17,18,-1
4,15,209,21,8,13
4,15,210,20,12,8
4,15,211,18,15,3
4,15,212,16,13,3
4,15,213,26,24,2
4,15,214,6,10,-4
4,15,215,16,8,8
4,15,216,17,11,6
4,15,217,14,14,0
4,15,218,16,8,8
4,15,219,12,6,6
4,15,220,25,24,1
4,15,221,22,10,12
4,15,222,18,18,0
4,15,223,20,11,9
4,15,224,12,11,1
4,15,225,26,11,15
4,15,226,24,15,9
4,15,227,17,13,4
4,15,228,10,14,-4
4,15,229,9,10,-1
4,15,230,15,4,11
4,15,231,10,8,2
4,15,232,13,5,8
4,15,233,26,6,20
4,15,234,22,12,10
4,15,235,24,20,4
4,15,236,11,9,2
4,15,237,17,9,8
4,15,238,5,12,-7
4,15,239,12,7,5
4,15,240,13,12,1
4,15,241,15,11,4
4,15,242,8,5,3
4,15,243,20,18,2
4,15,244,8,3,5
4,15,245,12,7,5
4,15,246,16,14,2
4,15,247,22,16,6
4,15,248,18,13,5
4,15,249,27,10,17
4,15,250,14,9,5
4,15,251,17,22,-5
4,15,252,21,13,8
4,15,253,32,29,3
4,15,254,14,7,7
4,15,255,8,12,-4
4,15,256,8,4,4
4,15,257,12,10,2
4,15,258,6,12,-6
4,15,259,21,9,12
4,15,260,1,8,-7
4,15,261,14,10,4
4,15,262,18,11,7
4,15,263,10,10,0
4,15,264,25,6,19
4,15,265,9,7,2
4,15,266,20,6,14
4,15,267,33,10,23
4,15,268,29,11,18
4,15,269,26,19,7
4,15,270,9,14,-5
4,15,271,22,16,6
4,15,272,10,13,-3
4,15,273,18,11,7
4,15,274,15,12,3
4,15,275,32,22,10
4,15,276,12,7,5
4,15,277,21,8,13
4,15,278,16,7,9
4,15,279,13,5,8
4,15,280,24,15,9
4,15,281,17,10,7
4,15,282,22,12,10
4,15,283,14,18,-4
4,15,284,9,13,-4
4,15,285,20,13,7
4,15,286,25,17,8
4,15,287,17,9,8
4,15,288,32,23,9
4,15,289,7,16,-9
4,15,290,20,14,6
4,15,291,17,10,7
4,15,292,8,10,-2
4,15,293,20,7,13
4,15,294,16,8,8
4,15,295,10,11,-1
4,15,296,17,9,8
4,15,297,30,11,19
4,15,298,16,6,10
4,15,299,10,10,0
4,16,0,24,11,13
4,16,1,15,14,1
4,16,2,17,9,8
4,16,3,15,16,-1
4,16,4,16,11,5
4,16,5,22,13,9
4,16,6,7,12,-5
4,16,7,21,6,15
4,16,8,22,8,14
4,16,9,10,10,0
4,16,10,26,6,20
4,16,11,19,9,10
4,16,12,24,12,12
4,16,13,31,25,6
4,16,14,16,7,9
4,16,15,17,8,9
4,16,16,14,12,2
4,16,17,18,12,6
4,16,18,18,18,0
4,16,19,23,21,2
4,16,20,21,8,13
4,16,21,13,9,4
4,16,22,17,13,4
4,16,23,26,20,6
4,16,24,8,9,-1
4,16,25,29,13,16
4,16,26,21,13,8
4,16,27,12,6,6
4,16,28,17,11,6
4,16,29,13,14,-1
4,16,30,16,4,12
4,16,31,4,4,0
4,16,32,19,9,10
4,16,33,27,12,15
4,16,34,7,16,-9
4,16,35,22,7,15
4,16,36,22,16,6
4,16,37,22,9,13
4,16,38,13,11,2
4,16,39,15,9,6
4,16,40,22,13,9
4,16,41,11,17,-6
4,16,42,17,8,9
4,16,43,22,13,9
4,16,44,18,7,11
4,16,45,7,8,-1
4,16,46,9,8,1
4,16,47,16,19,-3
4,16,48,28,18,10
4,16,49,22,37,-15
4,16,50,14,9,5
4,16,51,11,12,-1
4,16,52,15,14,1
4,16,53,19,7,12
4,16,54,20,8,12
4,16,55,22,17,5
4,16,56,13,6,7
4,16,57,7,4,3
4,16,58,25,19,6
4,16,59,10,18,-8
4,16,60,8,5,3
4,16,61,21,18,3
4,16,62,14,3,11
4,16,63,7,7,0
4,16,64,23,16,7
4,16,65,26,10,16
4,16,66,19,8,11
4,16,67,19,10,9
4,16,68,24,5,19
4,16,69,15,11,4
4,16,70,15,12,3
4,16,71,18,3,15
4,16,72,11,4,7
4,16,73,10,10,0
4,16,74,7,15,-8
4,16,75,19,14,5
4,16,76,12,11,1
4,16,77,13,8,5
4,16,78,19,8,11
4,16,79,9,8,1
4,16,80,15,11,4
4,16,81,17,6,11
4,16,82,13,9,4
4,16,83,17,19,-2
4,16,84,15,14,1
4,16,85,22,11,11
4,16,86,24,14,10
4,16,87,34,11,23
4,16,88,24,16,8
4,16,89,12,13,-1
4,16,90,15,10,5
4,16,91,20,20,0
4,16,92,12,8,4
4,16,93,10,13,-3
4,16,94,19,13,6
4,16,95,10,5,5
4,16,96,26,11,15
4,16,97,11,7,4
4,16,98,20,13,7
4,16,99,25,5,20
4,16,100,24,21,3
4,16,101,7,9,-2
4,16,102,10,19,-9
4,16,103,11,10,1
4,16,104,11,7,4
4,16,105,19,13,6
4,16,106,17,9,8
4,16,107,10,14,-4
4,16,108,23,14,9
4,16,109,19,13,6
4,16,110,16,19,-3
4,16,111,25,7,18
4,16,112,13,9,4
4,16,113,28,17,11
4,16,114,14,10,4
4,16,115,26,17,9
4,16,116,20,16,4
4,16,117,30,15,15
4,16,118,23,18,5
4,16,119,12,16,-4
4,16,120,22,9,13
4,16,121,17,12,5
4,16,122,28,11,17
4,16,123,19,14,5
4,16,124,9,5,4
4,16,125,9,10,-1
4,16,126,14,11,3
4,16,127,10,12,-2
4,16,128,19,13,6
4,16,129,23,5,18
4,16,130,21,14,7
4,16,131,9,6,3
4,16,132,10,11,-1
4,16,133,18,10,8
4,16,134,22,2,20
4,16,135,9,10,-1
4,16,136,10,5,5
4,16,137,18,6,12
4,16,138,12,7,5
4,16,139,10,6,4
4,16,140,20,17,3
4,16,141,16,23,-7
4,16,142,4,4,0
4,16,143,14,14,0
4,16,144,34,14,20
4,16,145,18,11,7
4,16,146,14,9,5
4,16,147,17,10,7
4,16,148,10,12,-2
4,16,149,11,8,3
4,16,150,15,9,6
4,16,151,8,4,4
4,16,152,13,17,-4
4,16,153,19,12,7
4,16,154,12,12,0
4,16,155,16,14,2
4,16,156,10,3,7
4,16,157,10,4,6
4,16,158,14,13,1
4,16,159,22,17,5
4,16,160,29,12,17
4,16,161,22,5,17
4,16,162,13,12,1
4,16,163,18,11,7
4,16,164,16,10,6
4,16,165,36,13,23
4,16,166,16,9,7
4,16,167,9,2,7
4,16,168,29,14,15
4,16,169,19,11,8
4,16,170,13,4,9
4,16,171,6,6,0
4,16,172,17,7,10
4,16,173,8,7,1
4,16,174,22,11,11
4,16,175,11,9,2
4,16,176,12,10,2
4,16,177,12,15,-3
4,16,178,20,14,6
4,16,179,17,8,9
4,16,180,13,16,-3
4,16,181,20,9,11
4,16,182,14,12,2
4,16,183,26,4,22
4,16,184,9,14,-5
4,16,185,17,7,10
4,16,186,11,12,-1
4,16,187,28,21,7
4,16,188,10,5,5
4,16,189,16,8,8
4,16,190,30,15,15
4,16,191,26,21,5
4,16,192,15,8,7
4,16,193,13,9,4
4,16,194,22,10,12
4,16,195,12,8,4
4,16,196,15,10,5
4,16,197,14,18,-4
4,16,198,21,9,12
4,16,199,21,12,9
4,16,200,15,16,-1
4,16,201,22,12,10
4,16,202,18,12,6
4,16,203,30,13,17
4,16,204,25,3,22
4,16,205,13,13,0
4,16,206,20,8,12
4,16,207,26,18,8
4,16,208,14,10,4
4,16,209,31,9,22
4,16,210,30,6,24
4,16,211,21,2,19
4,16,212,11,2,9
4,16,213,26,15,11
4,16,214,11,6,5
4,16,215,34,12,22
4,16,216,11,13,-2
4,16,217,5,3,2
4,16,218,23,14,9
4,16,219,13,11,2
4,16,220,17,15,2
4,16,221,21,8,13
4,16,222,11,10,1
4,16,223,44,21,23
4,16,224,18,15,3
4,16,225,19,13,6
4,16,226,12,14,-2
4,16,227,10,14,-4
4,16,228,23,22,1
4,16,229,18,9,9
4,16,230,13,2,11
4,16,231,4,8,-4
4,16,232,21,11,10
4,16,233,21,11,10
4,16,234,13,10,3
4,16,235,7,2,5
4,16,236,7,15,-8
4,16,237,23,16,7
4,16,238,20,8,12
4,16,239,16,11,5
4,16,240,19,8,11
4,16,241,23,12,11
4,16,242,22,14,8
4,16,243,16,14,2
4,16,244,3,14,-11
4,16,245,28,18,10
4,16,246,11,13,-2
4,16,247,10,4,6
4,16,248,23,11,12
4,16,249,11,5,6
4,16,250,21,11,10
4,16,251,16,15,1
4,16,252,14,6,8
4,16,253,26,7,19
4,16,254,19,9,10
4,16,255,18,19,-1
4,16,256,11,5,6
4,16,257,17,7,10
4,16,258,15,11,4
4,16,259,18,7,11
4,16,260,16,15,1
4,16,261,11,1,10
4,16,262,32,14,18
4,16,263,12,11,1
4,16,264,17,15,2
4,16,265,14,15,-1
4,16,266,25,15,10
4,16,267,25,12,13
4,16,268,14,9,5
4,16,269,23,14,9
4,16,270,14,3,11
4,16,271,27,6,21
4,16,272,10,15,-5
4,16,273,15,13,2
4,16,274,22,11,11
4,16,275,17,14,3
4,16,276,23,18,5
4,16,277,22,19,3
4,16,278,27,12,15
4,16,279,10,2,8
4,16,280,19,7,12
4,16,281,13,19,-6
4,16,282,23,8,15
4,16,283,34,13,21
4,16,284,23,8,15
4,16,285,17,15,2
4,16,286,18,16,2
4,16,287,24,7,17
4,16,288,13,8,5
4,16,289,18,8,10
4,16,290,30,13,17
4,16,291,24,15,9
4,16,292,33,10,23
4,16,293,7,9,-2
4,16,294,20,9,11
4,16,295,5,13,-8
4,16,296,24,8,16
4,16,297,25,8,17
4,16,298,17,16,1
4,16,299,21,11,10
4,17,0,23,14,9
4,17,1,6,1,5
4,17,2,11,8,3
4,17,3,22,10,12
4,17,4,10,9,1
4,17,5,14,15,-1
4,17,6,14,12,2
4,17,7,11,6,5
4,17,8,16,8,8
4,17,9,19,5,14
4,17,10,12,9,3
4,17,11,15,2,13
4,17,12,9,9,0
4,17,13,17,14,3
4,17,14,19,8,11
4,17,15,36,24,12
4,17,16,9,4,5
4,17,17,24,16,8
4,17,18,8,5,3
4,17,19,22,5,17
4,17,20,30,11,19
4,17,21,19,15,4
4,17,22,12,10,2
4,17,23,15,11,4
4,17,24,19,13,6
4,17,25,8,7,1
4,17,26,8,0,8
4,17,27,13,9,4
4,17,28,21,10,11
4,17,29,9,11,-2
4,17,30,12,13,-1
4,17,31,20,23,-3
4,17,32,24,11,13
4,17,33,15,10,5
4,17,34,12,6,6
4,17,35,19,7,12
4,17,36,29,11,18
4,17,37,10,5,5
4,17,38,16,6,10
4,17,39,9,17,-8
4,17,40,5,7,-2
4,17,41,9,2,7
4,17,42,11,12,-1
4,17,43,16,21,-5
4,17,44,15,12,3
4,17,45,22,13,9
4,17,46,11,9,2
4,17,47,28,16,12
4,17,48,18,16,2
4,17,49,24,8,16
4,17,50,17,12,5
4,17,51,13,17,-4
4,17,52,15,10,5
4,17,53,19,20,-1
4,17,54,34,14,20
4,17,55,33,15,18
4,17,56,29,19,10
4,17,57,14,18,-4
4,17,58,18,19,-1
4,17,59,15,6,9
4,17,60,6,16,-10
4,17,61,11,5,6
4,17,62,16,5,11
4,17,63,17,10,7
4,17,64,22,7,15
4,17,65,27,10,17
4,17,66,17,11,6
4,17,67,19,8,11
4,17,68,11,2,9
4,17,69,15,15,0
4,17,70,7,8,-1
4,17,71,17,27,-10
4,17,72,18,9,9
4,17,73,14,11,3
4,17,74,6,5,1
4,17,75,19,11,8
4,17,76,25,11,14
4,17,77,12,10,2
4,17,78,14,6,8
4,17,79,6,8,-2
4,17,80,10,3,7
4,17,81,5,7,-2
4,17,82,22,6,16
4,17,83,17,9,8
4,17,84,20,8,12
4,17,85,32,18,14
4,17,86,27,15,12
4,17,87,15,8,7
4,17,88,21,27,-6
4,17,89,6,4,2
4,17,90,24,16,8
4,17,91,17,10,7
4,17,92,17,24,-7
4,17,93,10,10,0
4,17,94,13,30,-17
4,17,95,23,14,9
4,17,96,17,11,6
4,17,97,5,1,4
4,17,98,6,11,-5
4,17,99,19,13,6
4,17,100,27,10,17
4,17,101,14,9,5
4,17,102,13,10,3
4,17,103,9,7,2
4,17,104,18,9,9
4,17,105,22,15,7
4,17,106,15,8,7
4,17,107,18,11,7
4,17,108,16,12,4
4,17,109,9,22,-13
4,17,110,23,18,5
4,17,111,14,14,0
4,17,112,23,16,7
4,17,113,13,9,4
4,17,114,15,13,2
4,17,115,25,8,17
4,17,116,20,11,9
4,17,117,8,3,5
4,17,118,17,13,4
4,17,119,18,8,10
4,17,120,18,13,5
4,17,121,20,3,17
4,17,122,19,9,10
4,17,123,27,8,19
4,17,124,17,14,3
4,17,125,17,10,7
4,17,126,22,7,15
4,17,127,14,10,4
4,17,128,30,9,21
4,17,129,12,5,7
4,17,130,13,6,7
4,17,131,16,11,5
4,17,132,18,13,5
4,17,133,21,12,9
4,17,134,15,9,6
4,17,135,18,29,-11
4,17,136,16,16,0
4,17,137,12,17,-5
4,17,138,9,1,8
4,17,139,26,7,19
4,17,140,10,8,2
4,17,141,12,18,-6
4,17,142,12,4,8
4,17,143,23,14,9
4,17,144,26,13,13
4,17,145,32,8,24
4,17,146,15,10,5
4,17,147,20,19,1
4,17,148,29,14,15
4,17,149,11,9,2
4,17,150,25,20,5
4,17,151,9,7,2
4,17,152,11,12,-1
4,17,153,26,11,15
4,17,154,24,16,8
4,17,155,12,5,7
4,17,156,34,19,15
4,17,157,14,6,8
4,17,158,15,15,0
4,17,159,28,15,13
4,17,160,19,10,9
4,17,161,14,17,-3
4,17,162,15,14,1
4,17,163,20,12,8
4,17,164,9,10,-1
4,17,165,22,16,6
4,17,166,18,13,5
4,17,167,19,12,7
4,17,168,7,18,-11
4,17,169,9,11,-2
4,17,170,12,9,3
4,17,171,23,6,17
4,17,172,7,8,-1
4,17,173,21,8,13
4,17,174,16,8,8
4,17,175,18,12,6
4,17,176,12,16,-4
4,17,177,15,5,10
4,17,178,14,12,2
4,17,179,15,24,-9
4,17,180,23,23,0
4,17,181,17,8,9
4,17,182,15,7,8
4,17,183,12,5,7
4,17,184,15,8,7
4,17,185,16,13,3
4,17,186,21,15,6
4,17,187,28,17,11
4,17,188,13,17,-4
4,17,189,18,9,9
4,17,190,11,16,-5
4,17,191,15,9,6
4,17,192,28,16,12
4,17,193,11,11,0
4,17,194,23,8,15
4,17,195,24,4,20
4,17,196,27,18,9
4,17,197,7,6,1
4,17,198,20,16,4
4,17,199,10,5,5
4,17,200,10,4,6
4,17,201,5,11,-6
4,17,202,18,9,9
4,17,203,14,19,-5
4,17,204,27,11,16
4,17,205,17,11,6
4,17,206,10,16,-6
4,17,207,12,6,6
4,17,208,20,20,0
4,17,209,14,7,7
4,17,210,14,8,6
4,17,211,16,9,7
4,17,212,13,10,3
4,17,213,11,12,-1
4,17,214,22,9,13
4,17,215,20,23,-3
4,17,216,25,9,16
4,17,217,15,14,1
4,17,218,16,9,7
4,17,219,14,8,6
4,17,220,13,6,7
4,17,221,12,3,9
4,17,222,19,16,3
4,17,223,15,15,0
4,17,224,12,2,10
4,17,225,17,7,10
4,17,226,28,8,20
4,17,227,24,7,17
4,17,228,28,6,22
4,17,229,17,10,7
4,17,230,12,4,8
4,17,231,17,17,0
4,17,232,16,9,7
4,17,233,26,13,13
4,17,234,13,17,-4
4,17,235,12,10,2
4,17,236,11,8,3
4,17,237,22,17,5
4,17,238,17,7,10
4,17,239,4,7,-3
4,17,240,17,15,2
4,17,241,36,22,14
4,17,242,10,16,-6
4,17,243,13,12,1
4,17,244,14,7,7
4,17,245,21,19,2
4,17,246,29,14,15
4,17,247,13,1,12
4,17,248,29,11,18
4,17,249,22,16,6
4,17,250,11,7,4
4,17,251,16,15,1
4,17,252,19,8,11
4,17,253,12,3,9
4,17,254,41,16,25
4,17,255,19,10,9
4,17,256,17,7,10
4,17,257,13,11,2
4,17,258,13,5,8
4,17,259,13,11,2
4,17,260,23,8,15
4,17,261,28,9,19
4,17,262,24,8,16
4,17,263,17,8,9
4,17,264,20,7,13
4,17,265,14,14,0
4,17,266,17,15,2
4,17,267,9,12,-3
4,17,268,16,8,8
4,17,269,30,20,10
4,17,270,15,18,-3
4,17,271,18,11,7
4,17,272,25,11,14
4,17,273,6,6,0
4,17,274,13,10,3
4,17,275,8,6,2
4,17,276,20,9,11
4,17,277,17,9,8
4,17,278,12,9,3
4,17,279,16,18,-2
4,17,280,15,13,2
4,17,281,18,30,-12
4,17,282,17,12,5
4,17,283,15,2,13
4,17,284,6,5,1
4,17,285,12,17,-5
4,17,286,25,19,6
4,17,287,18,7,11
4,17,288,25,16,9
4,17,289,10,9,1
4,17,290,17,11,6
4,17,291,16,11,5
4,17,292,13,13,0
4,17,293,14,7,7
4,17,294,12,5,7
4,17,295,7,15,-8
4,17,296,10,6,4
4,17,297,20,10,10
4,17,298,27,18,9
4,17,299,8,6,2
4,18,0,12,14,-2
4,18,1,24,11,13
4,18,2,11,7,4
4,18,3,19,14,5
4,18,4,19,14,5
4,18,5,30,13,17
4,18,6,13,14,-1
4,18,7,18,17,1
4,18,8,20,21,-1
4,18,9,10,6,4
4,18,10,24,18,6
4,18,11,23,12,11
4,18,12,15,6,9
4,18,13,16,8,8
4,18,14,21,9,12
4,18,15,25,7,18
4,18,16,12,15,-3
4,18,17,12,13,-1
4,18,18,14,8,6
4,18,19,20,10,10
4,18,20,18,11,7
4,18,21,11,10,1
4,18,22,9,9,0
4,18,23,17,9,8
4,18,24,12,7,5
4,18,25,20,16,4
4,18,26,26,13,13
4,18,27,19,16,3
4,18,28,11,3,8
4,18,29,19,10,9
4,18,30,22,10,12
4,18,31,26,6,20
4,18,32,14,13,1
4,18,33,7,6,1
4,18,34,10,14,-4
4,18,35,15,10,5
4,18,36,25,6,19
4,18,37,11,13,-2
4,18,38,24,12,12
4,18,39,18,5,13
4,18,40,7,5,2
4,18,41,8,7,1
4,18,42,27,29,-2
4,18,43,10,10,0
4,18,44,22,5,17
4,18,45,14,4,10
4,18,46,19,9,10
4,18,47,8,6,2
4,18,48,30,19,11
4,18,49,21,6,15
4,18,50,26,16,10
4,18,51,24,3,21
4,18,52,16,18,-2
4,18,53,22,17,5
4,18,54,20,13,7
4,18,55,14,13,1
4,18,56,15,10,5
4,18,57,17,4,13
4,18,58,22,11,11
4,18,59,16,27,-11
4,18,60,17,9,8
4,18,61,18,25,-7
4,18,62,11,8,3
4,18,63,22,7,15
4,18,64,18,14,4
4,18,65,16,9,7
4,18,66,22,26,-4
4,18,67,16,6,10
4,18,68,16,4,12
4,18,69,18,8,10
4,18,70,17,22,-5
4,18,71,23,15,8
4,18,72,13,23,-10
4,18,73,14,7,7
4,18,74,9,15,-6
4,18,75,20,5,15
4,18,76,11,7,4
4,18,77,21,9,12
4,18,78,20,10,10
4,18,79,15,17,-2
4,18,80,19,16,3
4,18,81,21,8,13
4,18,82,13,2,11
4,18,83,13,4,9
4,18,84,18,13,5
4,18,85,16,13,3
4,18,86,15,3,12
4,18,87,15,8,7
4,18,88,12,10,2
4,18,89,18,6,12
4,18,90,23,12,11
4,18,91,29,13,16
4,18,92,11,1,10
4,18,93,29,6,23
4,18,94,32,9,23
4,18,95,6,7,-1
4,18,96,8,15,-7
4,18,97,33,23,10
4,18,98,17,2,15
4,18,99,20,16,4
4,18,100,7,12,-5
4,18,101,24,10,14
4,18,102,19,12,7
4,18,103,15,6,9
4,18,104,19,12,7
4,18,105,30,10,20
4,18,106,6,15,-9
4,18,107,21,19,2
4,18,108,13,6,7
4,18,109,11,12,-1
4,18,110,19,11,8
4,18,111,20,10,10
4,18,112,23,13,10
4,18,113,17,12,5
4,18,114,20,11,9
4,18,115,24,12,12
4,18,116,16,7,9
4,18,117,11,1,10
4,18,118,19,16,3
4,18,119,7,2,5
4,18,120,6,7,-1
4,18,121,14,19,-5
4,18,122,19,21,-2
4,18,123,13,7,6
4,18,124,25,8,17
4,18,125,17,8,9
4,18,126,26,16,10
4,18,127,24,20,4
4,18,128,25,13,12
4,18,129,7,13,-6
4,18,130,11,6,5
4,18,131,20,5,15
4,18,132,15,12,3
4,18,133,7,4,3
4,18,134,26,12,14
4,18,135,32,12,20
4,18,136,17,4,13
4,18,137,26,11,15
4,18,138,8,16,-8
4,18,139,15,16,-1
4,18,140,8,22,-14
4,18,141,20,3,17
4,18,142,12,12,0
4,18,143,29,15,14
4,18,144,20,15,5
4,18,145,23,9,14
4,18,146,12,6,6
4,18,147,21,7,14
4,18,148,9,5,4
4,18,149,8,21,-13
4,18,150,17,21,-4
4,18,151,19,2,17
4,18,152,15,7,8
4,18,153,19,19,0
4,18,154,34,16,18
4,18,155,9,9,0
4,18,156,15,12,3
4,18,157,7,10,-3
4,18,158,28,17,11
4,18,159,11,6,5
4,18,160,20,12,8
4,18,161,17,11,6
4,18,162,22,11,11
4,18,163,19,5,14
4,18,164,20,7,13
4,18,165,20,12,8
4,18,166,18,9,9
4,18,167,2,4,-2
4,18,168,20,11,9
4,18,169,17,22,-5
4,18,170,17,17,0
4,18,171,9,16,-7
4,18,172,13,3,10
4,18,173,12,9,3
4,18,174,17,16,1
4,18,175,9,10,-1
4,18,176,15,13,2
4,18,177,27,10,17
4,18,178,24,9,15
4,18,179,22,11,11
4,18,180,16,6,10
4,18,181,12,14,-2
4,18,182,20,7,13
4,18,183,13,3,10
4,18,184,22,7,15
4,18,185,20,9,11
4,18,186,33,26,7
4,18,187,21,14,7
4,18,188,14,1,13
4,18,189,15,17,-2
4,18,190,7,5,2
4,18,191,16,11,5
4,18,192,7,5,2
4,18,193,12,5,7
4,18,194,7,11,-4
4,18,195,13,7,6
4,18,196,18,24,-6
4,18,197,25,14,11
4,18,198,35,13,22
4,18,199,23,10,13
4,18,200,14,3,11
4,18,201,18,9,9
4,18,202,12,3,9
4,18,203,13,5,8
4,18,204,19,6,13
4,18,205,12,9,3
4,18,206,16,11,5
4,18,207,24,15,9
4,18,208,16,9,7
4,18,209,28,4,24
4,18,210,32,7,25
4,18,211,13,4,9
4,18,212,6,11,-5
4,18,213,14,8,6
4,18,214,18,13,5
4,18,215,19,15,4
4,18,216,22,4,18
4,18,217,27,8,19
4,18,218,11,6,5
4,18,219,25,21,4
4,18,220,12,4,8
4,18,221,35,14,21
4,18,222,14,12,2
4,18,223,10,14,-4
4,18,224,15,10,5
4,18,225,32,18,14
4,18,226,1,2,-1
4,18,227,21,12,9
4,18,228,32,10,22
4,18,229,8,5,3
4,18,230,13,19,-6
4,18,231,8,4,4
4,18,232,12,11,1
4,18,233,16,14,2
4,18,234,14,16,-2
4,18,235,17,9,8
4,18,236,14,12,2
4,18,237,28,15,13
4,18,238,23,8,15
4,18,239,28,20,8
4,18,240,26,10,16
4,18,241,22,29,-7
4,18,242,13,17,-4
4,18,243,15,6,9
4,18,244,15,12,3
4,18,245,11,6,5
4,18,246,30,11,19
4,18,247,12,11,1
4,18,248,18,9,9
4,18,249,6,8,-2
4,18,250,14,19,-5
4,18,251,15,8,7
4,18,252,23,12,11
4,18,253,15,15,0
4,18,254,18,14,4
4,18,255,9,11,-2
4,18,256,22,10,12
4,18,257,8,15,-7
4,18,258,15,11,4
4,18,259,40,9,31
4,18,260,21,4,17
4,18,261,34,6,28
4,18,262,34,7,27
4,18,263,25,13,12
4,18,264,6,2,4
4,18,265,5,11,-6
4,18,266,16,19,-3
4,18,267,12,9,3
4,18,268,23,11,12
4,18,269,8,6,2
4,18,270,13,7,6
4,18,271,13,19,-6
4,18,272,16,13,3
4,18,273,7,9,-2
4,18,274,15,7,8
4,18,275,14,5,9
4,18,276,24,15,9
4,18,277,23,10,13
4,18,278,13,20,-7
4,18,279,24,9,15
4,18,280,21,16,5
4,18,281,20,14,6
4,18,282,12,10,2
4,18,283,13,6,7
4,18,284,26,13,13
4,18,285,5,14,-9
4,18,286,14,17,-3
4,18,287,19,13,6
4,18,288,18,21,-3
4,18,289,10,4,6
4,18,290,11,10,1
4,18,291,18,10,8
4,18,292,7,13,-6
4,18,293,11,3,8
4,18,294,8,8,0
4,18,295,16,16,0
4,18,296,20,11,9
4,18,297,28,23,5
4,18,298,15,10,5
4,18,299,9,8,1
4,19,0,3,4,-1
4,19,1,16,10,6
4,19,2,32,23,9
4,19,3,17,7,10
4,19,4,10,7,3
4,19,5,20,23,-3
4,19,6,25,8,17
4,19,7,8,16,-8
4,19,8,13,12,1
4,19,9,17,18,-1
4,19,10,14,11,3
4,19,11,21,18,3
4,19,12,15,4,11
4,19,13,12,3,9
4,19,14,15,16,-1
4,19,15,15,17,-2
4,19,16,19,9,10
4,19,17,24,4,20
4,19,18,16,15,1
4,19,19,15,13,2
4,19,20,22,9,13
4,19,21,19,10,9
4,19,22,19,7,12
4,19,23,8,4,4
4,19,24,15,15,0
4,19,25,12,17,-5
4,19,26,17,11,6
4,19,27,20,13,7
4,19,28,17,7,10
4,19,29,15,18,-3
4,19,30,7,3,4
4,19,31,26,17,9
4,19,32,19,9,10
4,19,33,29,14,15
4,19,34,13,8,5
4,19,35,20,7,13
4,19,36,18,15,3
4,19,37,34,14,20
4,19,38,21,19,2
4,19,39,14,27,-13
4,19,40,19,27,-8
4,19,41,21,9,12
4,19,42,10,8,2
4,19,43,7,7,0
4,19,44,22,21,1
4,19,45,24,12,12
4,19,46,22,21,1
4,19,47,18,17,1
4,19,48,22,13,9
4,19,49,23,19,4
4,19,50,26,11,15
4,19,51,15,9,6
4,19,52,12,8,4
4,19,53,19,8,11
4,19,54,17,6,11
4,19,55,8,9,-1
4,19,56,26,7,19
4,19,57,13,17,-4
4,19,58,14,21,-7
4,19,59,15,16,-1
4,19,60,10,11,-1
4,19,61,29,13,16
4,19,62,20,21,-1
4,19,63,31,12,19
4,19,64,22,5,17
4,19,65,30,10,20
4,19,66,22,10,12
4,19,67,19,8,11
4,19,68,6,7,-1
4,19,69,26,14,12
4,19,70,14,9,5
4,19,71,8,15,-7
4,19,72,14,7,7
4,19,73,13,9,4
4,19,74,13,13,0
4,19,75,32,22,10
4,19,76,24,22,2
4,19,77,13,24,-11
4,19,78,19,20,-1
4,19,79,20,14,6
4,19,80,15,4,11
4,19,81,11,10,1
4,19,82,29,13,16
4,19,83,13,13,0
4,19,84,15,15,0
4,19,85,12,11,1
4,19,86,27,13,14
4,19,87,12,11,1
4,19,88,18,18,0
4,19,89,11,17,-6
4,19,90,21,10,11
4,19,91,11,11,0
4,19,92,17,7,10
4,19,93,17,15,2
4,19,94,12,23,-11
4,19,95,8,7,1
4,19,96,15,7,8
4,19,97,17,11,6
4,19,98,10,6,4
4,19,99,22,6,16
4,19,100,9,2,7
4,19,101,18,12,6
4,19,102,17,8,9
4,19,103,7,5,2
4,19,104,14,14,0
4,19,105,16,13,3
4,19,106,14,8,6
4,19,107,15,7,8
4,19,108,27,14,13
4,19,109,18,10,8
4,19,110,7,4,3
4,19,111,9,8,1
4,19,112,26,18,8
4,19,113,10,15,-5
4,19,114,13,7,6
4,19,115,17,5,12
4,19,116,12,10,2
4,19,117,23,5,18
4,19,118,21,11,10
4,19,119,13,8,5
4,19,120,19,8,11
4,19,121,20,16,4
4,19,122,20,3,17
4,19,123,15,15,0
4,19,124,11,11,0
4,19,125,6,4,2
4,19,126,16,8,8
4,19,127,14,13,1
4,19,128,11,10,1
4,19,129,20,3,17
4,19,130,21,7,14
4,19,131,13,11,2
4,19,132,21,11,10
4,19,133,29,8,21
4,19,134,17,10,7
4,19,135,34,8,26
4,19,136,21,10,11
4,19,137,10,4,6
4,19,138,28,13,15
4,19,139,8,12,-4
4,19,140,19,9,10
4,19,141,16,11,5
4,19,142,19,13,6
4,19,143,8,4,4
4,19,144,9,11,-2
4,19,145,21,9,12
4,19,146,14,1,13
4,19,147,32,7,25
4,19,148,13,18,-5
4,19,149,26,15,11
4,19,150,10,7,3
4,19,151,20,17,3
4,19,152,15,19,-4
4,19,153,8,7,1
4,19,154,17,17,0
4,19,155,7,3,4
4,19,156,19,7,12
4,19,157,11,19,-8
4,19,158,27,12,15
4,19,159,28,20,8
4,19,160,25,17,8
4,19,161,10,13,-3
4,19,162,22,7,15
4,19,163,16,10,6
4,19,164,4,10,-6
4,19,165,14,16,-2
4,19,166,17,9,8
4,19,167,26,9,17
4,19,168,13,6,7
4,19,169,26,20,6
4,19,170,15,12,3
4,19,171,15,15,0
4,19,172,26,18,8
4,19,173,19,8,11
4,19,174,15,10,5
4,19,175,14,6,8
4,19,176,17,5,12
4,19,177,18,7,11
4,19,178,12,14,-2
4,19,179,20,12,8
4,19,180,6,3,3
4,19,181,33,20,13
4,19,182,12,11,1
4,19,183,18,13,5
4,19,184,22,16,6
4,19,185,18,10,8
4,19,186,35,35,0
4,19,187,22,5,17
4,19,188,13,6,7
4,19,189,28,22,6
4,19,190,14,14,0
4,19,191,21,14,7
4,19,192,14,22,-8
4,19,193,21,6,15
4,19,194,19,6,13
4,19,195,13,9,4
4,19,196,15,15,0
4,19,197,13,5,8
4,19,198,19,30,-11
4,19,199,35,5,30
4,19,200,24,9,15
4,19,201,23,11,12
4,19,202,15,16,-1
4,19,203,18,9,9
4,19,204,26,17,9
4,19,205,19,11,8
4,19,206,10,9,1
4,19,207,17,8,9
4,19,208,23,4,19
4,19,209,12,15,-3
4,19,210,17,5,12
4,19,211,16,16,0
4,19,212,18,10,8
4,19,213,25,10,15
4,19,214,12,18,-6
4,19,215,10,5,5
4,19,216,22,4,18
4,19,217,14,19,-5
4,19,218,11,10,1
4,19,219,13,5,8
4,19,220,18,10,8
4,19,221,11,8,3
4,19,222,17,14,3
4,19,223,26,17,9
4,19,224,29,13,16
4,19,225,9,6,3
4,19,226,10,8,2
4,19,227,32,13,19
4,19,228,7,6,1
4,19,229,21,14,7
4,19,230,18,17,1
4,19,231,16,11,5
4,19,232,9,7,2
4,19,233,6,11,-5
4,19,234,22,15,7
4,19,235,22,15,7
4,19,236,12,10,2
4,19,237,15,2,13
4,19,238,25,8,17
4,19,239,18,17,1
4,19,240,14,12,2
4,19,241,14,7,7
4,19,242,26,20,6
4,19,243,10,9,1
4,19,244,17,3,14
4,19,245,19,10,9
4,19,246,20,6,14
4,19,247,15,11,4
4,19,248,19,10,9
4,19,249,19,4,15
4,19,250,13,5,8
4,19,251,22,14,8
4,19,252,6,0,6
4,19,253,18,30,-12
4,19,254,19,14,5
4,19,255,23,11,12
4,19,256,23,11,12
4,19,257,9,15,-6
4,19,258,14,7,7
4,19,259,6,11,-5
4,19,260,19,10,9
4,19,261,21,10,11
4,19,262,17,11,6
4,19,263,22,8,14
4,19,264,13,14,-1
4,19,265,22,18,4
4,19,266,22,17,5
4,19,267,21,21,0
4,19,268,25,12,13
4,19,269,23,13,10
4,19,270,8,5,3
4,19,271,20,5,15
4,19,272,14,7,7
4,19,273,18,17,1
4,19,274,19,9,10
4,19,275,19,16,3
4,19,276,5,7,-2
4,19,277,13,15,-2
4,19,278,14,7,7
4,19,279,35,15,20
4,19,280,16,3,13
4,19,281,25,12,13
4,19,282,14,17,-3
4,19,283,19,7,12
4,19,284,12,9,3
4,19,285,24,9,15
4,19,286,13,11,2
4,19,287,23,12,11
4,19,288,15,14,1
4,19,289,4,2,2
4,19,290,21,18,3
4,19,291,11,5,6
4,19,292,22,11,11
4,19,293,28,18,10
4,19,294,21,21,0
4,19,295,23,15,8
4,19,296,10,10,0
4,19,297,16,9,7
4,19,298,20,11,9
4,19,299,20,13,7
4,20,0,26,7,19
4,20,1,29,13,16
4,20,2,17,13,4
4,20,3,9,12,-3
4,20,4,14,13,1
4,20,5,17,5,12
4,20,6,19,8,11
4,20,7,43,16,27
4,20,8,19,6,13
4,20,9,16,12,4
4,20,10,31,20,11
4,20,11,14,9,5
4,20,12,19,5,14
4,20,13,6,5,1
4,20,14,25,6,19
4,20,15,23,16,7
4,20,16,18,13,5
4,20,17,18,4,14
4,20,18,18,10,8
4,20,19,31,17,14
4,20,20,14,17,-3
4,20,21,36,17,19
4,20,22,31,12,19
4,20,23,15,7,8
4,20,24,17,10,7
4,20,25,13,12,1
4,20,26,32,6,26
4,20,27,22,10,12
4,20,28,24,9,15
4,20,29,27,9,18
4,20,30,9,4,5
4,20,31,27,8,19
4,20,32,17,12,5
4,20,33,16,7,9
4,20,34,11,11,0
4,20,35,17,3,14
4,20,36,34,13,21
4,20,37,21,23,-2
4,20,38,33,4,29
4,20,39,2,4,-2
4,20,40,18,28,-10
4,20,41,12,10,2
4,20,42,40,12,28
4,20,43,35,5,30
4,20,44,16,13,3
4,20,45,30,11,19
4,20,46,37,20,17
4,20,47,19,5,14
4,20,48,23,23,0
4,20,49,8,13,-5
4,20,50,21,13,8
4,20,51,18,12,6
4,20,52,28,13,15
4,20,53,10,10,0
4,20,54,16,16,0
4,20,55,22,15,7
4,20,56,26,3,23
4,20,57,15,15,0
4,20,58,24,12,12
4,20,59,20,14,6
4,20,60,12,6,6
4,20,61,16,13,3
4,20,62,28,6,22
4,20,63,18,9,9
4,20,64,24,10,14
4,20,65,14,12,2
4,20,66,16,9,7
4,20,67,14,5,9
4,20,68,16,11,5
4,20,69,22,17,5
4,20,70,20,19,1
4,20,71,15,12,3
4,20,72,7,5,2
4,20,73,14,6,8
4,20,74,13,20,-7
4,20,75,18,2,16
4,20,76,10,3,7
4,20,77,15,6,9
4,20,78,11,8,3
4,20,79,15,17,-2
4,20,80,20,10,10
4,20,81,14,9,5
4,20,82,24,6,18
4,20,83,17,21,-4
4,20,84,22,16,6
4,20,85,29,15,14
4,20,86,22,19,3
4,20,87,21,8,13
4,20,88,13,13,0
4,20,89,19,6,13
4,20,90,23,7,16
4,20,91,11,17,-6
4,20,92,19,14,5
4,20,93,24,9,15
4,20,94,16,12,4
4,20,95,16,10,6
4,20,96,30,24,6
4,20,97,22,12,10
4,20,98,8,4,4
4,20,99,12,11,1
4,20,100,6,6,0
4,20,101,11,16,-5
4,20,102,25,9,16
4,20,103,15,9,6
4,20,104,12,3,9
4,20,105,9,6,3
4,20,106,22,7,15
4,20,107,18,17,1
4,20,108,17,10,7
4,20,109,10,6,4
4,20,110,12,7,5
4,20,111,30,8,22
4,20,112,11,10,1
4,20,113,17,16,1
4,20,114,9,8,1
4,20,115,7,13,-6
4,20,116,18,9,9
4,20,117,18,8,10
4,20,118,18,18,0
4,20,119,10,5,5
4,20,120,16,6,10
4,20,121,20,5,15
4,20,122,20,18,2
4,20,123,10,8,2
4,20,124,35,15,20
4,20,125,11,10,1
4,20,126,21,13,8
4,20,127,16,11,5
4,20,128,22,8,14
4,20,129,24,8,16
4,20,130,6,5,1
4,20,131,26,20,6
4,20,132,26,8,18
4,20,133,15,12,3
4,20,134,14,8,6
4,20,135,14,16,-2
4,20,136,17,13,4
4,20,137,13,11,2
4,20,138,12,17,-5
4,20,139,20,9,11
4,20,140,16,11,5
4,20,141,29,5,24
4,20,142,9,10,-1
4,20,143,21,19,2
4,20,144,17,4,13
4,20,145,28,14,14
4,20,146,27,13,14
4,20,147,17,14,3
4,20,148,17,13,4
4,20,149,17,3,14
4,20,150,10,19,-9
4,20,151,15,19,-4
4,20,152,14,9,5
4,20,153,35,14,21
4,20,154,9,3,6
4,20,155,14,2,12
4,20,156,15,13,2
4,20,157,19,14,5
4,20,158,20,6,14
4,20,159,6,4,2
4,20,160,2,3,-1
4,20,161,10,20,-10
4,20,162,33,12,21
4,20,163,11,6,5
4,20,164,22,19,3
4,20,165,24,6,18
4,20,166,15,17,-2
4,20,167,12,17,-5
4,20,168,26,14,12
4,20,169,15,19,-4
4,20,170,15,11,4
4,20,171,33,24,9
4,20,172,24,10,14
4,20,173,22,14,8
4,20,174,17,14,3
4,20,175,24,17,7
4,20,176,17,20,-3
4,20,177,22,13,9
4,20,178,22,12,10
4,20,179,14,6,8
4,20,180,10,10,0
4,20,181,21,17,4
4,20,182,18,13,5
4,20,183,8,4,4
4,20,184,12,14,-2
4,20,185,14,12,2
4,20,186,7,11,-4
4,20,187,17,13,4
4,20,188,11,13,-2
4,20,189,20,6,14
4,20,190,40,6,34
4,20,191,18,7,11
4,20,192,15,7,8
4,20,193,13,10,3
4,20,194,16,8,8
4,20,195,12,8,4
4,20,196,15,6,9
4,20,197,33,15,18
4,20,198,16,2,14
4,20,199,10,12,-2
4,20,200,30,16,14
4,20,201,18,14,4
4,20,202,11,13,-2
4,20,203,20,6,14
4,20,204,20,8,12
4,20,205,16,14,2
4,20,206,26,13,13
4,20,207,32,14,18
4,20,208,19,2,17
4,20,209,19,12,7
4,20,210,10,8,2
4,20,211,9,9,0
4,20,212,20,9,11
4,20,213,20,13,7
4,20,214,17,10,7
4,20,215,12,18,-6
4,20,216,8,15,-7
4,20,217,15,20,-5
4,20,218,19,14,5
4,20,219,11,8,3
4,20,220,14,8,6
4,20,221,18,14,4
4,20,222,25,10,15
4,20,223,5,11,-6
4,20,224,33,13,20
4,20,225,9,9,0
4,20,226,10,10,0
4,20,227,21,11,10
4,20,228,30,14,16
4,20,229,8,5,3
4,20,230,12,8,4
4,20,231,22,17,5
4,20,232,16,4,12
4,20,233,20,15,5
4,20,234,18,9,9
4,20,235,15,5,10
4,20,236,22,11,11
4,20,237,11,3,8
4,20,238,6,5,1
4,20,239,20,5,15
4,20,240,15,12,3
4,20,241,19,6,13
4,20,242,15,10,5
4,20,243,13,11,2
4,20,244,15,9,6
4,20,245,15,11,4
4,20,246,23,18,5
4,20,247,36,23,13
4,20,248,8,13,-5
4,20,249,19,6,13
4,20,250,37,12,25
4,20,251,14,14,0
4,20,252,16,14,2
4,20,253,10,5,5
4,20,254,19,16,3
4,20,255,14,5,9
4,20,256,14,4,10
4,20,257,12,19,-7
4,20,258,18,10,8
4,20,259,9,7,2
4,20,260,26,11,15
4,20,261,8,10,-2
4,20,262,13,9,4
4,20,263,19,15,4
4,20,264,20,13,7
4,20,265,19,14,5
4,20,266,29,14,15
4,20,267,30,13,17
4,20,268,17,8,9
4,20,269,19,14,5
4,20,270,15,10,5
4,20,271,18,13,5
4,20,272,31,14,17
4,20,273,14,9,5
4,20,274,19,9,10
4,20,275,31,13,18
4,20,276,12,12,0
4,20,277,15,12,3
4,20,278,14,18,-4
4,20,279,9,4,5
4,20,280,25,15,10
4,20,281,12,8,4
4,20,282,14,11,3
4,20,283,25,11,14
4,20,284,21,13,8
4,20,285,14,16,-2
4,20,286,17,13,4
4,20,287,27,15,12
4,20,288,6,8,-2
4,20,289,11,20,-9
4,20,290,7,12,-5
4,20,291,16,12,4
4,20,292,11,10,1
4,20,293,17,10,7
4,20,294,5,2,3
4,20,295,16,20,-4
4,20,296,15,15,0
4,20,297,13,9,4
4,20,298,25,12,13
4,20,299,19,8,11
4,21,0,31,13,18
4,21,1,10,4,6
4,21,2,21,9,12
4,21,3,17,3,14
4,21,4,15,3,12
4,21,5,26,8,18
4,21,6,17,7,10
4,21,7,15,11,4
4,21,8,26,11,15
4,21,9,9,5,4
4,21,10,9,14,-5
4,21,11,26,11,15
4,21,12,14,15,-1
4,21,13,19,17,2
4,21,14,15,12,3
4,21,15,13,13,0
4,21,16,45,9,36
4,21,17,33,23,10
4,21,18,29,8,21
4,21,19,13,5,8
4,21,20,15,13,2
4,21,21,14,5,9
4,21,22,25,11,14
4,21,23,17,7,10
4,21,24,15,11,4
4,21,25,14,6,8
4,21,26,10,27,-17
4,21,27,15,23,-8
4,21,28,20,17,3
4,21,29,13,4,9
4,21,30,16,7,9
4,21,31,10,3,7
4,21,32,16,5,11
4,21,33,26,12,14
4,21,34,20,7,13
4,21,35,4,3,1
4,21,36,11,13,-2
4,21,37,6,12,-6
4,21,38,19,10,9
4,21,39,17,5,12
4,21,40,22,15,7
4,21,41,29,8,21
4,21,42,19,17,2
4,21,43,15,5,10
4,21,44,20,19,1
4,21,45,18,9,9
4,21,46,27,17,10
4,21,47,9,14,-5
4,21,48,15,16,-1
4,21,49,23,11,12
4,21,50,20,13,7
4,21,51,8,15,-7
4,21,52,21,14,7
4,21,53,23,15,8
4,21,54,6,6,0
4,21,55,31,15,16
4,21,56,29,19,10
4,21,57,23,8,15
4,21,58,17,9,8
4,21,59,18,15,3
4,21,60,21,15,6
4,21,61,25,6,19
4,21,62,25,14,11
4,21,63,23,25,-2
4,21,64,7,9,-2
4,21,65,24,11,13
4,21,66,20,18,2
4,21,67,8,8,0
4,21,68,7,4,3
4,21,69,22,19,3
4,21,70,17,10,7
4,21,71,17,6,11
4,21,72,19,6,13
4,21,73,17,10,7
4,21,74,18,15,3
4,21,75,10,13,-3
4,21,76,23,15,8
4,21,77,21,6,15
4,21,78,21,14,7
4,21,79,7,3,4
4,21,80,18,7,11
4,21,81,25,12,13
4,21,82,41,6,35
4,21,83,19,12,7
4,21,84,21,15,6
4,21,85,12,8,4
4,21,86,33,13,20
4,21,87,16,17,-1
4,21,88,14,5,9
4,21,89,27,4,23
4,21,90,17,13,4
4,21,91,22,6,16
4,21,92,27,9,18
4,21,93,15,9,6
4,21,94,16,7,9
4,21,95,14,17,-3
4,21,96,15,13,2
4,21,97,20,12,8
4,21,98,13,12,1
4,21,99,41,17,24
4,21,100,24,16,8
4,21,101,23,15,8
4,21,102,20,8,12
4,21,103,24,18,6
4,21,104,19,12,7
4,21,105,42,13,29
4,21,106,9,4,5
4,21,107,27,13,14
4,21,108,11,5,6
4,21,109,11,12,-1
4,21,110,17,15,2
4,21,111,20,10,10
4,21,112,17,15,2
4,21,113,5,12,-7
4,21,114,14,12,2
4,21,115,15,7,8
4,21,116,18,22,-4
4,21,117,26,30,-4
4,21,118,14,8,6
4,21,119,26,17,9
4,21,120,28,15,13
4,21,121,21,16,5
4,21,122,24,20,4
4,21,123,14,7,7
4,21,124,24,13,11
4,21,125,22,18,4
4,21,126,10,9,1
4,21,127,18,14,4
4,21,128,15,5,10
4,21,129,14,7,7
4,21,130,14,11,3
4,21,131,7,8,-1
4,21,132,27,18,9
4,21,133,22,11,11
4,21,134,12,1,11
4,21,135,15,8,7
4,21,136,20,8,12
4,21,137,21,16,5
4,21,138,35,14,21
4,21,139,18,8,10
4,21,140,22,9,13
4,21,141,22,6,16
4,21,142,16,12,4
4,21,143,17,15,2
4,21,144,16,10,6
4,21,145,16,27,-11
4,21,146,24,29,-5
4,21,147,8,1,7
4,21,148,25,10,15
4,21,149,23,14,9
4,21,150,17,14,3
4,21,151,7,16,-9
4,21,152,22,16,6
4,21,153,13,9,4
4,21,154,15,6,9
4,21,155,16,12,4
4,21,156,10,11,-1
4,21,157,11,12,-1
4,21,158,37,21,16
4,21,159,11,10,1
4,21,160,13,10,3
4,21,161,14,9,5
4,21,162,7,4,3
4,21,163,15,13,2
4,21,164,12,19,-7
4,21,165,15,7,8
4,21,166,24,11,13
4,21,167,14,13,1
4,21,168,10,16,-6
4,21,169,23,7,16
4,21,170,28,19,9
4,21,171,25,17,8
4,21,172,14,4,10
4,21,173,13,6,7
4,21,174,22,12,10
4,21,175,23,14,9
4,21,176,11,8,3
4,21,177,26,5,21
4,21,178,21,6,15
4,21,179,11,13,-2
4,21,180,24,17,7
4,21,181,22,23,-1
4,21,182,28,6,22
4,21,183,11,3,8
4,21,184,18,6,12
4,21,185,22,6,16
4,21,186,17,7,10
4,21,187,5,12,-7
4,21,188,18,9,9
4,21,189,25,11,14
4,21,190,18,17,1
4,21,191,16,4,12
4,21,192,13,6,7
4,21,193,21,22,-1
4,21,194,15,11,4
4,21,195,13,9,4
4,21,196,22,13,9
4,21,197,14,14,0
4,21,198,11,6,5
4,21,199,10,9,1
4,21,200,16,7,9
4,21,201,6,12,-6
4,21,202,12,4,8
4,21,203,10,5,5
4,21,204,31,10,21
4,21,205,15,14,1
4,21,206,9,11,-2
4,21,207,11,4,7
4,21,208,9,6,3
4,21,209,19,10,9
4,21,210,16,16,0
4,21,211,17,17,0
4,21,212,11,7,4
4,21,213,22,25,-3
4,21,214,12,4,8
4,21,215,20,11,9
4,21,216,15,2,13
4,21,217,20,9,11
4,21,218,10,8,2
4,21,219,15,9,6
4,21,220,16,15,1
4,21,221,27,24,3
4,21,222,25,15,10
4,21,223,16,4,12
4,21,224,46,19,27
4,21,225,29,7,22
4,21,226,8,3,5
4,21,227,18,11,7
4,21,228,6,6,0
4,21,229,9,9,0
4,21,230,18,20,-2
4,21,231,10,4,6
4,21,232,25,13,12
4,21,233,17,11,6
4,21,234,26,14,12
4,21,235,15,14,1
4,21,236,27,11,16
4,21,237,12,9,3
4,21,238,14,13,1
4,21,239,21,8,13
4,21,240,12,8,4
4,21,241,13,6,7
4,21,242,27,16,11
4,21,243,28,6,22
4,21,244,16,12,4
4,21,245,21,9,12
4,21,246,13,8,5
4,21,247,22,14,8
4,21,248,11,13,-2
4,21,249,14,14,0
4,21,250,29,7,22
4,21,251,16,27,-11
4,21,252,19,10,9
4,21,253,16,16,0
4,21,254,49,19,30
4,21,255,22,5,17
4,21,256,14,7,7
4,21,257,20,9,11
4,21,258,9,7,2
4,21,259,9,10,-1
4,21,260,13,5,8
4,21,261,14,9,5
4,21,262,30,11,19
4,21,263,17,8,9
4,21,264,24,26,-2
4,21,265,23,17,6
4,21,266,25,13,12
4,21,267,10,7,3
4,21,268,11,1,10
4,21,269,14,4,10
4,21,270,15,13,2
4,21,271,19,5,14
4,21,272,23,10,13
4,21,273,21,31,-10
4,21,274,13,15,-2
4,21,275,17,14,3
4,21,276,9,13,-4
4,21,277,8,11,-3
4,21,278,9,7,2
4,21,279,20,14,6
4,21,280,18,1,17
4,21,281,16,11,5
4,21,282,15,6,9
4,21,283,20,11,9
4,21,284,23,9,14
4,21,285,14,12,2
4,21,286,13,20,-7
4,21,287,16,11,5
4,21,288,24,9,15
4,21,289,14,4,10
4,21,290,25,24,1
4,21,291,20,14,6
4,21,292,31,6,25
4,21,293,20,14,6
4,21,294,18,7,11
4,21,295,18,9,9
4,21,296,22,8,14
4,21,297,21,10,11
4,21,298,17,16,1
4,21,299,24,21,3
4,22,0,15,9,6
4,22,1,23,8,15
4,22,2,18,16,2
4,22,3,21,9,12
4,22,4,13,5,8
4,22,5,24,6,18
4,22,6,31,21,10
4,22,7,19,10,9
4,22,8,8,4,4
4,22,9,15,9,6
4,22,10,22,4,18
4,22,11,27,18,9
4,22,12,15,16,-1
4,22,13,21,11,10
4,22,14,12,8,4
4,22,15,13,9,4
4,22,16,16,9,7
4,22,17,14,6,8
4,22,18,26,16,10
4,22,19,21,13,8
4,22,20,39,20,19
4,22,21,28,8,20
4,22,22,11,13,-2
4,22,23,26,19,7
4,22,24,9,7,2
4,22,25,17,8,9
4,22,26,24,10,14
4,22,27,20,10,10
4,22,28,14,8,6
4,22,29,19,6,13
4,22,30,30,23,7
4,22,31,19,17,2
4,22,32,21,9,12
4,22,33,13,12,1
4,22,34,20,6,14
4,22,35,30,7,23
4,22,36,11,2,9
4,22,37,13,14,-1
4,22,38,21,7,14
4,22,39,25,7,18
4,22,40,18,11,7
4,22,41,14,4,10
4,22,42,9,12,-3
4,22,43,17,9,8
4,22,44,25,11,14
4,22,45,26,11,15
4,22,46,16,11,5
4,22,47,13,13,0
4,22,48,10,13,-3
4,22,49,14,15,-1
4,22,50,18,7,11
4,22,51,20,10,10
4,22,52,6,7,-1
4,22,53,24,10,14
4,22,54,7,5,2
4,22,55,24,15,9
4,22,56,10,18,-8
4,22,57,18,24,-6
4,22,58,32,8,24
4,22,59,13,6,7
4,22,60,12,6,6
4,22,61,18,8,10
4,22,62,23,9,14
4,22,63,13,12,1
4,22,64,12,15,-3
4,22,65,14,8,6
4,22,66,12,18,-6
4,22,67,7,14,-7
4,22,68,15,13,2
4,22,69,27,9,18
4,22,70,8,8,0
4,22,71,21,11,10
4,22,72,17,10,7
4,22,73,25,6,19
4,22,74,20,9,11
4,22,75,9,8,1
4,22,76,30,17,13
4,22,77,15,7,8
4,22,78,21,11,10
4,22,79,24,18,6
4,22,80,26,14,12
4,22,81,20,6,14
4,22,82,17,20,-3
4,22,83,5,0,5
4,22,84,5,14,-9
4,22,85,30,23,7
4,22,86,14,14,0
4,22,87,17,12,5
4,22,88,15,2,13
4,22,89,20,13,7
4,22,90,22,9,13
4,22,91,19,18,1
4,22,92,11,6,5
4,22,93,34,19,15
4,22,94,10,8,2
4,22,95,9,14,-5
4,22,96,24,7,17
4,22,97,2,1,1
4,22,98,28,14,14
4,22,99,15,17,-2
4,22,100,20,11,9
4,22,101,19,15,4
4,22,102,28,21,7
4,22,103,31,9,22
4,22,104,24,10,14
4,22,105,27,13,14
4,22,106,23,14,9
4,22,107,27,21,6
4,22,108,22,22,0
4,22,109,15,8,7
4,22,110,32,11,21
4,22,111,21,6,15
4,22,112,26,2,24
4,22,113,23,14,9
4,22,114,14,5,9
4,22,115,18,8,10
4,22,116,11,5,6
4,22,117,42,17,25
4,22,118,8,7,1
4,22,119,12,14,-2
4,22,120,21,13,8
4,22,121,25,9,16
4,22,122,30,20,10
4,22,123,16,15,1
4,22,124,20,11,9
4,22,125,6,14,-8
4,22,126,22,10,12
4,22,127,19,6,13
4,22,128,10,14,-4
4,22,129,22,14,8
4,22,130,20,11,9
4,22,131,32,2,30
4,22,132,17,4,13
4,22,133,23,15,8
4,22,134,20,13,7
4,22,135,13,8,5
4,22,136,15,13,2
4,22,137,16,19,-3
4,22,138,11,3,8
4,22,139,19,7,12
4,22,140,29,16,13
4,22,141,20,14,6
4,22,142,12,14,-2
4,22,143,24,13,11
4,22,144,16,19,-3
4,22,145,14,22,-8
4,22,146,16,6,10
4,22,147,12,5,7
4,22,148,30,12,18
4,22,149,9,6,3
4,22,150,9,7,2
4,22,151,24,6,18
4,22,152,12,9,3
4,22,153,10,3,7
4,22,154,26,16,10
4,22,155,19,12,7
4,22,156,13,13,0
4,22,157,26,21,5
4,22,158,13,6,7
4,22,159,20,14,6
4,22,160,9,9,0
4,22,161,9,8,1
4,22,162,15,8,7
4,22,163,25,6,19
4,22,164,16,14,2
4,22,165,13,5,8
4,22,166,11,14,-3
4,22,167,6,10,-4
4,22,168,17,5,12
4,22,169,21,13,8
4,22,170,36,14,22
4,22,171,8,8,0
4,22,172,14,26,-12
4,22,173,31,21,10
4,22,174,34,24,10
4,22,175,23,9,14
4,22,176,26,6,20
4,22,177,30,15,15
4,22,178,14,7,7
4,22,179,10,3,7
4,22,180,11,12,-1
4,22,181,24,5,19
4,22,182,25,12,13
4,22,183,15,4,11
4,22,184,8,8,0
4,22,185,20,14,6
4,22,186,27,12,15
4,22,187,26,13,13
4,22,188,8,6,2
4,22,189,15,13,2
4,22,190,22,12,10
4,22,191,10,10,0
4,22,192,15,5,10
4,22,193,11,6,5
4,22,194,16,8,8
4,22,195,24,12,12
4,22,196,16,9,7
4,22,197,35,12,23
4,22,198,16,13,3
4,22,199,18,6,12
4,22,200,32,12,20
4,22,201,24,13,11
4,22,202,28,16,12
4,22,203,19,16,3
4,22,204,31,19,12
4,22,205,15,6,9
4,22,206,31,14,17
4,22,207,7,10,-3
4,22,208,25,11,14
4,22,209,28,9,19
4,22,210,27,11,16
4,22,211,34,7,27
4,22,212,21,9,12
4,22,213,16,19,-3
4,22,214,16,9,7
4,22,215,7,10,-3
4,22,216,19,9,10
4,22,217,20,7,13
4,22,218,23,9,14
4,22,219,18,6,12
4,22,220,21,14,7
4,22,221,31,17,14
4,22,222,23,13,10
4,22,223,28,11,17
4,22,224,27,18,9
4,22,225,11,6,5
4,22,226,18,17,1
4,22,227,22,19,3
4,22,228,26,5,21
4,22,229,23,17,6
4,22,230,22,14,8
4,22,231,11,10,1
4,22,232,15,2,13
4,22,233,25,18,7
4,22,234,32,10,22
4,22,235,11,11,0
4,22,236,16,11,5
4,22,237,23,9,14
4,22,238,17,7,10
4,22,239,34,13,21
4,22,240,12,13,-1
4,22,241,22,13,9
4,22,242,43,14,29
4,22,243,26,6,20
4,22,244,19,11,8
4,22,245,21,11,10
4,22,246,19,17,2
4,22,247,21,8,13
4,22,248,21,6,15
4,22,249,20,3,17
4,22,250,16,18,-2
4,22,251,15,9,6
4,22,252,13,16,-3
4,22,253,20,8,12
4,22,254,34,17,17
4,22,255,9,11,-2
4,22,256,20,4,16
4,22,257,22,10,12
4,22,258,22,13,9
4,22,259,18,14,4
4,22,260,23,19,4
4,22,261,32,9,23
4,22,262,26,14,12
4,22,263,32,16,16
4,22,264,27,16,11
4,22,265,50,8,42
4,22,266,18,15,3
4,22,267,15,10,5
4,22,268,12,12,0
4,22,269,20,10,10
4,22,270,11,10,1
4,22,271,10,11,-1
4,22,272,19,22,-3
4,22,273,20,6,14
4,22,274,16,10,6
4,22,275,14,12,2
4,22,276,24,15,9
4,22,277,11,10,1
4,22,278,33,10,23
4,22,279,17,2,15
4,22,280,17,15,2
4,22,281,5,6,-1
4,22,282,17,20,-3
4,22,283,23,13,10
4,22,284,20,6,14
4,22,285,23,7,16
4,22,286,16,22,-6
4,22,287,25,13,12
4,22,288,21,23,-2
4,22,289,24,13,11
4,22,290,9,11,-2
4,22,291,10,11,-1
4,22,292,15,14,1
4,22,293,20,12,8
4,22,294,12,11,1
4,22,295,22,10,12
4,22,296,20,7,13
4,22,297,20,17,3
4,22,298,6,11,-5
4,22,299,22,22,0
4,23,0,17,14,3
4,23,1,19,4,15
4,23,2,21,8,13
4,23,3,16,3,13
4,23,4,16,14,2
4,23,5,17,21,-4
4,23,6,26,10,16
4,23,7,14,8,6
4,23,8,13,6,7
4,23,9,25,10,15
4,23,10,20,16,4
4,23,11,17,4,13
4,23,12,14,12,2
4,23,13,22,7,15
4,23,14,22,11,11
4,23,15,18,2,16
4,23,16,18,13,5
4,23,17,19,7,12
4,23,18,15,8,7
4,23,19,20,4,16
4,23,20,10,3,7
4,23,21,13,16,-3
4,23,22,7,6,1
4,23,23,11,10,1
4,23,24,25,4,21
4,23,25,20,9,11
4,23,26,12,1,11
4,23,27,14,6,8
4,23,28,34,29,5
4,23,29,18,9,9
4,23,30,17,10,7
4,23,31,17,5,12
4,23,32,24,7,17
4,23,33,14,5,9
4,23,34,18,7,11
4,23,35,27,9,18
4,23,36,27,13,14
4,23,37,20,21,-1
4,23,38,9,5,4
4,23,39,9,6,3
4,23,40,30,13,17
4,23,41,18,22,-4
4,23,42,23,8,15
4,23,43,28,11,17
4,23,44,22,14,8
4,23,45,10,14,-4
4,23,46,12,11,1
4,23,47,6,5,1
4,23,48,48,16,32
4,23,49,19,13,6
4,23,50,13,12,1
4,23,51,10,12,-2
4,23,52,20,14,6
4,23,53,23,8,15
4,23,54,27,12,15
4,23,55,18,17,1
4,23,56,17,7,10
4,23,57,22,16,6
4,23,58,42,7,35
4,23,59,16,9,7
4,23,60,14,9,5
4,23,61,23,20,3
4,23,62,23,4,19
4,23,63,16,16,0
4,23,64,35,19,16
4,23,65,19,5,14
4,23,66,21,15,6
4,23,67,22,9,13
4,23,68,25,6,19
4,23,69,9,8,1
4,23,70,15,5,10
4,23,71,23,13,10
4,23,72,20,5,15
4,23,73,21,15,6
4,23,74,15,11,4
4,23,75,19,4,15
4,23,76,22,5,17
4,23,77,24,14,10
4,23,78,14,2,12
4,23,79,17,3,14
4,23,80,20,17,3
4,23,81,16,11,5
4,23,82,12,14,-2
4,23,83,15,6,9
4,23,84,19,7,12
4,23,85,35,12,23
4,23,86,22,6,16
4,23,87,20,21,-1
4,23,88,13,9,4
4,23,89,23,11,12
4,23,90,17,21,-4
4,23,91,14,11,3
4,23,92,29,20,9
4,23,93,26,12,14
4,23,94,30,7,23
4,23,95,17,12,5
4,23,96,5,3,2
4,23,97,15,9,6
4,23,98,18,7,11
4,23,99,18,14,4
4,23,100,16,8,8
4,23,101,16,4,12
4,23,102,23,9,14
4,23,103,18,7,11
4,23,104,27,14,13
4,23,105,15,6,9
4,23,106,12,15,-3
4,23,107,35,7,28
4,23,108,11,20,-9
4,23,109,19,6,13
4,23,110,29,10,19
4,23,111,14,7,7
4,23,112,24,16,8
4,23,113,27,10,17
4,23,114,20,9,11
4,23,115,13,15,-2
4,23,116,23,8,15
4,23,117,9,4,5
4,23,118,16,13,3
4,23,119,15,6,9
4,23,120,29,11,18
4,23,121,26,9,17
4,23,122,19,16,3
4,23,123,15,6,9
4,23,124,14,23,-9
4,23,125,10,2,8
4,23,126,21,5,16
4,23,127,27,9,18
4,23,128,24,17,7
4,23,129,15,16,-1
4,23,130,29,21,8
4,23,131,35,13,22
4,23,132,27,10,17
4,23,133,11,2,9
4,23,134,24,14,10
4,23,135,20,13,7
4,23,136,23,13,10
4,23,137,17,11,6
4,23,138,17,7,10
4,23,139,37,8,29
4,23,140,21,21,0
4,23,141,16,8,8
4,23,142,23,10,13
4,23,143,10,12,-2
4,23,144,11,10,1
4,23,145,8,11,-3
4,23,146,17,18,-1
4,23,147,23,13,10
4,23,148,18,16,2
4,23,149,23,5,18
4,23,150,29,8,21
4,23,151,8,2,6
4,23,152,8,5,3
4,23,153,15,21,-6
4,23,154,15,9,6
4,23,155,20,15,5
4,23,156,14,9,5
4,23,157,21,12,9
4,23,158,12,8,4
4,23,159,18,13,5
4,23,160,24,11,13
4,23,161,18,7,11
4,23,162,18,14,4
4,23,163,7,8,-1
4,23,164,25,9,16
4,23,165,31,8,23
4,23,166,22,13,9
4,23,167,10,9,1
4,23,168,22,18,4
4,23,169,5,10,-5
4,23,170,10,10,0
4,23,171,11,12,-1
4,23,172,13,4,9
4,23,173,18,8,10
4,23,174,9,12,-3
4,23,175,16,13,3
4,23,176,5,14,-9
4,23,177,11,10,1
4,23,178,6,5,1
4,23,179,16,5,11
4,23,180,13,11,2
4,23,181,29,20,9
4,23,182,11,4,7
4,23,183,15,11,4
4,23,184,10,19,-9
4,23,185,14,0,14
4,23,186,12,10,2
4,23,187,19,12,7
4,23,188,19,9,10
4,23,189,45,14,31
4,23,190,20,17,3
4,23,191,13,8,5
4,23,192,16,11,5
4,23,193,16,7,9
4,23,194,13,8,5
4,23,195,14,6,8
4,23,196,25,17,8
4,23,197,14,9,5
4,23,198,19,9,10
4,23,199,30,7,23
4,23,200,14,11,3
4,23,201,19,13,6
4,23,202,24,9,15
4,23,203,19,13,6
4,23,204,22,1,21
4,23,205,15,11,4
4,23,206,28,19,9
4,23,207,23,12,11
4,23,208,23,9,14
4,23,209,23,6,17
4,23,210,10,20,-10
4,23,211,12,3,9
4,23,212,9,10,-1
4,23,213,12,9,3
4,23,214,28,12,16
4,23,215,16,9,7
4,23,216,21,9,12
4,23,217,16,8,8
4,23,218,19,3,16
4,23,219,22,10,12
4,23,220,21,8,13
4,23,221,19,23,-4
4,23,222,25,14,11
4,23,223,16,11,5
4,23,224,29,20,9
4,23,225,24,10,14
4,23,226,18,14,4
4,23,227,13,13,0
4,23,228,31,21,10
4,23,229,14,12,2
4,23,230,25,2,23
4,23,231,13,15,-2
4,23,232,27,7,20
4,23,233,31,7,24
4,23,234,15,5,10
4,23,235,17,9,8
4,23,236,21,7,14
4,23,237,15,7,8
4,23,238,19,19,0
4,23,239,16,10,6
4,23,240,28,9,19
4,23,241,12,11,1
4,23,242,11,4,7
4,23,243,15,9,6
4,23,244,20,12,8
4,23,245,18,15,3
4,23,246,21,4,17
4,23,247,26,9,17
4,23,248,26,8,18
4,23,249,28,15,13
4,23,250,27,19,8
4,23,251,14,9,5
4,23,252,29,11,18
4,23,253,22,4,18
4,23,254,14,5,9
4,23,255,44,8,36
4,23,256,24,10,14
4,23,257,26,8,18
4,23,258,23,13,10
4,23,259,26,8,18
4,23,260,13,12,1
4,23,261,19,6,13
4,23,262,8,1,7
4,23,263,10,9,1
4,23,264,36,7,29
4,23,265,15,7,8
4,23,266,30,9,21
4,23,267,15,5,10
4,23,268,11,8,3
4,23,269,11,7,4
4,23,270,13,5,8
4,23,271,8,12,-4
4,23,272,8,8,0
4,23,273,17,7,10
4,23,274,21,5,16
4,23,275,14,10,4
4,23,276,19,6,13
4,23,277,6,13,-7
4,23,278,8,10,-2
4,23,279,10,4,6
4,23,280,5,7,-2
4,23,281,21,10,11
4,23,282,28,11,17
4,23,283,29,8,21
4,23,284,14,9,5
4,23,285,11,19,-8
4,23,286,15,6,9
4,23,287,24,11,13
4,23,288,25,1,24
4,23,289,19,14,5
4,23,290,5,5,0
4,23,291,25,3,22
4,23,292,14,11,3
4,23,293,21,11,10
4,23,294,16,10,6
4,23,295,26,14,12
4,23,296,21,9,12
4,23,297,16,8,8
4,23,298,20,10,10
4,23,299,26,6,20
4,24,0,14,6,8
4,24,1,26,12,14
4,24,2,19,16,3
4,24,3,2,4,-2
4,24,4,17,8,9
4,24,5,35,7,28
4,24,6,12,12,0
4,24,7,11,7,4
4,24,8,14,10,4
4,24,9,16,12,4
4,24,10,12,3,9
4,24,11,10,10,0
4,24,12,14,9,5
4,24,13,20,6,14
4,24,14,17,14,3
4,24,15,15,5,10
4,24,16,22,19,3
4,24,17,23,7,16
4,24,18,18,9,9
4,24,19,29,13,16
4,24,20,9,6,3
4,24,21,9,5,4
4,24,22,28,1,27
4,24,23,20,13,7
4,24,24,28,19,9
4,24,25,11,6,5
4,24,26,18,6,12
4,24,27,17,12,5
4,24,28,21,3,18
4,24,29,15,15,0
4,24,30,18,6,12
4,24,31,30,18,12
4,24,32,26,13,13
4,24,33,14,18,-4
4,24,34,12,7,5
4,24,35,27,13,14
4,24,36,11,3,8
4,24,37,19,15,4
4,24,38,11,16,-5
4,24,39,22,16,6
4,24,40,20,11,9
4,24,41,34,9,25
4,24,42,15,8,7
4,24,43,29,9,20
4,24,44,21,11,10
4,24,45,6,6,0
4,24,46,14,21,-7
4,24,47,23,4,19
4,24,48,28,8,20
4,24,49,20,14,6
4,24,50,11,11,0
4,24,51,22,10,12
4,24,52,35,10,25
4,24,53,24,18,6
4,24,54,13,12,1
4,24,55,16,6,10
4,24,56,10,6,4
4,24,57,14,6,8
4,24,58,22,15,7
4,24,59,24,5,19
4,24,60,17,15,2
4,24,61,12,12,0
4,24,62,36,11,25
4,24,63,15,12,3
4,24,64,25,13,12
4,24,65,29,12,17
4,24,66,16,5,11
4,24,67,15,9,6
4,24,68,24,10,14
4,24,69,11,13,-2
4,24,70,15,7,8
4,24,71,16,9,7
4,24,72,25,6,19
4,24,73,10,17,-7
4,24,74,10,7,3
4,24,75,17,10,7
4,24,76,15,14,1
4,24,77,9,6,3
4,24,78,16,8,8
4,24,79,12,10,2
4,24,80,13,15,-2
4,24,81,22,13,9
4,24,82,20,14,6
4,24,83,19,11,8
4,24,84,20,21,-1
4,24,85,26,8,18
4,24,86,19,18,1
4,24,87,16,19,-3
4,24,88,16,11,5
4,24,89,20,12,8
4,24,90,20,7,13
4,24,91,24,12,12
4,24,92,27,15,12
4,24,93,25,16,9
4,24,94,21,8,13
4,24,95,26,12,14
4,24,96,25,5,20
4,24,97,16,7,9
4,24,98,11,6,5
4,24,99,16,13,3
4,24,100,20,11,9
4,24,101,19,4,15
4,24,102,14,4,10
4,24,103,13,15,-2
4,24,104,26,19,7
4,24,105,27,17,10
4,24,106,25,16,9
4,24,107,5,2,3
4,24,108,6,5,1
4,24,109,23,7,16
4,24,110,15,16,-1
4,24,111,14,7,7
4,24,112,16,4,12
4,24,113,11,11,0
4,24,114,22,2,20
4,24,115,24,9,15
4,24,116,11,10,1
4,24,117,20,6,14
4,24,118,31,14,17
4,24,119,13,8,5
4,24,120,32,22,10
4,24,121,20,10,10
4,24,122,25,12,13
4,24,123,13,11,2
4,24,124,15,8,7
4,24,125,19,4,15
4,24,126,29,9,20
4,24,127,17,11,6
4,24,128,17,7,10
4,24,129,11,6,5
4,24,130,21,16,5
4,24,131,16,14,2
4,24,132,23,12,11
4,24,133,43,9,34
4,24,134,21,20,1
4,24,135,17,12,5
4,24,136,19,10,9
4,24,137,17,18,-1
4,24,138,11,4,7
4,24,139,22,16,6
4,24,140,32,8,24
4,24,141,8,7,1
4,24,142,23,12,11
4,24,143,21,9,12
4,24,144,33,14,19
4,24,145,19,10,9
4,24,146,17,15,2
4,24,147,28,6,22
4,24,148,23,8,15
4,24,149,14,9,5
4,24,150,17,6,11
4,24,151,15,11,4
4,24,152,17,10,7
4,24,153,21,10,11
4,24,154,40,6,34
4,24,155,26,16,10
4,24,156,11,5,6
4,24,157,13,12,1
4,24,158,14,14,0
4,24,159,29,10,19
4,24,160,27,10,17
4,24,161,8,7,1
4,24,162,26,10,16
4,24,163,21,11,10
4,24,164,14,7,7
4,24,165,26,18,8
4,24,166,23,15,8
4,24,167,23,8,15
4,24,168,18,12,6
4,24,169,24,14,10
4,24,170,19,7,12
4,24,171,19,14,5
4,24,172,9,12,-3
4,24,173,20,17,3
4,24,174,15,9,6
4,24,175,23,15,8
4,24,176,25,14,11
4,24,177,16,4,12
4,24,178,28,11,17
4,24,179,20,7,13
4,24,180,14,4,10
4,24,181,17,10,7
4,24,182,25,15,10
4,24,183,23,10,13
4,24,184,26,10,16
4,24,185,34,18,16
4,24,186,8,16,-8
4,24,187,27,7,20
4,24,188,10,11,-1
4,24,189,5,9,-4
4,24,190,9,5,4
4,24,191,11,2,9
4,24,192,9,11,-2
4,24,193,24,13,11
4,24,194,16,13,3
4,24,195,23,13,10
4,24,196,28,16,12
4,24,197,11,7,4
4,24,198,20,10,10
4,24,199,8,6,2
4,24,200,19,18,1
4,24,201,7,3,4
4,24,202,19,2,17
4,24,203,5,3,2
4,24,204,9,5,4
4,24,205,19,4,15
4,24,206,16,14,2
4,24,207,11,5,6
4,24,208,15,6,9
4,24,209,31,17,14
4,24,210,28,16,12
4,24,211,8,8,0
4,24,212,22,13,9
4,24,213,26,8,18
4,24,214,18,10,8
4,24,215,12,8,4
4,24,216,19,8,11
4,24,217,9,13,-4
4,24,218,33,6,27
4,24,219,17,10,7
4,24,220,19,7,12
4,24,221,17,4,13
4,24,222,29,12,17
4,24,223,24,20,4
4,24,224,19,19,0
4,24,225,24,4,20
4,24,226,14,15,-1
4,24,227,4,4,0
4,24,228,38,12,26
4,24,229,18,7,11
4,24,230,25,10,15
4,24,231,15,10,5
4,24,232,21,2,19
4,24,233,29,6,23
4,24,234,17,14,3
4,24,235,8,6,2
4,24,236,29,18,11
4,24,237,16,9,7
4,24,238,12,6,6
4,24,239,29,13,16
4,24,240,18,11,7
4,24,241,30,16,14
4,24,242,20,14,6
4,24,243,34,18,16
4,24,244,15,8,7
4,24,245,9,5,4
4,24,246,13,10,3
4,24,247,23,12,11
4,24,248,15,6,9
4,24,249,22,10,12
4,24,250,11,8,3
4,24,251,23,9,14
4,24,252,27,4,23
4,24,253,9,4,5
4,24,254,14,7,7
4,24,255,32,10,22
4,24,256,21,7,14
4,24,257,4,5,-1
4,24,258,20,9,11
4,24,259,13,16,-3
4,24,260,20,16,4
4,24,261,27,11,16
4,24,262,8,6,2
4,24,263,12,14,-2
4,24,264,22,8,14
4,24,265,4,7,-3
4,24,266,17,10,7
4,24,267,21,10,11
4,24,268,24,6,18
4,24,269,24,13,11
4,24,270,12,9,3
4,24,271,34,21,13
4,24,272,22,3,19
4,24,273,26,12,14
4,24,274,20,12,8
4,24,275,23,10,13
4,24,276,18,5,13
4,24,277,28,12,16
4,24,278,18,8,10
4,24,279,13,6,7
4,24,280,14,13,1
4,24,281,16,6,10
4,24,282,23,12,11
4,24,283,18,13,5
4,24,284,33,18,15
4,24,285,6,7,-1
4,24,286,35,13,22
4,24,287,10,9,1
4,24,288,11,5,6
4,24,289,24,13,11
4,24,290,10,9,1
4,24,291,29,11,18
4,24,292,14,10,4
4,24,293,17,12,5
4,24,294,7,7,0
4,24,295,18,9,9
4,24,296,16,10,6
4,24,297,8,4,4
4,24,298,19,8,11
4,24,299,19,11,8
4,25,0,20,10,10
4,25,1,22,8,14
4,25,2,9,26,-17
4,25,3,13,12,1
4,25,4,26,8,18
4,25,5,18,12,6
4,25,6,9,10,-1
4,25,7,18,12,6
4,25,8,15,7,8
4,25,9,12,4,8
4,25,10,24,9,15
4,25,11,17,4,13
4,25,12,23,17,6
4,25,13,14,8,6
4,25,14,27,17,10
4,25,15,27,11,16
4,25,16,23,8,15
4,25,17,13,8,5
4,25,18,15,9,6
4,25,19,18,11,7
4,25,20,14,5,9
4,25,21,20,9,11
4,25,22,26,7,19
4,25,23,17,9,8
4,25,24,14,5,9
4,25,25,27,15,12
4,25,26,29,7,22
4,25,27,11,5,6
4,25,28,48,10,38
4,25,29,26,17,9
4,25,30,27,10,17
4,25,31,30,7,23
4,25,32,21,4,17
4,25,33,31,15,16
4,25,34,30,8,22
4,25,35,24,14,10
4,25,36,32,10,22
4,25,37,15,16,-1
4,25,38,19,9,10
4,25,39,14,21,-7
4,25,40,18,18,0
4,25,41,25,9,16
4,25,42,7,6,1
4,25,43,23,9,14
4,25,44,18,6,12
4,25,45,14,10,4
4,25,46,12,7,5
4,25,47,9,8,1
4,25,48,15,2,13
4,25,49,24,9,15
4,25,50,15,11,4
4,25,51,16,11,5
4,25,52,19,8,11
4,25,53,17,13,4
4,25,54,17,9,8
4,25,55,29,9,20
4,25,56,15,5,10
4,25,57,14,5,9
4,25,58,19,6,13
4,25,59,8,9,-1
4,25,60,25,9,16
4,25,61,19,10,9
4,25,62,20,7,13
4,25,63,25,5,20
4,25,64,7,6,1
4,25,65,15,4,11
4,25,66,28,2,26
4,25,67,22,6,16
4,25,68,13,7,6
4,25,69,31,8,23
4,25,70,8,12,-4
4,25,71,17,9,8
4,25,72,18,14,4
4,25,73,20,13,7
4,25,74,22,10,12
4,25,75,37,13,24
4,25,76,20,9,11
4,25,77,8,7,1
4,25,78,8,12,-4
4,25,79,11,3,8
4,25,80,14,11,3
4,25,81,12,10,2
4,25,82,14,7,7
4,25,83,12,11,1
4,25,84,10,3,7
4,25,85,20,10,10
4,25,86,14,24,-10
4,25,87,33,5,28
4,25,88,20,6,14
4,25,89,22,18,4
4,25,90,29,10,19
4,25,91,9,7,2
4,25,92,22,8,14
4,25,93,18,3,15
4,25,94,21,10,11
4,25,95,15,8,7
4,25,96,14,6,8
4,25,97,28,21,7
4,25,98,32,13,19
4,25,99,19,18,1
4,25,100,14,9,5
4,25,101,24,19,5
4,25,102,11,7,4
4,25,103,21,8,13
4,25,104,16,10,6
4,25,105,28,11,17
4,25,106,27,7,20
4,25,107,21,10,11
4,25,108,30,10,20
4,25,109,13,7,6
4,25,110,21,13,8
4,25,111,23,8,15
4,25,112,21,19,2
4,25,113,16,19,-3
4,25,114,13,21,-8
4,25,115,10,5,5
4,25,116,9,3,6
4,25,117,17,13,4
4,25,118,20,14,6
4,25,119,22,12,10
4,25,120,17,8,9
4,25,121,32,12,20
4,25,122,12,5,7
4,25,123,7,4,3
4,25,124,17,4,13
4,25,125,27,22,5
4,25,126,29,12,17
4,25,127,16,4,12
4,25,128,16,8,8
4,25,129,14,7,7
4,25,130,15,6,9
4,25,131,15,11,4
4,25,132,14,7,7
4,25,133,28,17,11
4,25,134,14,6,8
4,25,135,12,1,11
4,25,136,27,14,13
4,25,137,18,7,11
4,25,138,21,9,12
4,25,139,45,17,28
4,25,140,20,7,13
4,25,141,18,10,8
4,25,142,18,7,11
4,25,143,17,8,9
4,25,144,22,4,18
4,25,145,19,13,6
4,25,146,8,1,7
4,25,147,2,3,-1
4,25,148,17,6,11
4,25,149,24,10,14
4,25,150,14,12,2
4,25,151,17,6,11
4,25,152,14,9,5
4,25,153,19,10,9
4,25,154,25,5,20
4,25,155,8,6,2
4,25,156,22,13,9
4,25,157,17,10,7
4,25,158,22,6,16
4,25,159,17,5,12
4,25,160,17,7,10
4,25,161,24,8,16
4,25,162,20,10,10
4,25,163,16,3,13
4,25,164,14,11,3
4,25,165,7,5,2
4,25,166,26,7,19
4,25,167,14,16,-2
4,25,168,27,8,19
4,25,169,30,24,6
4,25,170,8,4,4
4,25,171,16,7,9
4,25,172,40,27,13
4,25,173,16,10,6
4,25,174,22,18,4
4,25,175,14,12,2
4,25,176,13,3,10
4,25,177,30,19,11
4,25,178,12,3,9
4,25,179,17,4,13
4,25,180,17,13,4
4,25,181,18,8,10
4,25,182,26,6,20
4,25,183,15,7,8
4,25,184,18,8,10
4,25,185,27,12,15
4,25,186,10,9,1
4,25,187,15,12,3
4,25,188,38,7,31
4,25,189,31,11,20
4,25,190,20,7,13
4,25,191,35,7,28
4,25,192,9,3,6
4,25,193,20,19,1
4,25,194,19,6,13
4,25,195,22,11,11
4,25,196,27,15,12
4,25,197,9,17,-8
4,25,198,21,14,7
4,25,199,27,13,14
4,25,200,18,11,7
4,25,201,38,14,24
4,25,202,12,2,10
4,25,203,20,4,16
4,25,204,17,10,7
4,25,205,33,8,25
4,25,206,21,8,13
4,25,207,22,14,8
4,25,208,28,17,11
4,25,209,7,9,-2
4,25,210,6,6,0
4,25,211,10,14,-4
4,25,212,15,14,1
4,25,213,22,16,6
4,25,214,20,16,4
4,25,215,18,10,8
4,25,216,21,10,11
4,25,217,23,8,15
4,25,218,12,3,9
4,25,219,30,6,24
4,25,220,17,11,6
4,25,221,15,9,6
4,25,222,20,9,11
4,25,223,9,4,5
4,25,224,14,15,-1
4,25,225,11,2,9
4,25,226,10,23,-13
4,25,227,22,2,20
4,25,228,17,12,5
4,25,229,25,6,19
4,25,230,28,7,21
4,25,231,17,17,0
4,25,232,16,16,0
4,25,233,11,3,8
4,25,234,20,10,10
4,25,235,12,8,4
4,25,236,18,20,-2
4,25,237,32,14,18
4,25,238,23,11,12
4,25,239,30,11,19
4,25,240,23,8,15
4,25,241,20,19,1
4,25,242,10,9,1
4,25,243,25,16,9
4,25,244,16,8,8
4,25,245,27,14,13
4,25,246,20,8,12
4,25,247,17,6,11
4,25,248,38,8,30
4,25,249,15,5,10
4,25,250,21,10,11
4,25,251,24,14,10
4,25,252,29,26,3
4,25,253,22,6,16
4,25,254,32,7,25
4,25,255,12,11,1
4,25,256,23,5,18
4,25,257,22,10,12
4,25,258,9,6,3
4,25,259,18,1,17
4,25,260,16,13,3
4,25,261,27,11,16
4,25,262,22,29,-7
4,25,263,38,7,31
4,25,264,14,11,3
4,25,265,17,12,5
4,25,266,33,16,17
4,25,267,21,4,17
4,25,268,26,8,18
4,25,269,17,13,4
4,25,270,20,6,14
4,25,271,6,4,2
4,25,272,11,7,4
4,25,273,28,22,6
4,25,274,25,19,6
4,25,275,20,8,12
4,25,276,18,2,16
4,25,277,7,5,2
4,25,278,14,9,5
4,25,279,10,15,-5
4,25,280,5,9,-4
4,25,281,19,1,18
4,25,282,22,12,10
4,25,283,13,9,4
4,25,284,24,6,18
4,25,285,23,9,14
4,25,286,13,3,10
4,25,287,13,4,9
4,25,288,14,11,3
4,25,289,12,5,7
4,25,290,16,10,6
4,25,291,17,7,10
4,25,292,14,9,5
4,25,293,3,8,-5
4,25,294,29,8,21
4,25,295,15,11,4
4,25,296,22,12,10
4,25,297,15,7,8
4,25,298,25,6,19
4,25,299,16,19,-3
4,26,0,21,11,10
4,26,1,23,8,15
4,26,2,26,12,14
4,26,3,14,7,7
4,26,4,27,12,15
4,26,5,30,20,10
4,26,6,16,10,6
4,26,7,17,5,12
4,26,8,20,10,10
4,26,9,19,8,11
4,26,10,27,8,19
4,26,11,29,12,17
4,26,12,19,16,3
4,26,13,13,12,1
4,26,14,17,14,3
4,26,15,15,1,14
4,26,16,19,11,8
4,26,17,20,13,7
4,26,18,17,15,2
4,26,19,34,9,25
4,26,20,24,12,12
4,26,21,30,11,19
4,26,22,15,16,-1
4,26,23,20,12,8
4,26,24,14,3,11
4,26,25,13,7,6
4,26,26,22,7,15
4,26,27,14,7,7
4,26,28,8,6,2
4,26,29,3,8,-5
4,26,30,15,2,13
4,26,31,9,9,0
4,26,32,9,6,3
4,26,33,15,10,5
4,26,34,21,13,8
4,26,35,17,11,6
4,26,36,23,12,11
4,26,37,33,8,25
4,26,38,18,13,5
4,26,39,23,4,19
4,26,40,25,15,10
4,26,41,19,13,6
4,26,42,22,5,17
4,26,43,17,13,4
4,26,44,10,4,6
4,26,45,9,5,4
4,26,46,16,16,0
4,26,47,34,8,26
4,26,48,16,13,3
4,26,49,26,12,14
4,26,50,40,8,32
4,26,51,18,18,0
4,26,52,23,10,13
4,26,53,32,10,22
4,26,54,15,10,5
4,26,55,27,7,20
4,26,56,33,17,16
4,26,57,23,8,15
4,26,58,23,9,14
4,26,59,18,9,9
4,26,60,24,14,10
4,26,61,8,3,5
4,26,62,21,10,11
4,26,63,20,9,11
4,26,64,20,8,12
4,26,65,25,13,12
4,26,66,11,16,-5
4,26,67,17,9,8
4,26,68,24,9,15
4,26,69,17,12,5
4,26,70,14,4,10
4,26,71,27,9,18
4,26,72,31,14,17
4,26,73,14,10,4
4,26,74,18,14,4
4,26,75,18,7,11
4,26,76,7,5,2
4,26,77,14,7,7
4,26,78,21,19,2
4,26,79,12,10,2
4,26,80,21,4,17
4,26,81,19,11,8
4,26,82,14,13,1
4,26,83,15,8,7
4,26,84,16,6,10
4,26,85,20,17,3
4,26,86,13,15,-2
4,26,87,34,11,23
4,26,88,20,12,8
4,26,89,24,4,20
4,26,90,16,8,8
4,26,91,28,20,8
4,26,92,22,5,17
4,26,93,22,11,11
4,26,94,11,8,3
4,26,95,19,9,10
4,26,96,19,14,5
4,26,97,16,12,4
4,26,98,18,13,5
4,26,99,14,13,1
4,26,100,28,11,17
4,26,101,27,19,8
4,26,102,26,4,22
4,26,103,32,9,23
4,26,104,24,11,13
4,26,105,7,13,-6
4,26,106,15,5,10
4,26,107,30,15,15
4,26,108,22,7,15
4,26,109,21,21,0
4,26,110,22,22,0
4,26,111,12,15,-3
4,26,112,12,12,0
4,26,113,17,13,4
4,26,114,25,19,6
4,26,115,13,10,3
4,26,116,26,4,22
4,26,117,23,5,18
4,26,118,14,10,4
4,26,119,15,12,3
4,26,120,23,7,16
4,26,121,24,5,19
4,26,122,9,7,2
4,26,123,28,6,22
4,26,124,12,10,2
4,26,125,21,8,13
4,26,126,13,11,2
4,26,127,14,13,1
4,26,128,9,5,4
4,26,129,18,6,12
4,26,130,20,8,12
4,26,131,25,7,18
4,26,132,18,7,11
4,26,133,22,13,9
4,26,134,20,7,13
4,26,135,20,13,7
4,26,136,38,10,28
4,26,137,19,15,4
4,26,138,8,0,8
4,26,139,17,8,9
4,26,140,15,10,5
4,26,141,28,11,17
4,26,142,22,10,12
4,26,143,22,5,17
4,26,144,25,5,20
4,26,145,13,13,0
4,26,146,14,19,-5
4,26,147,17,17,0
4,26,148,13,11,2
4,26,149,12,15,-3
4,26,150,17,10,7
4,26,151,22,10,12
4,26,152,27,27,0
4,26,153,20,13,7
4,26,154,8,8,0
4,26,155,16,6,10
4,26,156,28,8,20
4,26,157,20,16,4
4,26,158,23,7,16
4,26,159,12,14,-2
4,26,160,25,11,14
4,26,161,8,7,1
4,26,162,24,10,14
4,26,163,19,10,9
4,26,164,21,9,12
4,26,165,18,13,5
4,26,166,25,14,11
4,26,167,36,20,16
4,26,168,12,0,12
4,26,169,18,11,7
4,26,170,9,4,5
4,26,171,17,7,10
4,26,172,21,12,9
4,26,173,22,11,11
4,26,174,33,4,29
4,26,175,25,7,18
4,26,176,9,2,7
4,26,177,11,7,4
4,26,178,40,22,18
4,26,179,25,5,20
4,26,180,18,10,8
4,26,181,15,6,9
4,26,182,12,11,1
4,26,183,26,2,24
4,26,184,25,6,19
4,26,185,20,3,17
4,26,186,18,12,6
4,26,187,26,19,7
4,26,188,14,5,9
4,26,189,16,10,6
4,26,190,17,6,11
4,26,191,8,2,6
4,26,192,13,8,5
4,26,193,20,13,7
4,26,194,20,8,12
4,26,195,13,16,-3
4,26,196,27,14,13
4,26,197,6,3,3
4,26,198,22,5,17
4,26,199,14,8,6
4,26,200,15,9,6
4,26,201,16,5,11
4,26,202,27,7,20
4,26,203,20,11,9
4,26,204,29,4,25
4,26,205,26,14,12
4,26,206,17,9,8
4,26,207,18,13,5
4,26,208,9,6,3
4,26,209,42,12,30
4,26,210,28,22,6
4,26,211,19,10,9
4,26,212,22,11,11
4,26,213,9,9,0
4,26,214,12,1,11
4,26,215,14,6,8
4,26,216,12,3,9
4,26,217,11,3,8
4,26,218,19,10,9
4,26,219,23,5,18
4,26,220,27,11,16
4,26,221,18,12,6
4,26,222,12,8,4
4,26,223,12,18,-6
4,26,224,10,17,-7
4,26,225,17,12,5
4,26,226,21,6,15
4,26,227,16,10,6
4,26,228,26,10,16
4,26,229,10,5,5
4,26,230,17,11,6
4,26,231,31,5,26
4,26,232,36,14,22
4,26,233,11,3,8
4,26,234,29,8,21
4,26,235,21,8,13
4,26,236,19,5,14
4,26,237,10,5,5
4,26,238,23,8,15
4,26,239,17,9,8
4,26,240,20,14,6
4,26,241,11,10,1
4,26,242,26,17,9
4,26,243,15,6,9
4,26,244,21,7,14
4,26,245,22,9,13
4,26,246,26,14,12
4,26,247,26,14,12
4,26,248,21,15,6
4,26,249,16,9,7
4,26,250,9,1,8
4,26,251,17,13,4
4,26,252,12,11,1
4,26,253,23,10,13
4,26,254,27,9,18
4,26,255,15,7,8
4,26,256,8,11,-3
4,26,257,25,6,19
4,26,258,6,7,-1
4,26,259,24,2,22
4,26,260,30,16,14
4,26,261,21,8,13
4,26,262,15,7,8
4,26,263,16,7,9
4,26,264,12,12,0
4,26,265,10,11,-1
4,26,266,25,8,17
4,26,267,13,2,11
4,26,268,12,6,6
4,26,269,29,13,16
4,26,270,13,11,2
4,26,271,17,18,-1
4,26,272,30,11,19
4,26,273,16,7,9
4,26,274,21,18,3
4,26,275,14,8,6
4,26,276,19,7,12
4,26,277,12,2,10
4,26,278,25,10,15
4,26,279,28,12,16
4,26,280,22,6,16
4,26,281,23,12,11
4,26,282,29,4,25
4,26,283,26,6,20
4,26,284,16,3,13
4,26,285,36,20,16
4,26,286,14,12,2
4,26,287,19,13,6
4,26,288,23,3,20
4,26,289,17,10,7
4,26,290,20,8,12
4,26,291,18,14,4
4,26,292,17,10,7
4,26,293,22,8,14
4,26,294,19,4,15
4,26,295,17,20,-3
4,26,296,5,10,-5
4,26,297,22,10,12
4,26,298,12,2,10
4,26,299,15,9,6
4,27,0,24,12,12
4,27,1,34,6,28
4,27,2,5,9,-4
4,27,3,15,15,0
4,27,4,19,13,6
4,27,5,19,11,8
4,27,6,12,11,1
4,27,7,16,8,8
4,27,8,22,7,15
4,27,9,14,4,10
4,27,10,8,4,4
4,27,11,15,10,5
4,27,12,22,16,6
4,27,13,10,9,1
4,27,14,22,11,11
4,27,15,22,28,-6
4,27,16,12,4,8
4,27,17,31,13,18
4,27,18,18,12,6
4,27,19,17,12,5
4,27,20,21,4,17
4,27,21,13,11,2
4,27,22,28,14,14
4,27,23,32,12,20
4,27,24,3,2,1
4,27,25,12,15,-3
4,27,26,14,4,10
4,27,27,22,15,7
4,27,28,46,20,26
4,27,29,12,5,7
4,27,30,14,5,9
4,27,31,28,14,14
4,27,32,20,5,15
4,27,33,30,16,14
4,27,34,34,11,23
4,27,35,19,14,5
4,27,36,33,9,24
4,27,37,15,7,8
4,27,38,24,6,18
4,27,39,2,1,1
4,27,40,18,15,3
4,27,41,25,23,2
4,27,42,31,9,22
4,27,43,8,9,-1
4,27,44,26,7,19
4,27,45,10,6,4
4,27,46,8,4,4
4,27,47,22,9,13
4,27,48,24,11,13
4,27,49,13,5,8
4,27,50,25,11,14
4,27,51,18,10,8
4,27,52,10,3,7
4,27,53,28,11,17
4,27,54,11,11,0
4,27,55,7,9,-2
4,27,56,18,9,9
4,27,57,18,4,14
4,27,58,22,8,14
4,27,59,18,10,8
4,27,60,39,20,19
4,27,61,34,6,28
4,27,62,11,11,0
4,27,63,19,13,6
4,27,64,19,3,16
4,27,65,12,11,1
4,27,66,11,15,-4
4,27,67,29,10,19
4,27,68,13,2,11
4,27,69,19,17,2
4,27,70,9,5,4
4,27,71,18,16,2
4,27,72,32,13,19
4,27,73,18,4,14
4,27,74,29,14,15
4,27,75,25,15,10
4,27,76,9,7,2
4,27,77,18,2,16
4,27,78,12,6,6
4,27,79,11,6,5
4,27,80,16,8,8
4,27,81,33,11,22
4,27,82,28,8,20
4,27,83,9,6,3
4,27,84,23,11,12
4,27,85,18,9,9
4,27,86,18,7,11
4,27,87,23,6,17
4,27,88,17,1,16
4,27,89,21,5,16
4,27,90,16,9,7
4,27,91,24,12,12
4,27,92,31,11,20
4,27,93,30,13,17
4,27,94,13,12,1
4,27,95,12,4,8
4,27,96,23,13,10
4,27,97,21,5,16
4,27,98,23,7,16
4,27,99,5,6,-1
4,27,100,21,7,14
4,27,101,24,15,9
4,27,102,17,14,3
4,27,103,19,7,12
4,27,104,19,1,18
4,27,105,21,2,19
4,27,106,28,17,11
4,27,107,18,9,9
4,27,108,24,19,5
4,27,109,11,13,-2
4,27,110,28,9,19
4,27,111,8,8,0
4,27,112,28,9,19
4,27,113,15,8,7
4,27,114,21,10,11
4,27,115,27,6,21
4,27,116,27,13,14
4,27,117,18,10,8
4,27,118,21,11,10
4,27,119,5,8,-3
4,27,120,25,16,9
4,27,121,21,7,14
4,27,122,26,7,19
4,27,123,21,10,11
4,27,124,27,13,14
4,27,125,22,14,8
4,27,126,5,8,-3
4,27,127,4,2,2
4,27,128,16,9,7
4,27,129,26,14,12
4,27,130,20,3,17
4,27,131,25,9,16
4,27,132,37,9,28
4,27,133,19,1,18
4,27,134,38,7,31
4,27,135,5,6,-1
4,27,136,20,17,3
4,27,137,25,9,16
4,27,138,15,10,5
4,27,139,16,10,6
4,27,140,9,2,7
4,27,141,20,12,8
4,27,142,28,9,19
4,27,143,19,13,6
4,27,144,12,6,6
4,27,145,22,9,13
4,27,146,21,11,10
4,27,147,21,18,3
4,27,148,20,3,17
4,27,149,11,1,10
4,27,150,31,7,24
4,27,151,9,6,3
4,27,152,22,20,2
4,27,153,31,14,17
4,27,154,19,11,8
4,27,155,26,25,1
4,27,156,25,12,13
4,27,157,16,9,7
4,27,158,29,12,17
4,27,159,18,6,12
4,27,160,26,15,11
4,27,161,14,16,-2
4,27,162,15,7,8
4,27,163,21,7,14
4,27,164,29,10,19
4,27,165,14,4,10
4,27,166,12,16,-4
4,27,167,19,8,11
4,27,168,16,10,6
4,27,169,21,3,18
4,27,170,14,5,9
4,27,171,11,8,3
4,27,172,11,11,0
4,27,173,7,4,3
4,27,174,17,11,6
4,27,175,22,6,16
4,27,176,20,9,11
4,27,177,14,7,7
4,27,178,13,7,6
4,27,179,22,12,10
4,27,180,15,4,11
4,27,181,22,11,11
4,27,182,18,13,5
4,27,183,21,7,14
4,27,184,33,15,18
4,27,185,21,14,7
4,27,186,27,11,16
4,27,187,18,5,13
4,27,188,26,6,20
4,27,189,22,10,12
4,27,190,29,6,23
4,27,191,18,21,-3
4,27,192,15,14,1
4,27,193,25,13,12
4,27,194,12,7,5
4,27,195,25,10,15
4,27,196,12,5,7
4,27,197,20,9,11
4,27,198,18,6,12
4,27,199,11,6,5
4,27,200,11,5,6
4,27,201,25,10,15
4,27,202,22,5,17
4,27,203,32,5,27
4,27,204,18,4,14
4,27,205,13,5,8
4,27,206,17,5,12
4,27,207,21,20,1
4,27,208,22,14,8
4,27,209,24,12,12
4,27,210,17,9,8
4,27,211,28,17,11
4,27,212,18,6,12
4,27,213,17,6,11
4,27,214,31,6,25
4,27,215,25,14,11
4,27,216,14,4,10
4,27,217,30,12,18
4,27,218,6,7,-1
4,27,219,15,6,9
4,27,220,13,12,1
4,27,221,11,6,5
4,27,222,19,5,14
4,27,223,12,10,2
4,27,224,31,10,21
4,27,225,15,9,6
4,27,226,11,11,0
4,27,227,8,7,1
4,27,228,20,10,10
4,27,229,41,16,25
4,27,230,40,12,28
4,27,231,18,8,10
4,27,232,16,20,-4
4,27,233,26,13,13
4,27,234,10,9,1
4,27,235,15,6,9
4,27,236,19,1,18
4,27,237,19,3,16
4,27,238,18,10,8
4,27,239,17,10,7
4,27,240,33,13,20
4,27,241,23,12,11
4,27,242,21,14,7
4,27,243,32,8,24
4,27,244,32,8,24
4,27,245,8,4,4
4,27,246,10,3,7
4,27,247,14,8,6
4,27,248,30,13,17
4,27,249,21,9,12
4,27,250,21,7,14
4,27,251,13,4,9
4,27,252,22,10,12
4,27,253,23,9,14
4,27,254,14,6,8
4,27,255,14,8,6
4,27,256,23,8,15
4,27,257,24,9,15
4,27,258,27,18,9
4,27,259,26,7,19
4,27,260,15,6,9
4,27,261,10,10,0
4,27,262,37,20,17
4,27,263,18,11,7
4,27,264,7,5,2
4,27,265,12,2,10
4,27,266,26,15,11
4,27,267,14,18,-4
4,27,268,22,7,15
4,27,269,20,14,6
4,27,270,6,9,-3
4,27,271,28,8,20
4,27,272,16,14,2
4,27,273,11,5,6
4,27,274,11,5,6
4,27,275,17,15,2
4,27,276,26,5,21
4,27,277,12,9,3
4,27,278,23,9,14
4,27,279,18,12,6
4,27,280,16,6,10
4,27,281,24,8,16
4,27,282,25,13,12
4,27,283,22,17,5
4,27,284,33,9,24
4,27,285,39,14,25
4,27,286,21,14,7
4,27,287,19,12,7
4,27,288,15,9,6
4,27,289,21,18,3
4,27,290,14,4,10
4,27,291,19,6,13
4,27,292,14,0,14
4,27,293,25,10,15
4,27,294,19,14,5
4,27,295,18,11,7
4,27,296,19,11,8
4,27,297,21,9,12
4,27,298,13,12,1
4,27,299,18,2,16
4,28,0,20,10,10
4,28,1,14,9,5
4,28,2,26,6,20
4,28,3,19,8,11
4,28,4,3,14,-11
4,28,5,15,9,6
4,28,6,20,13,7
4,28,7,29,19,10
4,28,8,17,14,3
4,28,9,33,17,16
4,28,10,14,15,-1
4,28,11,25,13,12
4,28,12,21,6,15
4,28,13,19,2,17
4,28,14,25,19,6
4,28,15,16,9,7
4,28,16,14,12,2
4,28,17,20,7,13
4,28,18,14,12,2
4,28,19,23,10,13
4,28,20,23,7,16
4,28,21,21,8,13
4,28,22,35,10,25
4,28,23,22,11,11
4,28,24,25,10,15
4,28,25,6,6,0
4,28,26,13,6,7
4,28,27,14,9,5
4,28,28,17,10,7
4,28,29,18,5,13
4,28,30,22,10,12
4,28,31,12,7,5
4,28,32,15,3,12
4,28,33,26,13,13
4,28,34,10,11,-1
4,28,35,12,3,9
4,28,36,12,3,9
4,28,37,2,6,-4
4,28,38,25,7,18
4,28,39,22,12,10
4,28,40,18,7,11
4,28,41,49,21,28
4,28,42,31,13,18
4,28,43,24,12,12
4,28,44,16,11,5
4,28,45,28,9,19
4,28,46,15,10,5
4,28,47,20,1,19
4,28,48,27,8,19
4,28,49,18,7,11
4,28,50,11,7,4
4,28,51,25,8,17
4,28,52,24,13,11
4,28,53,13,7,6
4,28,54,27,9,18
4,28,55,45,21,24
4,28,56,22,7,15
4,28,57,12,7,5
4,28,58,25,11,14
4,28,59,27,9,18
4,28,60,9,4,5
4,28,61,15,9,6
4,28,62,21,8,13
4,28,63,30,18,12
4,28,64,19,15,4
4,28,65,26,11,15
4,28,66,19,7,12
4,28,67,23,10,13
4,28,68,34,12,22
4,28,69,25,9,16
4,28,70,8,3,5
4,28,71,15,3,12
4,28,72,16,5,11
4,28,73,19,8,11
4,28,74,28,16,12
4,28,75,10,15,-5
4,28,76,27,3,24
4,28,77,12,5,7
4,28,78,13,11,2
4,28,79,29,21,8
4,28,80,18,13,5
4,28,81,11,10,1
4,28,82,22,11,11
4,28,83,21,4,17
4,28,84,28,9,19
4,28,85,18,16,2
4,28,86,11,3,8
4,28,87,27,8,19
4,28,88,24,5,19
4,28,89,16,9,7
4,28,90,27,15,12
4,28,91,21,11,10
4,28,92,22,15,7
4,28,93,21,15,6
4,28,94,14,9,5
4,28,95,12,5,7
4,28,96,27,14,13
4,28,97,31,3,28
4,28,98,26,5,21
4,28,99,21,10,11
4,28,100,14,13,1
4,28,101,25,14,11
4,28,102,22,4,18
4,28,103,25,11,14
4,28,104,23,13,10
4,28,105,21,10,11
4,28,106,23,12,11
4,28,107,16,4,12
4,28,108,17,8,9
4,28,109,22,20,2
4,28,110,29,15,14
4,28,111,39,8,31
4,28,112,22,7,15
4,28,113,18,7,11
4,28,114,16,10,6
4,28,115,10,4,6
4,28,116,21,4,17
4,28,117,19,8,11
4,28,118,32,12,20
4,28,119,25,3,22
4,28,120,22,13,9
4,28,121,26,7,19
4,28,122,11,12,-1
4,28,123,16,7,9
4,28,124,17,13,4
4,28,125,13,11,2
4,28,126,15,10,5
4,28,127,24,11,13
4,28,128,30,13,17
4,28,129,16,15,1
4,28,130,29,10,19
4,28,131,18,9,9
4,28,132,37,14,23
4,28,133,14,8,6
4,28,134,15,10,5
4,28,135,23,8,15
4,28,136,36,11,25
4,28,137,17,13,4
4,28,138,20,7,13
4,28,139,27,15,12
4,28,140,29,10,19
4,28,141,9,4,5
4,28,142,32,17,15
4,28,143,17,5,12
4,28,144,28,10,18
4,28,145,20,1,19
4,28,146,15,4,11
4,28,147,26,12,14
4,28,148,18,9,9
4,28,149,30,16,14
4,28,150,18,2,16
4,28,151,4,5,-1
4,28,152,25,5,20
4,28,153,10,14,-4
4,28,154,32,8,24
4,28,155,25,8,17
4,28,156,31,18,13
4,28,157,13,7,6
4,28,158,19,6,13
4,28,159,12,6,6
4,28,160,38,9,29
4,28,161,19,3,16
4,28,162,28,9,19
4,28,163,7,4,3
4,28,164,18,13,5
4,28,165,17,8,9
4,28,166,20,5,15
4,28,167,33,5,28
4,28,168,15,7,8
4,28,169,15,8,7
4,28,170,17,8,9
4,28,171,15,15,0
4,28,172,14,10,4
4,28,173,5,12,-7
4,28,174,45,9,36
4,28,175,26,5,21
4,28,176,9,6,3
4,28,177,14,6,8
4,28,178,13,6,7
4,28,179,14,5,9
4,28,180,12,15,-3
4,28,181,21,3,18
4,28,182,8,7,1
4,28,183,35,17,18
4,28,184,23,8,15
4,28,185,20,8,12
4,28,186,21,8,13
4,28,187,21,13,8
4,28,188,28,13,15
4,28,189,15,9,6
4,28,190,16,5,11
4,28,191,17,11,6
4,28,192,21,10,11
4,28,193,11,8,3
4,28,194,23,7,16
4,28,195,14,11,3
4,28,196,27,11,16
4,28,197,14,12,2
4,28,198,26,9,17
4,28,199,39,13,26
4,28,200,10,11,-1
4,28,201,12,7,5
4,28,202,8,2,6
4,28,203,17,8,9
4,28,204,14,5,9
4,28,205,31,8,23
4,28,206,8,6,2
4,28,207,11,5,6
4,28,208,12,4,8
4,28,209,26,6,20
4,28,210,14,8,6
4,28,211,22,7,15
4,28,212,13,6,7
4,28,213,18,10,8
4,28,214,7,4,3
4,28,215,19,6,13
4,28,216,18,4,14
4,28,217,13,15,-2
4,28,218,17,10,7
4,28,219,23,15,8
4,28,220,26,11,15
4,28,221,17,10,7
4,28,222,14,3,11
4,28,223,11,2,9
4,28,224,23,12,11
4,28,225,10,10,0
4,28,226,13,14,-1
4,28,227,16,11,5
4,28,228,19,7,12
4,28,229,27,6,21
4,28,230,16,9,7
4,28,231,22,8,14
4,28,232,20,9,11
4,28,233,31,9,22
4,28,234,21,5,16
4,28,235,19,18,1
4,28,236,20,6,14
4,28,237,22,4,18
4,28,238,16,11,5
4,28,239,21,14,7
4,28,240,22,6,16
4,28,241,20,12,8
4,28,242,18,11,7
4,28,243,23,13,10
4,28,244,32,15,17
4,28,245,22,4,18
4,28,246,20,15,5
4,28,247,18,9,9
4,28,248,16,10,6
4,28,249,15,6,9
4,28,250,21,5,16
4,28,251,17,6,11
4,28,252,14,11,3
4,28,253,18,4,14
4,28,254,19,9,10
4,28,255,10,9,1
4,28,256,20,9,11
4,28,257,24,15,9
4,28,258,33,12,21
4,28,259,12,11,1
4,28,260,22,12,10
4,28,261,12,3,9
4,28,262,18,8,10
4,28,263,8,3,5
4,28,264,8,10,-2
4,28,265,29,6,23
4,28,266,10,8,2
4,28,267,21,3,18
4,28,268,34,15,19
4,28,269,23,8,15
4,28,270,21,10,11
4,28,271,29,20,9
4,28,272,15,8,7
4,28,273,20,5,15
4,28,274,24,12,12
4,28,275,21,5,16
4,28,276,20,8,12
4,28,277,6,17,-11
4,28,278,27,5,22
4,28,279,14,5,9
4,28,280,20,9,11
4,28,281,28,6,22
4,28,282,28,11,17
4,28,283,34,21,13
4,28,284,10,10,0
4,28,285,10,3,7
4,28,286,12,12,0
4,28,287,23,9,14
4,28,288,19,18,1
4,28,289,31,13,18
4,28,290,29,7,22
4,28,291,6,4,2
4,28,292,16,11,5
4,28,293,11,2,9
4,28,294,22,10,12
4,28,295,18,11,7
4,28,296,27,13,14
4,28,297,15,5,10
4,28,298,15,7,8
4,28,299,12,8,4
4,29,0,30,6,24
4,29,1,16,4,12
4,29,2,13,12,1
4,29,3,19,17,2
4,29,4,18,7,11
4,29,5,18,3,15
4,29,6,22,10,12
4,29,7,35,14,21
4,29,8,10,6,4
4,29,9,19,13,6
4,29,10,13,3,10
4,29,11,14,9,5
4,29,12,26,5,21
4,29,13,21,15,6
4,29,14,26,7,19
4,29,15,24,12,12
4,29,16,24,10,14
4,29,17,30,16,14
4,29,18,19,5,14
4,29,19,30,8,22
4,29,20,27,10,17
4,29,21,12,5,7
4,29,22,7,7,0
4,29,23,22,10,12
4,29,24,25,7,18
4,29,25,13,9,4
4,29,26,29,7,22
4,29,27,9,11,-2
4,29,28,15,6,9
4,29,29,18,13,5
4,29,30,17,9,8
4,29,31,14,3,11
4,29,32,19,5,14
4,29,33,10,8,2
4,29,34,14,8,6
4,29,35,15,8,7
4,29,36,15,9,6
4,29,37,21,19,2
4,29,38,30,11,19
4,29,39,19,13,6
4,29,40,15,7,8
4,29,41,19,7,12
4,29,42,33,6,27
4,29,43,21,17,4
4,29,44,19,15,4
4,29,45,10,7,3
4,29,46,4,10,-6
4,29,47,17,12,5
4,29,48,25,10,15
4,29,49,8,2,6
4,29,50,12,4,8
4,29,51,17,6,11
4,29,52,31,13,18
4,29,53,17,2,15
4,29,54,15,9,6
4,29,55,26,14,12
4,29,56,31,20,11
4,29,57,16,8,8
4,29,58,12,18,-6
4,29,59,31,8,23
4,29,60,37,8,29
4,29,61,27,12,15
4,29,62,13,3,10
4,29,63,17,15,2
4,29,64,27,8,19
4,29,65,11,4,7
4,29,66,19,16,3
4,29,67,19,4,15
4,29,68,23,11,12
4,29,69,20,12,8
4,29,70,25,4,21
4,29,71,28,10,18
4,29,72,24,12,12
4,29,73,21,13,8
4,29,74,18,10,8
4,29,75,14,7,7
4,29,76,12,8,4
4,29,77,13,14,-1
4,29,78,16,7,9
4,29,79,31,10,21
4,29,80,14,8,6
4,29,81,24,9,15
4,29,82,8,1,7
4,29,83,10,8,2
4,29,84,12,11,1
4,29,85,27,8,19
4,29,86,20,10,10
4,29,87,12,5,7
4,29,88,57,20,37
4,29,89,23,10,13
4,29,90,20,18,2
4,29,91,14,5,9
4,29,92,13,7,6
4,29,93,34,8,26
4,29,94,15,6,9
4,29,95,17,1,16
4,29,96,10,4,6
4,29,97,23,7,16
4,29,98,24,11,13
4,29,99,12,1,11
4,29,100,14,7,7
4,29,101,23,8,15
4,29,102,32,6,26
4,29,103,24,16,8
4,29,104,12,11,1
4,29,105,23,11,12
4,29,106,33,12,21
4,29,107,23,11,12
4,29,108,19,7,12
4,29,109,21,2,19
4,29,110,26,5,21
4,29,111,9,3,6
4,29,112,16,9,7
4,29,113,15,8,7
4,29,114,23,10,13
4,29,115,18,13,5
4,29,116,16,8,8
4,29,117,18,5,13
4,29,118,23,9,14
4,29,119,30,7,23
4,29,120,11,5,6
4,29,121,24,6,18
4,29,122,20,11,9
4,29,123,25,8,17
4,29,124,21,16,5
4,29,125,31,10,21
4,29,126,19,9,10
4,29,127,7,5,2
4,29,128,6,3,3
4,29,129,26,11,15
4,29,130,19,3,16
4,29,131,11,9,2
4,29,132,25,15,10
4,29,133,29,9,20
4,29,134,27,15,12
4,29,135,16,9,7
4,29,136,24,11,13
4,29,137,22,12,10
4,29,138,22,6,16
4,29,139,30,9,21
4,29,140,8,4,4
4,29,141,12,10,2
4,29,142,15,11,4
4,29,143,19,15,4
4,29,144,37,16,21
4,29,145,23,7,16
4,29,146,28,16,12
4,29,147,14,14,0
4,29,148,25,16,9
4,29,149,16,8,8
4,29,150,36,12,24
4,29,151,24,6,18
4,29,152,26,8,18
4,29,153,17,8,9
4,29,154,35,11,24
4,29,155,22,4,18
4,29,156,7,5,2
4,29,157,19,14,5
4,29,158,15,8,7
4,29,159,22,5,17
4,29,160,30,13,17
4,29,161,33,6,27
4,29,162,17,9,8
4,29,163,11,9,2
4,29,164,14,7,7
4,29,165,33,17,16
4,29,166,13,5,8
4,29,167,5,6,-1
4,29,168,26,2,24
4,29,169,11,5,6
4,29,170,15,12,3
4,29,171,15,20,-5
4,29,172,18,6,12
4,29,173,10,10,0
4,29,174,18,8,10
4,29,175,34,7,27
4,29,176,24,14,10
4,29,177,9,13,-4
4,29,178,7,5,2
4,29,179,17,9,8
4,29,180,25,4,21
4,29,181,29,11,18
4,29,182,14,2,12
4,29,183,25,26,-1
4,29,184,12,8,4
4,29,185,15,10,5
4,29,186,14,5,9
4,29,187,26,12,14
4,29,188,20,6,14
4,29,189,7,6,1
4,29,190,10,16,-6
4,29,191,24,14,10
4,29,192,25,7,18
4,29,193,33,12,21
4,29,194,19,6,13
4,29,195,16,3,13
4,29,196,30,7,23
4,29,197,19,8,11
4,29,198,7,5,2
4,29,199,28,12,16
4,29,200,12,11,1
4,29,201,27,10,17
4,29,202,13,10,3
4,29,203,15,9,6
4,29,204,19,10,9
4,29,205,15,8,7
4,29,206,16,10,6
4,29,207,17,17,0
4,29,208,10,9,1
4,29,209,8,8,0
4,29,210,17,7,10
4,29,211,28,16,12
4,29,212,34,15,19
4,29,213,15,7,8
4,29,214,23,10,13
4,29,215,14,12,2
4,29,216,3,7,-4
4,29,217,9,4,5
4,29,218,10,10,0
4,29,219,24,10,14
4,29,220,19,8,11
4,29,221,13,4,9
4,29,222,27,13,14
4,29,223,14,7,7
4,29,224,11,15,-4
4,29,225,27,9,18
4,29,226,21,4,17
4,29,227,20,5,15
4,29,228,13,6,7
4,29,229,20,5,15
4,29,230,18,10,8
4,29,231,20,13,7
4,29,232,18,17,1
4,29,233,13,16,-3
4,29,234,16,9,7
4,29,235,21,14,7
4,29,236,16,4,12
4,29,237,17,13,4
4,29,238,31,11,20
4,29,239,19,7,12
4,29,240,16,16,0
4,29,241,12,11,1
4,29,242,17,9,8
4,29,243,20,9,11
4,29,244,37,18,19
4,29,245,26,8,18
4,29,246,30,15,15
4,29,247,16,11,5
4,29,248,24,6,18
4,29,249,14,3,11
4,29,250,27,11,16
4,29,251,16,9,7
4,29,252,10,2,8
4,29,253,13,6,7
4,29,254,16,17,-1
4,29,255,35,4,31
4,29,256,14,6,8
4,29,257,21,5,16
4,29,258,23,10,13
4,29,259,10,6,4
4,29,260,26,18,8
4,29,261,19,13,6
4,29,262,14,10,4
4,29,263,11,10,1
4,29,264,22,17,5
4,29,265,14,11,3
4,29,266,16,13,3
4,29,267,11,2,9
4,29,268,21,7,14
4,29,269,12,4,8
4,29,270,10,12,-2
4,29,271,30,17,13
4,29,272,22,4,18
4,29,273,11,8,3
4,29,274,18,7,11
4,29,275,18,8,10
4,29,276,34,12,22
4,29,277,20,8,12
4,29,278,7,11,-4
4,29,279,27,14,13
4,29,280,32,11,21
4,29,281,21,9,12
4,29,282,12,13,-1
4,29,283,13,3,10
4,29,284,17,8,9
4,29,285,18,11,7
4,29,286,29,17,12
4,29,287,9,5,4
4,29,288,25,9,16
4,29,289,16,15,1
4,29,290,24,7,17
4,29,291,20,7,13
4,29,292,23,8,15
4,29,293,29,12,17
4,29,294,18,9,9
4,29,295,27,8,19
4,29,296,20,14,6
4,29,297,27,11,16
4,29,298,23,15,8
4,29,299,25,8,17
4,30,0,8,7,1
4,30,1,17,5,12
4,30,2,25,11,14
4,30,3,29,15,14
4,30,4,14,8,6
4,30,5,23,12,11
4,30,6,24,19,5
4,30,7,26,6,20
4,30,8,16,10,6
4,30,9,24,5,19
4,30,10,14,13,1
4,30,11,13,2,11
4,30,12,16,7,9
4,30,13,29,2,27
4,30,14,15,11,4
4,30,15,23,8,15
4,30,16,30,18,12
4,30,17,30,11,19
4,30,18,8,14,-6
4,30,19,23,4,19
4,30,20,14,4,10
4,30,21,14,9,5
4,30,22,19,15,4
4,30,23,25,12,13
4,30,24,14,8,6
4,30,25,22,8,14
4,30,26,22,5,17
4,30,27,12,5,7
4,30,28,22,17,5
4,30,29,12,7,5
4,30,30,23,13,10
4,30,31,21,8,13
4,30,32,21,6,15
4,30,33,36,18,18
4,30,34,9,5,4
4,30,35,21,7,14
4,30,36,18,5,13
4,30,37,6,7,-1
4,30,38,16,11,5
4,30,39,15,10,5
4,30,40,23,15,8
4,30,41,26,9,17
4,30,42,20,7,13
4,30,43,11,9,2
4,30,44,15,8,7
4,30,45,25,5,20
4,30,46,13,13,0
4,30,47,35,16,19
4,30,48,40,9,31
4,30,49,28,5,23
4,30,50,21,6,15
4,30,51,15,3,12
4,30,52,10,12,-2
4,30,53,31,18,13
4,30,54,32,16,16
4,30,55,26,10,16
4,30,56,12,8,4
4,30,57,26,10,16
4,30,58,23,12,11
4,30,59,17,8,9
4,30,60,6,5,1
4,30,61,11,0,11
4,30,62,20,6,14
4,30,63,16,15,1
4,30,64,19,7,12
4,30,65,14,14,0
4,30,66,12,8,4
4,30,67,18,13,5
4,30,68,25,16,9
4,30,69,22,10,12
4,30,70,26,10,16
4,30,71,28,6,22
4,30,72,15,10,5
4,30,73,21,4,17
4,30,74,22,8,14
4,30,75,21,9,12
4,30,76,11,8,3
4,30,77,13,8,5
4,30,78,8,10,-2
4,30,79,8,5,3
4,30,80,15,3,12
4,30,81,9,4,5
4,30,82,24,5,19
4,30,83,12,10,2
4,30,84,7,12,-5
4,30,85,29,25,4
4,30,86,28,6,22
4,30,87,20,6,14
4,30,88,24,7,17
4,30,89,15,6,9
4,30,90,18,12,6
4,30,91,26,10,16
4,30,92,14,5,9
4,30,93,29,3,26
4,30,94,26,5,21
4,30,95,19,9,10
4,30,96,12,10,2
4,30,97,18,10,8
4,30,98,20,11,9
4,30,99,27,9,18
4,30,100,15,4,11
4,30,101,9,5,4
4,30,102,23,6,17
4,30,103,12,11,1
4,30,104,17,10,7
4,30,105,26,10,16
4,30,106,25,12,13
4,30,107,22,4,18
4,30,108,13,5,8
4,30,109,21,5,16
4,30,110,20,9,11
4,30,111,21,16,5
4,30,112,33,10,23
4,30,113,36,5,31
4,30,114,17,9,8
4,30,115,27,15,12
4,30,116,20,0,20
4,30,117,24,11,13
4,30,118,15,9,6
4,30,119,37,17,20
4,30,120,39,17,22
4,30,121,15,12,3
4,30,122,14,5,9
4,30,123,39,9,30
4,30,124,21,12,9
4,30,125,17,7,10
4,30,126,18,12,6
4,30,127,21,16,5
4,30,128,13,7,6
4,30,129,20,12,8
4,30,130,30,20,10
4,30,131,25,8,17
4,30,132,18,9,9
4,30,133,18,6,12
4,30,134,18,4,14
4,30,135,8,9,-1
4,30,136,19,7,12
4,30,137,23,9,14
4,30,138,18,20,-2
4,30,139,26,12,14
4,30,140,20,10,10
4,30,141,12,10,2
4,30,142,14,11,3
4,30,143,21,2,19
4,30,144,13,3,10
4,30,145,12,7,5
4,30,146,22,3,19
4,30,147,17,4,13
4,30,148,18,3,15
4,30,149,28,11,17
4,30,150,36,11,25
4,30,151,9,9,0
4,30,152,20,4,16
4,30,153,25,1,24
4,30,154,15,2,13
4,30,155,29,18,11
4,30,156,9,9,0
4,30,157,18,10,8
4,30,158,12,5,7
4,30,159,13,9,4
4,30,160,14,13,1
4,30,161,20,8,12
4,30,162,11,9,2
4,30,163,32,16,16
4,30,164,8,0,8
4,30,165,38,11,27
4,30,166,14,4,10
4,30,167,26,7,19
4,30,168,12,1,11
4,30,169,14,7,7
4,30,170,15,1,14
4,30,171,9,9,0
4,30,172,13,15,-2
4,30,173,32,21,11
4,30,174,10,10,0
4,30,175,30,10,20
4,30,176,13,24,-11
4,30,177,26,5,21
4,30,178,24,16,8
4,30,179,23,16,7
4,30,180,10,4,6
4,30,181,33,12,21
4,30,182,15,3,12
4,30,183,22,6,16
4,30,184,18,9,9
4,30,185,18,8,10
4,30,186,29,5,24
4,30,187,19,12,7
4,30,188,7,2,5
4,30,189,22,8,14
4,30,190,28,13,15
4,30,191,16,12,4
4,30,192,30,4,26
4,30,193,25,9,16
4,30,194,23,5,18
4,30,195,26,10,16
4,30,196,7,8,-1
4,30,197,3,8,-5
4,30,198,34,11,23
4,30,199,28,11,17
4,30,200,27,12,15
4,30,201,22,7,15
4,30,202,11,6,5
4,30,203,12,5,7
4,30,204,6,8,-2
4,30,205,13,4,9
4,30,206,27,6,21
4,30,207,8,11,-3
4,30,208,19,7,12
4,30,209,18,12,6
4,30,210,5,5,0
4,30,211,23,7,16
4,30,212,17,12,5
4,30,213,22,6,16
4,30,214,28,9,19
4,30,215,17,11,6
4,30,216,21,10,11
4,30,217,23,24,-1
4,30,218,22,6,16
4,30,219,17,16,1
4,30,220,26,3,23
4,30,221,9,12,-3
4,30,222,23,6,17
4,30,223,29,13,16
4,30,224,11,8,3
4,30,225,16,10,6
4,30,226,9,0,9
4,30,227,28,7,21
4,30,228,34,11,23
4,30,229,14,7,7
4,30,230,14,12,2
4,30,231,19,3,16
4,30,232,27,7,20
4,30,233,11,9,2
4,30,234,11,12,-1
4,30,235,19,8,11
4,30,236,13,7,6
4,30,237,44,11,33
4,30,238,29,10,19
4,30,239,21,5,16
4,30,240,27,6,21
4,30,241,27,11,16
4,30,242,11,6,5
4,30,243,23,11,12
4,30,244,23,7,16
4,30,245,19,9,10
4,30,246,15,9,6
4,30,247,27,9,18
4,30,248,22,16,6
4,30,249,25,10,15
4,30,250,27,20,7
4,30,251,19,7,12
4,30,252,17,14,3
4,30,253,18,13,5
4,30,254,14,3,11
4,30,255,18,7,11
4,30,256,14,12,2
4,30,257,16,4,12
4,30,258,19,4,15
4,30,259,24,10,14
4,30,260,16,5,11
4,30,261,6,15,-9
4,30,262,26,11,15
4,30,263,18,5,13
4,30,264,27,10,17
4,30,265,16,6,10
4,30,266,31,3,28
4,30,267,11,7,4
4,30,268,26,10,16
4,30,269,30,8,22
4,30,270,29,14,15
4,30,271,17,1,16
4,30,272,28,11,17
4,30,273,25,8,17
4,30,274,18,7,11
4,30,275,19,12,7
4,30,276,14,6,8
4,30,277,26,6,20
4,30,278,14,7,7
4,30,279,10,5,5
4,30,280,24,15,9
4,30,281,23,5,18
4,30,282,22,10,12
4,30,283,13,11,2
4,30,284,17,21,-4
4,30,285,7,4,3
4,30,286,16,5,11
4,30,287,8,2,6
4,30,288,13,3,10
4,30,289,24,6,18
4,30,290,15,7,8
4,30,291,17,4,13
4,30,292,21,10,11
4,30,293,20,9,11
4,30,294,24,5,19
4,30,295,25,7,18
4,30,296,25,7,18
4,30,297,27,10,17
4,30,298,24,6,18
4,30,299,19,11,8
5,1,0,6,12,-6
5,1,1,14,16,-2
5,1,2,3,10,-7
5,1,3,5,7,-2
5,1,4,10,13,-3
5,1,5,4,7,-3
5,1,6,9,9,0
5,1,7,9,9,0
5,1,8,17,17,0
5,1,9,2,4,-2
5,1,10,3,13,-10
5,1,11,1,4,-3
5,1,12,3,9,-6
5,1,13,5,7,-2
5,1,14,5,13,-8
5,1,15,8,10,-2
5,1,16,6,8,-2
5,1,17,3,5,-2
5,1,18,8,5,3
5,1,19,2,5,-3
5,1,20,15,12,3
5,1,21,4,10,-6
5,1,22,6,10,-4
5,1,23,6,6,0
5,1,24,5,9,-4
5,1,25,1,4,-3
5,1,26,11,9,2
5,1,27,8,10,-2
5,1,28,19,13,6
5,1,29,7,4,3
5,1,30,10,13,-3
5,1,31,4,0,4
5,1,32,11,8,3
5,1,33,12,17,-5
5,1,34,3,5,-2
5,1,35,10,13,-3
5,1,36,10,1,9
5,1,37,16,9,7
5,1,38,18,9,9
5,1,39,11,9,2
5,1,40,9,10,-1
5,1,41,2,3,-1
5,1,42,11,9,2
5,1,43,15,8,7
5,1,44,7,3,4
5,1,45,10,17,-7
5,1,46,6,8,-2
5,1,47,8,10,-2
5,1,48,14,6,8
5,1,49,8,4,4
5,1,50,6,10,-4
5,1,51,11,7,4
5,1,52,13,9,4
5,1,53,5,6,-1
5,1,54,16,13,3
5,1,55,6,26,-20
5,1,56,15,14,1
5,1,57,4,11,-7
5,1,58,0,7,-7
5,1,59,7,12,-5
5,1,60,9,10,-1
5,1,61,3,1,2
5,1,62,8,10,-2
5,1,63,9,8,1
5,1,64,13,10,3
5,1,65,10,12,-2
5,1,66,10,11,-1
5,1,67,5,5,0
5,1,68,12,23,-11
5,1,69,8,6,2
5,1,70,8,16,-8
5,1,71,12,13,-1
5,1,72,9,12,-3
5,1,73,7,16,-9
5,1,74,9,7,2
5,1,75,8,10,-2
5,1,76,11,8,3
5,1,77,8,9,-1
5,1,78,3,10,-7
5,1,79,12,13,-1
5,1,80,4,7,-3
5,1,81,10,6,4
5,1,82,9,8,1
5,1,83,10,5,5
5,1,84,7,6,1
5,1,85,12,16,-4
5,1,86,8,7,1
5,1,87,7,8,-1
5,1,88,5,8,-3
5,1,89,14,11,3
5,1,90,8,17,-9
5,1,91,17,13,4
5,1,92,16,12,4
5,1,93,10,9,1
5,1,94,10,6,4
5,1,95,12,19,-7
5,1,96,4,13,-9
5,1,97,12,6,6
5,1,98,9,16,-7
5,1,99,22,16,6
5,1,100,7,10,-3
5,1,101,5,4,1
5,1,102,10,8,2
5,1,103,10,9,1
5,1,104,3,7,-4
5,1,105,11,8,3
5,1,106,2,3,-1
5,1,107,11,11,0
5,1,108,10,10,0
5,1,109,9,14,-5
5,1,110,7,16,-9
5,1,111,9,12,-3
5,1,112,10,7,3
5,1,113,17,13,4
5,1,114,13,13,0
5,1,115,6,6,0
5,1,116,8,5,3
5,1,117,4,4,0
5,1,118,6,7,-1
5,1,119,3,7,-4
5,1,120,15,9,6
5,1,121,17,11,6
5,1,122,8,13,-5
5,1,123,9,10,-1
5,1,124,4,15,-11
5,1,125,6,11,-5
5,1,126,10,13,-3
5,1,127,2,4,-2
5,1,128,10,15,-5
5,1,129,5,6,-1
5,1,130,4,6,-2
5,1,131,7,10,-3
5,1,132,4,9,-5
5,1,133,5,11,-6
5,1,134,11,6,5
5,1,135,9,14,-5
5,1,136,14,8,6
5,1,137,6,7,-1
5,1,138,5,16,-11
5,1,139,18,23,-5
5,1,140,9,5,4
5,1,141,9,9,0
5,1,142,17,8,9
5,1,143,6,10,-4
5,1,144,12,13,-1
5,1,145,17,8,9
5,1,146,8,19,-11
5,1,147,5,16,-11
5,1,148,1,6,-5
5,1,149,8,11,-3
5,1,150,9,6,3
5,1,151,5,5,0
5,1,152,6,6,0
5,1,153,10,11,-1
5,1,154,10,12,-2
5,1,155,5,5,0
5,1,156,4,2,2
5,1,157,8,8,0
5,1,158,13,9,4
5,1,159,10,9,1
5,1,160,4,4,0
5,1,161,0,8,-8
5,1,162,12,12,0
5,1,163,20,19,1
5,1,164,5,9,-4
5,1,165,18,8,10
5,1,166,14,17,-3
5,1,167,4,7,-3
5,1,168,11,12,-1
5,1,169,11,8,3
5,1,170,7,9,-2
5,1,171,2,6,-4
5,1,172,15,4,11
5,1,173,6,6,0
5,1,174,6,11,-5
5,1,175,10,10,0
5,1,176,3,3,0
5,1,177,5,13,-8
5,1,178,6,10,-4
5,1,179,7,17,-10
5,1,180,1,2,-1
5,1,181,16,11,5
5,1,182,4,6,-2
5,1,183,12,11,1
5,1,184,10,8,2
5,1,185,5,3,2
5,1,186,11,16,-5
5,1,187,6,12,-6
5,1,188,11,17,-6
5,1,189,2,3,-1
5,1,190,8,14,-6
5,1,191,1,11,-10
5,1,192,11,5,6
5,1,193,2,1,1
5,1,194,5,5,0
5,1,195,10,6,4
5,1,196,1,2,-1
5,1,197,4,3,1
5,1,198,7,5,2
5,1,199,7,11,-4
5,1,200,7,13,-6
5,1,201,13,10,3
5,1,202,8,6,2
5,1,203,11,14,-3
5,1,204,14,5,9
5,1,205,20,9,11
5,1,206,6,7,-1
5,1,207,11,4,7
5,1,208,10,6,4
5,1,209,8,12,-4
5,1,210,5,11,-6
5,1,211,11,18,-7
5,1,212,15,21,-6
5,1,213,8,13,-5
5,1,214,22,16,6
5,1,215,5,13,-8
5,1,216,8,14,-6
5,1,217,5,6,-1
5,1,218,16,13,3
5,1,219,9,26,-17
5,1,220,5,5,0
5,1,221,14,8,6
5,1,222,11,7,4
5,1,223,9,13,-4
5,1,224,5,7,-2
5,1,225,4,6,-2
5,1,226,7,12,-5
5,1,227,6,7,-1
5,1,228,16,17,-1
5,1,229,6,12,-6
5,1,230,2,4,-2
5,1,231,6,6,0
5,1,232,5,24,-19
5,1,233,6,10,-4
5,1,234,2,4,-2
5,1,235,10,9,1
5,1,236,5,6,-1
5,1,237,10,8,2
5,1,238,9,14,-5
5,1,239,5,11,-6
5,1,240,2,3,-1
5,1,241,16,19,-3
5,1,242,1,5,-4
5,1,243,14,12,2
5,1,244,17,17,0
5,1,245,26,14,12
5,1,246,4,7,-3
5,1,247,3,13,-10
5,1,248,8,8,0
5,1,249,1,9,-8
5,1,250,7,11,-4
5,1,251,1,12,-11
5,1,252,4,2,2
5,1,253,9,10,-1
5,1,254,9,13,-4
5,1,255,2,6,-4
5,1,256,8,4,4
5,1,257,11,13,-2
5,1,258,11,11,0
5,1,259,11,14,-3
5,1,260,4,2,2
5,1,261,14,15,-1
5,1,262,12,23,-11
5,1,263,7,6,1
5,1,264,10,13,-3
5,1,265,9,13,-4
5,1,266,8,6,2
5,1,267,8,9,-1
5,1,268,13,9,4
5,1,269,7,8,-1
5,1,270,13,9,4
5,1,271,8,14,-6
5,1,272,12,13,-1
5,1,273,13,14,-1
5,1,274,4,12,-8
5,1,275,6,16,-10
5,1,276,8,11,-3
5,1,277,10,24,-14
5,1,278,1,0,1
5,1,279,14,16,-2
5,1,280,12,9,3
5,1,281,8,11,-3
5,1,282,10,6,4
5,1,283,3,7,-4
5,1,284,7,18,-11
5,1,285,11,17,-6
5,1,286,2,7,-5
5,1,287,5,4,1
5,1,288,2,8,-6
5,1,289,3,2,1
5,1,290,4,8,-4
5,1,291,2,8,-6
5,1,292,4,4,0
5,1,293,5,2,3
5,1,294,7,6,1
5,1,295,7,11,-4
5,1,296,19,7,12
5,1,297,8,8,0
5,1,298,11,13,-2
5,1,299,2,11,-9
5,2,0,6,7,-1
5,2,1,5,4,1
5,2,2,11,9,2
5,2,3,17,12,5
5,2,4,7,13,-6
5,2,5,5,13,-8
5,2,6,15,9,6
5,2,7,2,8,-6
5,2,8,10,11,-1
5,2,9,0,12,-12
5,2,10,9,14,-5
5,2,11,16,13,3
5,2,12,7,7,0
5,2,13,5,8,-3
5,2,14,6,16,-10
5,2,15,17,14,3
5,2,16,19,12,7
5,2,17,11,5,6
5,2,18,9,15,-6
5,2,19,4,3,1
5,2,20,4,1,3
5,2,21,20,11,9
5,2,22,8,9,-1
5,2,23,6,11,-5
5,2,24,10,17,-7
5,2,25,17,14,3
5,2,26,9,6,3
5,2,27,10,23,-13
5,2,28,15,11,4
5,2,29,9,14,-5
5,2,30,5,11,-6
5,2,31,9,6,3
5,2,32,16,16,0
5,2,33,3,1,2
5,2,34,12,14,-2
5,2,35,2,4,-2
5,2,36,10,6,4
5,2,37,4,10,-6
5,2,38,16,23,-7
5,2,39,11,15,-4
5,2,40,9,12,-3
5,2,41,8,18,-10
5,2,42,8,17,-9
5,2,43,3,4,-1
5,2,44,6,6,0
5,2,45,4,7,-3
5,2,46,8,8,0
5,2,47,4,17,-13
5,2,48,9,6,3
5,2,49,8,14,-6
5,2,50,0,5,-5
5,2,51,11,12,-1
5,2,52,11,9,2
5,2,53,13,9,4
5,2,54,2,10,-8
5,2,55,16,12,4
5,2,56,15,7,8
5,2,57,5,11,-6
5,2,58,10,11,-1
5,2,59,2,10,-8
5,2,60,2,8,-6
5,2,61,5,10,-5
5,2,62,15,17,-2
5,2,63,5,7,-2
5,2,64,5,9,-4
5,2,65,6,17,-11
5,2,66,8,5,3
5,2,67,7,14,-7
5,2,68,5,11,-6
5,2,69,9,18,-9
5,2,70,18,22,-4
5,2,71,10,2,8
5,2,72,2,5,-3
5,2,73,8,5,3
5,2,74,12,16,-4
5,2,75,6,16,-10
5,2,76,8,10,-2
5,2,77,8,14,-6
5,2,78,8,20,-12
5,2,79,6,8,-2
5,2,80,4,8,-4
5,2,81,13,18,-5
5,2,82,10,21,-11
5,2,83,6,5,1
5,2,84,12,10,2
5,2,85,5,4,1
5,2,86,7,9,-2
5,2,87,16,15,1
5,2,88,3,10,-7
5,2,89,8,9,-1
5,2,90,7,7,0
5,2,91,6,9,-3
5,2,92,10,15,-5
5,2,93,12,8,4
5,2,94,17,10,7
5,2,95,10,18,-8
5,2,96,10,11,-1
5,2,97,7,10,-3
5,2,98,22,18,4
5,2,99,8,8,0
5,2,100,11,11,0
5,2,101,14,10,4
5,2,102,8,5,3
5,2,103,3,8,-5
5,2,104,5,0,5
5,2,105,7,13,-6
5,2,106,9,14,-5
5,2,107,13,15,-2
5,2,108,17,10,7
5,2,109,13,7,6
5,2,110,7,10,-3
5,2,111,8,14,-6
5,2,112,14,12,2
5,2,113,4,6,-2
5,2,114,11,9,2
5,2,115,4,9,-5
5,2,116,7,13,-6
5,2,117,10,8,2
5,2,118,3,4,-1
5,2,119,10,11,-1
5,2,120,7,12,-5
5,2,121,23,22,1
5,2,122,11,14,-3
5,2,123,6,9,-3
5,2,124,10,18,-8
5,2,125,8,22,-14
5,2,126,14,17,-3
5,2,127,2,4,-2
5,2,128,29,16,13
5,2,129,13,14,-1
5,2,130,5,4,1
5,2,131,7,11,-4
5,2,132,7,8,-1
5,2,133,9,26,-17
5,2,134,23,10,13
5,2,135,6,14,-8
5,2,136,15,9,6
5,2,137,5,20,-15
5,2,138,16,23,-7
5,2,139,17,4,13
5,2,140,11,11,0
5,2,141,13,21,-8
5,2,142,12,11,1
5,2,143,18,16,2
5,2,144,8,19,-11
5,2,145,13,10,3
5,2,146,9,12,-3
5,2,147,3,6,-3
5,2,148,22,29,-7
5,2,149,3,9,-6
5,2,150,4,9,-5
5,2,151,10,10,0
5,2,152,14,23,-9
5,2,153,5,9,-4
5,2,154,5,22,-17
5,2,155,14,20,-6
5,2,156,14,12,2
5,2,157,9,17,-8
5,2,158,9,8,1
5,2,159,7,17,-10
5,2,160,16,12,4
5,2,161,7,20,-13
5,2,162,12,13,-1
5,2,163,10,5,5
5,2,164,11,12,-1
5,2,165,9,12,-3
5,2,166,11,20,-9
5,2,167,8,25,-17
5,2,168,9,8,1
5,2,169,15,3,12
5,2,170,11,14,-3
5,2,171,12,15,-3
5,2,172,24,11,13
5,2,173,3,6,-3
5,2,174,10,20,-10
5,2,175,13,6,7
5,2,176,21,5,16
5,2,177,6,7,-1
5,2,178,11,11,0
5,2,179,5,10,-5
5,2,180,10,20,-10
5,2,181,9,8,1
5,2,182,10,20,-10
5,2,183,13,11,2
5,2,184,10,16,-6
5,2,185,8,9,-1
5,2,186,9,15,-6
5,2,187,24,13,11
5,2,188,1,3,-2
5,2,189,6,14,-8
5,2,190,17,9,8
5,2,191,13,12,1
5,2,192,10,11,-1
5,2,193,14,27,-13
5,2,194,8,12,-4
5,2,195,9,17,-8
5,2,196,10,18,-8
5,2,197,23,18,5
5,2,198,10,13,-3
5,2,199,7,15,-8
5,2,200,9,11,-2
5,2,201,11,12,-1
5,2,202,4,6,-2
5,2,203,2,5,-3
5,2,204,5,25,-20
5,2,205,5,3,2
5,2,206,6,8,-2
5,2,207,19,16,3
5,2,208,10,4,6
5,2,209,14,9,5
5,2,210,12,18,-6
5,2,211,9,5,4
5,2,212,4,11,-7
5,2,213,13,15,-2
5,2,214,7,1,6
5,2,215,3,15,-12
5,2,216,15,14,1
5,2,217,13,11,2
5,2,218,13,14,-1
5,2,219,8,19,-11
5,2,220,5,2,3
5,2,221,4,11,-7
5,2,222,6,21,-15
5,2,223,13,13,0
5,2,224,31,5,26
5,2,225,6,6,0
5,2,226,9,14,-5
5,2,227,9,3,6
5,2,228,6,13,-7
5,2,229,23,12,11
5,2,230,12,7,5
5,2,231,7,8,-1
5,2,232,5,11,-6
5,2,233,4,17,-13
5,2,234,10,24,-14
5,2,235,17,9,8
5,2,236,4,13,-9
5,2,237,8,5,3
5,2,238,7,10,-3
5,2,239,11,5,6
5,2,240,6,28,-22
5,2,241,9,8,1
5,2,242,5,4,1
5,2,243,11,12,-1
5,2,244,8,12,-4
5,2,245,3,12,-9
5,2,246,5,8,-3
5,2,247,3,9,-6
5,2,248,10,17,-7
5,2,249,13,43,-30
5,2,250,6,14,-8
5,2,251,10,8,2
5,2,252,5,18,-13
5,2,253,7,12,-5
5,2,254,5,11,-6
5,2,255,12,14,-2
5,2,256,4,7,-3
5,2,257,13,10,3
5,2,258,10,16,-6
5,2,259,7,13,-6
5,2,260,6,8,-2
5,2,261,7,12,-5
5,2,262,8,21,-13
5,2,263,12,21,-9
5,2,264,12,10,2
5,2,265,14,6,8
5,2,266,6,4,2
5,2,267,0,7,-7
5,2,268,1,1,0
5,2,269,8,6,2
5,2,270,14,12,2
5,2,271,9,8,1
5,2,272,3,11,-8
5,2,273,4,16,-12
5,2,274,4,7,-3
5,2,275,9,12,-3
5,2,276,14,12,2
5,2,277,17,14,3
5,2,278,4,11,-7
5,2,279,22,16,6
5,2,280,12,17,-5
5,2,281,15,19,-4
5,2,282,11,16,-5
5,2,283,5,4,1
5,2,284,4,18,-14
5,2,285,12,10,2
5,2,286,19,17,2
5,2,287,5,10,-5
5,2,288,6,10,-4
5,2,289,7,5,2
5,2,290,15,15,0
5,2,291,8,10,-2
5,2,292,17,22,-5
5,2,293,5,10,-5
5,2,294,2,4,-2
5,2,295,5,10,-5
5,2,296,8,6,2
5,2,297,5,11,-6
5,2,298,4,5,-1
5,2,299,7,17,-10
5,3,0,6,12,-6
5,3,1,14,18,-4
5,3,2,5,11,-6
5,3,3,8,11,-3
5,3,4,9,13,-4
5,3,5,8,14,-6
5,3,6,6,14,-8
5,3,7,12,10,2
5,3,8,6,11,-5
5,3,9,11,9,2
5,3,10,2,5,-3
5,3,11,7,9,-2
5,3,12,18,10,8
5,3,13,8,18,-10
5,3,14,2,6,-4
5,3,15,10,27,-17
5,3,16,19,15,4
5,3,17,13,14,-1
5,3,18,9,5,4
5,3,19,8,13,-5
5,3,20,12,20,-8
5,3,21,19,13,6
5,3,22,11,23,-12
5,3,23,16,12,4
5,3,24,14,27,-13
5,3,25,3,14,-11
5,3,26,12,12,0
5,3,27,10,7,3
5,3,28,13,9,4
5,3,29,15,29,-14
5,3,30,17,13,4
5,3,31,12,15,-3
5,3,32,10,9,1
5,3,33,6,12,-6
5,3,34,13,20,-7
5,3,35,9,7,2
5,3,36,11,25,-14
5,3,37,10,5,5
5,3,38,14,23,-9
5,3,39,15,18,-3
5,3,40,11,17,-6
5,3,41,11,9,2
5,3,42,5,9,-4
5,3,43,5,3,2
5,3,44,4,12,-8
5,3,45,13,11,2
5,3,46,10,10,0
5,3,47,7,12,-5
5,3,48,11,18,-7
5,3,49,5,3,2
5,3,50,17,19,-2
5,3,51,11,11,0
5,3,52,9,17,-8
5,3,53,8,7,1
5,3,54,8,16,-8
5,3,55,15,17,-2
5,3,56,10,5,5
5,3,57,12,10,2
5,3,58,12,9,3
5,3,59,3,7,-4
5,3,60,12,3,9
5,3,61,9,5,4
5,3,62,14,10,4
5,3,63,10,17,-7
5,3,64,7,5,2
5,3,65,2,14,-12
5,3,66,6,12,-6
5,3,67,16,23,-7
5,3,68,7,8,-1
5,3,69,11,2,9
5,3,70,6,7,-1
5,3,71,7,5,2
5,3,72,3,6,-3
5,3,73,6,9,-3
5,3,74,6,7,-1
5,3,75,11,12,-1
5,3,76,20,12,8
5,3,77,17,12,5
5,3,78,8,10,-2
5,3,79,9,13,-4
5,3,80,32,26,6
5,3,81,27,9,18
5,3,82,9,6,3
5,3,83,11,12,-1
5,3,84,4,5,-1
5,3,85,15,21,-6
5,3,86,10,8,2
5,3,87,4,9,-5
5,3,88,16,19,-3
5,3,89,7,8,-1
5,3,90,5,18,-13
5,3,91,8,15,-7
5,3,92,19,10,9
5,3,93,16,12,4
5,3,94,6,2,4
5,3,95,14,23,-9
5,3,96,4,18,-14
5,3,97,7,5,2
5,3,98,7,20,-13
5,3,99,12,11,1
5,3,100,15,17,-2
5,3,101,21,16,5
5,3,102,9,11,-2
5,3,103,10,10,0
5,3,104,10,18,-8
5,3,105,11,10,1
5,3,106,8,13,-5
5,3,107,16,14,2
5,3,108,11,16,-5
5,3,109,4,15,-11
5,3,110,6,3,3
5,3,111,6,11,-5
5,3,112,11,6,5
5,3,113,23,20,3
5,3,114,12,11,1
5,3,115,16,23,-7
5,3,116,16,25,-9
5,3,117,3,13,-10
5,3,118,19,18,1
5,3,119,15,12,3
5,3,120,10,4,6
5,3,121,20,20,0
5,3,122,9,10,-1
5,3,123,12,14,-2
5,3,124,7,5,2
5,3,125,13,15,-2
5,3,126,10,14,-4
5,3,127,5,16,-11
5,3,128,12,9,3
5,3,129,6,14,-8
5,3,130,7,4,3
5,3,131,9,17,-8
5,3,132,13,11,2
5,3,133,16,11,5
5,3,134,4,16,-12
5,3,135,1,11,-10
5,3,136,4,18,-14
5,3,137,8,12,-4
5,3,138,5,9,-4
5,3,139,8,5,3
5,3,140,10,14,-4
5,3,141,8,14,-6
5,3,142,13,7,6
5,3,143,10,6,4
5,3,144,5,9,-4
5,3,145,9,5,4
5,3,146,4,7,-3
5,3,147,15,28,-13
5,3,148,7,9,-2
5,3,149,11,7,4
5,3,150,7,8,-1
5,3,151,7,6,1
5,3,152,12,17,-5
5,3,153,9,7,2
5,3,154,16,16,0
5,3,155,4,5,-1
5,3,156,8,15,-7
5,3,157,14,17,-3
5,3,158,6,4,2
5,3,159,11,24,-13
5,3,160,13,13,0
5,3,161,10,18,-8
5,3,162,8,10,-2
5,3,163,6,8,-2
5,3,164,19,10,9
5,3,165,9,13,-4
5,3,166,14,15,-1
5,3,167,22,21,1
5,3,168,4,8,-4
5,3,169,11,11,0
5,3,170,7,3,4
5,3,171,5,15,-10
5,3,172,9,13,-4
5,3,173,11,26,-15
5,3,174,8,19,-11
5,3,175,15,15,0
5,3,176,14,12,2
5,3,177,12,15,-3
5,3,178,8,22,-14
5,3,179,17,5,12
5,3,180,10,8,2
5,3,181,6,8,-2
5,3,182,24,17,7
5,3,183,3,7,-4
5,3,184,4,5,-1
5,3,185,9,17,-8
5,3,186,12,6,6
5,3,187,17,8,9
5,3,188,9,8,1
5,3,189,7,19,-12
5,3,190,5,7,-2
5,3,191,5,9,-4
5,3,192,22,14,8
5,3,193,9,10,-1
5,3,194,14,9,5
5,3,195,9,26,-17
5,3,196,13,12,1
5,3,197,14,13,1
5,3,198,15,21,-6
5,3,199,11,6,5
5,3,200,18,7,11
5,3,201,15,15,0
5,3,202,20,17,3
5,3,203,8,6,2
5,3,204,24,12,12
5,3,205,9,8,1
5,3,206,13,21,-8
5,3,207,11,23,-12
5,3,208,11,14,-3
5,3,209,11,19,-8
5,3,210,7,12,-5
5,3,211,11,11,0
5,3,212,17,13,4
5,3,213,11,15,-4
5,3,214,1,8,-7
5,3,215,7,5,2
5,3,216,8,3,5
5,3,217,13,4,9
5,3,218,12,8,4
5,3,219,11,14,-3
5,3,220,22,14,8
5,3,221,9,13,-4
5,3,222,16,17,-1
5,3,223,7,3,4
5,3,224,13,15,-2
5,3,225,6,4,2
5,3,226,8,18,-10
5,3,227,20,20,0
5,3,228,8,12,-4
5,3,229,10,12,-2
5,3,230,13,20,-7
5,3,231,6,8,-2
5,3,232,12,16,-4
5,3,233,12,9,3
5,3,234,12,16,-4
5,3,235,3,4,-1
5,3,236,9,9,0
5,3,237,15,14,1
5,3,238,9,14,-5
5,3,239,28,19,9
5,3,240,15,16,-1
5,3,241,10,12,-2
5,3,242,11,13,-2
5,3,243,7,2,5
5,3,244,10,15,-5
5,3,245,8,5,3
5,3,246,7,6,1
5,3,247,21,13,8
5,3,248,11,16,-5
5,3,249,5,9,-4
5,3,250,5,3,2
5,3,251,7,14,-7
5,3,252,15,13,2
5,3,253,8,3,5
5,3,254,10,7,3
5,3,255,13,16,-3
5,3,256,7,4,3
5,3,257,19,14,5
5,3,258,1,15,-14
5,3,259,7,15,-8
5,3,260,12,12,0
5,3,261,9,9,0
5,3,262,10,6,4
5,3,263,8,12,-4
5,3,264,9,3,6
5,3,265,8,8,0
5,3,266,10,18,-8
5,3,267,18,16,2
5,3,268,10,6,4
5,3,269,9,14,-5
5,3,270,4,5,-1
5,3,271,22,14,8
5,3,272,9,12,-3
5,3,273,17,21,-4
5,3,274,5,12,-7
5,3,275,9,21,-12
5,3,276,11,17,-6
5,3,277,18,27,-9
5,3,278,4,10,-6
5,3,279,3,14,-11
5,3,280,4,7,-3
5,3,281,13,19,-6
5,3,282,7,7,0
5,3,283,15,15,0
5,3,284,11,14,-3
5,3,285,9,3,6
5,3,286,13,15,-2
5,3,287,23,22,1
5,3,288,9,16,-7
5,3,289,8,9,-1
5,3,290,9,15,-6
5,3,291,6,18,-12
5,3,292,8,13,-5
5,3,293,6,1,5
5,3,294,12,19,-7
5,3,295,11,26,-15
5,3,296,11,12,-1
5,3,297,12,14,-2
5,3,298,11,15,-4
5,3,299,1,6,-5
5,4,0,17,13,4
5,4,1,12,5,7
5,4,2,10,19,-9
5,4,3,15,10,5
5,4,4,6,24,-18
5,4,5,8,15,-7
5,4,6,12,11,1
5,4,7,10,18,-8
5,4,8,8,14,-6
5,4,9,11,19,-8
5,4,10,11,9,2
5,4,11,9,13,-4
5,4,12,17,18,-1
5,4,13,15,24,-9
5,4,14,5,3,2
5,4,15,15,13,2
5,4,16,8,15,-7
5,4,17,14,13,1
5,4,18,7,14,-7
5,4,19,12,10,2
5,4,20,7,7,0
5,4,21,8,18,-10
5,4,22,10,13,-3
5,4,23,20,15,5
5,4,24,14,11,3
5,4,25,9,6,3
5,4,26,11,13,-2
5,4,27,13,19,-6
5,4,28,15,5,10
5,4,29,27,14,13
5,4,30,12,14,-2
5,4,31,4,12,-8
5,4,32,13,15,-2
5,4,33,11,11,0
5,4,34,14,10,4
5,4,35,5,18,-13
5,4,36,9,14,-5
5,4,37,25,18,7
5,4,38,13,26,-13
5,4,39,17,9,8
5,4,40,14,12,2
5,4,41,13,8,5
5,4,42,9,16,-7
5,4,43,14,8,6
5,4,44,4,12,-8
5,4,45,10,14,-4
5,4,46,12,5,7
5,4,47,12,20,-8
5,4,48,11,13,-2
5,4,49,13,6,7
5,4,50,7,13,-6
5,4,51,16,21,-5
5,4,52,8,11,-3
5,4,53,4,8,-4
5,4,54,20,15,5
5,4,55,19,10,9
5,4,56,8,14,-6
5,4,57,5,8,-3
5,4,58,21,23,-2
5,4,59,10,9,1
5,4,60,5,10,-5
5,4,61,9,17,-8
5,4,62,15,15,0
5,4,63,15,9,6
5,4,64,13,26,-13
5,4,65,10,10,0
5,4,66,11,14,-3
5,4,67,12,12,0
5,4,68,9,8,1
5,4,69,16,14,2
5,4,70,13,9,4
5,4,71,8,14,-6
5,4,72,18,19,-1
5,4,73,12,15,-3
5,4,74,29,20,9
5,4,75,11,9,2
5,4,76,14,31,-17
5,4,77,11,15,-4
5,4,78,14,10,4
5,4,79,8,16,-8
5,4,80,16,20,-4
5,4,81,10,27,-17
5,4,82,14,7,7
5,4,83,6,8,-2
5,4,84,15,2,13
5,4,85,6,10,-4
5,4,86,11,14,-3
5,4,87,18,16,2
5,4,88,19,24,-5
5,4,89,14,7,7
5,4,90,13,25,-12
5,4,91,5,4,1
5,4,92,7,13,-6
5,4,93,7,9,-2
5,4,94,7,6,1
5,4,95,12,21,-9
5,4,96,10,20,-10
5,4,97,17,18,-1
5,4,98,7,8,-1
5,4,99,7,9,-2
5,4,100,3,12,-9
5,4,101,15,19,-4
5,4,102,10,12,-2
5,4,103,17,9,8
5,4,104,6,12,-6
5,4,105,2,3,-1
5,4,106,6,11,-5
5,4,107,14,13,1
5,4,108,5,19,-14
5,4,109,7,17,-10
5,4,110,17,7,10
5,4,111,11,19,-8
5,4,112,10,18,-8
5,4,113,9,6,3
5,4,114,12,11,1
5,4,115,17,8,9
5,4,116,6,7,-1
5,4,117,6,13,-7
5,4,118,17,7,10
5,4,119,12,16,-4
5,4,120,8,8,0
5,4,121,6,4,2
5,4,122,10,22,-12
5,4,123,9,9,0
5,4,124,14,15,-1
5,4,125,11,16,-5
5,4,126,16,19,-3
5,4,127,11,5,6
5,4,128,20,15,5
5,4,129,8,10,-2
5,4,130,13,16,-3
5,4,131,25,17,8
5,4,132,5,7,-2
5,4,133,20,13,7
5,4,134,17,14,3
5,4,135,10,15,-5
5,4,136,4,6,-2
5,4,137,9,17,-8
5,4,138,23,16,7
5,4,139,9,12,-3
5,4,140,11,21,-10
5,4,141,7,6,1
5,4,142,16,27,-11
5,4,143,2,17,-15
5,4,144,12,16,-4
5,4,145,16,31,-15
5,4,146,5,2,3
5,4,147,9,2,7
5,4,148,12,13,-1
5,4,149,5,12,-7
5,4,150,10,18,-8
5,4,151,3,17,-14
5,4,152,9,8,1
5,4,153,4,15,-11
5,4,154,8,8,0
5,4,155,17,15,2
5,4,156,13,9,4
5,4,157,15,13,2
5,4,158,9,19,-10
5,4,159,15,14,1
5,4,160,20,25,-5
5,4,161,13,10,3
5,4,162,16,14,2
5,4,163,9,7,2
5,4,164,4,18,-14
5,4,165,6,10,-4
5,4,166,14,16,-2
5,4,167,4,3,1
5,4,168,13,12,1
5,4,169,2,8,-6
5,4,170,9,12,-3
5,4,171,10,18,-8
5,4,172,11,20,-9
5,4,173,8,5,3
5,4,174,19,20,-1
5,4,175,10,11,-1
5,4,176,10,18,-8
5,4,177,4,3,1
5,4,178,17,9,8
5,4,179,15,16,-1
5,4,180,22,7,15
5,4,181,10,12,-2
5,4,182,14,11,3
5,4,183,11,14,-3
5,4,184,9,18,-9
5,4,185,2,5,-3
5,4,186,5,3,2
5,4,187,3,6,-3
5,4,188,12,14,-2
5,4,189,5,13,-8
5,4,190,19,10,9
5,4,191,17,14,3
5,4,192,12,14,-2
5,4,193,5,5,0
5,4,194,14,13,1
5,4,195,7,9,-2
5,4,196,21,16,5
5,4,197,9,13,-4
5,4,198,19,9,10
5,4,199,14,8,6
5,4,200,6,10,-4
5,4,201,20,12,8
5,4,202,5,20,-15
5,4,203,14,9,5
5,4,204,16,19,-3
5,4,205,10,19,-9
5,4,206,11,11,0
5,4,207,4,17,-13
5,4,208,9,24,-15
5,4,209,20,7,13
5,4,210,12,5,7
5,4,211,17,24,-7
5,4,212,7,17,-10
5,4,213,7,10,-3
5,4,214,6,5,1
5,4,215,16,14,2
5,4,216,17,27,-10
5,4,217,12,14,-2
5,4,218,12,13,-1
5,4,219,6,9,-3
5,4,220,7,8,-1
5,4,221,13,4,9
5,4,222,11,16,-5
5,4,223,17,17,0
5,4,224,6,14,-8
5,4,225,10,8,2
5,4,226,9,14,-5
5,4,227,12,9,3
5,4,228,9,11,-2
5,4,229,5,12,-7
5,4,230,10,9,1
5,4,231,17,15,2
5,4,232,16,19,-3
5,4,233,18,5,13
5,4,234,17,22,-5
5,4,235,10,6,4
5,4,236,15,10,5
5,4,237,14,15,-1
5,4,238,13,12,1
5,4,239,12,15,-3
5,4,240,16,19,-3
5,4,241,3,8,-5
5,4,242,13,18,-5
5,4,243,8,15,-7
5,4,244,13,24,-11
5,4,245,15,4,11
5,4,246,24,10,14
5,4,247,7,8,-1
5,4,248,15,7,8
5,4,249,4,9,-5
5,4,250,8,3,5
5,4,251,13,17,-4
5,4,252,13,18,-5
5,4,253,15,18,-3
5,4,254,20,15,5
5,4,255,12,15,-3
5,4,256,11,16,-5
5,4,257,17,22,-5
5,4,258,10,20,-10
5,4,259,15,13,2
5,4,260,8,9,-1
5,4,261,9,16,-7
5,4,262,13,15,-2
5,4,263,21,23,-2
5,4,264,6,6,0
5,4,265,2,5,-3
5,4,266,16,20,-4
5,4,267,7,8,-1
5,4,268,22,17,5
5,4,269,11,7,4
5,4,270,13,12,1
5,4,271,13,11,2
5,4,272,13,4,9
5,4,273,14,15,-1
5,4,274,15,12,3
5,4,275,21,11,10
5,4,276,12,4,8
5,4,277,4,6,-2
5,4,278,12,23,-11
5,4,279,1,6,-5
5,4,280,9,4,5
5,4,281,20,14,6
5,4,282,8,16,-8
5,4,283,11,9,2
5,4,284,26,11,15
5,4,285,5,5,0
5,4,286,12,12,0
5,4,287,7,23,-16
5,4,288,20,18,2
5,4,289,14,7,7
5,4,290,8,20,-12
5,4,291,7,16,-9
5,4,292,13,17,-4
5,4,293,8,6,2
5,4,294,4,7,-3
5,4,295,12,27,-15
5,4,296,14,12,2
5,4,297,10,23,-13
5,4,298,6,0,6
5,4,299,11,13,-2
5,5,0,8,6,2
5,5,1,18,21,-3
5,5,2,9,5,4
5,5,3,7,7,0
5,5,4,8,1,7
5,5,5,12,20,-8
5,5,6,5,7,-2
5,5,7,16,14,2
5,5,8,11,18,-7
5,5,9,8,11,-3
5,5,10,15,14,1
5,5,11,8,14,-6
5,5,12,14,8,6
5,5,13,8,12,-4
5,5,14,14,9,5
5,5,15,10,22,-12
5,5,16,24,17,7
5,5,17,23,25,-2
5,5,18,8,16,-8
5,5,19,18,15,3
5,5,20,15,17,-2
5,5,21,7,12,-5
5,5,22,12,11,1
5,5,23,11,12,-1
5,5,24,5,10,-5
5,5,25,12,8,4
5,5,26,12,26,-14
5,5,27,15,17,-2
5,5,28,21,15,6
5,5,29,14,16,-2
5,5,30,20,13,7
5,5,31,8,9,-1
5,5,32,5,4,1
5,5,33,4,13,-9
5,5,34,8,11,-3
5,5,35,7,12,-5
5,5,36,11,15,-4
5,5,37,12,9,3
5,5,38,28,13,15
5,5,39,8,18,-10
5,5,40,12,23,-11
5,5,41,15,7,8
5,5,42,1,7,-6
5,5,43,8,10,-2
5,5,44,18,9,9
5,5,45,14,10,4
5,5,46,19,19,0
5,5,47,22,23,-1
5,5,48,5,10,-5
5,5,49,19,11,8
5,5,50,27,12,15
5,5,51,14,24,-10
5,5,52,14,26,-12
5,5,53,9,25,-16
5,5,54,16,17,-1
5,5,55,15,17,-2
5,5,56,8,9,-1
5,5,57,8,5,3
5,5,58,10,3,7
5,5,59,4,0,4
5,5,60,15,8,7
5,5,61,12,8,4
5,5,62,9,9,0
5,5,63,5,17,-12
5,5,64,16,13,3
5,5,65,18,19,-1
5,5,66,10,15,-5
5,5,67,6,8,-2
5,5,68,9,9,0
5,5,69,9,22,-13
5,5,70,19,17,2
5,5,71,12,14,-2
5,5,72,6,17,-11
5,5,73,7,14,-7
5,5,74,9,19,-10
5,5,75,17,10,7
5,5,76,22,20,2
5,5,77,8,11,-3
5,5,78,14,23,-9
5,5,79,5,7,-2
5,5,80,16,15,1
5,5,81,4,8,-4
5,5,82,5,4,1
5,5,83,12,5,7
5,5,84,19,6,13
5,5,85,19,23,-4
5,5,86,5,16,-11
5,5,87,11,12,-1
5,5,88,13,19,-6
5,5,89,13,19,-6
5,5,90,12,16,-4
5,5,91,11,15,-4
5,5,92,19,6,13
5,5,93,17,14,3
5,5,94,17,17,0
5,5,95,9,14,-5
5,5,96,13,19,-6
5,5,97,5,14,-9
5,5,98,20,21,-1
5,5,99,6,8,-2
5,5,100,15,14,1
5,5,101,11,9,2
5,5,102,11,15,-4
5,5,103,23,15,8
5,5,104,18,15,3
5,5,105,16,17,-1
5,5,106,3,6,-3
5,5,107,10,22,-12
5,5,108,12,14,-2
5,5,109,10,22,-12
5,5,110,16,16,0
5,5,111,17,16,1
5,5,112,7,16,-9
5,5,113,16,11,5
5,5,114,7,6,1
5,5,115,13,19,-6
5,5,116,18,21,-3
5,5,117,9,14,-5
5,5,118,11,12,-1
5,5,119,15,17,-2
5,5,120,21,13,8
5,5,121,12,7,5
5,5,122,9,5,4
5,5,123,17,10,7
5,5,124,12,11,1
5,5,125,7,9,-2
5,5,126,20,14,6
5,5,127,21,26,-5
5,5,128,7,9,-2
5,5,129,5,13,-8
5,5,130,8,22,-14
5,5,131,24,13,11
5,5,132,6,3,3
5,5,133,16,11,5
5,5,134,8,4,4
5,5,135,6,13,-7
5,5,136,18,9,9
5,5,137,9,19,-10
5,5,138,7,9,-2
5,5,139,11,17,-6
5,5,140,21,24,-3
5,5,141,21,19,2
5,5,142,16,9,7
5,5,143,12,11,1
5,5,144,7,13,-6
5,5,145,13,17,-4
5,5,146,22,12,10
5,5,147,12,26,-14
5,5,148,10,13,-3
5,5,149,13,20,-7
5,5,150,17,14,3
5,5,151,22,9,13
5,5,152,14,7,7
5,5,153,10,25,-15
5,5,154,10,22,-12
5,5,155,21,4,17
5,5,156,9,12,-3
5,5,157,9,13,-4
5,5,158,14,23,-9
5,5,159,3,11,-8
5,5,160,11,8,3
5,5,161,8,24,-16
5,5,162,9,2,7
5,5,163,4,12,-8
5,5,164,10,9,1
5,5,165,7,10,-3
5,5,166,11,12,-1
5,5,167,20,7,13
5,5,168,6,11,-5
5,5,169,17,22,-5
5,5,170,11,12,-1
5,5,171,20,23,-3
5,5,172,11,21,-10
5,5,173,9,13,-4
5,5,174,5,7,-2
5,5,175,15,7,8
5,5,176,11,15,-4
5,5,177,16,13,3
5,5,178,10,5,5
5,5,179,9,9,0
5,5,180,9,23,-14
5,5,181,6,11,-5
5,5,182,21,14,7
5,5,183,11,13,-2
5,5,184,4,10,-6
5,5,185,0,1,-1
5,5,186,22,9,13
5,5,187,8,8,0
5,5,188,14,16,-2
5,5,189,18,19,-1
5,5,190,21,17,4
5,5,191,7,15,-8
5,5,192,2,5,-3
5,5,193,7,7,0
5,5,194,14,12,2
5,5,195,12,20,-8
5,5,196,11,15,-4
5,5,197,7,5,2
5,5,198,4,10,-6
5,5,199,12,18,-6
5,5,200,8,10,-2
5,5,201,14,16,-2
5,5,202,16,12,4
5,5,203,13,26,-13
5,5,204,14,4,10
5,5,205,9,15,-6
5,5,206,11,10,1
5,5,207,17,16,1
5,5,208,7,9,-2
5,5,209,6,14,-8
5,5,210,13,12,1
5,5,211,18,11,7
5,5,212,5,14,-9
5,5,213,7,9,-2
5,5,214,11,20,-9
5,5,215,5,4,1
5,5,216,14,16,-2
5,5,217,21,18,3
5,5,218,4,8,-4
5,5,219,14,19,-5
5,5,220,7,13,-6
5,5,221,25,25,0
5,5,222,16,12,4
5,5,223,18,26,-8
5,5,224,18,10,8
5,5,225,16,10,6
5,5,226,12,22,-10
5,5,227,13,13,0
5,5,228,3,13,-10
5,5,229,17,12,5
5,5,230,7,19,-12
5,5,231,19,21,-2
5,5,232,7,5,2
5,5,233,10,21,-11
5,5,234,21,9,12
5,5,235,7,9,-2
5,5,236,18,9,9
5,5,237,8,12,-4
5,5,238,18,8,10
5,5,239,18,14,4
5,5,240,14,14,0
5,5,241,13,4,9
5,5,242,6,11,-5
5,5,243,17,21,-4
5,5,244,4,13,-9
5,5,245,8,7,1
5,5,246,26,24,2
5,5,247,13,14,-1
5,5,248,14,17,-3
5,5,249,12,16,-4
5,5,250,14,10,4
5,5,251,20,18,2
5,5,252,13,17,-4
5,5,253,18,15,3
5,5,254,16,22,-6
5,5,255,10,8,2
5,5,256,7,13,-6
5,5,257,11,7,4
5,5,258,17,14,3
5,5,259,17,13,4
5,5,260,9,22,-13
5,5,261,11,12,-1
5,5,262,11,14,-3
5,5,263,2,3,-1
5,5,264,13,10,3
5,5,265,12,16,-4
5,5,266,8,10,-2
5,5,267,15,15,0
5,5,268,6,11,-5
5,5,269,10,10,0
5,5,270,19,13,6
5,5,271,7,5,2
5,5,272,15,10,5
5,5,273,16,15,1
5,5,274,16,12,4
5,5,275,6,12,-6
5,5,276,17,19,-2
5,5,277,7,17,-10
5,5,278,8,15,-7
5,5,279,6,4,2
5,5,280,8,16,-8
5,5,281,8,9,-1
5,5,282,16,9,7
5,5,283,8,11,-3
5,5,284,4,6,-2
5,5,285,14,5,9
5,5,286,14,17,-3
5,5,287,8,16,-8
5,5,288,19,12,7
5,5,289,16,11,5
5,5,290,10,20,-10
5,5,291,15,19,-4
5,5,292,10,15,-5
5,5,293,9,15,-6
5,5,294,12,11,1
5,5,295,19,17,2
5,5,296,10,6,4
5,5,297,8,11,-3
5,5,298,20,13,7
5,5,299,10,11,-1
5,6,0,10,6,4
5,6,1,5,20,-15
5,6,2,27,31,-4
5,6,3,29,10,19
5,6,4,9,14,-5
5,6,5,12,9,3
5,6,6,4,5,-1
5,6,7,20,22,-2
5,6,8,11,14,-3
5,6,9,18,19,-1
5,6,10,15,18,-3
5,6,11,2,5,-3
5,6,12,7,10,-3
5,6,13,10,18,-8
5,6,14,6,5,1
5,6,15,15,15,0
5,6,16,7,11,-4
5,6,17,11,22,-11
5,6,18,10,10,0
5,6,19,19,16,3
5,6,20,21,21,0
5,6,21,15,16,-1
5,6,22,10,13,-3
5,6,23,12,16,-4
5,6,24,10,13,-3
5,6,25,16,20,-4
5,6,26,12,14,-2
5,6,27,11,22,-11
5,6,28,35,10,25
5,6,29,10,9,1
5,6,30,10,20,-10
5,6,31,18,10,8
5,6,32,16,4,12
5,6,33,14,5,9
5,6,34,14,20,-6
5,6,35,25,33,-8
5,6,36,8,4,4
5,6,37,7,14,-7
5,6,38,4,5,-1
5,6,39,6,7,-1
5,6,40,14,9,5
5,6,41,13,13,0
5,6,42,14,16,-2
5,6,43,23,8,15
5,6,44,4,8,-4
5,6,45,8,11,-3
5,6,46,6,20,-14
5,6,47,5,11,-6
5,6,48,8,11,-3
5,6,49,6,10,-4
5,6,50,14,20,-6
5,6,51,18,5,13
5,6,52,11,7,4
5,6,53,7,11,-4
5,6,54,26,13,13
5,6,55,3,2,1
5,6,56,7,19,-12
5,6,57,13,35,-22
5,6,58,5,14,-9
5,6,59,20,19,1
5,6,60,8,22,-14
5,6,61,6,8,-2
5,6,62,5,10,-5
5,6,63,4,5,-1
5,6,64,17,30,-13
5,6,65,15,11,4
5,6,66,16,15,1
5,6,67,17,17,0
5,6,68,8,10,-2
5,6,69,14,11,3
5,6,70,13,11,2
5,6,71,25,19,6
5,6,72,23,11,12
5,6,73,15,15,0
5,6,74,17,20,-3
5,6,75,18,24,-6
5,6,76,13,13,0
5,6,77,8,10,-2
5,6,78,9,13,-4
5,6,79,19,16,3
5,6,80,19,21,-2
5,6,81,11,15,-4
5,6,82,9,19,-10
5,6,83,13,15,-2
5,6,84,9,9,0
5,6,85,15,7,8
5,6,86,13,27,-14
5,6,87,8,16,-8
5,6,88,12,17,-5
5,6,89,14,6,8
5,6,90,9,11,-2
5,6,91,7,13,-6
5,6,92,15,16,-1
5,6,93,24,25,-1
5,6,94,6,8,-2
5,6,95,7,6,1
5,6,96,3,3,0
5,6,97,3,9,-6
5,6,98,9,8,1
5,6,99,22,12,10
5,6,100,9,10,-1
5,6,101,18,14,4
5,6,102,9,4,5
5,6,103,20,23,-3
5,6,104,5,15,-10
5,6,105,15,15,0
5,6,106,24,20,4
5,6,107,16,19,-3
5,6,108,4,8,-4
5,6,109,12,9,3
5,6,110,12,16,-4
5,6,111,12,15,-3
5,6,112,25,20,5
5,6,113,21,10,11
5,6,114,16,13,3
5,6,115,8,11,-3
5,6,116,6,6,0
5,6,117,12,14,-2
5,6,118,14,16,-2
5,6,119,17,6,11
5,6,120,13,33,-20
5,6,121,11,14,-3
5,6,122,7,4,3
5,6,123,13,15,-2
5,6,124,11,24,-13
5,6,125,9,17,-8
5,6,126,19,23,-4
5,6,127,11,10,1
5,6,128,11,18,-7
5,6,129,12,9,3
5,6,130,14,17,-3
5,6,131,18,16,2
5,6,132,21,20,1
5,6,133,10,16,-6
5,6,134,9,14,-5
5,6,135,8,11,-3
5,6,136,9,7,2
5,6,137,22,14,8
5,6,138,2,15,-13
5,6,139,7,7,0
5,6,140,10,11,-1
5,6,141,11,13,-2
5,6,142,16,12,4
5,6,143,4,11,-7
5,6,144,7,18,-11
5,6,145,4,15,-11
5,6,146,6,7,-1
5,6,147,16,9,7
5,6,148,18,7,11
5,6,149,7,4,3
5,6,150,21,24,-3
5,6,151,13,14,-1
5,6,152,10,11,-1
5,6,153,5,9,-4
5,6,154,13,18,-5
5,6,155,9,5,4
5,6,156,17,16,1
5,6,157,19,15,4
5,6,158,17,21,-4
5,6,159,12,7,5
5,6,160,9,5,4
5,6,161,21,14,7
5,6,162,15,11,4
5,6,163,17,5,12
5,6,164,8,27,-19
5,6,165,16,10,6
5,6,166,6,5,1
5,6,167,12,16,-4
5,6,168,12,13,-1
5,6,169,12,18,-6
5,6,170,24,14,10
5,6,171,17,18,-1
5,6,172,13,7,6
5,6,173,14,16,-2
5,6,174,18,24,-6
5,6,175,13,10,3
5,6,176,25,26,-1
5,6,177,17,9,8
5,6,178,10,6,4
5,6,179,20,12,8
5,6,180,8,19,-11
5,6,181,6,10,-4
5,6,182,11,10,1
5,6,183,10,12,-2
5,6,184,21,10,11
5,6,185,15,11,4
5,6,186,17,18,-1
5,6,187,7,8,-1
5,6,188,26,12,14
5,6,189,20,18,2
5,6,190,14,9,5
5,6,191,18,14,4
5,6,192,9,12,-3
5,6,193,9,8,1
5,6,194,14,22,-8
5,6,195,31,32,-1
5,6,196,13,17,-4
5,6,197,13,11,2
5,6,198,12,26,-14
5,6,199,17,21,-4
5,6,200,8,16,-8
5,6,201,11,18,-7
5,6,202,10,9,1
5,6,203,19,21,-2
5,6,204,16,16,0
5,6,205,18,11,7
5,6,206,13,12,1
5,6,207,6,4,2
5,6,208,27,14,13
5,6,209,8,21,-13
5,6,210,7,15,-8
5,6,211,14,29,-15
5,6,212,16,21,-5
5,6,213,16,17,-1
5,6,214,11,23,-12
5,6,215,10,7,3
5,6,216,6,14,-8
5,6,217,17,13,4
5,6,218,16,12,4
5,6,219,10,9,1
5,6,220,16,20,-4
5,6,221,6,13,-7
5,6,222,17,18,-1
5,6,223,12,5,7
5,6,224,15,18,-3
5,6,225,8,21,-13
5,6,226,16,5,11
5,6,227,18,17,1
5,6,228,21,16,5
5,6,229,11,13,-2
5,6,230,28,16,12
5,6,231,14,15,-1
5,6,232,10,14,-4
5,6,233,19,12,7
5,6,234,12,6,6
5,6,235,8,14,-6
5,6,236,18,17,1
5,6,237,14,11,3
5,6,238,4,8,-4
5,6,239,12,4,8
5,6,240,11,17,-6
5,6,241,16,6,10
5,6,242,7,4,3
5,6,243,16,11,5
5,6,244,9,7,2
5,6,245,13,12,1
5,6,246,12,8,4
5,6,247,12,14,-2
5,6,248,16,13,3
5,6,249,15,22,-7
5,6,250,14,25,-11
5,6,251,15,21,-6
5,6,252,11,14,-3
5,6,253,15,14,1
5,6,254,5,11,-6
5,6,255,11,12,-1
5,6,256,12,14,-2
5,6,257,13,23,-10
5,6,258,13,14,-1
5,6,259,12,6,6
5,6,260,11,15,-4
5,6,261,4,13,-9
5,6,262,20,12,8
5,6,263,15,24,-9
5,6,264,12,11,1
5,6,265,7,9,-2
5,6,266,15,17,-2
5,6,267,23,16,7
5,6,268,3,12,-9
5,6,269,12,20,-8
5,6,270,20,30,-10
5,6,271,21,19,2
5,6,272,11,20,-9
5,6,273,18,10,8
5,6,274,10,10,0
5,6,275,17,10,7
5,6,276,13,16,-3
5,6,277,4,4,0
5,6,278,19,13,6
5,6,279,17,20,-3
5,6,280,24,16,8
5,6,281,4,16,-12
5,6,282,17,10,7
5,6,283,7,7,0
5,6,284,19,16,3
5,6,285,9,16,-7
5,6,286,5,3,2
5,6,287,17,21,-4
5,6,288,7,3,4
5,6,289,14,22,-8
5,6,290,5,14,-9
5,6,291,9,11,-2
5,6,292,14,28,-14
5,6,293,10,19,-9
5,6,294,10,11,-1
5,6,295,9,13,-4
5,6,296,13,15,-2
5,6,297,9,13,-4
5,6,298,7,9,-2
5,6,299,16,8,8
5,7,0,11,25,-14
5,7,1,13,10,3
5,7,2,18,15,3
5,7,3,11,12,-1
5,7,4,3,1,2
5,7,5,10,14,-4
5,7,6,21,7,14
5,7,7,10,28,-18
5,7,8,18,6,12
5,7,9,16,15,1
5,7,10,26,20,6
5,7,11,16,15,1
5,7,12,13,12,1
5,7,13,5,5,0
5,7,14,23,17,6
5,7,15,19,20,-1
5,7,16,8,11,-3
5,7,17,10,16,-6
5,7,18,6,11,-5
5,7,19,20,23,-3
5,7,20,18,11,7
5,7,21,22,21,1
5,7,22,20,13,7
5,7,23,25,22,3
5,7,24,15,9,6
5,7,25,9,10,-1
5,7,26,11,10,1
5,7,27,21,17,4
5,7,28,12,4,8
5,7,29,18,28,-10
5,7,30,21,15,6
5,7,31,15,7,8
5,7,32,11,4,7
5,7,33,10,16,-6
5,7,34,21,19,2
5,7,35,15,8,7
5,7,36,12,17,-5
5,7,37,3,12,-9
5,7,38,9,22,-13
5,7,39,7,10,-3
5,7,40,8,16,-8
5,7,41,9,12,-3
5,7,42,9,15,-6
5,7,43,10,6,4
5,7,44,22,23,-1
5,7,45,13,13,0
5,7,46,8,3,5
5,7,47,15,11,4
5,7,48,12,25,-13
5,7,49,10,25,-15
5,7,50,16,13,3
5,7,51,17,14,3
5,7,52,9,10,-1
5,7,53,15,1,14
5,7,54,10,9,1
5,7,55,6,6,0
5,7,56,13,9,4
5,7,57,16,7,9
5,7,58,16,9,7
5,7,59,8,14,-6
5,7,60,16,17,-1
5,7,61,12,18,-6
5,7,62,10,13,-3
5,7,63,10,20,-10
5,7,64,18,16,2
5,7,65,18,12,6
5,7,66,19,18,1
5,7,67,10,11,-1
5,7,68,17,17,0
5,7,69,24,15,9
5,7,70,24,19,5
5,7,71,12,27,-15
5,7,72,16,13,3
5,7,73,13,13,0
5,7,74,6,7,-1
5,7,75,12,8,4
5,7,76,15,17,-2
5,7,77,11,11,0
5,7,78,22,20,2
5,7,79,6,12,-6
5,7,80,17,5,12
5,7,81,22,16,6
5,7,82,6,2,4
5,7,83,19,8,11
5,7,84,15,9,6
5,7,85,8,19,-11
5,7,86,21,15,6
5,7,87,17,13,4
5,7,88,20,8,12
5,7,89,13,18,-5
5,7,90,9,10,-1
5,7,91,4,11,-7
5,7,92,5,11,-6
5,7,93,17,10,7
5,7,94,22,8,14
5,7,95,9,10,-1
5,7,96,13,10,3
5,7,97,11,11,0
5,7,98,21,14,7
5,7,99,7,7,0
5,7,100,13,16,-3
5,7,101,19,13,6
5,7,102,17,8,9
5,7,103,39,23,16
5,7,104,12,14,-2
5,7,105,5,3,2
5,7,106,14,16,-2
5,7,107,9,8,1
5,7,108,9,18,-9
5,7,109,24,16,8
5,7,110,12,16,-4
5,7,111,14,16,-2
5,7,112,10,7,3
5,7,113,6,5,1
5,7,114,15,9,6
5,7,115,26,13,13
5,7,116,9,12,-3
5,7,117,16,16,0
5,7,118,15,7,8
5,7,119,8,8,0
5,7,120,19,20,-1
5,7,121,17,11,6
5,7,122,20,26,-6
5,7,123,23,10,13
5,7,124,26,21,5
5,7,125,9,20,-11
5,7,126,7,11,-4
5,7,127,18,20,-2
5,7,128,15,8,7
5,7,129,5,18,-13
5,7,130,14,32,-18
5,7,131,15,16,-1
5,7,132,10,2,8
5,7,133,17,12,5
5,7,134,14,27,-13
5,7,135,4,10,-6
5,7,136,10,14,-4
5,7,137,21,16,5
5,7,138,14,17,-3
5,7,139,18,18,0
5,7,140,11,10,1
5,7,141,19,20,-1
5,7,142,9,9,0
5,7,143,15,15,0
5,7,144,10,18,-8
5,7,145,9,8,1
5,7,146,10,16,-6
5,7,147,19,14,5
5,7,148,10,10,0
5,7,149,13,26,-13
5,7,150,11,21,-10
5,7,151,4,12,-8
5,7,152,11,16,-5
5,7,153,17,13,4
5,7,154,18,10,8
5,7,155,11,14,-3
5,7,156,12,13,-1
5,7,157,19,15,4
5,7,158,17,17,0
5,7,159,9,13,-4
5,7,160,11,10,1
5,7,161,24,18,6
5,7,162,17,19,-2
5,7,163,9,10,-1
5,7,164,13,11,2
5,7,165,8,5,3
5,7,166,16,10,6
5,7,167,11,7,4
5,7,168,18,22,-4
5,7,169,12,15,-3
5,7,170,20,19,1
5,7,171,21,24,-3
5,7,172,8,13,-5
5,7,173,17,14,3
5,7,174,27,23,4
5,7,175,20,10,10
5,7,176,12,10,2
5,7,177,13,8,5
5,7,178,5,1,4
5,7,179,13,21,-8
5,7,180,15,14,1
5,7,181,18,7,11
5,7,182,7,6,1
5,7,183,5,6,-1
5,7,184,10,17,-7
5,7,185,18,13,5
5,7,186,12,14,-2
5,7,187,12,11,1
5,7,188,22,12,10
5,7,189,9,10,-1
5,7,190,19,17,2
5,7,191,12,12,0
5,7,192,10,11,-1
5,7,193,15,10,5
5,7,194,12,20,-8
5,7,195,17,16,1
5,7,196,21,12,9
5,7,197,6,5,1
5,7,198,16,15,1
5,7,199,11,8,3
5,7,200,9,6,3
5,7,201,21,19,2
5,7,202,5,18,-13
5,7,203,6,6,0
5,7,204,15,9,6
5,7,205,17,18,-1
5,7,206,18,15,3
5,7,207,14,17,-3
5,7,208,15,16,-1
5,7,209,19,17,2
5,7,210,20,18,2
5,7,211,11,19,-8
5,7,212,33,24,9
5,7,213,7,10,-3
5,7,214,6,9,-3
5,7,215,20,14,6
5,7,216,12,13,-1
5,7,217,6,5,1
5,7,218,22,15,7
5,7,219,14,12,2
5,7,220,10,22,-12
5,7,221,7,10,-3
5,7,222,9,4,5
5,7,223,23,10,13
5,7,224,29,19,10
5,7,225,10,15,-5
5,7,226,13,9,4
5,7,227,12,6,6
5,7,228,22,16,6
5,7,229,7,8,-1
5,7,230,10,7,3
5,7,231,18,10,8
5,7,232,19,11,8
5,7,233,26,12,14
5,7,234,9,12,-3
5,7,235,11,21,-10
5,7,236,10,16,-6
5,7,237,12,9,3
5,7,238,17,7,10
5,7,239,16,14,2
5,7,240,17,13,4
5,7,241,15,7,8
5,7,242,12,9,3
5,7,243,8,16,-8
5,7,244,8,14,-6
5,7,245,24,10,14
5,7,246,26,21,5
5,7,247,13,10,3
5,7,248,12,17,-5
5,7,249,18,14,4
5,7,250,14,7,7
5,7,251,11,10,1
5,7,252,6,8,-2
5,7,253,18,14,4
5,7,254,17,22,-5
5,7,255,14,18,-4
5,7,256,21,14,7
5,7,257,9,14,-5
5,7,258,19,11,8
5,7,259,23,23,0
5,7,260,18,15,3
5,7,261,4,7,-3
5,7,262,15,12,3
5,7,263,6,14,-8
5,7,264,12,6,6
5,7,265,10,15,-5
5,7,266,17,22,-5
5,7,267,16,5,11
5,7,268,22,11,11
5,7,269,28,25,3
5,7,270,12,18,-6
5,7,271,5,14,-9
5,7,272,10,5,5
5,7,273,29,9,20
5,7,274,19,19,0
5,7,275,12,16,-4
5,7,276,14,32,-18
5,7,277,23,16,7
5,7,278,14,12,2
5,7,279,29,5,24
5,7,280,15,16,-1
5,7,281,25,24,1
5,7,282,13,16,-3
5,7,283,17,10,7
5,7,284,16,12,4
5,7,285,8,12,-4
5,7,286,8,11,-3
5,7,287,16,21,-5
5,7,288,23,16,7
5,7,289,10,31,-21
5,7,290,9,4,5
5,7,291,23,12,11
5,7,292,11,12,-1
5,7,293,11,7,4
5,7,294,26,31,-5
5,7,295,11,4,7
5,7,296,17,14,3
5,7,297,12,14,-2
5,7,298,6,8,-2
5,7,299,25,18,7
5,8,0,11,12,-1
5,8,1,15,15,0
5,8,2,14,16,-2
5,8,3,14,17,-3
5,8,4,11,24,-13
5,8,5,14,12,2
5,8,6,23,30,-7
5,8,7,7,16,-9
5,8,8,11,17,-6
5,8,9,13,16,-3
5,8,10,16,10,6
5,8,11,9,16,-7
5,8,12,9,15,-6
5,8,13,17,22,-5
5,8,14,12,9,3
5,8,15,12,10,2
5,8,16,9,5,4
5,8,17,12,29,-17
5,8,18,17,19,-2
5,8,19,22,14,8
5,8,20,10,16,-6
5,8,21,7,6,1
5,8,22,9,12,-3
5,8,23,12,8,4
5,8,24,15,10,5
5,8,25,12,7,5
5,8,26,12,24,-12
5,8,27,14,10,4
5,8,28,19,18,1
5,8,29,30,7,23
5,8,30,15,14,1
5,8,31,19,30,-11
5,8,32,5,4,1
5,8,33,13,22,-9
5,8,34,12,14,-2
5,8,35,8,16,-8
5,8,36,10,7,3
5,8,37,19,25,-6
5,8,38,8,17,-9
5,8,39,27,12,15
5,8,40,12,17,-5
5,8,41,8,15,-7
5,8,42,6,16,-10
5,8,43,9,19,-10
5,8,44,14,9,5
5,8,45,5,6,-1
5,8,46,12,10,2
5,8,47,4,17,-13
5,8,48,3,8,-5
5,8,49,13,10,3
5,8,50,21,12,9
5,8,51,6,20,-14
5,8,52,21,13,8
5,8,53,10,9,1
5,8,54,12,18,-6
5,8,55,11,3,8
5,8,56,19,19,0
5,8,57,16,15,1
5,8,58,33,4,29
5,8,59,16,10,6
5,8,60,13,11,2
5,8,61,5,8,-3
5,8,62,10,13,-3
5,8,63,11,12,-1
5,8,64,17,8,9
5,8,65,14,6,8
5,8,66,12,15,-3
5,8,67,3,6,-3
5,8,68,11,19,-8
5,8,69,11,14,-3
5,8,70,9,7,2
5,8,71,7,24,-17
5,8,72,7,12,-5
5,8,73,13,10,3
5,8,74,23,25,-2
5,8,75,7,8,-1
5,8,76,11,23,-12
5,8,77,26,23,3
5,8,78,9,8,1
5,8,79,11,10,1
5,8,80,22,11,11
5,8,81,17,9,8
5,8,82,17,14,3
5,8,83,23,24,-1
5,8,84,26,17,9
5,8,85,37,17,20
5,8,86,14,16,-2
5,8,87,28,11,17
5,8,88,10,18,-8
5,8,89,6,8,-2
5,8,90,18,12,6
5,8,91,11,13,-2
5,8,92,25,24,1
5,8,93,10,7,3
5,8,94,14,13,1
5,8,95,24,27,-3
5,8,96,6,15,-9
5,8,97,31,27,4
5,8,98,13,23,-10
5,8,99,16,14,2
5,8,100,20,11,9
5,8,101,16,10,6
5,8,102,11,29,-18
5,8,103,13,18,-5
5,8,104,12,11,1
5,8,105,14,22,-8
5,8,106,5,2,3
5,8,107,6,8,-2
5,8,108,15,23,-8
5,8,109,15,10,5
5,8,110,17,16,1
5,8,111,9,18,-9
5,8,112,29,15,14
5,8,113,20,16,4
5,8,114,15,16,-1
5,8,115,28,22,6
5,8,116,24,23,1
5,8,117,10,9,1
5,8,118,10,11,-1
5,8,119,24,17,7
5,8,120,12,7,5
5,8,121,7,13,-6
5,8,122,16,13,3
5,8,123,18,10,8
5,8,124,10,12,-2
5,8,125,24,16,8
5,8,126,5,17,-12
5,8,127,16,16,0
5,8,128,10,17,-7
5,8,129,12,11,1
5,8,130,3,12,-9
5,8,131,14,20,-6
5,8,132,18,18,0
5,8,133,24,17,7
5,8,134,18,10,8
5,8,135,12,10,2
5,8,136,22,21,1
5,8,137,15,13,2
5,8,138,8,8,0
5,8,139,15,14,1
5,8,140,11,16,-5
5,8,141,11,5,6
5,8,142,16,8,8
5,8,143,10,19,-9
5,8,144,22,17,5
5,8,145,14,5,9
5,8,146,7,7,0
5,8,147,18,9,9
5,8,148,12,9,3
5,8,149,6,10,-4
5,8,150,19,15,4
5,8,151,26,15,11
5,8,152,23,15,8
5,8,153,18,18,0
5,8,154,10,13,-3
5,8,155,13,8,5
5,8,156,7,7,0
5,8,157,6,20,-14
5,8,158,17,11,6
5,8,159,11,9,2
5,8,160,18,21,-3
5,8,161,9,7,2
5,8,162,16,16,0
5,8,163,16,10,6
5,8,164,14,9,5
5,8,165,16,11,5
5,8,166,12,4,8
5,8,167,9,12,-3
5,8,168,21,11,10
5,8,169,20,16,4
5,8,170,16,15,1
5,8,171,7,11,-4
5,8,172,20,19,1
5,8,173,23,9,14
5,8,174,20,12,8
5,8,175,11,22,-11
5,8,176,16,13,3
5,8,177,12,9,3
5,8,178,4,4,0
5,8,179,14,17,-3
5,8,180,3,9,-6
5,8,181,14,5,9
5,8,182,20,12,8
5,8,183,15,15,0
5,8,184,6,9,-3
5,8,185,19,10,9
5,8,186,19,14,5
5,8,187,30,24,6
5,8,188,9,16,-7
5,8,189,8,11,-3
5,8,190,15,12,3
5,8,191,19,14,5
5,8,192,14,10,4
5,8,193,22,14,8
5,8,194,24,24,0
5,8,195,15,16,-1
5,8,196,18,8,10
5,8,197,11,8,3
5,8,198,20,25,-5
5,8,199,22,17,5
5,8,200,20,21,-1
5,8,201,17,12,5
5,8,202,15,4,11
5,8,203,4,9,-5
5,8,204,10,13,-3
5,8,205,12,33,-21
5,8,206,19,16,3
5,8,207,25,19,6
5,8,208,14,6,8
5,8,209,13,3,10
5,8,210,9,8,1
5,8,211,11,17,-6
5,8,212,11,8,3
5,8,213,22,11,11
5,8,214,20,5,15
5,8,215,14,18,-4
5,8,216,13,10,3
5,8,217,6,6,0
5,8,218,8,7,1
5,8,219,8,5,3
5,8,220,10,20,-10
5,8,221,8,7,1
5,8,222,21,15,6
5,8,223,11,13,-2
5,8,224,10,12,-2
5,8,225,9,17,-8
5,8,226,13,5,8
5,8,227,20,18,2
5,8,228,19,13,6
5,8,229,6,5,1
5,8,230,23,9,14
5,8,231,6,10,-4
5,8,232,27,16,11
5,8,233,21,18,3
5,8,234,7,15,-8
5,8,235,14,25,-11
5,8,236,6,8,-2
5,8,237,16,34,-18
5,8,238,9,18,-9
5,8,239,14,13,1
5,8,240,17,5,12
5,8,241,24,15,9
5,8,242,14,19,-5
5,8,243,20,28,-8
5,8,244,16,19,-3
5,8,245,7,11,-4
5,8,246,12,12,0
5,8,247,13,17,-4
5,8,248,9,16,-7
5,8,249,7,17,-10
5,8,250,11,16,-5
5,8,251,28,14,14
5,8,252,15,18,-3
5,8,253,11,21,-10
5,8,254,15,18,-3
5,8,255,11,12,-1
5,8,256,19,16,3
5,8,257,14,18,-4
5,8,258,4,7,-3
5,8,259,19,26,-7
5,8,260,6,7,-1
5,8,261,11,7,4
5,8,262,10,8,2
5,8,263,19,19,0
5,8,264,14,17,-3
5,8,265,7,16,-9
5,8,266,15,13,2
5,8,267,13,10,3
5,8,268,20,33,-13
5,8,269,12,9,3
5,8,270,11,10,1
5,8,271,12,9,3
5,8,272,11,2,9
5,8,273,14,12,2
5,8,274,15,14,1
5,8,275,11,19,-8
5,8,276,17,11,6
5,8,277,11,8,3
5,8,278,7,3,4
5,8,279,16,6,10
5,8,280,10,6,4
5,8,281,7,11,-4
5,8,282,21,16,5
5,8,283,13,11,2
5,8,284,10,5,5
5,8,285,15,28,-13
5,8,286,8,11,-3
5,8,287,9,19,-10
5,8,288,10,10,0
5,8,289,11,22,-11
5,8,290,8,15,-7
5,8,291,2,5,-3
5,8,292,11,12,-1
5,8,293,16,18,-2
5,8,294,14,11,3
5,8,295,7,13,-6
5,8,296,17,17,0
5,8,297,13,12,1
5,8,298,17,13,4
5,8,299,40,20,20
5,9,0,18,9,9
5,9,1,11,11,0
5,9,2,26,15,11
5,9,3,20,15,5
5,9,4,19,16,3
5,9,5,35,18,17
5,9,6,14,7,7
5,9,7,24,9,15
5,9,8,19,25,-6
5,9,9,9,1,8
5,9,10,18,13,5
5,9,11,15,12,3
5,9,12,10,6,4
5,9,13,16,28,-12
5,9,14,16,16,0
5,9,15,21,14,7
5,9,16,17,21,-4
5,9,17,12,6,6
5,9,18,23,4,19
5,9,19,24,12,12
5,9,20,11,11,0
5,9,21,14,13,1
5,9,22,11,9,2
5,9,23,9,4,5
5,9,24,7,16,-9
5,9,25,13,7,6
5,9,26,12,9,3
5,9,27,22,15,7
5,9,28,12,18,-6
5,9,29,12,17,-5
5,9,30,19,17,2
5,9,31,18,9,9
5,9,32,15,10,5
5,9,33,9,8,1
5,9,34,16,5,11
5,9,35,25,11,14
5,9,36,15,7,8
5,9,37,13,9,4
5,9,38,13,27,-14
5,9,39,7,8,-1
5,9,40,15,11,4
5,9,41,20,20,0
5,9,42,19,12,7
5,9,43,22,14,8
5,9,44,12,12,0
5,9,45,8,11,-3
5,9,46,9,12,-3
5,9,47,10,17,-7
5,9,48,15,20,-5
5,9,49,17,20,-3
5,9,50,18,13,5
5,9,51,13,8,5
5,9,52,13,13,0
5,9,53,19,9,10
5,9,54,10,6,4
5,9,55,12,20,-8
5,9,56,12,8,4
5,9,57,11,12,-1
5,9,58,17,18,-1
5,9,59,11,8,3
5,9,60,22,5,17
5,9,61,19,25,-6
5,9,62,10,8,2
5,9,63,21,17,4
5,9,64,23,26,-3
5,9,65,14,17,-3
5,9,66,24,17,7
5,9,67,32,7,25
5,9,68,21,22,-1
5,9,69,13,14,-1
5,9,70,14,21,-7
5,9,71,20,7,13
5,9,72,14,21,-7
5,9,73,19,17,2
5,9,74,8,8,0
5,9,75,13,8,5
5,9,76,9,23,-14
5,9,77,13,4,9
5,9,78,13,13,0
5,9,79,22,11,11
5,9,80,9,1,8
5,9,81,11,11,0
5,9,82,10,8,2
5,9,83,26,16,10
5,9,84,31,15,16
5,9,85,9,12,-3
5,9,86,12,7,5
5,9,87,14,15,-1
5,9,88,11,11,0
5,9,89,18,11,7
5,9,90,7,10,-3
5,9,91,20,15,5
5,9,92,19,8,11
5,9,93,15,8,7
5,9,94,1,19,-18
5,9,95,23,12,11
5,9,96,11,17,-6
5,9,97,16,9,7
5,9,98,10,10,0
5,9,99,18,22,-4
5,9,100,14,16,-2
5,9,101,22,11,11
5,9,102,5,15,-10
5,9,103,12,34,-22
5,9,104,19,18,1
5,9,105,12,18,-6
5,9,106,14,21,-7
5,9,107,12,10,2
5,9,108,15,7,8
5,9,109,16,14,2
5,9,110,10,14,-4
5,9,111,9,13,-4
5,9,112,9,14,-5
5,9,113,15,8,7
5,9,114,16,15,1
5,9,115,15,14,1
5,9,116,14,15,-1
5,9,117,12,12,0
5,9,118,14,9,5
5,9,119,15,24,-9
5,9,120,8,18,-10
5,9,121,12,17,-5
5,9,122,21,11,10
5,9,123,18,20,-2
5,9,124,11,7,4
5,9,125,15,6,9
5,9,126,11,10,1
5,9,127,21,12,9
5,9,128,11,15,-4
5,9,129,17,16,1
5,9,130,10,6,4
5,9,131,11,5,6
5,9,132,12,16,-4
5,9,133,19,18,1
5,9,134,14,6,8
5,9,135,19,21,-2
5,9,136,23,25,-2
5,9,137,25,14,11
5,9,138,5,8,-3
5,9,139,13,27,-14
5,9,140,10,9,1
5,9,141,18,14,4
5,9,142,21,20,1
5,9,143,8,3,5
5,9,144,18,15,3
5,9,145,10,12,-2
5,9,146,15,10,5
5,9,147,5,11,-6
5,9,148,12,6,6
5,9,149,7,10,-3
5,9,150,12,13,-1
5,9,151,18,12,6
5,9,152,14,10,4
5,9,153,14,9,5
5,9,154,19,20,-1
5,9,155,10,16,-6
5,9,156,21,15,6
5,9,157,24,29,-5
5,9,158,15,9,6
5,9,159,9,11,-2
5,9,160,22,15,7
5,9,161,10,18,-8
5,9,162,13,6,7
5,9,163,10,14,-4
5,9,164,21,13,8
5,9,165,15,11,4
5,9,166,9,11,-2
5,9,167,14,11,3
5,9,168,15,21,-6
5,9,169,25,7,18
5,9,170,15,10,5
5,9,171,16,13,3
5,9,172,27,16,11
5,9,173,12,8,4
5,9,174,16,6,10
5,9,175,12,20,-8
5,9,176,27,26,1
5,9,177,24,16,8
5,9,178,10,8,2
5,9,179,9,13,-4
5,9,180,14,7,7
5,9,181,6,20,-14
5,9,182,15,6,9
5,9,183,11,7,4
5,9,184,8,10,-2
5,9,185,12,22,-10
5,9,186,17,7,10
5,9,187,14,26,-12
5,9,188,23,12,11
5,9,189,12,18,-6
5,9,190,25,15,10
5,9,191,13,10,3
5,9,192,15,11,4
5,9,193,6,8,-2
5,9,194,16,20,-4
5,9,195,6,9,-3
5,9,196,15,22,-7
5,9,197,15,7,8
5,9,198,14,8,6
5,9,199,19,17,2
5,9,200,16,14,2
5,9,201,3,16,-13
5,9,202,13,6,7
5,9,203,14,21,-7
5,9,204,8,19,-11
5,9,205,11,16,-5
5,9,206,13,11,2
5,9,207,20,26,-6
5,9,208,5,7,-2
5,9,209,14,14,0
5,9,210,4,9,-5
5,9,211,17,14,3
5,9,212,20,19,1
5,9,213,12,9,3
5,9,214,16,10,6
5,9,215,16,12,4
5,9,216,10,18,-8
5,9,217,17,11,6
5,9,218,14,24,-10
5,9,219,12,5,7
5,9,220,18,8,10
5,9,221,11,12,-1
5,9,222,18,11,7
5,9,223,24,13,11
5,9,224,13,12,1
5,9,225,8,12,-4
5,9,226,14,8,6
5,9,227,13,8,5
5,9,228,20,15,5
5,9,229,8,14,-6
5,9,230,13,13,0
5,9,231,13,14,-1
5,9,232,14,15,-1
5,9,233,18,23,-5
5,9,234,20,12,8
5,9,235,22,17,5
5,9,236,17,15,2
5,9,237,17,17,0
5,9,238,12,14,-2
5,9,239,17,7,10
5,9,240,10,22,-12
5,9,241,26,13,13
5,9,242,10,16,-6
5,9,243,12,12,0
5,9,244,13,11,2
5,9,245,17,10,7
5,9,246,12,10,2
5,9,247,12,10,2
5,9,248,8,8,0
5,9,249,11,9,2
5,9,250,17,19,-2
5,9,251,12,18,-6
5,9,252,16,9,7
5,9,253,9,5,4
5,9,254,16,14,2
5,9,255,16,16,0
5,9,256,9,10,-1
5,9,257,16,13,3
5,9,258,26,9,17
5,9,259,16,13,3
5,9,260,26,18,8
5,9,261,7,8,-1
5,9,262,17,12,5
5,9,263,28,19,9
5,9,264,16,12,4
5,9,265,8,10,-2
5,9,266,19,27,-8
5,9,267,15,11,4
5,9,268,12,4,8
5,9,269,19,15,4
5,9,270,20,24,-4
5,9,271,23,8,15
5,9,272,16,23,-7
5,9,273,32,12,20
5,9,274,23,14,9
5,9,275,16,18,-2
5,9,276,28,21,7
5,9,277,15,26,-11
5,9,278,26,33,-7
5,9,279,13,16,-3
5,9,280,24,15,9
5,9,281,8,9,-1
5,9,282,12,9,3
5,9,283,9,16,-7
5,9,284,22,7,15
5,9,285,6,7,-1
5,9,286,11,10,1
5,9,287,10,11,-1
5,9,288,14,6,8
5,9,289,12,17,-5
5,9,290,19,11,8
5,9,291,9,5,4
5,9,292,13,8,5
5,9,293,26,11,15
5,9,294,11,10,1
5,9,295,12,8,4
5,9,296,8,3,5
5,9,297,20,11,9
5,9,298,16,17,-1
5,9,299,11,9,2
5,10,0,11,28,-17
5,10,1,12,13,-1
5,10,2,30,20,10
5,10,3,10,10,0
5,10,4,14,13,1
5,10,5,25,9,16
5,10,6,16,14,2
5,10,7,20,25,-5
5,10,8,19,9,10
5,10,9,5,14,-9
5,10,10,7,8,-1
5,10,11,20,25,-5
5,10,12,7,10,-3
5,10,13,22,15,7
5,10,14,11,7,4
5,10,15,16,16,0
5,10,16,16,12,4
5,10,17,10,7,3
5,10,18,9,23,-14
5,10,19,26,13,13
5,10,20,20,11,9
5,10,21,22,19,3
5,10,22,15,7,8
5,10,23,14,11,3
5,10,24,21,19,2
5,10,25,20,18,2
5,10,26,19,14,5
5,10,27,16,12,4
5,10,28,26,14,12
5,10,29,11,17,-6
5,10,30,4,7,-3
5,10,31,8,16,-8
5,10,32,15,12,3
5,10,33,19,23,-4
5,10,34,21,24,-3
5,10,35,15,11,4
5,10,36,19,17,2
5,10,37,9,10,-1
5,10,38,12,10,2
5,10,39,12,10,2
5,10,40,19,10,9
5,10,41,10,8,2
5,10,42,15,26,-11
5,10,43,14,7,7
5,10,44,8,12,-4
5,10,45,15,10,5
5,10,46,5,5,0
5,10,47,10,9,1
5,10,48,18,12,6
5,10,49,31,27,4
5,10,50,7,7,0
5,10,51,22,16,6
5,10,52,14,21,-7
5,10,53,21,17,4
5,10,54,8,12,-4
5,10,55,16,10,6
5,10,56,7,14,-7
5,10,57,20,14,6
5,10,58,11,12,-1
5,10,59,4,9,-5
5,10,60,10,20,-10
5,10,61,8,13,-5
5,10,62,20,15,5
5,10,63,13,25,-12
5,10,64,14,11,3
5,10,65,20,2,18
5,10,66,15,16,-1
5,10,67,26,16,10
5,10,68,9,14,-5
5,10,69,8,17,-9
5,10,70,19,16,3
5,10,71,6,8,-2
5,10,72,4,13,-9
5,10,73,14,19,-5
5,10,74,19,21,-2
5,10,75,25,13,12
5,10,76,18,17,1
5,10,77,15,18,-3
5,10,78,11,7,4
5,10,79,17,13,4
5,10,80,16,9,7
5,10,81,8,14,-6
5,10,82,12,8,4
5,10,83,21,7,14
5,10,84,10,10,0
5,10,85,8,9,-1
5,10,86,27,16,11
5,10,87,12,10,2
5,10,88,27,11,16
5,10,89,19,21,-2
5,10,90,8,10,-2
5,10,91,11,16,-5
5,10,92,5,7,-2
5,10,93,19,26,-7
5,10,94,15,9,6
5,10,95,17,12,5
5,10,96,13,15,-2
5,10,97,14,8,6
5,10,98,7,11,-4
5,10,99,8,9,-1
5,10,100,16,14,2
5,10,101,5,4,1
5,10,102,18,33,-15
5,10,103,26,24,2
5,10,104,18,17,1
5,10,105,13,12,1
5,10,106,10,7,3
5,10,107,7,9,-2
5,10,108,16,18,-2
5,10,109,11,17,-6
5,10,110,11,7,4
5,10,111,11,7,4
5,10,112,14,12,2
5,10,113,12,10,2
5,10,114,9,14,-5
5,10,115,12,13,-1
5,10,116,22,22,0
5,10,117,12,9,3
5,10,118,16,15,1
5,10,119,5,13,-8
5,10,120,10,14,-4
5,10,121,9,9,0
5,10,122,17,15,2
5,10,123,18,17,1
5,10,124,19,6,13
5,10,125,10,10,0
5,10,126,6,7,-1
5,10,127,20,12,8
5,10,128,18,12,6
5,10,129,14,12,2
5,10,130,15,11,4
5,10,131,9,8,1
5,10,132,12,8,4
5,10,133,10,14,-4
5,10,134,9,18,-9
5,10,135,8,12,-4
5,10,136,18,15,3
5,10,137,13,6,7
5,10,138,24,9,15
5,10,139,5,8,-3
5,10,140,19,15,4
5,10,141,10,18,-8
5,10,142,12,14,-2
5,10,143,12,15,-3
5,10,144,17,6,11
5,10,145,19,17,2
5,10,146,6,15,-9
5,10,147,16,9,7
5,10,148,13,22,-9
5,10,149,11,14,-3
5,10,150,13,13,0
5,10,151,7,14,-7
5,10,152,18,10,8
5,10,153,13,10,3
5,10,154,13,13,0
5,10,155,20,14,6
5,10,156,16,11,5
5,10,157,20,20,0
5,10,158,22,22,0
5,10,159,17,16,1
5,10,160,13,18,-5
5,10,161,21,25,-4
5,10,162,11,21,-10
5,10,163,12,12,0
5,10,164,5,8,-3
5,10,165,9,12,-3
5,10,166,30,6,24
5,10,167,11,14,-3
5,10,168,21,17,4
5,10,169,20,14,6
5,10,170,19,10,9
5,10,171,15,5,10
5,10,172,24,15,9
5,10,173,19,15,4
5,10,174,10,6,4
5,10,175,8,5,3
5,10,176,31,21,10
5,10,177,13,9,4
5,10,178,21,23,-2
5,10,179,17,10,7
5,10,180,14,32,-18
5,10,181,22,16,6
5,10,182,35,28,7
5,10,183,19,17,2
5,10,184,22,6,16
5,10,185,13,12,1
5,10,186,20,12,8
5,10,187,21,12,9
5,10,188,20,17,3
5,10,189,8,12,-4
5,10,190,11,9,2
5,10,191,16,10,6
5,10,192,10,11,-1
5,10,193,18,8,10
5,10,194,8,11,-3
5,10,195,13,6,7
5,10,196,10,9,1
5,10,197,23,8,15
5,10,198,10,23,-13
5,10,199,10,22,-12
5,10,200,26,18,8
5,10,201,6,19,-13
5,10,202,15,9,6
5,10,203,17,7,10
5,10,204,30,18,12
5,10,205,25,31,-6
5,10,206,12,9,3
5,10,207,11,10,1
5,10,208,5,6,-1
5,10,209,20,10,10
5,10,210,15,20,-5
5,10,211,12,11,1
5,10,212,17,21,-4
5,10,213,16,10,6
5,10,214,15,15,0
5,10,215,10,10,0
5,10,216,3,4,-1
5,10,217,11,21,-10
5,10,218,21,23,-2
5,10,219,10,10,0
5,10,220,24,23,1
5,10,221,10,15,-5
5,10,222,24,14,10
5,10,223,10,11,-1
5,10,224,14,16,-2
5,10,225,9,3,6
5,10,226,9,6,3
5,10,227,16,22,-6
5,10,228,22,13,9
5,10,229,17,13,4
5,10,230,24,18,6
5,10,231,27,18,9
5,10,232,21,25,-4
5,10,233,16,15,1
5,10,234,12,11,1
5,10,235,21,6,15
5,10,236,14,12,2
5,10,237,27,15,12
5,10,238,16,17,-1
5,10,239,11,6,5
5,10,240,23,12,11
5,10,241,18,16,2
5,10,242,13,9,4
5,10,243,12,15,-3
5,10,244,21,13,8
5,10,245,21,25,-4
5,10,246,9,9,0
5,10,247,14,15,-1
5,10,248,9,5,4
5,10,249,12,12,0
5,10,250,15,17,-2
5,10,251,12,11,1
5,10,252,19,22,-3
5,10,253,18,24,-6
5,10,254,14,14,0
5,10,255,16,16,0
5,10,256,20,7,13
5,10,257,23,9,14
5,10,258,24,18,6
5,10,259,8,3,5
5,10,260,13,7,6
5,10,261,19,17,2
5,10,262,20,11,9
5,10,263,6,9,-3
5,10,264,14,15,-1
5,10,265,8,5,3
5,10,266,5,13,-8
5,10,267,16,8,8
5,10,268,6,8,-2
5,10,269,14,9,5
5,10,270,11,9,2
5,10,271,7,15,-8
5,10,272,13,19,-6
5,10,273,20,3,17
5,10,274,24,15,9
5,10,275,17,5,12
5,10,276,6,13,-7
5,10,277,11,16,-5
5,10,278,16,18,-2
5,10,279,19,10,9
5,10,280,7,16,-9
5,10,281,12,11,1
5,10,282,12,8,4
5,10,283,14,15,-1
5,10,284,11,14,-3
5,10,285,24,29,-5
5,10,286,12,13,-1
5,10,287,17,9,8
5,10,288,3,7,-4
5,10,289,30,11,19
5,10,290,26,10,16
5,10,291,18,14,4
5,10,292,21,14,7
5,10,293,5,10,-5
5,10,294,14,7,7
5,10,295,12,27,-15
5,10,296,16,5,11
5,10,297,20,16,4
5,10,298,26,32,-6
5,10,299,15,12,3
5,11,0,7,5,2
5,11,1,22,11,11
5,11,2,22,10,12
5,11,3,13,27,-14
5,11,4,11,8,3
5,11,5,11,9,2
5,11,6,10,8,2
5,11,7,9,16,-7
5,11,8,28,12,16
5,11,9,14,18,-4
5,11,10,19,11,8
5,11,11,15,10,5
5,11,12,18,9,9
5,11,13,13,25,-12
5,11,14,15,15,0
5,11,15,18,15,3
5,11,16,13,12,1
5,11,17,12,7,5
5,11,18,12,17,-5
5,11,19,18,6,12
5,11,20,17,4,13
5,11,21,14,16,-2
5,11,22,6,10,-4
5,11,23,14,11,3
5,11,24,3,9,-6
5,11,25,11,5,6
5,11,26,16,13,3
5,11,27,16,23,-7
5,11,28,12,14,-2
5,11,29,15,18,-3
5,11,30,19,4,15
5,11,31,24,6,18
5,11,32,10,12,-2
5,11,33,11,19,-8
5,11,34,29,13,16
5,11,35,16,11,5
5,11,36,17,13,4
5,11,37,10,6,4
5,11,38,18,18,0
5,11,39,14,22,-8
5,11,40,19,17,2
5,11,41,22,24,-2
5,11,42,12,11,1
5,11,43,10,9,1
5,11,44,11,11,0
5,11,45,17,22,-5
5,11,46,7,4,3
5,11,47,25,19,6
5,11,48,25,8,17
5,11,49,11,11,0
5,11,50,18,21,-3
5,11,51,21,20,1
5,11,52,13,11,2
5,11,53,19,13,6
5,11,54,17,10,7
5,11,55,16,16,0
5,11,56,20,15,5
5,11,57,28,13,15
5,11,58,12,18,-6
5,11,59,7,10,-3
5,11,60,14,11,3
5,11,61,12,5,7
5,11,62,15,14,1
5,11,63,19,14,5
5,11,64,7,8,-1
5,11,65,16,7,9
5,11,66,29,26,3
5,11,67,26,10,16
5,11,68,15,8,7
5,11,69,21,30,-9
5,11,70,10,10,0
5,11,71,11,19,-8
5,11,72,11,8,3
5,11,73,32,7,25
5,11,74,19,17,2
5,11,75,13,23,-10
5,11,76,20,13,7
5,11,77,14,16,-2
5,11,78,11,13,-2
5,11,79,17,23,-6
5,11,80,9,6,3
5,11,81,6,7,-1
5,11,82,9,9,0
5,11,83,3,11,-8
5,11,84,7,11,-4
5,11,85,11,6,5
5,11,86,18,5,13
5,11,87,26,23,3
5,11,88,17,12,5
5,11,89,15,10,5
5,11,90,15,9,6
5,11,91,10,13,-3
5,11,92,16,9,7
5,11,93,15,9,6
5,11,94,26,16,10
5,11,95,14,26,-12
5,11,96,20,19,1
5,11,97,12,8,4
5,11,98,15,18,-3
5,11,99,11,4,7
5,11,100,13,16,-3
5,11,101,11,9,2
5,11,102,23,23,0
5,11,103,15,18,-3
5,11,104,15,9,6
5,11,105,15,16,-1
5,11,106,27,13,14
5,11,107,8,7,1
5,11,108,30,22,8
5,11,109,27,8,19
5,11,110,15,8,7
5,11,111,11,10,1
5,11,112,11,26,-15
5,11,113,18,7,11
5,11,114,14,11,3
5,11,115,22,33,-11
5,11,116,14,14,0
5,11,117,16,14,2
5,11,118,20,7,13
5,11,119,10,22,-12
5,11,120,14,6,8
5,11,121,16,10,6
5,11,122,24,12,12
5,11,123,23,24,-1
5,11,124,8,7,1
5,11,125,17,18,-1
5,11,126,11,2,9
5,11,127,13,22,-9
5,11,128,8,13,-5
5,11,129,15,10,5
5,11,130,18,16,2
5,11,131,22,15,7
5,11,132,25,7,18
5,11,133,9,5,4
5,11,134,25,13,12
5,11,135,14,11,3
5,11,136,16,17,-1
5,11,137,15,12,3
5,11,138,12,16,-4
5,11,139,14,8,6
5,11,140,12,16,-4
5,11,141,16,23,-7
5,11,142,11,7,4
5,11,143,17,15,2
5,11,144,15,15,0
5,11,145,13,18,-5
5,11,146,15,13,2
5,11,147,19,20,-1
5,11,148,28,24,4
5,11,149,7,16,-9
5,11,150,11,14,-3
5,11,151,9,20,-11
5,11,152,18,8,10
5,11,153,21,23,-2
5,11,154,15,10,5
5,11,155,21,24,-3
5,11,156,17,18,-1
5,11,157,16,17,-1
5,11,158,16,15,1
5,11,159,18,19,-1
5,11,160,10,10,0
5,11,161,15,11,4
5,11,162,15,8,7
5,11,163,7,11,-4
5,11,164,23,26,-3
5,11,165,9,10,-1
5,11,166,13,20,-7
5,11,167,14,16,-2
5,11,168,2,6,-4
5,11,169,19,10,9
5,11,170,22,17,5
5,11,171,19,8,11
5,11,172,18,16,2
5,11,173,18,11,7
5,11,174,24,9,15
5,11,175,15,22,-7
5,11,176,15,10,5
5,11,177,14,11,3
5,11,178,12,8,4
5,11,179,25,12,13
5,11,180,16,20,-4
5,11,181,22,4,18
5,11,182,21,12,9
5,11,183,14,11,3
5,11,184,12,21,-9
5,11,185,13,9,4
5,11,186,12,9,3
5,11,187,5,8,-3
5,11,188,23,22,1
5,11,189,23,22,1
5,11,190,21,17,4
5,11,191,7,6,1
5,11,192,16,27,-11
5,11,193,14,11,3
5,11,194,23,18,5
5,11,195,32,18,14
5,11,196,15,15,0
5,11,197,17,10,7
5,11,198,15,8,7
5,11,199,20,12,8
5,11,200,25,17,8
5,11,201,19,25,-6
5,11,202,22,12,10
5,11,203,12,10,2
5,11,204,13,10,3
5,11,205,19,18,1
5,11,206,12,21,-9
5,11,207,27,15,12
5,11,208,10,15,-5
5,11,209,10,18,-8
5,11,210,12,17,-5
5,11,211,37,17,20
5,11,212,25,17,8
5,11,213,12,8,4
5,11,214,21,19,2
5,11,215,25,14,11
5,11,216,11,10,1
5,11,217,20,14,6
5,11,218,20,23,-3
5,11,219,27,14,13
5,11,220,10,16,-6
5,11,221,5,13,-8
5,11,222,19,10,9
5,11,223,10,12,-2
5,11,224,11,15,-4
5,11,225,14,15,-1
5,11,226,11,10,1
5,11,227,5,1,4
5,11,228,12,7,5
5,11,229,11,11,0
5,11,230,13,18,-5
5,11,231,10,8,2
5,11,232,8,4,4
5,11,233,14,12,2
5,11,234,19,8,11
5,11,235,22,11,11
5,11,236,17,8,9
5,11,237,17,15,2
5,11,238,17,14,3
5,11,239,13,12,1
5,11,240,16,17,-1
5,11,241,14,6,8
5,11,242,13,9,4
5,11,243,14,21,-7
5,11,244,10,20,-10
5,11,245,11,12,-1
5,11,246,12,7,5
5,11,247,15,13,2
5,11,248,10,7,3
5,11,249,12,9,3
5,11,250,19,13,6
5,11,251,24,26,-2
5,11,252,2,10,-8
5,11,253,12,12,0
5,11,254,10,19,-9
5,11,255,21,18,3
5,11,256,31,13,18
5,11,257,22,14,8
5,11,258,24,17,7
5,11,259,9,8,1
5,11,260,17,12,5
5,11,261,13,14,-1
5,11,262,17,12,5
5,11,263,17,16,1
5,11,264,14,16,-2
5,11,265,17,21,-4
5,11,266,14,8,6
5,11,267,10,12,-2
5,11,268,17,12,5
5,11,269,22,17,5
5,11,270,6,4,2
5,11,271,7,5,2
5,11,272,13,9,4
5,11,273,23,5,18
5,11,274,12,2,10
5,11,275,12,3,9
5,11,276,9,7,2
5,11,277,25,8,17
5,11,278,12,16,-4
5,11,279,24,7,17
5,11,280,9,12,-3
5,11,281,8,9,-1
5,11,282,22,18,4
5,11,283,11,12,-1
5,11,284,9,7,2
5,11,285,20,14,6
5,11,286,9,14,-5
5,11,287,15,16,-1
5,11,288,16,11,5
5,11,289,18,9,9
5,11,290,22,8,14
5,11,291,17,9,8
5,11,292,29,11,18
5,11,293,6,3,3
5,11,294,16,19,-3
5,11,295,20,21,-1
5,11,296,20,12,8
5,11,297,26,30,-4
5,11,298,15,29,-14
5,11,299,12,11,1
5,12,0,14,14,0
5,12,1,10,9,1
5,12,2,12,6,6
5,12,3,14,21,-7
5,12,4,20,12,8
5,12,5,5,12,-7
5,12,6,18,14,4
5,12,7,16,10,6
5,12,8,17,11,6
5,12,9,8,17,-9
5,12,10,23,12,11
5,12,11,15,16,-1
5,12,12,9,6,3
5,12,13,20,14,6
5,12,14,19,12,7
5,12,15,13,14,-1
5,12,16,20,8,12
5,12,17,14,14,0
5,12,18,10,5,5
5,12,19,19,8,11
5,12,20,12,14,-2
5,12,21,12,19,-7
5,12,22,24,18,6
5,12,23,14,11,3
5,12,24,20,12,8
5,12,25,25,17,8
5,12,26,20,22,-2
5,12,27,16,22,-6
5,12,28,11,12,-1
5,12,29,12,16,-4
5,12,30,9,13,-4
5,12,31,11,6,5
5,12,32,14,18,-4
5,12,33,21,10,11
5,12,34,9,17,-8
5,12,35,25,10,15
5,12,36,36,29,7
5,12,37,10,8,2
5,12,38,32,8,24
5,12,39,24,22,2
5,12,40,18,9,9
5,12,41,15,14,1
5,12,42,22,9,13
5,12,43,9,10,-1
5,12,44,17,5,12
5,12,45,17,15,2
5,12,46,19,15,4
5,12,47,13,22,-9
5,12,48,13,17,-4
5,12,49,8,21,-13
5,12,50,11,7,4
5,12,51,17,10,7
5,12,52,9,9,0
5,12,53,11,17,-6
5,12,54,14,8,6
5,12,55,10,10,0
5,12,56,22,19,3
5,12,57,17,8,9
5,12,58,26,14,12
5,12,59,14,7,7
5,12,60,15,13,2
5,12,61,7,5,2
5,12,62,26,9,17
5,12,63,12,4,8
5,12,64,16,9,7
5,12,65,11,16,-5
5,12,66,16,11,5
5,12,67,20,15,5
5,12,68,13,6,7
5,12,69,16,13,3
5,12,70,7,15,-8
5,12,71,6,13,-7
5,12,72,13,10,3
5,12,73,13,11,2
5,12,74,16,18,-2
5,12,75,12,5,7
5,12,76,17,15,2
5,12,77,12,6,6
5,12,78,30,7,23
5,12,79,26,15,11
5,12,80,20,18,2
5,12,81,14,21,-7
5,12,82,13,8,5
5,12,83,15,14,1
5,12,84,20,16,4
5,12,85,10,11,-1
5,12,86,22,15,7
5,12,87,13,6,7
5,12,88,11,11,0
5,12,89,10,13,-3
5,12,90,30,18,12
5,12,91,14,14,0
5,12,92,23,23,0
5,12,93,20,16,4
5,12,94,11,10,1
5,12,95,8,7,1
5,12,96,21,18,3
5,12,97,26,20,6
5,12,98,22,13,9
5,12,99,22,7,15
5,12,100,20,14,6
5,12,101,18,13,5
5,12,102,18,15,3
5,12,103,7,10,-3
5,12,104,8,5,3
5,12,105,17,11,6
5,12,106,17,20,-3
5,12,107,11,15,-4
5,12,108,11,20,-9
5,12,109,22,12,10
5,12,110,19,13,6
5,12,111,16,5,11
5,12,112,20,12,8
5,12,113,5,12,-7
5,12,114,14,17,-3
5,12,115,23,10,13
5,12,116,7,9,-2
5,12,117,12,5,7
5,12,118,9,10,-1
5,12,119,5,17,-12
5,12,120,16,17,-1
5,12,121,24,22,2
5,12,122,13,7,6
5,12,123,17,18,-1
5,12,124,14,7,7
5,12,125,16,21,-5
5,12,126,21,25,-4
5,12,127,26,16,10
5,12,128,31,23,8
5,12,129,9,16,-7
5,12,130,2,20,-18
5,12,131,31,6,25
5,12,132,20,16,4
5,12,133,28,14,14
5,12,134,30,21,9
5,12,135,13,7,6
5,12,136,12,9,3
5,12,137,17,19,-2
5,12,138,15,22,-7
5,12,139,12,16,-4
5,12,140,7,13,-6
5,12,141,20,12,8
5,12,142,15,14,1
5,12,143,11,10,1
5,12,144,6,13,-7
5,12,145,5,2,3
5,12,146,10,6,4
5,12,147,13,16,-3
5,12,148,9,22,-13
5,12,149,21,20,1
5,12,150,8,11,-3
5,12,151,14,18,-4
5,12,152,14,6,8
5,12,153,14,8,6
5,12,154,13,12,1
5,12,155,17,17,0
5,12,156,17,8,9
5,12,157,10,11,-1
5,12,158,17,22,-5
5,12,159,15,10,5
5,12,160,18,15,3
5,12,161,19,16,3
5,12,162,15,10,5
5,12,163,5,8,-3
5,12,164,7,16,-9
5,12,165,24,8,16
5,12,166,29,11,18
5,12,167,16,17,-1
5,12,168,12,10,2
5,12,169,27,9,18
5,12,170,19,15,4
5,12,171,21,14,7
5,12,172,16,8,8
5,12,173,16,12,4
5,12,174,21,12,9
5,12,175,19,12,7
5,12,176,28,15,13
5,12,177,13,18,-5
5,12,178,13,18,-5
5,12,179,22,3,19
5,12,180,23,17,6
5,12,181,8,10,-2
5,12,182,14,13,1
5,12,183,24,19,5
5,12,184,19,15,4
5,12,185,16,17,-1
5,12,186,16,7,9
5,12,187,20,27,-7
5,12,188,12,9,3
5,12,189,16,10,6
5,12,190,13,24,-11
5,12,191,14,10,4
5,12,192,13,10,3
5,12,193,18,14,4
5,12,194,11,10,1
5,12,195,13,17,-4
5,12,196,13,17,-4
5,12,197,20,17,3
5,12,198,14,7,7
5,12,199,25,8,17
5,12,200,17,13,4
5,12,201,19,17,2
5,12,202,12,14,-2
5,12,203,17,28,-11
5,12,204,16,13,3
5,12,205,16,8,8
5,12,206,30,28,2
5,12,207,15,10,5
5,12,208,21,9,12
5,12,209,10,15,-5
5,12,210,16,9,7
5,12,211,8,16,-8
5,12,212,17,16,1
5,12,213,8,13,-5
5,12,214,9,3,6
5,12,215,9,13,-4
5,12,216,12,4,8
5,12,217,9,13,-4
5,12,218,17,17,0
5,12,219,10,10,0
5,12,220,8,14,-6
5,12,221,25,10,15
5,12,222,7,6,1
5,12,223,20,11,9
5,12,224,16,13,3
5,12,225,7,13,-6
5,12,226,19,20,-1
5,12,227,17,18,-1
5,12,228,12,17,-5
5,12,229,16,18,-2
5,12,230,8,4,4
5,12,231,21,13,8
5,12,232,13,13,0
5,12,233,23,16,7
5,12,234,16,10,6
5,12,235,9,15,-6
5,12,236,22,15,7
5,12,237,25,17,8
5,12,238,13,8,5
5,12,239,21,12,9
5,12,240,23,12,11
5,12,241,23,10,13
5,12,242,21,16,5
5,12,243,21,21,0
5,12,244,11,20,-9
5,12,245,20,23,-3
5,12,246,15,20,-5
5,12,247,14,10,4
5,12,248,9,7,2
5,12,249,25,20,5
5,12,250,13,13,0
5,12,251,14,13,1
5,12,252,14,11,3
5,12,253,27,13,14
5,12,254,16,15,1
5,12,255,14,10,4
5,12,256,20,10,10
5,12,257,18,22,-4
5,12,258,15,5,10
5,12,259,19,12,7
5,12,260,14,9,5
5,12,261,19,24,-5
5,12,262,6,6,0
5,12,263,26,17,9
5,12,264,21,7,14
5,12,265,24,14,10
5,12,266,15,14,1
5,12,267,11,8,3
5,12,268,27,13,14
5,12,269,23,17,6
5,12,270,16,12,4
5,12,271,17,21,-4
5,12,272,20,19,1
5,12,273,8,14,-6
5,12,274,19,17,2
5,12,275,6,4,2
5,12,276,17,19,-2
5,12,277,11,15,-4
5,12,278,14,15,-1
5,12,279,19,11,8
5,12,280,29,6,23
5,12,281,15,8,7
5,12,282,11,7,4
5,12,283,14,3,11
5,12,284,13,3,10
5,12,285,14,15,-1
5,12,286,9,8,1
5,12,287,13,20,-7
5,12,288,28,12,16
5,12,289,17,14,3
5,12,290,5,10,-5
5,12,291,11,9,2
5,12,292,20,12,8
5,12,293,28,14,14
5,12,294,11,6,5
5,12,295,3,22,-19
5,12,296,12,14,-2
5,12,297,9,17,-8
5,12,298,13,15,-2
5,12,299,5,9,-4
5,13,0,15,5,10
5,13,1,18,25,-7
5,13,2,20,25,-5
5,13,3,11,10,1
5,13,4,8,8,0
5,13,5,21,7,14
5,13,6,29,17,12
5,13,7,23,15,8
5,13,8,21,4,17
5,13,9,22,19,3
5,13,10,11,18,-7
5,13,11,20,17,3
5,13,12,26,18,8
5,13,13,9,11,-2
5,13,14,20,15,5
5,13,15,21,18,3
5,13,16,11,7,4
5,13,17,15,28,-13
5,13,18,15,26,-11
5,13,19,13,14,-1
5,13,20,9,9,0
5,13,21,15,15,0
5,13,22,11,13,-2
5,13,23,23,14,9
5,13,24,15,6,9
5,13,25,22,15,7
5,13,26,21,16,5
5,13,27,13,13,0
5,13,28,28,20,8
5,13,29,22,20,2
5,13,30,16,24,-8
5,13,31,22,18,4
5,13,32,22,27,-5
5,13,33,8,8,0
5,13,34,3,10,-7
5,13,35,21,12,9
5,13,36,19,20,-1
5,13,37,10,5,5
5,13,38,21,17,4
5,13,39,17,19,-2
5,13,40,14,7,7
5,13,41,36,12,24
5,13,42,15,17,-2
5,13,43,16,18,-2
5,13,44,13,26,-13
5,13,45,25,11,14
5,13,46,23,14,9
5,13,47,12,4,8
5,13,48,17,4,13
5,13,49,35,10,25
5,13,50,27,12,15
5,13,51,19,9,10
5,13,52,14,9,5
5,13,53,14,19,-5
5,13,54,7,4,3
5,13,55,24,13,11
5,13,56,7,5,2
5,13,57,34,24,10
5,13,58,36,21,15
5,13,59,14,6,8
5,13,60,16,9,7
5,13,61,19,22,-3
5,13,62,24,11,13
5,13,63,23,22,1
5,13,64,18,21,-3
5,13,65,17,10,7
5,13,66,34,20,14
5,13,67,10,17,-7
5,13,68,16,21,-5
5,13,69,7,9,-2
5,13,70,18,11,7
5,13,71,19,15,4
5,13,72,20,20,0
5,13,73,21,8,13
5,13,74,9,3,6
5,13,75,25,16,9
5,13,76,27,17,10
5,13,77,17,7,10
5,13,78,12,6,6
5,13,79,48,16,32
5,13,80,16,16,0
5,13,81,34,11,23
5,13,82,20,13,7
5,13,83,30,18,12
5,13,84,18,14,4
5,13,85,8,14,-6
5,13,86,16,28,-12
5,13,87,19,17,2
5,13,88,19,9,10
5,13,89,15,16,-1
5,13,90,13,11,2
5,13,91,23,21,2
5,13,92,11,9,2
5,13,93,8,7,1
5,13,94,16,26,-10
5,13,95,23,25,-2
5,13,96,12,12,0
5,13,97,6,8,-2
5,13,98,18,27,-9
5,13,99,22,22,0
5,13,100,14,22,-8
5,13,101,22,9,13
5,13,102,18,8,10
5,13,103,15,8,7
5,13,104,27,28,-1
5,13,105,19,23,-4
5,13,106,11,3,8
5,13,107,15,22,-7
5,13,108,15,19,-4
5,13,109,20,17,3
5,13,110,30,32,-2
5,13,111,15,4,11
5,13,112,24,17,7
5,13,113,8,17,-9
5,13,114,19,22,-3
5,13,115,22,3,19
5,13,116,26,16,10
5,13,117,21,18,3
5,13,118,16,15,1
5,13,119,5,6,-1
5,13,120,18,16,2
5,13,121,12,10,2
5,13,122,15,12,3
5,13,123,28,16,12
5,13,124,14,20,-6
5,13,125,24,10,14
5,13,126,26,9,17
5,13,127,13,11,2
5,13,128,13,11,2
5,13,129,19,16,3
5,13,130,26,18,8
5,13,131,21,17,4
5,13,132,9,6,3
5,13,133,29,15,14
5,13,134,13,17,-4
5,13,135,21,24,-3
5,13,136,14,13,1
5,13,137,23,14,9
5,13,138,25,14,11
5,13,139,20,12,8
5,13,140,20,9,11
5,13,141,22,7,15
5,13,142,25,8,17
5,13,143,15,28,-13
5,13,144,5,12,-7
5,13,145,14,11,3
5,13,146,19,18,1
5,13,147,11,13,-2
5,13,148,12,25,-13
5,13,149,20,9,11
5,13,150,4,11,-7
5,13,151,10,17,-7
5,13,152,23,23,0
5,13,153,22,10,12
5,13,154,20,5,15
5,13,155,9,18,-9
5,13,156,16,8,8
5,13,157,13,5,8
5,13,158,16,5,11
5,13,159,6,16,-10
5,13,160,13,18,-5
5,13,161,12,11,1
5,13,162,7,13,-6
5,13,163,30,9,21
5,13,164,9,13,-4
5,13,165,18,16,2
5,13,166,20,21,-1
5,13,167,10,17,-7
5,13,168,25,12,13
5,13,169,22,22,0
5,13,170,10,12,-2
5,13,171,8,10,-2
5,13,172,20,18,2
5,13,173,10,7,3
5,13,174,28,16,12
5,13,175,22,18,4
5,13,176,14,10,4
5,13,177,22,19,3
5,13,178,13,7,6
5,13,179,11,10,1
5,13,180,23,8,15
5,13,181,16,15,1
5,13,182,18,13,5
5,13,183,14,14,0
5,13,184,39,17,22
5,13,185,15,2,13
5,13,186,3,4,-1
5,13,187,35,20,15
5,13,188,19,15,4
5,13,189,18,14,4
5,13,190,15,13,2
5,13,191,21,31,-10
5,13,192,14,1,13
5,13,193,16,18,-2
5,13,194,19,15,4
5,13,195,12,10,2
5,13,196,22,12,10
5,13,197,5,8,-3
5,13,198,22,11,11
5,13,199,14,6,8
5,13,200,16,8,8
5,13,201,14,22,-8
5,13,202,21,22,-1
5,13,203,14,11,3
5,13,204,7,5,2
5,13,205,14,5,9
5,13,206,6,1,5
5,13,207,18,10,8
5,13,208,15,18,-3
5,13,209,11,8,3
5,13,210,17,12,5
5,13,211,15,12,3
5,13,212,27,7,20
5,13,213,14,14,0
5,13,214,16,15,1
5,13,215,33,16,17
5,13,216,27,8,19
5,13,217,23,9,14
5,13,218,13,12,1
5,13,219,8,6,2
5,13,220,15,19,-4
5,13,221,16,19,-3
5,13,222,21,11,10
5,13,223,21,15,6
5,13,224,24,18,6
5,13,225,18,9,9
5,13,226,22,9,13
5,13,227,9,7,2
5,13,228,11,14,-3
5,13,229,23,9,14
5,13,230,18,28,-10
5,13,231,12,12,0
5,13,232,10,13,-3
5,13,233,3,6,-3
5,13,234,20,16,4
5,13,235,21,8,13
5,13,236,16,7,9
5,13,237,9,2,7
5,13,238,27,21,6
5,13,239,14,23,-9
5,13,240,22,16,6
5,13,241,20,13,7
5,13,242,20,16,4
5,13,243,15,17,-2
5,13,244,29,13,16
5,13,245,16,15,1
5,13,246,14,15,-1
5,13,247,7,8,-1
5,13,248,23,22,1
5,13,249,14,20,-6
5,13,250,14,6,8
5,13,251,19,11,8
5,13,252,16,18,-2
5,13,253,29,8,21
5,13,254,15,8,7
5,13,255,4,5,-1
5,13,256,25,11,14
5,13,257,18,15,3
5,13,258,12,4,8
5,13,259,17,18,-1
5,13,260,7,8,-1
5,13,261,23,9,14
5,13,262,23,24,-1
5,13,263,13,7,6
5,13,264,14,12,2
5,13,265,17,17,0
5,13,266,35,22,13
5,13,267,11,16,-5
5,13,268,11,21,-10
5,13,269,14,20,-6
5,13,270,13,12,1
5,13,271,22,12,10
5,13,272,11,15,-4
5,13,273,21,22,-1
5,13,274,14,8,6
5,13,275,10,4,6
5,13,276,28,23,5
5,13,277,11,20,-9
5,13,278,20,11,9
5,13,279,16,12,4
5,13,280,12,7,5
5,13,281,19,13,6
5,13,282,21,13,8
5,13,283,10,29,-19
5,13,284,10,7,3
5,13,285,14,12,2
5,13,286,19,10,9
5,13,287,15,3,12
5,13,288,5,7,-2
5,13,289,13,14,-1
5,13,290,27,9,18
5,13,291,17,12,5
5,13,292,13,8,5
5,13,293,6,10,-4
5,13,294,7,14,-7
5,13,295,23,16,7
5,13,296,13,7,6
5,13,297,12,15,-3
5,13,298,31,8,23
5,13,299,18,8,10
5,14,0,21,9,12
5,14,1,11,17,-6
5,14,2,9,7,2
5,14,3,12,14,-2
5,14,4,19,21,-2
5,14,5,14,10,4
5,14,6,9,8,1
5,14,7,10,8,2
5,14,8,19,8,11
5,14,9,21,11,10
5,14,10,15,6,9
5,14,11,10,10,0
5,14,12,12,12,0
5,14,13,15,7,8
5,14,14,14,8,6
5,14,15,16,17,-1
5,14,16,21,7,14
5,14,17,16,5,11
5,14,18,13,17,-4
5,14,19,30,29,1
5,14,20,23,11,12
5,14,21,16,7,9
5,14,22,22,23,-1
5,14,23,32,21,11
5,14,24,13,7,6
5,14,25,13,4,9
5,14,26,11,16,-5
5,14,27,20,11,9
5,14,28,42,9,33
5,14,29,17,8,9
5,14,30,7,8,-1
5,14,31,16,14,2
5,14,32,15,12,3
5,14,33,18,16,2
5,14,34,12,11,1
5,14,35,15,10,5
5,14,36,14,12,2
5,14,37,26,12,14
5,14,38,21,12,9
5,14,39,16,17,-1
5,14,40,39,11,28
5,14,41,17,11,6
5,14,42,12,7,5
5,14,43,5,7,-2
5,14,44,8,12,-4
5,14,45,15,7,8
5,14,46,15,16,-1
5,14,47,16,16,0
5,14,48,12,3,9
5,14,49,14,8,6
5,14,50,17,8,9
5,14,51,12,7,5
5,14,52,8,11,-3
5,14,53,15,9,6
5,14,54,16,23,-7
5,14,55,13,14,-1
5,14,56,21,11,10
5,14,57,20,18,2
5,14,58,18,20,-2
5,14,59,23,16,7
5,14,60,13,16,-3
5,14,61,20,17,3
5,14,62,13,15,-2
5,14,63,9,7,2
5,14,64,10,9,1
5,14,65,22,20,2
5,14,66,38,14,24
5,14,67,17,16,1
5,14,68,7,16,-9
5,14,69,20,20,0
5,14,70,22,21,1
5,14,71,18,16,2
5,14,72,17,13,4
5,14,73,27,11,16
5,14,74,24,17,7
5,14,75,16,12,4
5,14,76,30,24,6
5,14,77,12,12,0
5,14,78,25,17,8
5,14,79,18,13,5
5,14,80,13,9,4
5,14,81,19,15,4
5,14,82,21,8,13
5,14,83,10,11,-1
5,14,84,10,7,3
5,14,85,24,10,14
5,14,86,23,21,2
5,14,87,20,9,11
5,14,88,19,28,-9
5,14,89,17,10,7
5,14,90,14,8,6
5,14,91,14,6,8
5,14,92,24,14,10
5,14,93,5,17,-12
5,14,94,13,15,-2
5,14,95,14,18,-4
5,14,96,11,13,-2
5,14,97,8,11,-3
5,14,98,17,18,-1
5,14,99,12,10,2
5,14,100,21,7,14
5,14,101,9,12,-3
5,14,102,11,17,-6
5,14,103,11,12,-1
5,14,104,20,11,9
5,14,105,21,15,6
5,14,106,19,12,7
5,14,107,16,12,4
5,14,108,29,21,8
5,14,109,15,5,10
5,14,110,5,10,-5
5,14,111,17,11,6
5,14,112,21,15,6
5,14,113,16,5,11
5,14,114,11,20,-9
5,14,115,11,12,-1
5,14,116,19,8,11
5,14,117,10,8,2
5,14,118,21,23,-2
5,14,119,22,14,8
5,14,120,17,7,10
5,14,121,18,11,7
5,14,122,21,14,7
5,14,123,25,15,10
5,14,124,8,10,-2
5,14,125,15,13,2
5,14,126,8,5,3
5,14,127,11,16,-5
5,14,128,19,4,15
5,14,129,24,13,11
5,14,130,16,10,6
5,14,131,18,17,1
5,14,132,7,4,3
5,14,133,15,9,6
5,14,134,19,8,11
5,14,135,13,23,-10
5,14,136,14,16,-2
5,14,137,7,6,1
5,14,138,28,19,9
5,14,139,32,10,22
5,14,140,11,11,0
5,14,141,19,27,-8
5,14,142,15,4,11
5,14,143,14,8,6
5,14,144,22,19,3
5,14,145,11,17,-6
5,14,146,15,23,-8
5,14,147,18,23,-5
5,14,148,16,14,2
5,14,149,22,11,11
5,14,150,27,11,16
5,14,151,16,10,6
5,14,152,21,21,0
5,14,153,26,7,19
5,14,154,26,19,7
5,14,155,8,9,-1
5,14,156,14,18,-4
5,14,157,20,20,0
5,14,158,11,3,8
5,14,159,28,15,13
5,14,160,8,9,-1
5,14,161,29,7,22
5,14,162,15,20,-5
5,14,163,17,17,0
5,14,164,11,12,-1
5,14,165,15,14,1
5,14,166,25,18,7
5,14,167,20,12,8
5,14,168,27,20,7
5,14,169,12,15,-3
5,14,170,21,5,16
5,14,171,18,8,10
5,14,172,9,9,0
5,14,173,2,3,-1
5,14,174,19,14,5
5,14,175,17,17,0
5,14,176,7,5,2
5,14,177,14,18,-4
5,14,178,26,20,6
5,14,179,13,4,9
5,14,180,19,29,-10
5,14,181,12,10,2
5,14,182,18,15,3
5,14,183,11,4,7
5,14,184,15,11,4
5,14,185,2,16,-14
5,14,186,18,12,6
5,14,187,9,11,-2
5,14,188,17,15,2
5,14,189,17,7,10
5,14,190,14,11,3
5,14,191,20,16,4
5,14,192,12,20,-8
5,14,193,16,16,0
5,14,194,12,13,-1
5,14,195,24,17,7
5,14,196,21,20,1
5,14,197,19,11,8
5,14,198,30,13,17
5,14,199,10,6,4
5,14,200,28,12,16
5,14,201,24,9,15
5,14,202,18,26,-8
5,14,203,19,8,11
5,14,204,25,10,15
5,14,205,4,8,-4
5,14,206,13,15,-2
5,14,207,13,17,-4
5,14,208,17,12,5
5,14,209,7,5,2
5,14,210,13,5,8
5,14,211,20,21,-1
5,14,212,16,12,4
5,14,213,30,17,13
5,14,214,13,13,0
5,14,215,27,22,5
5,14,216,27,18,9
5,14,217,16,11,5
5,14,218,28,34,-6
5,14,219,19,29,-10
5,14,220,18,11,7
5,14,221,13,14,-1
5,14,222,20,14,6
5,14,223,16,6,10
5,14,224,27,16,11
5,14,225,16,5,11
5,14,226,15,8,7
5,14,227,18,8,10
5,14,228,14,17,-3
5,14,229,18,13,5
5,14,230,10,3,7
5,14,231,26,16,10
5,14,232,18,23,-5
5,14,233,8,14,-6
5,14,234,21,15,6
5,14,235,13,5,8
5,14,236,13,21,-8
5,14,237,22,12,10
5,14,238,10,8,2
5,14,239,18,9,9
5,14,240,12,13,-1
5,14,241,23,10,13
5,14,242,12,6,6
5,14,243,24,16,8
5,14,244,14,11,3
5,14,245,19,14,5
5,14,246,30,19,11
5,14,247,14,16,-2
5,14,248,4,6,-2
5,14,249,20,14,6
5,14,250,20,22,-2
5,14,251,30,15,15
5,14,252,8,13,-5
5,14,253,19,15,4
5,14,254,28,17,11
5,14,255,13,6,7
5,14,256,17,17,0
5,14,257,9,17,-8
5,14,258,16,14,2
5,14,259,31,17,14
5,14,260,17,18,-1
5,14,261,19,17,2
5,14,262,13,13,0
5,14,263,14,10,4
5,14,264,8,4,4
5,14,265,30,16,14
5,14,266,17,15,2
5,14,267,22,23,-1
5,14,268,15,11,4
5,14,269,29,11,18
5,14,270,31,11,20
5,14,271,13,16,-3
5,14,272,20,8,12
5,14,273,5,10,-5
5,14,274,18,18,0
5,14,275,28,8,20
5,14,276,18,16,2
5,14,277,9,7,2
5,14,278,14,9,5
5,14,279,24,17,7
5,14,280,17,13,4
5,14,281,33,18,15
5,14,282,12,19,-7
5,14,283,25,14,11
5,14,284,8,13,-5
5,14,285,17,17,0
5,14,286,14,15,-1
5,14,287,33,16,17
5,14,288,13,16,-3
5,14,289,20,10,10
5,14,290,21,16,5
5,14,291,20,13,7
5,14,292,19,17,2
5,14,293,17,17,0
5,14,294,4,3,1
5,14,295,44,10,34
5,14,296,11,3,8
5,14,297,13,9,4
5,14,298,20,8,12
5,14,299,31,7,24
5,15,0,15,11,4
5,15,1,15,7,8
5,15,2,18,13,5
5,15,3,20,20,0
5,15,4,13,3,10
5,15,5,20,9,11
5,15,6,17,9,8
5,15,7,16,20,-4
5,15,8,7,4,3
5,15,9,21,14,7
5,15,10,20,7,13
5,15,11,15,14,1
5,15,12,12,9,3
5,15,13,10,12,-2
5,15,14,16,6,10
5,15,15,18,14,4
5,15,16,15,10,5
5,15,17,7,13,-6
5,15,18,14,19,-5
5,15,19,18,16,2
5,15,20,21,15,6
5,15,21,15,11,4
5,15,22,17,19,-2
5,15,23,25,10,15
5,15,24,24,16,8
5,15,25,17,13,4
5,15,26,28,12,16
5,15,27,10,9,1
5,15,28,12,23,-11
5,15,29,21,12,9
5,15,30,9,9,0
5,15,31,22,21,1
5,15,32,25,5,20
5,15,33,12,6,6
5,15,34,7,16,-9
5,15,35,16,18,-2
5,15,36,14,6,8
5,15,37,20,9,11
5,15,38,18,13,5
5,15,39,11,18,-7
5,15,40,25,11,14
5,15,41,22,26,-4
5,15,42,13,2,11
5,15,43,19,13,6
5,15,44,20,19,1
5,15,45,34,12,22
5,15,46,13,14,-1
5,15,47,21,17,4
5,15,48,21,15,6
5,15,49,18,11,7
5,15,50,25,9,16
5,15,51,28,15,13
5,15,52,15,5,10
5,15,53,8,9,-1
5,15,54,15,22,-7
5,15,55,26,17,9
5,15,56,30,26,4
5,15,57,15,19,-4
5,15,58,23,12,11
5,15,59,9,11,-2
5,15,60,18,19,-1
5,15,61,10,7,3
5,15,62,25,11,14
5,15,63,12,11,1
5,15,64,30,21,9
5,15,65,10,19,-9
5,15,66,9,2,7
5,15,67,28,21,7
5,15,68,20,3,17
5,15,69,22,11,11
5,15,70,13,7,6
5,15,71,21,20,1
5,15,72,14,12,2
5,15,73,14,5,9
5,15,74,17,4,13
5,15,75,13,10,3
5,15,76,11,12,-1
5,15,77,13,9,4
5,15,78,15,8,7
5,15,79,24,10,14
5,15,80,24,17,7
5,15,81,25,13,12
5,15,82,19,10,9
5,15,83,21,12,9
5,15,84,13,7,6
5,15,85,22,21,1
5,15,86,24,8,16
5,15,87,20,9,11
5,15,88,12,20,-8
5,15,89,36,23,13
5,15,90,15,9,6
5,15,91,7,9,-2
5,15,92,19,18,1
5,15,93,18,15,3
5,15,94,7,17,-10
5,15,95,18,11,7
5,15,96,19,14,5
5,15,97,25,13,12
5,15,98,26,19,7
5,15,99,28,18,10
5,15,100,13,9,4
5,15,101,13,13,0
5,15,102,31,13,18
5,15,103,8,2,6
5,15,104,24,9,15
5,15,105,20,17,3
5,15,106,17,17,0
5,15,107,12,15,-3
5,15,108,14,8,6
5,15,109,13,8,5
5,15,110,9,13,-4
5,15,111,30,20,10
5,15,112,11,7,4
5,15,113,15,16,-1
5,15,114,11,10,1
5,15,115,4,10,-6
5,15,116,4,5,-1
5,15,117,12,10,2
5,15,118,26,10,16
5,15,119,13,10,3
5,15,120,10,11,-1
5,15,121,17,10,7
5,15,122,22,12,10
5,15,123,9,4,5
5,15,124,34,23,11
5,15,125,25,20,5
5,15,126,27,24,3
5,15,127,9,5,4
5,15,128,11,6,5
5,15,129,20,17,3
5,15,130,8,11,-3
5,15,131,27,15,12
5,15,132,31,13,18
5,15,133,27,9,18
5,15,134,16,16,0
5,15,135,8,1,7
5,15,136,27,17,10
5,15,137,27,19,8
5,15,138,37,12,25
5,15,139,26,24,2
5,15,140,25,18,7
5,15,141,15,21,-6
5,15,142,21,16,5
5,15,143,16,8,8
5,15,144,24,11,13
5,15,145,10,7,3
5,15,146,16,7,9
5,15,147,14,20,-6
5,15,148,19,17,2
5,15,149,23,14,9
5,15,150,23,14,9
5,15,151,18,11,7
5,15,152,24,18,6
5,15,153,10,9,1
5,15,154,23,13,10
5,15,155,25,16,9
5,15,156,10,8,2
5,15,157,21,27,-6
5,15,158,7,4,3
5,15,159,15,14,1
5,15,160,23,10,13
5,15,161,12,10,2
5,15,162,27,6,21
5,15,163,17,12,5
5,15,164,29,16,13
5,15,165,27,17,10
5,15,166,19,15,4
5,15,167,5,14,-9
5,15,168,30,5,25
5,15,169,13,6,7
5,15,170,15,11,4
5,15,171,15,8,7
5,15,172,9,13,-4
5,15,173,24,9,15
5,15,174,19,11,8
5,15,175,18,11,7
5,15,176,33,12,21
5,15,177,16,9,7
5,15,178,16,7,9
5,15,179,11,11,0
5,15,180,15,16,-1
5,15,181,15,11,4
5,15,182,17,10,7
5,15,183,6,8,-2
5,15,184,11,15,-4
5,15,185,13,20,-7
5,15,186,31,20,11
5,15,187,13,14,-1
5,15,188,28,8,20
5,15,189,20,22,-2
5,15,190,12,17,-5
5,15,191,25,18,7
5,15,192,20,8,12
5,15,193,17,13,4
5,15,194,7,7,0
5,15,195,22,14,8
5,15,196,9,10,-1
5,15,197,17,14,3
5,15,198,16,15,1
5,15,199,14,14,0
5,15,200,15,8,7
5,15,201,8,11,-3
5,15,202,11,32,-21
5,15,203,12,9,3
5,15,204,15,16,-1
5,15,205,21,12,9
5,15,206,15,9,6
5,15,207,10,13,-3
5,15,208,13,12,1
5,15,209,43,13,30
5,15,210,21,10,11
5,15,211,23,15,8
5,15,212,4,15,-11
5,15,213,11,6,5
5,15,214,6,11,-5
5,15,215,21,16,5
5,15,216,20,21,-1
5,15,217,11,15,-4
5,15,218,20,17,3
5,15,219,9,21,-12
5,15,220,21,8,13
5,15,221,11,6,5
5,15,222,14,4,10
5,15,223,15,17,-2
5,15,224,16,8,8
5,15,225,10,12,-2
5,15,226,16,15,1
5,15,227,9,17,-8
5,15,228,20,13,7
5,15,229,17,8,9
5,15,230,14,12,2
5,15,231,5,6,-1
5,15,232,30,19,11
5,15,233,16,17,-1
5,15,234,16,17,-1
5,15,235,14,9,5
5,15,236,21,11,10
5,15,237,16,8,8
5,15,238,25,7,18
5,15,239,31,32,-1
5,15,240,24,19,5
5,15,241,20,16,4
5,15,242,20,16,4
5,15,243,35,14,21
5,15,244,10,19,-9
5,15,245,14,8,6
5,15,246,27,15,12
5,15,247,24,20,4
5,15,248,25,16,9
5,15,249,23,11,12
5,15,250,14,15,-1
5,15,251,12,14,-2
5,15,252,14,19,-5
5,15,253,14,13,1
5,15,254,13,21,-8
5,15,255,13,10,3
5,15,256,5,15,-10
5,15,257,10,17,-7
5,15,258,13,10,3
5,15,259,11,21,-10
5,15,260,7,6,1
5,15,261,14,13,1
5,15,262,13,9,4
5,15,263,19,14,5
5,15,264,20,21,-1
5,15,265,20,16,4
5,15,266,16,11,5
5,15,267,15,4,11
5,15,268,28,12,16
5,15,269,20,12,8
5,15,270,19,9,10
5,15,271,8,7,1
5,15,272,16,6,10
5,15,273,26,9,17
5,15,274,5,2,3
5,15,275,21,15,6
5,15,276,12,9,3
5,15,277,24,16,8
5,15,278,26,14,12
5,15,279,21,15,6
5,15,280,18,20,-2
5,15,281,21,10,11
5,15,282,24,14,10
5,15,283,11,5,6
5,15,284,8,4,4
5,15,285,20,5,15
5,15,286,10,14,-4
5,15,287,9,5,4
5,15,288,15,8,7
5,15,289,21,10,11
5,15,290,19,13,6
5,15,291,25,15,10
5,15,292,10,3,7
5,15,293,13,8,5
5,15,294,17,15,2
5,15,295,11,9,2
5,15,296,17,13,4
5,15,297,19,9,10
5,15,298,19,15,4
5,15,299,14,10,4
5,16,0,8,9,-1
5,16,1,8,18,-10
5,16,2,17,10,7
5,16,3,15,7,8
5,16,4,9,4,5
5,16,5,25,11,14
5,16,6,13,19,-6
5,16,7,16,12,4
5,16,8,14,20,-6
5,16,9,25,8,17
5,16,10,24,8,16
5,16,11,16,5,11
5,16,12,10,11,-1
5,16,13,36,21,15
5,16,14,16,20,-4
5,16,15,14,6,8
5,16,16,15,13,2
5,16,17,22,9,13
5,16,18,14,9,5
5,16,19,14,16,-2
5,16,20,13,21,-8
5,16,21,13,12,1
5,16,22,6,8,-2
5,16,23,19,4,15
5,16,24,12,5,7
5,16,25,18,38,-20
5,16,26,9,6,3
5,16,27,7,15,-8
5,16,28,24,20,4
5,16,29,15,7,8
5,16,30,16,28,-12
5,16,31,21,15,6
5,16,32,13,11,2
5,16,33,10,7,3
5,16,34,29,4,25
5,16,35,18,14,4
5,16,36,21,10,11
5,16,37,13,13,0
5,16,38,21,17,4
5,16,39,12,12,0
5,16,40,16,14,2
5,16,41,15,5,10
5,16,42,21,17,4
5,16,43,37,13,24
5,16,44,5,12,-7
5,16,45,13,9,4
5,16,46,14,8,6
5,16,47,16,1,15
5,16,48,27,14,13
5,16,49,20,11,9
5,16,50,22,16,6
5,16,51,14,14,0
5,16,52,22,16,6
5,16,53,27,13,14
5,16,54,19,15,4
5,16,55,22,23,-1
5,16,56,24,16,8
5,16,57,11,2,9
5,16,58,17,18,-1
5,16,59,18,10,8
5,16,60,8,9,-1
5,16,61,20,9,11
5,16,62,15,13,2
5,16,63,25,18,7
5,16,64,16,24,-8
5,16,65,14,11,3
5,16,66,9,18,-9
5,16,67,10,15,-5
5,16,68,21,3,18
5,16,69,14,9,5
5,16,70,28,21,7
5,16,71,18,22,-4
5,16,72,11,10,1
5,16,73,15,12,3
5,16,74,30,15,15
5,16,75,14,9,5
5,16,76,23,16,7
5,16,77,11,19,-8
5,16,78,3,1,2
5,16,79,20,24,-4
5,16,80,25,15,10
5,16,81,13,11,2
5,16,82,18,14,4
5,16,83,14,16,-2
5,16,84,17,13,4
5,16,85,23,9,14
5,16,86,14,11,3
5,16,87,19,15,4
5,16,88,33,18,15
5,16,89,24,14,10
5,16,90,31,16,15
5,16,91,14,4,10
5,16,92,29,14,15
5,16,93,20,31,-11
5,16,94,14,13,1
5,16,95,21,13,8
5,16,96,4,10,-6
5,16,97,18,11,7
5,16,98,6,7,-1
5,16,99,13,14,-1
5,16,100,15,11,4
5,16,101,29,5,24
5,16,102,18,18,0
5,16,103,27,6,21
5,16,104,21,17,4
5,16,105,15,10,5
5,16,106,22,16,6
5,16,107,7,17,-10
5,16,108,18,12,6
5,16,109,20,15,5
5,16,110,14,18,-4
5,16,111,12,22,-10
5,16,112,17,5,12
5,16,113,8,16,-8
5,16,114,27,15,12
5,16,115,13,10,3
5,16,116,19,15,4
5,16,117,26,17,9
5,16,118,14,8,6
5,16,119,12,12,0
5,16,120,15,9,6
5,16,121,17,15,2
5,16,122,13,8,5
5,16,123,21,22,-1
5,16,124,19,12,7
5,16,125,21,21,0
5,16,126,16,5,11
5,16,127,27,18,9
5,16,128,26,13,13
5,16,129,15,10,5
5,16,130,16,15,1
5,16,131,19,11,8
5,16,132,23,6,17
5,16,133,7,6,1
5,16,134,25,17,8
5,16,135,16,2,14
5,16,136,26,7,19
5,16,137,8,11,-3
5,16,138,17,14,3
5,16,139,19,11,8
5,16,140,8,15,-7
5,16,141,25,13,12
5,16,142,22,9,13
5,16,143,12,6,6
5,16,144,19,11,8
5,16,145,18,12,6
5,16,146,15,12,3
5,16,147,21,15,6
5,16,148,20,9,11
5,16,149,12,5,7
5,16,150,12,10,2
5,16,151,8,3,5
5,16,152,22,14,8
5,16,153,22,3,19
5,16,154,17,11,6
5,16,155,11,5,6
5,16,156,15,13,2
5,16,157,20,4,16
5,16,158,11,7,4
5,16,159,15,10,5
5,16,160,36,12,24
5,16,161,9,9,0
5,16,162,20,8,12
5,16,163,15,4,11
5,16,164,18,6,12
5,16,165,8,6,2
5,16,166,13,10,3
5,16,167,10,13,-3
5,16,168,12,18,-6
5,16,169,17,14,3
5,16,170,13,20,-7
5,16,171,13,7,6
5,16,172,19,9,10
5,16,173,29,12,17
5,16,174,17,7,10
5,16,175,5,5,0
5,16,176,17,11,6
5,16,177,13,17,-4
5,16,178,10,12,-2
5,16,179,14,12,2
5,16,180,17,7,10
5,16,181,25,12,13
5,16,182,15,5,10
5,16,183,21,14,7
5,16,184,15,7,8
5,16,185,11,13,-2
5,16,186,24,10,14
5,16,187,12,4,8
5,16,188,26,12,14
5,16,189,11,9,2
5,16,190,10,6,4
5,16,191,22,16,6
5,16,192,21,22,-1
5,16,193,13,10,3
5,16,194,26,17,9
5,16,195,18,17,1
5,16,196,6,8,-2
5,16,197,31,16,15
5,16,198,29,15,14
5,16,199,25,4,21
5,16,200,22,19,3
5,16,201,21,13,8
5,16,202,9,9,0
5,16,203,12,8,4
5,16,204,21,13,8
5,16,205,20,11,9
5,16,206,20,11,9
5,16,207,20,16,4
5,16,208,9,9,0
5,16,209,26,10,16
5,16,210,14,4,10
5,16,211,30,26,4
5,16,212,9,5,4
5,16,213,20,17,3
5,16,214,9,17,-8
5,16,215,25,16,9
5,16,216,24,18,6
5,16,217,18,20,-2
5,16,218,29,10,19
5,16,219,19,13,6
5,16,220,26,11,15
5,16,221,11,16,-5
5,16,222,22,11,11
5,16,223,16,8,8
5,16,224,15,13,2
5,16,225,28,19,9
5,16,226,29,18,11
5,16,227,23,1,22
5,16,228,16,18,-2
5,16,229,19,19,0
5,16,230,9,7,2
5,16,231,22,13,9
5,16,232,12,10,2
5,16,233,14,6,8
5,16,234,22,14,8
5,16,235,31,29,2
5,16,236,27,13,14
5,16,237,11,12,-1
5,16,238,26,11,15
5,16,239,22,15,7
5,16,240,11,11,0
5,16,241,10,15,-5
5,16,242,16,7,9
5,16,243,15,6,9
5,16,244,13,7,6
5,16,245,18,23,-5
5,16,246,22,3,19
5,16,247,20,8,12
5,16,248,13,7,6
5,16,249,15,7,8
5,16,250,13,16,-3
5,16,251,16,25,-9
5,16,252,35,15,20
5,16,253,22,8,14
5,16,254,25,3,22
5,16,255,20,2,18
5,16,256,15,11,4
5,16,257,19,12,7
5,16,258,10,13,-3
5,16,259,24,12,12
5,16,260,14,26,-12
5,16,261,30,17,13
5,16,262,5,11,-6
5,16,263,20,20,0
5,16,264,20,8,12
5,16,265,24,7,17
5,16,266,13,6,7
5,16,267,19,10,9
5,16,268,12,6,6
5,16,269,16,12,4
5,16,270,11,11,0
5,16,271,19,7,12
5,16,272,10,13,-3
5,16,273,16,9,7
5,16,274,22,7,15
5,16,275,12,15,-3
5,16,276,12,8,4
5,16,277,14,4,10
5,16,278,16,7,9
5,16,279,26,16,10
5,16,280,31,9,22
5,16,281,19,12,7
5,16,282,17,24,-7
5,16,283,22,17,5
5,16,284,18,9,9
5,16,285,9,7,2
5,16,286,19,18,1
5,16,287,12,9,3
5,16,288,10,13,-3
5,16,289,20,11,9
5,16,290,10,17,-7
5,16,291,18,12,6
5,16,292,13,9,4
5,16,293,21,7,14
5,16,294,28,8,20
5,16,295,15,16,-1
5,16,296,21,12,9
5,16,297,27,6,21
5,16,298,16,18,-2
5,16,299,15,11,4
5,17,0,30,13,17
5,17,1,13,11,2
5,17,2,19,8,11
5,17,3,18,7,11
5,17,4,24,18,6
5,17,5,11,8,3
5,17,6,27,20,7
5,17,7,9,4,5
5,17,8,24,12,12
5,17,9,16,7,9
5,17,10,25,11,14
5,17,11,16,12,4
5,17,12,19,3,16
5,17,13,21,6,15
5,17,14,16,8,8
5,17,15,28,13,15
5,17,16,15,6,9
5,17,17,21,7,14
5,17,18,31,20,11
5,17,19,20,18,2
5,17,20,19,10,9
5,17,21,17,9,8
5,17,22,12,10,2
5,17,23,7,7,0
5,17,24,14,9,5
5,17,25,24,17,7
5,17,26,21,7,14
5,17,27,13,8,5
5,17,28,21,7,14
5,17,29,13,9,4
5,17,30,19,14,5
5,17,31,29,15,14
5,17,32,17,6,11
5,17,33,12,5,7
5,17,34,20,14,6
5,17,35,15,3,12
5,17,36,11,7,4
5,17,37,17,6,11
5,17,38,13,10,3
5,17,39,35,11,24
5,17,40,18,13,5
5,17,41,4,11,-7
5,17,42,24,11,13
5,17,43,17,8,9
5,17,44,7,7,0
5,17,45,28,6,22
5,17,46,24,8,16
5,17,47,14,6,8
5,17,48,23,9,14
5,17,49,15,13,2
5,17,50,17,15,2
5,17,51,11,12,-1
5,17,52,9,10,-1
5,17,53,17,2,15
5,17,54,41,17,24
5,17,55,21,9,12
5,17,56,26,11,15
5,17,57,16,5,11
5,17,58,21,8,13
5,17,59,16,5,11
5,17,60,10,8,2
5,17,61,11,6,5
5,17,62,11,6,5
5,17,63,30,10,20
5,17,64,16,8,8
5,17,65,16,18,-2
5,17,66,25,18,7
5,17,67,27,16,11
5,17,68,16,5,11
5,17,69,15,16,-1
5,17,70,14,10,4
5,17,71,21,10,11
5,17,72,17,14,3
5,17,73,20,8,12
5,17,74,15,11,4
5,17,75,13,12,1
5,17,76,19,8,11
5,17,77,6,11,-5
5,17,78,14,4,10
5,17,79,14,9,5
5,17,80,14,5,9
5,17,81,22,11,11
5,17,82,18,16,2
5,17,83,18,6,12
5,17,84,13,10,3
5,17,85,19,18,1
5,17,86,17,6,11
5,17,87,14,9,5
5,17,88,20,9,11
5,17,89,12,13,-1
5,17,90,13,9,4
5,17,91,8,10,-2
5,17,92,21,10,11
5,17,93,14,15,-1
5,17,94,16,22,-6
5,17,95,23,6,17
5,17,96,16,7,9
5,17,97,20,9,11
5,17,98,14,12,2
5,17,99,17,9,8
5,17,100,23,7,16
5,17,101,7,15,-8
5,17,102,27,10,17
5,17,103,12,6,6
5,17,104,13,5,8
5,17,105,29,12,17
5,17,106,31,22,9
5,17,107,23,15,8
5,17,108,19,12,7
5,17,109,10,13,-3
5,17,110,22,19,3
5,17,111,18,10,8
5,17,112,10,11,-1
5,17,113,24,21,3
5,17,114,19,16,3
5,17,115,8,14,-6
5,17,116,31,7,24
5,17,117,20,14,6
5,17,118,20,12,8
5,17,119,20,9,11
5,17,120,17,11,6
5,17,121,28,13,15
5,17,122,13,6,7
5,17,123,14,7,7
5,17,124,15,17,-2
5,17,125,27,8,19
5,17,126,19,10,9
5,17,127,25,10,15
5,17,128,12,1,11
5,17,129,12,12,0
5,17,130,17,16,1
5,17,131,17,11,6
5,17,132,23,15,8
5,17,133,14,8,6
5,17,134,19,21,-2
5,17,135,23,11,12
5,17,136,16,12,4
5,17,137,14,8,6
5,17,138,9,1,8
5,17,139,14,18,-4
5,17,140,27,27,0
5,17,141,25,18,7
5,17,142,19,10,9
5,17,143,22,14,8
5,17,144,15,12,3
5,17,145,22,2,20
5,17,146,14,11,3
5,17,147,17,15,2
5,17,148,37,9,28
5,17,149,14,9,5
5,17,150,11,13,-2
5,17,151,16,8,8
5,17,152,30,6,24
5,17,153,17,10,7
5,17,154,28,18,10
5,17,155,16,23,-7
5,17,156,16,4,12
5,17,157,10,6,4
5,17,158,10,10,0
5,17,159,8,9,-1
5,17,160,17,18,-1
5,17,161,25,8,17
5,17,162,25,12,13
5,17,163,22,13,9
5,17,164,25,9,16
5,17,165,10,8,2
5,17,166,23,13,10
5,17,167,9,5,4
5,17,168,33,16,17
5,17,169,15,13,2
5,17,170,34,17,17
5,17,171,32,24,8
5,17,172,27,21,6
5,17,173,0,2,-2
5,17,174,22,15,7
5,17,175,18,5,13
5,17,176,21,5,16
5,17,177,17,19,-2
5,17,178,12,10,2
5,17,179,24,10,14
5,17,180,13,13,0
5,17,181,24,5,19
5,17,182,10,11,-1
5,17,183,10,7,3
5,17,184,17,12,5
5,17,185,12,13,-1
5,17,186,29,15,14
5,17,187,36,19,17
5,17,188,20,5,15
5,17,189,15,6,9
5,17,190,13,15,-2
5,17,191,18,5,13
5,17,192,11,3,8
5,17,193,20,7,13
5,17,194,19,8,11
5,17,195,19,6,13
5,17,196,10,12,-2
5,17,197,15,8,7
5,17,198,14,5,9
5,17,199,20,14,6
5,17,200,11,3,8
5,17,201,32,11,21
5,17,202,18,4,14
5,17,203,13,7,6
5,17,204,19,15,4
5,17,205,21,8,13
5,17,206,18,6,12
5,17,207,12,10,2
5,17,208,20,14,6
5,17,209,22,16,6
5,17,210,17,3,14
5,17,211,18,8,10
5,17,212,10,14,-4
5,17,213,17,12,5
5,17,214,19,22,-3
5,17,215,13,18,-5
5,17,216,4,11,-7
5,17,217,12,12,0
5,17,218,12,6,6
5,17,219,13,13,0
5,17,220,28,15,13
5,17,221,25,13,12
5,17,222,5,3,2
5,17,223,29,13,16
5,17,224,26,15,11
5,17,225,21,17,4
5,17,226,13,7,6
5,17,227,11,10,1
5,17,228,31,15,16
5,17,229,10,13,-3
5,17,230,10,10,0
5,17,231,17,12,5
5,17,232,18,12,6
5,17,233,10,13,-3
5,17,234,21,13,8
5,17,235,11,8,3
5,17,236,16,13,3
5,17,237,5,7,-2
5,17,238,26,8,18
5,17,239,11,21,-10
5,17,240,11,2,9
5,17,241,21,10,11
5,17,242,12,12,0
5,17,243,14,13,1
5,17,244,25,5,20
5,17,245,20,6,14
5,17,246,23,14,9
5,17,247,12,13,-1
5,17,248,23,15,8
5,17,249,17,18,-1
5,17,250,8,10,-2
5,17,251,20,22,-2
5,17,252,19,12,7
5,17,253,9,10,-1
5,17,254,17,12,5
5,17,255,16,16,0
5,17,256,11,2,9
5,17,257,14,15,-1
5,17,258,16,9,7
5,17,259,10,19,-9
5,17,260,31,25,6
5,17,261,14,8,6
5,17,262,8,8,0
5,17,263,25,4,21
5,17,264,38,10,28
5,17,265,22,27,-5
5,17,266,20,10,10
5,17,267,11,11,0
5,17,268,23,19,4
5,17,269,10,7,3
5,17,270,21,14,7
5,17,271,21,19,2
5,17,272,21,10,11
5,17,273,22,22,0
5,17,274,14,7,7
5,17,275,14,15,-1
5,17,276,9,11,-2
5,17,277,3,15,-12
5,17,278,17,6,11
5,17,279,11,8,3
5,17,280,9,8,1
5,17,281,22,14,8
5,17,282,15,11,4
5,17,283,14,12,2
5,17,284,15,13,2
5,17,285,8,11,-3
5,17,286,15,17,-2
5,17,287,18,14,4
5,17,288,39,14,25
5,17,289,16,10,6
5,17,290,39,17,22
5,17,291,18,20,-2
5,17,292,22,15,7
5,17,293,17,10,7
5,17,294,25,25,0
5,17,295,9,12,-3
5,17,296,15,13,2
5,17,297,27,10,17
5,17,298,22,3,19
5,17,299,15,10,5
5,18,0,19,11,8
5,18,1,5,14,-9
5,18,2,8,6,2
5,18,3,27,12,15
5,18,4,18,5,13
5,18,5,16,6,10
5,18,6,20,23,-3
5,18,7,6,11,-5
5,18,8,16,14,2
5,18,9,18,8,10
5,18,10,15,10,5
5,18,11,19,19,0
5,18,12,25,7,18
5,18,13,12,8,4
5,18,14,17,9,8
5,18,15,14,13,1
5,18,16,17,15,2
5,18,17,15,11,4
5,18,18,12,13,-1
5,18,19,22,15,7
5,18,20,21,27,-6
5,18,21,24,27,-3
5,18,22,13,8,5
5,18,23,8,13,-5
5,18,24,13,20,-7
5,18,25,8,10,-2
5,18,26,29,21,8
5,18,27,26,23,3
5,18,28,17,17,0
5,18,29,23,10,13
5,18,30,25,7,18
5,18,31,14,14,0
5,18,32,25,8,17
5,18,33,17,16,1
5,18,34,30,6,24
5,18,35,21,7,14
5,18,36,20,15,5
5,18,37,18,3,15
5,18,38,10,5,5
5,18,39,14,6,8
5,18,40,14,10,4
5,18,41,23,11,12
5,18,42,27,7,20
5,18,43,23,11,12
5,18,44,18,15,3
5,18,45,15,12,3
5,18,46,24,17,7
5,18,47,17,17,0
5,18,48,19,15,4
5,18,49,9,6,3
5,18,50,12,12,0
5,18,51,8,3,5
5,18,52,13,8,5
5,18,53,13,9,4
5,18,54,21,5,16
5,18,55,10,4,6
5,18,56,6,3,3
5,18,57,9,10,-1
5,18,58,21,22,-1
5,18,59,6,8,-2
5,18,60,12,9,3
5,18,61,29,11,18
5,18,62,16,13,3
5,18,63,24,23,1
5,18,64,15,11,4
5,18,65,18,15,3
5,18,66,25,15,10
5,18,67,21,14,7
5,18,68,15,15,0
5,18,69,25,11,14
5,18,70,28,15,13
5,18,71,9,8,1
5,18,72,12,10,2
5,18,73,12,9,3
5,18,74,21,15,6
5,18,75,20,9,11
5,18,76,19,12,7
5,18,77,20,9,11
5,18,78,22,11,11
5,18,79,12,12,0
5,18,80,19,12,7
5,18,81,26,9,17
5,18,82,12,12,0
5,18,83,3,11,-8
5,18,84,20,14,6
5,18,85,18,7,11
5,18,86,22,9,13
5,18,87,12,13,-1
5,18,88,11,6,5
5,18,89,10,7,3
5,18,90,13,10,3
5,18,91,27,13,14
5,18,92,23,7,16
5,18,93,11,3,8
5,18,94,18,19,-1
5,18,95,6,4,2
5,18,96,14,12,2
5,18,97,19,8,11
5,18,98,23,9,14
5,18,99,14,8,6
5,18,100,25,12,13
5,18,101,15,7,8
5,18,102,11,6,5
5,18,103,16,12,4
5,18,104,17,19,-2
5,18,105,17,15,2
5,18,106,5,12,-7
5,18,107,21,11,10
5,18,108,9,18,-9
5,18,109,18,16,2
5,18,110,36,8,28
5,18,111,10,9,1
5,18,112,27,29,-2
5,18,113,11,14,-3
5,18,114,18,11,7
5,18,115,15,7,8
5,18,116,15,8,7
5,18,117,18,13,5
5,18,118,15,4,11
5,18,119,21,8,13
5,18,120,31,11,20
5,18,121,19,17,2
5,18,122,20,9,11
5,18,123,21,12,9
5,18,124,3,5,-2
5,18,125,26,12,14
5,18,126,26,20,6
5,18,127,6,6,0
5,18,128,9,2,7
5,18,129,11,14,-3
5,18,130,39,15,24
5,18,131,21,26,-5
5,18,132,17,14,3
5,18,133,26,16,10
5,18,134,8,13,-5
5,18,135,17,20,-3
5,18,136,16,8,8
5,18,137,32,30,2
5,18,138,24,11,13
5,18,139,14,8,6
5,18,140,35,16,19
5,18,141,22,6,16
5,18,142,22,11,11
5,18,143,13,6,7
5,18,144,18,12,6
5,18,145,18,19,-1
5,18,146,14,15,-1
5,18,147,29,20,9
5,18,148,15,10,5
5,18,149,8,10,-2
5,18,150,19,13,6
5,18,151,34,16,18
5,18,152,5,7,-2
5,18,153,14,7,7
5,18,154,25,19,6
5,18,155,24,13,11
5,18,156,16,12,4
5,18,157,11,2,9
5,18,158,13,9,4
5,18,159,32,16,16
5,18,160,15,11,4
5,18,161,20,21,-1
5,18,162,20,14,6
5,18,163,9,6,3
5,18,164,13,12,1
5,18,165,14,6,8
5,18,166,19,13,6
5,18,167,17,10,7
5,18,168,18,9,9
5,18,169,19,10,9
5,18,170,8,16,-8
5,18,171,21,9,12
5,18,172,20,16,4
5,18,173,21,6,15
5,18,174,26,9,17
5,18,175,20,16,4
5,18,176,20,17,3
5,18,177,13,20,-7
5,18,178,19,17,2
5,18,179,26,17,9
5,18,180,18,17,1
5,18,181,34,14,20
5,18,182,22,16,6
5,18,183,13,8,5
5,18,184,14,9,5
5,18,185,7,7,0
5,18,186,28,9,19
5,18,187,17,6,11
5,18,188,19,6,13
5,18,189,20,12,8
5,18,190,13,7,6
5,18,191,18,11,7
5,18,192,16,17,-1
5,18,193,21,7,14
5,18,194,16,20,-4
5,18,195,28,16,12
5,18,196,16,6,10
5,18,197,16,4,12
5,18,198,14,16,-2
5,18,199,6,10,-4
5,18,200,14,15,-1
5,18,201,26,17,9
5,18,202,36,11,25
5,18,203,17,5,12
5,18,204,20,11,9
5,18,205,23,13,10
5,18,206,20,8,12
5,18,207,14,5,9
5,18,208,12,20,-8
5,18,209,22,16,6
5,18,210,21,18,3
5,18,211,18,11,7
5,18,212,23,14,9
5,18,213,7,7,0
5,18,214,11,5,6
5,18,215,26,15,11
5,18,216,13,7,6
5,18,217,18,26,-8
5,18,218,8,15,-7
5,18,219,9,6,3
5,18,220,12,15,-3
5,18,221,18,15,3
5,18,222,23,10,13
5,18,223,22,7,15
5,18,224,31,21,10
5,18,225,18,14,4
5,18,226,18,8,10
5,18,227,24,3,21
5,18,228,15,5,10
5,18,229,12,14,-2
5,18,230,12,11,1
5,18,231,20,10,10
5,18,232,14,10,4
5,18,233,17,10,7
5,18,234,23,18,5
5,18,235,7,13,-6
5,18,236,21,7,14
5,18,237,14,4,10
5,18,238,11,7,4
5,18,239,11,11,0
5,18,240,28,10,18
5,18,241,23,11,12
5,18,242,11,13,-2
5,18,243,16,15,1
5,18,244,9,3,6
5,18,245,15,15,0
5,18,246,9,13,-4
5,18,247,16,11,5
5,18,248,13,12,1
5,18,249,11,6,5
5,18,250,19,9,10
5,18,251,35,4,31
5,18,252,25,9,16
5,18,253,21,9,12
5,18,254,21,9,12
5,18,255,22,17,5
5,18,256,11,17,-6
5,18,257,22,2,20
5,18,258,17,3,14
5,18,259,19,11,8
5,18,260,16,14,2
5,18,261,2,10,-8
5,18,262,34,22,12
5,18,263,13,8,5
5,18,264,28,15,13
5,18,265,10,21,-11
5,18,266,6,7,-1
5,18,267,11,9,2
5,18,268,17,10,7
5,18,269,9,6,3
5,18,270,26,10,16
5,18,271,20,16,4
5,18,272,12,7,5
5,18,273,23,13,10
5,18,274,16,10,6
5,18,275,23,1,22
5,18,276,13,13,0
5,18,277,19,16,3
5,18,278,20,15,5
5,18,279,13,11,2
5,18,280,14,7,7
5,18,281,23,9,14
5,18,282,22,15,7
5,18,283,22,13,9
5,18,284,11,12,-1
5,18,285,14,10,4
5,18,286,19,12,7
5,18,287,23,23,0
5,18,288,13,9,4
5,18,289,8,9,-1
5,18,290,10,4,6
5,18,291,19,28,-9
5,18,292,36,12,24
5,18,293,35,11,24
5,18,294,7,10,-3
5,18,295,31,10,21
5,18,296,19,9,10
5,18,297,14,7,7
5,18,298,5,3,2
5,18,299,23,22,1
5,19,0,20,10,10
5,19,1,10,14,-4
5,19,2,18,3,15
5,19,3,29,16,13
5,19,4,23,14,9
5,19,5,20,14,6
5,19,6,10,14,-4
5,19,7,14,11,3
5,19,8,17,6,11
5,19,9,12,4,8
5,19,10,29,11,18
5,19,11,13,6,7
5,19,12,13,7,6
5,19,13,25,14,11
5,19,14,7,4,3
5,19,15,19,12,7
5,19,16,17,5,12
5,19,17,22,22,0
5,19,18,19,6,13
5,19,19,21,9,12
5,19,20,16,10,6
5,19,21,27,8,19
5,19,22,4,10,-6
5,19,23,26,12,14
5,19,24,23,8,15
5,19,25,17,10,7
5,19,26,16,19,-3
5,19,27,38,17,21
5,19,28,6,5,1
5,19,29,21,20,1
5,19,30,27,22,5
5,19,31,18,16,2
5,19,32,18,15,3
5,19,33,20,15,5
5,19,34,18,15,3
5,19,35,7,9,-2
5,19,36,23,22,1
5,19,37,12,9,3
5,19,38,9,11,-2
5,19,39,15,20,-5
5,19,40,28,10,18
5,19,41,27,5,22
5,19,42,12,6,6
5,19,43,12,16,-4
5,19,44,13,11,2
5,19,45,27,21,6
5,19,46,11,4,7
5,19,47,14,9,5
5,19,48,12,10,2
5,19,49,16,10,6
5,19,50,16,12,4
5,19,51,30,14,16
5,19,52,26,11,15
5,19,53,25,16,9
5,19,54,6,0,6
5,19,55,23,14,9
5,19,56,11,4,7
5,19,57,11,10,1
5,19,58,21,9,12
5,19,59,19,4,15
5,19,60,24,12,12
5,19,61,19,7,12
5,19,62,33,18,15
5,19,63,16,17,-1
5,19,64,28,12,16
5,19,65,16,15,1
5,19,66,14,9,5
5,19,67,32,9,23
5,19,68,22,8,14
5,19,69,25,21,4
5,19,70,17,25,-8
5,19,71,17,9,8
5,19,72,14,13,1
5,19,73,17,18,-1
5,19,74,20,6,14
5,19,75,17,8,9
5,19,76,7,7,0
5,19,77,28,14,14
5,19,78,19,10,9
5,19,79,21,13,8
5,19,80,23,13,10
5,19,81,24,22,2
5,19,82,11,10,1
5,19,83,19,9,10
5,19,84,13,10,3
5,19,85,24,8,16
5,19,86,19,12,7
5,19,87,22,19,3
5,19,88,11,4,7
5,19,89,19,7,12
5,19,90,30,15,15
5,19,91,30,16,14
5,19,92,17,8,9
5,19,93,14,7,7
5,19,94,26,12,14
5,19,95,9,20,-11
5,19,96,18,8,10
5,19,97,14,11,3
5,19,98,20,6,14
5,19,99,31,24,7
5,19,100,19,13,6
5,19,101,10,5,5
5,19,102,28,17,11
5,19,103,18,13,5
5,19,104,11,13,-2
5,19,105,11,0,11
5,19,106,10,11,-1
5,19,107,13,9,4
5,19,108,7,11,-4
5,19,109,21,13,8
5,19,110,23,4,19
5,19,111,24,17,7
5,19,112,31,16,15
5,19,113,26,11,15
5,19,114,21,21,0
5,19,115,13,11,2
5,19,116,12,12,0
5,19,117,21,8,13
5,19,118,32,23,9
5,19,119,24,9,15
5,19,120,10,15,-5
5,19,121,13,17,-4
5,19,122,15,18,-3
5,19,123,14,9,5
5,19,124,15,19,-4
5,19,125,14,12,2
5,19,126,8,6,2
5,19,127,25,31,-6
5,19,128,23,8,15
5,19,129,34,26,8
5,19,130,16,20,-4
5,19,131,8,12,-4
5,19,132,17,11,6
5,19,133,18,18,0
5,19,134,19,7,12
5,19,135,18,12,6
5,19,136,18,11,7
5,19,137,15,24,-9
5,19,138,11,7,4
5,19,139,14,6,8
5,19,140,15,22,-7
5,19,141,27,10,17
5,19,142,12,12,0
5,19,143,15,6,9
5,19,144,30,17,13
5,19,145,20,16,4
5,19,146,20,18,2
5,19,147,14,12,2
5,19,148,17,1,16
5,19,149,19,9,10
5,19,150,11,14,-3
5,19,151,11,6,5
5,19,152,27,7,20
5,19,153,13,19,-6
5,19,154,18,7,11
5,19,155,20,5,15
5,19,156,10,8,2
5,19,157,17,10,7
5,19,158,33,9,24
5,19,159,8,9,-1
5,19,160,27,16,11
5,19,161,25,13,12
5,19,162,27,15,12
5,19,163,24,10,14
5,19,164,17,13,4
5,19,165,12,13,-1
5,19,166,11,9,2
5,19,167,15,24,-9
5,19,168,30,11,19
5,19,169,16,15,1
5,19,170,21,5,16
5,19,171,9,10,-1
5,19,172,25,21,4
5,19,173,21,5,16
5,19,174,12,8,4
5,19,175,23,6,17
5,19,176,17,19,-2
5,19,177,21,11,10
5,19,178,23,7,16
5,19,179,13,9,4
5,19,180,22,9,13
5,19,181,37,20,17
5,19,182,29,11,18
5,19,183,8,8,0
5,19,184,27,23,4
5,19,185,21,14,7
5,19,186,10,18,-8
5,19,187,22,11,11
5,19,188,28,16,12
5,19,189,22,17,5
5,19,190,19,19,0
5,19,191,18,14,4
5,19,192,16,15,1
5,19,193,17,16,1
5,19,194,12,19,-7
5,19,195,11,15,-4
5,19,196,13,8,5
5,19,197,18,11,7
5,19,198,18,11,7
5,19,199,21,18,3
5,19,200,16,16,0
5,19,201,11,8,3
5,19,202,28,12,16
5,19,203,20,10,10
5,19,204,19,13,6
5,19,205,15,8,7
5,19,206,16,27,-11
5,19,207,20,11,9
5,19,208,12,10,2
5,19,209,28,15,13
5,19,210,12,19,-7
5,19,211,13,14,-1
5,19,212,29,10,19
5,19,213,28,20,8
5,19,214,20,10,10
5,19,215,14,5,9
5,19,216,10,0,10
5,19,217,17,11,6
5,19,218,6,6,0
5,19,219,17,13,4
5,19,220,20,23,-3
5,19,221,21,13,8
5,19,222,7,22,-15
5,19,223,11,9,2
5,19,224,29,14,15
5,19,225,5,7,-2
5,19,226,21,12,9
5,19,227,20,7,13
5,19,228,14,16,-2
5,19,229,22,11,11
5,19,230,18,14,4
5,19,231,24,18,6
5,19,232,15,9,6
5,19,233,24,25,-1
5,19,234,26,6,20
5,19,235,14,16,-2
5,19,236,21,13,8
5,19,237,14,16,-2
5,19,238,20,15,5
5,19,239,7,18,-11
5,19,240,17,22,-5
5,19,241,12,15,-3
5,19,242,19,15,4
5,19,243,17,16,1
5,19,244,13,2,11
5,19,245,29,8,21
5,19,246,41,16,25
5,19,247,20,7,13
5,19,248,29,10,19
5,19,249,32,15,17
5,19,250,23,15,8
5,19,251,28,17,11
5,19,252,14,8,6
5,19,253,16,13,3
5,19,254,6,20,-14
5,19,255,20,7,13
5,19,256,18,19,-1
5,19,257,25,11,14
5,19,258,21,10,11
5,19,259,12,8,4
5,19,260,14,6,8
5,19,261,27,14,13
5,19,262,11,19,-8
5,19,263,27,18,9
5,19,264,18,12,6
5,19,265,24,17,7
5,19,266,15,16,-1
5,19,267,17,11,6
5,19,268,12,13,-1
5,19,269,28,12,16
5,19,270,20,7,13
5,19,271,13,7,6
5,19,272,11,12,-1
5,19,273,15,9,6
5,19,274,20,9,11
5,19,275,19,7,12
5,19,276,23,9,14
5,19,277,31,10,21
5,19,278,28,8,20
5,19,279,20,4,16
5,19,280,9,5,4
5,19,281,14,17,-3
5,19,282,7,14,-7
5,19,283,10,8,2
5,19,284,33,4,29
5,19,285,14,3,11
5,19,286,17,14,3
5,19,287,29,15,14
5,19,288,20,16,4
5,19,289,16,11,5
5,19,290,23,13,10
5,19,291,9,15,-6
5,19,292,15,10,5
5,19,293,17,22,-5
5,19,294,27,8,19
5,19,295,11,4,7
5,19,296,11,10,1
5,19,297,34,25,9
5,19,298,17,11,6
5,19,299,29,16,13
5,20,0,19,5,14
5,20,1,14,11,3
5,20,2,22,11,11
5,20,3,20,23,-3
5,20,4,12,16,-4
5,20,5,25,12,13
5,20,6,9,7,2
5,20,7,22,16,6
5,20,8,19,9,10
5,20,9,13,17,-4
5,20,10,16,7,9
5,20,11,19,6,13
5,20,12,9,11,-2
5,20,13,22,16,6
5,20,14,9,11,-2
5,20,15,12,10,2
5,20,16,18,13,5
5,20,17,16,12,4
5,20,18,30,15,15
5,20,19,15,4,11
5,20,20,14,8,6
5,20,21,11,6,5
5,20,22,23,13,10
5,20,23,14,12,2
5,20,24,17,9,8
5,20,25,35,8,27
5,20,26,16,15,1
5,20,27,22,11,11
5,20,28,22,15,7
5,20,29,21,13,8
5,20,30,14,9,5
5,20,31,29,11,18
5,20,32,11,9,2
5,20,33,26,13,13
5,20,34,17,9,8
5,20,35,15,6,9
5,20,36,17,16,1
5,20,37,12,10,2
5,20,38,15,20,-5
5,20,39,12,6,6
5,20,40,14,7,7
5,20,41,3,6,-3
5,20,42,18,13,5
5,20,43,17,16,1
5,20,44,21,11,10
5,20,45,16,11,5
5,20,46,37,21,16
5,20,47,7,13,-6
5,20,48,19,17,2
5,20,49,14,10,4
5,20,50,17,14,3
5,20,51,18,5,13
5,20,52,24,13,11
5,20,53,9,12,-3
5,20,54,14,15,-1
5,20,55,17,11,6
5,20,56,10,8,2
5,20,57,18,7,11
5,20,58,32,18,14
5,20,59,25,12,13
5,20,60,30,13,17
5,20,61,20,12,8
5,20,62,19,7,12
5,20,63,9,7,2
5,20,64,15,11,4
5,20,65,13,11,2
5,20,66,11,5,6
5,20,67,24,9,15
5,20,68,5,5,0
5,20,69,10,14,-4
5,20,70,9,11,-2
5,20,71,11,5,6
5,20,72,20,13,7
5,20,73,16,8,8
5,20,74,21,8,13
5,20,75,27,7,20
5,20,76,20,17,3
5,20,77,15,12,3
5,20,78,16,6,10
5,20,79,24,2,22
5,20,80,23,4,19
5,20,81,18,17,1
5,20,82,25,7,18
5,20,83,24,18,6
5,20,84,11,6,5
5,20,85,13,7,6
5,20,86,14,8,6
5,20,87,23,10,13
5,20,88,14,14,0
5,20,89,18,2,16
5,20,90,17,6,11
5,20,91,9,10,-1
5,20,92,11,14,-3
5,20,93,25,11,14
5,20,94,27,13,14
5,20,95,28,6,22
5,20,96,14,7,7
5,20,97,20,12,8
5,20,98,33,13,20
5,20,99,18,15,3
5,20,100,22,8,14
5,20,101,11,11,0
5,20,102,18,15,3
5,20,103,34,10,24
5,20,104,24,20,4
5,20,105,10,14,-4
5,20,106,17,10,7
5,20,107,9,8,1
5,20,108,19,7,12
5,20,109,22,12,10
5,20,110,10,9,1
5,20,111,16,12,4
5,20,112,17,11,6
5,20,113,9,8,1
5,20,114,12,12,0
5,20,115,27,16,11
5,20,116,25,20,5
5,20,117,32,16,16
5,20,118,27,23,4
5,20,119,25,12,13
5,20,120,21,11,10
5,20,121,38,16,22
5,20,122,12,13,-1
5,20,123,14,10,4
5,20,124,17,17,0
5,20,125,17,9,8
5,20,126,21,8,13
5,20,127,26,7,19
5,20,128,15,5,10
5,20,129,14,6,8
5,20,130,7,7,0
5,20,131,5,9,-4
5,20,132,16,12,4
5,20,133,17,7,10
5,20,134,24,11,13
5,20,135,32,14,18
5,20,136,9,16,-7
5,20,137,29,14,15
5,20,138,32,7,25
5,20,139,14,5,9
5,20,140,13,7,6
5,20,141,17,15,2
5,20,142,25,11,14
5,20,143,24,20,4
5,20,144,7,9,-2
5,20,145,11,10,1
5,20,146,12,8,4
5,20,147,7,6,1
5,20,148,29,13,16
5,20,149,22,20,2
5,20,150,21,9,12
5,20,151,8,5,3
5,20,152,25,21,4
5,20,153,27,11,16
5,20,154,16,6,10
5,20,155,15,8,7
5,20,156,10,11,-1
5,20,157,27,10,17
5,20,158,21,8,13
5,20,159,28,10,18
5,20,160,29,20,9
5,20,161,21,15,6
5,20,162,13,9,4
5,20,163,27,26,1
5,20,164,18,4,14
5,20,165,30,17,13
5,20,166,7,10,-3
5,20,167,21,16,5
5,20,168,24,18,6
5,20,169,18,9,9
5,20,170,31,15,16
5,20,171,26,31,-5
5,20,172,22,26,-4
5,20,173,13,8,5
5,20,174,25,6,19
5,20,175,7,4,3
5,20,176,20,14,6
5,20,177,15,17,-2
5,20,178,12,20,-8
5,20,179,18,16,2
5,20,180,25,8,17
5,20,181,39,15,24
5,20,182,18,10,8
5,20,183,24,12,12
5,20,184,17,9,8
5,20,185,29,5,24
5,20,186,18,14,4
5,20,187,9,10,-1
5,20,188,12,9,3
5,20,189,27,11,16
5,20,190,10,22,-12
5,20,191,12,8,4
5,20,192,25,16,9
5,20,193,10,8,2
5,20,194,21,17,4
5,20,195,34,12,22
5,20,196,6,14,-8
5,20,197,20,8,12
5,20,198,24,9,15
5,20,199,14,10,4
5,20,200,13,10,3
5,20,201,29,11,18
5,20,202,11,9,2
5,20,203,12,3,9
5,20,204,27,23,4
5,20,205,24,14,10
5,20,206,15,18,-3
5,20,207,27,18,9
5,20,208,9,7,2
5,20,209,12,10,2
5,20,210,25,13,12
5,20,211,21,8,13
5,20,212,22,9,13
5,20,213,21,18,3
5,20,214,8,12,-4
5,20,215,18,16,2
5,20,216,13,10,3
5,20,217,33,11,22
5,20,218,26,10,16
5,20,219,23,15,8
5,20,220,17,7,10
5,20,221,14,6,8
5,20,222,21,10,11
5,20,223,22,9,13
5,20,224,17,6,11
5,20,225,16,4,12
5,20,226,20,14,6
5,20,227,3,10,-7
5,20,228,19,12,7
5,20,229,24,9,15
5,20,230,21,20,1
5,20,231,12,12,0
5,20,232,21,14,7
5,20,233,16,4,12
5,20,234,17,14,3
5,20,235,21,9,12
5,20,236,11,11,0
5,20,237,17,10,7
5,20,238,22,14,8
5,20,239,15,1,14
5,20,240,13,11,2
5,20,241,9,6,3
5,20,242,14,15,-1
5,20,243,19,12,7
5,20,244,29,9,20
5,20,245,16,12,4
5,20,246,26,17,9
5,20,247,12,6,6
5,20,248,14,9,5
5,20,249,16,13,3
5,20,250,12,6,6
5,20,251,24,16,8
5,20,252,17,6,11
5,20,253,10,3,7
5,20,254,32,16,16
5,20,255,15,12,3
5,20,256,19,10,9
5,20,257,19,7,12
5,20,258,10,8,2
5,20,259,16,14,2
5,20,260,19,12,7
5,20,261,26,20,6
5,20,262,11,4,7
5,20,263,17,9,8
5,20,264,18,10,8
5,20,265,19,11,8
5,20,266,13,11,2
5,20,267,15,3,12
5,20,268,19,4,15
5,20,269,11,14,-3
5,20,270,11,23,-12
5,20,271,38,24,14
5,20,272,13,3,10
5,20,273,15,15,0
5,20,274,30,12,18
5,20,275,10,4,6
5,20,276,16,5,11
5,20,277,18,6,12
5,20,278,16,12,4
5,20,279,10,8,2
5,20,280,18,15,3
5,20,281,28,14,14
5,20,282,15,16,-1
5,20,283,26,12,14
5,20,284,19,12,7
5,20,285,23,28,-5
5,20,286,17,27,-10
5,20,287,17,10,7
5,20,288,31,8,23
5,20,289,23,11,12
5,20,290,17,11,6
5,20,291,22,15,7
5,20,292,13,10,3
5,20,293,11,5,6
5,20,294,14,11,3
5,20,295,26,17,9
5,20,296,22,6,16
5,20,297,13,15,-2
5,20,298,21,14,7
5,20,299,12,9,3
5,21,0,13,13,0
5,21,1,12,10,2
5,21,2,23,7,16
5,21,3,18,12,6
5,21,4,33,18,15
5,21,5,19,9,10
5,21,6,18,10,8
5,21,7,12,9,3
5,21,8,17,20,-3
5,21,9,21,13,8
5,21,10,8,3,5
5,21,11,8,1,7
5,21,12,17,20,-3
5,21,13,16,10,6
5,21,14,19,5,14
5,21,15,21,18,3
5,21,16,29,15,14
5,21,17,42,14,28
5,21,18,26,11,15
5,21,19,23,15,8
5,21,20,26,4,22
5,21,21,12,4,8
5,21,22,20,16,4
5,21,23,21,11,10
5,21,24,16,7,9
5,21,25,21,7,14
5,21,26,20,5,15
5,21,27,14,7,7
5,21,28,11,14,-3
5,21,29,16,10,6
5,21,30,9,7,2
5,21,31,7,6,1
5,21,32,10,10,0
5,21,33,25,7,18
5,21,34,6,4,2
5,21,35,13,20,-7
5,21,36,9,12,-3
5,21,37,17,8,9
5,21,38,12,18,-6
5,21,39,10,9,1
5,21,40,18,14,4
5,21,41,22,14,8
5,21,42,26,16,10
5,21,43,11,12,-1
5,21,44,13,9,4
5,21,45,16,7,9
5,21,46,16,8,8
5,21,47,26,7,19
5,21,48,11,13,-2
5,21,49,20,15,5
5,21,50,13,7,6
5,21,51,18,10,8
5,21,52,12,15,-3
5,21,53,21,17,4
5,21,54,8,1,7
5,21,55,21,13,8
5,21,56,30,13,17
5,21,57,21,17,4
5,21,58,12,9,3
5,21,59,23,12,11
5,21,60,20,10,10
5,21,61,19,6,13
5,21,62,13,3,10
5,21,63,13,7,6
5,21,64,13,9,4
5,21,65,12,12,0
5,21,66,33,20,13
5,21,67,19,10,9
5,21,68,28,13,15
5,21,69,29,12,17
5,21,70,19,9,10
5,21,71,24,7,17
5,21,72,24,15,9
5,21,73,19,6,13
5,21,74,12,17,-5
5,21,75,21,10,11
5,21,76,11,7,4
5,21,77,23,4,19
5,21,78,20,18,2
5,21,79,34,16,18
5,21,80,8,10,-2
5,21,81,10,13,-3
5,21,82,18,7,11
5,21,83,16,8,8
5,21,84,14,4,10
5,21,85,21,7,14
5,21,86,19,10,9
5,21,87,23,17,6
5,21,88,7,10,-3
5,21,89,9,7,2
5,21,90,14,12,2
5,21,91,27,22,5
5,21,92,9,12,-3
5,21,93,25,6,19
5,21,94,21,11,10
5,21,95,13,9,4
5,21,96,14,7,7
5,21,97,9,16,-7
5,21,98,12,12,0
5,21,99,24,10,14
5,21,100,9,9,0
5,21,101,24,15,9
5,21,102,10,8,2
5,21,103,18,16,2
5,21,104,27,22,5
5,21,105,20,14,6
5,21,106,23,15,8
5,21,107,16,15,1
5,21,108,30,8,22
5,21,109,12,7,5
5,21,110,28,14,14
5,21,111,16,1,15
5,21,112,18,4,14
5,21,113,15,13,2
5,21,114,17,13,4
5,21,115,20,20,0
5,21,116,34,9,25
5,21,117,12,7,5
5,21,118,17,11,6
5,21,119,29,16,13
5,21,120,31,15,16
5,21,121,11,4,7
5,21,122,16,17,-1
5,21,123,8,13,-5
5,21,124,32,13,19
5,21,125,10,8,2
5,21,126,14,3,11
5,21,127,25,9,16
5,21,128,16,13,3
5,21,129,21,7,14
5,21,130,8,9,-1
5,21,131,23,10,13
5,21,132,16,12,4
5,21,133,28,10,18
5,21,134,16,16,0
5,21,135,26,19,7
5,21,136,28,14,14
5,21,137,26,8,18
5,21,138,9,7,2
5,21,139,23,14,9
5,21,140,9,5,4
5,21,141,11,13,-2
5,21,142,20,15,5
5,21,143,19,16,3
5,21,144,15,9,6
5,21,145,20,18,2
5,21,146,23,9,14
5,21,147,24,15,9
5,21,148,20,11,9
5,21,149,25,18,7
5,21,150,11,19,-8
5,21,151,12,7,5
5,21,152,19,28,-9
5,21,153,17,17,0
5,21,154,21,12,9
5,21,155,22,12,10
5,21,156,13,11,2
5,21,157,11,4,7
5,21,158,13,5,8
5,21,159,22,10,12
5,21,160,16,6,10
5,21,161,27,11,16
5,21,162,19,6,13
5,21,163,19,15,4
5,21,164,9,13,-4
5,21,165,20,10,10
5,21,166,10,6,4
5,21,167,15,15,0
5,21,168,14,12,2
5,21,169,30,9,21
5,21,170,16,18,-2
5,21,171,21,8,13
5,21,172,9,16,-7
5,21,173,16,14,2
5,21,174,25,17,8
5,21,175,17,13,4
5,21,176,10,8,2
5,21,177,17,11,6
5,21,178,11,7,4
5,21,179,45,17,28
5,21,180,13,8,5
5,21,181,16,13,3
5,21,182,18,3,15
5,21,183,10,6,4
5,21,184,35,21,14
5,21,185,18,11,7
5,21,186,20,15,5
5,21,187,24,9,15
5,21,188,7,11,-4
5,21,189,13,9,4
5,21,190,19,16,3
5,21,191,15,7,8
5,21,192,20,7,13
5,21,193,10,15,-5
5,21,194,19,17,2
5,21,195,21,24,-3
5,21,196,26,13,13
5,21,197,20,16,4
5,21,198,22,11,11
5,21,199,25,15,10
5,21,200,24,15,9
5,21,201,28,16,12
5,21,202,4,0,4
5,21,203,26,9,17
5,21,204,23,11,12
5,21,205,6,6,0
5,21,206,19,8,11
5,21,207,25,12,13
5,21,208,20,8,12
5,21,209,18,12,6
5,21,210,31,13,18
5,21,211,22,15,7
5,21,212,20,14,6
5,21,213,8,5,3
5,21,214,18,11,7
5,21,215,30,15,15
5,21,216,21,13,8
5,21,217,22,15,7
5,21,218,12,7,5
5,21,219,16,14,2
5,21,220,24,16,8
5,21,221,23,15,8
5,21,222,5,18,-13
5,21,223,18,6,12
5,21,224,13,17,-4
5,21,225,15,10,5
5,21,226,20,6,14
5,21,227,14,1,13
5,21,228,22,6,16
5,21,229,17,9,8
5,21,230,21,15,6
5,21,231,25,13,12
5,21,232,20,14,6
5,21,233,13,17,-4
5,21,234,27,15,12
5,21,235,12,7,5
5,21,236,23,24,-1
5,21,237,20,15,5
5,21,238,19,9,10
5,21,239,19,13,6
5,21,240,18,11,7
5,21,241,11,4,7
5,21,242,19,9,10
5,21,243,16,6,10
5,21,244,28,13,15
5,21,245,13,7,6
5,21,246,29,23,6
5,21,247,14,15,-1
5,21,248,16,10,6
5,21,249,4,8,-4
5,21,250,18,7,11
5,21,251,37,15,22
5,21,252,31,19,12
5,21,253,19,4,15
5,21,254,6,4,2
5,21,255,24,13,11
5,21,256,25,10,15
5,21,257,16,16,0
5,21,258,17,15,2
5,21,259,14,11,3
5,21,260,23,8,15
5,21,261,11,9,2
5,21,262,14,13,1
5,21,263,11,3,8
5,21,264,13,10,3
5,21,265,33,18,15
5,21,266,27,9,18
5,21,267,9,9,0
5,21,268,17,11,6
5,21,269,11,11,0
5,21,270,17,9,8
5,21,271,20,5,15
5,21,272,10,3,7
5,21,273,12,16,-4
5,21,274,24,8,16
5,21,275,16,21,-5
5,21,276,21,14,7
5,21,277,18,14,4
5,21,278,17,13,4
5,21,279,10,6,4
5,21,280,16,4,12
5,21,281,13,24,-11
5,21,282,20,17,3
5,21,283,22,10,12
5,21,284,18,19,-1
5,21,285,20,11,9
5,21,286,14,7,7
5,21,287,6,13,-7
5,21,288,15,19,-4
5,21,289,18,9,9
5,21,290,18,12,6
5,21,291,27,12,15
5,21,292,28,21,7
5,21,293,26,16,10
5,21,294,11,21,-10
5,21,295,37,11,26
5,21,296,14,12,2
5,21,297,30,16,14
5,21,298,13,20,-7
5,21,299,11,5,6
5,22,0,12,11,1
5,22,1,22,14,8
5,22,2,17,17,0
5,22,3,19,7,12
5,22,4,13,11,2
5,22,5,21,28,-7
5,22,6,16,7,9
5,22,7,19,11,8
5,22,8,23,8,15
5,22,9,22,6,16
5,22,10,16,3,13
5,22,11,23,13,10
5,22,12,19,7,12
5,22,13,28,14,14
5,22,14,29,22,7
5,22,15,16,14,2
5,22,16,27,13,14
5,22,17,19,7,12
5,22,18,18,12,6
5,22,19,15,4,11
5,22,20,29,12,17
5,22,21,25,13,12
5,22,22,16,13,3
5,22,23,24,9,15
5,22,24,25,18,7
5,22,25,29,11,18
5,22,26,18,19,-1
5,22,27,5,2,3
5,22,28,12,4,8
5,22,29,23,12,11
5,22,30,39,5,34
5,22,31,13,14,-1
5,22,32,9,5,4
5,22,33,10,3,7
5,22,34,28,13,15
5,22,35,22,11,11
5,22,36,19,13,6
5,22,37,24,12,12
5,22,38,15,17,-2
5,22,39,21,13,8
5,22,40,26,6,20
5,22,41,12,6,6
5,22,42,14,9,5
5,22,43,13,16,-3
5,22,44,4,5,-1
5,22,45,12,12,0
5,22,46,17,6,11
5,22,47,17,7,10
5,22,48,24,11,13
5,22,49,17,12,5
5,22,50,18,7,11
5,22,51,21,12,9
5,22,52,18,8,10
5,22,53,6,1,5
5,22,54,13,10,3
5,22,55,16,9,7
5,22,56,7,10,-3
5,22,57,13,17,-4
5,22,58,24,22,2
5,22,59,14,4,10
5,22,60,17,4,13
5,22,61,23,16,7
5,22,62,13,14,-1
5,22,63,20,6,14
5,22,64,21,36,-15
5,22,65,1,1,0
5,22,66,10,12,-2
5,22,67,7,7,0
5,22,68,27,12,15
5,22,69,11,12,-1
5,22,70,25,11,14
5,22,71,20,11,9
5,22,72,26,13,13
5,22,73,21,12,9
5,22,74,18,8,10
5,22,75,21,8,13
5,22,76,10,11,-1
5,22,77,9,15,-6
5,22,78,16,5,11
5,22,79,21,14,7
5,22,80,14,5,9
5,22,81,12,5,7
5,22,82,11,4,7
5,22,83,15,13,2
5,22,84,13,20,-7
5,22,85,12,14,-2
5,22,86,17,16,1
5,22,87,6,4,2
5,22,88,11,14,-3
5,22,89,11,9,2
5,22,90,13,21,-8
5,22,91,12,6,6
5,22,92,18,7,11
5,22,93,20,18,2
5,22,94,19,10,9
5,22,95,18,9,9
5,22,96,34,18,16
5,22,97,13,4,9
5,22,98,25,12,13
5,22,99,31,7,24
5,22,100,13,6,7
5,22,101,15,5,10
5,22,102,24,11,13
5,22,103,8,7,1
5,22,104,29,17,12
5,22,105,29,8,21
5,22,106,14,7,7
5,22,107,8,9,-1
5,22,108,35,13,22
5,22,109,18,12,6
5,22,110,16,9,7
5,22,111,21,9,12
5,22,112,13,15,-2
5,22,113,13,18,-5
5,22,114,7,4,3
5,22,115,8,10,-2
5,22,116,8,10,-2
5,22,117,17,14,3
5,22,118,24,14,10
5,22,119,17,6,11
5,22,120,18,18,0
5,22,121,21,14,7
5,22,122,3,0,3
5,22,123,37,14,23
5,22,124,21,22,-1
5,22,125,24,11,13
5,22,126,29,22,7
5,22,127,17,6,11
5,22,128,20,12,8
5,22,129,33,12,21
5,22,130,17,7,10
5,22,131,11,8,3
5,22,132,26,11,15
5,22,133,23,3,20
5,22,134,8,13,-5
5,22,135,16,11,5
5,22,136,22,14,8
5,22,137,15,2,13
5,22,138,9,12,-3
5,22,139,28,16,12
5,22,140,16,6,10
5,22,141,6,7,-1
5,22,142,15,14,1
5,22,143,28,8,20
5,22,144,32,15,17
5,22,145,17,12,5
5,22,146,19,11,8
5,22,147,12,14,-2
5,22,148,8,9,-1
5,22,149,12,8,4
5,22,150,17,6,11
5,22,151,23,18,5
5,22,152,26,10,16
5,22,153,17,16,1
5,22,154,34,11,23
5,22,155,25,13,12
5,22,156,25,5,20
5,22,157,6,6,0
5,22,158,15,6,9
5,22,159,27,10,17
5,22,160,20,8,12
5,22,161,22,7,15
5,22,162,28,15,13
5,22,163,13,9,4
5,22,164,19,11,8
5,22,165,21,6,15
5,22,166,31,16,15
5,22,167,20,8,12
5,22,168,7,10,-3
5,22,169,28,19,9
5,22,170,23,13,10
5,22,171,24,9,15
5,22,172,24,24,0
5,22,173,20,10,10
5,22,174,13,16,-3
5,22,175,22,15,7
5,22,176,28,13,15
5,22,177,22,11,11
5,22,178,14,13,1
5,22,179,13,6,7
5,22,180,12,10,2
5,22,181,11,3,8
5,22,182,42,26,16
5,22,183,16,5,11
5,22,184,26,13,13
5,22,185,25,7,18
5,22,186,30,13,17
5,22,187,25,17,8
5,22,188,13,9,4
5,22,189,28,12,16
5,22,190,24,11,13
5,22,191,15,8,7
5,22,192,28,2,26
5,22,193,35,13,22
5,22,194,32,13,19
5,22,195,22,14,8
5,22,196,13,12,1
5,22,197,5,5,0
5,22,198,12,7,5
5,22,199,14,7,7
5,22,200,23,11,12
5,22,201,9,14,-5
5,22,202,19,10,9
5,22,203,32,4,28
5,22,204,11,14,-3
5,22,205,32,7,25
5,22,206,17,14,3
5,22,207,22,10,12
5,22,208,26,18,8
5,22,209,20,20,0
5,22,210,13,8,5
5,22,211,36,13,23
5,22,212,12,12,0
5,22,213,27,32,-5
5,22,214,20,2,18
5,22,215,21,8,13
5,22,216,24,8,16
5,22,217,11,9,2
5,22,218,27,13,14
5,22,219,8,15,-7
5,22,220,19,15,4
5,22,221,7,11,-4
5,22,222,14,6,8
5,22,223,15,8,7
5,22,224,19,11,8
5,22,225,24,12,12
5,22,226,14,13,1
5,22,227,27,11,16
5,22,228,13,9,4
5,22,229,27,12,15
5,22,230,19,11,8
5,22,231,29,17,12
5,22,232,19,7,12
5,22,233,18,11,7
5,22,234,9,6,3
5,22,235,20,7,13
5,22,236,27,15,12
5,22,237,21,19,2
5,22,238,28,12,16
5,22,239,16,13,3
5,22,240,11,10,1
5,22,241,18,29,-11
5,22,242,15,6,9
5,22,243,16,4,12
5,22,244,19,8,11
5,22,245,10,16,-6
5,22,246,20,7,13
5,22,247,28,11,17
5,22,248,26,13,13
5,22,249,10,6,4
5,22,250,16,13,3
5,22,251,16,15,1
5,22,252,22,8,14
5,22,253,14,2,12
5,22,254,22,9,13
5,22,255,21,6,15
5,22,256,21,5,16
5,22,257,11,6,5
5,22,258,12,3,9
5,22,259,19,9,10
5,22,260,11,9,2
5,22,261,37,14,23
5,22,262,24,9,15
5,22,263,32,14,18
5,22,264,17,16,1
5,22,265,13,13,0
5,22,266,23,13,10
5,22,267,18,6,12
5,22,268,22,6,16
5,22,269,5,8,-3
5,22,270,24,10,14
5,22,271,28,13,15
5,22,272,21,8,13
5,22,273,18,16,2
5,22,274,22,15,7
5,22,275,19,20,-1
5,22,276,11,3,8
5,22,277,15,17,-2
5,22,278,27,16,11
5,22,279,12,13,-1
5,22,280,18,5,13
5,22,281,18,16,2
5,22,282,14,17,-3
5,22,283,18,15,3
5,22,284,12,8,4
5,22,285,20,15,5
5,22,286,15,14,1
5,22,287,31,14,17
5,22,288,19,10,9
5,22,289,19,13,6
5,22,290,20,16,4
5,22,291,18,2,16
5,22,292,20,3,17
5,22,293,20,10,10
5,22,294,9,6,3
5,22,295,18,14,4
5,22,296,14,14,0
5,22,297,15,18,-3
5,22,298,5,20,-15
5,22,299,18,10,8
5,23,0,16,13,3
5,23,1,26,15,11
5,23,2,24,7,17
5,23,3,12,6,6
5,23,4,6,7,-1
5,23,5,27,11,16
5,23,6,20,9,11
5,23,7,18,15,3
5,23,8,21,13,8
5,23,9,12,11,1
5,23,10,24,14,10
5,23,11,30,4,26
5,23,12,6,3,3
5,23,13,9,10,-1
5,23,14,28,8,20
5,23,15,15,5,10
5,23,16,16,21,-5
5,23,17,18,5,13
5,23,18,9,7,2
5,23,19,25,4,21
5,23,20,23,7,16
5,23,21,14,12,2
5,23,22,18,3,15
5,23,23,20,11,9
5,23,24,19,13,6
5,23,25,22,17,5
5,23,26,26,13,13
5,23,27,22,6,16
5,23,28,22,9,13
5,23,29,19,9,10
5,23,30,23,6,17
5,23,31,13,18,-5
5,23,32,27,8,19
5,23,33,21,5,16
5,23,34,15,10,5
5,23,35,21,10,11
5,23,36,14,14,0
5,23,37,38,9,29
5,23,38,7,6,1
5,23,39,20,17,3
5,23,40,16,8,8
5,23,41,11,5,6
5,23,42,18,9,9
5,23,43,15,12,3
5,23,44,7,7,0
5,23,45,18,10,8
5,23,46,18,9,9
5,23,47,3,5,-2
5,23,48,11,23,-12
5,23,49,19,8,11
5,23,50,11,9,2
5,23,51,19,7,12
5,23,52,21,21,0
5,23,53,31,12,19
5,23,54,12,4,8
5,23,55,28,15,13
5,23,56,17,11,6
5,23,57,29,11,18
5,23,58,11,9,2
5,23,59,11,5,6
5,23,60,13,8,5
5,23,61,10,10,0
5,23,62,20,15,5
5,23,63,15,6,9
5,23,64,8,5,3
5,23,65,15,8,7
5,23,66,36,23,13
5,23,67,35,8,27
5,23,68,21,9,12
5,23,69,13,11,2
5,23,70,24,21,3
5,23,71,33,13,20
5,23,72,15,13,2
5,23,73,12,12,0
5,23,74,34,17,17
5,23,75,18,13,5
5,23,76,19,7,12
5,23,77,27,14,13
5,23,78,15,12,3
5,23,79,17,10,7
5,23,80,19,12,7
5,23,81,10,4,6
5,23,82,21,16,5
5,23,83,14,7,7
5,23,84,34,16,18
5,23,85,26,15,11
5,23,86,11,7,4
5,23,87,15,9,6
5,23,88,31,5,26
5,23,89,15,4,11
5,23,90,26,26,0
5,23,91,21,14,7
5,23,92,20,13,7
5,23,93,22,15,7
5,23,94,19,11,8
5,23,95,18,8,10
5,23,96,32,8,24
5,23,97,25,11,14
5,23,98,18,7,11
5,23,99,17,13,4
5,23,100,21,2,19
5,23,101,9,11,-2
5,23,102,11,12,-1
5,23,103,14,11,3
5,23,104,7,11,-4
5,23,105,25,15,10
5,23,106,13,10,3
5,23,107,21,14,7
5,23,108,22,10,12
5,23,109,28,8,20
5,23,110,8,4,4
5,23,111,27,26,1
5,23,112,11,14,-3
5,23,113,19,5,14
5,23,114,9,7,2
5,23,115,11,9,2
5,23,116,19,9,10
5,23,117,18,3,15
5,23,118,15,14,1
5,23,119,20,15,5
5,23,120,23,13,10
5,23,121,17,7,10
5,23,122,31,11,20
5,23,123,18,10,8
5,23,124,20,21,-1
5,23,125,15,12,3
5,23,126,44,17,27
5,23,127,21,13,8
5,23,128,24,7,17
5,23,129,21,12,9
5,23,130,16,7,9
5,23,131,27,11,16
5,23,132,23,14,9
5,23,133,15,10,5
5,23,134,13,19,-6
5,23,135,1,11,-10
5,23,136,22,12,10
5,23,137,20,11,9
5,23,138,30,17,13
5,23,139,21,16,5
5,23,140,12,9,3
5,23,141,14,13,1
5,23,142,18,6,12
5,23,143,18,8,10
5,23,144,16,10,6
5,23,145,20,11,9
5,23,146,24,7,17
5,23,147,13,9,4
5,23,148,7,7,0
5,23,149,22,6,16
5,23,150,26,16,10
5,23,151,16,9,7
5,23,152,18,13,5
5,23,153,20,7,13
5,23,154,16,7,9
5,23,155,41,8,33
5,23,156,11,5,6
5,23,157,17,12,5
5,23,158,20,11,9
5,23,159,24,14,10
5,23,160,19,11,8
5,23,161,21,9,12
5,23,162,9,3,6
5,23,163,16,9,7
5,23,164,9,16,-7
5,23,165,10,7,3
5,23,166,15,7,8
5,23,167,19,7,12
5,23,168,13,8,5
5,23,169,12,5,7
5,23,170,20,8,12
5,23,171,15,7,8
5,23,172,15,5,10
5,23,173,23,8,15
5,23,174,22,9,13
5,23,175,14,19,-5
5,23,176,15,11,4
5,23,177,32,15,17
5,23,178,7,0,7
5,23,179,26,22,4
5,23,180,19,9,10
5,23,181,37,5,32
5,23,182,33,3,30
5,23,183,31,11,20
5,23,184,14,3,11
5,23,185,20,7,13
5,23,186,16,8,8
5,23,187,25,13,12
5,23,188,24,9,15
5,23,189,16,10,6
5,23,190,15,7,8
5,23,191,16,7,9
5,23,192,21,10,11
5,23,193,13,8,5
5,23,194,10,7,3
5,23,195,16,10,6
5,23,196,17,12,5
5,23,197,11,10,1
5,23,198,10,5,5
5,23,199,16,4,12
5,23,200,18,3,15
5,23,201,15,7,8
5,23,202,26,15,11
5,23,203,37,21,16
5,23,204,14,5,9
5,23,205,26,7,19
5,23,206,20,6,14
5,23,207,26,16,10
5,23,208,15,5,10
5,23,209,11,13,-2
5,23,210,14,5,9
5,23,211,8,12,-4
5,23,212,13,14,-1
5,23,213,30,9,21
5,23,214,21,4,17
5,23,215,12,10,2
5,23,216,22,6,16
5,23,217,18,17,1
5,23,218,25,16,9
5,23,219,29,5,24
5,23,220,13,24,-11
5,23,221,27,6,21
5,23,222,29,11,18
5,23,223,18,13,5
5,23,224,8,10,-2
5,23,225,23,4,19
5,23,226,20,3,17
5,23,227,25,16,9
5,23,228,19,12,7
5,23,229,14,15,-1
5,23,230,17,7,10
5,23,231,15,9,6
5,23,232,15,7,8
5,23,233,11,11,0
5,23,234,16,4,12
5,23,235,17,11,6
5,23,236,19,8,11
5,23,237,13,8,5
5,23,238,29,15,14
5,23,239,21,7,14
5,23,240,18,2,16
5,23,241,20,9,11
5,23,242,23,18,5
5,23,243,18,6,12
5,23,244,9,9,0
5,23,245,10,5,5
5,23,246,5,2,3
5,23,247,25,6,19
5,23,248,14,13,1
5,23,249,11,16,-5
5,23,250,19,14,5
5,23,251,12,9,3
5,23,252,25,14,11
5,23,253,33,13,20
5,23,254,8,8,0
5,23,255,6,5,1
5,23,256,21,15,6
5,23,257,17,3,14
5,23,258,18,20,-2
5,23,259,20,7,13
5,23,260,18,9,9
5,23,261,12,16,-4
5,23,262,23,17,6
5,23,263,19,6,13
5,23,264,24,9,15
5,23,265,20,14,6
5,23,266,28,12,16
5,23,267,5,5,0
5,23,268,17,9,8
5,23,269,14,12,2
5,23,270,16,11,5
5,23,271,18,8,10
5,23,272,20,20,0
5,23,273,17,10,7
5,23,274,14,8,6
5,23,275,21,9,12
5,23,276,20,15,5
5,23,277,13,6,7
5,23,278,14,7,7
5,23,279,25,12,13
5,23,280,19,5,14
5,23,281,14,9,5
5,23,282,19,6,13
5,23,283,17,15,2
5,23,284,24,19,5
5,23,285,27,7,20
5,23,286,9,8,1
5,23,287,20,10,10
5,23,288,15,9,6
5,23,289,20,14,6
5,23,290,21,11,10
5,23,291,21,18,3
5,23,292,16,5,11
5,23,293,19,19,0
5,23,294,17,8,9
5,23,295,18,9,9
5,23,296,9,3,6
5,23,297,25,11,14
5,23,298,26,7,19
5,23,299,30,16,14
5,24,0,12,7,5
5,24,1,21,18,3
5,24,2,11,10,1
5,24,3,20,10,10
5,24,4,20,16,4
5,24,5,17,5,12
5,24,6,19,11,8
5,24,7,15,4,11
5,24,8,24,5,19
5,24,9,20,13,7
5,24,10,13,7,6
5,24,11,9,11,-2
5,24,12,24,14,10
5,24,13,23,25,-2
5,24,14,18,19,-1
5,24,15,17,11,6
5,24,16,21,15,6
5,24,17,14,7,7
5,24,18,13,5,8
5,24,19,14,9,5
5,24,20,22,7,15
5,24,21,26,16,10
5,24,22,21,15,6
5,24,23,13,8,5
5,24,24,15,8,7
5,24,25,24,12,12
5,24,26,10,4,6
5,24,27,16,16,0
5,24,28,27,14,13
5,24,29,15,10,5
5,24,30,18,13,5
5,24,31,31,14,17
5,24,32,29,21,8
5,24,33,19,12,7
5,24,34,12,12,0
5,24,35,18,10,8
5,24,36,20,18,2
5,24,37,14,12,2
5,24,38,14,9,5
5,24,39,21,7,14
5,24,40,25,9,16
5,24,41,8,5,3
5,24,42,27,24,3
5,24,43,22,9,13
5,24,44,15,12,3
5,24,45,38,15,23
5,24,46,14,10,4
5,24,47,15,10,5
5,24,48,8,17,-9
5,24,49,9,14,-5
5,24,50,26,6,20
5,24,51,17,10,7
5,24,52,26,10,16
5,24,53,28,10,18
5,24,54,16,16,0
5,24,55,11,6,5
5,24,56,19,10,9
5,24,57,24,6,18
5,24,58,20,11,9
5,24,59,14,12,2
5,24,60,27,11,16
5,24,61,15,9,6
5,24,62,20,7,13
5,24,63,19,5,14
5,24,64,35,16,19
5,24,65,26,5,21
5,24,66,27,22,5
5,24,67,22,9,13
5,24,68,8,9,-1
5,24,69,32,17,15
5,24,70,25,7,18
5,24,71,29,8,21
5,24,72,21,11,10
5,24,73,13,12,1
5,24,74,19,19,0
5,24,75,21,9,12
5,24,76,14,4,10
5,24,77,17,6,11
5,24,78,22,14,8
5,24,79,25,11,14
5,24,80,8,3,5
5,24,81,27,15,12
5,24,82,8,15,-7
5,24,83,23,6,17
5,24,84,11,13,-2
5,24,85,17,13,4
5,24,86,13,4,9
5,24,87,21,17,4
5,24,88,24,17,7
5,24,89,7,6,1
5,24,90,21,8,13
5,24,91,11,9,2
5,24,92,16,16,0
5,24,93,19,11,8
5,24,94,32,13,19
5,24,95,25,22,3
5,24,96,39,3,36
5,24,97,15,17,-2
5,24,98,17,15,2
5,24,99,27,15,12
5,24,100,14,8,6
5,24,101,17,12,5
5,24,102,21,13,8
5,24,103,10,4,6
5,24,104,17,9,8
5,24,105,23,17,6
5,24,106,16,1,15
5,24,107,12,10,2
5,24,108,24,5,19
5,24,109,11,3,8
5,24,110,36,22,14
5,24,111,8,9,-1
5,24,112,4,7,-3
5,24,113,23,15,8
5,24,114,7,3,4
5,24,115,12,8,4
5,24,116,25,16,9
5,24,117,13,9,4
5,24,118,25,9,16
5,24,119,18,13,5
5,24,120,32,11,21
5,24,121,10,11,-1
5,24,122,18,9,9
5,24,123,34,8,26
5,24,124,15,7,8
5,24,125,18,15,3
5,24,126,32,6,26
5,24,127,29,18,11
5,24,128,19,9,10
5,24,129,31,12,19
5,24,130,16,9,7
5,24,131,27,11,16
5,24,132,36,6,30
5,24,133,28,15,13
5,24,134,20,14,6
5,24,135,19,8,11
5,24,136,21,7,14
5,24,137,12,9,3
5,24,138,23,14,9
5,24,139,16,9,7
5,24,140,27,13,14
5,24,141,33,18,15
5,24,142,18,9,9
5,24,143,41,18,23
5,24,144,15,6,9
5,24,145,28,13,15
5,24,146,27,4,23
5,24,147,23,9,14
5,24,148,11,6,5
5,24,149,22,26,-4
5,24,150,18,17,1
5,24,151,23,16,7
5,24,152,7,5,2
5,24,153,20,6,14
5,24,154,11,3,8
5,24,155,11,11,0
5,24,156,23,5,18
5,24,157,14,12,2
5,24,158,15,13,2
5,24,159,11,10,1
5,24,160,12,2,10
5,24,161,21,12,9
5,24,162,13,6,7
5,24,163,15,12,3
5,24,164,12,10,2
5,24,165,15,8,7
5,24,166,14,4,10
5,24,167,20,9,11
5,24,168,14,5,9
5,24,169,21,9,12
5,24,170,41,13,28
5,24,171,27,10,17
5,24,172,16,20,-4
5,24,173,22,8,14
5,24,174,8,7,1
5,24,175,30,14,16
5,24,176,26,6,20
5,24,177,20,10,10
5,24,178,28,18,10
5,24,179,9,8,1
5,24,180,13,28,-15
5,24,181,34,12,22
5,24,182,25,9,16
5,24,183,19,11,8
5,24,184,16,5,11
5,24,185,15,12,3
5,24,186,25,9,16
5,24,187,10,5,5
5,24,188,35,12,23
5,24,189,25,14,11
5,24,190,19,14,5
5,24,191,21,8,13
5,24,192,19,11,8
5,24,193,29,7,22
5,24,194,21,12,9
5,24,195,19,16,3
5,24,196,23,9,14
5,24,197,12,7,5
5,24,198,20,9,11
5,24,199,18,13,5
5,24,200,30,16,14
5,24,201,12,21,-9
5,24,202,14,8,6
5,24,203,17,11,6
5,24,204,13,15,-2
5,24,205,14,9,5
5,24,206,4,6,-2
5,24,207,14,6,8
5,24,208,25,6,19
5,24,209,14,6,8
5,24,210,5,7,-2
5,24,211,22,9,13
5,24,212,35,22,13
5,24,213,28,11,17
5,24,214,21,15,6
5,24,215,18,16,2
5,24,216,25,9,16
5,24,217,12,8,4
5,24,218,19,7,12
5,24,219,11,9,2
5,24,220,10,9,1
5,24,221,12,6,6
5,24,222,18,10,8
5,24,223,28,19,9
5,24,224,33,10,23
5,24,225,29,9,20
5,24,226,31,12,19
5,24,227,18,7,11
5,24,228,19,17,2
5,24,229,12,14,-2
5,24,230,11,9,2
5,24,231,24,13,11
5,24,232,29,23,6
5,24,233,13,4,9
5,24,234,15,7,8
5,24,235,20,13,7
5,24,236,15,9,6
5,24,237,36,14,22
5,24,238,20,10,10
5,24,239,18,10,8
5,24,240,30,22,8
5,24,241,28,15,13
5,24,242,11,12,-1
5,24,243,21,5,16
5,24,244,23,13,10
5,24,245,15,3,12
5,24,246,26,12,14
5,24,247,27,26,1
5,24,248,17,7,10
5,24,249,21,10,11
5,24,250,8,3,5
5,24,251,18,12,6
5,24,252,9,5,4
5,24,253,23,9,14
5,24,254,20,10,10
5,24,255,26,11,15
5,24,256,8,14,-6
5,24,257,19,17,2
5,24,258,25,10,15
5,24,259,17,7,10
5,24,260,17,14,3
5,24,261,10,5,5
5,24,262,12,4,8
5,24,263,18,12,6
5,24,264,15,13,2
5,24,265,17,16,1
5,24,266,17,9,8
5,24,267,20,11,9
5,24,268,23,15,8
5,24,269,17,8,9
5,24,270,24,11,13
5,24,271,15,12,3
5,24,272,20,5,15
5,24,273,24,11,13
5,24,274,23,9,14
5,24,275,19,12,7
5,24,276,20,12,8
5,24,277,13,9,4
5,24,278,16,16,0
5,24,279,27,22,5
5,24,280,29,14,15
5,24,281,14,9,5
5,24,282,32,13,19
5,24,283,26,13,13
5,24,284,17,20,-3
5,24,285,15,9,6
5,24,286,30,17,13
5,24,287,28,23,5
5,24,288,29,7,22
5,24,289,26,10,16
5,24,290,10,14,-4
5,24,291,20,18,2
5,24,292,10,6,4
5,24,293,18,11,7
5,24,294,23,8,15
5,24,295,12,11,1
5,24,296,28,11,17
5,24,297,36,17,19
5,24,298,11,10,1
5,24,299,4,5,-1
5,25,0,15,8,7
5,25,1,8,5,3
5,25,2,22,14,8
5,25,3,19,5,14
5,25,4,16,11,5
5,25,5,10,13,-3
5,25,6,32,15,17
5,25,7,24,8,16
5,25,8,17,17,0
5,25,9,22,15,7
5,25,10,5,12,-7
5,25,11,16,7,9
5,25,12,26,18,8
5,25,13,26,6,20
5,25,14,12,8,4
5,25,15,13,16,-3
5,25,16,11,9,2
5,25,17,19,13,6
5,25,18,12,6,6
5,25,19,21,11,10
5,25,20,16,14,2
5,25,21,23,5,18
5,25,22,16,8,8
5,25,23,17,9,8
5,25,24,12,6,6
5,25,25,12,2,10
5,25,26,41,9,32
5,25,27,15,2,13
5,25,28,12,10,2
5,25,29,21,9,12
5,25,30,7,8,-1
5,25,31,15,17,-2
5,25,32,10,6,4
5,25,33,12,12,0
5,25,34,22,14,8
5,25,35,27,11,16
5,25,36,7,7,0
5,25,37,19,7,12
5,25,38,21,9,12
5,25,39,11,7,4
5,25,40,32,11,21
5,25,41,27,7,20
5,25,42,27,10,17
5,25,43,20,13,7
5,25,44,25,10,15
5,25,45,12,11,1
5,25,46,23,21,2
5,25,47,12,13,-1
5,25,48,16,11,5
5,25,49,25,6,19
5,25,50,20,11,9
5,25,51,13,8,5
5,25,52,23,10,13
5,25,53,27,13,14
5,25,54,20,8,12
5,25,55,18,10,8
5,25,56,23,9,14
5,25,57,21,14,7
5,25,58,23,8,15
5,25,59,16,16,0
5,25,60,22,7,15
5,25,61,24,5,19
5,25,62,19,16,3
5,25,63,16,16,0
5,25,64,23,7,16
5,25,65,15,14,1
5,25,66,18,13,5
5,25,67,30,26,4
5,25,68,18,10,8
5,25,69,33,9,24
5,25,70,13,21,-8
5,25,71,14,8,6
5,25,72,24,5,19
5,25,73,17,4,13
5,25,74,50,12,38
5,25,75,13,17,-4
5,25,76,38,14,24
5,25,77,26,19,7
5,25,78,14,12,2
5,25,79,18,8,10
5,25,80,20,17,3
5,25,81,15,11,4
5,25,82,23,18,5
5,25,83,17,2,15
5,25,84,26,10,16
5,25,85,13,3,10
5,25,86,14,8,6
5,25,87,28,9,19
5,25,88,23,13,10
5,25,89,32,11,21
5,25,90,16,13,3
5,25,91,25,15,10
5,25,92,20,20,0
5,25,93,14,12,2
5,25,94,16,9,7
5,25,95,13,4,9
5,25,96,17,4,13
5,25,97,36,10,26
5,25,98,9,5,4
5,25,99,31,12,19
5,25,100,20,8,12
5,25,101,17,11,6
5,25,102,19,7,12
5,25,103,12,13,-1
5,25,104,18,12,6
5,25,105,18,10,8
5,25,106,15,6,9
5,25,107,23,22,1
5,25,108,33,14,19
5,25,109,18,14,4
5,25,110,15,9,6
5,25,111,18,8,10
5,25,112,20,7,13
5,25,113,10,2,8
5,25,114,28,11,17
5,25,115,17,7,10
5,25,116,25,8,17
5,25,117,16,19,-3
5,25,118,29,19,10
5,25,119,23,6,17
5,25,120,14,12,2
5,25,121,11,6,5
5,25,122,15,15,0
5,25,123,26,5,21
5,25,124,14,4,10
5,25,125,43,28,15
5,25,126,11,11,0
5,25,127,18,10,8
5,25,128,26,27,-1
5,25,129,24,12,12
5,25,130,13,10,3
5,25,131,13,5,8
5,25,132,30,15,15
5,25,133,18,12,6
5,25,134,18,7,11
5,25,135,34,5,29
5,25,136,20,14,6
5,25,137,16,6,10
5,25,138,14,3,11
5,25,139,25,6,19
5,25,140,17,18,-1
5,25,141,18,13,5
5,25,142,27,9,18
5,25,143,13,5,8
5,25,144,18,13,5
5,25,145,18,12,6
5,25,146,24,14,10
5,25,147,11,8,3
5,25,148,19,9,10
5,25,149,19,9,10
5,25,150,20,14,6
5,25,151,22,13,9
5,25,152,1,7,-6
5,25,153,18,9,9
5,25,154,24,4,20
5,25,155,17,12,5
5,25,156,27,9,18
5,25,157,22,3,19
5,25,158,22,12,10
5,25,159,17,9,8
5,25,160,27,23,4
5,25,161,12,9,3
5,25,162,17,13,4
5,25,163,19,9,10
5,25,164,14,5,9
5,25,165,17,11,6
5,25,166,22,19,3
5,25,167,8,12,-4
5,25,168,28,6,22
5,25,169,10,4,6
5,25,170,30,13,17
5,25,171,26,22,4
5,25,172,12,9,3
5,25,173,13,14,-1
5,25,174,34,16,18
5,25,175,29,19,10
5,25,176,17,8,9
5,25,177,24,6,18
5,25,178,20,4,16
5,25,179,13,9,4
5,25,180,3,4,-1
5,25,181,25,13,12
5,25,182,14,8,6
5,25,183,37,12,25
5,25,184,24,13,11
5,25,185,24,9,15
5,25,186,14,4,10
5,25,187,15,7,8
5,25,188,24,14,10
5,25,189,21,3,18
5,25,190,21,8,13
5,25,191,22,13,9
5,25,192,24,15,9
5,25,193,23,5,18
5,25,194,13,2,11
5,25,195,17,6,11
5,25,196,20,12,8
5,25,197,26,11,15
5,25,198,13,13,0
5,25,199,21,8,13
5,25,200,22,9,13
5,25,201,22,13,9
5,25,202,16,5,11
5,25,203,27,10,17
5,25,204,27,8,19
5,25,205,17,17,0
5,25,206,14,8,6
5,25,207,20,11,9
5,25,208,17,5,12
5,25,209,22,9,13
5,25,210,17,13,4
5,25,211,18,21,-3
5,25,212,17,5,12
5,25,213,36,18,18
5,25,214,19,7,12
5,25,215,7,12,-5
5,25,216,20,11,9
5,25,217,10,16,-6
5,25,218,18,5,13
5,25,219,15,10,5
5,25,220,20,8,12
5,25,221,5,11,-6
5,25,222,25,9,16
5,25,223,11,13,-2
5,25,224,23,4,19
5,25,225,19,4,15
5,25,226,11,17,-6
5,25,227,19,8,11
5,25,228,14,15,-1
5,25,229,22,16,6
5,25,230,19,8,11
5,25,231,21,14,7
5,25,232,28,20,8
5,25,233,9,8,1
5,25,234,37,9,28
5,25,235,10,7,3
5,25,236,22,10,12
5,25,237,20,8,12
5,25,238,26,11,15
5,25,239,32,9,23
5,25,240,18,10,8
5,25,241,15,13,2
5,25,242,12,5,7
5,25,243,19,16,3
5,25,244,9,8,1
5,25,245,15,6,9
5,25,246,30,17,13
5,25,247,27,13,14
5,25,248,18,5,13
5,25,249,17,9,8
5,25,250,18,9,9
5,25,251,18,7,11
5,25,252,13,6,7
5,25,253,13,9,4
5,25,254,19,3,16
5,25,255,14,6,8
5,25,256,11,3,8
5,25,257,20,11,9
5,25,258,15,10,5
5,25,259,29,12,17
5,25,260,26,17,9
5,25,261,21,11,10
5,25,262,14,7,7
5,25,263,16,6,10
5,25,264,22,4,18
5,25,265,31,10,21
5,25,266,8,11,-3
5,25,267,32,16,16
5,25,268,18,9,9
5,25,269,34,9,25
5,25,270,8,7,1
5,25,271,27,7,20
5,25,272,24,12,12
5,25,273,11,13,-2
5,25,274,30,12,18
5,25,275,18,8,10
5,25,276,25,11,14
5,25,277,17,7,10
5,25,278,31,13,18
5,25,279,15,12,3
5,25,280,18,11,7
5,25,281,26,14,12
5,25,282,15,13,2
5,25,283,22,9,13
5,25,284,20,13,7
5,25,285,18,23,-5
5,25,286,17,12,5
5,25,287,17,16,1
5,25,288,28,14,14
5,25,289,21,13,8
5,25,290,26,7,19
5,25,291,17,9,8
5,25,292,17,23,-6
5,25,293,17,7,10
5,25,294,15,14,1
5,25,295,20,13,7
5,25,296,13,15,-2
5,25,297,18,7,11
5,25,298,16,24,-8
5,25,299,21,3,18
5,26,0,6,6,0
5,26,1,18,9,9
5,26,2,19,11,8
5,26,3,17,18,-1
5,26,4,17,5,12
5,26,5,28,16,12
5,26,6,19,4,15
5,26,7,20,3,17
5,26,8,15,4,11
5,26,9,14,5,9
5,26,10,20,15,5
5,26,11,24,13,11
5,26,12,27,10,17
5,26,13,24,11,13
5,26,14,22,6,16
5,26,15,18,10,8
5,26,16,20,11,9
5,26,17,14,8,6
5,26,18,22,21,1
5,26,19,38,9,29
5,26,20,14,12,2
5,26,21,15,9,6
5,26,22,11,21,-10
5,26,23,20,11,9
5,26,24,23,9,14
5,26,25,10,9,1
5,26,26,21,9,12
5,26,27,19,11,8
5,26,28,7,8,-1
5,26,29,11,16,-5
5,26,30,28,8,20
5,26,31,17,7,10
5,26,32,33,10,23
5,26,33,20,13,7
5,26,34,10,5,5
5,26,35,22,7,15
5,26,36,17,11,6
5,26,37,9,15,-6
5,26,38,16,13,3
5,26,39,32,13,19
5,26,40,14,2,12
5,26,41,24,13,11
5,26,42,33,17,16
5,26,43,16,11,5
5,26,44,16,8,8
5,26,45,20,6,14
5,26,46,29,10,19
5,26,47,19,9,10
5,26,48,11,4,7
5,26,49,13,7,6
5,26,50,13,6,7
5,26,51,13,4,9
5,26,52,18,2,16
5,26,53,26,15,11
5,26,54,11,11,0
5,26,55,17,6,11
5,26,56,9,8,1
5,26,57,17,12,5
5,26,58,18,8,10
5,26,59,20,7,13
5,26,60,19,7,12
5,26,61,24,4,20
5,26,62,16,8,8
5,26,63,13,10,3
5,26,64,22,13,9
5,26,65,32,10,22
5,26,66,17,10,7
5,26,67,26,9,17
5,26,68,18,17,1
5,26,69,29,13,16
5,26,70,25,5,20
5,26,71,15,7,8
5,26,72,31,20,11
5,26,73,14,14,0
5,26,74,19,14,5
5,26,75,10,4,6
5,26,76,22,15,7
5,26,77,38,10,28
5,26,78,13,7,6
5,26,79,25,18,7
5,26,80,12,11,1
5,26,81,7,7,0
5,26,82,19,9,10
5,26,83,5,8,-3
5,26,84,24,14,10
5,26,85,23,6,17
5,26,86,23,5,18
5,26,87,3,12,-9
5,26,88,15,17,-2
5,26,89,15,15,0
5,26,90,9,3,6
5,26,91,24,13,11
5,26,92,30,18,12
5,26,93,14,6,8
5,26,94,16,9,7
5,26,95,21,5,16
5,26,96,16,14,2
5,26,97,11,11,0
5,26,98,17,3,14
5,26,99,19,17,2
5,26,100,12,7,5
5,26,101,15,6,9
5,26,102,11,7,4
5,26,103,16,3,13
5,26,104,10,7,3
5,26,105,15,13,2
5,26,106,17,6,11
5,26,107,12,8,4
5,26,108,12,11,1
5,26,109,17,12,5
5,26,110,32,5,27
5,26,111,7,4,3
5,26,112,8,8,0
5,26,113,17,12,5
5,26,114,25,4,21
5,26,115,39,10,29
5,26,116,8,9,-1
5,26,117,33,4,29
5,26,118,21,8,13
5,26,119,21,11,10
5,26,120,29,1,28
5,26,121,19,16,3
5,26,122,17,7,10
5,26,123,23,14,9
5,26,124,21,11,10
5,26,125,20,6,14
5,26,126,10,11,-1
5,26,127,11,2,9
5,26,128,13,3,10
5,26,129,19,10,9
5,26,130,32,9,23
5,26,131,21,19,2
5,26,132,19,3,16
5,26,133,20,9,11
5,26,134,25,10,15
5,26,135,18,1,17
5,26,136,19,14,5
5,26,137,29,5,24
5,26,138,17,9,8
5,26,139,22,7,15
5,26,140,11,13,-2
5,26,141,9,8,1
5,26,142,27,12,15
5,26,143,23,7,16
5,26,144,23,12,11
5,26,145,20,9,11
5,26,146,30,16,14
5,26,147,34,11,23
5,26,148,30,11,19
5,26,149,16,10,6
5,26,150,22,13,9
5,26,151,28,6,22
5,26,152,28,20,8
5,26,153,20,13,7
5,26,154,15,5,10
5,26,155,30,16,14
5,26,156,1,3,-2
5,26,157,10,18,-8
5,26,158,23,7,16
5,26,159,17,12,5
5,26,160,19,19,0
5,26,161,8,13,-5
5,26,162,22,10,12
5,26,163,19,12,7
5,26,164,44,16,28
5,26,165,19,15,4
5,26,166,29,17,12
5,26,167,15,11,4
5,26,168,12,15,-3
5,26,169,11,7,4
5,26,170,28,11,17
5,26,171,27,12,15
5,26,172,22,5,17
5,26,173,15,12,3
5,26,174,7,5,2
5,26,175,17,12,5
5,26,176,25,11,14
5,26,177,36,13,23
5,26,178,21,16,5
5,26,179,17,2,15
5,26,180,32,17,15
5,26,181,18,15,3
5,26,182,12,28,-16
5,26,183,17,7,10
5,26,184,19,9,10
5,26,185,14,10,4
5,26,186,31,14,17
5,26,187,31,7,24
5,26,188,26,11,15
5,26,189,26,14,12
5,26,190,26,17,9
5,26,191,15,6,9
5,26,192,17,15,2
5,26,193,28,7,21
5,26,194,22,14,8
5,26,195,23,7,16
5,26,196,18,17,1
5,26,197,19,8,11
5,26,198,25,17,8
5,26,199,18,16,2
5,26,200,18,14,4
5,26,201,10,5,5
5,26,202,12,6,6
5,26,203,25,11,14
5,26,204,22,11,11
5,26,205,13,4,9
5,26,206,22,13,9
5,26,207,18,17,1
5,26,208,9,7,2
5,26,209,16,6,10
5,26,210,15,10,5
5,26,211,8,8,0
5,26,212,21,8,13
5,26,213,16,3,13
5,26,214,17,4,13
5,26,215,20,13,7
5,26,216,14,14,0
5,26,217,16,8,8
5,26,218,30,12,18
5,26,219,29,19,10
5,26,220,18,3,15
5,26,221,19,1,18
5,26,222,38,13,25
5,26,223,24,11,13
5,26,224,14,10,4
5,26,225,9,7,2
5,26,226,19,16,3
5,26,227,6,10,-4
5,26,228,24,10,14
5,26,229,23,8,15
5,26,230,17,12,5
5,26,231,30,12,18
5,26,232,22,17,5
5,26,233,15,8,7
5,26,234,28,10,18
5,26,235,12,10,2
5,26,236,17,15,2
5,26,237,13,1,12
5,26,238,15,13,2
5,26,239,6,6,0
5,26,240,25,20,5
5,26,241,18,3,15
5,26,242,22,13,9
5,26,243,16,15,1
5,26,244,38,20,18
5,26,245,18,7,11
5,26,246,9,7,2
5,26,247,20,8,12
5,26,248,12,11,1
5,26,249,16,8,8
5,26,250,29,15,14
5,26,251,17,19,-2
5,26,252,23,22,1
5,26,253,7,10,-3
5,26,254,15,25,-10
5,26,255,12,7,5
5,26,256,24,4,20
5,26,257,15,5,10
5,26,258,34,6,28
5,26,259,28,21,7
5,26,260,17,7,10
5,26,261,14,13,1
5,26,262,31,8,23
5,26,263,15,6,9
5,26,264,13,12,1
5,26,265,24,12,12
5,26,266,18,17,1
5,26,267,35,5,30
5,26,268,22,10,12
5,26,269,17,12,5
5,26,270,31,14,17
5,26,271,32,9,23
5,26,272,20,9,11
5,26,273,31,11,20
5,26,274,6,4,2
5,26,275,33,4,29
5,26,276,6,7,-1
5,26,277,28,10,18
5,26,278,13,8,5
5,26,279,26,5,21
5,26,280,17,5,12
5,26,281,47,8,39
5,26,282,24,12,12
5,26,283,44,3,41
5,26,284,21,11,10
5,26,285,25,12,13
5,26,286,16,10,6
5,26,287,7,12,-5
5,26,288,20,11,9
5,26,289,17,12,5
5,26,290,30,16,14
5,26,291,15,6,9
5,26,292,11,14,-3
5,26,293,26,7,19
5,26,294,28,7,21
5,26,295,29,4,25
5,26,296,23,12,11
5,26,297,30,13,17
5,26,298,20,15,5
5,26,299,7,6,1
5,27,0,32,12,20
5,27,1,16,15,1
5,27,2,9,5,4
5,27,3,26,6,20
5,27,4,6,6,0
5,27,5,21,19,2
5,27,6,17,5,12
5,27,7,9,4,5
5,27,8,17,16,1
5,27,9,18,2,16
5,27,10,34,8,26
5,27,11,7,15,-8
5,27,12,11,6,5
5,27,13,13,17,-4
5,27,14,33,9,24
5,27,15,29,18,11
5,27,16,16,8,8
5,27,17,22,18,4
5,27,18,12,14,-2
5,27,19,45,12,33
5,27,20,19,10,9
5,27,21,16,9,7
5,27,22,22,7,15
5,27,23,15,13,2
5,27,24,22,6,16
5,27,25,28,4,24
5,27,26,28,13,15
5,27,27,14,7,7
5,27,28,14,14,0
5,27,29,10,7,3
5,27,30,19,14,5
5,27,31,14,8,6
5,27,32,27,9,18
5,27,33,29,12,17
5,27,34,31,15,16
5,27,35,13,20,-7
5,27,36,17,16,1
5,27,37,36,14,22
5,27,38,23,15,8
5,27,39,15,9,6
5,27,40,18,13,5
5,27,41,10,14,-4
5,27,42,16,6,10
5,27,43,7,0,7
5,27,44,26,19,7
5,27,45,31,19,12
5,27,46,12,11,1
5,27,47,26,7,19
5,27,48,27,23,4
5,27,49,22,8,14
5,27,50,15,10,5
5,27,51,14,7,7
5,27,52,24,12,12
5,27,53,17,5,12
5,27,54,14,5,9
5,27,55,34,12,22
5,27,56,19,11,8
5,27,57,11,7,4
5,27,58,18,8,10
5,27,59,18,4,14
5,27,60,11,3,8
5,27,61,23,9,14
5,27,62,30,11,19
5,27,63,10,9,1
5,27,64,16,9,7
5,27,65,31,10,21
5,27,66,23,17,6
5,27,67,17,11,6
5,27,68,30,10,20
5,27,69,19,10,9
5,27,70,21,9,12
5,27,71,23,23,0
5,27,72,27,22,5
5,27,73,21,4,17
5,27,74,24,17,7
5,27,75,16,7,9
5,27,76,36,13,23
5,27,77,23,6,17
5,27,78,13,6,7
5,27,79,16,4,12
5,27,80,23,5,18
5,27,81,29,11,18
5,27,82,20,5,15
5,27,83,30,23,7
5,27,84,26,20,6
5,27,85,21,17,4
5,27,86,14,11,3
5,27,87,10,5,5
5,27,88,17,9,8
5,27,89,45,22,23
5,27,90,29,13,16
5,27,91,24,5,19
5,27,92,17,11,6
5,27,93,19,9,10
5,27,94,18,11,7
5,27,95,14,12,2
5,27,96,15,7,8
5,27,97,27,10,17
5,27,98,14,5,9
5,27,99,17,5,12
5,27,100,10,6,4
5,27,101,19,7,12
5,27,102,12,7,5
5,27,103,33,5,28
5,27,104,36,10,26
5,27,105,25,13,12
5,27,106,34,9,25
5,27,107,16,7,9
5,27,108,16,9,7
5,27,109,18,16,2
5,27,110,36,12,24
5,27,111,25,10,15
5,27,112,19,8,11
5,27,113,12,7,5
5,27,114,11,7,4
5,27,115,30,10,20
5,27,116,22,4,18
5,27,117,20,7,13
5,27,118,14,15,-1
5,27,119,10,7,3
5,27,120,23,12,11
5,27,121,16,12,4
5,27,122,18,8,10
5,27,123,10,7,3
5,27,124,16,5,11
5,27,125,11,6,5
5,27,126,20,7,13
5,27,127,4,10,-6
5,27,128,27,12,15
5,27,129,13,9,4
5,27,130,13,6,7
5,27,131,28,6,22
5,27,132,19,11,8
5,27,133,30,10,20
5,27,134,23,9,14
5,27,135,20,10,10
5,27,136,28,15,13
5,27,137,13,11,2
5,27,138,31,14,17
5,27,139,30,10,20
5,27,140,21,11,10
5,27,141,29,10,19
5,27,142,30,9,21
5,27,143,25,11,14
5,27,144,17,3,14
5,27,145,23,11,12
5,27,146,17,20,-3
5,27,147,20,15,5
5,27,148,19,8,11
5,27,149,5,7,-2
5,27,150,15,6,9
5,27,151,7,6,1
5,27,152,27,6,21
5,27,153,20,18,2
5,27,154,14,15,-1
5,27,155,19,11,8
5,27,156,21,12,9
5,27,157,18,5,13
5,27,158,32,20,12
5,27,159,23,4,19
5,27,160,32,8,24
5,27,161,21,6,15
5,27,162,4,4,0
5,27,163,20,7,13
5,27,164,19,4,15
5,27,165,35,10,25
5,27,166,13,6,7
5,27,167,18,11,7
5,27,168,29,9,20
5,27,169,24,10,14
5,27,170,14,12,2
5,27,171,21,4,17
5,27,172,27,2,25
5,27,173,13,10,3
5,27,174,26,12,14
5,27,175,27,13,14
5,27,176,20,4,16
5,27,177,16,13,3
5,27,178,19,4,15
5,27,179,19,10,9
5,27,180,16,4,12
5,27,181,33,20,13
5,27,182,18,11,7
5,27,183,14,11,3
5,27,184,5,4,1
5,27,185,16,1,15
5,27,186,17,16,1
5,27,187,37,10,27
5,27,188,22,21,1
5,27,189,12,9,3
5,27,190,19,5,14
5,27,191,24,7,17
5,27,192,25,10,15
5,27,193,16,14,2
5,27,194,8,12,-4
5,27,195,19,7,12
5,27,196,12,7,5
5,27,197,24,8,16
5,27,198,26,13,13
5,27,199,20,8,12
5,27,200,15,7,8
5,27,201,19,9,10
5,27,202,20,9,11
5,27,203,21,5,16
5,27,204,20,6,14
5,27,205,20,8,12
5,27,206,9,7,2
5,27,207,11,9,2
5,27,208,12,10,2
5,27,209,13,6,7
5,27,210,32,16,16
5,27,211,41,6,35
5,27,212,17,4,13
5,27,213,19,12,7
5,27,214,25,7,18
5,27,215,24,15,9
5,27,216,22,10,12
5,27,217,45,13,32
5,27,218,25,19,6
5,27,219,12,10,2
5,27,220,34,18,16
5,27,221,22,6,16
5,27,222,32,6,26
5,27,223,20,9,11
5,27,224,38,4,34
5,27,225,22,9,13
5,27,226,25,8,17
5,27,227,21,19,2
5,27,228,20,12,8
5,27,229,39,18,21
5,27,230,19,16,3
5,27,231,14,7,7
5,27,232,15,6,9
5,27,233,15,5,10
5,27,234,18,12,6
5,27,235,19,10,9
5,27,236,18,16,2
5,27,237,14,8,6
5,27,238,16,11,5
5,27,239,28,15,13
5,27,240,28,9,19
5,27,241,20,11,9
5,27,242,17,8,9
5,27,243,33,12,21
5,27,244,13,13,0
5,27,245,13,5,8
5,27,246,10,12,-2
5,27,247,24,5,19
5,27,248,20,17,3
5,27,249,18,16,2
5,27,250,18,8,10
5,27,251,14,5,9
5,27,252,9,10,-1
5,27,253,34,8,26
5,27,254,10,11,-1
5,27,255,19,10,9
5,27,256,17,19,-2
5,27,257,14,5,9
5,27,258,14,8,6
5,27,259,5,5,0
5,27,260,16,6,10
5,27,261,3,9,-6
5,27,262,12,9,3
5,27,263,18,15,3
5,27,264,20,8,12
5,27,265,18,9,9
5,27,266,14,0,14
5,27,267,16,10,6
5,27,268,28,16,12
5,27,269,28,6,22
5,27,270,25,6,19
5,27,271,28,13,15
5,27,272,32,4,28
5,27,273,10,6,4
5,27,274,35,17,18
5,27,275,18,15,3
5,27,276,15,4,11
5,27,277,31,6,25
5,27,278,19,9,10
5,27,279,30,13,17
5,27,280,49,14,35
5,27,281,21,12,9
5,27,282,19,12,7
5,27,283,34,8,26
5,27,284,31,12,19
5,27,285,19,6,13
5,27,286,9,5,4
5,27,287,12,10,2
5,27,288,22,15,7
5,27,289,21,8,13
5,27,290,32,14,18
5,27,291,15,13,2
5,27,292,10,4,6
5,27,293,18,19,-1
5,27,294,25,14,11
5,27,295,16,8,8
5,27,296,12,13,-1
5,27,297,21,15,6
5,27,298,22,9,13
5,27,299,28,9,19
5,28,0,19,11,8
5,28,1,7,12,-5
5,28,2,17,11,6
5,28,3,16,13,3
5,28,4,20,2,18
5,28,5,23,12,11
5,28,6,21,7,14
5,28,7,20,7,13
5,28,8,33,15,18
5,28,9,33,20,13
5,28,10,27,17,10
5,28,11,21,10,11
5,28,12,26,12,14
5,28,13,24,7,17
5,28,14,24,17,7
5,28,15,31,10,21
5,28,16,10,11,-1
5,28,17,23,14,9
5,28,18,16,12,4
5,28,19,36,4,32
5,28,20,10,8,2
5,28,21,25,10,15
5,28,22,29,13,16
5,28,23,11,5,6
5,28,24,15,10,5
5,28,25,16,15,1
5,28,26,13,11,2
5,28,27,19,11,8
5,28,28,15,17,-2
5,28,29,8,9,-1
5,28,30,12,10,2
5,28,31,40,18,22
5,28,32,24,13,11
5,28,33,35,6,29
5,28,34,7,2,5
5,28,35,17,16,1
5,28,36,27,11,16
5,28,37,19,2,17
5,28,38,17,13,4
5,28,39,14,9,5
5,28,40,18,8,10
5,28,41,13,9,4
5,28,42,22,26,-4
5,28,43,22,11,11
5,28,44,13,16,-3
5,28,45,22,12,10
5,28,46,17,12,5
5,28,47,35,1,34
5,28,48,19,9,10
5,28,49,14,15,-1
5,28,50,23,11,12
5,28,51,31,5,26
5,28,52,18,10,8
5,28,53,19,10,9
5,28,54,11,2,9
5,28,55,24,10,14
5,28,56,22,7,15
5,28,57,28,14,14
5,28,58,19,2,17
5,28,59,14,7,7
5,28,60,29,13,16
5,28,61,15,12,3
5,28,62,13,6,7
5,28,63,21,14,7
5,28,64,30,12,18
5,28,65,26,19,7
5,28,66,16,10,6
5,28,67,24,12,12
5,28,68,22,5,17
5,28,69,22,13,9
5,28,70,12,4,8
5,28,71,9,6,3
5,28,72,16,13,3
5,28,73,18,10,8
5,28,74,25,10,15
5,28,75,23,11,12
5,28,76,19,11,8
5,28,77,34,4,30
5,28,78,15,6,9
5,28,79,16,10,6
5,28,80,15,4,11
5,28,81,15,6,9
5,28,82,13,4,9
5,28,83,9,12,-3
5,28,84,21,5,16
5,28,85,18,5,13
5,28,86,13,8,5
5,28,87,7,9,-2
5,28,88,19,1,18
5,28,89,21,5,16
5,28,90,25,3,22
5,28,91,20,7,13
5,28,92,32,13,19
5,28,93,17,3,14
5,28,94,12,6,6
5,28,95,9,5,4
5,28,96,29,4,25
5,28,97,26,10,16
5,28,98,23,11,12
5,28,99,22,7,15
5,28,100,17,5,12
5,28,101,30,9,21
5,28,102,17,15,2
5,28,103,19,14,5
5,28,104,29,10,19
5,28,105,23,8,15
5,28,106,21,9,12
5,28,107,18,9,9
5,28,108,14,9,5
5,28,109,32,14,18
5,28,110,22,9,13
5,28,111,27,25,2
5,28,112,28,4,24
5,28,113,10,17,-7
5,28,114,9,11,-2
5,28,115,19,5,14
5,28,116,14,10,4
5,28,117,34,15,19
5,28,118,19,3,16
5,28,119,19,7,12
5,28,120,19,5,14
5,28,121,19,14,5
5,28,122,19,6,13
5,28,123,14,9,5
5,28,124,17,14,3
5,28,125,21,6,15
5,28,126,19,16,3
5,28,127,19,5,14
5,28,128,12,17,-5
5,28,129,25,17,8
5,28,130,5,15,-10
5,28,131,19,5,14
5,28,132,37,13,24
5,28,133,30,18,12
5,28,134,26,12,14
5,28,135,19,12,7
5,28,136,25,16,9
5,28,137,19,7,12
5,28,138,19,18,1
5,28,139,25,9,16
5,28,140,26,13,13
5,28,141,12,10,2
5,28,142,21,18,3
5,28,143,19,15,4
5,28,144,8,6,2
5,28,145,34,15,19
5,28,146,19,5,14
5,28,147,21,19,2
5,28,148,34,9,25
5,28,149,23,4,19
5,28,150,36,11,25
5,28,151,8,0,8
5,28,152,26,7,19
5,28,153,18,11,7
5,28,154,29,5,24
5,28,155,12,7,5
5,28,156,8,1,7
5,28,157,12,6,6
5,28,158,16,11,5
5,28,159,17,5,12
5,28,160,17,9,8
5,28,161,21,9,12
5,28,162,24,12,12
5,28,163,11,7,4
5,28,164,34,7,27
5,28,165,5,3,2
5,28,166,18,17,1
5,28,167,22,8,14
5,28,168,24,2,22
5,28,169,13,8,5
5,28,170,15,3,12
5,28,171,16,11,5
5,28,172,23,12,11
5,28,173,20,13,7
5,28,174,23,12,11
5,28,175,12,12,0
5,28,176,21,1,20
5,28,177,35,15,20
5,28,178,12,6,6
5,28,179,18,8,10
5,28,180,28,11,17
5,28,181,16,11,5
5,28,182,19,6,13
5,28,183,29,11,18
5,28,184,24,5,19
5,28,185,12,4,8
5,28,186,23,7,16
5,28,187,21,7,14
5,28,188,15,5,10
5,28,189,19,16,3
5,28,190,22,6,16
5,28,191,23,7,16
5,28,192,23,9,14
5,28,193,26,1,25
5,28,194,25,4,21
5,28,195,35,17,18
5,28,196,13,3,10
5,28,197,15,8,7
5,28,198,15,9,6
5,28,199,17,10,7
5,28,200,9,8,1
5,28,201,19,6,13
5,28,202,15,13,2
5,28,203,22,17,5
5,28,204,38,12,26
5,28,205,28,11,17
5,28,206,11,7,4
5,28,207,3,11,-8
5,28,208,20,11,9
5,28,209,13,4,9
5,28,210,14,8,6
5,28,211,18,10,8
5,28,212,25,20,5
5,28,213,53,10,43
5,28,214,40,13,27
5,28,215,22,17,5
5,28,216,18,13,5
5,28,217,18,9,9
5,28,218,14,3,11
5,28,219,21,21,0
5,28,220,17,18,-1
5,28,221,22,9,13
5,28,222,12,3,9
5,28,223,28,9,19
5,28,224,17,23,-6
5,28,225,12,4,8
5,28,226,31,5,26
5,28,227,29,12,17
5,28,228,18,3,15
5,28,229,14,5,9
5,28,230,30,23,7
5,28,231,18,7,11
5,28,232,8,9,-1
5,28,233,23,2,21
5,28,234,26,10,16
5,28,235,15,8,7
5,28,236,21,5,16
5,28,237,11,8,3
5,28,238,19,6,13
5,28,239,23,12,11
5,28,240,30,8,22
5,28,241,12,7,5
5,28,242,9,6,3
5,28,243,20,10,10
5,28,244,33,18,15
5,28,245,39,14,25
5,28,246,16,6,10
5,28,247,23,4,19
5,28,248,18,17,1
5,28,249,32,7,25
5,28,250,23,5,18
5,28,251,13,5,8
5,28,252,20,20,0
5,28,253,27,10,17
5,28,254,28,7,21
5,28,255,23,10,13
5,28,256,11,6,5
5,28,257,13,13,0
5,28,258,17,15,2
5,28,259,19,8,11
5,28,260,8,7,1
5,28,261,19,7,12
5,28,262,10,4,6
5,28,263,11,8,3
5,28,264,14,8,6
5,28,265,12,11,1
5,28,266,14,8,6
5,28,267,21,8,13
5,28,268,33,8,25
5,28,269,15,7,8
5,28,270,25,9,16
5,28,271,18,10,8
5,28,272,26,15,11
5,28,273,6,3,3
5,28,274,26,10,16
5,28,275,18,11,7
5,28,276,11,13,-2
5,28,277,17,5,12
5,28,278,11,5,6
5,28,279,26,20,6
5,28,280,28,21,7
5,28,281,25,8,17
5,28,282,16,6,10
5,28,283,21,8,13
5,28,284,13,11,2
5,28,285,33,17,16
5,28,286,26,14,12
5,28,287,19,11,8
5,28,288,20,11,9
5,28,289,18,5,13
5,28,290,18,0,18
5,28,291,16,11,5
5,28,292,22,8,14
5,28,293,19,1,18
5,28,294,25,16,9
5,28,295,21,7,14
5,28,296,14,5,9
5,28,297,31,5,26
5,28,298,16,8,8
5,28,299,23,14,9
5,29,0,16,5,11
5,29,1,25,16,9
5,29,2,22,8,14
5,29,3,15,11,4
5,29,4,17,8,9
5,29,5,28,16,12
5,29,6,15,9,6
5,29,7,20,7,13
5,29,8,21,10,11
5,29,9,18,6,12
5,29,10,22,10,12
5,29,11,24,10,14
5,29,12,20,13,7
5,29,13,17,8,9
5,29,14,5,4,1
5,29,15,20,8,12
5,29,16,18,10,8
5,29,17,40,16,24
5,29,18,25,7,18
5,29,19,15,13,2
5,29,20,6,11,-5
5,29,21,20,2,18
5,29,22,12,11,1
5,29,23,25,11,14
5,29,24,10,12,-2
5,29,25,25,13,12
5,29,26,15,7,8
5,29,27,22,9,13
5,29,28,18,16,2
5,29,29,19,12,7
5,29,30,22,4,18
5,29,31,19,13,6
5,29,32,19,8,11
5,29,33,19,11,8
5,29,34,41,18,23
5,29,35,13,10,3
5,29,36,14,6,8
5,29,37,23,9,14
5,29,38,32,14,18
5,29,39,31,12,19
5,29,40,22,15,7
5,29,41,26,17,9
5,29,42,23,14,9
5,29,43,17,5,12
5,29,44,16,2,14
5,29,45,28,5,23
5,29,46,26,4,22
5,29,47,10,8,2
5,29,48,38,13,25
5,29,49,20,6,14
5,29,50,13,17,-4
5,29,51,24,10,14
5,29,52,24,14,10
5,29,53,14,15,-1
5,29,54,19,19,0
5,29,55,20,12,8
5,29,56,24,13,11
5,29,57,14,16,-2
5,29,58,23,7,16
5,29,59,23,8,15
5,29,60,19,9,10
5,29,61,15,24,-9
5,29,62,11,3,8
5,29,63,10,4,6
5,29,64,23,9,14
5,29,65,22,6,16
5,29,66,5,3,2
5,29,67,13,10,3
5,29,68,28,3,25
5,29,69,16,14,2
5,29,70,31,10,21
5,29,71,19,7,12
5,29,72,22,4,18
5,29,73,16,14,2
5,29,74,9,9,0
5,29,75,22,3,19
5,29,76,16,14,2
5,29,77,27,16,11
5,29,78,36,6,30
5,29,79,26,18,8
5,29,80,16,12,4
5,29,81,18,9,9
5,29,82,9,10,-1
5,29,83,18,6,12
5,29,84,13,10,3
5,29,85,25,5,20
5,29,86,12,11,1
5,29,87,27,19,8
5,29,88,9,5,4
5,29,89,17,2,15
5,29,90,20,16,4
5,29,91,37,12,25
5,29,92,7,0,7
5,29,93,40,6,34
5,29,94,36,9,27
5,29,95,20,11,9
5,29,96,21,15,6
5,29,97,11,15,-4
5,29,98,23,12,11
5,29,99,10,10,0
5,29,100,23,6,17
5,29,101,29,9,20
5,29,102,14,3,11
5,29,103,14,11,3
5,29,104,18,9,9
5,29,105,25,16,9
5,29,106,29,5,24
5,29,107,20,7,13
5,29,108,5,3,2
5,29,109,18,5,13
5,29,110,20,10,10
5,29,111,18,9,9
5,29,112,20,8,12
5,29,113,23,13,10
5,29,114,27,12,15
5,29,115,12,9,3
5,29,116,6,15,-9
5,29,117,11,8,3
5,29,118,14,4,10
5,29,119,15,10,5
5,29,120,18,10,8
5,29,121,21,4,17
5,29,122,32,5,27
5,29,123,19,5,14
5,29,124,23,11,12
5,29,125,7,3,4
5,29,126,18,4,14
5,29,127,22,22,0
5,29,128,25,2,23
5,29,129,39,8,31
5,29,130,23,10,13
5,29,131,11,11,0
5,29,132,20,9,11
5,29,133,17,9,8
5,29,134,23,9,14
5,29,135,12,11,1
5,29,136,20,8,12
5,29,137,18,10,8
5,29,138,28,7,21
5,29,139,20,17,3
5,29,140,15,4,11
5,29,141,30,9,21
5,29,142,20,14,6
5,29,143,31,14,17
5,29,144,20,13,7
5,29,145,13,7,6
5,29,146,33,18,15
5,29,147,30,24,6
5,29,148,27,10,17
5,29,149,11,10,1
5,29,150,12,6,6
5,29,151,27,9,18
5,29,152,17,9,8
5,29,153,32,14,18
5,29,154,30,12,18
5,29,155,26,13,13
5,29,156,11,8,3
5,29,157,20,10,10
5,29,158,9,5,4
5,29,159,15,10,5
5,29,160,27,10,17
5,29,161,27,13,14
5,29,162,26,3,23
5,29,163,21,13,8
5,29,164,12,6,6
5,29,165,31,2,29
5,29,166,34,14,20
5,29,167,26,4,22
5,29,168,9,11,-2
5,29,169,14,5,9
5,29,170,27,13,14
5,29,171,20,15,5
5,29,172,7,9,-2
5,29,173,18,12,6
5,29,174,12,8,4
5,29,175,27,6,21
5,29,176,34,13,21
5,29,177,16,10,6
5,29,178,11,6,5
5,29,179,36,9,27
5,29,180,18,10,8
5,29,181,25,4,21
5,29,182,26,9,17
5,29,183,26,11,15
5,29,184,15,15,0
5,29,185,13,5,8
5,29,186,19,6,13
5,29,187,27,7,20
5,29,188,10,16,-6
5,29,189,14,8,6
5,29,190,22,9,13
5,29,191,10,1,9
5,29,192,16,7,9
5,29,193,20,6,14
5,29,194,23,9,14
5,29,195,23,11,12
5,29,196,38,15,23
5,29,197,29,5,24
5,29,198,15,8,7
5,29,199,16,1,15
5,29,200,18,10,8
5,29,201,21,17,4
5,29,202,18,8,10
5,29,203,14,6,8
5,29,204,20,12,8
5,29,205,15,13,2
5,29,206,28,9,19
5,29,207,21,13,8
5,29,208,21,8,13
5,29,209,22,7,15
5,29,210,12,5,7
5,29,211,21,6,15
5,29,212,30,11,19
5,29,213,21,10,11
5,29,214,12,5,7
5,29,215,25,7,18
5,29,216,21,6,15
5,29,217,19,10,9
5,29,218,18,12,6
5,29,219,24,11,13
5,29,220,22,6,16
5,29,221,27,11,16
5,29,222,21,24,-3
5,29,223,32,11,21
5,29,224,30,14,16
5,29,225,16,12,4
5,29,226,23,13,10
5,29,227,26,11,15
5,29,228,23,13,10
5,29,229,36,13,23
5,29,230,15,12,3
5,29,231,17,7,10
5,29,232,14,9,5
5,29,233,39,18,21
5,29,234,41,11,30
5,29,235,22,9,13
5,29,236,19,11,8
5,29,237,21,12,9
5,29,238,14,13,1
5,29,239,30,4,26
5,29,240,18,10,8
5,29,241,15,6,9
5,29,242,9,2,7
5,29,243,16,9,7
5,29,244,18,7,11
5,29,245,25,11,14
5,29,246,39,13,26
5,29,247,22,3,19
5,29,248,23,7,16
5,29,249,28,23,5
5,29,250,20,5,15
5,29,251,11,7,4
5,29,252,23,5,18
5,29,253,11,4,7
5,29,254,10,2,8
5,29,255,22,9,13
5,29,256,18,4,14
5,29,257,25,15,10
5,29,258,14,8,6
5,29,259,19,10,9
5,29,260,12,8,4
5,29,261,15,19,-4
5,29,262,21,15,6
5,29,263,20,8,12
5,29,264,25,12,13
5,29,265,16,4,12
5,29,266,16,4,12
5,29,267,21,17,4
5,29,268,23,12,11
5,29,269,15,1,14
5,29,270,26,6,20
5,29,271,10,10,0
5,29,272,13,4,9
5,29,273,18,18,0
5,29,274,23,9,14
5,29,275,11,9,2
5,29,276,21,11,10
5,29,277,12,3,9
5,29,278,18,13,5
5,29,279,19,8,11
5,29,280,31,18,13
5,29,281,22,7,15
5,29,282,15,10,5
5,29,283,17,3,14
5,29,284,23,19,4
5,29,285,31,10,21
5,29,286,23,7,16
5,29,287,29,7,22
5,29,288,27,7,20
5,29,289,22,9,13
5,29,290,26,26,0
5,29,291,15,4,11
5,29,292,32,10,22
5,29,293,4,7,-3
5,29,294,15,3,12
5,29,295,14,3,11
5,29,296,33,13,20
5,29,297,12,10,2
5,29,298,11,7,4
5,29,299,12,8,4
5,30,0,18,4,14
5,30,1,19,10,9
5,30,2,18,11,7
5,30,3,22,11,11
5,30,4,17,13,4
5,30,5,18,20,-2
5,30,6,24,11,13
5,30,7,14,8,6
5,30,8,21,10,11
5,30,9,20,15,5
5,30,10,21,9,12
5,30,11,27,10,17
5,30,12,18,8,10
5,30,13,25,11,14
5,30,14,20,4,16
5,30,15,20,10,10
5,30,16,18,11,7
5,30,17,24,10,14
5,30,18,25,19,6
5,30,19,7,8,-1
5,30,20,14,8,6
5,30,21,18,8,10
5,30,22,13,7,6
5,30,23,9,1,8
5,30,24,10,9,1
5,30,25,6,5,1
5,30,26,13,9,4
5,30,27,20,6,14
5,30,28,28,2,26
5,30,29,15,5,10
5,30,30,22,12,10
5,30,31,25,13,12
5,30,32,18,8,10
5,30,33,17,11,6
5,30,34,25,12,13
5,30,35,30,7,23
5,30,36,23,8,15
5,30,37,34,15,19
5,30,38,16,13,3
5,30,39,23,6,17
5,30,40,13,6,7
5,30,41,38,8,30
5,30,42,38,13,25
5,30,43,21,8,13
5,30,44,19,5,14
5,30,45,38,9,29
5,30,46,14,10,4
5,30,47,14,10,4
5,30,48,18,10,8
5,30,49,28,7,21
5,30,50,36,12,24
5,30,51,19,8,11
5,30,52,16,13,3
5,30,53,17,13,4
5,30,54,13,10,3
5,30,55,21,6,15
5,30,56,7,10,-3
5,30,57,19,12,7
5,30,58,32,8,24
5,30,59,14,11,3
5,30,60,29,8,21
5,30,61,25,22,3
5,30,62,17,7,10
5,30,63,20,5,15
5,30,64,13,9,4
5,30,65,15,1,14
5,30,66,27,14,13
5,30,67,13,16,-3
5,30,68,19,9,10
5,30,69,29,12,17
5,30,70,21,6,15
5,30,71,18,5,13
5,30,72,23,8,15
5,30,73,15,7,8
5,30,74,14,10,4
5,30,75,23,19,4
5,30,76,18,7,11
5,30,77,25,5,20
5,30,78,4,3,1
5,30,79,27,14,13
5,30,80,26,11,15
5,30,81,22,3,19
5,30,82,13,11,2
5,30,83,17,8,9
5,30,84,26,9,17
5,30,85,20,3,17
5,30,86,14,4,10
5,30,87,22,9,13
5,30,88,20,8,12
5,30,89,14,12,2
5,30,90,18,5,13
5,30,91,21,9,12
5,30,92,27,4,23
5,30,93,21,11,10
5,30,94,23,11,12
5,30,95,24,10,14
5,30,96,17,14,3
5,30,97,14,9,5
5,30,98,8,9,-1
5,30,99,31,5,26
5,30,100,39,11,28
5,30,101,21,8,13
5,30,102,24,7,17
5,30,103,15,7,8
5,30,104,13,8,5
5,30,105,20,5,15
5,30,106,33,12,21
5,30,107,14,11,3
5,30,108,17,5,12
5,30,109,34,14,20
5,30,110,6,5,1
5,30,111,20,4,16
5,30,112,6,13,-7
5,30,113,22,6,16
5,30,114,26,9,17
5,30,115,13,14,-1
5,30,116,19,4,15
5,30,117,19,11,8
5,30,118,18,7,11
5,30,119,12,7,5
5,30,120,10,5,5
5,30,121,15,10,5
5,30,122,27,13,14
5,30,123,22,10,12
5,30,124,27,13,14
5,30,125,22,21,1
5,30,126,26,9,17
5,30,127,29,16,13
5,30,128,27,18,9
5,30,129,33,11,22
5,30,130,19,9,10
5,30,131,17,7,10
5,30,132,27,4,23
5,30,133,22,10,12
5,30,134,10,6,4
5,30,135,13,6,7
5,30,136,18,12,6
5,30,137,21,11,10
5,30,138,21,4,17
5,30,139,12,7,5
5,30,140,13,4,9
5,30,141,30,21,9
5,30,142,11,7,4
5,30,143,15,19,-4
5,30,144,13,6,7
5,30,145,24,7,17
5,30,146,34,13,21
5,30,147,20,4,16
5,30,148,15,8,7
5,30,149,23,7,16
5,30,150,22,14,8
5,30,151,13,11,2
5,30,152,22,15,7
5,30,153,17,3,14
5,30,154,18,11,7
5,30,155,34,11,23
5,30,156,25,11,14
5,30,157,32,19,13
5,30,158,15,11,4
5,30,159,20,15,5
5,30,160,29,8,21
5,30,161,19,8,11
5,30,162,15,13,2
5,30,163,19,14,5
5,30,164,23,12,11
5,30,165,21,7,14
5,30,166,13,9,4
5,30,167,18,9,9
5,30,168,27,8,19
5,30,169,26,6,20
5,30,170,23,5,18
5,30,171,12,9,3
5,30,172,19,9,10
5,30,173,24,9,15
5,30,174,15,10,5
5,30,175,4,0,4
5,30,176,33,17,16
5,30,177,22,11,11
5,30,178,16,9,7
5,30,179,23,12,11
5,30,180,31,12,19
5,30,181,26,6,20
5,30,182,18,5,13
5,30,183,15,6,9
5,30,184,22,9,13
5,30,185,18,5,13
5,30,186,32,15,17
5,30,187,23,9,14
5,30,188,20,11,9
5,30,189,23,11,12
5,30,190,20,3,17
5,30,191,25,8,17
5,30,192,16,10,6
5,30,193,22,9,13
5,30,194,12,5,7
5,30,195,20,5,15
5,30,196,23,9,14
5,30,197,18,14,4
5,30,198,38,21,17
5,30,199,36,9,27
5,30,200,13,8,5
5,30,201,16,13,3
5,30,202,19,10,9
5,30,203,25,5,20
5,30,204,17,9,8
5,30,205,15,11,4
5,30,206,20,5,15
5,30,207,11,11,0
5,30,208,21,11,10
5,30,209,24,8,16
5,30,210,19,7,12
5,30,211,18,6,12
5,30,212,12,10,2
5,30,213,21,4,17
5,30,214,7,6,1
5,30,215,31,12,19
5,30,216,9,9,0
5,30,217,11,15,-4
5,30,218,18,18,0
5,30,219,20,15,5
5,30,220,20,7,13
5,30,221,29,9,20
5,30,222,7,16,-9
5,30,223,10,16,-6
5,30,224,33,6,27
5,30,225,36,10,26
5,30,226,30,16,14
5,30,227,19,7,12
5,30,228,16,6,10
5,30,229,29,25,4
5,30,230,27,11,16
5,30,231,14,11,3
5,30,232,13,3,10
5,30,233,19,6,13
5,30,234,18,8,10
5,30,235,12,4,8
5,30,236,15,9,6
5,30,237,23,4,19
5,30,238,25,10,15
5,30,239,13,10,3
5,30,240,27,15,12
5,30,241,23,10,13
5,30,242,18,5,13
5,30,243,17,9,8
5,30,244,25,10,15
5,30,245,20,21,-1
5,30,246,25,13,12
5,30,247,15,5,10
5,30,248,26,2,24
5,30,249,23,13,10
5,30,250,13,5,8
5,30,251,17,10,7
5,30,252,22,4,18
5,30,253,12,12,0
5,30,254,17,10,7
5,30,255,24,15,9
5,30,256,18,9,9
5,30,257,22,2,20
5,30,258,26,13,13
5,30,259,17,10,7
5,30,260,26,13,13
5,30,261,29,5,24
5,30,262,23,13,10
5,30,263,7,5,2
5,30,264,9,3,6
5,30,265,19,7,12
5,30,266,16,5,11
5,30,267,17,5,12
5,30,268,15,9,6
5,30,269,14,6,8
5,30,270,16,10,6
5,30,271,14,5,9
5,30,272,17,8,9
5,30,273,15,8,7
5,30,274,28,12,16
5,30,275,23,6,17
5,30,276,24,10,14
5,30,277,19,8,11
5,30,278,9,10,-1
5,30,279,29,12,17
5,30,280,15,9,6
5,30,281,21,14,7
5,30,282,16,8,8
5,30,283,23,18,5
5,30,284,29,15,14
5,30,285,8,2,6
5,30,286,13,4,9
5,30,287,11,5,6
5,30,288,23,7,16
5,30,289,27,17,10
5,30,290,29,13,16
5,30,291,14,6,8
5,30,292,14,8,6
5,30,293,22,16,6
5,30,294,15,9,6
5,30,295,30,6,24
5,30,296,18,9,9
5,30,297,26,12,14
5,30,298,22,10,12
5,30,299,22,10,12
