# frame_skip_agent_A, frame_skip_agent_B, episode, score_A, score_B, reward
6,1,0,9,12,-3
6,1,1,16,22,-6
6,1,2,22,10,12
6,1,3,7,19,-12
6,1,4,8,7,1
6,1,5,11,14,-3
6,1,6,8,2,6
6,1,7,10,4,6
6,1,8,5,7,-2
6,1,9,7,6,1
6,1,10,14,15,-1
6,1,11,4,10,-6
6,1,12,6,5,1
6,1,13,12,8,4
6,1,14,17,24,-7
6,1,15,3,8,-5
6,1,16,7,8,-1
6,1,17,6,4,2
6,1,18,7,15,-8
6,1,19,15,15,0
6,1,20,5,6,-1
6,1,21,12,10,2
6,1,22,22,9,13
6,1,23,8,8,0
6,1,24,9,14,-5
6,1,25,4,7,-3
6,1,26,3,10,-7
6,1,27,19,16,3
6,1,28,16,7,9
6,1,29,22,15,7
6,1,30,13,13,0
6,1,31,8,14,-6
6,1,32,4,9,-5
6,1,33,10,10,0
6,1,34,10,13,-3
6,1,35,7,15,-8
6,1,36,5,4,1
6,1,37,6,14,-8
6,1,38,10,8,2
6,1,39,7,10,-3
6,1,40,13,2,11
6,1,41,7,9,-2
6,1,42,4,11,-7
6,1,43,14,4,10
6,1,44,4,7,-3
6,1,45,4,5,-1
6,1,46,11,14,-3
6,1,47,14,11,3
6,1,48,6,11,-5
6,1,49,9,3,6
6,1,50,15,9,6
6,1,51,6,10,-4
6,1,52,11,11,0
6,1,53,18,21,-3
6,1,54,7,10,-3
6,1,55,11,11,0
6,1,56,7,12,-5
6,1,57,5,13,-8
6,1,58,12,13,-1
6,1,59,11,13,-2
6,1,60,8,16,-8
6,1,61,6,1,5
6,1,62,13,22,-9
6,1,63,10,14,-4
6,1,64,11,16,-5
6,1,65,8,11,-3
6,1,66,3,8,-5
6,1,67,8,13,-5
6,1,68,9,22,-13
6,1,69,5,4,1
6,1,70,4,7,-3
6,1,71,15,16,-1
6,1,72,11,15,-4
6,1,73,10,10,0
6,1,74,13,27,-14
6,1,75,14,17,-3
6,1,76,2,9,-7
6,1,77,3,10,-7
6,1,78,6,11,-5
6,1,79,4,7,-3
6,1,80,12,13,-1
6,1,81,9,12,-3
6,1,82,6,8,-2
6,1,83,14,9,5
6,1,84,9,7,2
6,1,85,7,9,-2
6,1,86,12,14,-2
6,1,87,1,9,-8
6,1,88,8,12,-4
6,1,89,11,15,-4
6,1,90,4,7,-3
6,1,91,5,17,-12
6,1,92,7,24,-17
6,1,93,10,4,6
6,1,94,11,13,-2
6,1,95,14,7,7
6,1,96,29,16,13
6,1,97,6,7,-1
6,1,98,10,7,3
6,1,99,14,17,-3
6,1,100,7,5,2
6,1,101,3,2,1
6,1,102,12,13,-1
6,1,103,10,7,3
6,1,104,10,9,1
6,1,105,13,10,3
6,1,106,14,11,3
6,1,107,7,9,-2
6,1,108,4,15,-11
6,1,109,10,6,4
6,1,110,4,11,-7
6,1,111,9,17,-8
6,1,112,7,12,-5
6,1,113,11,10,1
6,1,114,11,6,5
6,1,115,11,18,-7
6,1,116,7,8,-1
6,1,117,5,13,-8
6,1,118,7,12,-5
6,1,119,4,27,-23
6,1,120,17,15,2
6,1,121,13,17,-4
6,1,122,6,15,-9
6,1,123,11,12,-1
6,1,124,5,11,-6
6,1,125,7,19,-12
6,1,126,9,6,3
6,1,127,14,20,-6
6,1,128,14,19,-5
6,1,129,12,9,3
6,1,130,11,11,0
6,1,131,8,5,3
6,1,132,11,10,1
6,1,133,10,14,-4
6,1,134,3,3,0
6,1,135,10,11,-1
6,1,136,7,20,-13
6,1,137,18,7,11
6,1,138,5,18,-13
6,1,139,7,13,-6
6,1,140,10,17,-7
6,1,141,15,33,-18
6,1,142,9,14,-5
6,1,143,19,13,6
6,1,144,15,24,-9
6,1,145,9,19,-10
6,1,146,9,5,4
6,1,147,14,4,10
6,1,148,12,14,-2
6,1,149,13,19,-6
6,1,150,16,17,-1
6,1,151,19,12,7
6,1,152,13,13,0
6,1,153,14,4,10
6,1,154,7,17,-10
6,1,155,12,24,-12
6,1,156,5,11,-6
6,1,157,10,19,-9
6,1,158,10,14,-4
6,1,159,11,16,-5
6,1,160,9,23,-14
6,1,161,6,16,-10
6,1,162,0,1,-1
6,1,163,9,19,-10
6,1,164,7,7,0
6,1,165,17,16,1
6,1,166,5,5,0
6,1,167,14,12,2
6,1,168,15,5,10
6,1,169,5,11,-6
6,1,170,2,8,-6
6,1,171,6,14,-8
6,1,172,9,27,-18
6,1,173,5,6,-1
6,1,174,6,5,1
6,1,175,6,5,1
6,1,176,9,10,-1
6,1,177,14,11,3
6,1,178,9,12,-3
6,1,179,5,5,0
6,1,180,18,17,1
6,1,181,15,22,-7
6,1,182,2,5,-3
6,1,183,0,0,0
6,1,184,4,8,-4
6,1,185,3,6,-3
6,1,186,7,10,-3
6,1,187,11,9,2
6,1,188,4,16,-12
6,1,189,13,8,5
6,1,190,7,6,1
6,1,191,5,4,1
6,1,192,14,22,-8
6,1,193,6,9,-3
6,1,194,11,13,-2
6,1,195,2,14,-12
6,1,196,14,13,1
6,1,197,4,8,-4
6,1,198,10,9,1
6,1,199,11,11,0
6,1,200,10,12,-2
6,1,201,18,9,9
6,1,202,14,34,-20
6,1,203,5,9,-4
6,1,204,11,13,-2
6,1,205,1,11,-10
6,1,206,11,17,-6
6,1,207,12,19,-7
6,1,208,14,17,-3
6,1,209,11,10,1
6,1,210,8,10,-2
6,1,211,4,8,-4
6,1,212,6,9,-3
6,1,213,17,10,7
6,1,214,4,9,-5
6,1,215,5,11,-6
6,1,216,8,18,-10
6,1,217,8,8,0
6,1,218,16,9,7
6,1,219,9,14,-5
6,1,220,11,11,0
6,1,221,7,23,-16
6,1,222,5,9,-4
6,1,223,11,21,-10
6,1,224,7,11,-4
6,1,225,12,8,4
6,1,226,11,11,0
6,1,227,5,8,-3
6,1,228,15,27,-12
6,1,229,5,7,-2
6,1,230,12,14,-2
6,1,231,7,16,-9
6,1,232,16,21,-5
6,1,233,4,7,-3
6,1,234,5,4,1
6,1,235,3,5,-2
6,1,236,5,4,1
6,1,237,5,13,-8
6,1,238,8,14,-6
6,1,239,9,3,6
6,1,240,6,11,-5
6,1,241,7,7,0
6,1,242,4,5,-1
6,1,243,8,15,-7
6,1,244,7,6,1
6,1,245,12,12,0
6,1,246,17,17,0
6,1,247,10,5,5
6,1,248,14,20,-6
6,1,249,2,4,-2
6,1,250,4,2,2
6,1,251,13,7,6
6,1,252,12,20,-8
6,1,253,4,11,-7
6,1,254,9,12,-3
6,1,255,2,2,0
6,1,256,11,10,1
6,1,257,4,0,4
6,1,258,5,7,-2
6,1,259,5,12,-7
6,1,260,6,4,2
6,1,261,5,6,-1
6,1,262,9,3,6
6,1,263,13,9,4
6,1,264,8,12,-4
6,1,265,1,7,-6
6,1,266,14,14,0
6,1,267,8,20,-12
6,1,268,4,10,-6
6,1,269,7,15,-8
6,1,270,11,15,-4
6,1,271,6,6,0
6,1,272,6,20,-14
6,1,273,9,12,-3
6,1,274,12,20,-8
6,1,275,2,7,-5
6,1,276,9,19,-10
6,1,277,10,12,-2
6,1,278,10,12,-2
6,1,279,16,16,0
6,1,280,1,10,-9
6,1,281,4,9,-5
6,1,282,10,8,2
6,1,283,11,12,-1
6,1,284,24,16,8
6,1,285,0,0,0
6,1,286,8,8,0
6,1,287,11,10,1
6,1,288,2,5,-3
6,1,289,8,19,-11
6,1,290,6,13,-7
6,1,291,13,8,5
6,1,292,13,10,3
6,1,293,11,8,3
6,1,294,9,9,0
6,1,295,7,9,-2
6,1,296,7,14,-7
6,1,297,9,13,-4
6,1,298,6,10,-4
6,1,299,11,13,-2
6,2,0,13,17,-4
6,2,1,10,7,3
6,2,2,9,11,-2
6,2,3,20,2,18
6,2,4,8,13,-5
6,2,5,13,4,9
6,2,6,7,10,-3
6,2,7,4,12,-8
6,2,8,5,11,-6
6,2,9,6,7,-1
6,2,10,11,15,-4
6,2,11,5,18,-13
6,2,12,13,10,3
6,2,13,16,9,7
6,2,14,7,20,-13
6,2,15,13,19,-6
6,2,16,6,10,-4
6,2,17,11,14,-3
6,2,18,10,13,-3
6,2,19,26,14,12
6,2,20,13,21,-8
6,2,21,8,16,-8
6,2,22,14,11,3
6,2,23,13,20,-7
6,2,24,5,18,-13
6,2,25,4,10,-6
6,2,26,22,14,8
6,2,27,15,15,0
6,2,28,6,10,-4
6,2,29,8,5,3
6,2,30,9,10,-1
6,2,31,9,11,-2
6,2,32,13,12,1
6,2,33,15,21,-6
6,2,34,9,21,-12
6,2,35,21,13,8
6,2,36,6,4,2
6,2,37,8,10,-2
6,2,38,7,9,-2
6,2,39,16,10,6
6,2,40,5,4,1
6,2,41,5,10,-5
6,2,42,18,12,6
6,2,43,5,7,-2
6,2,44,9,7,2
6,2,45,6,11,-5
6,2,46,11,15,-4
6,2,47,10,18,-8
6,2,48,4,10,-6
6,2,49,9,9,0
6,2,50,6,9,-3
6,2,51,11,9,2
6,2,52,6,9,-3
6,2,53,8,20,-12
6,2,54,5,13,-8
6,2,55,18,12,6
6,2,56,6,3,3
6,2,57,16,14,2
6,2,58,6,12,-6
6,2,59,10,11,-1
6,2,60,7,12,-5
6,2,61,12,8,4
6,2,62,10,9,1
6,2,63,8,12,-4
6,2,64,9,15,-6
6,2,65,27,23,4
6,2,66,3,11,-8
6,2,67,9,9,0
6,2,68,7,13,-6
6,2,69,8,4,4
6,2,70,2,7,-5
6,2,71,9,14,-5
6,2,72,7,14,-7
6,2,73,13,8,5
6,2,74,15,9,6
6,2,75,12,14,-2
6,2,76,6,12,-6
6,2,77,10,15,-5
6,2,78,2,14,-12
6,2,79,2,3,-1
6,2,80,4,12,-8
6,2,81,10,11,-1
6,2,82,6,18,-12
6,2,83,16,3,13
6,2,84,14,12,2
6,2,85,14,7,7
6,2,86,16,8,8
6,2,87,15,15,0
6,2,88,6,15,-9
6,2,89,10,15,-5
6,2,90,21,11,10
6,2,91,19,16,3
6,2,92,20,20,0
6,2,93,10,15,-5
6,2,94,7,12,-5
6,2,95,4,2,2
6,2,96,11,21,-10
6,2,97,2,16,-14
6,2,98,13,6,7
6,2,99,10,15,-5
6,2,100,26,7,19
6,2,101,15,9,6
6,2,102,4,6,-2
6,2,103,10,7,3
6,2,104,14,13,1
6,2,105,9,14,-5
6,2,106,5,7,-2
6,2,107,7,7,0
6,2,108,10,1,9
6,2,109,13,15,-2
6,2,110,11,12,-1
6,2,111,9,13,-4
6,2,112,5,4,1
6,2,113,9,19,-10
6,2,114,5,10,-5
6,2,115,8,16,-8
6,2,116,13,22,-9
6,2,117,14,14,0
6,2,118,6,7,-1
6,2,119,5,18,-13
6,2,120,14,11,3
6,2,121,6,14,-8
6,2,122,15,9,6
6,2,123,11,21,-10
6,2,124,7,20,-13
6,2,125,16,9,7
6,2,126,16,16,0
6,2,127,5,3,2
6,2,128,14,15,-1
6,2,129,11,23,-12
6,2,130,7,14,-7
6,2,131,11,12,-1
6,2,132,6,2,4
6,2,133,13,9,4
6,2,134,12,8,4
6,2,135,4,3,1
6,2,136,13,9,4
6,2,137,18,6,12
6,2,138,8,14,-6
6,2,139,10,10,0
6,2,140,7,11,-4
6,2,141,28,14,14
6,2,142,9,3,6
6,2,143,5,12,-7
6,2,144,12,8,4
6,2,145,16,10,6
6,2,146,6,3,3
6,2,147,14,8,6
6,2,148,11,23,-12
6,2,149,5,11,-6
6,2,150,13,18,-5
6,2,151,7,13,-6
6,2,152,10,21,-11
6,2,153,7,18,-11
6,2,154,11,8,3
6,2,155,4,16,-12
6,2,156,4,10,-6
6,2,157,7,7,0
6,2,158,9,11,-2
6,2,159,21,19,2
6,2,160,10,5,5
6,2,161,6,5,1
6,2,162,11,7,4
6,2,163,4,8,-4
6,2,164,7,7,0
6,2,165,8,18,-10
6,2,166,10,16,-6
6,2,167,12,22,-10
6,2,168,14,16,-2
6,2,169,3,9,-6
6,2,170,2,5,-3
6,2,171,2,5,-3
6,2,172,19,21,-2
6,2,173,5,4,1
6,2,174,11,10,1
6,2,175,5,7,-2
6,2,176,10,6,4
6,2,177,5,11,-6
6,2,178,16,13,3
6,2,179,12,19,-7
6,2,180,8,14,-6
6,2,181,5,7,-2
6,2,182,3,9,-6
6,2,183,14,5,9
6,2,184,17,10,7
6,2,185,7,8,-1
6,2,186,16,17,-1
6,2,187,17,15,2
6,2,188,16,13,3
6,2,189,5,7,-2
6,2,190,13,10,3
6,2,191,14,17,-3
6,2,192,12,18,-6
6,2,193,16,17,-1
6,2,194,7,9,-2
6,2,195,6,4,2
6,2,196,14,10,4
6,2,197,4,7,-3
6,2,198,6,10,-4
6,2,199,7,11,-4
6,2,200,8,11,-3
6,2,201,17,11,6
6,2,202,8,14,-6
6,2,203,9,14,-5
6,2,204,8,18,-10
6,2,205,5,15,-10
6,2,206,13,17,-4
6,2,207,7,11,-4
6,2,208,14,14,0
6,2,209,9,12,-3
6,2,210,8,9,-1
6,2,211,3,3,0
6,2,212,12,14,-2
6,2,213,3,6,-3
6,2,214,3,15,-12
6,2,215,6,12,-6
6,2,216,5,7,-2
6,2,217,12,16,-4
6,2,218,16,16,0
6,2,219,13,15,-2
6,2,220,15,19,-4
6,2,221,10,15,-5
6,2,222,8,9,-1
6,2,223,2,9,-7
6,2,224,12,10,2
6,2,225,5,12,-7
6,2,226,3,11,-8
6,2,227,12,17,-5
6,2,228,5,6,-1
6,2,229,10,5,5
6,2,230,14,26,-12
6,2,231,8,16,-8
6,2,232,11,10,1
6,2,233,13,15,-2
6,2,234,11,10,1
6,2,235,14,11,3
6,2,236,12,13,-1
6,2,237,7,8,-1
6,2,238,7,9,-2
6,2,239,7,4,3
6,2,240,22,15,7
6,2,241,7,10,-3
6,2,242,7,11,-4
6,2,243,5,8,-3
6,2,244,13,16,-3
6,2,245,9,2,7
6,2,246,20,18,2
6,2,247,11,13,-2
6,2,248,13,14,-1
6,2,249,5,14,-9
6,2,250,9,5,4
6,2,251,10,21,-11
6,2,252,9,18,-9
6,2,253,8,4,4
6,2,254,12,10,2
6,2,255,10,9,1
6,2,256,5,20,-15
6,2,257,9,10,-1
6,2,258,16,14,2
6,2,259,13,15,-2
6,2,260,13,8,5
6,2,261,13,11,2
6,2,262,20,5,15
6,2,263,19,7,12
6,2,264,7,18,-11
6,2,265,19,13,6
6,2,266,12,13,-1
6,2,267,19,8,11
6,2,268,3,3,0
6,2,269,8,11,-3
6,2,270,16,15,1
6,2,271,20,16,4
6,2,272,12,17,-5
6,2,273,16,7,9
6,2,274,4,3,1
6,2,275,6,19,-13
6,2,276,23,7,16
6,2,277,4,5,-1
6,2,278,23,20,3
6,2,279,5,8,-3
6,2,280,13,15,-2
6,2,281,13,11,2
6,2,282,21,18,3
6,2,283,3,44,-41
6,2,284,13,11,2
6,2,285,9,9,0
6,2,286,2,12,-10
6,2,287,11,12,-1
6,2,288,7,15,-8
6,2,289,16,19,-3
6,2,290,9,18,-9
6,2,291,6,20,-14
6,2,292,2,4,-2
6,2,293,20,23,-3
6,2,294,11,14,-3
6,2,295,12,15,-3
6,2,296,14,14,0
6,2,297,17,12,5
6,2,298,8,19,-11
6,2,299,10,3,7
6,3,0,16,17,-1
6,3,1,14,21,-7
6,3,2,10,24,-14
6,3,3,19,12,7
6,3,4,8,8,0
6,3,5,8,13,-5
6,3,6,15,13,2
6,3,7,14,13,1
6,3,8,10,10,0
6,3,9,9,16,-7
6,3,10,17,24,-7
6,3,11,7,27,-20
6,3,12,11,15,-4
6,3,13,11,12,-1
6,3,14,8,20,-12
6,3,15,7,11,-4
6,3,16,8,15,-7
6,3,17,0,2,-2
6,3,18,17,18,-1
6,3,19,13,17,-4
6,3,20,7,6,1
6,3,21,11,9,2
6,3,22,15,6,9
6,3,23,14,8,6
6,3,24,8,12,-4
6,3,25,6,11,-5
6,3,26,8,15,-7
6,3,27,12,17,-5
6,3,28,9,15,-6
6,3,29,11,6,5
6,3,30,12,8,4
6,3,31,17,15,2
6,3,32,8,10,-2
6,3,33,30,23,7
6,3,34,10,19,-9
6,3,35,2,5,-3
6,3,36,3,8,-5
6,3,37,13,14,-1
6,3,38,23,10,13
6,3,39,13,23,-10
6,3,40,8,9,-1
6,3,41,18,14,4
6,3,42,13,22,-9
6,3,43,7,18,-11
6,3,44,8,29,-21
6,3,45,10,4,6
6,3,46,17,16,1
6,3,47,6,11,-5
6,3,48,14,16,-2
6,3,49,13,11,2
6,3,50,4,5,-1
6,3,51,9,10,-1
6,3,52,15,11,4
6,3,53,8,21,-13
6,3,54,5,14,-9
6,3,55,6,21,-15
6,3,56,9,18,-9
6,3,57,1,7,-6
6,3,58,12,26,-14
6,3,59,4,16,-12
6,3,60,11,15,-4
6,3,61,19,35,-16
6,3,62,11,20,-9
6,3,63,9,13,-4
6,3,64,10,13,-3
6,3,65,17,22,-5
6,3,66,18,12,6
6,3,67,6,14,-8
6,3,68,4,16,-12
6,3,69,5,14,-9
6,3,70,5,18,-13
6,3,71,5,7,-2
6,3,72,14,13,1
6,3,73,12,14,-2
6,3,74,9,4,5
6,3,75,4,8,-4
6,3,76,17,14,3
6,3,77,14,14,0
6,3,78,15,11,4
6,3,79,15,6,9
6,3,80,13,17,-4
6,3,81,11,18,-7
6,3,82,12,19,-7
6,3,83,17,12,5
6,3,84,12,10,2
6,3,85,9,12,-3
6,3,86,13,13,0
6,3,87,15,20,-5
6,3,88,8,11,-3
6,3,89,10,14,-4
6,3,90,18,8,10
6,3,91,9,5,4
6,3,92,6,10,-4
6,3,93,9,15,-6
6,3,94,7,10,-3
6,3,95,16,17,-1
6,3,96,15,18,-3
6,3,97,12,16,-4
6,3,98,19,12,7
6,3,99,11,7,4
6,3,100,10,27,-17
6,3,101,15,14,1
6,3,102,12,24,-12
6,3,103,23,23,0
6,3,104,5,6,-1
6,3,105,10,10,0
6,3,106,10,14,-4
6,3,107,7,11,-4
6,3,108,13,2,11
6,3,109,14,16,-2
6,3,110,3,10,-7
6,3,111,19,18,1
6,3,112,5,19,-14
6,3,113,5,7,-2
6,3,114,8,18,-10
6,3,115,20,20,0
6,3,116,10,8,2
6,3,117,13,23,-10
6,3,118,8,20,-12
6,3,119,17,15,2
6,3,120,17,9,8
6,3,121,7,6,1
6,3,122,9,20,-11
6,3,123,4,8,-4
6,3,124,8,15,-7
6,3,125,6,9,-3
6,3,126,6,15,-9
6,3,127,4,6,-2
6,3,128,4,14,-10
6,3,129,10,18,-8
6,3,130,16,19,-3
6,3,131,14,10,4
6,3,132,20,18,2
6,3,133,9,7,2
6,3,134,7,5,2
6,3,135,10,8,2
6,3,136,20,16,4
6,3,137,8,8,0
6,3,138,7,9,-2
6,3,139,5,17,-12
6,3,140,8,10,-2
6,3,141,7,18,-11
6,3,142,9,7,2
6,3,143,10,9,1
6,3,144,9,11,-2
6,3,145,4,14,-10
6,3,146,4,28,-24
6,3,147,12,17,-5
6,3,148,18,16,2
6,3,149,1,6,-5
6,3,150,2,10,-8
6,3,151,7,10,-3
6,3,152,9,9,0
6,3,153,9,8,1
6,3,154,17,12,5
6,3,155,11,14,-3
6,3,156,15,17,-2
6,3,157,12,20,-8
6,3,158,12,16,-4
6,3,159,14,10,4
6,3,160,6,19,-13
6,3,161,22,20,2
6,3,162,4,3,1
6,3,163,5,12,-7
6,3,164,14,12,2
6,3,165,7,15,-8
6,3,166,21,9,12
6,3,167,21,5,16
6,3,168,6,10,-4
6,3,169,12,6,6
6,3,170,13,15,-2
6,3,171,12,12,0
6,3,172,9,9,0
6,3,173,13,18,-5
6,3,174,14,12,2
6,3,175,6,7,-1
6,3,176,9,14,-5
6,3,177,15,15,0
6,3,178,8,11,-3
6,3,179,24,13,11
6,3,180,15,10,5
6,3,181,14,22,-8
6,3,182,9,17,-8
6,3,183,0,2,-2
6,3,184,6,15,-9
6,3,185,26,17,9
6,3,186,8,19,-11
6,3,187,17,7,10
6,3,188,9,8,1
6,3,189,18,5,13
6,3,190,4,20,-16
6,3,191,10,19,-9
6,3,192,5,15,-10
6,3,193,8,19,-11
6,3,194,9,15,-6
6,3,195,5,19,-14
6,3,196,11,17,-6
6,3,197,11,10,1
6,3,198,4,1,3
6,3,199,5,9,-4
6,3,200,12,24,-12
6,3,201,16,16,0
6,3,202,5,9,-4
6,3,203,2,16,-14
6,3,204,17,12,5
6,3,205,8,21,-13
6,3,206,12,14,-2
6,3,207,24,20,4
6,3,208,8,19,-11
6,3,209,7,12,-5
6,3,210,8,14,-6
6,3,211,17,13,4
6,3,212,2,6,-4
6,3,213,8,17,-9
6,3,214,11,14,-3
6,3,215,18,17,1
6,3,216,11,18,-7
6,3,217,2,2,0
6,3,218,4,7,-3
6,3,219,17,14,3
6,3,220,9,11,-2
6,3,221,16,15,1
6,3,222,17,13,4
6,3,223,3,12,-9
6,3,224,4,10,-6
6,3,225,6,2,4
6,3,226,10,11,-1
6,3,227,20,18,2
6,3,228,11,12,-1
6,3,229,15,13,2
6,3,230,10,18,-8
6,3,231,26,28,-2
6,3,232,12,25,-13
6,3,233,17,13,4
6,3,234,5,13,-8
6,3,235,15,14,1
6,3,236,13,8,5
6,3,237,10,14,-4
6,3,238,2,9,-7
6,3,239,17,10,7
6,3,240,16,3,13
6,3,241,6,9,-3
6,3,242,3,1,2
6,3,243,18,18,0
6,3,244,3,8,-5
6,3,245,11,10,1
6,3,246,10,7,3
6,3,247,19,17,2
6,3,248,6,12,-6
6,3,249,13,15,-2
6,3,250,12,11,1
6,3,251,8,8,0
6,3,252,9,19,-10
6,3,253,13,15,-2
6,3,254,16,12,4
6,3,255,7,13,-6
6,3,256,7,6,1
6,3,257,10,22,-12
6,3,258,9,10,-1
6,3,259,7,7,0
6,3,260,13,5,8
6,3,261,19,17,2
6,3,262,4,6,-2
6,3,263,9,17,-8
6,3,264,10,12,-2
6,3,265,17,17,0
6,3,266,17,18,-1
6,3,267,16,17,-1
6,3,268,8,9,-1
6,3,269,6,17,-11
6,3,270,9,12,-3
6,3,271,7,8,-1
6,3,272,14,14,0
6,3,273,6,4,2
6,3,274,8,15,-7
6,3,275,4,10,-6
6,3,276,12,17,-5
6,3,277,8,6,2
6,3,278,10,17,-7
6,3,279,11,10,1
6,3,280,16,20,-4
6,3,281,15,25,-10
6,3,282,10,18,-8
6,3,283,17,4,13
6,3,284,28,10,18
6,3,285,14,12,2
6,3,286,8,20,-12
6,3,287,10,17,-7
6,3,288,6,15,-9
6,3,289,13,32,-19
6,3,290,14,20,-6
6,3,291,10,14,-4
6,3,292,7,8,-1
6,3,293,12,16,-4
6,3,294,13,12,1
6,3,295,3,11,-8
6,3,296,16,5,11
6,3,297,11,11,0
6,3,298,8,14,-6
6,3,299,15,23,-8
6,4,0,9,15,-6
6,4,1,11,12,-1
6,4,2,13,9,4
6,4,3,10,16,-6
6,4,4,13,8,5
6,4,5,13,10,3
6,4,6,11,28,-17
6,4,7,6,2,4
6,4,8,19,18,1
6,4,9,28,11,17
6,4,10,16,7,9
6,4,11,11,11,0
6,4,12,4,11,-7
6,4,13,5,20,-15
6,4,14,11,3,8
6,4,15,10,28,-18
6,4,16,6,8,-2
6,4,17,2,4,-2
6,4,18,11,15,-4
6,4,19,16,19,-3
6,4,20,18,20,-2
6,4,21,10,7,3
6,4,22,9,18,-9
6,4,23,13,25,-12
6,4,24,7,12,-5
6,4,25,16,12,4
6,4,26,17,11,6
6,4,27,10,22,-12
6,4,28,19,16,3
6,4,29,14,4,10
6,4,30,2,11,-9
6,4,31,5,8,-3
6,4,32,13,8,5
6,4,33,16,14,2
6,4,34,14,15,-1
6,4,35,8,17,-9
6,4,36,14,12,2
6,4,37,25,20,5
6,4,38,15,14,1
6,4,39,11,23,-12
6,4,40,15,20,-5
6,4,41,9,7,2
6,4,42,17,9,8
6,4,43,22,10,12
6,4,44,5,11,-6
6,4,45,10,18,-8
6,4,46,8,16,-8
6,4,47,7,15,-8
6,4,48,22,37,-15
6,4,49,14,15,-1
6,4,50,10,17,-7
6,4,51,9,12,-3
6,4,52,5,5,0
6,4,53,12,11,1
6,4,54,9,7,2
6,4,55,26,16,10
6,4,56,15,37,-22
6,4,57,14,11,3
6,4,58,5,9,-4
6,4,59,7,13,-6
6,4,60,15,9,6
6,4,61,10,3,7
6,4,62,11,15,-4
6,4,63,16,11,5
6,4,64,10,15,-5
6,4,65,27,18,9
6,4,66,5,20,-15
6,4,67,17,12,5
6,4,68,19,14,5
6,4,69,13,11,2
6,4,70,7,9,-2
6,4,71,11,12,-1
6,4,72,11,17,-6
6,4,73,8,10,-2
6,4,74,13,16,-3
6,4,75,15,25,-10
6,4,76,9,11,-2
6,4,77,4,5,-1
6,4,78,14,17,-3
6,4,79,17,15,2
6,4,80,12,19,-7
6,4,81,13,26,-13
6,4,82,14,12,2
6,4,83,5,11,-6
6,4,84,9,5,4
6,4,85,11,10,1
6,4,86,20,23,-3
6,4,87,7,8,-1
6,4,88,5,9,-4
6,4,89,7,13,-6
6,4,90,16,17,-1
6,4,91,13,16,-3
6,4,92,10,14,-4
6,4,93,17,13,4
6,4,94,8,23,-15
6,4,95,21,19,2
6,4,96,10,6,4
6,4,97,22,20,2
6,4,98,14,26,-12
6,4,99,15,18,-3
6,4,100,13,15,-2
6,4,101,10,13,-3
6,4,102,13,17,-4
6,4,103,3,10,-7
6,4,104,10,18,-8
6,4,105,7,8,-1
6,4,106,11,15,-4
6,4,107,11,11,0
6,4,108,11,11,0
6,4,109,5,6,-1
6,4,110,19,11,8
6,4,111,3,5,-2
6,4,112,11,14,-3
6,4,113,4,5,-1
6,4,114,7,13,-6
6,4,115,7,10,-3
6,4,116,8,3,5
6,4,117,10,12,-2
6,4,118,12,22,-10
6,4,119,8,11,-3
6,4,120,8,8,0
6,4,121,19,16,3
6,4,122,24,19,5
6,4,123,9,14,-5
6,4,124,5,7,-2
6,4,125,6,10,-4
6,4,126,9,14,-5
6,4,127,8,8,0
6,4,128,8,5,3
6,4,129,8,19,-11
6,4,130,13,12,1
6,4,131,11,9,2
6,4,132,10,9,1
6,4,133,14,24,-10
6,4,134,13,11,2
6,4,135,7,16,-9
6,4,136,15,22,-7
6,4,137,12,10,2
6,4,138,18,11,7
6,4,139,9,22,-13
6,4,140,14,21,-7
6,4,141,16,14,2
6,4,142,8,19,-11
6,4,143,11,10,1
6,4,144,23,8,15
6,4,145,9,12,-3
6,4,146,8,9,-1
6,4,147,15,10,5
6,4,148,12,6,6
6,4,149,7,9,-2
6,4,150,17,21,-4
6,4,151,15,23,-8
6,4,152,9,7,2
6,4,153,12,13,-1
6,4,154,11,22,-11
6,4,155,20,25,-5
6,4,156,8,19,-11
6,4,157,19,13,6
6,4,158,2,9,-7
6,4,159,15,17,-2
6,4,160,10,9,1
6,4,161,15,14,1
6,4,162,12,12,0
6,4,163,10,14,-4
6,4,164,12,9,3
6,4,165,23,12,11
6,4,166,24,13,11
6,4,167,17,14,3
6,4,168,12,21,-9
6,4,169,14,25,-11
6,4,170,12,16,-4
6,4,171,11,11,0
6,4,172,5,8,-3
6,4,173,10,8,2
6,4,174,7,14,-7
6,4,175,9,14,-5
6,4,176,11,12,-1
6,4,177,14,21,-7
6,4,178,10,10,0
6,4,179,9,16,-7
6,4,180,19,26,-7
6,4,181,16,16,0
6,4,182,16,22,-6
6,4,183,12,14,-2
6,4,184,5,13,-8
6,4,185,18,16,2
6,4,186,11,10,1
6,4,187,6,4,2
6,4,188,11,22,-11
6,4,189,7,12,-5
6,4,190,13,8,5
6,4,191,21,16,5
6,4,192,18,26,-8
6,4,193,14,21,-7
6,4,194,5,12,-7
6,4,195,11,9,2
6,4,196,5,13,-8
6,4,197,12,13,-1
6,4,198,20,16,4
6,4,199,10,24,-14
6,4,200,11,4,7
6,4,201,13,9,4
6,4,202,6,10,-4
6,4,203,5,6,-1
6,4,204,10,29,-19
6,4,205,3,9,-6
6,4,206,19,11,8
6,4,207,11,19,-8
6,4,208,10,18,-8
6,4,209,17,19,-2
6,4,210,8,13,-5
6,4,211,14,28,-14
6,4,212,13,12,1
6,4,213,8,15,-7
6,4,214,6,23,-17
6,4,215,5,7,-2
6,4,216,14,8,6
6,4,217,4,8,-4
6,4,218,15,26,-11
6,4,219,9,15,-6
6,4,220,18,6,12
6,4,221,14,24,-10
6,4,222,12,4,8
6,4,223,17,14,3
6,4,224,9,13,-4
6,4,225,14,8,6
6,4,226,13,8,5
6,4,227,5,16,-11
6,4,228,10,10,0
6,4,229,4,18,-14
6,4,230,19,18,1
6,4,231,5,9,-4
6,4,232,4,5,-1
6,4,233,11,14,-3
6,4,234,4,10,-6
6,4,235,21,28,-7
6,4,236,10,17,-7
6,4,237,2,16,-14
6,4,238,7,16,-9
6,4,239,11,25,-14
6,4,240,18,14,4
6,4,241,15,16,-1
6,4,242,8,15,-7
6,4,243,10,6,4
6,4,244,18,20,-2
6,4,245,14,17,-3
6,4,246,13,31,-18
6,4,247,8,7,1
6,4,248,2,9,-7
6,4,249,16,12,4
6,4,250,15,14,1
6,4,251,13,17,-4
6,4,252,9,13,-4
6,4,253,19,13,6
6,4,254,15,15,0
6,4,255,17,19,-2
6,4,256,9,2,7
6,4,257,18,11,7
6,4,258,5,13,-8
6,4,259,24,22,2
6,4,260,10,7,3
6,4,261,7,12,-5
6,4,262,7,8,-1
6,4,263,8,12,-4
6,4,264,16,18,-2
6,4,265,25,15,10
6,4,266,5,10,-5
6,4,267,8,13,-5
6,4,268,15,16,-1
6,4,269,7,9,-2
6,4,270,11,9,2
6,4,271,8,16,-8
6,4,272,8,10,-2
6,4,273,6,19,-13
6,4,274,10,14,-4
6,4,275,12,17,-5
6,4,276,14,14,0
6,4,277,16,10,6
6,4,278,10,13,-3
6,4,279,22,14,8
6,4,280,8,3,5
6,4,281,9,18,-9
6,4,282,19,15,4
6,4,283,10,12,-2
6,4,284,2,6,-4
6,4,285,17,6,11
6,4,286,9,19,-10
6,4,287,8,8,0
6,4,288,19,10,9
6,4,289,12,13,-1
6,4,290,7,10,-3
6,4,291,15,19,-4
6,4,292,9,13,-4
6,4,293,6,11,-5
6,4,294,11,16,-5
6,4,295,7,7,0
6,4,296,15,9,6
6,4,297,7,4,3
6,4,298,7,15,-8
6,4,299,10,7,3
6,5,0,11,11,0
6,5,1,9,12,-3
6,5,2,19,10,9
6,5,3,13,16,-3
6,5,4,5,7,-2
6,5,5,11,13,-2
6,5,6,7,5,2
6,5,7,4,13,-9
6,5,8,15,18,-3
6,5,9,9,6,3
6,5,10,16,17,-1
6,5,11,8,22,-14
6,5,12,13,18,-5
6,5,13,7,7,0
6,5,14,19,18,1
6,5,15,8,12,-4
6,5,16,10,11,-1
6,5,17,18,23,-5
6,5,18,12,19,-7
6,5,19,12,22,-10
6,5,20,13,16,-3
6,5,21,16,15,1
6,5,22,5,12,-7
6,5,23,19,10,9
6,5,24,13,18,-5
6,5,25,17,17,0
6,5,26,9,22,-13
6,5,27,12,19,-7
6,5,28,5,8,-3
6,5,29,20,15,5
6,5,30,10,10,0
6,5,31,8,16,-8
6,5,32,5,14,-9
6,5,33,7,22,-15
6,5,34,20,18,2
6,5,35,14,9,5
6,5,36,7,8,-1
6,5,37,14,17,-3
6,5,38,13,19,-6
6,5,39,13,6,7
6,5,40,15,17,-2
6,5,41,6,8,-2
6,5,42,13,16,-3
6,5,43,12,18,-6
6,5,44,17,15,2
6,5,45,6,10,-4
6,5,46,13,16,-3
6,5,47,6,6,0
6,5,48,21,15,6
6,5,49,5,10,-5
6,5,50,14,16,-2
6,5,51,11,13,-2
6,5,52,13,12,1
6,5,53,11,24,-13
6,5,54,9,10,-1
6,5,55,21,14,7
6,5,56,12,28,-16
6,5,57,11,19,-8
6,5,58,16,18,-2
6,5,59,3,16,-13
6,5,60,17,20,-3
6,5,61,1,3,-2
6,5,62,15,16,-1
6,5,63,16,33,-17
6,5,64,16,16,0
6,5,65,8,15,-7
6,5,66,18,10,8
6,5,67,8,16,-8
6,5,68,15,12,3
6,5,69,13,18,-5
6,5,70,16,14,2
6,5,71,2,8,-6
6,5,72,16,19,-3
6,5,73,13,11,2
6,5,74,16,10,6
6,5,75,7,8,-1
6,5,76,3,9,-6
6,5,77,22,13,9
6,5,78,15,34,-19
6,5,79,18,14,4
6,5,80,8,8,0
6,5,81,8,15,-7
6,5,82,12,14,-2
6,5,83,12,19,-7
6,5,84,12,24,-12
6,5,85,14,16,-2
6,5,86,2,4,-2
6,5,87,13,11,2
6,5,88,15,13,2
6,5,89,6,11,-5
6,5,90,20,24,-4
6,5,91,12,13,-1
6,5,92,9,11,-2
6,5,93,15,10,5
6,5,94,7,7,0
6,5,95,9,13,-4
6,5,96,7,12,-5
6,5,97,20,13,7
6,5,98,10,6,4
6,5,99,17,19,-2
6,5,100,9,15,-6
6,5,101,7,5,2
6,5,102,18,19,-1
6,5,103,8,20,-12
6,5,104,19,21,-2
6,5,105,10,21,-11
6,5,106,14,14,0
6,5,107,14,11,3
6,5,108,22,16,6
6,5,109,11,6,5
6,5,110,8,12,-4
6,5,111,10,18,-8
6,5,112,6,12,-6
6,5,113,8,6,2
6,5,114,20,9,11
6,5,115,12,11,1
6,5,116,13,6,7
6,5,117,9,22,-13
6,5,118,15,15,0
6,5,119,19,8,11
6,5,120,7,8,-1
6,5,121,7,11,-4
6,5,122,11,14,-3
6,5,123,8,3,5
6,5,124,6,11,-5
6,5,125,5,13,-8
6,5,126,16,19,-3
6,5,127,8,12,-4
6,5,128,5,3,2
6,5,129,12,24,-12
6,5,130,5,7,-2
6,5,131,6,13,-7
6,5,132,6,17,-11
6,5,133,16,12,4
6,5,134,14,19,-5
6,5,135,14,15,-1
6,5,136,11,11,0
6,5,137,9,12,-3
6,5,138,16,11,5
6,5,139,21,16,5
6,5,140,15,18,-3
6,5,141,8,12,-4
6,5,142,5,11,-6
6,5,143,15,13,2
6,5,144,23,9,14
6,5,145,3,7,-4
6,5,146,7,22,-15
6,5,147,16,15,1
6,5,148,10,1,9
6,5,149,6,4,2
6,5,150,15,16,-1
6,5,151,11,13,-2
6,5,152,3,5,-2
6,5,153,8,24,-16
6,5,154,3,6,-3
6,5,155,26,11,15
6,5,156,15,16,-1
6,5,157,18,13,5
6,5,158,6,16,-10
6,5,159,13,14,-1
6,5,160,10,15,-5
6,5,161,15,13,2
6,5,162,4,5,-1
6,5,163,13,22,-9
6,5,164,18,3,15
6,5,165,18,18,0
6,5,166,11,19,-8
6,5,167,9,12,-3
6,5,168,7,13,-6
6,5,169,10,9,1
6,5,170,9,15,-6
6,5,171,7,6,1
6,5,172,12,14,-2
6,5,173,8,20,-12
6,5,174,17,15,2
6,5,175,9,4,5
6,5,176,4,13,-9
6,5,177,8,17,-9
6,5,178,11,19,-8
6,5,179,14,14,0
6,5,180,5,9,-4
6,5,181,12,10,2
6,5,182,4,9,-5
6,5,183,9,15,-6
6,5,184,4,7,-3
6,5,185,17,15,2
6,5,186,8,12,-4
6,5,187,10,4,6
6,5,188,14,39,-25
6,5,189,8,18,-10
6,5,190,15,11,4
6,5,191,14,7,7
6,5,192,16,18,-2
6,5,193,4,8,-4
6,5,194,7,15,-8
6,5,195,3,14,-11
6,5,196,13,18,-5
6,5,197,8,13,-5
6,5,198,21,9,12
6,5,199,8,8,0
6,5,200,16,4,12
6,5,201,21,4,17
6,5,202,18,10,8
6,5,203,14,13,1
6,5,204,11,13,-2
6,5,205,9,24,-15
6,5,206,20,18,2
6,5,207,17,18,-1
6,5,208,11,16,-5
6,5,209,8,12,-4
6,5,210,10,18,-8
6,5,211,6,8,-2
6,5,212,6,10,-4
6,5,213,20,9,11
6,5,214,10,15,-5
6,5,215,7,11,-4
6,5,216,9,16,-7
6,5,217,14,17,-3
6,5,218,13,11,2
6,5,219,16,22,-6
6,5,220,16,9,7
6,5,221,14,32,-18
6,5,222,6,17,-11
6,5,223,16,25,-9
6,5,224,21,15,6
6,5,225,11,6,5
6,5,226,6,0,6
6,5,227,16,18,-2
6,5,228,14,19,-5
6,5,229,8,12,-4
6,5,230,6,16,-10
6,5,231,19,8,11
6,5,232,1,7,-6
6,5,233,13,15,-2
6,5,234,9,16,-7
6,5,235,4,6,-2
6,5,236,17,16,1
6,5,237,6,6,0
6,5,238,12,15,-3
6,5,239,20,17,3
6,5,240,17,13,4
6,5,241,10,23,-13
6,5,242,15,9,6
6,5,243,2,17,-15
6,5,244,5,9,-4
6,5,245,10,17,-7
6,5,246,16,12,4
6,5,247,9,13,-4
6,5,248,8,18,-10
6,5,249,15,11,4
6,5,250,16,17,-1
6,5,251,5,13,-8
6,5,252,9,15,-6
6,5,253,12,10,2
6,5,254,2,10,-8
6,5,255,17,17,0
6,5,256,29,9,20
6,5,257,8,2,6
6,5,258,40,18,22
6,5,259,7,9,-2
6,5,260,7,7,0
6,5,261,14,22,-8
6,5,262,11,11,0
6,5,263,10,9,1
6,5,264,9,7,2
6,5,265,14,21,-7
6,5,266,12,13,-1
6,5,267,22,9,13
6,5,268,4,20,-16
6,5,269,13,9,4
6,5,270,11,24,-13
6,5,271,2,5,-3
6,5,272,14,15,-1
6,5,273,17,17,0
6,5,274,19,16,3
6,5,275,10,13,-3
6,5,276,6,14,-8
6,5,277,14,10,4
6,5,278,10,10,0
6,5,279,13,6,7
6,5,280,11,14,-3
6,5,281,12,10,2
6,5,282,5,6,-1
6,5,283,16,9,7
6,5,284,6,12,-6
6,5,285,13,16,-3
6,5,286,11,7,4
6,5,287,14,16,-2
6,5,288,22,24,-2
6,5,289,10,10,0
6,5,290,6,7,-1
6,5,291,5,16,-11
6,5,292,11,18,-7
6,5,293,18,22,-4
6,5,294,15,17,-2
6,5,295,14,24,-10
6,5,296,2,4,-2
6,5,297,15,4,11
6,5,298,14,13,1
6,5,299,14,16,-2
6,6,0,13,12,1
6,6,1,12,10,2
6,6,2,2,20,-18
6,6,3,15,20,-5
6,6,4,25,19,6
6,6,5,12,9,3
6,6,6,14,6,8
6,6,7,15,9,6
6,6,8,17,25,-8
6,6,9,21,20,1
6,6,10,15,14,1
6,6,11,13,7,6
6,6,12,27,8,19
6,6,13,23,14,9
6,6,14,26,10,16
6,6,15,17,15,2
6,6,16,15,29,-14
6,6,17,10,13,-3
6,6,18,10,21,-11
6,6,19,7,25,-18
6,6,20,10,9,1
6,6,21,18,11,7
6,6,22,14,7,7
6,6,23,21,16,5
6,6,24,14,11,3
6,6,25,22,12,10
6,6,26,17,16,1
6,6,27,9,11,-2
6,6,28,15,8,7
6,6,29,8,14,-6
6,6,30,6,5,1
6,6,31,13,20,-7
6,6,32,11,13,-2
6,6,33,21,10,11
6,6,34,3,6,-3
6,6,35,22,21,1
6,6,36,25,1,24
6,6,37,21,16,5
6,6,38,6,8,-2
6,6,39,18,21,-3
6,6,40,8,13,-5
6,6,41,15,9,6
6,6,42,16,14,2
6,6,43,11,9,2
6,6,44,17,21,-4
6,6,45,9,7,2
6,6,46,12,6,6
6,6,47,21,15,6
6,6,48,12,16,-4
6,6,49,14,6,8
6,6,50,21,14,7
6,6,51,22,13,9
6,6,52,8,15,-7
6,6,53,23,11,12
6,6,54,11,10,1
6,6,55,10,19,-9
6,6,56,16,17,-1
6,6,57,13,31,-18
6,6,58,22,20,2
6,6,59,13,10,3
6,6,60,4,10,-6
6,6,61,19,25,-6
6,6,62,13,4,9
6,6,63,11,20,-9
6,6,64,26,15,11
6,6,65,7,18,-11
6,6,66,7,13,-6
6,6,67,4,8,-4
6,6,68,19,10,9
6,6,69,18,19,-1
6,6,70,9,15,-6
6,6,71,12,11,1
6,6,72,9,12,-3
6,6,73,33,16,17
6,6,74,5,7,-2
6,6,75,8,23,-15
6,6,76,7,5,2
6,6,77,10,9,1
6,6,78,11,14,-3
6,6,79,4,2,2
6,6,80,12,10,2
6,6,81,12,7,5
6,6,82,17,26,-9
6,6,83,19,19,0
6,6,84,10,11,-1
6,6,85,14,12,2
6,6,86,23,39,-16
6,6,87,9,11,-2
6,6,88,10,17,-7
6,6,89,14,6,8
6,6,90,11,8,3
6,6,91,9,11,-2
6,6,92,6,15,-9
6,6,93,17,9,8
6,6,94,9,15,-6
6,6,95,11,10,1
6,6,96,19,19,0
6,6,97,19,9,10
6,6,98,15,13,2
6,6,99,13,10,3
6,6,100,12,12,0
6,6,101,8,13,-5
6,6,102,14,11,3
6,6,103,15,19,-4
6,6,104,18,16,2
6,6,105,12,13,-1
6,6,106,11,6,5
6,6,107,13,24,-11
6,6,108,8,7,1
6,6,109,10,25,-15
6,6,110,22,17,5
6,6,111,12,13,-1
6,6,112,11,6,5
6,6,113,14,24,-10
6,6,114,9,13,-4
6,6,115,17,15,2
6,6,116,15,28,-13
6,6,117,7,7,0
6,6,118,16,22,-6
6,6,119,15,17,-2
6,6,120,11,13,-2
6,6,121,5,12,-7
6,6,122,11,12,-1
6,6,123,8,15,-7
6,6,124,17,10,7
6,6,125,15,17,-2
6,6,126,13,23,-10
6,6,127,19,6,13
6,6,128,6,16,-10
6,6,129,9,16,-7
6,6,130,23,12,11
6,6,131,22,15,7
6,6,132,2,5,-3
6,6,133,14,17,-3
6,6,134,11,15,-4
6,6,135,17,9,8
6,6,136,9,19,-10
6,6,137,10,17,-7
6,6,138,5,10,-5
6,6,139,13,6,7
6,6,140,25,12,13
6,6,141,11,20,-9
6,6,142,14,12,2
6,6,143,12,20,-8
6,6,144,21,15,6
6,6,145,12,12,0
6,6,146,1,10,-9
6,6,147,12,19,-7
6,6,148,13,11,2
6,6,149,8,26,-18
6,6,150,13,14,-1
6,6,151,14,20,-6
6,6,152,14,23,-9
6,6,153,8,16,-8
6,6,154,13,17,-4
6,6,155,15,3,12
6,6,156,12,18,-6
6,6,157,12,24,-12
6,6,158,11,14,-3
6,6,159,8,15,-7
6,6,160,12,17,-5
6,6,161,16,9,7
6,6,162,24,10,14
6,6,163,25,16,9
6,6,164,8,4,4
6,6,165,17,12,5
6,6,166,17,22,-5
6,6,167,18,17,1
6,6,168,15,16,-1
6,6,169,13,12,1
6,6,170,17,11,6
6,6,171,17,13,4
6,6,172,24,20,4
6,6,173,15,9,6
6,6,174,8,8,0
6,6,175,11,15,-4
6,6,176,21,24,-3
6,6,177,13,15,-2
6,6,178,11,16,-5
6,6,179,11,9,2
6,6,180,15,15,0
6,6,181,13,31,-18
6,6,182,18,22,-4
6,6,183,18,14,4
6,6,184,10,30,-20
6,6,185,30,19,11
6,6,186,16,34,-18
6,6,187,8,6,2
6,6,188,3,12,-9
6,6,189,27,12,15
6,6,190,12,10,2
6,6,191,9,17,-8
6,6,192,15,8,7
6,6,193,15,22,-7
6,6,194,4,6,-2
6,6,195,19,11,8
6,6,196,14,17,-3
6,6,197,19,13,6
6,6,198,10,16,-6
6,6,199,22,28,-6
6,6,200,8,13,-5
6,6,201,24,14,10
6,6,202,15,11,4
6,6,203,19,21,-2
6,6,204,17,15,2
6,6,205,9,9,0
6,6,206,14,21,-7
6,6,207,13,6,7
6,6,208,19,10,9
6,6,209,13,7,6
6,6,210,19,9,10
6,6,211,5,10,-5
6,6,212,11,8,3
6,6,213,10,6,4
6,6,214,10,19,-9
6,6,215,13,11,2
6,6,216,15,19,-4
6,6,217,20,18,2
6,6,218,16,9,7
6,6,219,19,12,7
6,6,220,17,11,6
6,6,221,7,9,-2
6,6,222,10,28,-18
6,6,223,5,11,-6
6,6,224,8,10,-2
6,6,225,5,17,-12
6,6,226,14,35,-21
6,6,227,13,8,5
6,6,228,17,13,4
6,6,229,9,9,0
6,6,230,12,9,3
6,6,231,13,12,1
6,6,232,8,26,-18
6,6,233,14,17,-3
6,6,234,13,14,-1
6,6,235,15,7,8
6,6,236,9,11,-2
6,6,237,6,8,-2
6,6,238,20,19,1
6,6,239,7,12,-5
6,6,240,13,14,-1
6,6,241,14,12,2
6,6,242,8,17,-9
6,6,243,13,6,7
6,6,244,13,13,0
6,6,245,9,8,1
6,6,246,14,13,1
6,6,247,11,9,2
6,6,248,13,25,-12
6,6,249,28,18,10
6,6,250,20,20,0
6,6,251,11,21,-10
6,6,252,14,12,2
6,6,253,6,21,-15
6,6,254,10,17,-7
6,6,255,9,13,-4
6,6,256,6,10,-4
6,6,257,10,13,-3
6,6,258,27,12,15
6,6,259,22,16,6
6,6,260,9,11,-2
6,6,261,16,9,7
6,6,262,19,15,4
6,6,263,17,10,7
6,6,264,7,20,-13
6,6,265,17,11,6
6,6,266,11,11,0
6,6,267,9,19,-10
6,6,268,13,31,-18
6,6,269,18,20,-2
6,6,270,6,6,0
6,6,271,15,21,-6
6,6,272,11,14,-3
6,6,273,17,19,-2
6,6,274,15,14,1
6,6,275,21,18,3
6,6,276,19,11,8
6,6,277,8,6,2
6,6,278,12,13,-1
6,6,279,12,25,-13
6,6,280,13,8,5
6,6,281,21,14,7
6,6,282,17,11,6
6,6,283,7,8,-1
6,6,284,11,13,-2
6,6,285,7,11,-4
6,6,286,10,19,-9
6,6,287,16,21,-5
6,6,288,8,15,-7
6,6,289,6,6,0
6,6,290,20,23,-3
6,6,291,13,4,9
6,6,292,2,11,-9
6,6,293,10,13,-3
6,6,294,16,10,6
6,6,295,14,11,3
6,6,296,13,8,5
6,6,297,15,18,-3
6,6,298,20,24,-4
6,6,299,17,22,-5
6,7,0,21,14,7
6,7,1,12,23,-11
6,7,2,31,31,0
6,7,3,26,21,5
6,7,4,18,18,0
6,7,5,11,18,-7
6,7,6,18,16,2
6,7,7,14,13,1
6,7,8,16,15,1
6,7,9,14,9,5
6,7,10,11,16,-5
6,7,11,23,15,8
6,7,12,16,7,9
6,7,13,17,5,12
6,7,14,7,10,-3
6,7,15,13,21,-8
6,7,16,23,10,13
6,7,17,23,8,15
6,7,18,27,18,9
6,7,19,12,12,0
6,7,20,18,12,6
6,7,21,5,6,-1
6,7,22,14,9,5
6,7,23,14,13,1
6,7,24,13,14,-1
6,7,25,8,9,-1
6,7,26,24,10,14
6,7,27,23,38,-15
6,7,28,19,18,1
6,7,29,24,9,15
6,7,30,13,12,1
6,7,31,18,17,1
6,7,32,23,24,-1
6,7,33,6,12,-6
6,7,34,16,9,7
6,7,35,11,15,-4
6,7,36,17,14,3
6,7,37,8,11,-3
6,7,38,14,5,9
6,7,39,12,9,3
6,7,40,11,12,-1
6,7,41,16,25,-9
6,7,42,5,6,-1
6,7,43,18,16,2
6,7,44,6,5,1
6,7,45,10,13,-3
6,7,46,10,17,-7
6,7,47,13,11,2
6,7,48,31,21,10
6,7,49,17,22,-5
6,7,50,12,13,-1
6,7,51,6,15,-9
6,7,52,26,27,-1
6,7,53,15,15,0
6,7,54,9,23,-14
6,7,55,14,12,2
6,7,56,17,22,-5
6,7,57,26,22,4
6,7,58,11,19,-8
6,7,59,17,14,3
6,7,60,24,22,2
6,7,61,15,12,3
6,7,62,18,13,5
6,7,63,18,13,5
6,7,64,9,14,-5
6,7,65,6,10,-4
6,7,66,13,18,-5
6,7,67,7,13,-6
6,7,68,8,13,-5
6,7,69,23,23,0
6,7,70,18,13,5
6,7,71,15,15,0
6,7,72,8,11,-3
6,7,73,7,8,-1
6,7,74,7,12,-5
6,7,75,5,14,-9
6,7,76,11,17,-6
6,7,77,16,13,3
6,7,78,22,15,7
6,7,79,16,2,14
6,7,80,7,14,-7
6,7,81,9,7,2
6,7,82,17,20,-3
6,7,83,17,15,2
6,7,84,15,15,0
6,7,85,16,6,10
6,7,86,7,14,-7
6,7,87,15,16,-1
6,7,88,22,19,3
6,7,89,10,21,-11
6,7,90,16,15,1
6,7,91,14,12,2
6,7,92,11,10,1
6,7,93,13,23,-10
6,7,94,32,14,18
6,7,95,10,10,0
6,7,96,19,10,9
6,7,97,22,11,11
6,7,98,20,19,1
6,7,99,23,13,10
6,7,100,15,20,-5
6,7,101,4,6,-2
6,7,102,26,10,16
6,7,103,18,20,-2
6,7,104,20,12,8
6,7,105,14,24,-10
6,7,106,11,9,2
6,7,107,9,15,-6
6,7,108,16,11,5
6,7,109,9,13,-4
6,7,110,10,8,2
6,7,111,9,16,-7
6,7,112,14,14,0
6,7,113,8,13,-5
6,7,114,22,18,4
6,7,115,7,11,-4
6,7,116,28,33,-5
6,7,117,15,27,-12
6,7,118,14,17,-3
6,7,119,8,18,-10
6,7,120,31,19,12
6,7,121,12,8,4
6,7,122,10,10,0
6,7,123,16,14,2
6,7,124,12,14,-2
6,7,125,33,8,25
6,7,126,10,19,-9
6,7,127,7,16,-9
6,7,128,12,16,-4
6,7,129,4,3,1
6,7,130,11,9,2
6,7,131,22,25,-3
6,7,132,16,12,4
6,7,133,17,11,6
6,7,134,21,28,-7
6,7,135,14,14,0
6,7,136,7,14,-7
6,7,137,15,23,-8
6,7,138,6,14,-8
6,7,139,10,26,-16
6,7,140,14,18,-4
6,7,141,8,7,1
6,7,142,5,11,-6
6,7,143,10,19,-9
6,7,144,18,31,-13
6,7,145,14,17,-3
6,7,146,12,22,-10
6,7,147,10,12,-2
6,7,148,15,14,1
6,7,149,19,11,8
6,7,150,8,11,-3
6,7,151,27,15,12
6,7,152,14,12,2
6,7,153,11,36,-25
6,7,154,5,6,-1
6,7,155,13,26,-13
6,7,156,23,25,-2
6,7,157,11,9,2
6,7,158,19,26,-7
6,7,159,13,10,3
6,7,160,23,14,9
6,7,161,8,14,-6
6,7,162,12,13,-1
6,7,163,9,9,0
6,7,164,7,4,3
6,7,165,12,24,-12
6,7,166,16,21,-5
6,7,167,12,12,0
6,7,168,25,23,2
6,7,169,12,8,4
6,7,170,11,9,2
6,7,171,12,7,5
6,7,172,13,19,-6
6,7,173,11,13,-2
6,7,174,11,18,-7
6,7,175,13,24,-11
6,7,176,17,13,4
6,7,177,15,20,-5
6,7,178,17,16,1
6,7,179,11,23,-12
6,7,180,24,28,-4
6,7,181,6,8,-2
6,7,182,4,7,-3
6,7,183,22,11,11
6,7,184,16,12,4
6,7,185,10,19,-9
6,7,186,17,20,-3
6,7,187,3,29,-26
6,7,188,14,10,4
6,7,189,8,20,-12
6,7,190,15,12,3
6,7,191,20,21,-1
6,7,192,12,11,1
6,7,193,11,9,2
6,7,194,14,11,3
6,7,195,21,20,1
6,7,196,21,17,4
6,7,197,20,27,-7
6,7,198,16,6,10
6,7,199,16,4,12
6,7,200,25,20,5
6,7,201,15,14,1
6,7,202,29,12,17
6,7,203,19,9,10
6,7,204,9,10,-1
6,7,205,4,9,-5
6,7,206,25,21,4
6,7,207,13,13,0
6,7,208,11,21,-10
6,7,209,22,12,10
6,7,210,19,12,7
6,7,211,12,14,-2
6,7,212,12,2,10
6,7,213,29,23,6
6,7,214,16,11,5
6,7,215,10,14,-4
6,7,216,26,7,19
6,7,217,14,12,2
6,7,218,29,19,10
6,7,219,11,25,-14
6,7,220,12,5,7
6,7,221,13,10,3
6,7,222,8,16,-8
6,7,223,21,25,-4
6,7,224,17,12,5
6,7,225,21,10,11
6,7,226,14,13,1
6,7,227,21,15,6
6,7,228,13,14,-1
6,7,229,17,18,-1
6,7,230,15,16,-1
6,7,231,8,5,3
6,7,232,12,39,-27
6,7,233,10,12,-2
6,7,234,11,22,-11
6,7,235,9,14,-5
6,7,236,8,25,-17
6,7,237,9,22,-13
6,7,238,18,20,-2
6,7,239,22,19,3
6,7,240,26,23,3
6,7,241,14,20,-6
6,7,242,9,15,-6
6,7,243,24,18,6
6,7,244,16,18,-2
6,7,245,20,15,5
6,7,246,14,15,-1
6,7,247,15,15,0
6,7,248,7,6,1
6,7,249,8,25,-17
6,7,250,16,12,4
6,7,251,16,11,5
6,7,252,3,6,-3
6,7,253,6,15,-9
6,7,254,21,13,8
6,7,255,16,9,7
6,7,256,10,21,-11
6,7,257,10,24,-14
6,7,258,14,10,4
6,7,259,8,11,-3
6,7,260,9,9,0
6,7,261,15,28,-13
6,7,262,5,10,-5
6,7,263,9,23,-14
6,7,264,11,7,4
6,7,265,19,16,3
6,7,266,23,33,-10
6,7,267,21,19,2
6,7,268,19,8,11
6,7,269,18,14,4
6,7,270,5,9,-4
6,7,271,15,26,-11
6,7,272,21,10,11
6,7,273,22,14,8
6,7,274,9,12,-3
6,7,275,10,11,-1
6,7,276,15,19,-4
6,7,277,16,20,-4
6,7,278,16,18,-2
6,7,279,7,7,0
6,7,280,6,12,-6
6,7,281,18,16,2
6,7,282,7,14,-7
6,7,283,5,7,-2
6,7,284,12,15,-3
6,7,285,18,16,2
6,7,286,9,5,4
6,7,287,12,4,8
6,7,288,11,16,-5
6,7,289,11,10,1
6,7,290,19,19,0
6,7,291,15,14,1
6,7,292,8,14,-6
6,7,293,15,7,8
6,7,294,17,13,4
6,7,295,15,22,-7
6,7,296,23,10,13
6,7,297,7,8,-1
6,7,298,5,4,1
6,7,299,10,11,-1
6,8,0,13,12,1
6,8,1,5,18,-13
6,8,2,17,11,6
6,8,3,24,9,15
6,8,4,28,11,17
6,8,5,15,14,1
6,8,6,10,12,-2
6,8,7,7,6,1
6,8,8,24,20,4
6,8,9,22,23,-1
6,8,10,4,7,-3
6,8,11,10,6,4
6,8,12,16,21,-5
6,8,13,12,15,-3
6,8,14,24,22,2
6,8,15,19,21,-2
6,8,16,11,11,0
6,8,17,13,15,-2
6,8,18,8,12,-4
6,8,19,16,18,-2
6,8,20,11,1,10
6,8,21,14,13,1
6,8,22,11,17,-6
6,8,23,24,18,6
6,8,24,13,12,1
6,8,25,25,22,3
6,8,26,11,12,-1
6,8,27,10,11,-1
6,8,28,20,23,-3
6,8,29,21,11,10
6,8,30,15,23,-8
6,8,31,13,8,5
6,8,32,16,11,5
6,8,33,14,12,2
6,8,34,11,15,-4
6,8,35,13,20,-7
6,8,36,6,10,-4
6,8,37,20,8,12
6,8,38,14,15,-1
6,8,39,16,18,-2
6,8,40,16,16,0
6,8,41,18,20,-2
6,8,42,23,22,1
6,8,43,12,19,-7
6,8,44,12,15,-3
6,8,45,28,11,17
6,8,46,8,15,-7
6,8,47,22,19,3
6,8,48,10,8,2
6,8,49,11,17,-6
6,8,50,6,11,-5
6,8,51,14,20,-6
6,8,52,21,14,7
6,8,53,14,10,4
6,8,54,18,16,2
6,8,55,11,12,-1
6,8,56,11,10,1
6,8,57,19,13,6
6,8,58,5,12,-7
6,8,59,12,26,-14
6,8,60,20,16,4
6,8,61,10,8,2
6,8,62,12,9,3
6,8,63,12,11,1
6,8,64,17,15,2
6,8,65,16,14,2
6,8,66,11,12,-1
6,8,67,15,7,8
6,8,68,17,6,11
6,8,69,12,22,-10
6,8,70,14,17,-3
6,8,71,13,24,-11
6,8,72,13,10,3
6,8,73,11,18,-7
6,8,74,21,12,9
6,8,75,12,21,-9
6,8,76,19,18,1
6,8,77,12,13,-1
6,8,78,17,14,3
6,8,79,10,14,-4
6,8,80,8,3,5
6,8,81,9,11,-2
6,8,82,5,12,-7
6,8,83,9,16,-7
6,8,84,9,17,-8
6,8,85,14,6,8
6,8,86,10,12,-2
6,8,87,23,16,7
6,8,88,8,6,2
6,8,89,5,13,-8
6,8,90,18,18,0
6,8,91,13,20,-7
6,8,92,12,16,-4
6,8,93,15,14,1
6,8,94,19,11,8
6,8,95,9,13,-4
6,8,96,12,16,-4
6,8,97,27,12,15
6,8,98,18,19,-1
6,8,99,30,15,15
6,8,100,20,21,-1
6,8,101,12,22,-10
6,8,102,7,10,-3
6,8,103,14,14,0
6,8,104,7,8,-1
6,8,105,8,7,1
6,8,106,11,17,-6
6,8,107,22,14,8
6,8,108,13,12,1
6,8,109,7,13,-6
6,8,110,8,5,3
6,8,111,17,7,10
6,8,112,11,11,0
6,8,113,26,16,10
6,8,114,6,5,1
6,8,115,9,17,-8
6,8,116,16,11,5
6,8,117,24,8,16
6,8,118,16,8,8
6,8,119,14,14,0
6,8,120,9,6,3
6,8,121,14,12,2
6,8,122,11,17,-6
6,8,123,15,13,2
6,8,124,19,12,7
6,8,125,14,27,-13
6,8,126,16,17,-1
6,8,127,23,13,10
6,8,128,12,12,0
6,8,129,23,6,17
6,8,130,11,28,-17
6,8,131,18,17,1
6,8,132,15,14,1
6,8,133,26,16,10
6,8,134,16,16,0
6,8,135,11,15,-4
6,8,136,17,10,7
6,8,137,10,15,-5
6,8,138,16,22,-6
6,8,139,12,19,-7
6,8,140,16,23,-7
6,8,141,6,5,1
6,8,142,21,8,13
6,8,143,16,16,0
6,8,144,6,6,0
6,8,145,13,8,5
6,8,146,11,9,2
6,8,147,18,19,-1
6,8,148,13,15,-2
6,8,149,8,5,3
6,8,150,18,16,2
6,8,151,11,8,3
6,8,152,12,7,5
6,8,153,9,11,-2
6,8,154,4,4,0
6,8,155,13,6,7
6,8,156,8,17,-9
6,8,157,7,10,-3
6,8,158,35,12,23
6,8,159,10,20,-10
6,8,160,17,10,7
6,8,161,24,4,20
6,8,162,17,12,5
6,8,163,7,8,-1
6,8,164,11,18,-7
6,8,165,11,33,-22
6,8,166,13,13,0
6,8,167,20,10,10
6,8,168,22,10,12
6,8,169,27,12,15
6,8,170,10,17,-7
6,8,171,13,11,2
6,8,172,22,25,-3
6,8,173,15,20,-5
6,8,174,21,22,-1
6,8,175,2,8,-6
6,8,176,10,24,-14
6,8,177,11,7,4
6,8,178,19,19,0
6,8,179,22,20,2
6,8,180,14,14,0
6,8,181,13,15,-2
6,8,182,16,17,-1
6,8,183,10,14,-4
6,8,184,11,8,3
6,8,185,18,7,11
6,8,186,13,10,3
6,8,187,13,11,2
6,8,188,20,19,1
6,8,189,10,12,-2
6,8,190,22,6,16
6,8,191,19,6,13
6,8,192,12,10,2
6,8,193,4,6,-2
6,8,194,28,42,-14
6,8,195,17,15,2
6,8,196,23,17,6
6,8,197,7,5,2
6,8,198,8,13,-5
6,8,199,7,9,-2
6,8,200,11,11,0
6,8,201,18,10,8
6,8,202,26,28,-2
6,8,203,15,14,1
6,8,204,16,13,3
6,8,205,15,17,-2
6,8,206,5,28,-23
6,8,207,13,6,7
6,8,208,22,19,3
6,8,209,16,8,8
6,8,210,12,18,-6
6,8,211,14,15,-1
6,8,212,5,4,1
6,8,213,9,16,-7
6,8,214,16,12,4
6,8,215,25,14,11
6,8,216,12,5,7
6,8,217,16,16,0
6,8,218,17,6,11
6,8,219,2,6,-4
6,8,220,14,17,-3
6,8,221,18,26,-8
6,8,222,11,22,-11
6,8,223,14,7,7
6,8,224,27,19,8
6,8,225,8,3,5
6,8,226,22,21,1
6,8,227,14,16,-2
6,8,228,20,16,4
6,8,229,8,10,-2
6,8,230,18,12,6
6,8,231,10,8,2
6,8,232,13,18,-5
6,8,233,8,8,0
6,8,234,14,11,3
6,8,235,20,7,13
6,8,236,15,15,0
6,8,237,9,9,0
6,8,238,8,14,-6
6,8,239,16,9,7
6,8,240,8,4,4
6,8,241,17,17,0
6,8,242,12,10,2
6,8,243,11,19,-8
6,8,244,6,12,-6
6,8,245,9,16,-7
6,8,246,14,22,-8
6,8,247,8,7,1
6,8,248,44,23,21
6,8,249,12,12,0
6,8,250,15,8,7
6,8,251,14,11,3
6,8,252,9,12,-3
6,8,253,15,7,8
6,8,254,10,21,-11
6,8,255,16,21,-5
6,8,256,15,14,1
6,8,257,19,14,5
6,8,258,18,9,9
6,8,259,15,18,-3
6,8,260,14,16,-2
6,8,261,20,20,0
6,8,262,10,9,1
6,8,263,17,14,3
6,8,264,15,23,-8
6,8,265,27,21,6
6,8,266,19,19,0
6,8,267,18,14,4
6,8,268,18,12,6
6,8,269,21,9,12
6,8,270,18,7,11
6,8,271,10,16,-6
6,8,272,17,14,3
6,8,273,10,10,0
6,8,274,20,27,-7
6,8,275,18,16,2
6,8,276,24,14,10
6,8,277,22,17,5
6,8,278,10,8,2
6,8,279,9,9,0
6,8,280,21,15,6
6,8,281,25,13,12
6,8,282,25,23,2
6,8,283,11,6,5
6,8,284,10,15,-5
6,8,285,11,16,-5
6,8,286,18,18,0
6,8,287,8,11,-3
6,8,288,15,9,6
6,8,289,19,21,-2
6,8,290,24,19,5
6,8,291,21,26,-5
6,8,292,7,6,1
6,8,293,14,18,-4
6,8,294,19,16,3
6,8,295,8,12,-4
6,8,296,14,13,1
6,8,297,7,3,4
6,8,298,5,9,-4
6,8,299,14,9,5
6,9,0,13,20,-7
6,9,1,30,17,13
6,9,2,7,13,-6
6,9,3,4,2,2
6,9,4,9,16,-7
6,9,5,20,12,8
6,9,6,4,15,-11
6,9,7,16,13,3
6,9,8,15,11,4
6,9,9,24,28,-4
6,9,10,3,15,-12
6,9,11,10,22,-12
6,9,12,14,12,2
6,9,13,30,22,8
6,9,14,15,18,-3
6,9,15,19,7,12
6,9,16,21,10,11
6,9,17,16,12,4
6,9,18,14,14,0
6,9,19,15,15,0
6,9,20,12,6,6
6,9,21,15,12,3
6,9,22,11,10,1
6,9,23,30,18,12
6,9,24,19,15,4
6,9,25,30,18,12
6,9,26,16,13,3
6,9,27,14,8,6
6,9,28,11,11,0
6,9,29,19,6,13
6,9,30,10,8,2
6,9,31,7,11,-4
6,9,32,32,15,17
6,9,33,18,12,6
6,9,34,11,16,-5
6,9,35,15,15,0
6,9,36,8,9,-1
6,9,37,33,12,21
6,9,38,20,9,11
6,9,39,21,20,1
6,9,40,12,2,10
6,9,41,10,11,-1
6,9,42,21,20,1
6,9,43,14,16,-2
6,9,44,12,10,2
6,9,45,22,23,-1
6,9,46,14,18,-4
6,9,47,20,12,8
6,9,48,5,3,2
6,9,49,16,19,-3
6,9,50,10,8,2
6,9,51,10,11,-1
6,9,52,11,15,-4
6,9,53,28,26,2
6,9,54,21,19,2
6,9,55,21,23,-2
6,9,56,10,8,2
6,9,57,19,23,-4
6,9,58,26,14,12
6,9,59,12,18,-6
6,9,60,16,13,3
6,9,61,32,15,17
6,9,62,24,13,11
6,9,63,7,11,-4
6,9,64,4,14,-10
6,9,65,17,15,2
6,9,66,7,6,1
6,9,67,23,19,4
6,9,68,21,22,-1
6,9,69,5,18,-13
6,9,70,14,15,-1
6,9,71,27,21,6
6,9,72,12,4,8
6,9,73,24,20,4
6,9,74,15,11,4
6,9,75,18,18,0
6,9,76,19,18,1
6,9,77,4,15,-11
6,9,78,13,13,0
6,9,79,6,20,-14
6,9,80,10,13,-3
6,9,81,8,14,-6
6,9,82,20,2,18
6,9,83,13,14,-1
6,9,84,17,16,1
6,9,85,15,26,-11
6,9,86,23,17,6
6,9,87,4,16,-12
6,9,88,7,6,1
6,9,89,12,6,6
6,9,90,15,19,-4
6,9,91,13,14,-1
6,9,92,8,8,0
6,9,93,6,17,-11
6,9,94,28,16,12
6,9,95,30,12,18
6,9,96,16,17,-1
6,9,97,8,9,-1
6,9,98,5,6,-1
6,9,99,8,11,-3
6,9,100,11,24,-13
6,9,101,12,14,-2
6,9,102,8,22,-14
6,9,103,15,8,7
6,9,104,17,21,-4
6,9,105,24,17,7
6,9,106,14,11,3
6,9,107,26,22,4
6,9,108,11,8,3
6,9,109,3,8,-5
6,9,110,14,18,-4
6,9,111,16,12,4
6,9,112,24,8,16
6,9,113,11,24,-13
6,9,114,17,12,5
6,9,115,15,16,-1
6,9,116,14,16,-2
6,9,117,18,16,2
6,9,118,23,7,16
6,9,119,16,24,-8
6,9,120,20,27,-7
6,9,121,19,19,0
6,9,122,22,23,-1
6,9,123,11,7,4
6,9,124,10,7,3
6,9,125,22,14,8
6,9,126,7,8,-1
6,9,127,7,11,-4
6,9,128,9,23,-14
6,9,129,12,10,2
6,9,130,30,11,19
6,9,131,8,8,0
6,9,132,12,12,0
6,9,133,11,10,1
6,9,134,18,19,-1
6,9,135,3,6,-3
6,9,136,6,8,-2
6,9,137,10,17,-7
6,9,138,5,14,-9
6,9,139,20,31,-11
6,9,140,21,20,1
6,9,141,16,13,3
6,9,142,18,9,9
6,9,143,10,12,-2
6,9,144,21,16,5
6,9,145,11,7,4
6,9,146,16,12,4
6,9,147,10,11,-1
6,9,148,19,12,7
6,9,149,10,9,1
6,9,150,15,20,-5
6,9,151,11,22,-11
6,9,152,16,22,-6
6,9,153,12,10,2
6,9,154,29,16,13
6,9,155,13,13,0
6,9,156,23,14,9
6,9,157,8,24,-16
6,9,158,16,15,1
6,9,159,19,8,11
6,9,160,23,23,0
6,9,161,22,4,18
6,9,162,12,9,3
6,9,163,21,10,11
6,9,164,20,20,0
6,9,165,12,13,-1
6,9,166,18,16,2
6,9,167,7,11,-4
6,9,168,23,21,2
6,9,169,18,12,6
6,9,170,24,8,16
6,9,171,29,25,4
6,9,172,12,14,-2
6,9,173,17,11,6
6,9,174,9,13,-4
6,9,175,21,15,6
6,9,176,9,5,4
6,9,177,18,10,8
6,9,178,12,20,-8
6,9,179,15,15,0
6,9,180,5,11,-6
6,9,181,8,15,-7
6,9,182,10,14,-4
6,9,183,13,21,-8
6,9,184,6,11,-5
6,9,185,18,22,-4
6,9,186,16,12,4
6,9,187,25,17,8
6,9,188,8,17,-9
6,9,189,20,15,5
6,9,190,15,18,-3
6,9,191,4,10,-6
6,9,192,15,18,-3
6,9,193,11,5,6
6,9,194,11,10,1
6,9,195,21,16,5
6,9,196,16,18,-2
6,9,197,16,12,4
6,9,198,14,8,6
6,9,199,14,16,-2
6,9,200,14,8,6
6,9,201,21,17,4
6,9,202,17,18,-1
6,9,203,19,16,3
6,9,204,8,9,-1
6,9,205,9,8,1
6,9,206,10,10,0
6,9,207,16,14,2
6,9,208,12,7,5
6,9,209,14,7,7
6,9,210,14,15,-1
6,9,211,24,18,6
6,9,212,9,12,-3
6,9,213,11,14,-3
6,9,214,6,8,-2
6,9,215,12,12,0
6,9,216,13,6,7
6,9,217,5,7,-2
6,9,218,9,8,1
6,9,219,17,15,2
6,9,220,11,18,-7
6,9,221,14,9,5
6,9,222,13,12,1
6,9,223,15,15,0
6,9,224,14,24,-10
6,9,225,24,26,-2
6,9,226,19,13,6
6,9,227,19,17,2
6,9,228,39,16,23
6,9,229,9,8,1
6,9,230,8,7,1
6,9,231,14,25,-11
6,9,232,27,10,17
6,9,233,10,12,-2
6,9,234,21,18,3
6,9,235,21,16,5
6,9,236,10,16,-6
6,9,237,27,28,-1
6,9,238,17,17,0
6,9,239,11,12,-1
6,9,240,16,9,7
6,9,241,17,16,1
6,9,242,5,11,-6
6,9,243,6,13,-7
6,9,244,30,19,11
6,9,245,21,14,7
6,9,246,14,14,0
6,9,247,13,20,-7
6,9,248,16,12,4
6,9,249,16,7,9
6,9,250,13,13,0
6,9,251,22,16,6
6,9,252,5,10,-5
6,9,253,12,11,1
6,9,254,13,22,-9
6,9,255,26,20,6
6,9,256,10,10,0
6,9,257,12,14,-2
6,9,258,15,9,6
6,9,259,8,15,-7
6,9,260,24,27,-3
6,9,261,20,11,9
6,9,262,18,14,4
6,9,263,21,14,7
6,9,264,27,14,13
6,9,265,19,6,13
6,9,266,14,12,2
6,9,267,15,8,7
6,9,268,10,5,5
6,9,269,25,13,12
6,9,270,14,7,7
6,9,271,21,12,9
6,9,272,9,11,-2
6,9,273,22,13,9
6,9,274,11,5,6
6,9,275,16,31,-15
6,9,276,10,7,3
6,9,277,12,4,8
6,9,278,15,14,1
6,9,279,19,12,7
6,9,280,22,10,12
6,9,281,17,13,4
6,9,282,9,12,-3
6,9,283,11,10,1
6,9,284,23,13,10
6,9,285,20,23,-3
6,9,286,14,11,3
6,9,287,3,8,-5
6,9,288,14,8,6
6,9,289,2,6,-4
6,9,290,16,22,-6
6,9,291,12,20,-8
6,9,292,21,17,4
6,9,293,11,15,-4
6,9,294,29,30,-1
6,9,295,15,10,5
6,9,296,15,7,8
6,9,297,20,12,8
6,9,298,10,8,2
6,9,299,13,10,3
6,10,0,13,15,-2
6,10,1,16,11,5
6,10,2,26,14,12
6,10,3,15,19,-4
6,10,4,17,20,-3
6,10,5,28,15,13
6,10,6,21,19,2
6,10,7,14,20,-6
6,10,8,11,10,1
6,10,9,9,26,-17
6,10,10,10,11,-1
6,10,11,17,8,9
6,10,12,8,12,-4
6,10,13,6,5,1
6,10,14,7,7,0
6,10,15,9,11,-2
6,10,16,2,9,-7
6,10,17,10,22,-12
6,10,18,17,8,9
6,10,19,11,16,-5
6,10,20,13,4,9
6,10,21,10,25,-15
6,10,22,14,9,5
6,10,23,19,18,1
6,10,24,6,19,-13
6,10,25,10,23,-13
6,10,26,15,19,-4
6,10,27,12,10,2
6,10,28,13,10,3
6,10,29,13,7,6
6,10,30,11,8,3
6,10,31,10,11,-1
6,10,32,5,9,-4
6,10,33,7,24,-17
6,10,34,17,15,2
6,10,35,17,11,6
6,10,36,30,27,3
6,10,37,6,8,-2
6,10,38,15,16,-1
6,10,39,20,29,-9
6,10,40,21,19,2
6,10,41,14,8,6
6,10,42,5,11,-6
6,10,43,12,16,-4
6,10,44,20,18,2
6,10,45,11,8,3
6,10,46,12,13,-1
6,10,47,16,21,-5
6,10,48,34,14,20
6,10,49,15,17,-2
6,10,50,22,20,2
6,10,51,20,10,10
6,10,52,10,9,1
6,10,53,12,8,4
6,10,54,11,5,6
6,10,55,28,17,11
6,10,56,14,19,-5
6,10,57,12,9,3
6,10,58,20,19,1
6,10,59,10,20,-10
6,10,60,11,7,4
6,10,61,16,21,-5
6,10,62,14,14,0
6,10,63,12,12,0
6,10,64,15,13,2
6,10,65,9,16,-7
6,10,66,13,7,6
6,10,67,15,24,-9
6,10,68,16,11,5
6,10,69,24,22,2
6,10,70,34,17,17
6,10,71,17,15,2
6,10,72,4,17,-13
6,10,73,14,14,0
6,10,74,6,5,1
6,10,75,13,16,-3
6,10,76,19,20,-1
6,10,77,3,6,-3
6,10,78,26,8,18
6,10,79,12,15,-3
6,10,80,10,7,3
6,10,81,5,10,-5
6,10,82,14,11,3
6,10,83,6,12,-6
6,10,84,13,25,-12
6,10,85,28,24,4
6,10,86,12,12,0
6,10,87,14,23,-9
6,10,88,25,28,-3
6,10,89,8,13,-5
6,10,90,14,7,7
6,10,91,4,9,-5
6,10,92,9,23,-14
6,10,93,17,15,2
6,10,94,9,9,0
6,10,95,15,23,-8
6,10,96,21,19,2
6,10,97,6,11,-5
6,10,98,20,12,8
6,10,99,16,18,-2
6,10,100,27,13,14
6,10,101,10,19,-9
6,10,102,7,10,-3
6,10,103,14,22,-8
6,10,104,11,10,1
6,10,105,17,9,8
6,10,106,27,19,8
6,10,107,8,12,-4
6,10,108,12,10,2
6,10,109,23,5,18
6,10,110,22,9,13
6,10,111,12,6,6
6,10,112,13,21,-8
6,10,113,16,21,-5
6,10,114,9,16,-7
6,10,115,24,28,-4
6,10,116,13,21,-8
6,10,117,13,13,0
6,10,118,26,18,8
6,10,119,7,15,-8
6,10,120,9,15,-6
6,10,121,11,7,4
6,10,122,19,15,4
6,10,123,24,17,7
6,10,124,20,19,1
6,10,125,14,21,-7
6,10,126,18,20,-2
6,10,127,6,8,-2
6,10,128,4,4,0
6,10,129,10,10,0
6,10,130,21,16,5
6,10,131,15,11,4
6,10,132,19,10,9
6,10,133,25,18,7
6,10,134,19,16,3
6,10,135,14,20,-6
6,10,136,12,2,10
6,10,137,13,14,-1
6,10,138,9,6,3
6,10,139,14,22,-8
6,10,140,16,12,4
6,10,141,19,23,-4
6,10,142,22,13,9
6,10,143,12,8,4
6,10,144,4,15,-11
6,10,145,17,21,-4
6,10,146,20,8,12
6,10,147,11,7,4
6,10,148,16,16,0
6,10,149,23,16,7
6,10,150,17,11,6
6,10,151,21,29,-8
6,10,152,12,17,-5
6,10,153,8,15,-7
6,10,154,19,20,-1
6,10,155,21,7,14
6,10,156,18,15,3
6,10,157,10,11,-1
6,10,158,13,18,-5
6,10,159,8,19,-11
6,10,160,5,20,-15
6,10,161,23,23,0
6,10,162,14,9,5
6,10,163,23,13,10
6,10,164,26,19,7
6,10,165,9,1,8
6,10,166,20,13,7
6,10,167,23,22,1
6,10,168,17,22,-5
6,10,169,7,17,-10
6,10,170,4,13,-9
6,10,171,18,16,2
6,10,172,21,13,8
6,10,173,9,8,1
6,10,174,23,25,-2
6,10,175,13,8,5
6,10,176,7,3,4
6,10,177,10,23,-13
6,10,178,13,24,-11
6,10,179,10,17,-7
6,10,180,19,33,-14
6,10,181,13,13,0
6,10,182,6,8,-2
6,10,183,10,13,-3
6,10,184,24,42,-18
6,10,185,15,5,10
6,10,186,6,1,5
6,10,187,9,17,-8
6,10,188,17,16,1
6,10,189,8,23,-15
6,10,190,21,7,14
6,10,191,21,17,4
6,10,192,15,10,5
6,10,193,13,16,-3
6,10,194,17,10,7
6,10,195,15,31,-16
6,10,196,6,13,-7
6,10,197,20,22,-2
6,10,198,22,19,3
6,10,199,17,11,6
6,10,200,16,21,-5
6,10,201,19,19,0
6,10,202,17,10,7
6,10,203,6,9,-3
6,10,204,10,2,8
6,10,205,29,18,11
6,10,206,16,6,10
6,10,207,12,12,0
6,10,208,18,21,-3
6,10,209,12,24,-12
6,10,210,10,5,5
6,10,211,9,21,-12
6,10,212,10,15,-5
6,10,213,21,10,11
6,10,214,10,8,2
6,10,215,14,9,5
6,10,216,16,6,10
6,10,217,19,9,10
6,10,218,11,16,-5
6,10,219,14,8,6
6,10,220,14,16,-2
6,10,221,16,23,-7
6,10,222,12,17,-5
6,10,223,16,15,1
6,10,224,13,13,0
6,10,225,25,11,14
6,10,226,15,11,4
6,10,227,9,20,-11
6,10,228,23,18,5
6,10,229,21,18,3
6,10,230,15,20,-5
6,10,231,18,9,9
6,10,232,23,17,6
6,10,233,28,20,8
6,10,234,5,13,-8
6,10,235,9,16,-7
6,10,236,10,10,0
6,10,237,10,15,-5
6,10,238,11,9,2
6,10,239,30,10,20
6,10,240,14,7,7
6,10,241,20,13,7
6,10,242,10,17,-7
6,10,243,10,23,-13
6,10,244,27,18,9
6,10,245,9,15,-6
6,10,246,10,16,-6
6,10,247,19,15,4
6,10,248,11,7,4
6,10,249,16,11,5
6,10,250,19,9,10
6,10,251,16,18,-2
6,10,252,13,19,-6
6,10,253,26,23,3
6,10,254,11,10,1
6,10,255,11,16,-5
6,10,256,15,9,6
6,10,257,14,14,0
6,10,258,15,13,2
6,10,259,28,31,-3
6,10,260,3,14,-11
6,10,261,18,16,2
6,10,262,14,15,-1
6,10,263,12,13,-1
6,10,264,16,14,2
6,10,265,11,21,-10
6,10,266,19,16,3
6,10,267,15,12,3
6,10,268,8,19,-11
6,10,269,15,10,5
6,10,270,27,12,15
6,10,271,8,18,-10
6,10,272,9,11,-2
6,10,273,15,16,-1
6,10,274,9,8,1
6,10,275,12,5,7
6,10,276,14,13,1
6,10,277,6,10,-4
6,10,278,13,12,1
6,10,279,11,10,1
6,10,280,21,14,7
6,10,281,14,14,0
6,10,282,18,13,5
6,10,283,6,5,1
6,10,284,12,23,-11
6,10,285,28,16,12
6,10,286,21,12,9
6,10,287,18,17,1
6,10,288,17,22,-5
6,10,289,16,17,-1
6,10,290,14,9,5
6,10,291,23,18,5
6,10,292,14,10,4
6,10,293,13,19,-6
6,10,294,20,28,-8
6,10,295,5,9,-4
6,10,296,20,17,3
6,10,297,9,12,-3
6,10,298,28,22,6
6,10,299,9,10,-1
6,11,0,17,14,3
6,11,1,25,13,12
6,11,2,11,12,-1
6,11,3,22,18,4
6,11,4,8,6,2
6,11,5,22,15,7
6,11,6,24,23,1
6,11,7,19,9,10
6,11,8,20,11,9
6,11,9,11,13,-2
6,11,10,13,19,-6
6,11,11,15,8,7
6,11,12,13,16,-3
6,11,13,15,5,10
6,11,14,13,4,9
6,11,15,14,19,-5
6,11,16,12,14,-2
6,11,17,13,9,4
6,11,18,10,12,-2
6,11,19,12,11,1
6,11,20,15,11,4
6,11,21,13,26,-13
6,11,22,5,12,-7
6,11,23,9,11,-2
6,11,24,7,3,4
6,11,25,8,25,-17
6,11,26,13,11,2
6,11,27,11,17,-6
6,11,28,12,9,3
6,11,29,16,15,1
6,11,30,13,12,1
6,11,31,14,18,-4
6,11,32,9,12,-3
6,11,33,18,16,2
6,11,34,17,14,3
6,11,35,18,13,5
6,11,36,9,10,-1
6,11,37,21,16,5
6,11,38,7,6,1
6,11,39,9,8,1
6,11,40,14,6,8
6,11,41,9,9,0
6,11,42,25,12,13
6,11,43,14,20,-6
6,11,44,28,27,1
6,11,45,12,12,0
6,11,46,11,12,-1
6,11,47,16,13,3
6,11,48,19,14,5
6,11,49,13,10,3
6,11,50,19,15,4
6,11,51,19,18,1
6,11,52,26,13,13
6,11,53,38,27,11
6,11,54,10,6,4
6,11,55,17,3,14
6,11,56,15,19,-4
6,11,57,16,18,-2
6,11,58,12,23,-11
6,11,59,19,11,8
6,11,60,17,8,9
6,11,61,3,8,-5
6,11,62,4,10,-6
6,11,63,8,12,-4
6,11,64,21,16,5
6,11,65,16,25,-9
6,11,66,26,22,4
6,11,67,16,15,1
6,11,68,32,30,2
6,11,69,19,8,11
6,11,70,17,14,3
6,11,71,11,10,1
6,11,72,21,3,18
6,11,73,7,7,0
6,11,74,19,18,1
6,11,75,16,7,9
6,11,76,5,9,-4
6,11,77,25,19,6
6,11,78,8,4,4
6,11,79,23,28,-5
6,11,80,27,25,2
6,11,81,29,9,20
6,11,82,13,14,-1
6,11,83,18,12,6
6,11,84,14,26,-12
6,11,85,16,22,-6
6,11,86,18,16,2
6,11,87,8,14,-6
6,11,88,12,23,-11
6,11,89,18,12,6
6,11,90,9,4,5
6,11,91,16,20,-4
6,11,92,17,16,1
6,11,93,32,13,19
6,11,94,7,9,-2
6,11,95,18,13,5
6,11,96,12,19,-7
6,11,97,22,17,5
6,11,98,25,7,18
6,11,99,13,7,6
6,11,100,24,28,-4
6,11,101,18,21,-3
6,11,102,11,18,-7
6,11,103,7,13,-6
6,11,104,26,15,11
6,11,105,15,23,-8
6,11,106,13,2,11
6,11,107,21,33,-12
6,11,108,20,18,2
6,11,109,16,19,-3
6,11,110,14,5,9
6,11,111,5,7,-2
6,11,112,19,7,12
6,11,113,12,7,5
6,11,114,10,20,-10
6,11,115,11,5,6
6,11,116,14,20,-6
6,11,117,19,14,5
6,11,118,38,16,22
6,11,119,32,13,19
6,11,120,18,11,7
6,11,121,18,19,-1
6,11,122,10,8,2
6,11,123,22,15,7
6,11,124,16,8,8
6,11,125,6,13,-7
6,11,126,16,20,-4
6,11,127,10,10,0
6,11,128,17,21,-4
6,11,129,26,12,14
6,11,130,18,11,7
6,11,131,13,26,-13
6,11,132,6,14,-8
6,11,133,20,7,13
6,11,134,4,10,-6
6,11,135,19,17,2
6,11,136,16,13,3
6,11,137,10,12,-2
6,11,138,33,11,22
6,11,139,17,5,12
6,11,140,31,34,-3
6,11,141,12,4,8
6,11,142,13,12,1
6,11,143,13,19,-6
6,11,144,5,13,-8
6,11,145,10,8,2
6,11,146,25,13,12
6,11,147,8,17,-9
6,11,148,12,8,4
6,11,149,16,25,-9
6,11,150,34,19,15
6,11,151,1,8,-7
6,11,152,2,4,-2
6,11,153,28,10,18
6,11,154,5,5,0
6,11,155,15,13,2
6,11,156,16,11,5
6,11,157,23,18,5
6,11,158,10,13,-3
6,11,159,14,11,3
6,11,160,12,13,-1
6,11,161,13,16,-3
6,11,162,13,11,2
6,11,163,19,17,2
6,11,164,14,8,6
6,11,165,20,12,8
6,11,166,18,19,-1
6,11,167,27,19,8
6,11,168,22,24,-2
6,11,169,16,12,4
6,11,170,9,12,-3
6,11,171,10,10,0
6,11,172,14,15,-1
6,11,173,7,16,-9
6,11,174,23,16,7
6,11,175,11,9,2
6,11,176,33,21,12
6,11,177,11,18,-7
6,11,178,25,13,12
6,11,179,15,9,6
6,11,180,8,12,-4
6,11,181,16,6,10
6,11,182,2,8,-6
6,11,183,22,14,8
6,11,184,14,16,-2
6,11,185,17,12,5
6,11,186,10,14,-4
6,11,187,9,15,-6
6,11,188,18,25,-7
6,11,189,26,16,10
6,11,190,25,10,15
6,11,191,11,15,-4
6,11,192,12,18,-6
6,11,193,3,2,1
6,11,194,15,8,7
6,11,195,16,20,-4
6,11,196,12,6,6
6,11,197,20,16,4
6,11,198,17,21,-4
6,11,199,13,19,-6
6,11,200,17,23,-6
6,11,201,9,13,-4
6,11,202,17,8,9
6,11,203,9,6,3
6,11,204,12,16,-4
6,11,205,26,20,6
6,11,206,8,5,3
6,11,207,8,14,-6
6,11,208,12,2,10
6,11,209,8,17,-9
6,11,210,24,16,8
6,11,211,18,10,8
6,11,212,27,13,14
6,11,213,19,12,7
6,11,214,4,16,-12
6,11,215,11,15,-4
6,11,216,14,13,1
6,11,217,22,8,14
6,11,218,20,16,4
6,11,219,18,19,-1
6,11,220,14,15,-1
6,11,221,23,9,14
6,11,222,17,19,-2
6,11,223,12,14,-2
6,11,224,26,11,15
6,11,225,8,9,-1
6,11,226,14,21,-7
6,11,227,15,20,-5
6,11,228,12,18,-6
6,11,229,19,13,6
6,11,230,3,14,-11
6,11,231,22,22,0
6,11,232,22,21,1
6,11,233,5,15,-10
6,11,234,31,27,4
6,11,235,18,22,-4
6,11,236,20,17,3
6,11,237,13,8,5
6,11,238,16,3,13
6,11,239,14,4,10
6,11,240,18,20,-2
6,11,241,18,16,2
6,11,242,19,14,5
6,11,243,18,10,8
6,11,244,9,11,-2
6,11,245,8,6,2
6,11,246,21,16,5
6,11,247,10,9,1
6,11,248,17,7,10
6,11,249,14,28,-14
6,11,250,18,14,4
6,11,251,6,4,2
6,11,252,14,31,-17
6,11,253,14,8,6
6,11,254,20,16,4
6,11,255,12,17,-5
6,11,256,11,21,-10
6,11,257,36,14,22
6,11,258,11,10,1
6,11,259,13,20,-7
6,11,260,11,11,0
6,11,261,8,13,-5
6,11,262,16,14,2
6,11,263,7,13,-6
6,11,264,11,11,0
6,11,265,21,20,1
6,11,266,13,15,-2
6,11,267,21,13,8
6,11,268,19,18,1
6,11,269,10,8,2
6,11,270,21,15,6
6,11,271,15,10,5
6,11,272,12,25,-13
6,11,273,12,18,-6
6,11,274,19,13,6
6,11,275,18,13,5
6,11,276,16,12,4
6,11,277,22,13,9
6,11,278,12,12,0
6,11,279,17,12,5
6,11,280,16,7,9
6,11,281,26,10,16
6,11,282,17,22,-5
6,11,283,14,12,2
6,11,284,14,14,0
6,11,285,4,12,-8
6,11,286,23,18,5
6,11,287,17,28,-11
6,11,288,11,10,1
6,11,289,18,6,12
6,11,290,11,23,-12
6,11,291,19,15,4
6,11,292,22,10,12
6,11,293,6,15,-9
6,11,294,12,20,-8
6,11,295,20,10,10
6,11,296,23,13,10
6,11,297,19,15,4
6,11,298,25,12,13
6,11,299,13,17,-4
6,12,0,17,24,-7
6,12,1,12,12,0
6,12,2,7,14,-7
6,12,3,14,20,-6
6,12,4,9,6,3
6,12,5,21,24,-3
6,12,6,11,15,-4
6,12,7,6,10,-4
6,12,8,10,6,4
6,12,9,15,18,-3
6,12,10,22,10,12
6,12,11,22,18,4
6,12,12,5,6,-1
6,12,13,35,15,20
6,12,14,20,19,1
6,12,15,21,8,13
6,12,16,30,18,12
6,12,17,14,18,-4
6,12,18,9,15,-6
6,12,19,17,19,-2
6,12,20,23,5,18
6,12,21,13,3,10
6,12,22,21,10,11
6,12,23,18,11,7
6,12,24,35,13,22
6,12,25,17,23,-6
6,12,26,17,12,5
6,12,27,15,10,5
6,12,28,13,5,8
6,12,29,15,13,2
6,12,30,19,23,-4
6,12,31,8,6,2
6,12,32,30,10,20
6,12,33,10,8,2
6,12,34,19,7,12
6,12,35,15,23,-8
6,12,36,25,11,14
6,12,37,12,6,6
6,12,38,25,20,5
6,12,39,9,25,-16
6,12,40,6,13,-7
6,12,41,15,13,2
6,12,42,20,17,3
6,12,43,37,14,23
6,12,44,16,4,12
6,12,45,12,6,6
6,12,46,17,6,11
6,12,47,22,20,2
6,12,48,23,20,3
6,12,49,25,13,12
6,12,50,14,9,5
6,12,51,16,9,7
6,12,52,8,9,-1
6,12,53,15,7,8
6,12,54,16,20,-4
6,12,55,19,11,8
6,12,56,26,27,-1
6,12,57,15,23,-8
6,12,58,28,15,13
6,12,59,12,5,7
6,12,60,14,10,4
6,12,61,14,22,-8
6,12,62,31,14,17
6,12,63,12,23,-11
6,12,64,21,20,1
6,12,65,17,16,1
6,12,66,17,11,6
6,12,67,12,11,1
6,12,68,17,25,-8
6,12,69,16,8,8
6,12,70,23,10,13
6,12,71,11,3,8
6,12,72,10,19,-9
6,12,73,18,11,7
6,12,74,10,7,3
6,12,75,15,14,1
6,12,76,28,15,13
6,12,77,13,11,2
6,12,78,15,9,6
6,12,79,14,10,4
6,12,80,16,12,4
6,12,81,17,13,4
6,12,82,21,14,7
6,12,83,8,5,3
6,12,84,14,9,5
6,12,85,16,15,1
6,12,86,13,11,2
6,12,87,18,42,-24
6,12,88,15,11,4
6,12,89,28,14,14
6,12,90,5,5,0
6,12,91,12,3,9
6,12,92,34,14,20
6,12,93,18,15,3
6,12,94,13,14,-1
6,12,95,10,8,2
6,12,96,14,15,-1
6,12,97,17,25,-8
6,12,98,14,21,-7
6,12,99,31,14,17
6,12,100,12,10,2
6,12,101,21,11,10
6,12,102,31,11,20
6,12,103,7,12,-5
6,12,104,21,13,8
6,12,105,20,8,12
6,12,106,14,19,-5
6,12,107,16,16,0
6,12,108,34,9,25
6,12,109,17,8,9
6,12,110,11,4,7
6,12,111,9,10,-1
6,12,112,12,16,-4
6,12,113,23,16,7
6,12,114,10,11,-1
6,12,115,17,13,4
6,12,116,20,18,2
6,12,117,10,9,1
6,12,118,12,8,4
6,12,119,16,12,4
6,12,120,9,9,0
6,12,121,9,4,5
6,12,122,15,9,6
6,12,123,9,17,-8
6,12,124,26,13,13
6,12,125,27,17,10
6,12,126,9,12,-3
6,12,127,13,14,-1
6,12,128,15,13,2
6,12,129,7,18,-11
6,12,130,12,18,-6
6,12,131,19,21,-2
6,12,132,14,26,-12
6,12,133,20,8,12
6,12,134,27,20,7
6,12,135,22,13,9
6,12,136,5,12,-7
6,12,137,43,25,18
6,12,138,25,23,2
6,12,139,12,19,-7
6,12,140,20,17,3
6,12,141,10,20,-10
6,12,142,13,11,2
6,12,143,7,11,-4
6,12,144,13,14,-1
6,12,145,11,15,-4
6,12,146,15,13,2
6,12,147,24,6,18
6,12,148,13,15,-2
6,12,149,10,22,-12
6,12,150,10,16,-6
6,12,151,24,15,9
6,12,152,17,13,4
6,12,153,5,5,0
6,12,154,15,6,9
6,12,155,20,9,11
6,12,156,8,16,-8
6,12,157,19,12,7
6,12,158,7,14,-7
6,12,159,11,20,-9
6,12,160,22,12,10
6,12,161,10,13,-3
6,12,162,12,10,2
6,12,163,14,21,-7
6,12,164,13,15,-2
6,12,165,16,10,6
6,12,166,4,8,-4
6,12,167,17,12,5
6,12,168,13,17,-4
6,12,169,14,15,-1
6,12,170,13,9,4
6,12,171,14,13,1
6,12,172,20,11,9
6,12,173,17,13,4
6,12,174,15,21,-6
6,12,175,17,16,1
6,12,176,22,29,-7
6,12,177,18,7,11
6,12,178,27,9,18
6,12,179,11,10,1
6,12,180,10,14,-4
6,12,181,11,9,2
6,12,182,20,13,7
6,12,183,14,13,1
6,12,184,11,16,-5
6,12,185,24,16,8
6,12,186,13,16,-3
6,12,187,17,20,-3
6,12,188,10,16,-6
6,12,189,24,14,10
6,12,190,10,12,-2
6,12,191,23,16,7
6,12,192,25,10,15
6,12,193,20,13,7
6,12,194,24,15,9
6,12,195,12,21,-9
6,12,196,19,13,6
6,12,197,8,13,-5
6,12,198,21,11,10
6,12,199,16,8,8
6,12,200,5,11,-6
6,12,201,14,18,-4
6,12,202,17,14,3
6,12,203,6,8,-2
6,12,204,14,7,7
6,12,205,17,7,10
6,12,206,14,18,-4
6,12,207,24,3,21
6,12,208,6,12,-6
6,12,209,10,11,-1
6,12,210,8,21,-13
6,12,211,25,14,11
6,12,212,12,8,4
6,12,213,29,12,17
6,12,214,23,10,13
6,12,215,13,8,5
6,12,216,10,12,-2
6,12,217,13,21,-8
6,12,218,25,16,9
6,12,219,18,23,-5
6,12,220,8,11,-3
6,12,221,18,18,0
6,12,222,17,9,8
6,12,223,13,6,7
6,12,224,11,9,2
6,12,225,12,13,-1
6,12,226,23,15,8
6,12,227,23,16,7
6,12,228,21,20,1
6,12,229,15,14,1
6,12,230,12,25,-13
6,12,231,18,13,5
6,12,232,16,16,0
6,12,233,15,11,4
6,12,234,16,8,8
6,12,235,31,11,20
6,12,236,18,19,-1
6,12,237,25,13,12
6,12,238,18,6,12
6,12,239,21,22,-1
6,12,240,12,20,-8
6,12,241,6,18,-12
6,12,242,22,14,8
6,12,243,23,22,1
6,12,244,20,18,2
6,12,245,23,14,9
6,12,246,24,16,8
6,12,247,16,15,1
6,12,248,33,19,14
6,12,249,19,8,11
6,12,250,24,28,-4
6,12,251,20,13,7
6,12,252,16,13,3
6,12,253,21,17,4
6,12,254,7,14,-7
6,12,255,11,15,-4
6,12,256,17,8,9
6,12,257,27,14,13
6,12,258,25,13,12
6,12,259,23,14,9
6,12,260,18,13,5
6,12,261,12,10,2
6,12,262,21,15,6
6,12,263,23,19,4
6,12,264,12,10,2
6,12,265,18,12,6
6,12,266,9,8,1
6,12,267,12,8,4
6,12,268,22,18,4
6,12,269,27,23,4
6,12,270,12,9,3
6,12,271,14,18,-4
6,12,272,11,4,7
6,12,273,22,11,11
6,12,274,12,13,-1
6,12,275,17,13,4
6,12,276,14,24,-10
6,12,277,17,13,4
6,12,278,13,9,4
6,12,279,19,11,8
6,12,280,6,9,-3
6,12,281,20,7,13
6,12,282,26,11,15
6,12,283,18,13,5
6,12,284,14,6,8
6,12,285,10,17,-7
6,12,286,10,6,4
6,12,287,19,17,2
6,12,288,17,18,-1
6,12,289,12,6,6
6,12,290,12,25,-13
6,12,291,23,14,9
6,12,292,4,7,-3
6,12,293,16,27,-11
6,12,294,9,5,4
6,12,295,23,9,14
6,12,296,21,11,10
6,12,297,9,4,5
6,12,298,18,19,-1
6,12,299,20,17,3
6,13,0,18,13,5
6,13,1,16,15,1
6,13,2,11,4,7
6,13,3,12,16,-4
6,13,4,5,18,-13
6,13,5,12,10,2
6,13,6,7,20,-13
6,13,7,25,20,5
6,13,8,22,17,5
6,13,9,18,7,11
6,13,10,21,20,1
6,13,11,20,17,3
6,13,12,5,20,-15
6,13,13,14,9,5
6,13,14,19,11,8
6,13,15,33,12,21
6,13,16,11,13,-2
6,13,17,13,9,4
6,13,18,19,9,10
6,13,19,16,27,-11
6,13,20,11,16,-5
6,13,21,18,12,6
6,13,22,19,26,-7
6,13,23,18,17,1
6,13,24,6,7,-1
6,13,25,22,18,4
6,13,26,23,16,7
6,13,27,14,8,6
6,13,28,13,22,-9
6,13,29,24,13,11
6,13,30,27,12,15
6,13,31,29,17,12
6,13,32,25,17,8
6,13,33,12,22,-10
6,13,34,11,7,4
6,13,35,15,16,-1
6,13,36,32,16,16
6,13,37,11,6,5
6,13,38,19,13,6
6,13,39,20,17,3
6,13,40,15,12,3
6,13,41,19,13,6
6,13,42,21,13,8
6,13,43,20,8,12
6,13,44,7,6,1
6,13,45,9,9,0
6,13,46,15,18,-3
6,13,47,26,16,10
6,13,48,18,7,11
6,13,49,16,22,-6
6,13,50,22,21,1
6,13,51,18,21,-3
6,13,52,8,16,-8
6,13,53,11,17,-6
6,13,54,26,11,15
6,13,55,13,22,-9
6,13,56,9,17,-8
6,13,57,2,10,-8
6,13,58,10,21,-11
6,13,59,25,14,11
6,13,60,13,18,-5
6,13,61,12,6,6
6,13,62,11,14,-3
6,13,63,21,9,12
6,13,64,15,11,4
6,13,65,7,9,-2
6,13,66,18,16,2
6,13,67,28,15,13
6,13,68,10,5,5
6,13,69,5,5,0
6,13,70,27,20,7
6,13,71,11,7,4
6,13,72,10,7,3
6,13,73,24,9,15
6,13,74,25,12,13
6,13,75,18,16,2
6,13,76,29,26,3
6,13,77,14,11,3
6,13,78,10,5,5
6,13,79,7,23,-16
6,13,80,14,14,0
6,13,81,11,13,-2
6,13,82,15,10,5
6,13,83,25,18,7
6,13,84,19,8,11
6,13,85,17,14,3
6,13,86,12,13,-1
6,13,87,26,13,13
6,13,88,9,20,-11
6,13,89,18,19,-1
6,13,90,17,7,10
6,13,91,8,8,0
6,13,92,21,9,12
6,13,93,40,15,25
6,13,94,10,9,1
6,13,95,5,10,-5
6,13,96,15,7,8
6,13,97,13,19,-6
6,13,98,27,21,6
6,13,99,13,8,5
6,13,100,21,19,2
6,13,101,13,24,-11
6,13,102,33,27,6
6,13,103,28,18,10
6,13,104,20,8,12
6,13,105,17,27,-10
6,13,106,22,17,5
6,13,107,23,14,9
6,13,108,20,14,6
6,13,109,38,17,21
6,13,110,12,8,4
6,13,111,18,14,4
6,13,112,10,13,-3
6,13,113,12,24,-12
6,13,114,17,12,5
6,13,115,15,11,4
6,13,116,25,23,2
6,13,117,23,12,11
6,13,118,14,6,8
6,13,119,18,20,-2
6,13,120,7,19,-12
6,13,121,20,29,-9
6,13,122,12,17,-5
6,13,123,13,10,3
6,13,124,13,15,-2
6,13,125,15,11,4
6,13,126,11,16,-5
6,13,127,15,18,-3
6,13,128,19,10,9
6,13,129,10,7,3
6,13,130,32,21,11
6,13,131,23,24,-1
6,13,132,21,17,4
6,13,133,23,23,0
6,13,134,13,15,-2
6,13,135,10,7,3
6,13,136,16,11,5
6,13,137,17,18,-1
6,13,138,21,9,12
6,13,139,13,15,-2
6,13,140,4,10,-6
6,13,141,22,12,10
6,13,142,15,12,3
6,13,143,9,12,-3
6,13,144,3,12,-9
6,13,145,22,18,4
6,13,146,18,10,8
6,13,147,26,5,21
6,13,148,24,23,1
6,13,149,20,8,12
6,13,150,10,14,-4
6,13,151,20,27,-7
6,13,152,14,13,1
6,13,153,14,7,7
6,13,154,12,8,4
6,13,155,39,30,9
6,13,156,19,12,7
6,13,157,19,2,17
6,13,158,7,8,-1
6,13,159,15,32,-17
6,13,160,17,17,0
6,13,161,16,8,8
6,13,162,14,15,-1
6,13,163,20,20,0
6,13,164,26,15,11
6,13,165,11,9,2
6,13,166,10,11,-1
6,13,167,17,7,10
6,13,168,19,14,5
6,13,169,14,15,-1
6,13,170,11,13,-2
6,13,171,17,6,11
6,13,172,8,7,1
6,13,173,20,23,-3
6,13,174,4,12,-8
6,13,175,16,24,-8
6,13,176,8,10,-2
6,13,177,21,5,16
6,13,178,18,8,10
6,13,179,21,16,5
6,13,180,5,11,-6
6,13,181,13,9,4
6,13,182,20,18,2
6,13,183,20,14,6
6,13,184,25,22,3
6,13,185,7,9,-2
6,13,186,29,17,12
6,13,187,12,12,0
6,13,188,30,34,-4
6,13,189,16,13,3
6,13,190,16,13,3
6,13,191,9,8,1
6,13,192,7,22,-15
6,13,193,25,18,7
6,13,194,16,11,5
6,13,195,14,10,4
6,13,196,9,11,-2
6,13,197,12,9,3
6,13,198,18,5,13
6,13,199,22,7,15
6,13,200,17,21,-4
6,13,201,12,21,-9
6,13,202,11,6,5
6,13,203,16,17,-1
6,13,204,5,11,-6
6,13,205,18,13,5
6,13,206,26,20,6
6,13,207,9,4,5
6,13,208,8,10,-2
6,13,209,10,13,-3
6,13,210,11,10,1
6,13,211,22,10,12
6,13,212,29,20,9
6,13,213,14,10,4
6,13,214,6,11,-5
6,13,215,19,15,4
6,13,216,20,26,-6
6,13,217,22,10,12
6,13,218,17,10,7
6,13,219,37,29,8
6,13,220,18,10,8
6,13,221,24,16,8
6,13,222,20,19,1
6,13,223,18,10,8
6,13,224,16,6,10
6,13,225,13,28,-15
6,13,226,13,9,4
6,13,227,17,10,7
6,13,228,11,12,-1
6,13,229,14,15,-1
6,13,230,7,9,-2
6,13,231,6,5,1
6,13,232,12,16,-4
6,13,233,13,25,-12
6,13,234,22,12,10
6,13,235,12,14,-2
6,13,236,26,10,16
6,13,237,10,12,-2
6,13,238,11,16,-5
6,13,239,12,18,-6
6,13,240,14,9,5
6,13,241,29,21,8
6,13,242,16,20,-4
6,13,243,14,7,7
6,13,244,16,7,9
6,13,245,17,14,3
6,13,246,16,19,-3
6,13,247,19,16,3
6,13,248,15,7,8
6,13,249,13,5,8
6,13,250,14,12,2
6,13,251,18,18,0
6,13,252,19,22,-3
6,13,253,18,21,-3
6,13,254,20,11,9
6,13,255,21,7,14
6,13,256,15,19,-4
6,13,257,28,10,18
6,13,258,13,19,-6
6,13,259,12,8,4
6,13,260,22,15,7
6,13,261,15,19,-4
6,13,262,27,18,9
6,13,263,15,22,-7
6,13,264,19,6,13
6,13,265,15,18,-3
6,13,266,11,12,-1
6,13,267,16,9,7
6,13,268,17,10,7
6,13,269,10,10,0
6,13,270,9,20,-11
6,13,271,10,8,2
6,13,272,23,8,15
6,13,273,16,10,6
6,13,274,30,5,25
6,13,275,20,17,3
6,13,276,19,15,4
6,13,277,9,8,1
6,13,278,18,12,6
6,13,279,23,8,15
6,13,280,34,14,20
6,13,281,20,13,7
6,13,282,16,4,12
6,13,283,14,20,-6
6,13,284,7,10,-3
6,13,285,16,11,5
6,13,286,10,12,-2
6,13,287,25,7,18
6,13,288,13,16,-3
6,13,289,12,15,-3
6,13,290,26,18,8
6,13,291,24,8,16
6,13,292,13,8,5
6,13,293,10,13,-3
6,13,294,18,13,5
6,13,295,6,8,-2
6,13,296,12,16,-4
6,13,297,18,19,-1
6,13,298,13,8,5
6,13,299,10,9,1
6,14,0,33,28,5
6,14,1,33,15,18
6,14,2,14,8,6
6,14,3,10,14,-4
6,14,4,12,19,-7
6,14,5,14,19,-5
6,14,6,20,10,10
6,14,7,21,17,4
6,14,8,26,12,14
6,14,9,17,20,-3
6,14,10,19,14,5
6,14,11,5,8,-3
6,14,12,10,20,-10
6,14,13,23,12,11
6,14,14,23,9,14
6,14,15,17,10,7
6,14,16,8,15,-7
6,14,17,13,9,4
6,14,18,11,6,5
6,14,19,26,19,7
6,14,20,28,19,9
6,14,21,19,7,12
6,14,22,21,20,1
6,14,23,19,7,12
6,14,24,17,15,2
6,14,25,22,15,7
6,14,26,16,8,8
6,14,27,20,10,10
6,14,28,15,12,3
6,14,29,27,20,7
6,14,30,16,7,9
6,14,31,21,26,-5
6,14,32,15,15,0
6,14,33,18,13,5
6,14,34,21,19,2
6,14,35,20,17,3
6,14,36,16,5,11
6,14,37,6,11,-5
6,14,38,11,9,2
6,14,39,12,11,1
6,14,40,4,18,-14
6,14,41,27,13,14
6,14,42,26,14,12
6,14,43,15,12,3
6,14,44,11,13,-2
6,14,45,23,10,13
6,14,46,17,23,-6
6,14,47,22,19,3
6,14,48,11,11,0
6,14,49,17,7,10
6,14,50,22,14,8
6,14,51,20,3,17
6,14,52,20,22,-2
6,14,53,15,18,-3
6,14,54,13,12,1
6,14,55,18,10,8
6,14,56,13,12,1
6,14,57,26,16,10
6,14,58,14,18,-4
6,14,59,11,11,0
6,14,60,5,6,-1
6,14,61,17,15,2
6,14,62,19,12,7
6,14,63,11,11,0
6,14,64,11,5,6
6,14,65,23,24,-1
6,14,66,15,5,10
6,14,67,19,19,0
6,14,68,11,11,0
6,14,69,7,10,-3
6,14,70,15,13,2
6,14,71,24,10,14
6,14,72,26,14,12
6,14,73,3,10,-7
6,14,74,9,8,1
6,14,75,12,7,5
6,14,76,9,15,-6
6,14,77,20,10,10
6,14,78,16,5,11
6,14,79,11,18,-7
6,14,80,13,14,-1
6,14,81,16,11,5
6,14,82,19,19,0
6,14,83,20,18,2
6,14,84,13,12,1
6,14,85,7,9,-2
6,14,86,5,17,-12
6,14,87,7,3,4
6,14,88,20,12,8
6,14,89,10,23,-13
6,14,90,27,8,19
6,14,91,14,24,-10
6,14,92,14,8,6
6,14,93,8,7,1
6,14,94,12,7,5
6,14,95,23,15,8
6,14,96,24,18,6
6,14,97,17,9,8
6,14,98,17,12,5
6,14,99,14,12,2
6,14,100,27,15,12
6,14,101,16,10,6
6,14,102,9,9,0
6,14,103,24,8,16
6,14,104,17,14,3
6,14,105,16,17,-1
6,14,106,9,19,-10
6,14,107,12,4,8
6,14,108,13,22,-9
6,14,109,17,14,3
6,14,110,15,9,6
6,14,111,6,9,-3
6,14,112,9,10,-1
6,14,113,34,13,21
6,14,114,11,24,-13
6,14,115,9,17,-8
6,14,116,23,15,8
6,14,117,17,10,7
6,14,118,17,9,8
6,14,119,21,22,-1
6,14,120,12,10,2
6,14,121,13,7,6
6,14,122,21,10,11
6,14,123,16,8,8
6,14,124,3,8,-5
6,14,125,10,9,1
6,14,126,14,12,2
6,14,127,6,8,-2
6,14,128,17,23,-6
6,14,129,17,14,3
6,14,130,9,16,-7
6,14,131,11,9,2
6,14,132,11,0,11
6,14,133,9,11,-2
6,14,134,15,19,-4
6,14,135,18,18,0
6,14,136,19,20,-1
6,14,137,12,11,1
6,14,138,9,7,2
6,14,139,26,18,8
6,14,140,10,10,0
6,14,141,7,17,-10
6,14,142,12,11,1
6,14,143,9,20,-11
6,14,144,7,16,-9
6,14,145,21,6,15
6,14,146,15,14,1
6,14,147,16,16,0
6,14,148,6,5,1
6,14,149,9,6,3
6,14,150,11,12,-1
6,14,151,3,4,-1
6,14,152,20,10,10
6,14,153,19,9,10
6,14,154,15,17,-2
6,14,155,12,12,0
6,14,156,5,5,0
6,14,157,7,14,-7
6,14,158,14,8,6
6,14,159,13,13,0
6,14,160,16,16,0
6,14,161,20,8,12
6,14,162,26,15,11
6,14,163,27,15,12
6,14,164,22,15,7
6,14,165,16,18,-2
6,14,166,16,8,8
6,14,167,7,12,-5
6,14,168,9,15,-6
6,14,169,19,13,6
6,14,170,29,3,26
6,14,171,7,17,-10
6,14,172,10,5,5
6,14,173,18,18,0
6,14,174,29,15,14
6,14,175,19,15,4
6,14,176,25,18,7
6,14,177,20,13,7
6,14,178,13,7,6
6,14,179,19,10,9
6,14,180,12,10,2
6,14,181,20,16,4
6,14,182,12,17,-5
6,14,183,12,11,1
6,14,184,21,4,17
6,14,185,21,9,12
6,14,186,19,14,5
6,14,187,27,18,9
6,14,188,18,12,6
6,14,189,9,12,-3
6,14,190,12,7,5
6,14,191,27,20,7
6,14,192,16,23,-7
6,14,193,16,10,6
6,14,194,25,11,14
6,14,195,16,11,5
6,14,196,18,11,7
6,14,197,19,13,6
6,14,198,4,5,-1
6,14,199,8,15,-7
6,14,200,17,25,-8
6,14,201,20,9,11
6,14,202,20,16,4
6,14,203,19,19,0
6,14,204,18,15,3
6,14,205,4,6,-2
6,14,206,31,16,15
6,14,207,23,5,18
6,14,208,12,12,0
6,14,209,26,10,16
6,14,210,8,5,3
6,14,211,31,13,18
6,14,212,10,6,4
6,14,213,22,11,11
6,14,214,12,13,-1
6,14,215,14,10,4
6,14,216,11,22,-11
6,14,217,9,6,3
6,14,218,7,5,2
6,14,219,15,20,-5
6,14,220,31,19,12
6,14,221,12,21,-9
6,14,222,34,22,12
6,14,223,16,7,9
6,14,224,16,9,7
6,14,225,18,14,4
6,14,226,10,5,5
6,14,227,13,14,-1
6,14,228,10,11,-1
6,14,229,26,17,9
6,14,230,9,12,-3
6,14,231,22,27,-5
6,14,232,17,12,5
6,14,233,24,18,6
6,14,234,7,8,-1
6,14,235,30,17,13
6,14,236,21,15,6
6,14,237,19,15,4
6,14,238,23,15,8
6,14,239,20,27,-7
6,14,240,20,35,-15
6,14,241,14,12,2
6,14,242,7,24,-17
6,14,243,12,19,-7
6,14,244,23,28,-5
6,14,245,24,12,12
6,14,246,16,17,-1
6,14,247,19,15,4
6,14,248,18,18,0
6,14,249,7,10,-3
6,14,250,15,18,-3
6,14,251,19,7,12
6,14,252,11,12,-1
6,14,253,17,11,6
6,14,254,16,11,5
6,14,255,18,13,5
6,14,256,12,30,-18
6,14,257,24,3,21
6,14,258,17,11,6
6,14,259,20,26,-6
6,14,260,8,12,-4
6,14,261,14,16,-2
6,14,262,24,9,15
6,14,263,7,10,-3
6,14,264,18,12,6
6,14,265,10,19,-9
6,14,266,30,14,16
6,14,267,16,13,3
6,14,268,21,7,14
6,14,269,31,25,6
6,14,270,16,21,-5
6,14,271,20,23,-3
6,14,272,15,9,6
6,14,273,14,11,3
6,14,274,8,16,-8
6,14,275,18,7,11
6,14,276,11,5,6
6,14,277,15,4,11
6,14,278,8,9,-1
6,14,279,13,3,10
6,14,280,13,16,-3
6,14,281,18,11,7
6,14,282,10,22,-12
6,14,283,10,7,3
6,14,284,10,7,3
6,14,285,13,14,-1
6,14,286,13,9,4
6,14,287,29,14,15
6,14,288,12,14,-2
6,14,289,15,7,8
6,14,290,13,18,-5
6,14,291,28,19,9
6,14,292,15,22,-7
6,14,293,6,16,-10
6,14,294,10,13,-3
6,14,295,17,18,-1
6,14,296,17,8,9
6,14,297,22,9,13
6,14,298,15,12,3
6,14,299,21,13,8
6,15,0,18,24,-6
6,15,1,21,19,2
6,15,2,18,23,-5
6,15,3,15,10,5
6,15,4,21,29,-8
6,15,5,20,4,16
6,15,6,16,15,1
6,15,7,16,12,4
6,15,8,14,14,0
6,15,9,11,11,0
6,15,10,25,6,19
6,15,11,5,9,-4
6,15,12,22,6,16
6,15,13,18,15,3
6,15,14,14,4,10
6,15,15,7,8,-1
6,15,16,22,21,1
6,15,17,19,10,9
6,15,18,20,9,11
6,15,19,10,7,3
6,15,20,27,13,14
6,15,21,17,13,4
6,15,22,7,2,5
6,15,23,13,23,-10
6,15,24,16,11,5
6,15,25,8,7,1
6,15,26,18,8,10
6,15,27,9,8,1
6,15,28,26,13,13
6,15,29,15,12,3
6,15,30,25,9,16
6,15,31,13,16,-3
6,15,32,24,13,11
6,15,33,12,11,1
6,15,34,15,8,7
6,15,35,17,13,4
6,15,36,12,11,1
6,15,37,11,8,3
6,15,38,13,10,3
6,15,39,13,10,3
6,15,40,16,18,-2
6,15,41,11,21,-10
6,15,42,17,10,7
6,15,43,22,19,3
6,15,44,25,16,9
6,15,45,21,9,12
6,15,46,24,17,7
6,15,47,17,6,11
6,15,48,16,7,9
6,15,49,3,15,-12
6,15,50,14,19,-5
6,15,51,31,16,15
6,15,52,15,15,0
6,15,53,22,11,11
6,15,54,21,14,7
6,15,55,18,19,-1
6,15,56,28,11,17
6,15,57,14,13,1
6,15,58,14,13,1
6,15,59,21,16,5
6,15,60,5,11,-6
6,15,61,20,26,-6
6,15,62,15,6,9
6,15,63,17,11,6
6,15,64,17,16,1
6,15,65,19,8,11
6,15,66,26,8,18
6,15,67,32,18,14
6,15,68,10,11,-1
6,15,69,17,22,-5
6,15,70,14,17,-3
6,15,71,12,11,1
6,15,72,17,24,-7
6,15,73,13,8,5
6,15,74,14,10,4
6,15,75,13,14,-1
6,15,76,16,17,-1
6,15,77,17,18,-1
6,15,78,26,11,15
6,15,79,13,9,4
6,15,80,26,10,16
6,15,81,17,10,7
6,15,82,17,10,7
6,15,83,14,7,7
6,15,84,10,8,2
6,15,85,15,25,-10
6,15,86,16,7,9
6,15,87,19,4,15
6,15,88,7,15,-8
6,15,89,20,12,8
6,15,90,20,22,-2
6,15,91,7,13,-6
6,15,92,28,14,14
6,15,93,10,4,6
6,15,94,14,8,6
6,15,95,22,12,10
6,15,96,19,12,7
6,15,97,12,13,-1
6,15,98,19,16,3
6,15,99,24,18,6
6,15,100,7,24,-17
6,15,101,15,8,7
6,15,102,14,10,4
6,15,103,16,20,-4
6,15,104,17,19,-2
6,15,105,10,8,2
6,15,106,24,20,4
6,15,107,17,11,6
6,15,108,12,6,6
6,15,109,25,11,14
6,15,110,17,8,9
6,15,111,11,16,-5
6,15,112,13,13,0
6,15,113,10,9,1
6,15,114,12,13,-1
6,15,115,23,21,2
6,15,116,20,9,11
6,15,117,10,9,1
6,15,118,18,13,5
6,15,119,6,9,-3
6,15,120,19,11,8
6,15,121,24,12,12
6,15,122,23,8,15
6,15,123,20,14,6
6,15,124,15,14,1
6,15,125,12,8,4
6,15,126,28,16,12
6,15,127,15,13,2
6,15,128,12,18,-6
6,15,129,15,20,-5
6,15,130,30,12,18
6,15,131,24,14,10
6,15,132,23,11,12
6,15,133,11,8,3
6,15,134,14,12,2
6,15,135,31,20,11
6,15,136,19,9,10
6,15,137,29,10,19
6,15,138,11,12,-1
6,15,139,22,16,6
6,15,140,6,13,-7
6,15,141,20,20,0
6,15,142,15,23,-8
6,15,143,30,15,15
6,15,144,19,15,4
6,15,145,8,7,1
6,15,146,17,6,11
6,15,147,10,22,-12
6,15,148,26,17,9
6,15,149,20,14,6
6,15,150,18,16,2
6,15,151,23,8,15
6,15,152,19,17,2
6,15,153,27,13,14
6,15,154,8,7,1
6,15,155,12,14,-2
6,15,156,15,9,6
6,15,157,24,13,11
6,15,158,23,16,7
6,15,159,13,11,2
6,15,160,23,11,12
6,15,161,10,9,1
6,15,162,15,18,-3
6,15,163,26,9,17
6,15,164,10,4,6
6,15,165,20,29,-9
6,15,166,9,12,-3
6,15,167,20,17,3
6,15,168,4,9,-5
6,15,169,20,14,6
6,15,170,14,8,6
6,15,171,12,10,2
6,15,172,20,17,3
6,15,173,12,19,-7
6,15,174,19,12,7
6,15,175,14,12,2
6,15,176,9,3,6
6,15,177,13,10,3
6,15,178,22,26,-4
6,15,179,10,10,0
6,15,180,15,6,9
6,15,181,20,14,6
6,15,182,21,26,-5
6,15,183,27,18,9
6,15,184,13,7,6
6,15,185,15,14,1
6,15,186,15,11,4
6,15,187,8,6,2
6,15,188,12,14,-2
6,15,189,11,17,-6
6,15,190,18,33,-15
6,15,191,13,14,-1
6,15,192,10,17,-7
6,15,193,15,7,8
6,15,194,11,14,-3
6,15,195,19,14,5
6,15,196,11,23,-12
6,15,197,9,12,-3
6,15,198,14,12,2
6,15,199,16,10,6
6,15,200,21,16,5
6,15,201,21,16,5
6,15,202,23,16,7
6,15,203,13,6,7
6,15,204,11,17,-6
6,15,205,14,13,1
6,15,206,12,12,0
6,15,207,15,15,0
6,15,208,12,4,8
6,15,209,30,21,9
6,15,210,19,9,10
6,15,211,25,17,8
6,15,212,27,7,20
6,15,213,27,17,10
6,15,214,23,14,9
6,15,215,15,5,10
6,15,216,7,5,2
6,15,217,23,13,10
6,15,218,15,12,3
6,15,219,27,21,6
6,15,220,14,17,-3
6,15,221,20,9,11
6,15,222,24,21,3
6,15,223,14,7,7
6,15,224,12,8,4
6,15,225,17,14,3
6,15,226,18,16,2
6,15,227,15,15,0
6,15,228,26,13,13
6,15,229,20,11,9
6,15,230,30,23,7
6,15,231,17,7,10
6,15,232,29,28,1
6,15,233,14,5,9
6,15,234,12,16,-4
6,15,235,12,10,2
6,15,236,21,16,5
6,15,237,13,6,7
6,15,238,12,20,-8
6,15,239,9,9,0
6,15,240,15,19,-4
6,15,241,11,16,-5
6,15,242,27,20,7
6,15,243,6,7,-1
6,15,244,23,10,13
6,15,245,15,10,5
6,15,246,16,14,2
6,15,247,13,11,2
6,15,248,22,14,8
6,15,249,30,24,6
6,15,250,12,5,7
6,15,251,25,13,12
6,15,252,26,18,8
6,15,253,14,5,9
6,15,254,14,7,7
6,15,255,23,14,9
6,15,256,3,1,2
6,15,257,9,16,-7
6,15,258,8,7,1
6,15,259,13,12,1
6,15,260,18,12,6
6,15,261,25,14,11
6,15,262,21,18,3
6,15,263,24,15,9
6,15,264,12,10,2
6,15,265,22,21,1
6,15,266,17,6,11
6,15,267,38,21,17
6,15,268,12,3,9
6,15,269,16,13,3
6,15,270,22,15,7
6,15,271,11,18,-7
6,15,272,18,24,-6
6,15,273,19,13,6
6,15,274,18,11,7
6,15,275,17,12,5
6,15,276,12,4,8
6,15,277,19,28,-9
6,15,278,25,18,7
6,15,279,14,9,5
6,15,280,19,25,-6
6,15,281,18,12,6
6,15,282,18,12,6
6,15,283,37,18,19
6,15,284,14,16,-2
6,15,285,19,24,-5
6,15,286,17,5,12
6,15,287,17,12,5
6,15,288,34,18,16
6,15,289,15,27,-12
6,15,290,20,11,9
6,15,291,15,14,1
6,15,292,27,15,12
6,15,293,14,16,-2
6,15,294,26,16,10
6,15,295,27,14,13
6,15,296,28,17,11
6,15,297,16,10,6
6,15,298,21,18,3
6,15,299,19,6,13
6,16,0,8,7,1
6,16,1,26,9,17
6,16,2,26,15,11
6,16,3,13,16,-3
6,16,4,8,10,-2
6,16,5,14,4,10
6,16,6,26,15,11
6,16,7,29,18,11
6,16,8,10,9,1
6,16,9,22,17,5
6,16,10,10,14,-4
6,16,11,15,6,9
6,16,12,15,13,2
6,16,13,9,14,-5
6,16,14,30,24,6
6,16,15,30,14,16
6,16,16,27,9,18
6,16,17,22,23,-1
6,16,18,10,7,3
6,16,19,9,15,-6
6,16,20,12,15,-3
6,16,21,5,1,4
6,16,22,18,13,5
6,16,23,23,12,11
6,16,24,14,6,8
6,16,25,9,15,-6
6,16,26,15,7,8
6,16,27,36,13,23
6,16,28,21,6,15
6,16,29,21,13,8
6,16,30,12,11,1
6,16,31,30,12,18
6,16,32,13,19,-6
6,16,33,16,14,2
6,16,34,15,21,-6
6,16,35,20,6,14
6,16,36,21,14,7
6,16,37,22,6,16
6,16,38,14,8,6
6,16,39,33,22,11
6,16,40,19,12,7
6,16,41,18,11,7
6,16,42,17,20,-3
6,16,43,28,15,13
6,16,44,24,8,16
6,16,45,9,9,0
6,16,46,11,15,-4
6,16,47,19,14,5
6,16,48,17,15,2
6,16,49,30,18,12
6,16,50,25,18,7
6,16,51,18,10,8
6,16,52,25,10,15
6,16,53,22,11,11
6,16,54,21,13,8
6,16,55,15,13,2
6,16,56,18,12,6
6,16,57,35,7,28
6,16,58,24,10,14
6,16,59,16,16,0
6,16,60,14,17,-3
6,16,61,27,15,12
6,16,62,14,7,7
6,16,63,9,6,3
6,16,64,20,13,7
6,16,65,25,16,9
6,16,66,15,9,6
6,16,67,4,5,-1
6,16,68,31,16,15
6,16,69,22,13,9
6,16,70,13,6,7
6,16,71,19,6,13
6,16,72,27,7,20
6,16,73,15,20,-5
6,16,74,24,23,1
6,16,75,18,12,6
6,16,76,10,17,-7
6,16,77,15,19,-4
6,16,78,15,21,-6
6,16,79,17,14,3
6,16,80,21,14,7
6,16,81,12,18,-6
6,16,82,22,12,10
6,16,83,14,9,5
6,16,84,29,16,13
6,16,85,24,5,19
6,16,86,11,8,3
6,16,87,13,15,-2
6,16,88,16,20,-4
6,16,89,17,16,1
6,16,90,18,15,3
6,16,91,18,13,5
6,16,92,11,11,0
6,16,93,26,8,18
6,16,94,9,10,-1
6,16,95,22,8,14
6,16,96,15,7,8
6,16,97,16,15,1
6,16,98,16,13,3
6,16,99,25,11,14
6,16,100,19,22,-3
6,16,101,10,11,-1
6,16,102,12,10,2
6,16,103,10,5,5
6,16,104,34,26,8
6,16,105,17,9,8
6,16,106,23,22,1
6,16,107,4,17,-13
6,16,108,20,18,2
6,16,109,16,33,-17
6,16,110,19,23,-4
6,16,111,15,23,-8
6,16,112,19,32,-13
6,16,113,10,6,4
6,16,114,25,14,11
6,16,115,22,16,6
6,16,116,12,6,6
6,16,117,22,13,9
6,16,118,11,6,5
6,16,119,10,6,4
6,16,120,26,17,9
6,16,121,22,21,1
6,16,122,12,12,0
6,16,123,17,16,1
6,16,124,31,21,10
6,16,125,20,14,6
6,16,126,19,15,4
6,16,127,8,5,3
6,16,128,23,18,5
6,16,129,18,18,0
6,16,130,15,17,-2
6,16,131,25,13,12
6,16,132,13,12,1
6,16,133,18,23,-5
6,16,134,11,13,-2
6,16,135,10,13,-3
6,16,136,16,12,4
6,16,137,20,8,12
6,16,138,11,11,0
6,16,139,30,17,13
6,16,140,22,13,9
6,16,141,10,1,9
6,16,142,23,18,5
6,16,143,15,13,2
6,16,144,20,23,-3
6,16,145,22,20,2
6,16,146,11,10,1
6,16,147,18,7,11
6,16,148,13,11,2
6,16,149,13,19,-6
6,16,150,11,9,2
6,16,151,16,5,11
6,16,152,18,11,7
6,16,153,9,10,-1
6,16,154,10,16,-6
6,16,155,16,20,-4
6,16,156,23,19,4
6,16,157,21,12,9
6,16,158,33,15,18
6,16,159,11,14,-3
6,16,160,15,9,6
6,16,161,17,3,14
6,16,162,15,17,-2
6,16,163,9,7,2
6,16,164,31,7,24
6,16,165,13,13,0
6,16,166,23,19,4
6,16,167,23,14,9
6,16,168,23,15,8
6,16,169,18,10,8
6,16,170,23,15,8
6,16,171,24,19,5
6,16,172,18,6,12
6,16,173,17,13,4
6,16,174,10,10,0
6,16,175,16,26,-10
6,16,176,21,18,3
6,16,177,29,11,18
6,16,178,26,25,1
6,16,179,19,9,10
6,16,180,19,10,9
6,16,181,8,13,-5
6,16,182,9,8,1
6,16,183,14,5,9
6,16,184,29,13,16
6,16,185,21,18,3
6,16,186,27,22,5
6,16,187,15,13,2
6,16,188,10,7,3
6,16,189,21,9,12
6,16,190,16,22,-6
6,16,191,13,10,3
6,16,192,20,13,7
6,16,193,19,14,5
6,16,194,17,16,1
6,16,195,36,13,23
6,16,196,20,6,14
6,16,197,13,8,5
6,16,198,27,14,13
6,16,199,19,12,7
6,16,200,18,15,3
6,16,201,9,22,-13
6,16,202,12,13,-1
6,16,203,26,15,11
6,16,204,18,7,11
6,16,205,22,11,11
6,16,206,12,13,-1
6,16,207,16,17,-1
6,16,208,9,2,7
6,16,209,16,13,3
6,16,210,30,19,11
6,16,211,11,8,3
6,16,212,23,12,11
6,16,213,16,17,-1
6,16,214,16,3,13
6,16,215,13,15,-2
6,16,216,15,9,6
6,16,217,16,14,2
6,16,218,10,9,1
6,16,219,17,7,10
6,16,220,14,19,-5
6,16,221,15,12,3
6,16,222,19,11,8
6,16,223,10,12,-2
6,16,224,16,19,-3
6,16,225,30,13,17
6,16,226,25,10,15
6,16,227,15,13,2
6,16,228,17,5,12
6,16,229,34,13,21
6,16,230,16,6,10
6,16,231,21,14,7
6,16,232,14,8,6
6,16,233,19,16,3
6,16,234,10,8,2
6,16,235,15,8,7
6,16,236,20,14,6
6,16,237,24,11,13
6,16,238,32,27,5
6,16,239,13,15,-2
6,16,240,18,11,7
6,16,241,19,14,5
6,16,242,11,18,-7
6,16,243,14,12,2
6,16,244,18,9,9
6,16,245,16,23,-7
6,16,246,27,16,11
6,16,247,29,24,5
6,16,248,16,6,10
6,16,249,9,12,-3
6,16,250,13,9,4
6,16,251,22,12,10
6,16,252,18,4,14
6,16,253,18,4,14
6,16,254,18,15,3
6,16,255,21,9,12
6,16,256,29,15,14
6,16,257,22,11,11
6,16,258,20,12,8
6,16,259,9,11,-2
6,16,260,12,4,8
6,16,261,26,5,21
6,16,262,11,3,8
6,16,263,18,13,5
6,16,264,19,16,3
6,16,265,11,7,4
6,16,266,13,8,5
6,16,267,20,25,-5
6,16,268,22,14,8
6,16,269,19,23,-4
6,16,270,31,22,9
6,16,271,20,14,6
6,16,272,23,8,15
6,16,273,13,12,1
6,16,274,14,16,-2
6,16,275,22,8,14
6,16,276,10,16,-6
6,16,277,10,18,-8
6,16,278,11,15,-4
6,16,279,11,12,-1
6,16,280,32,15,17
6,16,281,27,12,15
6,16,282,14,11,3
6,16,283,13,10,3
6,16,284,13,21,-8
6,16,285,17,17,0
6,16,286,12,15,-3
6,16,287,37,24,13
6,16,288,10,11,-1
6,16,289,20,10,10
6,16,290,14,17,-3
6,16,291,13,12,1
6,16,292,7,7,0
6,16,293,11,10,1
6,16,294,9,15,-6
6,16,295,28,18,10
6,16,296,23,17,6
6,16,297,5,3,2
6,16,298,21,8,13
6,16,299,10,13,-3
6,17,0,16,14,2
6,17,1,18,2,16
6,17,2,20,15,5
6,17,3,21,15,6
6,17,4,22,19,3
6,17,5,20,16,4
6,17,6,23,17,6
6,17,7,27,4,23
6,17,8,21,29,-8
6,17,9,18,5,13
6,17,10,10,8,2
6,17,11,8,10,-2
6,17,12,12,22,-10
6,17,13,25,15,10
6,17,14,10,12,-2
6,17,15,21,8,13
6,17,16,13,8,5
6,17,17,33,38,-5
6,17,18,7,12,-5
6,17,19,14,13,1
6,17,20,23,11,12
6,17,21,36,20,16
6,17,22,12,14,-2
6,17,23,24,18,6
6,17,24,30,14,16
6,17,25,18,18,0
6,17,26,20,11,9
6,17,27,22,12,10
6,17,28,21,15,6
6,17,29,28,17,11
6,17,30,32,17,15
6,17,31,6,12,-6
6,17,32,28,15,13
6,17,33,26,17,9
6,17,34,17,9,8
6,17,35,30,11,19
6,17,36,11,14,-3
6,17,37,15,9,6
6,17,38,23,17,6
6,17,39,22,9,13
6,17,40,34,10,24
6,17,41,12,6,6
6,17,42,22,15,7
6,17,43,18,10,8
6,17,44,17,9,8
6,17,45,17,23,-6
6,17,46,14,10,4
6,17,47,20,5,15
6,17,48,18,11,7
6,17,49,17,6,11
6,17,50,17,15,2
6,17,51,51,6,45
6,17,52,16,15,1
6,17,53,15,18,-3
6,17,54,16,14,2
6,17,55,19,20,-1
6,17,56,5,6,-1
6,17,57,14,17,-3
6,17,58,32,15,17
6,17,59,4,7,-3
6,17,60,17,22,-5
6,17,61,9,11,-2
6,17,62,33,11,22
6,17,63,13,10,3
6,17,64,20,15,5
6,17,65,21,9,12
6,17,66,24,26,-2
6,17,67,13,4,9
6,17,68,16,6,10
6,17,69,32,19,13
6,17,70,15,25,-10
6,17,71,10,12,-2
6,17,72,15,20,-5
6,17,73,8,13,-5
6,17,74,8,9,-1
6,17,75,28,14,14
6,17,76,13,9,4
6,17,77,16,15,1
6,17,78,29,16,13
6,17,79,18,10,8
6,17,80,12,11,1
6,17,81,32,11,21
6,17,82,12,12,0
6,17,83,21,15,6
6,17,84,11,13,-2
6,17,85,16,10,6
6,17,86,10,5,5
6,17,87,15,7,8
6,17,88,19,4,15
6,17,89,13,11,2
6,17,90,16,17,-1
6,17,91,21,9,12
6,17,92,15,15,0
6,17,93,11,9,2
6,17,94,18,13,5
6,17,95,10,9,1
6,17,96,36,19,17
6,17,97,16,14,2
6,17,98,25,24,1
6,17,99,17,16,1
6,17,100,13,15,-2
6,17,101,14,12,2
6,17,102,31,19,12
6,17,103,14,14,0
6,17,104,8,10,-2
6,17,105,12,14,-2
6,17,106,30,8,22
6,17,107,25,14,11
6,17,108,25,12,13
6,17,109,17,13,4
6,17,110,12,6,6
6,17,111,18,20,-2
6,17,112,15,13,2
6,17,113,13,8,5
6,17,114,21,15,6
6,17,115,16,7,9
6,17,116,15,17,-2
6,17,117,32,21,11
6,17,118,12,14,-2
6,17,119,21,27,-6
6,17,120,20,17,3
6,17,121,14,18,-4
6,17,122,18,8,10
6,17,123,28,17,11
6,17,124,11,12,-1
6,17,125,13,13,0
6,17,126,33,12,21
6,17,127,16,20,-4
6,17,128,12,14,-2
6,17,129,11,10,1
6,17,130,13,18,-5
6,17,131,17,12,5
6,17,132,17,8,9
6,17,133,20,13,7
6,17,134,26,11,15
6,17,135,12,9,3
6,17,136,9,7,2
6,17,137,27,19,8
6,17,138,10,13,-3
6,17,139,18,16,2
6,17,140,14,7,7
6,17,141,26,10,16
6,17,142,14,10,4
6,17,143,22,22,0
6,17,144,11,17,-6
6,17,145,19,23,-4
6,17,146,17,13,4
6,17,147,20,10,10
6,17,148,24,12,12
6,17,149,30,11,19
6,17,150,26,22,4
6,17,151,22,10,12
6,17,152,12,11,1
6,17,153,29,7,22
6,17,154,28,18,10
6,17,155,23,21,2
6,17,156,33,12,21
6,17,157,21,18,3
6,17,158,32,26,6
6,17,159,16,10,6
6,17,160,10,10,0
6,17,161,23,14,9
6,17,162,20,15,5
6,17,163,11,8,3
6,17,164,16,17,-1
6,17,165,22,14,8
6,17,166,18,6,12
6,17,167,13,12,1
6,17,168,19,8,11
6,17,169,15,17,-2
6,17,170,16,6,10
6,17,171,21,21,0
6,17,172,22,10,12
6,17,173,9,6,3
6,17,174,25,17,8
6,17,175,10,6,4
6,17,176,21,16,5
6,17,177,13,18,-5
6,17,178,10,9,1
6,17,179,22,18,4
6,17,180,20,14,6
6,17,181,12,7,5
6,17,182,18,10,8
6,17,183,20,16,4
6,17,184,10,18,-8
6,17,185,26,11,15
6,17,186,22,15,7
6,17,187,16,5,11
6,17,188,17,14,3
6,17,189,10,10,0
6,17,190,23,20,3
6,17,191,26,9,17
6,17,192,15,10,5
6,17,193,10,13,-3
6,17,194,31,15,16
6,17,195,29,5,24
6,17,196,14,18,-4
6,17,197,8,4,4
6,17,198,7,21,-14
6,17,199,13,5,8
6,17,200,32,25,7
6,17,201,26,21,5
6,17,202,30,16,14
6,17,203,18,6,12
6,17,204,17,6,11
6,17,205,12,18,-6
6,17,206,19,9,10
6,17,207,33,9,24
6,17,208,18,9,9
6,17,209,21,12,9
6,17,210,11,16,-5
6,17,211,18,12,6
6,17,212,18,9,9
6,17,213,20,12,8
6,17,214,47,9,38
6,17,215,20,13,7
6,17,216,13,9,4
6,17,217,14,4,10
6,17,218,9,16,-7
6,17,219,27,21,6
6,17,220,15,11,4
6,17,221,16,15,1
6,17,222,14,20,-6
6,17,223,12,11,1
6,17,224,30,11,19
6,17,225,11,13,-2
6,17,226,17,6,11
6,17,227,14,13,1
6,17,228,20,18,2
6,17,229,19,10,9
6,17,230,9,14,-5
6,17,231,22,8,14
6,17,232,20,15,5
6,17,233,26,12,14
6,17,234,30,14,16
6,17,235,24,7,17
6,17,236,23,10,13
6,17,237,20,10,10
6,17,238,26,10,16
6,17,239,9,4,5
6,17,240,26,9,17
6,17,241,29,15,14
6,17,242,17,7,10
6,17,243,22,6,16
6,17,244,21,8,13
6,17,245,12,9,3
6,17,246,18,14,4
6,17,247,17,21,-4
6,17,248,17,12,5
6,17,249,20,24,-4
6,17,250,20,14,6
6,17,251,23,25,-2
6,17,252,6,19,-13
6,17,253,17,13,4
6,17,254,16,20,-4
6,17,255,25,8,17
6,17,256,18,7,11
6,17,257,17,15,2
6,17,258,14,19,-5
6,17,259,12,8,4
6,17,260,11,12,-1
6,17,261,17,20,-3
6,17,262,12,7,5
6,17,263,15,14,1
6,17,264,15,11,4
6,17,265,19,20,-1
6,17,266,21,4,17
6,17,267,7,6,1
6,17,268,28,10,18
6,17,269,7,11,-4
6,17,270,21,11,10
6,17,271,25,21,4
6,17,272,10,3,7
6,17,273,14,11,3
6,17,274,19,5,14
6,17,275,21,10,11
6,17,276,19,7,12
6,17,277,23,7,16
6,17,278,21,22,-1
6,17,279,11,3,8
6,17,280,19,11,8
6,17,281,20,16,4
6,17,282,19,10,9
6,17,283,6,12,-6
6,17,284,22,9,13
6,17,285,22,5,17
6,17,286,28,14,14
6,17,287,20,21,-1
6,17,288,15,13,2
6,17,289,17,10,7
6,17,290,16,7,9
6,17,291,15,7,8
6,17,292,38,16,22
6,17,293,10,4,6
6,17,294,10,2,8
6,17,295,24,22,2
6,17,296,16,17,-1
6,17,297,9,7,2
6,17,298,19,7,12
6,17,299,10,8,2
6,18,0,16,9,7
6,18,1,25,17,8
6,18,2,16,25,-9
6,18,3,16,5,11
6,18,4,11,12,-1
6,18,5,13,6,7
6,18,6,14,3,11
6,18,7,13,3,10
6,18,8,23,14,9
6,18,9,20,11,9
6,18,10,26,11,15
6,18,11,16,12,4
6,18,12,11,3,8
6,18,13,11,12,-1
6,18,14,15,13,2
6,18,15,16,12,4
6,18,16,10,15,-5
6,18,17,18,6,12
6,18,18,8,14,-6
6,18,19,17,9,8
6,18,20,14,4,10
6,18,21,28,20,8
6,18,22,6,11,-5
6,18,23,27,15,12
6,18,24,18,14,4
6,18,25,24,19,5
6,18,26,24,17,7
6,18,27,49,17,32
6,18,28,19,12,7
6,18,29,18,15,3
6,18,30,11,7,4
6,18,31,25,22,3
6,18,32,11,20,-9
6,18,33,22,9,13
6,18,34,12,8,4
6,18,35,22,17,5
6,18,36,18,8,10
6,18,37,25,22,3
6,18,38,21,18,3
6,18,39,10,11,-1
6,18,40,23,14,9
6,18,41,23,6,17
6,18,42,8,9,-1
6,18,43,27,9,18
6,18,44,16,13,3
6,18,45,14,5,9
6,18,46,23,13,10
6,18,47,18,7,11
6,18,48,18,7,11
6,18,49,22,10,12
6,18,50,9,2,7
6,18,51,9,7,2
6,18,52,15,14,1
6,18,53,25,13,12
6,18,54,20,15,5
6,18,55,31,13,18
6,18,56,7,4,3
6,18,57,35,13,22
6,18,58,14,14,0
6,18,59,21,9,12
6,18,60,26,17,9
6,18,61,24,28,-4
6,18,62,18,7,11
6,18,63,12,10,2
6,18,64,18,16,2
6,18,65,12,11,1
6,18,66,23,13,10
6,18,67,19,10,9
6,18,68,17,19,-2
6,18,69,14,12,2
6,18,70,26,21,5
6,18,71,16,12,4
6,18,72,8,7,1
6,18,73,12,8,4
6,18,74,8,10,-2
6,18,75,16,15,1
6,18,76,30,9,21
6,18,77,23,15,8
6,18,78,9,8,1
6,18,79,27,14,13
6,18,80,15,12,3
6,18,81,16,16,0
6,18,82,23,7,16
6,18,83,16,18,-2
6,18,84,12,8,4
6,18,85,23,17,6
6,18,86,14,7,7
6,18,87,8,2,6
6,18,88,25,10,15
6,18,89,16,17,-1
6,18,90,10,11,-1
6,18,91,29,18,11
6,18,92,20,12,8
6,18,93,15,24,-9
6,18,94,18,9,9
6,18,95,13,8,5
6,18,96,36,22,14
6,18,97,25,6,19
6,18,98,8,5,3
6,18,99,15,3,12
6,18,100,34,18,16
6,18,101,24,3,21
6,18,102,15,22,-7
6,18,103,9,12,-3
6,18,104,18,13,5
6,18,105,20,13,7
6,18,106,22,7,15
6,18,107,18,13,5
6,18,108,19,6,13
6,18,109,17,13,4
6,18,110,6,10,-4
6,18,111,11,6,5
6,18,112,11,5,6
6,18,113,24,22,2
6,18,114,22,14,8
6,18,115,16,13,3
6,18,116,21,17,4
6,18,117,17,12,5
6,18,118,4,2,2
6,18,119,16,10,6
6,18,120,13,8,5
6,18,121,17,14,3
6,18,122,15,12,3
6,18,123,18,14,4
6,18,124,17,4,13
6,18,125,21,14,7
6,18,126,19,13,6
6,18,127,17,23,-6
6,18,128,19,10,9
6,18,129,24,21,3
6,18,130,23,16,7
6,18,131,23,3,20
6,18,132,11,7,4
6,18,133,17,8,9
6,18,134,12,6,6
6,18,135,21,25,-4
6,18,136,16,10,6
6,18,137,19,11,8
6,18,138,15,26,-11
6,18,139,31,24,7
6,18,140,7,16,-9
6,18,141,14,21,-7
6,18,142,18,11,7
6,18,143,14,12,2
6,18,144,9,7,2
6,18,145,23,16,7
6,18,146,19,5,14
6,18,147,16,6,10
6,18,148,19,12,7
6,18,149,9,4,5
6,18,150,11,9,2
6,18,151,6,13,-7
6,18,152,11,7,4
6,18,153,10,4,6
6,18,154,13,10,3
6,18,155,18,14,4
6,18,156,21,16,5
6,18,157,29,17,12
6,18,158,8,7,1
6,18,159,9,8,1
6,18,160,15,25,-10
6,18,161,11,14,-3
6,18,162,16,11,5
6,18,163,10,15,-5
6,18,164,8,8,0
6,18,165,25,20,5
6,18,166,19,9,10
6,18,167,18,10,8
6,18,168,15,13,2
6,18,169,11,1,10
6,18,170,6,3,3
6,18,171,9,9,0
6,18,172,16,17,-1
6,18,173,20,4,16
6,18,174,25,20,5
6,18,175,9,6,3
6,18,176,19,6,13
6,18,177,9,18,-9
6,18,178,32,15,17
6,18,179,16,6,10
6,18,180,17,16,1
6,18,181,8,9,-1
6,18,182,23,12,11
6,18,183,35,29,6
6,18,184,19,4,15
6,18,185,21,14,7
6,18,186,26,18,8
6,18,187,18,6,12
6,18,188,15,12,3
6,18,189,23,9,14
6,18,190,19,3,16
6,18,191,12,6,6
6,18,192,27,14,13
6,18,193,27,2,25
6,18,194,27,8,19
6,18,195,18,28,-10
6,18,196,25,19,6
6,18,197,16,24,-8
6,18,198,15,10,5
6,18,199,17,15,2
6,18,200,13,13,0
6,18,201,24,6,18
6,18,202,22,13,9
6,18,203,15,13,2
6,18,204,24,20,4
6,18,205,29,11,18
6,18,206,23,8,15
6,18,207,35,24,11
6,18,208,24,10,14
6,18,209,10,10,0
6,18,210,17,7,10
6,18,211,16,10,6
6,18,212,9,9,0
6,18,213,13,16,-3
6,18,214,17,8,9
6,18,215,10,11,-1
6,18,216,15,16,-1
6,18,217,21,10,11
6,18,218,34,15,19
6,18,219,24,11,13
6,18,220,17,7,10
6,18,221,16,9,7
6,18,222,17,16,1
6,18,223,15,6,9
6,18,224,12,12,0
6,18,225,27,24,3
6,18,226,20,24,-4
6,18,227,22,9,13
6,18,228,9,2,7
6,18,229,10,19,-9
6,18,230,31,7,24
6,18,231,15,10,5
6,18,232,10,7,3
6,18,233,10,15,-5
6,18,234,26,19,7
6,18,235,20,34,-14
6,18,236,33,17,16
6,18,237,10,13,-3
6,18,238,21,14,7
6,18,239,19,21,-2
6,18,240,22,13,9
6,18,241,13,14,-1
6,18,242,28,19,9
6,18,243,8,14,-6
6,18,244,30,9,21
6,18,245,15,11,4
6,18,246,5,8,-3
6,18,247,27,10,17
6,18,248,16,9,7
6,18,249,16,17,-1
6,18,250,14,7,7
6,18,251,10,4,6
6,18,252,8,12,-4
6,18,253,16,18,-2
6,18,254,9,15,-6
6,18,255,11,6,5
6,18,256,4,16,-12
6,18,257,21,22,-1
6,18,258,25,3,22
6,18,259,26,3,23
6,18,260,13,5,8
6,18,261,13,9,4
6,18,262,13,10,3
6,18,263,11,9,2
6,18,264,20,14,6
6,18,265,18,10,8
6,18,266,21,17,4
6,18,267,31,16,15
6,18,268,17,14,3
6,18,269,20,12,8
6,18,270,23,15,8
6,18,271,14,15,-1
6,18,272,18,9,9
6,18,273,9,8,1
6,18,274,18,10,8
6,18,275,19,27,-8
6,18,276,29,7,22
6,18,277,19,8,11
6,18,278,31,8,23
6,18,279,32,1,31
6,18,280,30,17,13
6,18,281,6,17,-11
6,18,282,12,15,-3
6,18,283,17,9,8
6,18,284,11,5,6
6,18,285,14,18,-4
6,18,286,6,12,-6
6,18,287,14,9,5
6,18,288,20,9,11
6,18,289,19,13,6
6,18,290,9,7,2
6,18,291,15,11,4
6,18,292,29,8,21
6,18,293,21,19,2
6,18,294,19,9,10
6,18,295,6,13,-7
6,18,296,7,16,-9
6,18,297,6,12,-6
6,18,298,15,6,9
6,18,299,18,4,14
6,19,0,21,9,12
6,19,1,16,7,9
6,19,2,8,9,-1
6,19,3,19,12,7
6,19,4,13,13,0
6,19,5,21,23,-2
6,19,6,16,6,10
6,19,7,14,8,6
6,19,8,30,11,19
6,19,9,15,9,6
6,19,10,16,10,6
6,19,11,23,17,6
6,19,12,14,11,3
6,19,13,16,13,3
6,19,14,22,10,12
6,19,15,11,8,3
6,19,16,20,12,8
6,19,17,18,15,3
6,19,18,15,13,2
6,19,19,23,10,13
6,19,20,20,18,2
6,19,21,29,12,17
6,19,22,15,12,3
6,19,23,24,16,8
6,19,24,9,7,2
6,19,25,32,23,9
6,19,26,11,10,1
6,19,27,21,14,7
6,19,28,15,12,3
6,19,29,25,17,8
6,19,30,13,11,2
6,19,31,27,15,12
6,19,32,16,3,13
6,19,33,17,18,-1
6,19,34,21,9,12
6,19,35,18,17,1
6,19,36,12,19,-7
6,19,37,28,16,12
6,19,38,25,11,14
6,19,39,22,8,14
6,19,40,19,23,-4
6,19,41,20,8,12
6,19,42,12,8,4
6,19,43,20,23,-3
6,19,44,9,11,-2
6,19,45,21,17,4
6,19,46,20,28,-8
6,19,47,21,11,10
6,19,48,14,11,3
6,19,49,25,20,5
6,19,50,13,12,1
6,19,51,34,3,31
6,19,52,25,6,19
6,19,53,22,7,15
6,19,54,24,19,5
6,19,55,17,18,-1
6,19,56,19,22,-3
6,19,57,21,22,-1
6,19,58,20,21,-1
6,19,59,9,14,-5
6,19,60,18,19,-1
6,19,61,13,9,4
6,19,62,26,21,5
6,19,63,21,7,14
6,19,64,30,13,17
6,19,65,16,8,8
6,19,66,13,12,1
6,19,67,16,11,5
6,19,68,13,14,-1
6,19,69,28,10,18
6,19,70,19,17,2
6,19,71,27,13,14
6,19,72,25,14,11
6,19,73,33,9,24
6,19,74,19,14,5
6,19,75,19,11,8
6,19,76,19,16,3
6,19,77,17,8,9
6,19,78,26,13,13
6,19,79,12,19,-7
6,19,80,18,7,11
6,19,81,17,10,7
6,19,82,22,22,0
6,19,83,15,4,11
6,19,84,8,8,0
6,19,85,22,14,8
6,19,86,14,6,8
6,19,87,16,21,-5
6,19,88,11,20,-9
6,19,89,9,12,-3
6,19,90,11,5,6
6,19,91,30,13,17
6,19,92,12,13,-1
6,19,93,18,8,10
6,19,94,17,9,8
6,19,95,21,10,11
6,19,96,15,15,0
6,19,97,14,12,2
6,19,98,22,23,-1
6,19,99,11,11,0
6,19,100,22,10,12
6,19,101,16,12,4
6,19,102,19,9,10
6,19,103,21,3,18
6,19,104,26,13,13
6,19,105,20,13,7
6,19,106,26,8,18
6,19,107,18,15,3
6,19,108,9,3,6
6,19,109,8,11,-3
6,19,110,19,6,13
6,19,111,29,14,15
6,19,112,18,6,12
6,19,113,24,7,17
6,19,114,21,17,4
6,19,115,22,7,15
6,19,116,16,16,0
6,19,117,17,5,12
6,19,118,19,17,2
6,19,119,26,8,18
6,19,120,21,9,12
6,19,121,20,12,8
6,19,122,12,11,1
6,19,123,5,5,0
6,19,124,22,4,18
6,19,125,20,18,2
6,19,126,23,15,8
6,19,127,14,16,-2
6,19,128,11,14,-3
6,19,129,8,0,8
6,19,130,26,10,16
6,19,131,11,7,4
6,19,132,17,10,7
6,19,133,11,12,-1
6,19,134,22,11,11
6,19,135,20,7,13
6,19,136,14,11,3
6,19,137,20,12,8
6,19,138,16,17,-1
6,19,139,24,16,8
6,19,140,19,14,5
6,19,141,9,2,7
6,19,142,11,23,-12
6,19,143,5,2,3
6,19,144,6,18,-12
6,19,145,19,17,2
6,19,146,22,11,11
6,19,147,27,16,11
6,19,148,15,12,3
6,19,149,8,11,-3
6,19,150,12,9,3
6,19,151,40,13,27
6,19,152,21,4,17
6,19,153,7,23,-16
6,19,154,16,3,13
6,19,155,17,13,4
6,19,156,17,16,1
6,19,157,10,12,-2
6,19,158,16,4,12
6,19,159,16,12,4
6,19,160,12,8,4
6,19,161,15,11,4
6,19,162,18,20,-2
6,19,163,7,11,-4
6,19,164,20,9,11
6,19,165,30,8,22
6,19,166,20,13,7
6,19,167,19,13,6
6,19,168,6,13,-7
6,19,169,23,10,13
6,19,170,33,24,9
6,19,171,13,8,5
6,19,172,32,30,2
6,19,173,21,14,7
6,19,174,12,11,1
6,19,175,13,17,-4
6,19,176,20,15,5
6,19,177,8,6,2
6,19,178,25,20,5
6,19,179,11,12,-1
6,19,180,21,21,0
6,19,181,10,19,-9
6,19,182,5,11,-6
6,19,183,30,18,12
6,19,184,24,5,19
6,19,185,12,10,2
6,19,186,29,12,17
6,19,187,21,13,8
6,19,188,17,16,1
6,19,189,22,7,15
6,19,190,14,10,4
6,19,191,30,14,16
6,19,192,7,14,-7
6,19,193,9,8,1
6,19,194,13,19,-6
6,19,195,15,12,3
6,19,196,19,21,-2
6,19,197,14,15,-1
6,19,198,15,18,-3
6,19,199,23,8,15
6,19,200,28,8,20
6,19,201,19,5,14
6,19,202,13,5,8
6,19,203,14,13,1
6,19,204,20,18,2
6,19,205,6,6,0
6,19,206,5,8,-3
6,19,207,29,16,13
6,19,208,16,9,7
6,19,209,27,16,11
6,19,210,21,11,10
6,19,211,21,19,2
6,19,212,15,6,9
6,19,213,14,6,8
6,19,214,11,4,7
6,19,215,17,16,1
6,19,216,6,9,-3
6,19,217,10,24,-14
6,19,218,20,15,5
6,19,219,16,16,0
6,19,220,14,16,-2
6,19,221,26,8,18
6,19,222,19,20,-1
6,19,223,18,12,6
6,19,224,17,10,7
6,19,225,18,9,9
6,19,226,19,5,14
6,19,227,21,22,-1
6,19,228,26,14,12
6,19,229,18,18,0
6,19,230,14,17,-3
6,19,231,33,21,12
6,19,232,14,13,1
6,19,233,25,13,12
6,19,234,14,10,4
6,19,235,15,9,6
6,19,236,23,21,2
6,19,237,28,10,18
6,19,238,7,11,-4
6,19,239,22,21,1
6,19,240,27,23,4
6,19,241,14,16,-2
6,19,242,16,12,4
6,19,243,8,6,2
6,19,244,21,15,6
6,19,245,19,19,0
6,19,246,23,16,7
6,19,247,20,20,0
6,19,248,40,12,28
6,19,249,11,14,-3
6,19,250,12,10,2
6,19,251,23,7,16
6,19,252,15,4,11
6,19,253,34,13,21
6,19,254,18,13,5
6,19,255,13,10,3
6,19,256,17,4,13
6,19,257,20,24,-4
6,19,258,10,5,5
6,19,259,22,8,14
6,19,260,21,6,15
6,19,261,9,11,-2
6,19,262,8,9,-1
6,19,263,7,4,3
6,19,264,9,11,-2
6,19,265,20,20,0
6,19,266,15,8,7
6,19,267,16,13,3
6,19,268,9,8,1
6,19,269,24,22,2
6,19,270,12,17,-5
6,19,271,20,12,8
6,19,272,15,18,-3
6,19,273,34,17,17
6,19,274,17,6,11
6,19,275,41,15,26
6,19,276,21,11,10
6,19,277,7,7,0
6,19,278,24,7,17
6,19,279,19,9,10
6,19,280,8,7,1
6,19,281,16,7,9
6,19,282,23,6,17
6,19,283,7,5,2
6,19,284,12,7,5
6,19,285,22,16,6
6,19,286,17,18,-1
6,19,287,27,15,12
6,19,288,14,10,4
6,19,289,20,21,-1
6,19,290,13,9,4
6,19,291,21,23,-2
6,19,292,13,13,0
6,19,293,11,4,7
6,19,294,27,14,13
6,19,295,18,9,9
6,19,296,16,7,9
6,19,297,25,11,14
6,19,298,9,11,-2
6,19,299,21,15,6
6,20,0,27,9,18
6,20,1,15,7,8
6,20,2,9,4,5
6,20,3,8,6,2
6,20,4,19,22,-3
6,20,5,17,17,0
6,20,6,14,7,7
6,20,7,12,10,2
6,20,8,18,12,6
6,20,9,21,8,13
6,20,10,13,6,7
6,20,11,12,13,-1
6,20,12,20,8,12
6,20,13,30,24,6
6,20,14,20,10,10
6,20,15,19,15,4
6,20,16,8,12,-4
6,20,17,12,6,6
6,20,18,22,11,11
6,20,19,17,12,5
6,20,20,18,10,8
6,20,21,13,7,6
6,20,22,24,22,2
6,20,23,23,9,14
6,20,24,25,13,12
6,20,25,18,10,8
6,20,26,22,18,4
6,20,27,16,15,1
6,20,28,8,5,3
6,20,29,27,15,12
6,20,30,14,13,1
6,20,31,17,4,13
6,20,32,27,15,12
6,20,33,30,5,25
6,20,34,18,17,1
6,20,35,15,10,5
6,20,36,21,20,1
6,20,37,20,17,3
6,20,38,16,14,2
6,20,39,12,8,4
6,20,40,21,11,10
6,20,41,17,15,2
6,20,42,10,10,0
6,20,43,17,2,15
6,20,44,16,16,0
6,20,45,15,12,3
6,20,46,10,19,-9
6,20,47,20,9,11
6,20,48,15,19,-4
6,20,49,29,10,19
6,20,50,16,4,12
6,20,51,26,12,14
6,20,52,12,7,5
6,20,53,23,4,19
6,20,54,16,11,5
6,20,55,20,12,8
6,20,56,31,10,21
6,20,57,20,18,2
6,20,58,22,6,16
6,20,59,15,8,7
6,20,60,26,25,1
6,20,61,15,9,6
6,20,62,13,6,7
6,20,63,34,14,20
6,20,64,30,14,16
6,20,65,28,5,23
6,20,66,4,12,-8
6,20,67,20,13,7
6,20,68,20,10,10
6,20,69,14,19,-5
6,20,70,22,11,11
6,20,71,23,15,8
6,20,72,21,20,1
6,20,73,18,14,4
6,20,74,9,17,-8
6,20,75,20,15,5
6,20,76,22,15,7
6,20,77,17,10,7
6,20,78,18,17,1
6,20,79,30,17,13
6,20,80,10,4,6
6,20,81,11,6,5
6,20,82,15,16,-1
6,20,83,35,15,20
6,20,84,34,16,18
6,20,85,21,23,-2
6,20,86,26,8,18
6,20,87,20,20,0
6,20,88,10,11,-1
6,20,89,17,11,6
6,20,90,25,12,13
6,20,91,11,10,1
6,20,92,18,13,5
6,20,93,18,11,7
6,20,94,10,5,5
6,20,95,19,9,10
6,20,96,15,4,11
6,20,97,19,13,6
6,20,98,26,19,7
6,20,99,14,22,-8
6,20,100,17,17,0
6,20,101,22,8,14
6,20,102,27,16,11
6,20,103,6,4,2
6,20,104,24,2,22
6,20,105,16,10,6
6,20,106,12,14,-2
6,20,107,20,6,14
6,20,108,31,15,16
6,20,109,19,11,8
6,20,110,10,5,5
6,20,111,17,14,3
6,20,112,7,12,-5
6,20,113,18,12,6
6,20,114,25,11,14
6,20,115,18,15,3
6,20,116,24,6,18
6,20,117,22,11,11
6,20,118,13,13,0
6,20,119,18,21,-3
6,20,120,23,21,2
6,20,121,11,2,9
6,20,122,27,9,18
6,20,123,30,16,14
6,20,124,21,11,10
6,20,125,19,7,12
6,20,126,15,4,11
6,20,127,11,11,0
6,20,128,13,6,7
6,20,129,20,8,12
6,20,130,27,17,10
6,20,131,16,17,-1
6,20,132,7,7,0
6,20,133,11,5,6
6,20,134,22,17,5
6,20,135,14,11,3
6,20,136,20,15,5
6,20,137,18,14,4
6,20,138,5,15,-10
6,20,139,17,9,8
6,20,140,22,13,9
6,20,141,19,7,12
6,20,142,23,9,14
6,20,143,22,11,11
6,20,144,30,18,12
6,20,145,13,6,7
6,20,146,23,7,16
6,20,147,15,16,-1
6,20,148,24,20,4
6,20,149,17,11,6
6,20,150,20,22,-2
6,20,151,17,10,7
6,20,152,25,17,8
6,20,153,17,19,-2
6,20,154,38,17,21
6,20,155,27,16,11
6,20,156,12,17,-5
6,20,157,25,8,17
6,20,158,28,14,14
6,20,159,11,11,0
6,20,160,17,14,3
6,20,161,23,15,8
6,20,162,19,16,3
6,20,163,17,5,12
6,20,164,24,18,6
6,20,165,16,12,4
6,20,166,12,11,1
6,20,167,25,16,9
6,20,168,15,10,5
6,20,169,10,15,-5
6,20,170,16,30,-14
6,20,171,24,12,12
6,20,172,24,15,9
6,20,173,10,17,-7
6,20,174,28,22,6
6,20,175,17,14,3
6,20,176,17,9,8
6,20,177,15,2,13
6,20,178,14,14,0
6,20,179,12,6,6
6,20,180,11,11,0
6,20,181,23,12,11
6,20,182,17,8,9
6,20,183,25,23,2
6,20,184,14,10,4
6,20,185,18,14,4
6,20,186,9,4,5
6,20,187,19,7,12
6,20,188,14,8,6
6,20,189,19,6,13
6,20,190,18,8,10
6,20,191,14,20,-6
6,20,192,22,5,17
6,20,193,16,11,5
6,20,194,21,8,13
6,20,195,8,8,0
6,20,196,28,20,8
6,20,197,29,9,20
6,20,198,14,11,3
6,20,199,21,14,7
6,20,200,10,8,2
6,20,201,20,10,10
6,20,202,12,11,1
6,20,203,15,13,2
6,20,204,14,12,2
6,20,205,17,10,7
6,20,206,18,10,8
6,20,207,26,11,15
6,20,208,19,14,5
6,20,209,28,12,16
6,20,210,18,23,-5
6,20,211,25,13,12
6,20,212,35,8,27
6,20,213,16,12,4
6,20,214,21,16,5
6,20,215,15,23,-8
6,20,216,29,21,8
6,20,217,26,13,13
6,20,218,14,15,-1
6,20,219,20,14,6
6,20,220,13,13,0
6,20,221,27,20,7
6,20,222,25,7,18
6,20,223,16,9,7
6,20,224,31,11,20
6,20,225,11,13,-2
6,20,226,20,23,-3
6,20,227,35,19,16
6,20,228,5,13,-8
6,20,229,14,6,8
6,20,230,29,15,14
6,20,231,18,18,0
6,20,232,15,20,-5
6,20,233,17,9,8
6,20,234,14,10,4
6,20,235,22,7,15
6,20,236,16,23,-7
6,20,237,11,22,-11
6,20,238,25,14,11
6,20,239,25,19,6
6,20,240,20,18,2
6,20,241,23,8,15
6,20,242,14,18,-4
6,20,243,23,15,8
6,20,244,16,5,11
6,20,245,11,10,1
6,20,246,25,16,9
6,20,247,24,26,-2
6,20,248,43,8,35
6,20,249,18,22,-4
6,20,250,25,10,15
6,20,251,18,15,3
6,20,252,12,10,2
6,20,253,23,12,11
6,20,254,27,14,13
6,20,255,20,12,8
6,20,256,26,31,-5
6,20,257,25,20,5
6,20,258,9,6,3
6,20,259,18,16,2
6,20,260,17,14,3
6,20,261,17,5,12
6,20,262,18,14,4
6,20,263,22,9,13
6,20,264,12,15,-3
6,20,265,20,14,6
6,20,266,22,22,0
6,20,267,18,8,10
6,20,268,22,21,1
6,20,269,14,12,2
6,20,270,31,28,3
6,20,271,15,11,4
6,20,272,22,12,10
6,20,273,27,4,23
6,20,274,27,12,15
6,20,275,18,7,11
6,20,276,7,7,0
6,20,277,17,16,1
6,20,278,14,6,8
6,20,279,20,16,4
6,20,280,6,8,-2
6,20,281,11,14,-3
6,20,282,26,15,11
6,20,283,20,15,5
6,20,284,9,5,4
6,20,285,17,9,8
6,20,286,9,11,-2
6,20,287,19,14,5
6,20,288,13,9,4
6,20,289,10,15,-5
6,20,290,11,8,3
6,20,291,32,6,26
6,20,292,12,13,-1
6,20,293,25,19,6
6,20,294,15,12,3
6,20,295,20,23,-3
6,20,296,28,8,20
6,20,297,10,14,-4
6,20,298,17,18,-1
6,20,299,14,11,3
6,21,0,11,10,1
6,21,1,13,10,3
6,21,2,12,19,-7
6,21,3,26,16,10
6,21,4,8,7,1
6,21,5,19,16,3
6,21,6,16,15,1
6,21,7,23,17,6
6,21,8,18,26,-8
6,21,9,9,15,-6
6,21,10,11,11,0
6,21,11,26,26,0
6,21,12,18,17,1
6,21,13,26,11,15
6,21,14,10,15,-5
6,21,15,24,19,5
6,21,16,25,20,5
6,21,17,5,4,1
6,21,18,17,14,3
6,21,19,14,9,5
6,21,20,5,8,-3
6,21,21,28,19,9
6,21,22,8,1,7
6,21,23,25,17,8
6,21,24,26,9,17
6,21,25,12,11,1
6,21,26,36,16,20
6,21,27,26,16,10
6,21,28,23,17,6
6,21,29,9,6,3
6,21,30,18,12,6
6,21,31,29,23,6
6,21,32,5,21,-16
6,21,33,14,5,9
6,21,34,36,8,28
6,21,35,23,3,20
6,21,36,16,17,-1
6,21,37,5,3,2
6,21,38,17,5,12
6,21,39,21,13,8
6,21,40,21,12,9
6,21,41,16,9,7
6,21,42,29,16,13
6,21,43,19,7,12
6,21,44,15,11,4
6,21,45,19,8,11
6,21,46,13,15,-2
6,21,47,12,10,2
6,21,48,11,10,1
6,21,49,31,21,10
6,21,50,15,9,6
6,21,51,16,19,-3
6,21,52,18,18,0
6,21,53,11,18,-7
6,21,54,26,20,6
6,21,55,18,10,8
6,21,56,36,13,23
6,21,57,6,8,-2
6,21,58,20,16,4
6,21,59,28,14,14
6,21,60,26,4,22
6,21,61,16,10,6
6,21,62,22,8,14
6,21,63,25,9,16
6,21,64,15,5,10
6,21,65,23,6,17
6,21,66,13,8,5
6,21,67,23,11,12
6,21,68,16,8,8
6,21,69,18,11,7
6,21,70,12,14,-2
6,21,71,29,30,-1
6,21,72,32,20,12
6,21,73,21,13,8
6,21,74,29,12,17
6,21,75,13,14,-1
6,21,76,19,6,13
6,21,77,28,9,19
6,21,78,21,13,8
6,21,79,16,9,7
6,21,80,27,11,16
6,21,81,19,6,13
6,21,82,12,6,6
6,21,83,14,14,0
6,21,84,17,16,1
6,21,85,6,10,-4
6,21,86,17,9,8
6,21,87,24,7,17
6,21,88,13,11,2
6,21,89,15,5,10
6,21,90,32,8,24
6,21,91,14,6,8
6,21,92,12,15,-3
6,21,93,18,7,11
6,21,94,11,9,2
6,21,95,12,10,2
6,21,96,16,13,3
6,21,97,23,16,7
6,21,98,18,13,5
6,21,99,11,10,1
6,21,100,18,14,4
6,21,101,16,11,5
6,21,102,16,8,8
6,21,103,11,15,-4
6,21,104,9,8,1
6,21,105,13,9,4
6,21,106,13,6,7
6,21,107,19,13,6
6,21,108,12,6,6
6,21,109,10,7,3
6,21,110,12,6,6
6,21,111,16,12,4
6,21,112,12,10,2
6,21,113,13,22,-9
6,21,114,18,7,11
6,21,115,15,13,2
6,21,116,10,8,2
6,21,117,10,0,10
6,21,118,14,10,4
6,21,119,28,12,16
6,21,120,18,17,1
6,21,121,20,18,2
6,21,122,11,5,6
6,21,123,8,10,-2
6,21,124,24,26,-2
6,21,125,17,6,11
6,21,126,20,5,15
6,21,127,17,18,-1
6,21,128,10,8,2
6,21,129,24,19,5
6,21,130,11,3,8
6,21,131,29,12,17
6,21,132,29,8,21
6,21,133,12,8,4
6,21,134,20,25,-5
6,21,135,23,11,12
6,21,136,19,11,8
6,21,137,12,7,5
6,21,138,20,23,-3
6,21,139,27,16,11
6,21,140,22,13,9
6,21,141,18,9,9
6,21,142,20,10,10
6,21,143,15,13,2
6,21,144,18,13,5
6,21,145,19,8,11
6,21,146,18,10,8
6,21,147,24,8,16
6,21,148,22,10,12
6,21,149,24,29,-5
6,21,150,8,13,-5
6,21,151,17,13,4
6,21,152,25,12,13
6,21,153,16,14,2
6,21,154,24,17,7
6,21,155,24,12,12
6,21,156,19,11,8
6,21,157,20,18,2
6,21,158,21,13,8
6,21,159,9,8,1
6,21,160,31,6,25
6,21,161,20,11,9
6,21,162,24,16,8
6,21,163,26,16,10
6,21,164,18,12,6
6,21,165,14,18,-4
6,21,166,15,13,2
6,21,167,25,16,9
6,21,168,26,17,9
6,21,169,15,15,0
6,21,170,13,18,-5
6,21,171,25,10,15
6,21,172,16,15,1
6,21,173,17,12,5
6,21,174,24,12,12
6,21,175,11,12,-1
6,21,176,14,12,2
6,21,177,23,8,15
6,21,178,8,4,4
6,21,179,20,9,11
6,21,180,38,13,25
6,21,181,17,11,6
6,21,182,18,19,-1
6,21,183,20,22,-2
6,21,184,19,7,12
6,21,185,19,12,7
6,21,186,23,15,8
6,21,187,15,14,1
6,21,188,20,23,-3
6,21,189,17,5,12
6,21,190,13,13,0
6,21,191,10,11,-1
6,21,192,22,25,-3
6,21,193,20,10,10
6,21,194,17,9,8
6,21,195,18,10,8
6,21,196,33,12,21
6,21,197,17,16,1
6,21,198,19,14,5
6,21,199,9,8,1
6,21,200,20,14,6
6,21,201,11,12,-1
6,21,202,9,7,2
6,21,203,18,5,13
6,21,204,17,17,0
6,21,205,34,19,15
6,21,206,17,15,2
6,21,207,25,19,6
6,21,208,26,25,1
6,21,209,21,14,7
6,21,210,10,10,0
6,21,211,15,12,3
6,21,212,20,14,6
6,21,213,10,4,6
6,21,214,11,14,-3
6,21,215,9,12,-3
6,21,216,18,8,10
6,21,217,10,13,-3
6,21,218,21,12,9
6,21,219,23,9,14
6,21,220,14,16,-2
6,21,221,17,9,8
6,21,222,25,9,16
6,21,223,23,15,8
6,21,224,13,7,6
6,21,225,9,9,0
6,21,226,27,14,13
6,21,227,34,33,1
6,21,228,15,6,9
6,21,229,21,15,6
6,21,230,28,13,15
6,21,231,16,11,5
6,21,232,18,5,13
6,21,233,17,13,4
6,21,234,15,17,-2
6,21,235,19,14,5
6,21,236,14,7,7
6,21,237,6,2,4
6,21,238,17,9,8
6,21,239,34,10,24
6,21,240,27,16,11
6,21,241,16,19,-3
6,21,242,23,21,2
6,21,243,22,11,11
6,21,244,22,15,7
6,21,245,30,19,11
6,21,246,25,19,6
6,21,247,25,6,19
6,21,248,21,7,14
6,21,249,23,7,16
6,21,250,12,11,1
6,21,251,8,6,2
6,21,252,9,8,1
6,21,253,15,17,-2
6,21,254,26,19,7
6,21,255,35,13,22
6,21,256,30,11,19
6,21,257,20,12,8
6,21,258,24,6,18
6,21,259,10,13,-3
6,21,260,13,11,2
6,21,261,28,12,16
6,21,262,10,5,5
6,21,263,22,27,-5
6,21,264,11,19,-8
6,21,265,14,11,3
6,21,266,18,14,4
6,21,267,12,5,7
6,21,268,14,8,6
6,21,269,20,8,12
6,21,270,16,8,8
6,21,271,32,8,24
6,21,272,12,8,4
6,21,273,13,8,5
6,21,274,20,10,10
6,21,275,20,15,5
6,21,276,10,11,-1
6,21,277,21,14,7
6,21,278,15,9,6
6,21,279,36,19,17
6,21,280,21,13,8
6,21,281,9,14,-5
6,21,282,13,18,-5
6,21,283,10,2,8
6,21,284,27,7,20
6,21,285,21,10,11
6,21,286,20,16,4
6,21,287,18,14,4
6,21,288,20,13,7
6,21,289,2,5,-3
6,21,290,19,14,5
6,21,291,22,10,12
6,21,292,17,15,2
6,21,293,15,10,5
6,21,294,13,12,1
6,21,295,13,9,4
6,21,296,20,17,3
6,21,297,17,14,3
6,21,298,23,10,13
6,21,299,9,6,3
6,22,0,27,17,10
6,22,1,19,9,10
6,22,2,20,9,11
6,22,3,15,7,8
6,22,4,14,13,1
6,22,5,14,4,10
6,22,6,23,4,19
6,22,7,30,16,14
6,22,8,28,18,10
6,22,9,26,16,10
6,22,10,31,19,12
6,22,11,16,9,7
6,22,12,15,7,8
6,22,13,25,7,18
6,22,14,34,20,14
6,22,15,26,8,18
6,22,16,11,13,-2
6,22,17,20,26,-6
6,22,18,13,14,-1
6,22,19,16,18,-2
6,22,20,28,24,4
6,22,21,8,8,0
6,22,22,22,8,14
6,22,23,13,21,-8
6,22,24,18,13,5
6,22,25,22,14,8
6,22,26,19,20,-1
6,22,27,15,10,5
6,22,28,16,14,2
6,22,29,13,8,5
6,22,30,20,14,6
6,22,31,13,10,3
6,22,32,16,8,8
6,22,33,20,12,8
6,22,34,23,6,17
6,22,35,16,13,3
6,22,36,17,11,6
6,22,37,15,3,12
6,22,38,13,15,-2
6,22,39,18,10,8
6,22,40,4,6,-2
6,22,41,12,11,1
6,22,42,21,15,6
6,22,43,19,13,6
6,22,44,11,11,0
6,22,45,19,19,0
6,22,46,22,25,-3
6,22,47,24,13,11
6,22,48,22,19,3
6,22,49,12,10,2
6,22,50,16,16,0
6,22,51,33,11,22
6,22,52,18,11,7
6,22,53,29,7,22
6,22,54,7,15,-8
6,22,55,16,6,10
6,22,56,17,12,5
6,22,57,16,7,9
6,22,58,28,10,18
6,22,59,27,14,13
6,22,60,28,35,-7
6,22,61,21,9,12
6,22,62,18,8,10
6,22,63,27,6,21
6,22,64,16,10,6
6,22,65,26,11,15
6,22,66,10,9,1
6,22,67,32,10,22
6,22,68,18,19,-1
6,22,69,15,22,-7
6,22,70,19,10,9
6,22,71,26,16,10
6,22,72,29,13,16
6,22,73,19,14,5
6,22,74,22,11,11
6,22,75,6,3,3
6,22,76,10,19,-9
6,22,77,14,8,6
6,22,78,9,7,2
6,22,79,15,14,1
6,22,80,23,22,1
6,22,81,34,18,16
6,22,82,23,8,15
6,22,83,19,15,4
6,22,84,14,9,5
6,22,85,22,12,10
6,22,86,21,18,3
6,22,87,20,13,7
6,22,88,16,7,9
6,22,89,11,13,-2
6,22,90,22,12,10
6,22,91,15,11,4
6,22,92,30,13,17
6,22,93,17,13,4
6,22,94,23,27,-4
6,22,95,11,19,-8
6,22,96,20,7,13
6,22,97,28,10,18
6,22,98,27,14,13
6,22,99,31,22,9
6,22,100,8,2,6
6,22,101,12,16,-4
6,22,102,18,12,6
6,22,103,12,4,8
6,22,104,24,6,18
6,22,105,17,13,4
6,22,106,15,23,-8
6,22,107,20,22,-2
6,22,108,18,17,1
6,22,109,33,10,23
6,22,110,30,12,18
6,22,111,31,16,15
6,22,112,26,12,14
6,22,113,21,8,13
6,22,114,11,11,0
6,22,115,8,6,2
6,22,116,10,13,-3
6,22,117,18,8,10
6,22,118,8,16,-8
6,22,119,28,12,16
6,22,120,22,14,8
6,22,121,4,3,1
6,22,122,19,11,8
6,22,123,28,9,19
6,22,124,19,11,8
6,22,125,18,6,12
6,22,126,29,18,11
6,22,127,25,5,20
6,22,128,15,7,8
6,22,129,31,16,15
6,22,130,25,16,9
6,22,131,20,6,14
6,22,132,21,9,12
6,22,133,15,14,1
6,22,134,14,8,6
6,22,135,27,10,17
6,22,136,17,7,10
6,22,137,11,12,-1
6,22,138,16,11,5
6,22,139,34,14,20
6,22,140,21,10,11
6,22,141,21,20,1
6,22,142,20,12,8
6,22,143,23,17,6
6,22,144,11,13,-2
6,22,145,29,8,21
6,22,146,21,14,7
6,22,147,23,11,12
6,22,148,18,12,6
6,22,149,15,9,6
6,22,150,18,13,5
6,22,151,15,11,4
6,22,152,23,15,8
6,22,153,12,9,3
6,22,154,33,9,24
6,22,155,21,23,-2
6,22,156,9,13,-4
6,22,157,20,20,0
6,22,158,19,9,10
6,22,159,14,4,10
6,22,160,14,10,4
6,22,161,16,17,-1
6,22,162,27,19,8
6,22,163,14,11,3
6,22,164,15,22,-7
6,22,165,3,3,0
6,22,166,10,8,2
6,22,167,19,20,-1
6,22,168,23,12,11
6,22,169,14,10,4
6,22,170,36,18,18
6,22,171,9,5,4
6,22,172,36,9,27
6,22,173,23,12,11
6,22,174,35,11,24
6,22,175,28,9,19
6,22,176,9,6,3
6,22,177,20,13,7
6,22,178,15,19,-4
6,22,179,17,13,4
6,22,180,21,16,5
6,22,181,15,30,-15
6,22,182,24,8,16
6,22,183,33,18,15
6,22,184,25,9,16
6,22,185,23,12,11
6,22,186,16,24,-8
6,22,187,25,16,9
6,22,188,23,12,11
6,22,189,15,11,4
6,22,190,7,8,-1
6,22,191,16,2,14
6,22,192,8,2,6
6,22,193,20,6,14
6,22,194,18,17,1
6,22,195,8,1,7
6,22,196,6,12,-6
6,22,197,17,12,5
6,22,198,27,14,13
6,22,199,26,13,13
6,22,200,16,15,1
6,22,201,33,20,13
6,22,202,9,5,4
6,22,203,16,11,5
6,22,204,36,19,17
6,22,205,18,4,14
6,22,206,24,12,12
6,22,207,16,13,3
6,22,208,24,16,8
6,22,209,15,7,8
6,22,210,14,6,8
6,22,211,14,8,6
6,22,212,12,7,5
6,22,213,23,3,20
6,22,214,27,8,19
6,22,215,20,16,4
6,22,216,18,10,8
6,22,217,22,9,13
6,22,218,12,7,5
6,22,219,6,12,-6
6,22,220,21,22,-1
6,22,221,17,9,8
6,22,222,13,6,7
6,22,223,28,20,8
6,22,224,11,10,1
6,22,225,9,21,-12
6,22,226,9,7,2
6,22,227,31,18,13
6,22,228,11,13,-2
6,22,229,13,7,6
6,22,230,10,17,-7
6,22,231,13,21,-8
6,22,232,14,9,5
6,22,233,8,15,-7
6,22,234,22,12,10
6,22,235,17,19,-2
6,22,236,20,14,6
6,22,237,23,10,13
6,22,238,20,30,-10
6,22,239,16,13,3
6,22,240,18,15,3
6,22,241,38,17,21
6,22,242,38,20,18
6,22,243,9,5,4
6,22,244,15,12,3
6,22,245,25,6,19
6,22,246,31,17,14
6,22,247,34,10,24
6,22,248,9,11,-2
6,22,249,18,19,-1
6,22,250,18,6,12
6,22,251,14,13,1
6,22,252,16,9,7
6,22,253,5,9,-4
6,22,254,27,17,10
6,22,255,25,10,15
6,22,256,30,19,11
6,22,257,27,7,20
6,22,258,25,14,11
6,22,259,16,15,1
6,22,260,18,9,9
6,22,261,13,8,5
6,22,262,35,17,18
6,22,263,11,4,7
6,22,264,25,25,0
6,22,265,34,22,12
6,22,266,15,10,5
6,22,267,34,10,24
6,22,268,19,16,3
6,22,269,12,11,1
6,22,270,27,10,17
6,22,271,28,8,20
6,22,272,24,21,3
6,22,273,12,13,-1
6,22,274,22,6,16
6,22,275,10,7,3
6,22,276,19,9,10
6,22,277,6,5,1
6,22,278,20,10,10
6,22,279,7,8,-1
6,22,280,18,16,2
6,22,281,11,10,1
6,22,282,21,4,17
6,22,283,25,13,12
6,22,284,12,5,7
6,22,285,19,10,9
6,22,286,19,11,8
6,22,287,15,6,9
6,22,288,15,15,0
6,22,289,7,8,-1
6,22,290,19,8,11
6,22,291,10,8,2
6,22,292,15,10,5
6,22,293,27,12,15
6,22,294,29,11,18
6,22,295,27,12,15
6,22,296,17,8,9
6,22,297,23,4,19
6,22,298,17,13,4
6,22,299,14,8,6
6,23,0,25,9,16
6,23,1,13,12,1
6,23,2,23,9,14
6,23,3,21,10,11
6,23,4,17,3,14
6,23,5,17,12,5
6,23,6,29,12,17
6,23,7,15,15,0
6,23,8,19,9,10
6,23,9,19,10,9
6,23,10,12,8,4
6,23,11,16,20,-4
6,23,12,26,11,15
6,23,13,10,17,-7
6,23,14,18,3,15
6,23,15,18,22,-4
6,23,16,13,18,-5
6,23,17,12,10,2
6,23,18,23,12,11
6,23,19,36,14,22
6,23,20,19,10,9
6,23,21,14,8,6
6,23,22,22,6,16
6,23,23,31,12,19
6,23,24,21,10,11
6,23,25,15,27,-12
6,23,26,13,8,5
6,23,27,22,8,14
6,23,28,14,19,-5
6,23,29,18,14,4
6,23,30,14,11,3
6,23,31,20,9,11
6,23,32,27,15,12
6,23,33,13,6,7
6,23,34,16,16,0
6,23,35,7,20,-13
6,23,36,24,2,22
6,23,37,9,12,-3
6,23,38,13,16,-3
6,23,39,8,8,0
6,23,40,22,12,10
6,23,41,14,5,9
6,23,42,31,17,14
6,23,43,11,4,7
6,23,44,20,7,13
6,23,45,7,3,4
6,23,46,17,8,9
6,23,47,21,8,13
6,23,48,17,11,6
6,23,49,24,9,15
6,23,50,23,9,14
6,23,51,12,10,2
6,23,52,31,19,12
6,23,53,25,14,11
6,23,54,25,16,9
6,23,55,18,12,6
6,23,56,16,8,8
6,23,57,10,8,2
6,23,58,31,13,18
6,23,59,24,13,11
6,23,60,11,11,0
6,23,61,23,8,15
6,23,62,11,13,-2
6,23,63,18,10,8
6,23,64,30,16,14
6,23,65,17,11,6
6,23,66,11,9,2
6,23,67,17,14,3
6,23,68,30,12,18
6,23,69,28,17,11
6,23,70,18,8,10
6,23,71,12,8,4
6,23,72,26,11,15
6,23,73,30,11,19
6,23,74,22,8,14
6,23,75,24,9,15
6,23,76,9,12,-3
6,23,77,22,11,11
6,23,78,10,4,6
6,23,79,13,14,-1
6,23,80,32,17,15
6,23,81,11,12,-1
6,23,82,24,13,11
6,23,83,12,12,0
6,23,84,13,12,1
6,23,85,9,7,2
6,23,86,17,5,12
6,23,87,14,9,5
6,23,88,18,22,-4
6,23,89,15,4,11
6,23,90,28,14,14
6,23,91,19,13,6
6,23,92,18,11,7
6,23,93,35,7,28
6,23,94,28,14,14
6,23,95,26,6,20
6,23,96,21,7,14
6,23,97,10,9,1
6,23,98,21,12,9
6,23,99,19,14,5
6,23,100,11,8,3
6,23,101,32,7,25
6,23,102,10,10,0
6,23,103,24,7,17
6,23,104,17,10,7
6,23,105,23,21,2
6,23,106,7,15,-8
6,23,107,15,6,9
6,23,108,20,8,12
6,23,109,27,22,5
6,23,110,17,9,8
6,23,111,15,9,6
6,23,112,15,7,8
6,23,113,21,8,13
6,23,114,24,8,16
6,23,115,9,16,-7
6,23,116,19,11,8
6,23,117,23,18,5
6,23,118,16,10,6
6,23,119,19,15,4
6,23,120,23,21,2
6,23,121,23,13,10
6,23,122,27,11,16
6,23,123,15,7,8
6,23,124,14,15,-1
6,23,125,24,14,10
6,23,126,10,8,2
6,23,127,31,20,11
6,23,128,18,12,6
6,23,129,15,10,5
6,23,130,36,10,26
6,23,131,13,10,3
6,23,132,18,17,1
6,23,133,8,14,-6
6,23,134,17,9,8
6,23,135,16,21,-5
6,23,136,19,7,12
6,23,137,13,9,4
6,23,138,12,9,3
6,23,139,7,3,4
6,23,140,26,10,16
6,23,141,22,16,6
6,23,142,24,10,14
6,23,143,19,9,10
6,23,144,17,10,7
6,23,145,13,10,3
6,23,146,32,10,22
6,23,147,15,9,6
6,23,148,9,15,-6
6,23,149,24,14,10
6,23,150,12,13,-1
6,23,151,7,7,0
6,23,152,11,2,9
6,23,153,25,6,19
6,23,154,23,7,16
6,23,155,21,9,12
6,23,156,22,10,12
6,23,157,21,13,8
6,23,158,22,10,12
6,23,159,17,6,11
6,23,160,8,6,2
6,23,161,25,18,7
6,23,162,16,7,9
6,23,163,8,13,-5
6,23,164,16,9,7
6,23,165,14,19,-5
6,23,166,20,6,14
6,23,167,8,13,-5
6,23,168,11,3,8
6,23,169,16,6,10
6,23,170,24,14,10
6,23,171,14,11,3
6,23,172,20,9,11
6,23,173,25,16,9
6,23,174,24,1,23
6,23,175,23,21,2
6,23,176,12,6,6
6,23,177,16,4,12
6,23,178,28,19,9
6,23,179,16,12,4
6,23,180,18,5,13
6,23,181,13,3,10
6,23,182,24,6,18
6,23,183,14,13,1
6,23,184,33,11,22
6,23,185,9,11,-2
6,23,186,25,6,19
6,23,187,10,12,-2
6,23,188,19,10,9
6,23,189,19,11,8
6,23,190,15,13,2
6,23,191,8,9,-1
6,23,192,23,12,11
6,23,193,36,11,25
6,23,194,19,10,9
6,23,195,15,18,-3
6,23,196,15,23,-8
6,23,197,24,8,16
6,23,198,29,8,21
6,23,199,16,12,4
6,23,200,21,4,17
6,23,201,19,6,13
6,23,202,23,10,13
6,23,203,26,14,12
6,23,204,23,9,14
6,23,205,35,8,27
6,23,206,21,11,10
6,23,207,16,9,7
6,23,208,18,4,14
6,23,209,15,11,4
6,23,210,17,25,-8
6,23,211,19,11,8
6,23,212,16,6,10
6,23,213,13,10,3
6,23,214,16,2,14
6,23,215,20,14,6
6,23,216,7,8,-1
6,23,217,27,18,9
6,23,218,28,8,20
6,23,219,16,9,7
6,23,220,21,17,4
6,23,221,41,13,28
6,23,222,20,12,8
6,23,223,14,8,6
6,23,224,20,17,3
6,23,225,32,6,26
6,23,226,23,13,10
6,23,227,31,6,25
6,23,228,29,12,17
6,23,229,22,7,15
6,23,230,15,9,6
6,23,231,17,7,10
6,23,232,24,11,13
6,23,233,26,8,18
6,23,234,34,15,19
6,23,235,17,13,4
6,23,236,19,8,11
6,23,237,12,12,0
6,23,238,32,4,28
6,23,239,32,15,17
6,23,240,15,7,8
6,23,241,13,7,6
6,23,242,9,14,-5
6,23,243,19,24,-5
6,23,244,5,8,-3
6,23,245,25,14,11
6,23,246,33,17,16
6,23,247,13,6,7
6,23,248,13,7,6
6,23,249,29,14,15
6,23,250,18,14,4
6,23,251,24,4,20
6,23,252,18,15,3
6,23,253,23,18,5
6,23,254,15,7,8
6,23,255,31,18,13
6,23,256,15,10,5
6,23,257,13,6,7
6,23,258,11,9,2
6,23,259,15,7,8
6,23,260,40,16,24
6,23,261,16,8,8
6,23,262,22,13,9
6,23,263,17,9,8
6,23,264,14,12,2
6,23,265,6,3,3
6,23,266,20,11,9
6,23,267,37,15,22
6,23,268,20,12,8
6,23,269,32,1,31
6,23,270,21,12,9
6,23,271,9,13,-4
6,23,272,16,17,-1
6,23,273,28,5,23
6,23,274,26,7,19
6,23,275,14,13,1
6,23,276,29,10,19
6,23,277,18,16,2
6,23,278,17,6,11
6,23,279,20,12,8
6,23,280,17,6,11
6,23,281,25,9,16
6,23,282,24,8,16
6,23,283,16,7,9
6,23,284,15,5,10
6,23,285,17,14,3
6,23,286,12,8,4
6,23,287,23,11,12
6,23,288,20,12,8
6,23,289,22,13,9
6,23,290,23,19,4
6,23,291,24,4,20
6,23,292,19,0,19
6,23,293,14,16,-2
6,23,294,26,4,22
6,23,295,37,9,28
6,23,296,21,9,12
6,23,297,17,8,9
6,23,298,7,2,5
6,23,299,23,8,15
6,24,0,16,9,7
6,24,1,27,9,18
6,24,2,18,9,9
6,24,3,18,4,14
6,24,4,10,9,1
6,24,5,25,14,11
6,24,6,14,3,11
6,24,7,31,17,14
6,24,8,22,6,16
6,24,9,24,17,7
6,24,10,29,8,21
6,24,11,15,8,7
6,24,12,18,4,14
6,24,13,20,16,4
6,24,14,14,6,8
6,24,15,20,18,2
6,24,16,17,18,-1
6,24,17,30,18,12
6,24,18,16,10,6
6,24,19,39,25,14
6,24,20,20,4,16
6,24,21,25,11,14
6,24,22,28,15,13
6,24,23,11,10,1
6,24,24,13,11,2
6,24,25,29,12,17
6,24,26,19,9,10
6,24,27,26,15,11
6,24,28,34,18,16
6,24,29,16,16,0
6,24,30,6,3,3
6,24,31,18,16,2
6,24,32,9,5,4
6,24,33,9,16,-7
6,24,34,14,8,6
6,24,35,2,4,-2
6,24,36,20,8,12
6,24,37,28,6,22
6,24,38,15,6,9
6,24,39,27,10,17
6,24,40,30,15,15
6,24,41,22,21,1
6,24,42,17,5,12
6,24,43,16,15,1
6,24,44,17,13,4
6,24,45,25,8,17
6,24,46,32,14,18
6,24,47,20,10,10
6,24,48,32,5,27
6,24,49,25,10,15
6,24,50,32,13,19
6,24,51,13,14,-1
6,24,52,17,11,6
6,24,53,43,22,21
6,24,54,24,12,12
6,24,55,24,23,1
6,24,56,27,13,14
6,24,57,23,12,11
6,24,58,10,9,1
6,24,59,28,13,15
6,24,60,11,9,2
6,24,61,38,22,16
6,24,62,28,13,15
6,24,63,27,7,20
6,24,64,18,15,3
6,24,65,25,12,13
6,24,66,10,15,-5
6,24,67,23,11,12
6,24,68,24,16,8
6,24,69,25,12,13
6,24,70,18,7,11
6,24,71,21,12,9
6,24,72,12,16,-4
6,24,73,16,14,2
6,24,74,22,9,13
6,24,75,18,14,4
6,24,76,24,13,11
6,24,77,35,9,26
6,24,78,26,12,14
6,24,79,15,17,-2
6,24,80,15,3,12
6,24,81,35,16,19
6,24,82,32,13,19
6,24,83,13,14,-1
6,24,84,24,11,13
6,24,85,30,12,18
6,24,86,5,7,-2
6,24,87,38,21,17
6,24,88,17,10,7
6,24,89,17,21,-4
6,24,90,18,16,2
6,24,91,34,15,19
6,24,92,30,12,18
6,24,93,12,12,0
6,24,94,10,3,7
6,24,95,32,15,17
6,24,96,17,12,5
6,24,97,22,8,14
6,24,98,22,5,17
6,24,99,20,22,-2
6,24,100,21,16,5
6,24,101,8,6,2
6,24,102,22,11,11
6,24,103,28,9,19
6,24,104,19,17,2
6,24,105,22,5,17
6,24,106,14,17,-3
6,24,107,13,6,7
6,24,108,7,12,-5
6,24,109,29,12,17
6,24,110,14,7,7
6,24,111,26,17,9
6,24,112,9,13,-4
6,24,113,18,9,9
6,24,114,21,9,12
6,24,115,18,8,10
6,24,116,23,22,1
6,24,117,25,15,10
6,24,118,33,5,28
6,24,119,33,16,17
6,24,120,11,10,1
6,24,121,13,7,6
6,24,122,22,7,15
6,24,123,16,7,9
6,24,124,40,17,23
6,24,125,11,7,4
6,24,126,15,5,10
6,24,127,24,14,10
6,24,128,18,8,10
6,24,129,21,10,11
6,24,130,23,5,18
6,24,131,24,15,9
6,24,132,7,6,1
6,24,133,23,11,12
6,24,134,10,4,6
6,24,135,15,16,-1
6,24,136,33,14,19
6,24,137,23,18,5
6,24,138,10,6,4
6,24,139,16,10,6
6,24,140,16,13,3
6,24,141,25,23,2
6,24,142,24,15,9
6,24,143,13,4,9
6,24,144,15,3,12
6,24,145,20,9,11
6,24,146,19,2,17
6,24,147,15,7,8
6,24,148,23,5,18
6,24,149,20,7,13
6,24,150,12,11,1
6,24,151,20,10,10
6,24,152,19,6,13
6,24,153,26,9,17
6,24,154,24,12,12
6,24,155,16,7,9
6,24,156,16,10,6
6,24,157,28,6,22
6,24,158,16,10,6
6,24,159,19,0,19
6,24,160,17,10,7
6,24,161,10,17,-7
6,24,162,51,12,39
6,24,163,6,4,2
6,24,164,21,12,9
6,24,165,14,5,9
6,24,166,18,7,11
6,24,167,13,5,8
6,24,168,13,6,7
6,24,169,22,18,4
6,24,170,13,6,7
6,24,171,10,5,5
6,24,172,29,14,15
6,24,173,16,18,-2
6,24,174,33,18,15
6,24,175,11,3,8
6,24,176,5,13,-8
6,24,177,13,6,7
6,24,178,8,9,-1
6,24,179,17,8,9
6,24,180,19,12,7
6,24,181,13,9,4
6,24,182,27,7,20
6,24,183,15,20,-5
6,24,184,20,18,2
6,24,185,13,7,6
6,24,186,17,9,8
6,24,187,20,13,7
6,24,188,30,25,5
6,24,189,22,16,6
6,24,190,27,18,9
6,24,191,16,17,-1
6,24,192,19,4,15
6,24,193,36,9,27
6,24,194,9,11,-2
6,24,195,13,6,7
6,24,196,19,15,4
6,24,197,17,13,4
6,24,198,26,18,8
6,24,199,17,4,13
6,24,200,16,17,-1
6,24,201,8,10,-2
6,24,202,31,13,18
6,24,203,28,8,20
6,24,204,9,12,-3
6,24,205,23,7,16
6,24,206,27,21,6
6,24,207,15,6,9
6,24,208,21,10,11
6,24,209,8,11,-3
6,24,210,21,8,13
6,24,211,24,11,13
6,24,212,17,14,3
6,24,213,17,15,2
6,24,214,25,17,8
6,24,215,16,17,-1
6,24,216,10,9,1
6,24,217,9,12,-3
6,24,218,38,16,22
6,24,219,21,8,13
6,24,220,27,22,5
6,24,221,18,19,-1
6,24,222,6,2,4
6,24,223,28,22,6
6,24,224,17,15,2
6,24,225,16,10,6
6,24,226,17,7,10
6,24,227,24,6,18
6,24,228,23,8,15
6,24,229,18,7,11
6,24,230,9,11,-2
6,24,231,20,6,14
6,24,232,22,11,11
6,24,233,17,12,5
6,24,234,18,10,8
6,24,235,23,3,20
6,24,236,35,19,16
6,24,237,19,28,-9
6,24,238,29,9,20
6,24,239,28,7,21
6,24,240,21,8,13
6,24,241,16,10,6
6,24,242,16,7,9
6,24,243,12,11,1
6,24,244,26,16,10
6,24,245,24,9,15
6,24,246,21,16,5
6,24,247,17,13,4
6,24,248,18,19,-1
6,24,249,22,13,9
6,24,250,22,3,19
6,24,251,29,15,14
6,24,252,13,8,5
6,24,253,24,9,15
6,24,254,16,15,1
6,24,255,25,6,19
6,24,256,32,14,18
6,24,257,13,18,-5
6,24,258,20,19,1
6,24,259,13,9,4
6,24,260,25,7,18
6,24,261,9,9,0
6,24,262,29,19,10
6,24,263,15,11,4
6,24,264,30,13,17
6,24,265,24,24,0
6,24,266,14,17,-3
6,24,267,11,14,-3
6,24,268,23,8,15
6,24,269,21,11,10
6,24,270,10,8,2
6,24,271,16,5,11
6,24,272,20,12,8
6,24,273,18,13,5
6,24,274,16,14,2
6,24,275,19,8,11
6,24,276,28,12,16
6,24,277,18,10,8
6,24,278,19,15,4
6,24,279,27,7,20
6,24,280,21,6,15
6,24,281,15,11,4
6,24,282,20,12,8
6,24,283,29,18,11
6,24,284,13,11,2
6,24,285,26,6,20
6,24,286,16,10,6
6,24,287,23,19,4
6,24,288,8,10,-2
6,24,289,20,8,12
6,24,290,3,3,0
6,24,291,27,21,6
6,24,292,28,10,18
6,24,293,24,18,6
6,24,294,23,9,14
6,24,295,21,13,8
6,24,296,17,11,6
6,24,297,27,16,11
6,24,298,23,22,1
6,24,299,19,11,8
6,25,0,18,9,9
6,25,1,30,11,19
6,25,2,32,15,17
6,25,3,14,11,3
6,25,4,12,11,1
6,25,5,19,20,-1
6,25,6,19,17,2
6,25,7,13,12,1
6,25,8,21,18,3
6,25,9,22,20,2
6,25,10,20,9,11
6,25,11,22,10,12
6,25,12,10,8,2
6,25,13,21,9,12
6,25,14,13,8,5
6,25,15,19,5,14
6,25,16,30,12,18
6,25,17,11,4,7
6,25,18,18,12,6
6,25,19,22,5,17
6,25,20,17,12,5
6,25,21,23,6,17
6,25,22,11,8,3
6,25,23,14,8,6
6,25,24,20,9,11
6,25,25,23,3,20
6,25,26,23,9,14
6,25,27,20,17,3
6,25,28,20,11,9
6,25,29,17,6,11
6,25,30,19,9,10
6,25,31,20,15,5
6,25,32,19,14,5
6,25,33,11,9,2
6,25,34,23,17,6
6,25,35,14,11,3
6,25,36,13,3,10
6,25,37,25,17,8
6,25,38,10,4,6
6,25,39,17,18,-1
6,25,40,32,10,22
6,25,41,16,9,7
6,25,42,6,6,0
6,25,43,19,6,13
6,25,44,23,13,10
6,25,45,28,23,5
6,25,46,25,12,13
6,25,47,24,17,7
6,25,48,19,18,1
6,25,49,16,11,5
6,25,50,19,5,14
6,25,51,21,11,10
6,25,52,27,16,11
6,25,53,25,13,12
6,25,54,16,9,7
6,25,55,20,15,5
6,25,56,29,15,14
6,25,57,22,8,14
6,25,58,12,10,2
6,25,59,28,7,21
6,25,60,15,8,7
6,25,61,27,10,17
6,25,62,22,20,2
6,25,63,13,7,6
6,25,64,12,11,1
6,25,65,15,8,7
6,25,66,13,10,3
6,25,67,17,9,8
6,25,68,12,16,-4
6,25,69,29,23,6
6,25,70,20,10,10
6,25,71,29,15,14
6,25,72,29,19,10
6,25,73,25,18,7
6,25,74,23,9,14
6,25,75,22,22,0
6,25,76,28,11,17
6,25,77,19,13,6
6,25,78,13,10,3
6,25,79,14,8,6
6,25,80,20,4,16
6,25,81,27,17,10
6,25,82,29,17,12
6,25,83,26,15,11
6,25,84,32,7,25
6,25,85,20,21,-1
6,25,86,16,18,-2
6,25,87,5,3,2
6,25,88,11,5,6
6,25,89,26,7,19
6,25,90,15,15,0
6,25,91,7,11,-4
6,25,92,9,7,2
6,25,93,10,14,-4
6,25,94,20,18,2
6,25,95,14,16,-2
6,25,96,15,8,7
6,25,97,27,10,17
6,25,98,14,9,5
6,25,99,26,12,14
6,25,100,11,6,5
6,25,101,34,11,23
6,25,102,20,5,15
6,25,103,18,13,5
6,25,104,15,10,5
6,25,105,19,13,6
6,25,106,23,11,12
6,25,107,21,5,16
6,25,108,14,16,-2
6,25,109,39,21,18
6,25,110,33,6,27
6,25,111,17,10,7
6,25,112,19,12,7
6,25,113,17,11,6
6,25,114,20,11,9
6,25,115,21,7,14
6,25,116,18,7,11
6,25,117,5,8,-3
6,25,118,16,6,10
6,25,119,10,5,5
6,25,120,19,21,-2
6,25,121,21,8,13
6,25,122,32,17,15
6,25,123,12,5,7
6,25,124,18,8,10
6,25,125,26,26,0
6,25,126,17,8,9
6,25,127,28,2,26
6,25,128,36,12,24
6,25,129,22,7,15
6,25,130,16,6,10
6,25,131,18,7,11
6,25,132,15,12,3
6,25,133,16,13,3
6,25,134,12,3,9
6,25,135,23,11,12
6,25,136,8,20,-12
6,25,137,30,10,20
6,25,138,10,3,7
6,25,139,22,6,16
6,25,140,26,14,12
6,25,141,26,10,16
6,25,142,27,11,16
6,25,143,27,7,20
6,25,144,13,6,7
6,25,145,14,4,10
6,25,146,19,16,3
6,25,147,17,11,6
6,25,148,27,7,20
6,25,149,11,6,5
6,25,150,24,5,19
6,25,151,11,4,7
6,25,152,26,13,13
6,25,153,19,14,5
6,25,154,13,13,0
6,25,155,25,12,13
6,25,156,19,12,7
6,25,157,21,14,7
6,25,158,22,14,8
6,25,159,12,5,7
6,25,160,18,15,3
6,25,161,25,12,13
6,25,162,16,15,1
6,25,163,22,12,10
6,25,164,17,18,-1
6,25,165,16,6,10
6,25,166,20,12,8
6,25,167,15,7,8
6,25,168,20,16,4
6,25,169,17,8,9
6,25,170,22,9,13
6,25,171,18,15,3
6,25,172,25,5,20
6,25,173,24,6,18
6,25,174,35,10,25
6,25,175,13,8,5
6,25,176,13,7,6
6,25,177,34,12,22
6,25,178,14,7,7
6,25,179,12,5,7
6,25,180,34,9,25
6,25,181,19,12,7
6,25,182,18,6,12
6,25,183,4,7,-3
6,25,184,18,14,4
6,25,185,19,16,3
6,25,186,18,20,-2
6,25,187,10,6,4
6,25,188,15,10,5
6,25,189,22,8,14
6,25,190,25,16,9
6,25,191,24,14,10
6,25,192,23,18,5
6,25,193,23,15,8
6,25,194,27,20,7
6,25,195,16,9,7
6,25,196,13,2,11
6,25,197,24,15,9
6,25,198,8,11,-3
6,25,199,15,12,3
6,25,200,26,13,13
6,25,201,21,14,7
6,25,202,28,13,15
6,25,203,32,15,17
6,25,204,12,10,2
6,25,205,18,12,6
6,25,206,19,10,9
6,25,207,20,4,16
6,25,208,18,17,1
6,25,209,19,16,3
6,25,210,13,9,4
6,25,211,23,11,12
6,25,212,12,14,-2
6,25,213,36,12,24
6,25,214,17,2,15
6,25,215,20,6,14
6,25,216,26,8,18
6,25,217,8,11,-3
6,25,218,8,11,-3
6,25,219,28,7,21
6,25,220,20,11,9
6,25,221,27,13,14
6,25,222,23,16,7
6,25,223,25,7,18
6,25,224,15,9,6
6,25,225,23,14,9
6,25,226,22,12,10
6,25,227,15,13,2
6,25,228,13,9,4
6,25,229,22,4,18
6,25,230,19,14,5
6,25,231,16,6,10
6,25,232,25,19,6
6,25,233,19,10,9
6,25,234,14,6,8
6,25,235,18,13,5
6,25,236,12,4,8
6,25,237,26,16,10
6,25,238,11,6,5
6,25,239,9,5,4
6,25,240,9,4,5
6,25,241,31,14,17
6,25,242,20,13,7
6,25,243,19,8,11
6,25,244,26,6,20
6,25,245,20,29,-9
6,25,246,10,7,3
6,25,247,9,1,8
6,25,248,35,13,22
6,25,249,16,10,6
6,25,250,22,11,11
6,25,251,18,7,11
6,25,252,14,11,3
6,25,253,19,19,0
6,25,254,28,14,14
6,25,255,19,4,15
6,25,256,12,12,0
6,25,257,17,10,7
6,25,258,36,14,22
6,25,259,20,19,1
6,25,260,11,5,6
6,25,261,13,6,7
6,25,262,10,17,-7
6,25,263,6,6,0
6,25,264,14,13,1
6,25,265,28,19,9
6,25,266,17,11,6
6,25,267,26,30,-4
6,25,268,13,13,0
6,25,269,7,8,-1
6,25,270,24,12,12
6,25,271,30,13,17
6,25,272,32,18,14
6,25,273,32,8,24
6,25,274,19,19,0
6,25,275,27,7,20
6,25,276,25,20,5
6,25,277,29,8,21
6,25,278,31,7,24
6,25,279,17,10,7
6,25,280,15,7,8
6,25,281,23,12,11
6,25,282,18,13,5
6,25,283,17,6,11
6,25,284,8,12,-4
6,25,285,35,13,22
6,25,286,20,18,2
6,25,287,18,9,9
6,25,288,17,13,4
6,25,289,27,10,17
6,25,290,25,10,15
6,25,291,20,17,3
6,25,292,16,7,9
6,25,293,17,10,7
6,25,294,21,7,14
6,25,295,16,12,4
6,25,296,22,21,1
6,25,297,26,7,19
6,25,298,16,7,9
6,25,299,24,11,13
6,26,0,23,12,11
6,26,1,13,16,-3
6,26,2,22,15,7
6,26,3,16,10,6
6,26,4,19,6,13
6,26,5,19,18,1
6,26,6,23,14,9
6,26,7,31,9,22
6,26,8,16,8,8
6,26,9,21,6,15
6,26,10,28,12,16
6,26,11,12,6,6
6,26,12,30,12,18
6,26,13,22,11,11
6,26,14,24,14,10
6,26,15,32,16,16
6,26,16,21,12,9
6,26,17,19,7,12
6,26,18,19,16,3
6,26,19,29,9,20
6,26,20,15,9,6
6,26,21,19,15,4
6,26,22,20,8,12
6,26,23,35,10,25
6,26,24,18,9,9
6,26,25,23,9,14
6,26,26,23,20,3
6,26,27,24,9,15
6,26,28,11,1,10
6,26,29,17,11,6
6,26,30,29,7,22
6,26,31,22,12,10
6,26,32,21,6,15
6,26,33,20,11,9
6,26,34,25,9,16
6,26,35,17,7,10
6,26,36,13,11,2
6,26,37,15,15,0
6,26,38,16,6,10
6,26,39,5,8,-3
6,26,40,9,12,-3
6,26,41,12,8,4
6,26,42,21,6,15
6,26,43,13,17,-4
6,26,44,8,8,0
6,26,45,17,15,2
6,26,46,27,11,16
6,26,47,14,3,11
6,26,48,30,8,22
6,26,49,14,6,8
6,26,50,16,10,6
6,26,51,19,15,4
6,26,52,9,11,-2
6,26,53,9,4,5
6,26,54,25,6,19
6,26,55,19,9,10
6,26,56,14,11,3
6,26,57,10,2,8
6,26,58,22,9,13
6,26,59,15,8,7
6,26,60,24,5,19
6,26,61,9,4,5
6,26,62,20,14,6
6,26,63,26,16,10
6,26,64,12,5,7
6,26,65,18,7,11
6,26,66,17,8,9
6,26,67,10,15,-5
6,26,68,24,6,18
6,26,69,28,1,27
6,26,70,23,15,8
6,26,71,15,7,8
6,26,72,20,10,10
6,26,73,23,17,6
6,26,74,24,8,16
6,26,75,13,8,5
6,26,76,19,6,13
6,26,77,19,24,-5
6,26,78,21,17,4
6,26,79,22,12,10
6,26,80,26,14,12
6,26,81,18,12,6
6,26,82,16,8,8
6,26,83,28,14,14
6,26,84,23,18,5
6,26,85,16,24,-8
6,26,86,14,14,0
6,26,87,29,14,15
6,26,88,19,13,6
6,26,89,15,6,9
6,26,90,18,8,10
6,26,91,14,14,0
6,26,92,18,0,18
6,26,93,15,23,-8
6,26,94,5,4,1
6,26,95,22,6,16
6,26,96,20,15,5
6,26,97,13,16,-3
6,26,98,12,9,3
6,26,99,18,6,12
6,26,100,12,8,4
6,26,101,21,9,12
6,26,102,8,8,0
6,26,103,19,10,9
6,26,104,20,5,15
6,26,105,14,15,-1
6,26,106,15,14,1
6,26,107,10,7,3
6,26,108,36,15,21
6,26,109,15,4,11
6,26,110,22,25,-3
6,26,111,21,16,5
6,26,112,22,8,14
6,26,113,19,6,13
6,26,114,14,13,1
6,26,115,16,8,8
6,26,116,19,7,12
6,26,117,14,13,1
6,26,118,12,1,11
6,26,119,12,13,-1
6,26,120,21,19,2
6,26,121,16,7,9
6,26,122,13,14,-1
6,26,123,26,11,15
6,26,124,31,12,19
6,26,125,27,16,11
6,26,126,14,21,-7
6,26,127,6,6,0
6,26,128,22,8,14
6,26,129,14,7,7
6,26,130,12,5,7
6,26,131,26,17,9
6,26,132,24,12,12
6,26,133,17,12,5
6,26,134,19,16,3
6,26,135,18,11,7
6,26,136,10,3,7
6,26,137,22,9,13
6,26,138,20,12,8
6,26,139,31,14,17
6,26,140,25,9,16
6,26,141,21,19,2
6,26,142,31,17,14
6,26,143,13,8,5
6,26,144,25,18,7
6,26,145,12,8,4
6,26,146,22,9,13
6,26,147,21,10,11
6,26,148,16,10,6
6,26,149,21,12,9
6,26,150,15,7,8
6,26,151,24,5,19
6,26,152,20,10,10
6,26,153,14,11,3
6,26,154,39,12,27
6,26,155,11,14,-3
6,26,156,18,8,10
6,26,157,33,12,21
6,26,158,15,12,3
6,26,159,9,4,5
6,26,160,2,3,-1
6,26,161,17,8,9
6,26,162,19,3,16
6,26,163,25,21,4
6,26,164,11,8,3
6,26,165,3,10,-7
6,26,166,20,17,3
6,26,167,15,3,12
6,26,168,18,11,7
6,26,169,9,6,3
6,26,170,22,9,13
6,26,171,28,11,17
6,26,172,29,15,14
6,26,173,39,13,26
6,26,174,14,11,3
6,26,175,12,13,-1
6,26,176,33,21,12
6,26,177,17,17,0
6,26,178,29,8,21
6,26,179,24,13,11
6,26,180,11,10,1
6,26,181,18,8,10
6,26,182,24,8,16
6,26,183,25,8,17
6,26,184,23,4,19
6,26,185,15,5,10
6,26,186,16,4,12
6,26,187,15,8,7
6,26,188,21,7,14
6,26,189,24,12,12
6,26,190,19,20,-1
6,26,191,29,11,18
6,26,192,9,11,-2
6,26,193,22,7,15
6,26,194,33,16,17
6,26,195,15,8,7
6,26,196,23,16,7
6,26,197,27,9,18
6,26,198,24,9,15
6,26,199,25,9,16
6,26,200,9,10,-1
6,26,201,18,11,7
6,26,202,29,7,22
6,26,203,18,7,11
6,26,204,9,6,3
6,26,205,19,10,9
6,26,206,23,11,12
6,26,207,22,16,6
6,26,208,19,9,10
6,26,209,17,8,9
6,26,210,19,12,7
6,26,211,13,4,9
6,26,212,22,7,15
6,26,213,17,24,-7
6,26,214,38,8,30
6,26,215,23,14,9
6,26,216,23,11,12
6,26,217,35,22,13
6,26,218,26,22,4
6,26,219,29,21,8
6,26,220,4,1,3
6,26,221,27,9,18
6,26,222,16,6,10
6,26,223,8,7,1
6,26,224,22,4,18
6,26,225,15,7,8
6,26,226,18,13,5
6,26,227,14,17,-3
6,26,228,24,7,17
6,26,229,9,4,5
6,26,230,28,17,11
6,26,231,13,2,11
6,26,232,13,5,8
6,26,233,11,8,3
6,26,234,26,12,14
6,26,235,17,8,9
6,26,236,22,18,4
6,26,237,25,19,6
6,26,238,32,11,21
6,26,239,32,9,23
6,26,240,12,8,4
6,26,241,16,4,12
6,26,242,13,12,1
6,26,243,16,10,6
6,26,244,21,9,12
6,26,245,23,12,11
6,26,246,24,15,9
6,26,247,18,10,8
6,26,248,17,10,7
6,26,249,14,3,11
6,26,250,23,10,13
6,26,251,24,8,16
6,26,252,14,13,1
6,26,253,8,10,-2
6,26,254,15,8,7
6,26,255,36,10,26
6,26,256,8,5,3
6,26,257,18,13,5
6,26,258,22,23,-1
6,26,259,49,10,39
6,26,260,19,10,9
6,26,261,15,7,8
6,26,262,31,11,20
6,26,263,27,10,17
6,26,264,17,12,5
6,26,265,26,8,18
6,26,266,8,6,2
6,26,267,28,16,12
6,26,268,16,2,14
6,26,269,9,13,-4
6,26,270,20,6,14
6,26,271,31,11,20
6,26,272,14,13,1
6,26,273,27,8,19
6,26,274,9,6,3
6,26,275,24,9,15
6,26,276,36,6,30
6,26,277,28,18,10
6,26,278,12,7,5
6,26,279,27,11,16
6,26,280,13,7,6
6,26,281,16,16,0
6,26,282,15,8,7
6,26,283,10,18,-8
6,26,284,27,18,9
6,26,285,16,13,3
6,26,286,24,2,22
6,26,287,18,13,5
6,26,288,16,12,4
6,26,289,41,13,28
6,26,290,21,11,10
6,26,291,18,12,6
6,26,292,26,10,16
6,26,293,18,28,-10
6,26,294,10,5,5
6,26,295,17,11,6
6,26,296,13,3,10
6,26,297,15,9,6
6,26,298,8,14,-6
6,26,299,23,14,9
6,27,0,14,9,5
6,27,1,16,12,4
6,27,2,18,5,13
6,27,3,22,5,17
6,27,4,11,8,3
6,27,5,18,10,8
6,27,6,19,10,9
6,27,7,19,9,10
6,27,8,6,6,0
6,27,9,16,10,6
6,27,10,17,7,10
6,27,11,28,11,17
6,27,12,20,6,14
6,27,13,8,7,1
6,27,14,19,11,8
6,27,15,19,5,14
6,27,16,11,13,-2
6,27,17,36,9,27
6,27,18,12,5,7
6,27,19,22,11,11
6,27,20,17,8,9
6,27,21,14,15,-1
6,27,22,25,16,9
6,27,23,14,14,0
6,27,24,29,15,14
6,27,25,26,8,18
6,27,26,34,11,23
6,27,27,15,7,8
6,27,28,18,20,-2
6,27,29,18,13,5
6,27,30,22,7,15
6,27,31,9,4,5
6,27,32,28,11,17
6,27,33,27,12,15
6,27,34,24,8,16
6,27,35,25,10,15
6,27,36,18,12,6
6,27,37,34,10,24
6,27,38,23,11,12
6,27,39,18,13,5
6,27,40,24,14,10
6,27,41,20,5,15
6,27,42,20,10,10
6,27,43,32,15,17
6,27,44,43,10,33
6,27,45,18,4,14
6,27,46,12,9,3
6,27,47,11,7,4
6,27,48,17,6,11
6,27,49,23,14,9
6,27,50,14,4,10
6,27,51,10,11,-1
6,27,52,13,13,0
6,27,53,19,10,9
6,27,54,16,11,5
6,27,55,17,3,14
6,27,56,16,2,14
6,27,57,16,10,6
6,27,58,17,11,6
6,27,59,14,3,11
6,27,60,15,17,-2
6,27,61,13,14,-1
6,27,62,6,12,-6
6,27,63,19,16,3
6,27,64,17,2,15
6,27,65,20,5,15
6,27,66,29,10,19
6,27,67,21,17,4
6,27,68,8,5,3
6,27,69,22,18,4
6,27,70,22,10,12
6,27,71,17,22,-5
6,27,72,27,14,13
6,27,73,15,12,3
6,27,74,24,12,12
6,27,75,24,13,11
6,27,76,28,10,18
6,27,77,25,7,18
6,27,78,15,11,4
6,27,79,17,7,10
6,27,80,24,9,15
6,27,81,22,8,14
6,27,82,14,12,2
6,27,83,14,12,2
6,27,84,21,4,17
6,27,85,31,11,20
6,27,86,13,5,8
6,27,87,12,6,6
6,27,88,16,8,8
6,27,89,13,9,4
6,27,90,22,13,9
6,27,91,12,7,5
6,27,92,8,5,3
6,27,93,22,10,12
6,27,94,20,6,14
6,27,95,22,12,10
6,27,96,27,9,18
6,27,97,28,12,16
6,27,98,17,9,8
6,27,99,30,16,14
6,27,100,24,16,8
6,27,101,20,9,11
6,27,102,28,12,16
6,27,103,13,5,8
6,27,104,12,9,3
6,27,105,19,13,6
6,27,106,29,15,14
6,27,107,1,2,-1
6,27,108,15,12,3
6,27,109,37,11,26
6,27,110,15,11,4
6,27,111,35,10,25
6,27,112,24,8,16
6,27,113,24,21,3
6,27,114,17,8,9
6,27,115,22,5,17
6,27,116,19,18,1
6,27,117,19,10,9
6,27,118,14,13,1
6,27,119,19,18,1
6,27,120,18,12,6
6,27,121,25,12,13
6,27,122,23,11,12
6,27,123,23,8,15
6,27,124,39,16,23
6,27,125,19,14,5
6,27,126,10,9,1
6,27,127,21,14,7
6,27,128,24,6,18
6,27,129,8,8,0
6,27,130,30,16,14
6,27,131,11,14,-3
6,27,132,6,3,3
6,27,133,24,14,10
6,27,134,18,10,8
6,27,135,18,10,8
6,27,136,17,1,16
6,27,137,8,3,5
6,27,138,20,17,3
6,27,139,23,20,3
6,27,140,16,16,0
6,27,141,17,26,-9
6,27,142,13,15,-2
6,27,143,18,11,7
6,27,144,9,11,-2
6,27,145,17,2,15
6,27,146,29,18,11
6,27,147,20,25,-5
6,27,148,25,10,15
6,27,149,11,9,2
6,27,150,9,4,5
6,27,151,19,17,2
6,27,152,15,16,-1
6,27,153,18,16,2
6,27,154,22,9,13
6,27,155,11,3,8
6,27,156,26,17,9
6,27,157,22,10,12
6,27,158,19,9,10
6,27,159,21,16,5
6,27,160,24,7,17
6,27,161,18,11,7
6,27,162,25,7,18
6,27,163,17,9,8
6,27,164,22,13,9
6,27,165,14,12,2
6,27,166,14,3,11
6,27,167,20,9,11
6,27,168,24,15,9
6,27,169,19,14,5
6,27,170,16,17,-1
6,27,171,14,10,4
6,27,172,19,8,11
6,27,173,29,19,10
6,27,174,13,12,1
6,27,175,16,12,4
6,27,176,16,13,3
6,27,177,24,14,10
6,27,178,31,4,27
6,27,179,24,16,8
6,27,180,10,13,-3
6,27,181,29,9,20
6,27,182,24,10,14
6,27,183,11,9,2
6,27,184,8,9,-1
6,27,185,21,12,9
6,27,186,21,7,14
6,27,187,15,16,-1
6,27,188,16,14,2
6,27,189,36,12,24
6,27,190,11,7,4
6,27,191,24,8,16
6,27,192,25,3,22
6,27,193,32,14,18
6,27,194,34,18,16
6,27,195,17,13,4
6,27,196,27,6,21
6,27,197,16,7,9
6,27,198,9,8,1
6,27,199,27,14,13
6,27,200,20,11,9
6,27,201,11,15,-4
6,27,202,28,33,-5
6,27,203,16,9,7
6,27,204,22,8,14
6,27,205,21,13,8
6,27,206,16,9,7
6,27,207,6,6,0
6,27,208,11,6,5
6,27,209,22,15,7
6,27,210,20,9,11
6,27,211,20,12,8
6,27,212,13,13,0
6,27,213,21,9,12
6,27,214,19,10,9
6,27,215,6,10,-4
6,27,216,21,14,7
6,27,217,20,12,8
6,27,218,18,14,4
6,27,219,17,8,9
6,27,220,21,17,4
6,27,221,12,8,4
6,27,222,20,6,14
6,27,223,21,8,13
6,27,224,23,8,15
6,27,225,14,9,5
6,27,226,23,6,17
6,27,227,17,12,5
6,27,228,23,8,15
6,27,229,38,11,27
6,27,230,11,11,0
6,27,231,16,9,7
6,27,232,19,14,5
6,27,233,25,8,17
6,27,234,22,16,6
6,27,235,18,11,7
6,27,236,24,16,8
6,27,237,29,5,24
6,27,238,12,7,5
6,27,239,20,8,12
6,27,240,34,14,20
6,27,241,20,6,14
6,27,242,30,17,13
6,27,243,21,10,11
6,27,244,31,8,23
6,27,245,15,8,7
6,27,246,13,4,9
6,27,247,12,6,6
6,27,248,15,15,0
6,27,249,26,14,12
6,27,250,11,3,8
6,27,251,7,7,0
6,27,252,12,5,7
6,27,253,19,11,8
6,27,254,22,4,18
6,27,255,20,11,9
6,27,256,18,8,10
6,27,257,28,15,13
6,27,258,36,15,21
6,27,259,5,8,-3
6,27,260,8,9,-1
6,27,261,15,17,-2
6,27,262,23,3,20
6,27,263,16,12,4
6,27,264,13,12,1
6,27,265,18,8,10
6,27,266,13,2,11
6,27,267,11,8,3
6,27,268,14,10,4
6,27,269,18,9,9
6,27,270,13,4,9
6,27,271,15,10,5
6,27,272,15,18,-3
6,27,273,15,9,6
6,27,274,11,5,6
6,27,275,22,11,11
6,27,276,18,9,9
6,27,277,20,13,7
6,27,278,10,5,5
6,27,279,23,13,10
6,27,280,9,6,3
6,27,281,28,10,18
6,27,282,21,12,9
6,27,283,21,10,11
6,27,284,15,10,5
6,27,285,26,9,17
6,27,286,3,5,-2
6,27,287,27,12,15
6,27,288,26,17,9
6,27,289,2,1,1
6,27,290,13,5,8
6,27,291,26,6,20
6,27,292,7,13,-6
6,27,293,21,16,5
6,27,294,19,7,12
6,27,295,28,8,20
6,27,296,29,9,20
6,27,297,20,22,-2
6,27,298,8,6,2
6,27,299,29,8,21
6,28,0,12,7,5
6,28,1,28,16,12
6,28,2,8,6,2
6,28,3,29,1,28
6,28,4,13,12,1
6,28,5,27,8,19
6,28,6,16,13,3
6,28,7,28,5,23
6,28,8,9,3,6
6,28,9,24,13,11
6,28,10,23,9,14
6,28,11,23,12,11
6,28,12,27,12,15
6,28,13,12,3,9
6,28,14,14,8,6
6,28,15,29,13,16
6,28,16,19,7,12
6,28,17,18,11,7
6,28,18,14,9,5
6,28,19,23,13,10
6,28,20,9,13,-4
6,28,21,31,12,19
6,28,22,22,14,8
6,28,23,32,13,19
6,28,24,18,7,11
6,28,25,39,6,33
6,28,26,10,1,9
6,28,27,19,9,10
6,28,28,21,17,4
6,28,29,28,6,22
6,28,30,41,16,25
6,28,31,20,13,7
6,28,32,21,12,9
6,28,33,13,6,7
6,28,34,25,11,14
6,28,35,18,12,6
6,28,36,18,8,10
6,28,37,15,9,6
6,28,38,16,4,12
6,28,39,17,16,1
6,28,40,10,12,-2
6,28,41,25,19,6
6,28,42,29,12,17
6,28,43,17,19,-2
6,28,44,25,17,8
6,28,45,12,7,5
6,28,46,20,5,15
6,28,47,10,7,3
6,28,48,17,10,7
6,28,49,22,7,15
6,28,50,18,6,12
6,28,51,15,7,8
6,28,52,19,8,11
6,28,53,23,7,16
6,28,54,9,4,5
6,28,55,15,15,0
6,28,56,11,4,7
6,28,57,28,7,21
6,28,58,13,16,-3
6,28,59,24,12,12
6,28,60,12,4,8
6,28,61,11,4,7
6,28,62,19,9,10
6,28,63,27,16,11
6,28,64,29,14,15
6,28,65,16,10,6
6,28,66,31,12,19
6,28,67,12,16,-4
6,28,68,29,6,23
6,28,69,26,6,20
6,28,70,19,11,8
6,28,71,17,11,6
6,28,72,18,16,2
6,28,73,23,15,8
6,28,74,33,15,18
6,28,75,28,9,19
6,28,76,34,7,27
6,28,77,21,15,6
6,28,78,20,16,4
6,28,79,47,19,28
6,28,80,29,11,18
6,28,81,5,16,-11
6,28,82,22,6,16
6,28,83,28,17,11
6,28,84,15,3,12
6,28,85,17,4,13
6,28,86,19,7,12
6,28,87,30,20,10
6,28,88,18,9,9
6,28,89,35,5,30
6,28,90,18,11,7
6,28,91,23,10,13
6,28,92,23,10,13
6,28,93,15,8,7
6,28,94,17,7,10
6,28,95,14,3,11
6,28,96,16,4,12
6,28,97,22,8,14
6,28,98,12,9,3
6,28,99,20,2,18
6,28,100,25,10,15
6,28,101,22,8,14
6,28,102,19,10,9
6,28,103,44,6,38
6,28,104,29,7,22
6,28,105,18,10,8
6,28,106,9,8,1
6,28,107,29,9,20
6,28,108,15,11,4
6,28,109,24,7,17
6,28,110,18,5,13
6,28,111,9,7,2
6,28,112,21,10,11
6,28,113,14,4,10
6,28,114,21,7,14
6,28,115,29,7,22
6,28,116,29,9,20
6,28,117,22,4,18
6,28,118,18,15,3
6,28,119,15,12,3
6,28,120,25,8,17
6,28,121,21,10,11
6,28,122,17,11,6
6,28,123,24,12,12
6,28,124,23,11,12
6,28,125,27,9,18
6,28,126,33,8,25
6,28,127,5,7,-2
6,28,128,21,11,10
6,28,129,26,19,7
6,28,130,23,7,16
6,28,131,8,10,-2
6,28,132,20,7,13
6,28,133,20,11,9
6,28,134,14,11,3
6,28,135,25,12,13
6,28,136,3,4,-1
6,28,137,13,4,9
6,28,138,16,17,-1
6,28,139,19,10,9
6,28,140,19,13,6
6,28,141,15,9,6
6,28,142,25,12,13
6,28,143,6,18,-12
6,28,144,17,16,1
6,28,145,25,14,11
6,28,146,31,15,16
6,28,147,19,14,5
6,28,148,28,11,17
6,28,149,20,8,12
6,28,150,12,13,-1
6,28,151,20,8,12
6,28,152,20,7,13
6,28,153,22,11,11
6,28,154,11,4,7
6,28,155,30,8,22
6,28,156,14,11,3
6,28,157,11,17,-6
6,28,158,13,7,6
6,28,159,23,9,14
6,28,160,19,9,10
6,28,161,19,14,5
6,28,162,14,12,2
6,28,163,28,7,21
6,28,164,16,8,8
6,28,165,21,11,10
6,28,166,12,4,8
6,28,167,26,9,17
6,28,168,11,10,1
6,28,169,20,4,16
6,28,170,13,16,-3
6,28,171,33,5,28
6,28,172,18,6,12
6,28,173,15,10,5
6,28,174,24,8,16
6,28,175,10,4,6
6,28,176,38,16,22
6,28,177,16,13,3
6,28,178,16,13,3
6,28,179,21,15,6
6,28,180,23,10,13
6,28,181,25,10,15
6,28,182,8,4,4
6,28,183,22,7,15
6,28,184,9,2,7
6,28,185,11,4,7
6,28,186,25,17,8
6,28,187,17,19,-2
6,28,188,21,11,10
6,28,189,11,11,0
6,28,190,17,8,9
6,28,191,12,12,0
6,28,192,17,8,9
6,28,193,23,10,13
6,28,194,5,7,-2
6,28,195,18,11,7
6,28,196,22,8,14
6,28,197,21,15,6
6,28,198,12,10,2
6,28,199,8,9,-1
6,28,200,28,18,10
6,28,201,22,8,14
6,28,202,30,9,21
6,28,203,12,4,8
6,28,204,27,11,16
6,28,205,34,9,25
6,28,206,17,13,4
6,28,207,20,13,7
6,28,208,13,17,-4
6,28,209,33,10,23
6,28,210,25,16,9
6,28,211,20,8,12
6,28,212,20,5,15
6,28,213,21,9,12
6,28,214,17,16,1
6,28,215,7,13,-6
6,28,216,37,9,28
6,28,217,21,14,7
6,28,218,20,17,3
6,28,219,17,8,9
6,28,220,21,19,2
6,28,221,16,9,7
6,28,222,21,6,15
6,28,223,25,9,16
6,28,224,16,17,-1
6,28,225,21,15,6
6,28,226,33,13,20
6,28,227,30,20,10
6,28,228,28,8,20
6,28,229,19,8,11
6,28,230,2,8,-6
6,28,231,26,9,17
6,28,232,12,5,7
6,28,233,27,20,7
6,28,234,30,12,18
6,28,235,31,13,18
6,28,236,18,13,5
6,28,237,18,6,12
6,28,238,15,8,7
6,28,239,15,6,9
6,28,240,22,3,19
6,28,241,30,13,17
6,28,242,22,13,9
6,28,243,11,6,5
6,28,244,21,10,11
6,28,245,30,13,17
6,28,246,22,18,4
6,28,247,11,6,5
6,28,248,16,16,0
6,28,249,7,8,-1
6,28,250,27,20,7
6,28,251,17,12,5
6,28,252,15,3,12
6,28,253,19,17,2
6,28,254,17,9,8
6,28,255,20,18,2
6,28,256,30,13,17
6,28,257,8,6,2
6,28,258,28,20,8
6,28,259,23,10,13
6,28,260,24,9,15
6,28,261,17,9,8
6,28,262,25,16,9
6,28,263,20,16,4
6,28,264,12,11,1
6,28,265,23,10,13
6,28,266,12,11,1
6,28,267,24,15,9
6,28,268,15,3,12
6,28,269,25,11,14
6,28,270,23,8,15
6,28,271,16,15,1
6,28,272,30,13,17
6,28,273,21,13,8
6,28,274,27,13,14
6,28,275,7,5,2
6,28,276,23,10,13
6,28,277,28,8,20
6,28,278,34,14,20
6,28,279,23,7,16
6,28,280,26,21,5
6,28,281,22,15,7
6,28,282,26,6,20
6,28,283,15,15,0
6,28,284,32,10,22
6,28,285,14,13,1
6,28,286,17,11,6
6,28,287,9,11,-2
6,28,288,24,25,-1
6,28,289,22,16,6
6,28,290,28,9,19
6,28,291,20,8,12
6,28,292,16,7,9
6,28,293,19,15,4
6,28,294,30,15,15
6,28,295,13,3,10
6,28,296,14,6,8
6,28,297,38,9,29
6,28,298,18,9,9
6,28,299,17,6,11
6,29,0,25,10,15
6,29,1,23,14,9
6,29,2,27,5,22
6,29,3,31,10,21
6,29,4,29,9,20
6,29,5,29,9,20
6,29,6,26,7,19
6,29,7,28,9,19
6,29,8,32,3,29
6,29,9,16,9,7
6,29,10,15,11,4
6,29,11,30,17,13
6,29,12,17,10,7
6,29,13,14,5,9
6,29,14,36,7,29
6,29,15,30,17,13
6,29,16,18,4,14
6,29,17,21,14,7
6,29,18,8,18,-10
6,29,19,14,4,10
6,29,20,3,7,-4
6,29,21,32,16,16
6,29,22,36,10,26
6,29,23,19,14,5
6,29,24,16,9,7
6,29,25,13,10,3
6,29,26,10,6,4
6,29,27,21,7,14
6,29,28,24,6,18
6,29,29,25,21,4
6,29,30,9,4,5
6,29,31,23,13,10
6,29,32,17,12,5
6,29,33,16,22,-6
6,29,34,10,7,3
6,29,35,22,3,19
6,29,36,29,19,10
6,29,37,14,12,2
6,29,38,25,9,16
6,29,39,25,8,17
6,29,40,13,8,5
6,29,41,11,5,6
6,29,42,19,14,5
6,29,43,14,14,0
6,29,44,14,4,10
6,29,45,36,9,27
6,29,46,24,16,8
6,29,47,38,6,32
6,29,48,25,15,10
6,29,49,12,3,9
6,29,50,24,11,13
6,29,51,18,14,4
6,29,52,34,12,22
6,29,53,16,12,4
6,29,54,22,9,13
6,29,55,19,3,16
6,29,56,24,19,5
6,29,57,12,9,3
6,29,58,10,8,2
6,29,59,17,5,12
6,29,60,28,8,20
6,29,61,23,13,10
6,29,62,13,5,8
6,29,63,14,9,5
6,29,64,13,3,10
6,29,65,41,5,36
6,29,66,35,11,24
6,29,67,19,13,6
6,29,68,25,13,12
6,29,69,19,9,10
6,29,70,29,7,22
6,29,71,13,11,2
6,29,72,33,27,6
6,29,73,25,7,18
6,29,74,14,6,8
6,29,75,25,29,-4
6,29,76,13,13,0
6,29,77,18,8,10
6,29,78,19,13,6
6,29,79,30,21,9
6,29,80,22,10,12
6,29,81,35,10,25
6,29,82,17,11,6
6,29,83,14,11,3
6,29,84,13,9,4
6,29,85,16,4,12
6,29,86,16,8,8
6,29,87,25,10,15
6,29,88,18,6,12
6,29,89,15,4,11
6,29,90,12,9,3
6,29,91,25,12,13
6,29,92,24,10,14
6,29,93,18,8,10
6,29,94,30,8,22
6,29,95,38,16,22
6,29,96,6,5,1
6,29,97,30,19,11
6,29,98,27,14,13
6,29,99,26,11,15
6,29,100,16,13,3
6,29,101,18,7,11
6,29,102,14,7,7
6,29,103,36,16,20
6,29,104,34,13,21
6,29,105,21,17,4
6,29,106,17,7,10
6,29,107,12,6,6
6,29,108,29,21,8
6,29,109,10,3,7
6,29,110,19,15,4
6,29,111,6,7,-1
6,29,112,20,4,16
6,29,113,6,16,-10
6,29,114,12,21,-9
6,29,115,15,3,12
6,29,116,49,5,44
6,29,117,27,6,21
6,29,118,20,5,15
6,29,119,21,8,13
6,29,120,18,3,15
6,29,121,15,14,1
6,29,122,19,11,8
6,29,123,7,4,3
6,29,124,25,7,18
6,29,125,21,17,4
6,29,126,22,12,10
6,29,127,33,16,17
6,29,128,13,12,1
6,29,129,12,8,4
6,29,130,29,15,14
6,29,131,42,13,29
6,29,132,23,8,15
6,29,133,25,16,9
6,29,134,20,13,7
6,29,135,8,16,-8
6,29,136,10,5,5
6,29,137,26,8,18
6,29,138,18,14,4
6,29,139,16,4,12
6,29,140,12,5,7
6,29,141,23,17,6
6,29,142,15,12,3
6,29,143,12,9,3
6,29,144,25,8,17
6,29,145,31,11,20
6,29,146,23,21,2
6,29,147,17,13,4
6,29,148,18,7,11
6,29,149,17,18,-1
6,29,150,12,15,-3
6,29,151,16,3,13
6,29,152,26,10,16
6,29,153,11,9,2
6,29,154,28,10,18
6,29,155,24,18,6
6,29,156,18,13,5
6,29,157,17,15,2
6,29,158,17,10,7
6,29,159,33,13,20
6,29,160,27,11,16
6,29,161,18,14,4
6,29,162,17,7,10
6,29,163,20,7,13
6,29,164,12,6,6
6,29,165,34,23,11
6,29,166,20,1,19
6,29,167,26,7,19
6,29,168,12,9,3
6,29,169,12,13,-1
6,29,170,25,4,21
6,29,171,17,8,9
6,29,172,25,9,16
6,29,173,31,13,18
6,29,174,22,7,15
6,29,175,24,13,11
6,29,176,18,5,13
6,29,177,11,1,10
6,29,178,7,10,-3
6,29,179,13,14,-1
6,29,180,23,8,15
6,29,181,28,12,16
6,29,182,19,6,13
6,29,183,40,14,26
6,29,184,29,18,11
6,29,185,19,3,16
6,29,186,25,18,7
6,29,187,30,9,21
6,29,188,16,5,11
6,29,189,17,18,-1
6,29,190,17,9,8
6,29,191,24,9,15
6,29,192,19,10,9
6,29,193,15,15,0
6,29,194,16,16,0
6,29,195,29,7,22
6,29,196,18,6,12
6,29,197,36,7,29
6,29,198,17,12,5
6,29,199,6,5,1
6,29,200,20,15,5
6,29,201,30,10,20
6,29,202,32,8,24
6,29,203,9,4,5
6,29,204,17,14,3
6,29,205,5,7,-2
6,29,206,25,15,10
6,29,207,30,10,20
6,29,208,29,17,12
6,29,209,15,2,13
6,29,210,27,9,18
6,29,211,22,11,11
6,29,212,24,9,15
6,29,213,9,9,0
6,29,214,11,7,4
6,29,215,26,11,15
6,29,216,18,4,14
6,29,217,25,6,19
6,29,218,11,13,-2
6,29,219,16,9,7
6,29,220,17,16,1
6,29,221,21,4,17
6,29,222,13,9,4
6,29,223,28,7,21
6,29,224,12,12,0
6,29,225,23,6,17
6,29,226,20,12,8
6,29,227,14,10,4
6,29,228,20,6,14
6,29,229,23,15,8
6,29,230,15,11,4
6,29,231,22,7,15
6,29,232,10,7,3
6,29,233,18,11,7
6,29,234,26,12,14
6,29,235,14,5,9
6,29,236,24,13,11
6,29,237,14,1,13
6,29,238,28,11,17
6,29,239,9,12,-3
6,29,240,27,12,15
6,29,241,15,8,7
6,29,242,33,8,25
6,29,243,14,10,4
6,29,244,24,5,19
6,29,245,20,9,11
6,29,246,25,8,17
6,29,247,22,9,13
6,29,248,9,8,1
6,29,249,28,11,17
6,29,250,17,9,8
6,29,251,20,5,15
6,29,252,15,7,8
6,29,253,16,10,6
6,29,254,18,13,5
6,29,255,13,11,2
6,29,256,12,6,6
6,29,257,23,16,7
6,29,258,17,6,11
6,29,259,13,2,11
6,29,260,6,9,-3
6,29,261,4,2,2
6,29,262,22,5,17
6,29,263,24,9,15
6,29,264,27,6,21
6,29,265,9,4,5
6,29,266,24,10,14
6,29,267,16,5,11
6,29,268,25,13,12
6,29,269,11,23,-12
6,29,270,23,5,18
6,29,271,17,2,15
6,29,272,27,6,21
6,29,273,14,7,7
6,29,274,29,16,13
6,29,275,20,11,9
6,29,276,10,17,-7
6,29,277,8,2,6
6,29,278,23,12,11
6,29,279,24,5,19
6,29,280,17,5,12
6,29,281,16,8,8
6,29,282,15,13,2
6,29,283,14,7,7
6,29,284,25,14,11
6,29,285,1,16,-15
6,29,286,10,8,2
6,29,287,23,13,10
6,29,288,12,4,8
6,29,289,23,11,12
6,29,290,37,18,19
6,29,291,36,11,25
6,29,292,23,19,4
6,29,293,8,11,-3
6,29,294,30,20,10
6,29,295,22,10,12
6,29,296,18,7,11
6,29,297,16,9,7
6,29,298,11,16,-5
6,29,299,35,18,17
6,30,0,28,4,24
6,30,1,29,8,21
6,30,2,20,15,5
6,30,3,30,2,28
6,30,4,22,7,15
6,30,5,11,9,2
6,30,6,24,11,13
6,30,7,11,10,1
6,30,8,21,12,9
6,30,9,14,7,7
6,30,10,17,4,13
6,30,11,22,3,19
6,30,12,26,15,11
6,30,13,18,17,1
6,30,14,19,9,10
6,30,15,20,24,-4
6,30,16,26,12,14
6,30,17,13,9,4
6,30,18,32,12,20
6,30,19,18,7,11
6,30,20,23,7,16
6,30,21,13,9,4
6,30,22,22,5,17
6,30,23,26,1,25
6,30,24,17,18,-1
6,30,25,19,10,9
6,30,26,16,10,6
6,30,27,22,17,5
6,30,28,22,7,15
6,30,29,21,20,1
6,30,30,16,7,9
6,30,31,11,8,3
6,30,32,11,12,-1
6,30,33,26,9,17
6,30,34,20,10,10
6,30,35,31,4,27
6,30,36,12,9,3
6,30,37,14,7,7
6,30,38,24,13,11
6,30,39,3,6,-3
6,30,40,13,6,7
6,30,41,24,7,17
6,30,42,27,11,16
6,30,43,20,12,8
6,30,44,19,4,15
6,30,45,23,12,11
6,30,46,13,14,-1
6,30,47,23,16,7
6,30,48,20,7,13
6,30,49,16,16,0
6,30,50,24,8,16
6,30,51,12,6,6
6,30,52,16,4,12
6,30,53,19,12,7
6,30,54,15,11,4
6,30,55,23,6,17
6,30,56,24,7,17
6,30,57,27,13,14
6,30,58,27,10,17
6,30,59,16,18,-2
6,30,60,12,7,5
6,30,61,18,13,5
6,30,62,21,13,8
6,30,63,15,8,7
6,30,64,24,18,6
6,30,65,22,7,15
6,30,66,24,10,14
6,30,67,13,14,-1
6,30,68,16,16,0
6,30,69,16,13,3
6,30,70,41,15,26
6,30,71,15,4,11
6,30,72,20,8,12
6,30,73,17,7,10
6,30,74,34,19,15
6,30,75,22,11,11
6,30,76,15,10,5
6,30,77,23,19,4
6,30,78,8,6,2
6,30,79,32,8,24
6,30,80,16,10,6
6,30,81,23,6,17
6,30,82,20,15,5
6,30,83,16,7,9
6,30,84,28,14,14
6,30,85,28,12,16
6,30,86,16,5,11
6,30,87,14,14,0
6,30,88,14,7,7
6,30,89,29,6,23
6,30,90,8,4,4
6,30,91,15,8,7
6,30,92,26,8,18
6,30,93,20,3,17
6,30,94,23,16,7
6,30,95,28,9,19
6,30,96,22,11,11
6,30,97,21,12,9
6,30,98,22,15,7
6,30,99,21,9,12
6,30,100,22,9,13
6,30,101,14,8,6
6,30,102,14,8,6
6,30,103,21,6,15
6,30,104,27,7,20
6,30,105,5,6,-1
6,30,106,18,11,7
6,30,107,10,7,3
6,30,108,19,10,9
6,30,109,23,5,18
6,30,110,15,7,8
6,30,111,20,11,9
6,30,112,18,6,12
6,30,113,18,6,12
6,30,114,20,5,15
6,30,115,12,4,8
6,30,116,21,17,4
6,30,117,20,12,8
6,30,118,4,7,-3
6,30,119,26,9,17
6,30,120,7,6,1
6,30,121,17,10,7
6,30,122,16,8,8
6,30,123,11,9,2
6,30,124,31,9,22
6,30,125,22,4,18
6,30,126,20,7,13
6,30,127,11,12,-1
6,30,128,27,13,14
6,30,129,21,5,16
6,30,130,2,6,-4
6,30,131,14,5,9
6,30,132,9,5,4
6,30,133,21,10,11
6,30,134,18,15,3
6,30,135,18,12,6
6,30,136,20,8,12
6,30,137,6,5,1
6,30,138,21,23,-2
6,30,139,17,6,11
6,30,140,19,6,13
6,30,141,33,21,12
6,30,142,13,11,2
6,30,143,20,8,12
6,30,144,14,6,8
6,30,145,31,3,28
6,30,146,36,9,27
6,30,147,12,6,6
6,30,148,7,4,3
6,30,149,27,21,6
6,30,150,21,9,12
6,30,151,19,5,14
6,30,152,36,5,31
6,30,153,24,8,16
6,30,154,36,19,17
6,30,155,27,9,18
6,30,156,17,10,7
6,30,157,22,6,16
6,30,158,17,5,12
6,30,159,17,6,11
6,30,160,25,8,17
6,30,161,32,8,24
6,30,162,17,8,9
6,30,163,27,16,11
6,30,164,18,14,4
6,30,165,11,3,8
6,30,166,17,3,14
6,30,167,20,5,15
6,30,168,40,14,26
6,30,169,29,7,22
6,30,170,35,13,22
6,30,171,14,8,6
6,30,172,11,6,5
6,30,173,20,5,15
6,30,174,27,10,17
6,30,175,5,3,2
6,30,176,30,18,12
6,30,177,18,7,11
6,30,178,38,12,26
6,30,179,8,3,5
6,30,180,15,15,0
6,30,181,27,8,19
6,30,182,8,7,1
6,30,183,30,10,20
6,30,184,38,7,31
6,30,185,15,19,-4
6,30,186,15,7,8
6,30,187,19,6,13
6,30,188,13,13,0
6,30,189,19,12,7
6,30,190,8,4,4
6,30,191,22,3,19
6,30,192,19,9,10
6,30,193,10,6,4
6,30,194,26,15,11
6,30,195,14,1,13
6,30,196,40,7,33
6,30,197,18,6,12
6,30,198,16,8,8
6,30,199,20,17,3
6,30,200,17,3,14
6,30,201,18,6,12
6,30,202,17,6,11
6,30,203,27,5,22
6,30,204,31,4,27
6,30,205,25,15,10
6,30,206,14,8,6
6,30,207,15,6,9
6,30,208,20,7,13
6,30,209,34,8,26
6,30,210,15,13,2
6,30,211,17,7,10
6,30,212,16,5,11
6,30,213,23,19,4
6,30,214,22,10,12
6,30,215,14,9,5
6,30,216,22,11,11
6,30,217,9,6,3
6,30,218,19,5,14
6,30,219,18,4,14
6,30,220,30,12,18
6,30,221,40,13,27
6,30,222,19,9,10
6,30,223,23,16,7
6,30,224,28,8,20
6,30,225,22,13,9
6,30,226,11,23,-12
6,30,227,17,6,11
6,30,228,20,15,5
6,30,229,20,14,6
6,30,230,38,14,24
6,30,231,19,9,10
6,30,232,14,6,8
6,30,233,31,24,7
6,30,234,18,13,5
6,30,235,19,11,8
6,30,236,41,13,28
6,30,237,22,15,7
6,30,238,23,8,15
6,30,239,10,14,-4
6,30,240,9,7,2
6,30,241,32,5,27
6,30,242,13,7,6
6,30,243,21,11,10
6,30,244,9,7,2
6,30,245,22,14,8
6,30,246,19,12,7
6,30,247,20,7,13
6,30,248,11,4,7
6,30,249,18,11,7
6,30,250,13,11,2
6,30,251,11,9,2
6,30,252,17,2,15
6,30,253,27,7,20
6,30,254,13,19,-6
6,30,255,40,7,33
6,30,256,16,9,7
6,30,257,10,18,-8
6,30,258,8,24,-16
6,30,259,29,3,26
6,30,260,20,4,16
6,30,261,18,8,10
6,30,262,23,18,5
6,30,263,9,6,3
6,30,264,16,16,0
6,30,265,10,5,5
6,30,266,22,8,14
6,30,267,19,6,13
6,30,268,29,12,17
6,30,269,21,6,15
6,30,270,24,16,8
6,30,271,7,6,1
6,30,272,24,12,12
6,30,273,19,10,9
6,30,274,18,6,12
6,30,275,20,9,11
6,30,276,33,14,19
6,30,277,7,15,-8
6,30,278,22,5,17
6,30,279,13,7,6
6,30,280,26,18,8
6,30,281,23,4,19
6,30,282,11,11,0
6,30,283,21,8,13
6,30,284,25,11,14
6,30,285,23,8,15
6,30,286,29,18,11
6,30,287,24,23,1
6,30,288,12,8,4
6,30,289,16,11,5
6,30,290,14,9,5
6,30,291,22,13,9
6,30,292,27,12,15
6,30,293,8,5,3
6,30,294,28,11,17
6,30,295,26,14,12
6,30,296,19,9,10
6,30,297,23,13,10
6,30,298,27,5,22
6,30,299,14,3,11
7,1,0,12,12,0
7,1,1,7,11,-4
7,1,2,10,11,-1
7,1,3,9,20,-11
7,1,4,3,8,-5
7,1,5,3,11,-8
7,1,6,10,12,-2
7,1,7,5,6,-1
7,1,8,9,12,-3
7,1,9,16,18,-2
7,1,10,24,15,9
7,1,11,11,11,0
7,1,12,9,8,1
7,1,13,14,15,-1
7,1,14,8,8,0
7,1,15,6,8,-2
7,1,16,9,11,-2
7,1,17,9,15,-6
7,1,18,10,0,10
7,1,19,6,6,0
7,1,20,6,10,-4
7,1,21,11,11,0
7,1,22,2,9,-7
7,1,23,5,6,-1
7,1,24,6,15,-9
7,1,25,8,12,-4
7,1,26,7,10,-3
7,1,27,9,9,0
7,1,28,9,18,-9
7,1,29,13,7,6
7,1,30,5,10,-5
7,1,31,10,13,-3
7,1,32,19,23,-4
7,1,33,8,7,1
7,1,34,3,10,-7
7,1,35,6,10,-4
7,1,36,8,16,-8
7,1,37,4,7,-3
7,1,38,14,17,-3
7,1,39,5,8,-3
7,1,40,9,10,-1
7,1,41,4,3,1
7,1,42,12,13,-1
7,1,43,6,13,-7
7,1,44,5,15,-10
7,1,45,7,14,-7
7,1,46,8,17,-9
7,1,47,16,12,4
7,1,48,7,5,2
7,1,49,4,13,-9
7,1,50,7,6,1
7,1,51,24,19,5
7,1,52,13,16,-3
7,1,53,6,10,-4
7,1,54,7,22,-15
7,1,55,8,19,-11
7,1,56,15,17,-2
7,1,57,14,17,-3
7,1,58,12,9,3
7,1,59,14,8,6
7,1,60,9,2,7
7,1,61,5,12,-7
7,1,62,7,19,-12
7,1,63,6,9,-3
7,1,64,4,11,-7
7,1,65,7,9,-2
7,1,66,0,23,-23
7,1,67,10,7,3
7,1,68,9,16,-7
7,1,69,10,15,-5
7,1,70,12,3,9
7,1,71,7,19,-12
7,1,72,11,9,2
7,1,73,3,2,1
7,1,74,8,3,5
7,1,75,13,15,-2
7,1,76,15,10,5
7,1,77,12,18,-6
7,1,78,3,13,-10
7,1,79,4,5,-1
7,1,80,11,7,4
7,1,81,4,9,-5
7,1,82,9,6,3
7,1,83,24,22,2
7,1,84,4,15,-11
7,1,85,14,21,-7
7,1,86,12,13,-1
7,1,87,14,20,-6
7,1,88,15,10,5
7,1,89,5,11,-6
7,1,90,8,8,0
7,1,91,4,0,4
7,1,92,8,5,3
7,1,93,3,3,0
7,1,94,6,10,-4
7,1,95,4,11,-7
7,1,96,16,17,-1
7,1,97,6,11,-5
7,1,98,8,6,2
7,1,99,11,2,9
7,1,100,5,12,-7
7,1,101,6,3,3
7,1,102,13,16,-3
7,1,103,5,13,-8
7,1,104,17,18,-1
7,1,105,6,8,-2
7,1,106,11,9,2
7,1,107,11,18,-7
7,1,108,5,13,-8
7,1,109,7,10,-3
7,1,110,11,15,-4
7,1,111,12,22,-10
7,1,112,10,7,3
7,1,113,10,19,-9
7,1,114,14,28,-14
7,1,115,7,24,-17
7,1,116,14,8,6
7,1,117,9,7,2
7,1,118,14,12,2
7,1,119,6,8,-2
7,1,120,19,28,-9
7,1,121,2,10,-8
7,1,122,16,10,6
7,1,123,8,10,-2
7,1,124,5,12,-7
7,1,125,4,5,-1
7,1,126,12,10,2
7,1,127,5,12,-7
7,1,128,7,5,2
7,1,129,10,13,-3
7,1,130,19,22,-3
7,1,131,11,9,2
7,1,132,13,10,3
7,1,133,7,8,-1
7,1,134,7,2,5
7,1,135,20,10,10
7,1,136,9,13,-4
7,1,137,12,9,3
7,1,138,1,4,-3
7,1,139,9,6,3
7,1,140,4,10,-6
7,1,141,11,12,-1
7,1,142,4,6,-2
7,1,143,9,7,2
7,1,144,8,6,2
7,1,145,9,12,-3
7,1,146,7,6,1
7,1,147,13,12,1
7,1,148,4,15,-11
7,1,149,11,12,-1
7,1,150,3,11,-8
7,1,151,6,27,-21
7,1,152,29,17,12
7,1,153,9,12,-3
7,1,154,5,8,-3
7,1,155,14,27,-13
7,1,156,7,6,1
7,1,157,18,10,8
7,1,158,10,5,5
7,1,159,6,10,-4
7,1,160,9,15,-6
7,1,161,4,10,-6
7,1,162,9,6,3
7,1,163,13,9,4
7,1,164,5,17,-12
7,1,165,7,9,-2
7,1,166,11,9,2
7,1,167,10,11,-1
7,1,168,12,14,-2
7,1,169,5,5,0
7,1,170,11,7,4
7,1,171,14,15,-1
7,1,172,8,8,0
7,1,173,4,19,-15
7,1,174,4,15,-11
7,1,175,11,13,-2
7,1,176,10,14,-4
7,1,177,3,9,-6
7,1,178,9,12,-3
7,1,179,6,5,1
7,1,180,5,13,-8
7,1,181,6,9,-3
7,1,182,11,14,-3
7,1,183,10,12,-2
7,1,184,5,19,-14
7,1,185,11,20,-9
7,1,186,12,12,0
7,1,187,13,15,-2
7,1,188,8,12,-4
7,1,189,10,4,6
7,1,190,5,5,0
7,1,191,7,12,-5
7,1,192,6,8,-2
7,1,193,8,6,2
7,1,194,12,5,7
7,1,195,3,7,-4
7,1,196,9,11,-2
7,1,197,18,15,3
7,1,198,9,5,4
7,1,199,7,14,-7
7,1,200,13,15,-2
7,1,201,2,11,-9
7,1,202,5,7,-2
7,1,203,18,11,7
7,1,204,9,7,2
7,1,205,2,8,-6
7,1,206,6,13,-7
7,1,207,10,26,-16
7,1,208,11,16,-5
7,1,209,1,14,-13
7,1,210,12,11,1
7,1,211,12,16,-4
7,1,212,4,7,-3
7,1,213,9,14,-5
7,1,214,6,12,-6
7,1,215,5,9,-4
7,1,216,10,8,2
7,1,217,13,20,-7
7,1,218,8,8,0
7,1,219,8,9,-1
7,1,220,12,11,1
7,1,221,6,7,-1
7,1,222,16,10,6
7,1,223,9,10,-1
7,1,224,13,3,10
7,1,225,10,12,-2
7,1,226,5,14,-9
7,1,227,7,8,-1
7,1,228,6,13,-7
7,1,229,11,12,-1
7,1,230,3,14,-11
7,1,231,11,4,7
7,1,232,14,6,8
7,1,233,8,15,-7
7,1,234,12,6,6
7,1,235,14,11,3
7,1,236,13,12,1
7,1,237,3,0,3
7,1,238,2,5,-3
7,1,239,7,6,1
7,1,240,8,4,4
7,1,241,9,9,0
7,1,242,10,7,3
7,1,243,14,9,5
7,1,244,8,12,-4
7,1,245,17,25,-8
7,1,246,1,5,-4
7,1,247,3,5,-2
7,1,248,1,17,-16
7,1,249,10,3,7
7,1,250,6,14,-8
7,1,251,11,14,-3
7,1,252,13,11,2
7,1,253,10,6,4
7,1,254,10,7,3
7,1,255,14,18,-4
7,1,256,7,12,-5
7,1,257,11,22,-11
7,1,258,10,10,0
7,1,259,6,11,-5
7,1,260,8,7,1
7,1,261,7,13,-6
7,1,262,5,10,-5
7,1,263,12,15,-3
7,1,264,8,11,-3
7,1,265,18,18,0
7,1,266,10,13,-3
7,1,267,3,5,-2
7,1,268,4,18,-14
7,1,269,7,13,-6
7,1,270,14,17,-3
7,1,271,20,19,1
7,1,272,12,15,-3
7,1,273,10,9,1
7,1,274,6,5,1
7,1,275,18,14,4
7,1,276,12,17,-5
7,1,277,12,11,1
7,1,278,4,9,-5
7,1,279,5,2,3
7,1,280,5,4,1
7,1,281,11,12,-1
7,1,282,9,7,2
7,1,283,12,19,-7
7,1,284,11,18,-7
7,1,285,7,6,1
7,1,286,10,12,-2
7,1,287,7,10,-3
7,1,288,8,27,-19
7,1,289,20,13,7
7,1,290,6,9,-3
7,1,291,8,12,-4
7,1,292,5,8,-3
7,1,293,25,25,0
7,1,294,13,15,-2
7,1,295,20,15,5
7,1,296,8,8,0
7,1,297,5,20,-15
7,1,298,14,15,-1
7,1,299,8,21,-13
7,2,0,5,9,-4
7,2,1,9,16,-7
7,2,2,11,18,-7
7,2,3,10,19,-9
7,2,4,7,15,-8
7,2,5,18,15,3
7,2,6,9,14,-5
7,2,7,3,8,-5
7,2,8,2,10,-8
7,2,9,11,5,6
7,2,10,9,16,-7
7,2,11,14,13,1
7,2,12,8,19,-11
7,2,13,5,12,-7
7,2,14,4,11,-7
7,2,15,12,17,-5
7,2,16,1,15,-14
7,2,17,5,10,-5
7,2,18,10,17,-7
7,2,19,1,4,-3
7,2,20,9,18,-9
7,2,21,6,19,-13
7,2,22,5,2,3
7,2,23,12,9,3
7,2,24,6,20,-14
7,2,25,10,7,3
7,2,26,3,5,-2
7,2,27,11,27,-16
7,2,28,24,17,7
7,2,29,11,9,2
7,2,30,6,6,0
7,2,31,11,30,-19
7,2,32,18,17,1
7,2,33,5,16,-11
7,2,34,17,18,-1
7,2,35,4,10,-6
7,2,36,7,12,-5
7,2,37,9,10,-1
7,2,38,13,13,0
7,2,39,8,9,-1
7,2,40,6,6,0
7,2,41,13,10,3
7,2,42,30,13,17
7,2,43,11,8,3
7,2,44,2,10,-8
7,2,45,11,14,-3
7,2,46,10,18,-8
7,2,47,6,11,-5
7,2,48,10,23,-13
7,2,49,10,17,-7
7,2,50,8,19,-11
7,2,51,16,11,5
7,2,52,9,9,0
7,2,53,4,9,-5
7,2,54,16,12,4
7,2,55,6,12,-6
7,2,56,5,4,1
7,2,57,7,14,-7
7,2,58,16,7,9
7,2,59,11,11,0
7,2,60,7,14,-7
7,2,61,24,14,10
7,2,62,8,16,-8
7,2,63,8,10,-2
7,2,64,7,9,-2
7,2,65,19,10,9
7,2,66,12,19,-7
7,2,67,12,10,2
7,2,68,9,12,-3
7,2,69,10,22,-12
7,2,70,12,11,1
7,2,71,8,11,-3
7,2,72,5,12,-7
7,2,73,13,19,-6
7,2,74,14,23,-9
7,2,75,5,11,-6
7,2,76,11,10,1
7,2,77,6,9,-3
7,2,78,11,12,-1
7,2,79,14,14,0
7,2,80,17,20,-3
7,2,81,7,17,-10
7,2,82,11,15,-4
7,2,83,4,6,-2
7,2,84,6,8,-2
7,2,85,5,17,-12
7,2,86,1,16,-15
7,2,87,4,12,-8
7,2,88,19,14,5
7,2,89,7,13,-6
7,2,90,7,11,-4
7,2,91,14,20,-6
7,2,92,14,17,-3
7,2,93,5,20,-15
7,2,94,11,18,-7
7,2,95,3,6,-3
7,2,96,10,28,-18
7,2,97,8,16,-8
7,2,98,6,6,0
7,2,99,7,21,-14
7,2,100,12,13,-1
7,2,101,5,6,-1
7,2,102,21,15,6
7,2,103,18,11,7
7,2,104,7,6,1
7,2,105,5,7,-2
7,2,106,18,14,4
7,2,107,7,13,-6
7,2,108,20,14,6
7,2,109,12,14,-2
7,2,110,19,12,7
7,2,111,7,9,-2
7,2,112,10,14,-4
7,2,113,8,7,1
7,2,114,9,15,-6
7,2,115,7,11,-4
7,2,116,13,20,-7
7,2,117,11,8,3
7,2,118,2,11,-9
7,2,119,10,15,-5
7,2,120,2,10,-8
7,2,121,9,10,-1
7,2,122,6,7,-1
7,2,123,9,4,5
7,2,124,10,9,1
7,2,125,7,10,-3
7,2,126,6,28,-22
7,2,127,13,11,2
7,2,128,7,11,-4
7,2,129,13,12,1
7,2,130,12,15,-3
7,2,131,10,7,3
7,2,132,17,16,1
7,2,133,8,15,-7
7,2,134,7,15,-8
7,2,135,5,6,-1
7,2,136,3,12,-9
7,2,137,6,10,-4
7,2,138,4,13,-9
7,2,139,15,20,-5
7,2,140,6,10,-4
7,2,141,11,12,-1
7,2,142,8,9,-1
7,2,143,6,5,1
7,2,144,2,4,-2
7,2,145,7,11,-4
7,2,146,11,9,2
7,2,147,18,14,4
7,2,148,2,14,-12
7,2,149,15,12,3
7,2,150,9,20,-11
7,2,151,8,13,-5
7,2,152,9,9,0
7,2,153,10,9,1
7,2,154,6,4,2
7,2,155,18,26,-8
7,2,156,12,18,-6
7,2,157,4,11,-7
7,2,158,10,13,-3
7,2,159,12,10,2
7,2,160,5,11,-6
7,2,161,13,13,0
7,2,162,12,23,-11
7,2,163,9,13,-4
7,2,164,3,15,-12
7,2,165,16,7,9
7,2,166,17,18,-1
7,2,167,33,33,0
7,2,168,4,10,-6
7,2,169,5,4,1
7,2,170,13,15,-2
7,2,171,17,21,-4
7,2,172,7,15,-8
7,2,173,14,12,2
7,2,174,2,17,-15
7,2,175,7,8,-1
7,2,176,5,16,-11
7,2,177,8,23,-15
7,2,178,5,4,1
7,2,179,3,6,-3
7,2,180,18,10,8
7,2,181,8,2,6
7,2,182,13,4,9
7,2,183,9,11,-2
7,2,184,8,11,-3
7,2,185,11,16,-5
7,2,186,13,19,-6
7,2,187,12,13,-1
7,2,188,4,10,-6
7,2,189,10,5,5
7,2,190,9,14,-5
7,2,191,8,12,-4
7,2,192,14,16,-2
7,2,193,11,10,1
7,2,194,16,1,15
7,2,195,3,11,-8
7,2,196,7,16,-9
7,2,197,10,13,-3
7,2,198,6,27,-21
7,2,199,9,22,-13
7,2,200,10,6,4
7,2,201,16,9,7
7,2,202,8,10,-2
7,2,203,16,13,3
7,2,204,8,12,-4
7,2,205,22,10,12
7,2,206,7,11,-4
7,2,207,10,12,-2
7,2,208,16,20,-4
7,2,209,9,14,-5
7,2,210,20,12,8
7,2,211,12,27,-15
7,2,212,9,6,3
7,2,213,19,12,7
7,2,214,10,10,0
7,2,215,12,19,-7
7,2,216,5,8,-3
7,2,217,19,10,9
7,2,218,22,19,3
7,2,219,6,21,-15
7,2,220,19,10,9
7,2,221,5,14,-9
7,2,222,9,18,-9
7,2,223,4,6,-2
7,2,224,9,13,-4
7,2,225,20,21,-1
7,2,226,9,17,-8
7,2,227,10,8,2
7,2,228,14,7,7
7,2,229,9,6,3
7,2,230,21,19,2
7,2,231,23,23,0
7,2,232,11,18,-7
7,2,233,9,10,-1
7,2,234,8,14,-6
7,2,235,12,23,-11
7,2,236,12,18,-6
7,2,237,11,13,-2
7,2,238,7,20,-13
7,2,239,3,11,-8
7,2,240,3,10,-7
7,2,241,10,4,6
7,2,242,3,5,-2
7,2,243,7,10,-3
7,2,244,9,12,-3
7,2,245,8,8,0
7,2,246,12,17,-5
7,2,247,12,13,-1
7,2,248,15,12,3
7,2,249,8,9,-1
7,2,250,5,9,-4
7,2,251,20,16,4
7,2,252,10,8,2
7,2,253,8,8,0
7,2,254,10,16,-6
7,2,255,11,14,-3
7,2,256,5,6,-1
7,2,257,13,19,-6
7,2,258,5,9,-4
7,2,259,7,23,-16
7,2,260,11,6,5
7,2,261,8,15,-7
7,2,262,7,14,-7
7,2,263,13,11,2
7,2,264,6,9,-3
7,2,265,9,10,-1
7,2,266,2,5,-3
7,2,267,10,13,-3
7,2,268,6,12,-6
7,2,269,11,16,-5
7,2,270,7,5,2
7,2,271,13,10,3
7,2,272,8,15,-7
7,2,273,5,18,-13
7,2,274,3,13,-10
7,2,275,13,13,0
7,2,276,10,12,-2
7,2,277,10,6,4
7,2,278,16,15,1
7,2,279,9,6,3
7,2,280,8,11,-3
7,2,281,8,6,2
7,2,282,8,9,-1
7,2,283,9,28,-19
7,2,284,6,9,-3
7,2,285,14,15,-1
7,2,286,15,28,-13
7,2,287,13,6,7
7,2,288,18,14,4
7,2,289,11,14,-3
7,2,290,7,23,-16
7,2,291,9,10,-1
7,2,292,4,11,-7
7,2,293,10,11,-1
7,2,294,16,16,0
7,2,295,5,5,0
7,2,296,14,13,1
7,2,297,11,25,-14
7,2,298,9,11,-2
7,2,299,11,8,3
7,3,0,6,11,-5
7,3,1,14,21,-7
7,3,2,12,18,-6
7,3,3,9,13,-4
7,3,4,26,15,11
7,3,5,17,18,-1
7,3,6,11,12,-1
7,3,7,13,9,4
7,3,8,9,7,2
7,3,9,18,15,3
7,3,10,11,21,-10
7,3,11,8,3,5
7,3,12,6,18,-12
7,3,13,8,15,-7
7,3,14,9,12,-3
7,3,15,17,17,0
7,3,16,4,9,-5
7,3,17,8,21,-13
7,3,18,7,10,-3
7,3,19,13,11,2
7,3,20,13,18,-5
7,3,21,7,15,-8
7,3,22,22,17,5
7,3,23,15,22,-7
7,3,24,8,8,0
7,3,25,11,16,-5
7,3,26,8,9,-1
7,3,27,8,10,-2
7,3,28,13,6,7
7,3,29,10,13,-3
7,3,30,7,17,-10
7,3,31,13,9,4
7,3,32,9,21,-12
7,3,33,11,16,-5
7,3,34,9,18,-9
7,3,35,7,12,-5
7,3,36,12,18,-6
7,3,37,14,10,4
7,3,38,5,8,-3
7,3,39,14,8,6
7,3,40,12,6,6
7,3,41,12,7,5
7,3,42,17,11,6
7,3,43,21,23,-2
7,3,44,9,16,-7
7,3,45,6,13,-7
7,3,46,4,10,-6
7,3,47,6,6,0
7,3,48,5,15,-10
7,3,49,7,10,-3
7,3,50,7,9,-2
7,3,51,9,10,-1
7,3,52,8,14,-6
7,3,53,8,22,-14
7,3,54,7,20,-13
7,3,55,8,17,-9
7,3,56,8,3,5
7,3,57,19,8,11
7,3,58,7,8,-1
7,3,59,6,10,-4
7,3,60,4,5,-1
7,3,61,19,8,11
7,3,62,12,10,2
7,3,63,23,20,3
7,3,64,11,24,-13
7,3,65,2,7,-5
7,3,66,6,8,-2
7,3,67,20,19,1
7,3,68,5,14,-9
7,3,69,3,7,-4
7,3,70,3,11,-8
7,3,71,9,2,7
7,3,72,14,13,1
7,3,73,15,12,3
7,3,74,8,7,1
7,3,75,8,12,-4
7,3,76,9,6,3
7,3,77,8,15,-7
7,3,78,13,11,2
7,3,79,17,8,9
7,3,80,9,9,0
7,3,81,21,18,3
7,3,82,9,9,0
7,3,83,7,15,-8
7,3,84,22,3,19
7,3,85,12,3,9
7,3,86,8,11,-3
7,3,87,4,8,-4
7,3,88,15,16,-1
7,3,89,12,17,-5
7,3,90,6,23,-17
7,3,91,10,12,-2
7,3,92,8,8,0
7,3,93,10,17,-7
7,3,94,12,13,-1
7,3,95,12,17,-5
7,3,96,13,5,8
7,3,97,10,4,6
7,3,98,9,19,-10
7,3,99,18,16,2
7,3,100,8,7,1
7,3,101,8,15,-7
7,3,102,13,15,-2
7,3,103,7,9,-2
7,3,104,13,8,5
7,3,105,9,15,-6
7,3,106,16,11,5
7,3,107,11,7,4
7,3,108,10,20,-10
7,3,109,5,10,-5
7,3,110,5,10,-5
7,3,111,10,23,-13
7,3,112,12,20,-8
7,3,113,8,6,2
7,3,114,7,8,-1
7,3,115,6,16,-10
7,3,116,13,8,5
7,3,117,17,18,-1
7,3,118,19,16,3
7,3,119,10,11,-1
7,3,120,11,6,5
7,3,121,20,15,5
7,3,122,7,17,-10
7,3,123,9,6,3
7,3,124,20,28,-8
7,3,125,9,7,2
7,3,126,14,14,0
7,3,127,14,17,-3
7,3,128,8,20,-12
7,3,129,7,17,-10
7,3,130,23,12,11
7,3,131,13,30,-17
7,3,132,10,13,-3
7,3,133,7,11,-4
7,3,134,11,11,0
7,3,135,13,15,-2
7,3,136,5,8,-3
7,3,137,11,11,0
7,3,138,7,20,-13
7,3,139,8,20,-12
7,3,140,10,7,3
7,3,141,3,3,0
7,3,142,3,3,0
7,3,143,8,6,2
7,3,144,14,20,-6
7,3,145,7,10,-3
7,3,146,18,17,1
7,3,147,9,12,-3
7,3,148,14,11,3
7,3,149,17,25,-8
7,3,150,9,16,-7
7,3,151,5,19,-14
7,3,152,7,11,-4
7,3,153,7,5,2
7,3,154,8,11,-3
7,3,155,10,21,-11
7,3,156,13,28,-15
7,3,157,15,14,1
7,3,158,8,20,-12
7,3,159,9,13,-4
7,3,160,18,10,8
7,3,161,13,22,-9
7,3,162,16,20,-4
7,3,163,10,10,0
7,3,164,10,24,-14
7,3,165,14,14,0
7,3,166,6,12,-6
7,3,167,4,15,-11
7,3,168,16,11,5
7,3,169,9,14,-5
7,3,170,5,11,-6
7,3,171,10,24,-14
7,3,172,3,12,-9
7,3,173,13,16,-3
7,3,174,15,30,-15
7,3,175,11,17,-6
7,3,176,0,6,-6
7,3,177,8,20,-12
7,3,178,10,7,3
7,3,179,16,11,5
7,3,180,9,13,-4
7,3,181,22,12,10
7,3,182,16,25,-9
7,3,183,7,20,-13
7,3,184,28,18,10
7,3,185,14,15,-1
7,3,186,7,5,2
7,3,187,2,13,-11
7,3,188,14,16,-2
7,3,189,19,30,-11
7,3,190,7,8,-1
7,3,191,7,10,-3
7,3,192,9,18,-9
7,3,193,8,15,-7
7,3,194,10,4,6
7,3,195,13,9,4
7,3,196,8,23,-15
7,3,197,20,19,1
7,3,198,8,12,-4
7,3,199,17,11,6
7,3,200,6,8,-2
7,3,201,7,21,-14
7,3,202,5,6,-1
7,3,203,11,14,-3
7,3,204,8,5,3
7,3,205,8,17,-9
7,3,206,11,13,-2
7,3,207,21,20,1
7,3,208,9,13,-4
7,3,209,6,11,-5
7,3,210,12,12,0
7,3,211,10,12,-2
7,3,212,17,7,10
7,3,213,6,15,-9
7,3,214,12,6,6
7,3,215,8,6,2
7,3,216,8,6,2
7,3,217,8,14,-6
7,3,218,13,12,1
7,3,219,12,19,-7
7,3,220,15,18,-3
7,3,221,13,12,1
7,3,222,17,15,2
7,3,223,19,8,11
7,3,224,8,10,-2
7,3,225,14,16,-2
7,3,226,9,9,0
7,3,227,12,12,0
7,3,228,14,14,0
7,3,229,18,27,-9
7,3,230,9,9,0
7,3,231,15,17,-2
7,3,232,17,21,-4
7,3,233,13,14,-1
7,3,234,13,10,3
7,3,235,14,21,-7
7,3,236,7,18,-11
7,3,237,12,12,0
7,3,238,13,13,0
7,3,239,13,13,0
7,3,240,15,22,-7
7,3,241,12,23,-11
7,3,242,17,14,3
7,3,243,14,19,-5
7,3,244,12,17,-5
7,3,245,5,8,-3
7,3,246,7,11,-4
7,3,247,8,26,-18
7,3,248,11,9,2
7,3,249,10,11,-1
7,3,250,5,11,-6
7,3,251,12,12,0
7,3,252,2,4,-2
7,3,253,7,12,-5
7,3,254,5,8,-3
7,3,255,2,17,-15
7,3,256,9,14,-5
7,3,257,14,22,-8
7,3,258,23,22,1
7,3,259,3,12,-9
7,3,260,14,23,-9
7,3,261,11,17,-6
7,3,262,13,24,-11
7,3,263,8,7,1
7,3,264,13,11,2
7,3,265,7,15,-8
7,3,266,9,21,-12
7,3,267,10,14,-4
7,3,268,9,8,1
7,3,269,8,9,-1
7,3,270,8,19,-11
7,3,271,11,5,6
7,3,272,13,8,5
7,3,273,14,20,-6
7,3,274,5,12,-7
7,3,275,10,28,-18
7,3,276,10,15,-5
7,3,277,6,17,-11
7,3,278,16,14,2
7,3,279,13,11,2
7,3,280,7,21,-14
7,3,281,12,12,0
7,3,282,5,12,-7
7,3,283,9,2,7
7,3,284,1,5,-4
7,3,285,4,11,-7
7,3,286,7,10,-3
7,3,287,13,15,-2
7,3,288,15,13,2
7,3,289,15,19,-4
7,3,290,2,6,-4
7,3,291,12,9,3
7,3,292,9,9,0
7,3,293,12,14,-2
7,3,294,8,9,-1
7,3,295,2,3,-1
7,3,296,6,10,-4
7,3,297,12,20,-8
7,3,298,16,32,-16
7,3,299,10,19,-9
7,4,0,19,15,4
7,4,1,9,14,-5
7,4,2,11,12,-1
7,4,3,15,11,4
7,4,4,2,4,-2
7,4,5,18,14,4
7,4,6,12,19,-7
7,4,7,8,7,1
7,4,8,9,9,0
7,4,9,27,37,-10
7,4,10,11,6,5
7,4,11,6,11,-5
7,4,12,18,19,-1
7,4,13,6,11,-5
7,4,14,16,17,-1
7,4,15,21,7,14
7,4,16,10,21,-11
7,4,17,19,23,-4
7,4,18,14,7,7
7,4,19,11,15,-4
7,4,20,12,10,2
7,4,21,22,16,6
7,4,22,10,14,-4
7,4,23,11,14,-3
7,4,24,11,8,3
7,4,25,9,11,-2
7,4,26,8,8,0
7,4,27,3,10,-7
7,4,28,9,13,-4
7,4,29,21,11,10
7,4,30,16,12,4
7,4,31,11,17,-6
7,4,32,11,18,-7
7,4,33,6,7,-1
7,4,34,22,22,0
7,4,35,18,14,4
7,4,36,12,14,-2
7,4,37,13,15,-2
7,4,38,16,17,-1
7,4,39,10,18,-8
7,4,40,11,15,-4
7,4,41,10,11,-1
7,4,42,13,17,-4
7,4,43,8,5,3
7,4,44,6,22,-16
7,4,45,9,8,1
7,4,46,8,7,1
7,4,47,13,11,2
7,4,48,8,18,-10
7,4,49,14,12,2
7,4,50,19,20,-1
7,4,51,14,11,3
7,4,52,9,14,-5
7,4,53,9,20,-11
7,4,54,5,19,-14
7,4,55,4,13,-9
7,4,56,7,6,1
7,4,57,14,13,1
7,4,58,16,20,-4
7,4,59,18,17,1
7,4,60,16,23,-7
7,4,61,8,25,-17
7,4,62,7,3,4
7,4,63,7,19,-12
7,4,64,14,14,0
7,4,65,10,9,1
7,4,66,3,7,-4
7,4,67,27,10,17
7,4,68,7,20,-13
7,4,69,4,13,-9
7,4,70,13,14,-1
7,4,71,13,27,-14
7,4,72,13,15,-2
7,4,73,13,8,5
7,4,74,18,33,-15
7,4,75,13,16,-3
7,4,76,14,19,-5
7,4,77,12,16,-4
7,4,78,10,10,0
7,4,79,7,11,-4
7,4,80,9,12,-3
7,4,81,4,5,-1
7,4,82,23,24,-1
7,4,83,7,9,-2
7,4,84,15,10,5
7,4,85,5,16,-11
7,4,86,15,18,-3
7,4,87,13,16,-3
7,4,88,13,14,-1
7,4,89,11,22,-11
7,4,90,10,27,-17
7,4,91,9,19,-10
7,4,92,6,4,2
7,4,93,10,14,-4
7,4,94,5,8,-3
7,4,95,15,17,-2
7,4,96,18,9,9
7,4,97,6,20,-14
7,4,98,17,22,-5
7,4,99,8,11,-3
7,4,100,9,9,0
7,4,101,11,9,2
7,4,102,26,16,10
7,4,103,9,8,1
7,4,104,15,9,6
7,4,105,15,9,6
7,4,106,12,33,-21
7,4,107,12,20,-8
7,4,108,8,6,2
7,4,109,15,18,-3
7,4,110,13,13,0
7,4,111,18,15,3
7,4,112,13,11,2
7,4,113,23,11,12
7,4,114,14,12,2
7,4,115,16,10,6
7,4,116,11,18,-7
7,4,117,11,11,0
7,4,118,18,21,-3
7,4,119,8,4,4
7,4,120,18,13,5
7,4,121,8,11,-3
7,4,122,20,11,9
7,4,123,13,14,-1
7,4,124,5,6,-1
7,4,125,6,9,-3
7,4,126,24,17,7
7,4,127,8,16,-8
7,4,128,7,15,-8
7,4,129,15,18,-3
7,4,130,18,11,7
7,4,131,20,29,-9
7,4,132,6,7,-1
7,4,133,19,25,-6
7,4,134,18,16,2
7,4,135,14,23,-9
7,4,136,9,8,1
7,4,137,2,14,-12
7,4,138,7,5,2
7,4,139,5,7,-2
7,4,140,12,8,4
7,4,141,12,14,-2
7,4,142,8,18,-10
7,4,143,8,15,-7
7,4,144,8,7,1
7,4,145,9,12,-3
7,4,146,9,9,0
7,4,147,19,24,-5
7,4,148,6,12,-6
7,4,149,6,9,-3
7,4,150,7,22,-15
7,4,151,15,16,-1
7,4,152,9,7,2
7,4,153,9,23,-14
7,4,154,6,11,-5
7,4,155,14,13,1
7,4,156,12,22,-10
7,4,157,19,12,7
7,4,158,7,15,-8
7,4,159,15,13,2
7,4,160,15,15,0
7,4,161,3,7,-4
7,4,162,10,14,-4
7,4,163,7,6,1
7,4,164,11,15,-4
7,4,165,10,12,-2
7,4,166,23,12,11
7,4,167,20,10,10
7,4,168,9,11,-2
7,4,169,24,19,5
7,4,170,5,7,-2
7,4,171,6,12,-6
7,4,172,12,23,-11
7,4,173,12,10,2
7,4,174,17,13,4
7,4,175,7,12,-5
7,4,176,10,18,-8
7,4,177,7,14,-7
7,4,178,11,13,-2
7,4,179,11,9,2
7,4,180,19,9,10
7,4,181,17,13,4
7,4,182,8,9,-1
7,4,183,11,6,5
7,4,184,15,15,0
7,4,185,5,11,-6
7,4,186,8,19,-11
7,4,187,10,25,-15
7,4,188,5,8,-3
7,4,189,12,17,-5
7,4,190,12,10,2
7,4,191,29,19,10
7,4,192,12,18,-6
7,4,193,14,19,-5
7,4,194,9,15,-6
7,4,195,15,11,4
7,4,196,9,9,0
7,4,197,9,21,-12
7,4,198,15,13,2
7,4,199,6,21,-15
7,4,200,5,12,-7
7,4,201,16,11,5
7,4,202,3,2,1
7,4,203,9,16,-7
7,4,204,11,13,-2
7,4,205,23,9,14
7,4,206,14,8,6
7,4,207,13,23,-10
7,4,208,12,8,4
7,4,209,17,10,7
7,4,210,2,19,-17
7,4,211,3,13,-10
7,4,212,2,5,-3
7,4,213,13,23,-10
7,4,214,14,5,9
7,4,215,14,8,6
7,4,216,9,11,-2
7,4,217,5,19,-14
7,4,218,17,14,3
7,4,219,9,13,-4
7,4,220,8,8,0
7,4,221,9,14,-5
7,4,222,15,12,3
7,4,223,13,20,-7
7,4,224,9,24,-15
7,4,225,14,14,0
7,4,226,14,10,4
7,4,227,24,16,8
7,4,228,11,23,-12
7,4,229,8,17,-9
7,4,230,12,23,-11
7,4,231,4,12,-8
7,4,232,11,11,0
7,4,233,8,13,-5
7,4,234,3,3,0
7,4,235,16,21,-5
7,4,236,16,13,3
7,4,237,11,16,-5
7,4,238,21,16,5
7,4,239,10,10,0
7,4,240,4,12,-8
7,4,241,6,9,-3
7,4,242,21,13,8
7,4,243,21,13,8
7,4,244,21,13,8
7,4,245,5,25,-20
7,4,246,9,22,-13
7,4,247,10,14,-4
7,4,248,13,8,5
7,4,249,14,6,8
7,4,250,13,7,6
7,4,251,5,6,-1
7,4,252,5,11,-6
7,4,253,11,15,-4
7,4,254,18,14,4
7,4,255,18,14,4
7,4,256,17,21,-4
7,4,257,10,10,0
7,4,258,8,12,-4
7,4,259,19,22,-3
7,4,260,25,21,4
7,4,261,21,16,5
7,4,262,17,18,-1
7,4,263,14,13,1
7,4,264,8,6,2
7,4,265,8,11,-3
7,4,266,12,5,7
7,4,267,14,21,-7
7,4,268,10,8,2
7,4,269,12,10,2
7,4,270,23,14,9
7,4,271,9,15,-6
7,4,272,9,5,4
7,4,273,8,11,-3
7,4,274,14,11,3
7,4,275,7,10,-3
7,4,276,16,16,0
7,4,277,6,13,-7
7,4,278,8,20,-12
7,4,279,7,5,2
7,4,280,14,26,-12
7,4,281,8,18,-10
7,4,282,12,9,3
7,4,283,13,25,-12
7,4,284,9,12,-3
7,4,285,13,25,-12
7,4,286,10,7,3
7,4,287,6,17,-11
7,4,288,22,12,10
7,4,289,8,8,0
7,4,290,7,12,-5
7,4,291,13,16,-3
7,4,292,25,28,-3
7,4,293,15,15,0
7,4,294,16,22,-6
7,4,295,24,34,-10
7,4,296,21,17,4
7,4,297,16,10,6
7,4,298,15,22,-7
7,4,299,11,18,-7
7,5,0,10,5,5
7,5,1,14,18,-4
7,5,2,3,13,-10
7,5,3,14,10,4
7,5,4,13,10,3
7,5,5,12,18,-6
7,5,6,7,17,-10
7,5,7,10,16,-6
7,5,8,7,21,-14
7,5,9,6,10,-4
7,5,10,8,12,-4
7,5,11,12,14,-2
7,5,12,14,21,-7
7,5,13,11,12,-1
7,5,14,16,13,3
7,5,15,19,8,11
7,5,16,9,8,1
7,5,17,10,13,-3
7,5,18,3,8,-5
7,5,19,11,7,4
7,5,20,3,18,-15
7,5,21,15,18,-3
7,5,22,7,20,-13
7,5,23,28,19,9
7,5,24,21,24,-3
7,5,25,11,6,5
7,5,26,11,24,-13
7,5,27,9,8,1
7,5,28,14,17,-3
7,5,29,19,13,6
7,5,30,13,12,1
7,5,31,8,8,0
7,5,32,13,15,-2
7,5,33,12,13,-1
7,5,34,7,13,-6
7,5,35,11,13,-2
7,5,36,22,23,-1
7,5,37,4,14,-10
7,5,38,14,14,0
7,5,39,14,20,-6
7,5,40,12,27,-15
7,5,41,9,23,-14
7,5,42,13,11,2
7,5,43,8,8,0
7,5,44,26,8,18
7,5,45,27,12,15
7,5,46,14,20,-6
7,5,47,2,8,-6
7,5,48,16,24,-8
7,5,49,8,5,3
7,5,50,15,16,-1
7,5,51,9,13,-4
7,5,52,11,8,3
7,5,53,5,6,-1
7,5,54,9,13,-4
7,5,55,6,8,-2
7,5,56,12,17,-5
7,5,57,9,12,-3
7,5,58,7,15,-8
7,5,59,14,13,1
7,5,60,24,12,12
7,5,61,7,12,-5
7,5,62,20,22,-2
7,5,63,8,20,-12
7,5,64,11,8,3
7,5,65,19,12,7
7,5,66,7,7,0
7,5,67,10,11,-1
7,5,68,6,13,-7
7,5,69,13,17,-4
7,5,70,20,19,1
7,5,71,6,7,-1
7,5,72,5,10,-5
7,5,73,13,10,3
7,5,74,10,12,-2
7,5,75,24,23,1
7,5,76,12,18,-6
7,5,77,11,15,-4
7,5,78,16,17,-1
7,5,79,26,30,-4
7,5,80,8,18,-10
7,5,81,26,19,7
7,5,82,3,15,-12
7,5,83,12,15,-3
7,5,84,12,22,-10
7,5,85,11,17,-6
7,5,86,10,10,0
7,5,87,12,15,-3
7,5,88,23,17,6
7,5,89,18,12,6
7,5,90,10,9,1
7,5,91,11,8,3
7,5,92,17,13,4
7,5,93,9,21,-12
7,5,94,10,8,2
7,5,95,14,11,3
7,5,96,11,9,2
7,5,97,10,12,-2
7,5,98,11,11,0
7,5,99,6,3,3
7,5,100,23,9,14
7,5,101,9,15,-6
7,5,102,9,14,-5
7,5,103,14,16,-2
7,5,104,12,7,5
7,5,105,6,7,-1
7,5,106,22,17,5
7,5,107,11,16,-5
7,5,108,15,16,-1
7,5,109,22,21,1
7,5,110,10,12,-2
7,5,111,5,24,-19
7,5,112,8,9,-1
7,5,113,14,14,0
7,5,114,28,26,2
7,5,115,15,23,-8
7,5,116,14,6,8
7,5,117,17,18,-1
7,5,118,8,10,-2
7,5,119,11,19,-8
7,5,120,10,20,-10
7,5,121,8,6,2
7,5,122,6,18,-12
7,5,123,4,16,-12
7,5,124,13,18,-5
7,5,125,12,13,-1
7,5,126,8,17,-9
7,5,127,17,16,1
7,5,128,11,13,-2
7,5,129,11,14,-3
7,5,130,13,18,-5
7,5,131,12,28,-16
7,5,132,13,14,-1
7,5,133,12,11,1
7,5,134,10,14,-4
7,5,135,14,8,6
7,5,136,8,11,-3
7,5,137,12,20,-8
7,5,138,3,3,0
7,5,139,17,13,4
7,5,140,13,13,0
7,5,141,12,9,3
7,5,142,10,22,-12
7,5,143,12,18,-6
7,5,144,8,8,0
7,5,145,13,16,-3
7,5,146,12,16,-4
7,5,147,14,14,0
7,5,148,17,17,0
7,5,149,29,35,-6
7,5,150,9,12,-3
7,5,151,7,6,1
7,5,152,11,23,-12
7,5,153,13,20,-7
7,5,154,5,14,-9
7,5,155,13,15,-2
7,5,156,5,16,-11
7,5,157,9,23,-14
7,5,158,18,13,5
7,5,159,16,13,3
7,5,160,12,11,1
7,5,161,8,9,-1
7,5,162,4,15,-11
7,5,163,8,9,-1
7,5,164,8,16,-8
7,5,165,17,14,3
7,5,166,14,16,-2
7,5,167,21,11,10
7,5,168,24,34,-10
7,5,169,4,13,-9
7,5,170,10,17,-7
7,5,171,9,11,-2
7,5,172,18,27,-9
7,5,173,12,6,6
7,5,174,28,23,5
7,5,175,9,11,-2
7,5,176,15,17,-2
7,5,177,14,31,-17
7,5,178,14,17,-3
7,5,179,7,24,-17
7,5,180,12,10,2
7,5,181,15,18,-3
7,5,182,14,19,-5
7,5,183,14,16,-2
7,5,184,14,10,4
7,5,185,16,18,-2
7,5,186,7,8,-1
7,5,187,9,8,1
7,5,188,19,16,3
7,5,189,15,13,2
7,5,190,11,11,0
7,5,191,20,19,1
7,5,192,12,13,-1
7,5,193,19,30,-11
7,5,194,18,15,3
7,5,195,21,27,-6
7,5,196,9,4,5
7,5,197,12,9,3
7,5,198,12,18,-6
7,5,199,7,29,-22
7,5,200,10,10,0
7,5,201,13,13,0
7,5,202,20,16,4
7,5,203,5,9,-4
7,5,204,4,8,-4
7,5,205,8,19,-11
7,5,206,15,12,3
7,5,207,16,16,0
7,5,208,14,7,7
7,5,209,9,26,-17
7,5,210,18,12,6
7,5,211,14,9,5
7,5,212,4,10,-6
7,5,213,18,31,-13
7,5,214,6,14,-8
7,5,215,15,26,-11
7,5,216,12,37,-25
7,5,217,7,12,-5
7,5,218,19,15,4
7,5,219,11,12,-1
7,5,220,5,14,-9
7,5,221,15,14,1
7,5,222,19,11,8
7,5,223,10,6,4
7,5,224,12,8,4
7,5,225,11,15,-4
7,5,226,4,18,-14
7,5,227,21,14,7
7,5,228,15,12,3
7,5,229,9,32,-23
7,5,230,13,24,-11
7,5,231,9,7,2
7,5,232,5,9,-4
7,5,233,11,7,4
7,5,234,12,17,-5
7,5,235,12,19,-7
7,5,236,9,25,-16
7,5,237,16,9,7
7,5,238,15,16,-1
7,5,239,18,10,8
7,5,240,10,3,7
7,5,241,10,13,-3
7,5,242,9,17,-8
7,5,243,16,5,11
7,5,244,15,16,-1
7,5,245,19,19,0
7,5,246,20,12,8
7,5,247,19,21,-2
7,5,248,8,16,-8
7,5,249,18,17,1
7,5,250,15,11,4
7,5,251,19,14,5
7,5,252,11,9,2
7,5,253,19,32,-13
7,5,254,16,22,-6
7,5,255,13,16,-3
7,5,256,31,18,13
7,5,257,13,10,3
7,5,258,6,9,-3
7,5,259,12,13,-1
7,5,260,5,5,0
7,5,261,14,11,3
7,5,262,12,21,-9
7,5,263,16,14,2
7,5,264,16,13,3
7,5,265,18,10,8
7,5,266,13,13,0
7,5,267,8,17,-9
7,5,268,9,5,4
7,5,269,10,16,-6
7,5,270,19,25,-6
7,5,271,19,12,7
7,5,272,14,17,-3
7,5,273,12,9,3
7,5,274,35,20,15
7,5,275,30,18,12
7,5,276,6,9,-3
7,5,277,17,14,3
7,5,278,26,8,18
7,5,279,23,20,3
7,5,280,20,5,15
7,5,281,3,8,-5
7,5,282,5,9,-4
7,5,283,9,9,0
7,5,284,18,17,1
7,5,285,17,14,3
7,5,286,6,8,-2
7,5,287,22,24,-2
7,5,288,18,27,-9
7,5,289,17,22,-5
7,5,290,8,5,3
7,5,291,16,14,2
7,5,292,18,15,3
7,5,293,5,7,-2
7,5,294,10,8,2
7,5,295,25,8,17
7,5,296,20,14,6
7,5,297,14,15,-1
7,5,298,15,16,-1
7,5,299,12,8,4
7,6,0,12,27,-15
7,6,1,10,20,-10
7,6,2,4,10,-6
7,6,3,17,17,0
7,6,4,9,13,-4
7,6,5,14,8,6
7,6,6,5,9,-4
7,6,7,9,13,-4
7,6,8,8,12,-4
7,6,9,12,18,-6
7,6,10,5,12,-7
7,6,11,18,11,7
7,6,12,35,8,27
7,6,13,8,2,6
7,6,14,10,14,-4
7,6,15,17,22,-5
7,6,16,18,16,2
7,6,17,9,11,-2
7,6,18,6,9,-3
7,6,19,10,12,-2
7,6,20,2,6,-4
7,6,21,5,13,-8
7,6,22,7,16,-9
7,6,23,7,20,-13
7,6,24,10,18,-8
7,6,25,7,10,-3
7,6,26,8,11,-3
7,6,27,3,11,-8
7,6,28,11,8,3
7,6,29,14,15,-1
7,6,30,20,11,9
7,6,31,13,10,3
7,6,32,11,16,-5
7,6,33,8,11,-3
7,6,34,8,15,-7
7,6,35,6,11,-5
7,6,36,18,20,-2
7,6,37,18,10,8
7,6,38,13,32,-19
7,6,39,13,13,0
7,6,40,16,24,-8
7,6,41,8,11,-3
7,6,42,4,11,-7
7,6,43,14,13,1
7,6,44,8,18,-10
7,6,45,14,10,4
7,6,46,15,21,-6
7,6,47,19,19,0
7,6,48,16,16,0
7,6,49,15,26,-11
7,6,50,9,16,-7
7,6,51,7,6,1
7,6,52,5,10,-5
7,6,53,14,18,-4
7,6,54,10,10,0
7,6,55,9,10,-1
7,6,56,9,4,5
7,6,57,8,4,4
7,6,58,19,22,-3
7,6,59,20,12,8
7,6,60,9,6,3
7,6,61,9,13,-4
7,6,62,20,19,1
7,6,63,10,23,-13
7,6,64,4,18,-14
7,6,65,11,18,-7
7,6,66,20,14,6
7,6,67,12,19,-7
7,6,68,16,18,-2
7,6,69,27,26,1
7,6,70,12,13,-1
7,6,71,17,16,1
7,6,72,10,6,4
7,6,73,7,6,1
7,6,74,20,25,-5
7,6,75,20,14,6
7,6,76,26,14,12
7,6,77,19,13,6
7,6,78,11,13,-2
7,6,79,21,15,6
7,6,80,12,23,-11
7,6,81,21,13,8
7,6,82,25,22,3
7,6,83,15,31,-16
7,6,84,27,17,10
7,6,85,8,18,-10
7,6,86,14,9,5
7,6,87,11,21,-10
7,6,88,15,23,-8
7,6,89,16,14,2
7,6,90,8,16,-8
7,6,91,18,20,-2
7,6,92,15,23,-8
7,6,93,4,8,-4
7,6,94,20,18,2
7,6,95,11,10,1
7,6,96,10,20,-10
7,6,97,9,13,-4
7,6,98,4,18,-14
7,6,99,14,20,-6
7,6,100,12,13,-1
7,6,101,6,7,-1
7,6,102,13,11,2
7,6,103,8,19,-11
7,6,104,10,14,-4
7,6,105,6,12,-6
7,6,106,17,16,1
7,6,107,28,26,2
7,6,108,18,15,3
7,6,109,14,19,-5
7,6,110,6,14,-8
7,6,111,6,4,2
7,6,112,10,12,-2
7,6,113,15,24,-9
7,6,114,8,1,7
7,6,115,10,9,1
7,6,116,9,14,-5
7,6,117,14,28,-14
7,6,118,6,11,-5
7,6,119,31,5,26
7,6,120,16,18,-2
7,6,121,24,20,4
7,6,122,12,12,0
7,6,123,12,14,-2
7,6,124,8,15,-7
7,6,125,5,4,1
7,6,126,23,13,10
7,6,127,9,18,-9
7,6,128,27,8,19
7,6,129,10,9,1
7,6,130,15,15,0
7,6,131,12,25,-13
7,6,132,10,16,-6
7,6,133,10,17,-7
7,6,134,22,32,-10
7,6,135,6,10,-4
7,6,136,23,10,13
7,6,137,13,16,-3
7,6,138,18,12,6
7,6,139,5,8,-3
7,6,140,4,5,-1
7,6,141,19,13,6
7,6,142,10,8,2
7,6,143,18,12,6
7,6,144,20,17,3
7,6,145,7,19,-12
7,6,146,5,8,-3
7,6,147,11,23,-12
7,6,148,18,16,2
7,6,149,20,13,7
7,6,150,18,25,-7
7,6,151,21,13,8
7,6,152,16,6,10
7,6,153,8,9,-1
7,6,154,8,9,-1
7,6,155,15,29,-14
7,6,156,4,11,-7
7,6,157,12,12,0
7,6,158,21,14,7
7,6,159,16,28,-12
7,6,160,14,11,3
7,6,161,11,13,-2
7,6,162,12,9,3
7,6,163,5,13,-8
7,6,164,13,9,4
7,6,165,19,16,3
7,6,166,10,12,-2
7,6,167,22,31,-9
7,6,168,10,17,-7
7,6,169,11,13,-2
7,6,170,12,15,-3
7,6,171,20,6,14
7,6,172,7,8,-1
7,6,173,19,10,9
7,6,174,16,14,2
7,6,175,9,8,1
7,6,176,21,22,-1
7,6,177,7,10,-3
7,6,178,11,12,-1
7,6,179,23,33,-10
7,6,180,15,10,5
7,6,181,8,5,3
7,6,182,8,16,-8
7,6,183,22,31,-9
7,6,184,23,28,-5
7,6,185,14,13,1
7,6,186,16,10,6
7,6,187,10,11,-1
7,6,188,11,13,-2
7,6,189,7,6,1
7,6,190,27,8,19
7,6,191,13,7,6
7,6,192,11,15,-4
7,6,193,9,13,-4
7,6,194,17,14,3
7,6,195,13,9,4
7,6,196,15,4,11
7,6,197,11,20,-9
7,6,198,18,14,4
7,6,199,8,15,-7
7,6,200,6,7,-1
7,6,201,8,11,-3
7,6,202,13,13,0
7,6,203,7,11,-4
7,6,204,17,14,3
7,6,205,11,13,-2
7,6,206,12,7,5
7,6,207,11,9,2
7,6,208,10,10,0
7,6,209,9,17,-8
7,6,210,9,8,1
7,6,211,12,29,-17
7,6,212,4,16,-12
7,6,213,13,12,1
7,6,214,10,15,-5
7,6,215,8,16,-8
7,6,216,15,9,6
7,6,217,15,16,-1
7,6,218,27,19,8
7,6,219,23,10,13
7,6,220,7,11,-4
7,6,221,18,7,11
7,6,222,12,9,3
7,6,223,11,4,7
7,6,224,17,11,6
7,6,225,10,12,-2
7,6,226,12,17,-5
7,6,227,12,13,-1
7,6,228,30,31,-1
7,6,229,13,30,-17
7,6,230,18,12,6
7,6,231,14,10,4
7,6,232,1,7,-6
7,6,233,10,7,3
7,6,234,8,11,-3
7,6,235,21,30,-9
7,6,236,5,9,-4
7,6,237,4,6,-2
7,6,238,4,15,-11
7,6,239,21,7,14
7,6,240,18,13,5
7,6,241,14,8,6
7,6,242,15,12,3
7,6,243,18,14,4
7,6,244,15,13,2
7,6,245,23,9,14
7,6,246,18,10,8
7,6,247,9,12,-3
7,6,248,27,26,1
7,6,249,13,28,-15
7,6,250,9,20,-11
7,6,251,9,11,-2
7,6,252,15,23,-8
7,6,253,7,6,1
7,6,254,26,19,7
7,6,255,16,30,-14
7,6,256,10,17,-7
7,6,257,21,21,0
7,6,258,9,5,4
7,6,259,10,4,6
7,6,260,4,11,-7
7,6,261,22,15,7
7,6,262,15,20,-5
7,6,263,12,22,-10
7,6,264,10,13,-3
7,6,265,9,10,-1
7,6,266,12,21,-9
7,6,267,10,23,-13
7,6,268,7,10,-3
7,6,269,15,12,3
7,6,270,24,14,10
7,6,271,9,14,-5
7,6,272,19,26,-7
7,6,273,18,29,-11
7,6,274,13,16,-3
7,6,275,16,18,-2
7,6,276,16,14,2
7,6,277,11,8,3
7,6,278,15,14,1
7,6,279,11,8,3
7,6,280,10,15,-5
7,6,281,16,26,-10
7,6,282,9,13,-4
7,6,283,15,12,3
7,6,284,13,12,1
7,6,285,9,8,1
7,6,286,21,24,-3
7,6,287,19,22,-3
7,6,288,7,10,-3
7,6,289,12,22,-10
7,6,290,20,13,7
7,6,291,16,25,-9
7,6,292,14,9,5
7,6,293,15,21,-6
7,6,294,16,14,2
7,6,295,8,16,-8
7,6,296,13,13,0
7,6,297,9,16,-7
7,6,298,11,11,0
7,6,299,15,15,0
7,7,0,11,7,4
7,7,1,15,15,0
7,7,2,17,38,-21
7,7,3,7,11,-4
7,7,4,20,14,6
7,7,5,9,13,-4
7,7,6,6,9,-3
7,7,7,25,13,12
7,7,8,19,19,0
7,7,9,18,13,5
7,7,10,19,14,5
7,7,11,7,15,-8
7,7,12,12,9,3
7,7,13,18,16,2
7,7,14,9,26,-17
7,7,15,20,26,-6
7,7,16,20,23,-3
7,7,17,18,9,9
7,7,18,19,16,3
7,7,19,17,17,0
7,7,20,17,9,8
7,7,21,8,8,0
7,7,22,10,12,-2
7,7,23,3,7,-4
7,7,24,11,23,-12
7,7,25,14,18,-4
7,7,26,8,24,-16
7,7,27,13,18,-5
7,7,28,14,17,-3
7,7,29,23,14,9
7,7,30,7,14,-7
7,7,31,16,17,-1
7,7,32,15,20,-5
7,7,33,6,4,2
7,7,34,12,19,-7
7,7,35,15,17,-2
7,7,36,10,8,2
7,7,37,16,20,-4
7,7,38,12,6,6
7,7,39,8,8,0
7,7,40,11,7,4
7,7,41,12,19,-7
7,7,42,14,16,-2
7,7,43,13,11,2
7,7,44,4,6,-2
7,7,45,31,24,7
7,7,46,8,7,1
7,7,47,13,17,-4
7,7,48,9,15,-6
7,7,49,16,24,-8
7,7,50,11,16,-5
7,7,51,23,11,12
7,7,52,14,17,-3
7,7,53,12,21,-9
7,7,54,14,17,-3
7,7,55,14,6,8
7,7,56,25,29,-4
7,7,57,8,16,-8
7,7,58,9,21,-12
7,7,59,12,3,9
7,7,60,11,5,6
7,7,61,24,18,6
7,7,62,20,19,1
7,7,63,16,11,5
7,7,64,14,20,-6
7,7,65,12,12,0
7,7,66,8,5,3
7,7,67,16,12,4
7,7,68,14,12,2
7,7,69,25,20,5
7,7,70,18,14,4
7,7,71,14,11,3
7,7,72,12,12,0
7,7,73,13,10,3
7,7,74,24,14,10
7,7,75,12,12,0
7,7,76,15,20,-5
7,7,77,15,10,5
7,7,78,17,11,6
7,7,79,7,11,-4
7,7,80,21,18,3
7,7,81,17,9,8
7,7,82,15,12,3
7,7,83,14,27,-13
7,7,84,19,20,-1
7,7,85,15,16,-1
7,7,86,14,17,-3
7,7,87,22,19,3
7,7,88,31,18,13
7,7,89,11,8,3
7,7,90,16,6,10
7,7,91,6,7,-1
7,7,92,10,23,-13
7,7,93,14,16,-2
7,7,94,23,21,2
7,7,95,25,16,9
7,7,96,18,14,4
7,7,97,16,9,7
7,7,98,15,22,-7
7,7,99,12,23,-11
7,7,100,4,16,-12
7,7,101,16,6,10
7,7,102,3,4,-1
7,7,103,22,28,-6
7,7,104,13,29,-16
7,7,105,10,8,2
7,7,106,12,14,-2
7,7,107,14,11,3
7,7,108,22,13,9
7,7,109,17,15,2
7,7,110,8,10,-2
7,7,111,15,27,-12
7,7,112,18,9,9
7,7,113,20,27,-7
7,7,114,17,15,2
7,7,115,21,15,6
7,7,116,20,22,-2
7,7,117,13,21,-8
7,7,118,18,22,-4
7,7,119,8,17,-9
7,7,120,21,20,1
7,7,121,10,13,-3
7,7,122,7,8,-1
7,7,123,7,14,-7
7,7,124,11,16,-5
7,7,125,4,11,-7
7,7,126,9,12,-3
7,7,127,23,13,10
7,7,128,21,10,11
7,7,129,19,16,3
7,7,130,11,14,-3
7,7,131,26,19,7
7,7,132,8,13,-5
7,7,133,24,3,21
7,7,134,2,8,-6
7,7,135,20,13,7
7,7,136,8,13,-5
7,7,137,22,17,5
7,7,138,17,21,-4
7,7,139,8,7,1
7,7,140,23,24,-1
7,7,141,20,21,-1
7,7,142,13,7,6
7,7,143,12,13,-1
7,7,144,17,9,8
7,7,145,11,11,0
7,7,146,23,15,8
7,7,147,17,11,6
7,7,148,12,9,3
7,7,149,24,21,3
7,7,150,11,26,-15
7,7,151,28,19,9
7,7,152,15,12,3
7,7,153,11,16,-5
7,7,154,12,16,-4
7,7,155,14,18,-4
7,7,156,3,14,-11
7,7,157,14,15,-1
7,7,158,15,20,-5
7,7,159,11,13,-2
7,7,160,17,15,2
7,7,161,15,8,7
7,7,162,17,18,-1
7,7,163,20,19,1
7,7,164,18,23,-5
7,7,165,8,11,-3
7,7,166,5,9,-4
7,7,167,18,19,-1
7,7,168,15,11,4
7,7,169,12,8,4
7,7,170,12,19,-7
7,7,171,27,32,-5
7,7,172,5,8,-3
7,7,173,13,23,-10
7,7,174,19,18,1
7,7,175,11,17,-6
7,7,176,7,11,-4
7,7,177,12,18,-6
7,7,178,13,9,4
7,7,179,13,14,-1
7,7,180,16,9,7
7,7,181,14,16,-2
7,7,182,14,4,10
7,7,183,10,9,1
7,7,184,14,17,-3
7,7,185,16,19,-3
7,7,186,12,10,2
7,7,187,8,16,-8
7,7,188,7,18,-11
7,7,189,23,9,14
7,7,190,10,10,0
7,7,191,5,10,-5
7,7,192,17,15,2
7,7,193,14,11,3
7,7,194,18,24,-6
7,7,195,14,16,-2
7,7,196,6,13,-7
7,7,197,9,15,-6
7,7,198,12,24,-12
7,7,199,23,9,14
7,7,200,13,6,7
7,7,201,19,9,10
7,7,202,24,22,2
7,7,203,13,17,-4
7,7,204,19,23,-4
7,7,205,21,9,12
7,7,206,17,37,-20
7,7,207,6,16,-10
7,7,208,12,17,-5
7,7,209,14,22,-8
7,7,210,13,15,-2
7,7,211,12,11,1
7,7,212,13,21,-8
7,7,213,9,13,-4
7,7,214,17,16,1
7,7,215,8,16,-8
7,7,216,15,17,-2
7,7,217,22,17,5
7,7,218,18,10,8
7,7,219,12,8,4
7,7,220,15,21,-6
7,7,221,21,21,0
7,7,222,13,19,-6
7,7,223,23,25,-2
7,7,224,6,9,-3
7,7,225,6,11,-5
7,7,226,21,29,-8
7,7,227,6,10,-4
7,7,228,23,15,8
7,7,229,14,13,1
7,7,230,12,7,5
7,7,231,7,25,-18
7,7,232,19,10,9
7,7,233,15,14,1
7,7,234,13,9,4
7,7,235,19,16,3
7,7,236,20,10,10
7,7,237,11,4,7
7,7,238,14,8,6
7,7,239,10,24,-14
7,7,240,21,23,-2
7,7,241,6,10,-4
7,7,242,28,17,11
7,7,243,12,21,-9
7,7,244,23,31,-8
7,7,245,21,20,1
7,7,246,27,20,7
7,7,247,20,23,-3
7,7,248,17,10,7
7,7,249,15,20,-5
7,7,250,22,28,-6
7,7,251,11,12,-1
7,7,252,10,14,-4
7,7,253,21,16,5
7,7,254,9,8,1
7,7,255,7,7,0
7,7,256,25,19,6
7,7,257,17,19,-2
7,7,258,17,11,6
7,7,259,20,17,3
7,7,260,9,15,-6
7,7,261,10,10,0
7,7,262,13,15,-2
7,7,263,9,6,3
7,7,264,22,26,-4
7,7,265,11,17,-6
7,7,266,8,11,-3
7,7,267,14,8,6
7,7,268,15,20,-5
7,7,269,11,8,3
7,7,270,9,8,1
7,7,271,11,23,-12
7,7,272,17,21,-4
7,7,273,22,15,7
7,7,274,11,27,-16
7,7,275,14,18,-4
7,7,276,12,11,1
7,7,277,16,19,-3
7,7,278,11,15,-4
7,7,279,14,17,-3
7,7,280,14,18,-4
7,7,281,17,21,-4
7,7,282,13,16,-3
7,7,283,26,9,17
7,7,284,14,16,-2
7,7,285,14,12,2
7,7,286,15,7,8
7,7,287,18,22,-4
7,7,288,7,19,-12
7,7,289,22,14,8
7,7,290,14,15,-1
7,7,291,12,14,-2
7,7,292,18,13,5
7,7,293,17,12,5
7,7,294,19,19,0
7,7,295,10,18,-8
7,7,296,5,10,-5
7,7,297,10,16,-6
7,7,298,15,19,-4
7,7,299,20,23,-3
7,8,0,14,26,-12
7,8,1,7,15,-8
7,8,2,7,10,-3
7,8,3,15,14,1
7,8,4,7,17,-10
7,8,5,10,28,-18
7,8,6,14,11,3
7,8,7,8,13,-5
7,8,8,10,20,-10
7,8,9,4,8,-4
7,8,10,11,7,4
7,8,11,22,17,5
7,8,12,8,6,2
7,8,13,12,19,-7
7,8,14,9,16,-7
7,8,15,10,16,-6
7,8,16,19,18,1
7,8,17,17,16,1
7,8,18,22,7,15
7,8,19,13,12,1
7,8,20,16,20,-4
7,8,21,17,16,1
7,8,22,28,15,13
7,8,23,11,9,2
7,8,24,18,28,-10
7,8,25,19,13,6
7,8,26,18,13,5
7,8,27,6,8,-2
7,8,28,8,12,-4
7,8,29,10,15,-5
7,8,30,22,17,5
7,8,31,10,19,-9
7,8,32,17,19,-2
7,8,33,21,20,1
7,8,34,11,18,-7
7,8,35,16,20,-4
7,8,36,15,26,-11
7,8,37,20,15,5
7,8,38,4,3,1
7,8,39,5,5,0
7,8,40,18,13,5
7,8,41,17,15,2
7,8,42,6,9,-3
7,8,43,11,21,-10
7,8,44,20,18,2
7,8,45,17,11,6
7,8,46,9,5,4
7,8,47,9,12,-3
7,8,48,14,14,0
7,8,49,25,18,7
7,8,50,13,6,7
7,8,51,13,15,-2
7,8,52,12,11,1
7,8,53,16,11,5
7,8,54,25,14,11
7,8,55,14,3,11
7,8,56,5,16,-11
7,8,57,15,13,2
7,8,58,13,19,-6
7,8,59,9,7,2
7,8,60,15,27,-12
7,8,61,11,7,4
7,8,62,11,13,-2
7,8,63,16,15,1
7,8,64,6,14,-8
7,8,65,7,16,-9
7,8,66,29,19,10
7,8,67,22,21,1
7,8,68,8,8,0
7,8,69,9,10,-1
7,8,70,18,7,11
7,8,71,23,25,-2
7,8,72,18,15,3
7,8,73,7,22,-15
7,8,74,23,15,8
7,8,75,15,13,2
7,8,76,11,13,-2
7,8,77,18,8,10
7,8,78,7,10,-3
7,8,79,12,10,2
7,8,80,20,5,15
7,8,81,8,8,0
7,8,82,16,8,8
7,8,83,4,9,-5
7,8,84,23,27,-4
7,8,85,13,23,-10
7,8,86,15,15,0
7,8,87,15,12,3
7,8,88,8,11,-3
7,8,89,7,14,-7
7,8,90,12,23,-11
7,8,91,15,16,-1
7,8,92,11,28,-17
7,8,93,22,15,7
7,8,94,9,10,-1
7,8,95,12,14,-2
7,8,96,16,20,-4
7,8,97,16,8,8
7,8,98,13,25,-12
7,8,99,20,14,6
7,8,100,8,7,1
7,8,101,14,13,1
7,8,102,15,14,1
7,8,103,11,9,2
7,8,104,16,13,3
7,8,105,7,12,-5
7,8,106,8,8,0
7,8,107,15,13,2
7,8,108,10,18,-8
7,8,109,18,12,6
7,8,110,6,19,-13
7,8,111,19,17,2
7,8,112,13,21,-8
7,8,113,15,8,7
7,8,114,15,9,6
7,8,115,13,21,-8
7,8,116,10,7,3
7,8,117,12,28,-16
7,8,118,11,6,5
7,8,119,15,20,-5
7,8,120,12,19,-7
7,8,121,28,28,0
7,8,122,13,10,3
7,8,123,15,13,2
7,8,124,11,9,2
7,8,125,10,13,-3
7,8,126,17,30,-13
7,8,127,16,12,4
7,8,128,10,12,-2
7,8,129,15,13,2
7,8,130,9,11,-2
7,8,131,16,17,-1
7,8,132,11,16,-5
7,8,133,16,15,1
7,8,134,6,7,-1
7,8,135,5,4,1
7,8,136,10,14,-4
7,8,137,16,11,5
7,8,138,26,15,11
7,8,139,8,26,-18
7,8,140,23,24,-1
7,8,141,6,4,2
7,8,142,19,11,8
7,8,143,12,18,-6
7,8,144,15,21,-6
7,8,145,6,9,-3
7,8,146,23,15,8
7,8,147,19,18,1
7,8,148,16,15,1
7,8,149,23,30,-7
7,8,150,11,21,-10
7,8,151,23,19,4
7,8,152,11,6,5
7,8,153,17,10,7
7,8,154,15,16,-1
7,8,155,14,26,-12
7,8,156,6,12,-6
7,8,157,13,21,-8
7,8,158,22,17,5
7,8,159,23,19,4
7,8,160,15,12,3
7,8,161,8,15,-7
7,8,162,15,22,-7
7,8,163,7,19,-12
7,8,164,16,33,-17
7,8,165,28,14,14
7,8,166,4,5,-1
7,8,167,13,11,2
7,8,168,14,16,-2
7,8,169,12,8,4
7,8,170,22,19,3
7,8,171,11,22,-11
7,8,172,12,15,-3
7,8,173,12,19,-7
7,8,174,16,24,-8
7,8,175,10,12,-2
7,8,176,13,9,4
7,8,177,28,12,16
7,8,178,10,9,1
7,8,179,15,16,-1
7,8,180,18,8,10
7,8,181,12,27,-15
7,8,182,11,18,-7
7,8,183,13,16,-3
7,8,184,12,18,-6
7,8,185,13,17,-4
7,8,186,23,19,4
7,8,187,18,19,-1
7,8,188,20,16,4
7,8,189,17,34,-17
7,8,190,12,16,-4
7,8,191,5,8,-3
7,8,192,12,16,-4
7,8,193,25,32,-7
7,8,194,17,14,3
7,8,195,9,13,-4
7,8,196,17,13,4
7,8,197,11,14,-3
7,8,198,12,17,-5
7,8,199,21,28,-7
7,8,200,12,13,-1
7,8,201,13,13,0
7,8,202,8,14,-6
7,8,203,7,6,1
7,8,204,9,29,-20
7,8,205,8,14,-6
7,8,206,17,16,1
7,8,207,10,21,-11
7,8,208,9,3,6
7,8,209,22,13,9
7,8,210,20,17,3
7,8,211,15,15,0
7,8,212,11,23,-12
7,8,213,9,9,0
7,8,214,4,11,-7
7,8,215,12,19,-7
7,8,216,9,27,-18
7,8,217,19,12,7
7,8,218,23,17,6
7,8,219,17,16,1
7,8,220,18,19,-1
7,8,221,12,15,-3
7,8,222,22,34,-12
7,8,223,13,20,-7
7,8,224,6,19,-13
7,8,225,11,8,3
7,8,226,23,14,9
7,8,227,14,7,7
7,8,228,12,20,-8
7,8,229,19,17,2
7,8,230,10,18,-8
7,8,231,16,13,3
7,8,232,18,15,3
7,8,233,1,9,-8
7,8,234,14,12,2
7,8,235,6,4,2
7,8,236,15,16,-1
7,8,237,23,23,0
7,8,238,13,13,0
7,8,239,8,22,-14
7,8,240,10,7,3
7,8,241,12,27,-15
7,8,242,16,13,3
7,8,243,10,10,0
7,8,244,4,10,-6
7,8,245,15,17,-2
7,8,246,14,12,2
7,8,247,17,16,1
7,8,248,7,12,-5
7,8,249,20,18,2
7,8,250,13,16,-3
7,8,251,22,15,7
7,8,252,11,11,0
7,8,253,11,24,-13
7,8,254,14,26,-12
7,8,255,18,15,3
7,8,256,4,7,-3
7,8,257,16,12,4
7,8,258,16,6,10
7,8,259,11,7,4
7,8,260,9,10,-1
7,8,261,14,12,2
7,8,262,21,12,9
7,8,263,9,14,-5
7,8,264,13,24,-11
7,8,265,21,18,3
7,8,266,5,15,-10
7,8,267,10,22,-12
7,8,268,14,21,-7
7,8,269,5,9,-4
7,8,270,15,15,0
7,8,271,21,14,7
7,8,272,7,11,-4
7,8,273,17,24,-7
7,8,274,21,8,13
7,8,275,18,10,8
7,8,276,10,13,-3
7,8,277,15,20,-5
7,8,278,28,18,10
7,8,279,17,17,0
7,8,280,18,21,-3
7,8,281,29,18,11
7,8,282,9,20,-11
7,8,283,7,1,6
7,8,284,20,24,-4
7,8,285,15,13,2
7,8,286,13,25,-12
7,8,287,19,7,12
7,8,288,5,12,-7
7,8,289,8,17,-9
7,8,290,18,29,-11
7,8,291,14,13,1
7,8,292,7,11,-4
7,8,293,13,15,-2
7,8,294,8,17,-9
7,8,295,18,20,-2
7,8,296,13,24,-11
7,8,297,1,10,-9
7,8,298,12,2,10
7,8,299,11,4,7
7,9,0,31,12,19
7,9,1,9,17,-8
7,9,2,8,20,-12
7,9,3,16,6,10
7,9,4,30,21,9
7,9,5,16,15,1
7,9,6,14,21,-7
7,9,7,18,17,1
7,9,8,17,14,3
7,9,9,14,13,1
7,9,10,21,15,6
7,9,11,19,24,-5
7,9,12,21,15,6
7,9,13,24,24,0
7,9,14,13,6,7
7,9,15,12,22,-10
7,9,16,19,17,2
7,9,17,28,23,5
7,9,18,29,17,12
7,9,19,13,6,7
7,9,20,8,9,-1
7,9,21,22,30,-8
7,9,22,9,9,0
7,9,23,20,10,10
7,9,24,16,19,-3
7,9,25,9,11,-2
7,9,26,12,27,-15
7,9,27,7,9,-2
7,9,28,10,20,-10
7,9,29,1,7,-6
7,9,30,6,11,-5
7,9,31,13,7,6
7,9,32,7,6,1
7,9,33,23,13,10
7,9,34,19,11,8
7,9,35,22,27,-5
7,9,36,18,13,5
7,9,37,31,16,15
7,9,38,7,11,-4
7,9,39,17,12,5
7,9,40,19,24,-5
7,9,41,16,17,-1
7,9,42,15,9,6
7,9,43,14,22,-8
7,9,44,24,12,12
7,9,45,15,16,-1
7,9,46,19,18,1
7,9,47,4,11,-7
7,9,48,17,14,3
7,9,49,15,11,4
7,9,50,17,9,8
7,9,51,12,12,0
7,9,52,9,13,-4
7,9,53,14,19,-5
7,9,54,19,9,10
7,9,55,26,25,1
7,9,56,13,12,1
7,9,57,10,15,-5
7,9,58,14,27,-13
7,9,59,23,18,5
7,9,60,8,17,-9
7,9,61,14,16,-2
7,9,62,9,18,-9
7,9,63,12,13,-1
7,9,64,19,39,-20
7,9,65,12,16,-4
7,9,66,27,11,16
7,9,67,12,11,1
7,9,68,16,17,-1
7,9,69,10,11,-1
7,9,70,15,17,-2
7,9,71,18,9,9
7,9,72,12,16,-4
7,9,73,27,17,10
7,9,74,13,10,3
7,9,75,23,14,9
7,9,76,19,20,-1
7,9,77,8,10,-2
7,9,78,11,25,-14
7,9,79,9,16,-7
7,9,80,12,13,-1
7,9,81,10,14,-4
7,9,82,18,6,12
7,9,83,10,12,-2
7,9,84,11,12,-1
7,9,85,6,9,-3
7,9,86,25,13,12
7,9,87,12,15,-3
7,9,88,12,14,-2
7,9,89,7,19,-12
7,9,90,21,22,-1
7,9,91,4,15,-11
7,9,92,14,17,-3
7,9,93,20,11,9
7,9,94,15,25,-10
7,9,95,20,14,6
7,9,96,27,20,7
7,9,97,10,23,-13
7,9,98,10,13,-3
7,9,99,13,15,-2
7,9,100,11,15,-4
7,9,101,25,16,9
7,9,102,17,10,7
7,9,103,6,10,-4
7,9,104,12,8,4
7,9,105,19,21,-2
7,9,106,13,19,-6
7,9,107,7,12,-5
7,9,108,20,19,1
7,9,109,10,19,-9
7,9,110,30,11,19
7,9,111,15,22,-7
7,9,112,23,14,9
7,9,113,9,9,0
7,9,114,22,19,3
7,9,115,8,11,-3
7,9,116,11,25,-14
7,9,117,19,8,11
7,9,118,13,16,-3
7,9,119,17,15,2
7,9,120,10,17,-7
7,9,121,22,16,6
7,9,122,10,15,-5
7,9,123,31,26,5
7,9,124,33,20,13
7,9,125,14,15,-1
7,9,126,20,10,10
7,9,127,17,11,6
7,9,128,6,12,-6
7,9,129,13,33,-20
7,9,130,17,18,-1
7,9,131,23,19,4
7,9,132,13,21,-8
7,9,133,19,17,2
7,9,134,15,12,3
7,9,135,8,4,4
7,9,136,9,19,-10
7,9,137,14,14,0
7,9,138,33,16,17
7,9,139,17,19,-2
7,9,140,3,13,-10
7,9,141,3,8,-5
7,9,142,25,16,9
7,9,143,27,16,11
7,9,144,14,14,0
7,9,145,11,5,6
7,9,146,13,9,4
7,9,147,11,13,-2
7,9,148,10,7,3
7,9,149,1,9,-8
7,9,150,20,15,5
7,9,151,16,12,4
7,9,152,13,12,1
7,9,153,6,8,-2
7,9,154,23,11,12
7,9,155,13,8,5
7,9,156,13,5,8
7,9,157,24,9,15
7,9,158,12,11,1
7,9,159,19,15,4
7,9,160,20,14,6
7,9,161,26,16,10
7,9,162,7,11,-4
7,9,163,14,15,-1
7,9,164,9,21,-12
7,9,165,12,17,-5
7,9,166,17,15,2
7,9,167,21,21,0
7,9,168,12,16,-4
7,9,169,7,11,-4
7,9,170,17,3,14
7,9,171,10,5,5
7,9,172,11,20,-9
7,9,173,17,16,1
7,9,174,24,20,4
7,9,175,12,14,-2
7,9,176,10,11,-1
7,9,177,13,18,-5
7,9,178,26,14,12
7,9,179,19,13,6
7,9,180,7,17,-10
7,9,181,24,14,10
7,9,182,8,18,-10
7,9,183,8,27,-19
7,9,184,19,14,5
7,9,185,8,11,-3
7,9,186,13,13,0
7,9,187,28,13,15
7,9,188,41,21,20
7,9,189,16,10,6
7,9,190,17,9,8
7,9,191,20,14,6
7,9,192,21,17,4
7,9,193,10,9,1
7,9,194,20,17,3
7,9,195,16,20,-4
7,9,196,24,15,9
7,9,197,20,12,8
7,9,198,10,18,-8
7,9,199,29,26,3
7,9,200,10,10,0
7,9,201,11,9,2
7,9,202,12,12,0
7,9,203,12,14,-2
7,9,204,16,23,-7
7,9,205,8,9,-1
7,9,206,14,24,-10
7,9,207,28,29,-1
7,9,208,23,11,12
7,9,209,16,11,5
7,9,210,9,27,-18
7,9,211,8,7,1
7,9,212,31,18,13
7,9,213,14,14,0
7,9,214,20,24,-4
7,9,215,20,22,-2
7,9,216,32,13,19
7,9,217,13,13,0
7,9,218,6,10,-4
7,9,219,14,23,-9
7,9,220,12,28,-16
7,9,221,22,16,6
7,9,222,12,4,8
7,9,223,18,14,4
7,9,224,12,15,-3
7,9,225,18,10,8
7,9,226,13,17,-4
7,9,227,12,9,3
7,9,228,12,16,-4
7,9,229,9,11,-2
7,9,230,6,9,-3
7,9,231,9,10,-1
7,9,232,22,15,7
7,9,233,26,28,-2
7,9,234,11,7,4
7,9,235,12,4,8
7,9,236,10,8,2
7,9,237,19,14,5
7,9,238,18,12,6
7,9,239,14,19,-5
7,9,240,20,11,9
7,9,241,28,21,7
7,9,242,17,8,9
7,9,243,14,20,-6
7,9,244,6,11,-5
7,9,245,17,9,8
7,9,246,8,11,-3
7,9,247,17,17,0
7,9,248,18,10,8
7,9,249,9,11,-2
7,9,250,9,15,-6
7,9,251,9,10,-1
7,9,252,12,16,-4
7,9,253,15,26,-11
7,9,254,14,18,-4
7,9,255,14,11,3
7,9,256,20,22,-2
7,9,257,17,17,0
7,9,258,17,8,9
7,9,259,15,13,2
7,9,260,18,13,5
7,9,261,23,16,7
7,9,262,28,24,4
7,9,263,11,27,-16
7,9,264,16,12,4
7,9,265,18,17,1
7,9,266,17,25,-8
7,9,267,20,17,3
7,9,268,13,19,-6
7,9,269,8,14,-6
7,9,270,5,12,-7
7,9,271,15,12,3
7,9,272,25,19,6
7,9,273,31,22,9
7,9,274,13,19,-6
7,9,275,18,15,3
7,9,276,19,19,0
7,9,277,22,8,14
7,9,278,14,17,-3
7,9,279,14,23,-9
7,9,280,15,12,3
7,9,281,14,21,-7
7,9,282,9,10,-1
7,9,283,17,19,-2
7,9,284,11,9,2
7,9,285,27,9,18
7,9,286,9,5,4
7,9,287,12,13,-1
7,9,288,13,17,-4
7,9,289,25,15,10
7,9,290,22,20,2
7,9,291,12,15,-3
7,9,292,14,7,7
7,9,293,12,10,2
7,9,294,16,25,-9
7,9,295,13,9,4
7,9,296,22,12,10
7,9,297,16,14,2
7,9,298,13,6,7
7,9,299,11,17,-6
7,10,0,21,19,2
7,10,1,29,14,15
7,10,2,2,13,-11
7,10,3,16,9,7
7,10,4,9,13,-4
7,10,5,18,20,-2
7,10,6,20,11,9
7,10,7,21,13,8
7,10,8,9,19,-10
7,10,9,8,5,3
7,10,10,13,20,-7
7,10,11,17,18,-1
7,10,12,15,25,-10
7,10,13,12,20,-8
7,10,14,11,6,5
7,10,15,13,8,5
7,10,16,15,21,-6
7,10,17,11,5,6
7,10,18,28,15,13
7,10,19,7,10,-3
7,10,20,17,24,-7
7,10,21,10,14,-4
7,10,22,20,14,6
7,10,23,24,15,9
7,10,24,2,17,-15
7,10,25,15,15,0
7,10,26,23,11,12
7,10,27,17,19,-2
7,10,28,14,10,4
7,10,29,22,27,-5
7,10,30,19,18,1
7,10,31,24,23,1
7,10,32,19,17,2
7,10,33,12,18,-6
7,10,34,5,10,-5
7,10,35,26,13,13
7,10,36,19,16,3
7,10,37,16,12,4
7,10,38,32,15,17
7,10,39,13,14,-1
7,10,40,14,18,-4
7,10,41,17,16,1
7,10,42,12,11,1
7,10,43,33,24,9
7,10,44,23,20,3
7,10,45,7,8,-1
7,10,46,8,10,-2
7,10,47,10,20,-10
7,10,48,20,18,2
7,10,49,20,15,5
7,10,50,20,10,10
7,10,51,10,9,1
7,10,52,24,19,5
7,10,53,16,24,-8
7,10,54,7,10,-3
7,10,55,10,11,-1
7,10,56,15,22,-7
7,10,57,22,4,18
7,10,58,13,18,-5
7,10,59,27,12,15
7,10,60,15,19,-4
7,10,61,15,3,12
7,10,62,16,16,0
7,10,63,14,18,-4
7,10,64,21,37,-16
7,10,65,13,22,-9
7,10,66,8,10,-2
7,10,67,9,9,0
7,10,68,16,12,4
7,10,69,13,9,4
7,10,70,18,6,12
7,10,71,12,21,-9
7,10,72,15,26,-11
7,10,73,11,15,-4
7,10,74,17,13,4
7,10,75,15,20,-5
7,10,76,13,20,-7
7,10,77,12,16,-4
7,10,78,14,13,1
7,10,79,17,13,4
7,10,80,18,6,12
7,10,81,18,9,9
7,10,82,15,9,6
7,10,83,19,14,5
7,10,84,14,14,0
7,10,85,26,11,15
7,10,86,25,20,5
7,10,87,14,11,3
7,10,88,12,11,1
7,10,89,22,16,6
7,10,90,11,14,-3
7,10,91,15,17,-2
7,10,92,20,16,4
7,10,93,21,21,0
7,10,94,9,6,3
7,10,95,12,23,-11
7,10,96,7,8,-1
7,10,97,30,15,15
7,10,98,15,25,-10
7,10,99,11,23,-12
7,10,100,2,11,-9
7,10,101,6,11,-5
7,10,102,17,8,9
7,10,103,19,10,9
7,10,104,18,18,0
7,10,105,19,20,-1
7,10,106,7,5,2
7,10,107,20,12,8
7,10,108,6,8,-2
7,10,109,15,9,6
7,10,110,10,14,-4
7,10,111,22,10,12
7,10,112,21,15,6
7,10,113,22,8,14
7,10,114,12,11,1
7,10,115,7,7,0
7,10,116,17,6,11
7,10,117,9,13,-4
7,10,118,10,30,-20
7,10,119,26,27,-1
7,10,120,18,12,6
7,10,121,31,18,13
7,10,122,7,18,-11
7,10,123,5,11,-6
7,10,124,16,13,3
7,10,125,9,11,-2
7,10,126,12,18,-6
7,10,127,2,16,-14
7,10,128,18,11,7
7,10,129,8,22,-14
7,10,130,15,7,8
7,10,131,12,15,-3
7,10,132,5,2,3
7,10,133,13,16,-3
7,10,134,18,15,3
7,10,135,11,15,-4
7,10,136,10,15,-5
7,10,137,10,11,-1
7,10,138,17,22,-5
7,10,139,19,9,10
7,10,140,26,26,0
7,10,141,10,4,6
7,10,142,15,13,2
7,10,143,13,8,5
7,10,144,17,18,-1
7,10,145,15,20,-5
7,10,146,11,12,-1
7,10,147,12,13,-1
7,10,148,9,13,-4
7,10,149,9,13,-4
7,10,150,11,13,-2
7,10,151,14,17,-3
7,10,152,15,13,2
7,10,153,20,12,8
7,10,154,15,38,-23
7,10,155,4,17,-13
7,10,156,19,28,-9
7,10,157,23,19,4
7,10,158,16,11,5
7,10,159,13,28,-15
7,10,160,18,19,-1
7,10,161,11,23,-12
7,10,162,21,5,16
7,10,163,9,16,-7
7,10,164,8,19,-11
7,10,165,11,21,-10
7,10,166,10,9,1
7,10,167,14,20,-6
7,10,168,16,11,5
7,10,169,22,18,4
7,10,170,12,19,-7
7,10,171,10,18,-8
7,10,172,4,10,-6
7,10,173,13,16,-3
7,10,174,10,12,-2
7,10,175,10,6,4
7,10,176,13,18,-5
7,10,177,13,18,-5
7,10,178,23,14,9
7,10,179,10,11,-1
7,10,180,9,10,-1
7,10,181,16,16,0
7,10,182,19,25,-6
7,10,183,23,19,4
7,10,184,11,10,1
7,10,185,9,6,3
7,10,186,11,17,-6
7,10,187,12,16,-4
7,10,188,14,12,2
7,10,189,17,4,13
7,10,190,26,8,18
7,10,191,16,19,-3
7,10,192,8,4,4
7,10,193,11,13,-2
7,10,194,25,15,10
7,10,195,13,9,4
7,10,196,19,16,3
7,10,197,15,20,-5
7,10,198,10,12,-2
7,10,199,13,10,3
7,10,200,7,5,2
7,10,201,5,10,-5
7,10,202,24,20,4
7,10,203,9,25,-16
7,10,204,17,23,-6
7,10,205,29,15,14
7,10,206,16,12,4
7,10,207,10,3,7
7,10,208,15,13,2
7,10,209,6,18,-12
7,10,210,17,15,2
7,10,211,13,15,-2
7,10,212,24,25,-1
7,10,213,12,8,4
7,10,214,15,13,2
7,10,215,15,16,-1
7,10,216,22,14,8
7,10,217,16,19,-3
7,10,218,16,21,-5
7,10,219,14,13,1
7,10,220,17,17,0
7,10,221,17,13,4
7,10,222,11,15,-4
7,10,223,18,8,10
7,10,224,25,21,4
7,10,225,12,19,-7
7,10,226,15,15,0
7,10,227,11,12,-1
7,10,228,22,7,15
7,10,229,12,10,2
7,10,230,20,19,1
7,10,231,19,22,-3
7,10,232,17,13,4
7,10,233,16,11,5
7,10,234,29,16,13
7,10,235,12,17,-5
7,10,236,15,20,-5
7,10,237,13,12,1
7,10,238,17,20,-3
7,10,239,11,15,-4
7,10,240,5,3,2
7,10,241,19,13,6
7,10,242,10,8,2
7,10,243,5,11,-6
7,10,244,12,18,-6
7,10,245,18,21,-3
7,10,246,23,15,8
7,10,247,23,13,10
7,10,248,10,8,2
7,10,249,13,28,-15
7,10,250,24,14,10
7,10,251,19,21,-2
7,10,252,16,12,4
7,10,253,11,12,-1
7,10,254,8,15,-7
7,10,255,8,7,1
7,10,256,19,8,11
7,10,257,18,19,-1
7,10,258,19,20,-1
7,10,259,7,14,-7
7,10,260,11,14,-3
7,10,261,8,12,-4
7,10,262,40,27,13
7,10,263,22,11,11
7,10,264,8,6,2
7,10,265,20,21,-1
7,10,266,17,24,-7
7,10,267,24,9,15
7,10,268,17,22,-5
7,10,269,18,5,13
7,10,270,19,14,5
7,10,271,7,5,2
7,10,272,14,19,-5
7,10,273,14,13,1
7,10,274,13,17,-4
7,10,275,7,8,-1
7,10,276,31,15,16
7,10,277,27,26,1
7,10,278,15,21,-6
7,10,279,12,20,-8
7,10,280,19,35,-16
7,10,281,25,21,4
7,10,282,5,7,-2
7,10,283,17,15,2
7,10,284,14,13,1
7,10,285,9,19,-10
7,10,286,10,27,-17
7,10,287,16,11,5
7,10,288,8,15,-7
7,10,289,9,21,-12
7,10,290,17,20,-3
7,10,291,10,15,-5
7,10,292,15,15,0
7,10,293,14,12,2
7,10,294,23,19,4
7,10,295,8,9,-1
7,10,296,17,17,0
7,10,297,20,22,-2
7,10,298,10,8,2
7,10,299,7,28,-21
7,11,0,13,8,5
7,11,1,15,18,-3
7,11,2,12,16,-4
7,11,3,17,17,0
7,11,4,20,14,6
7,11,5,13,10,3
7,11,6,7,6,1
7,11,7,15,13,2
7,11,8,9,21,-12
7,11,9,7,12,-5
7,11,10,3,5,-2
7,11,11,33,19,14
7,11,12,18,16,2
7,11,13,13,21,-8
7,11,14,14,26,-12
7,11,15,12,6,6
7,11,16,12,14,-2
7,11,17,28,17,11
7,11,18,9,11,-2
7,11,19,14,10,4
7,11,20,15,4,11
7,11,21,8,11,-3
7,11,22,8,10,-2
7,11,23,14,19,-5
7,11,24,21,22,-1
7,11,25,13,17,-4
7,11,26,17,14,3
7,11,27,31,18,13
7,11,28,5,18,-13
7,11,29,12,22,-10
7,11,30,13,15,-2
7,11,31,12,7,5
7,11,32,15,13,2
7,11,33,16,15,1
7,11,34,16,26,-10
7,11,35,9,10,-1
7,11,36,7,8,-1
7,11,37,12,18,-6
7,11,38,15,10,5
7,11,39,12,13,-1
7,11,40,6,2,4
7,11,41,12,4,8
7,11,42,15,21,-6
7,11,43,19,8,11
7,11,44,21,16,5
7,11,45,16,22,-6
7,11,46,16,8,8
7,11,47,23,22,1
7,11,48,18,25,-7
7,11,49,7,12,-5
7,11,50,12,7,5
7,11,51,14,15,-1
7,11,52,13,23,-10
7,11,53,16,11,5
7,11,54,8,14,-6
7,11,55,24,18,6
7,11,56,14,13,1
7,11,57,16,14,2
7,11,58,19,17,2
7,11,59,17,12,5
7,11,60,22,25,-3
7,11,61,14,12,2
7,11,62,27,11,16
7,11,63,15,21,-6
7,11,64,8,12,-4
7,11,65,6,14,-8
7,11,66,21,15,6
7,11,67,22,17,5
7,11,68,15,19,-4
7,11,69,20,9,11
7,11,70,7,6,1
7,11,71,19,24,-5
7,11,72,18,17,1
7,11,73,6,13,-7
7,11,74,16,13,3
7,11,75,20,11,9
7,11,76,9,25,-16
7,11,77,10,16,-6
7,11,78,13,15,-2
7,11,79,13,22,-9
7,11,80,20,18,2
7,11,81,32,18,14
7,11,82,37,23,14
7,11,83,15,8,7
7,11,84,9,15,-6
7,11,85,8,18,-10
7,11,86,18,16,2
7,11,87,12,5,7
7,11,88,20,19,1
7,11,89,18,8,10
7,11,90,16,10,6
7,11,91,7,6,1
7,11,92,6,19,-13
7,11,93,10,15,-5
7,11,94,8,15,-7
7,11,95,17,12,5
7,11,96,8,11,-3
7,11,97,22,11,11
7,11,98,16,8,8
7,11,99,17,13,4
7,11,100,9,14,-5
7,11,101,19,31,-12
7,11,102,13,4,9
7,11,103,20,11,9
7,11,104,18,16,2
7,11,105,16,5,11
7,11,106,28,11,17
7,11,107,16,18,-2
7,11,108,14,12,2
7,11,109,8,7,1
7,11,110,10,8,2
7,11,111,7,32,-25
7,11,112,15,19,-4
7,11,113,12,13,-1
7,11,114,19,21,-2
7,11,115,23,16,7
7,11,116,9,19,-10
7,11,117,13,16,-3
7,11,118,4,14,-10
7,11,119,20,17,3
7,11,120,13,11,2
7,11,121,10,18,-8
7,11,122,19,7,12
7,11,123,24,22,2
7,11,124,19,11,8
7,11,125,20,18,2
7,11,126,19,20,-1
7,11,127,11,20,-9
7,11,128,6,13,-7
7,11,129,16,12,4
7,11,130,15,26,-11
7,11,131,12,16,-4
7,11,132,28,17,11
7,11,133,8,5,3
7,11,134,16,17,-1
7,11,135,17,12,5
7,11,136,24,12,12
7,11,137,27,20,7
7,11,138,15,15,0
7,11,139,16,10,6
7,11,140,9,14,-5
7,11,141,11,11,0
7,11,142,20,14,6
7,11,143,25,10,15
7,11,144,7,20,-13
7,11,145,19,12,7
7,11,146,16,7,9
7,11,147,27,22,5
7,11,148,20,30,-10
7,11,149,7,9,-2
7,11,150,15,24,-9
7,11,151,14,17,-3
7,11,152,11,22,-11
7,11,153,4,12,-8
7,11,154,15,12,3
7,11,155,18,15,3
7,11,156,15,8,7
7,11,157,19,16,3
7,11,158,12,15,-3
7,11,159,15,8,7
7,11,160,20,11,9
7,11,161,17,11,6
7,11,162,24,16,8
7,11,163,8,7,1
7,11,164,12,12,0
7,11,165,7,11,-4
7,11,166,10,12,-2
7,11,167,13,9,4
7,11,168,11,8,3
7,11,169,11,16,-5
7,11,170,18,17,1
7,11,171,6,15,-9
7,11,172,19,32,-13
7,11,173,10,10,0
7,11,174,8,9,-1
7,11,175,14,5,9
7,11,176,17,15,2
7,11,177,11,14,-3
7,11,178,23,13,10
7,11,179,16,12,4
7,11,180,19,14,5
7,11,181,4,14,-10
7,11,182,18,15,3
7,11,183,23,17,6
7,11,184,10,30,-20
7,11,185,21,19,2
7,11,186,11,9,2
7,11,187,25,15,10
7,11,188,10,23,-13
7,11,189,12,12,0
7,11,190,20,32,-12
7,11,191,15,21,-6
7,11,192,15,10,5
7,11,193,10,20,-10
7,11,194,23,9,14
7,11,195,18,21,-3
7,11,196,9,19,-10
7,11,197,30,16,14
7,11,198,6,10,-4
7,11,199,17,11,6
7,11,200,18,21,-3
7,11,201,21,13,8
7,11,202,9,11,-2
7,11,203,11,11,0
7,11,204,13,19,-6
7,11,205,14,13,1
7,11,206,15,21,-6
7,11,207,14,5,9
7,11,208,15,20,-5
7,11,209,16,18,-2
7,11,210,12,21,-9
7,11,211,16,21,-5
7,11,212,18,6,12
7,11,213,14,13,1
7,11,214,18,18,0
7,11,215,9,13,-4
7,11,216,17,23,-6
7,11,217,11,15,-4
7,11,218,10,4,6
7,11,219,15,4,11
7,11,220,5,9,-4
7,11,221,10,16,-6
7,11,222,16,12,4
7,11,223,25,17,8
7,11,224,25,28,-3
7,11,225,15,16,-1
7,11,226,11,13,-2
7,11,227,13,21,-8
7,11,228,27,19,8
7,11,229,10,6,4
7,11,230,16,14,2
7,11,231,26,15,11
7,11,232,5,4,1
7,11,233,15,20,-5
7,11,234,12,6,6
7,11,235,16,17,-1
7,11,236,12,17,-5
7,11,237,7,7,0
7,11,238,21,16,5
7,11,239,17,17,0
7,11,240,24,20,4
7,11,241,44,11,33
7,11,242,15,16,-1
7,11,243,19,16,3
7,11,244,20,10,10
7,11,245,25,5,20
7,11,246,15,16,-1
7,11,247,6,18,-12
7,11,248,22,14,8
7,11,249,19,16,3
7,11,250,11,8,3
7,11,251,14,15,-1
7,11,252,18,5,13
7,11,253,18,18,0
7,11,254,17,13,4
7,11,255,23,19,4
7,11,256,9,8,1
7,11,257,13,15,-2
7,11,258,14,9,5
7,11,259,14,6,8
7,11,260,23,17,6
7,11,261,36,16,20
7,11,262,13,16,-3
7,11,263,9,12,-3
7,11,264,19,17,2
7,11,265,18,16,2
7,11,266,11,11,0
7,11,267,13,5,8
7,11,268,8,15,-7
7,11,269,35,18,17
7,11,270,12,10,2
7,11,271,18,12,6
7,11,272,12,14,-2
7,11,273,16,21,-5
7,11,274,12,13,-1
7,11,275,18,26,-8
7,11,276,4,7,-3
7,11,277,27,27,0
7,11,278,10,15,-5
7,11,279,21,14,7
7,11,280,13,11,2
7,11,281,12,13,-1
7,11,282,23,15,8
7,11,283,11,18,-7
7,11,284,10,22,-12
7,11,285,15,16,-1
7,11,286,20,14,6
7,11,287,8,20,-12
7,11,288,17,16,1
7,11,289,8,12,-4
7,11,290,14,14,0
7,11,291,6,10,-4
7,11,292,19,26,-7
7,11,293,17,15,2
7,11,294,10,15,-5
7,11,295,15,15,0
7,11,296,3,11,-8
7,11,297,2,2,0
7,11,298,14,7,7
7,11,299,11,9,2
7,12,0,11,12,-1
7,12,1,7,10,-3
7,12,2,10,18,-8
7,12,3,9,14,-5
7,12,4,7,13,-6
7,12,5,18,24,-6
7,12,6,10,16,-6
7,12,7,18,5,13
7,12,8,16,23,-7
7,12,9,10,20,-10
7,12,10,20,9,11
7,12,11,7,8,-1
7,12,12,26,17,9
7,12,13,11,24,-13
7,12,14,23,22,1
7,12,15,18,23,-5
7,12,16,14,11,3
7,12,17,17,21,-4
7,12,18,8,6,2
7,12,19,18,22,-4
7,12,20,28,20,8
7,12,21,30,21,9
7,12,22,21,19,2
7,12,23,11,12,-1
7,12,24,13,13,0
7,12,25,17,11,6
7,12,26,20,17,3
7,12,27,25,19,6
7,12,28,16,12,4
7,12,29,7,1,6
7,12,30,25,19,6
7,12,31,21,21,0
7,12,32,14,13,1
7,12,33,19,15,4
7,12,34,36,16,20
7,12,35,8,13,-5
7,12,36,8,9,-1
7,12,37,7,11,-4
7,12,38,12,12,0
7,12,39,22,9,13
7,12,40,16,17,-1
7,12,41,16,26,-10
7,12,42,19,6,13
7,12,43,18,19,-1
7,12,44,20,20,0
7,12,45,40,16,24
7,12,46,24,17,7
7,12,47,13,12,1
7,12,48,16,16,0
7,12,49,15,12,3
7,12,50,13,6,7
7,12,51,12,16,-4
7,12,52,11,15,-4
7,12,53,24,20,4
7,12,54,9,23,-14
7,12,55,16,11,5
7,12,56,19,15,4
7,12,57,12,17,-5
7,12,58,13,12,1
7,12,59,14,8,6
7,12,60,13,6,7
7,12,61,16,11,5
7,12,62,20,18,2
7,12,63,19,15,4
7,12,64,13,11,2
7,12,65,18,18,0
7,12,66,18,20,-2
7,12,67,24,10,14
7,12,68,12,5,7
7,12,69,22,18,4
7,12,70,21,16,5
7,12,71,9,7,2
7,12,72,15,13,2
7,12,73,6,16,-10
7,12,74,28,15,13
7,12,75,19,15,4
7,12,76,22,22,0
7,12,77,11,16,-5
7,12,78,17,20,-3
7,12,79,20,12,8
7,12,80,17,11,6
7,12,81,8,10,-2
7,12,82,20,16,4
7,12,83,17,16,1
7,12,84,15,23,-8
7,12,85,13,12,1
7,12,86,21,15,6
7,12,87,17,19,-2
7,12,88,23,15,8
7,12,89,28,17,11
7,12,90,17,12,5
7,12,91,17,23,-6
7,12,92,29,22,7
7,12,93,14,8,6
7,12,94,11,7,4
7,12,95,9,8,1
7,12,96,34,28,6
7,12,97,19,19,0
7,12,98,18,11,7
7,12,99,18,13,5
7,12,100,16,13,3
7,12,101,10,13,-3
7,12,102,9,9,0
7,12,103,17,13,4
7,12,104,16,18,-2
7,12,105,21,21,0
7,12,106,6,11,-5
7,12,107,17,26,-9
7,12,108,19,20,-1
7,12,109,20,13,7
7,12,110,16,8,8
7,12,111,9,9,0
7,12,112,16,26,-10
7,12,113,8,9,-1
7,12,114,15,23,-8
7,12,115,15,16,-1
7,12,116,13,19,-6
7,12,117,6,15,-9
7,12,118,10,24,-14
7,12,119,9,12,-3
7,12,120,14,19,-5
7,12,121,11,9,2
7,12,122,27,11,16
7,12,123,7,15,-8
7,12,124,14,22,-8
7,12,125,14,15,-1
7,12,126,11,17,-6
7,12,127,22,28,-6
7,12,128,19,7,12
7,12,129,14,8,6
7,12,130,12,5,7
7,12,131,23,16,7
7,12,132,13,1,12
7,12,133,23,17,6
7,12,134,15,19,-4
7,12,135,16,8,8
7,12,136,10,16,-6
7,12,137,13,15,-2
7,12,138,15,20,-5
7,12,139,13,7,6
7,12,140,27,11,16
7,12,141,13,15,-2
7,12,142,13,7,6
7,12,143,26,14,12
7,12,144,8,13,-5
7,12,145,22,16,6
7,12,146,14,20,-6
7,12,147,15,7,8
7,12,148,11,7,4
7,12,149,20,23,-3
7,12,150,12,22,-10
7,12,151,9,9,0
7,12,152,17,10,7
7,12,153,14,17,-3
7,12,154,22,20,2
7,12,155,5,5,0
7,12,156,28,20,8
7,12,157,14,14,0
7,12,158,27,26,1
7,12,159,19,11,8
7,12,160,15,13,2
7,12,161,18,16,2
7,12,162,22,21,1
7,12,163,14,6,8
7,12,164,21,8,13
7,12,165,18,14,4
7,12,166,10,10,0
7,12,167,20,15,5
7,12,168,20,14,6
7,12,169,23,28,-5
7,12,170,12,15,-3
7,12,171,18,11,7
7,12,172,13,12,1
7,12,173,10,5,5
7,12,174,19,15,4
7,12,175,10,9,1
7,12,176,13,13,0
7,12,177,13,16,-3
7,12,178,17,14,3
7,12,179,25,15,10
7,12,180,16,16,0
7,12,181,13,21,-8
7,12,182,14,16,-2
7,12,183,13,20,-7
7,12,184,18,18,0
7,12,185,14,8,6
7,12,186,7,9,-2
7,12,187,13,15,-2
7,12,188,14,7,7
7,12,189,16,8,8
7,12,190,17,8,9
7,12,191,18,5,13
7,12,192,11,6,5
7,12,193,19,21,-2
7,12,194,17,11,6
7,12,195,21,6,15
7,12,196,19,18,1
7,12,197,11,5,6
7,12,198,12,7,5
7,12,199,8,1,7
7,12,200,28,23,5
7,12,201,12,11,1
7,12,202,14,9,5
7,12,203,26,14,12
7,12,204,14,10,4
7,12,205,23,25,-2
7,12,206,23,8,15
7,12,207,20,8,12
7,12,208,12,15,-3
7,12,209,10,8,2
7,12,210,26,16,10
7,12,211,10,18,-8
7,12,212,17,18,-1
7,12,213,26,20,6
7,12,214,18,6,12
7,12,215,30,31,-1
7,12,216,25,22,3
7,12,217,14,11,3
7,12,218,12,22,-10
7,12,219,13,6,7
7,12,220,1,2,-1
7,12,221,24,12,12
7,12,222,10,12,-2
7,12,223,18,20,-2
7,12,224,24,16,8
7,12,225,9,8,1
7,12,226,13,17,-4
7,12,227,23,17,6
7,12,228,24,12,12
7,12,229,15,15,0
7,12,230,13,11,2
7,12,231,28,9,19
7,12,232,16,6,10
7,12,233,18,19,-1
7,12,234,6,16,-10
7,12,235,16,11,5
7,12,236,15,21,-6
7,12,237,18,22,-4
7,12,238,12,19,-7
7,12,239,15,18,-3
7,12,240,23,13,10
7,12,241,28,18,10
7,12,242,17,12,5
7,12,243,20,21,-1
7,12,244,23,20,3
7,12,245,16,13,3
7,12,246,21,15,6
7,12,247,22,17,5
7,12,248,10,7,3
7,12,249,23,8,15
7,12,250,8,6,2
7,12,251,9,16,-7
7,12,252,15,12,3
7,12,253,18,28,-10
7,12,254,21,17,4
7,12,255,21,26,-5
7,12,256,9,8,1
7,12,257,6,9,-3
7,12,258,23,10,13
7,12,259,26,17,9
7,12,260,16,18,-2
7,12,261,25,15,10
7,12,262,12,18,-6
7,12,263,21,17,4
7,12,264,6,14,-8
7,12,265,7,16,-9
7,12,266,12,16,-4
7,12,267,3,9,-6
7,12,268,19,10,9
7,12,269,24,14,10
7,12,270,16,9,7
7,12,271,12,19,-7
7,12,272,29,28,1
7,12,273,17,21,-4
7,12,274,15,15,0
7,12,275,15,18,-3
7,12,276,27,19,8
7,12,277,7,6,1
7,12,278,22,8,14
7,12,279,23,6,17
7,12,280,16,13,3
7,12,281,15,13,2
7,12,282,21,11,10
7,12,283,20,21,-1
7,12,284,20,13,7
7,12,285,6,12,-6
7,12,286,10,10,0
7,12,287,13,17,-4
7,12,288,16,18,-2
7,12,289,18,22,-4
7,12,290,8,11,-3
7,12,291,6,7,-1
7,12,292,9,18,-9
7,12,293,13,8,5
7,12,294,16,22,-6
7,12,295,14,4,10
7,12,296,11,16,-5
7,12,297,14,7,7
7,12,298,17,17,0
7,12,299,15,12,3
7,13,0,13,17,-4
7,13,1,22,19,3
7,13,2,10,10,0
7,13,3,11,15,-4
7,13,4,9,18,-9
7,13,5,18,19,-1
7,13,6,13,11,2
7,13,7,7,17,-10
7,13,8,13,10,3
7,13,9,17,26,-9
7,13,10,17,8,9
7,13,11,15,12,3
7,13,12,17,12,5
7,13,13,14,10,4
7,13,14,20,24,-4
7,13,15,21,19,2
7,13,16,18,27,-9
7,13,17,20,11,9
7,13,18,23,23,0
7,13,19,15,17,-2
7,13,20,19,3,16
7,13,21,15,25,-10
7,13,22,15,22,-7
7,13,23,16,13,3
7,13,24,14,14,0
7,13,25,18,20,-2
7,13,26,12,17,-5
7,13,27,13,8,5
7,13,28,19,7,12
7,13,29,16,16,0
7,13,30,13,5,8
7,13,31,24,18,6
7,13,32,21,15,6
7,13,33,19,16,3
7,13,34,19,14,5
7,13,35,11,14,-3
7,13,36,12,30,-18
7,13,37,25,15,10
7,13,38,12,6,6
7,13,39,13,27,-14
7,13,40,6,12,-6
7,13,41,29,6,23
7,13,42,9,8,1
7,13,43,16,24,-8
7,13,44,16,12,4
7,13,45,16,14,2
7,13,46,13,13,0
7,13,47,18,9,9
7,13,48,12,12,0
7,13,49,21,10,11
7,13,50,17,10,7
7,13,51,15,13,2
7,13,52,13,21,-8
7,13,53,18,10,8
7,13,54,11,7,4
7,13,55,9,12,-3
7,13,56,15,9,6
7,13,57,28,11,17
7,13,58,8,8,0
7,13,59,20,22,-2
7,13,60,12,6,6
7,13,61,15,12,3
7,13,62,7,4,3
7,13,63,13,10,3
7,13,64,11,4,7
7,13,65,20,8,12
7,13,66,9,7,2
7,13,67,14,11,3
7,13,68,10,6,4
7,13,69,21,14,7
7,13,70,15,8,7
7,13,71,11,8,3
7,13,72,18,8,10
7,13,73,15,23,-8
7,13,74,13,11,2
7,13,75,14,17,-3
7,13,76,20,3,17
7,13,77,22,20,2
7,13,78,13,8,5
7,13,79,11,13,-2
7,13,80,26,13,13
7,13,81,8,8,0
7,13,82,13,11,2
7,13,83,11,16,-5
7,13,84,8,5,3
7,13,85,10,9,1
7,13,86,12,8,4
7,13,87,7,8,-1
7,13,88,8,23,-15
7,13,89,17,25,-8
7,13,90,20,21,-1
7,13,91,28,9,19
7,13,92,18,15,3
7,13,93,22,20,2
7,13,94,16,15,1
7,13,95,10,17,-7
7,13,96,14,5,9
7,13,97,9,21,-12
7,13,98,12,11,1
7,13,99,10,6,4
7,13,100,15,6,9
7,13,101,10,12,-2
7,13,102,12,13,-1
7,13,103,13,11,2
7,13,104,16,18,-2
7,13,105,23,17,6
7,13,106,18,12,6
7,13,107,21,24,-3
7,13,108,11,14,-3
7,13,109,8,17,-9
7,13,110,14,17,-3
7,13,111,14,14,0
7,13,112,24,12,12
7,13,113,19,14,5
7,13,114,9,12,-3
7,13,115,16,12,4
7,13,116,8,15,-7
7,13,117,16,8,8
7,13,118,8,16,-8
7,13,119,21,20,1
7,13,120,19,12,7
7,13,121,17,14,3
7,13,122,16,11,5
7,13,123,21,17,4
7,13,124,15,16,-1
7,13,125,13,19,-6
7,13,126,27,21,6
7,13,127,15,13,2
7,13,128,22,18,4
7,13,129,27,24,3
7,13,130,35,15,20
7,13,131,18,8,10
7,13,132,11,6,5
7,13,133,21,19,2
7,13,134,17,3,14
7,13,135,15,24,-9
7,13,136,17,7,10
7,13,137,15,18,-3
7,13,138,19,11,8
7,13,139,15,19,-4
7,13,140,3,4,-1
7,13,141,15,4,11
7,13,142,21,14,7
7,13,143,6,19,-13
7,13,144,14,9,5
7,13,145,25,26,-1
7,13,146,13,21,-8
7,13,147,17,25,-8
7,13,148,28,11,17
7,13,149,17,16,1
7,13,150,18,14,4
7,13,151,15,18,-3
7,13,152,16,22,-6
7,13,153,14,11,3
7,13,154,5,14,-9
7,13,155,19,19,0
7,13,156,26,18,8
7,13,157,21,18,3
7,13,158,29,16,13
7,13,159,10,10,0
7,13,160,27,19,8
7,13,161,23,14,9
7,13,162,22,6,16
7,13,163,23,24,-1
7,13,164,6,13,-7
7,13,165,24,6,18
7,13,166,24,21,3
7,13,167,17,4,13
7,13,168,12,12,0
7,13,169,10,9,1
7,13,170,17,21,-4
7,13,171,44,31,13
7,13,172,13,14,-1
7,13,173,25,35,-10
7,13,174,21,25,-4
7,13,175,22,20,2
7,13,176,23,20,3
7,13,177,13,19,-6
7,13,178,9,9,0
7,13,179,14,13,1
7,13,180,8,9,-1
7,13,181,23,18,5
7,13,182,15,12,3
7,13,183,25,15,10
7,13,184,9,11,-2
7,13,185,2,6,-4
7,13,186,21,8,13
7,13,187,26,10,16
7,13,188,9,8,1
7,13,189,32,20,12
7,13,190,16,11,5
7,13,191,7,11,-4
7,13,192,17,18,-1
7,13,193,17,10,7
7,13,194,29,23,6
7,13,195,22,14,8
7,13,196,15,3,12
7,13,197,15,18,-3
7,13,198,17,14,3
7,13,199,10,25,-15
7,13,200,29,13,16
7,13,201,9,15,-6
7,13,202,24,29,-5
7,13,203,16,11,5
7,13,204,18,23,-5
7,13,205,20,12,8
7,13,206,23,21,2
7,13,207,6,11,-5
7,13,208,16,12,4
7,13,209,19,13,6
7,13,210,18,13,5
7,13,211,13,9,4
7,13,212,16,7,9
7,13,213,21,15,6
7,13,214,15,12,3
7,13,215,16,13,3
7,13,216,20,27,-7
7,13,217,11,13,-2
7,13,218,18,6,12
7,13,219,15,15,0
7,13,220,25,37,-12
7,13,221,23,11,12
7,13,222,11,7,4
7,13,223,15,13,2
7,13,224,15,15,0
7,13,225,8,26,-18
7,13,226,24,18,6
7,13,227,9,10,-1
7,13,228,24,36,-12
7,13,229,3,8,-5
7,13,230,23,15,8
7,13,231,12,7,5
7,13,232,19,5,14
7,13,233,14,14,0
7,13,234,12,17,-5
7,13,235,17,31,-14
7,13,236,12,6,6
7,13,237,18,12,6
7,13,238,6,10,-4
7,13,239,8,31,-23
7,13,240,27,26,1
7,13,241,20,11,9
7,13,242,21,13,8
7,13,243,13,17,-4
7,13,244,18,13,5
7,13,245,16,10,6
7,13,246,16,22,-6
7,13,247,23,8,15
7,13,248,14,12,2
7,13,249,23,14,9
7,13,250,31,17,14
7,13,251,14,16,-2
7,13,252,8,11,-3
7,13,253,23,15,8
7,13,254,7,5,2
7,13,255,19,43,-24
7,13,256,17,9,8
7,13,257,29,22,7
7,13,258,14,18,-4
7,13,259,10,3,7
7,13,260,18,17,1
7,13,261,12,14,-2
7,13,262,14,18,-4
7,13,263,15,21,-6
7,13,264,13,9,4
7,13,265,14,15,-1
7,13,266,7,15,-8
7,13,267,30,24,6
7,13,268,14,10,4
7,13,269,9,7,2
7,13,270,12,21,-9
7,13,271,27,16,11
7,13,272,10,4,6
7,13,273,10,19,-9
7,13,274,22,17,5
7,13,275,13,10,3
7,13,276,14,8,6
7,13,277,18,17,1
7,13,278,10,4,6
7,13,279,6,15,-9
7,13,280,23,18,5
7,13,281,9,14,-5
7,13,282,14,12,2
7,13,283,17,9,8
7,13,284,12,23,-11
7,13,285,20,15,5
7,13,286,26,11,15
7,13,287,27,15,12
7,13,288,26,12,14
7,13,289,12,5,7
7,13,290,26,19,7
7,13,291,27,13,14
7,13,292,15,13,2
7,13,293,20,12,8
7,13,294,17,14,3
7,13,295,37,11,26
7,13,296,16,12,4
7,13,297,19,15,4
7,13,298,16,6,10
7,13,299,19,11,8
7,14,0,12,8,4
7,14,1,17,14,3
7,14,2,14,12,2
7,14,3,16,14,2
7,14,4,11,5,6
7,14,5,16,10,6
7,14,6,23,9,14
7,14,7,4,17,-13
7,14,8,16,18,-2
7,14,9,16,12,4
7,14,10,9,12,-3
7,14,11,16,20,-4
7,14,12,16,8,8
7,14,13,23,21,2
7,14,14,7,17,-10
7,14,15,22,8,14
7,14,16,17,13,4
7,14,17,33,29,4
7,14,18,17,17,0
7,14,19,20,16,4
7,14,20,19,17,2
7,14,21,12,15,-3
7,14,22,11,16,-5
7,14,23,11,6,5
7,14,24,17,23,-6
7,14,25,22,15,7
7,14,26,9,14,-5
7,14,27,13,11,2
7,14,28,14,19,-5
7,14,29,14,16,-2
7,14,30,21,24,-3
7,14,31,15,10,5
7,14,32,20,17,3
7,14,33,24,9,15
7,14,34,18,20,-2
7,14,35,13,21,-8
7,14,36,13,15,-2
7,14,37,12,12,0
7,14,38,24,19,5
7,14,39,29,19,10
7,14,40,23,16,7
7,14,41,26,14,12
7,14,42,14,14,0
7,14,43,14,16,-2
7,14,44,13,15,-2
7,14,45,24,15,9
7,14,46,21,13,8
7,14,47,20,16,4
7,14,48,9,14,-5
7,14,49,16,23,-7
7,14,50,13,15,-2
7,14,51,13,17,-4
7,14,52,13,14,-1
7,14,53,11,12,-1
7,14,54,22,22,0
7,14,55,7,3,4
7,14,56,11,10,1
7,14,57,17,11,6
7,14,58,10,16,-6
7,14,59,10,11,-1
7,14,60,38,13,25
7,14,61,21,13,8
7,14,62,13,25,-12
7,14,63,15,9,6
7,14,64,24,10,14
7,14,65,17,13,4
7,14,66,7,13,-6
7,14,67,7,13,-6
7,14,68,9,13,-4
7,14,69,18,11,7
7,14,70,10,15,-5
7,14,71,10,21,-11
7,14,72,13,20,-7
7,14,73,25,14,11
7,14,74,22,24,-2
7,14,75,14,16,-2
7,14,76,21,7,14
7,14,77,31,10,21
7,14,78,33,22,11
7,14,79,21,20,1
7,14,80,15,12,3
7,14,81,18,11,7
7,14,82,19,11,8
7,14,83,7,11,-4
7,14,84,24,6,18
7,14,85,12,11,1
7,14,86,25,9,16
7,14,87,8,12,-4
7,14,88,23,16,7
7,14,89,31,18,13
7,14,90,21,13,8
7,14,91,6,12,-6
7,14,92,9,22,-13
7,14,93,36,18,18
7,14,94,29,21,8
7,14,95,37,21,16
7,14,96,10,10,0
7,14,97,19,12,7
7,14,98,8,16,-8
7,14,99,11,19,-8
7,14,100,17,17,0
7,14,101,24,16,8
7,14,102,18,14,4
7,14,103,23,23,0
7,14,104,12,18,-6
7,14,105,11,11,0
7,14,106,19,17,2
7,14,107,5,12,-7
7,14,108,17,12,5
7,14,109,13,3,10
7,14,110,23,17,6
7,14,111,12,16,-4
7,14,112,23,14,9
7,14,113,22,13,9
7,14,114,20,18,2
7,14,115,9,13,-4
7,14,116,13,17,-4
7,14,117,18,27,-9
7,14,118,20,21,-1
7,14,119,20,9,11
7,14,120,14,4,10
7,14,121,14,23,-9
7,14,122,13,24,-11
7,14,123,12,12,0
7,14,124,12,16,-4
7,14,125,9,21,-12
7,14,126,12,23,-11
7,14,127,17,9,8
7,14,128,13,14,-1
7,14,129,9,15,-6
7,14,130,13,23,-10
7,14,131,21,16,5
7,14,132,18,19,-1
7,14,133,10,18,-8
7,14,134,30,16,14
7,14,135,13,17,-4
7,14,136,6,14,-8
7,14,137,14,10,4
7,14,138,10,16,-6
7,14,139,20,15,5
7,14,140,18,25,-7
7,14,141,20,16,4
7,14,142,8,17,-9
7,14,143,11,21,-10
7,14,144,4,13,-9
7,14,145,28,12,16
7,14,146,19,14,5
7,14,147,38,16,22
7,14,148,9,6,3
7,14,149,16,7,9
7,14,150,17,26,-9
7,14,151,11,12,-1
7,14,152,20,12,8
7,14,153,7,9,-2
7,14,154,15,8,7
7,14,155,19,16,3
7,14,156,15,11,4
7,14,157,14,16,-2
7,14,158,12,14,-2
7,14,159,18,19,-1
7,14,160,14,7,7
7,14,161,6,5,1
7,14,162,18,18,0
7,14,163,16,13,3
7,14,164,25,14,11
7,14,165,2,8,-6
7,14,166,20,11,9
7,14,167,16,17,-1
7,14,168,17,10,7
7,14,169,14,12,2
7,14,170,20,23,-3
7,14,171,16,22,-6
7,14,172,16,8,8
7,14,173,23,17,6
7,14,174,17,12,5
7,14,175,19,19,0
7,14,176,15,15,0
7,14,177,16,8,8
7,14,178,11,12,-1
7,14,179,11,9,2
7,14,180,27,19,8
7,14,181,16,14,2
7,14,182,14,10,4
7,14,183,15,28,-13
7,14,184,20,26,-6
7,14,185,18,17,1
7,14,186,15,2,13
7,14,187,9,31,-22
7,14,188,20,17,3
7,14,189,16,15,1
7,14,190,14,14,0
7,14,191,20,18,2
7,14,192,20,21,-1
7,14,193,10,12,-2
7,14,194,14,14,0
7,14,195,18,11,7
7,14,196,8,2,6
7,14,197,18,17,1
7,14,198,7,11,-4
7,14,199,12,2,10
7,14,200,15,12,3
7,14,201,12,12,0
7,14,202,19,17,2
7,14,203,11,16,-5
7,14,204,11,10,1
7,14,205,16,18,-2
7,14,206,27,16,11
7,14,207,10,7,3
7,14,208,28,14,14
7,14,209,15,17,-2
7,14,210,28,16,12
7,14,211,14,15,-1
7,14,212,17,15,2
7,14,213,24,13,11
7,14,214,18,13,5
7,14,215,19,15,4
7,14,216,11,11,0
7,14,217,15,14,1
7,14,218,13,11,2
7,14,219,24,15,9
7,14,220,8,6,2
7,14,221,14,14,0
7,14,222,19,16,3
7,14,223,11,9,2
7,14,224,8,12,-4
7,14,225,11,14,-3
7,14,226,19,10,9
7,14,227,14,14,0
7,14,228,15,7,8
7,14,229,15,19,-4
7,14,230,19,13,6
7,14,231,20,18,2
7,14,232,12,11,1
7,14,233,9,8,1
7,14,234,14,10,4
7,14,235,10,5,5
7,14,236,23,17,6
7,14,237,31,25,6
7,14,238,20,11,9
7,14,239,16,12,4
7,14,240,23,8,15
7,14,241,8,22,-14
7,14,242,25,31,-6
7,14,243,5,8,-3
7,14,244,29,9,20
7,14,245,25,11,14
7,14,246,16,12,4
7,14,247,17,19,-2
7,14,248,23,35,-12
7,14,249,8,7,1
7,14,250,18,25,-7
7,14,251,18,9,9
7,14,252,28,5,23
7,14,253,17,16,1
7,14,254,25,17,8
7,14,255,11,10,1
7,14,256,9,9,0
7,14,257,8,13,-5
7,14,258,15,31,-16
7,14,259,21,11,10
7,14,260,9,15,-6
7,14,261,13,22,-9
7,14,262,16,12,4
7,14,263,12,22,-10
7,14,264,25,10,15
7,14,265,9,14,-5
7,14,266,21,16,5
7,14,267,15,9,6
7,14,268,19,9,10
7,14,269,25,14,11
7,14,270,23,13,10
7,14,271,7,17,-10
7,14,272,14,13,1
7,14,273,21,14,7
7,14,274,9,12,-3
7,14,275,15,6,9
7,14,276,8,16,-8
7,14,277,11,15,-4
7,14,278,26,18,8
7,14,279,9,6,3
7,14,280,22,9,13
7,14,281,25,10,15
7,14,282,12,7,5
7,14,283,9,7,2
7,14,284,8,11,-3
7,14,285,25,15,10
7,14,286,17,19,-2
7,14,287,19,17,2
7,14,288,20,9,11
7,14,289,19,15,4
7,14,290,19,13,6
7,14,291,22,24,-2
7,14,292,29,23,6
7,14,293,14,17,-3
7,14,294,24,10,14
7,14,295,11,13,-2
7,14,296,10,9,1
7,14,297,22,8,14
7,14,298,15,33,-18
7,14,299,9,9,0
7,15,0,8,7,1
7,15,1,18,9,9
7,15,2,29,10,19
7,15,3,11,10,1
7,15,4,21,7,14
7,15,5,11,10,1
7,15,6,18,2,16
7,15,7,16,11,5
7,15,8,30,8,22
7,15,9,19,9,10
7,15,10,11,12,-1
7,15,11,20,18,2
7,15,12,15,14,1
7,15,13,24,5,19
7,15,14,12,9,3
7,15,15,19,18,1
7,15,16,19,24,-5
7,15,17,16,13,3
7,15,18,10,13,-3
7,15,19,29,18,11
7,15,20,18,12,6
7,15,21,10,14,-4
7,15,22,17,17,0
7,15,23,7,13,-6
7,15,24,26,22,4
7,15,25,23,8,15
7,15,26,23,13,10
7,15,27,13,13,0
7,15,28,14,10,4
7,15,29,17,28,-11
7,15,30,5,20,-15
7,15,31,25,11,14
7,15,32,16,13,3
7,15,33,14,16,-2
7,15,34,24,17,7
7,15,35,14,11,3
7,15,36,8,6,2
7,15,37,14,14,0
7,15,38,17,9,8
7,15,39,10,22,-12
7,15,40,15,8,7
7,15,41,10,12,-2
7,15,42,8,7,1
7,15,43,22,15,7
7,15,44,33,25,8
7,15,45,18,12,6
7,15,46,8,17,-9
7,15,47,15,14,1
7,15,48,23,11,12
7,15,49,9,13,-4
7,15,50,22,10,12
7,15,51,27,16,11
7,15,52,19,19,0
7,15,53,14,6,8
7,15,54,22,12,10
7,15,55,12,7,5
7,15,56,21,19,2
7,15,57,24,10,14
7,15,58,13,12,1
7,15,59,13,16,-3
7,15,60,17,18,-1
7,15,61,16,18,-2
7,15,62,15,5,10
7,15,63,19,7,12
7,15,64,23,26,-3
7,15,65,27,15,12
7,15,66,16,10,6
7,15,67,14,5,9
7,15,68,15,10,5
7,15,69,12,11,1
7,15,70,22,16,6
7,15,71,22,19,3
7,15,72,19,12,7
7,15,73,20,11,9
7,15,74,15,13,2
7,15,75,19,22,-3
7,15,76,21,18,3
7,15,77,4,7,-3
7,15,78,35,9,26
7,15,79,16,12,4
7,15,80,16,13,3
7,15,81,13,29,-16
7,15,82,16,9,7
7,15,83,14,10,4
7,15,84,9,9,0
7,15,85,30,22,8
7,15,86,12,6,6
7,15,87,23,18,5
7,15,88,11,7,4
7,15,89,11,11,0
7,15,90,17,12,5
7,15,91,18,20,-2
7,15,92,15,14,1
7,15,93,21,19,2
7,15,94,10,16,-6
7,15,95,23,11,12
7,15,96,15,15,0
7,15,97,15,11,4
7,15,98,26,19,7
7,15,99,20,22,-2
7,15,100,17,12,5
7,15,101,20,18,2
7,15,102,22,9,13
7,15,103,18,22,-4
7,15,104,17,19,-2
7,15,105,16,19,-3
7,15,106,18,16,2
7,15,107,10,24,-14
7,15,108,15,17,-2
7,15,109,14,11,3
7,15,110,30,20,10
7,15,111,12,12,0
7,15,112,15,15,0
7,15,113,13,10,3
7,15,114,20,13,7
7,15,115,31,16,15
7,15,116,10,1,9
7,15,117,18,6,12
7,15,118,8,9,-1
7,15,119,7,10,-3
7,15,120,21,15,6
7,15,121,19,7,12
7,15,122,14,17,-3
7,15,123,18,18,0
7,15,124,14,7,7
7,15,125,19,15,4
7,15,126,30,9,21
7,15,127,30,21,9
7,15,128,8,8,0
7,15,129,12,6,6
7,15,130,13,20,-7
7,15,131,17,11,6
7,15,132,31,24,7
7,15,133,26,19,7
7,15,134,23,13,10
7,15,135,7,10,-3
7,15,136,15,13,2
7,15,137,30,23,7
7,15,138,26,10,16
7,15,139,18,18,0
7,15,140,16,11,5
7,15,141,26,21,5
7,15,142,14,13,1
7,15,143,24,33,-9
7,15,144,18,10,8
7,15,145,13,6,7
7,15,146,9,12,-3
7,15,147,31,17,14
7,15,148,17,13,4
7,15,149,25,19,6
7,15,150,25,12,13
7,15,151,20,11,9
7,15,152,12,8,4
7,15,153,22,22,0
7,15,154,12,8,4
7,15,155,18,7,11
7,15,156,18,10,8
7,15,157,20,17,3
7,15,158,12,11,1
7,15,159,15,16,-1
7,15,160,22,20,2
7,15,161,26,20,6
7,15,162,6,7,-1
7,15,163,8,21,-13
7,15,164,18,14,4
7,15,165,22,14,8
7,15,166,14,14,0
7,15,167,12,13,-1
7,15,168,16,21,-5
7,15,169,28,9,19
7,15,170,26,12,14
7,15,171,19,23,-4
7,15,172,28,18,10
7,15,173,14,12,2
7,15,174,8,4,4
7,15,175,12,14,-2
7,15,176,18,19,-1
7,15,177,7,10,-3
7,15,178,15,6,9
7,15,179,21,18,3
7,15,180,12,10,2
7,15,181,22,15,7
7,15,182,15,25,-10
7,15,183,17,27,-10
7,15,184,9,17,-8
7,15,185,24,8,16
7,15,186,16,19,-3
7,15,187,14,11,3
7,15,188,18,9,9
7,15,189,14,9,5
7,15,190,17,20,-3
7,15,191,11,19,-8
7,15,192,21,21,0
7,15,193,13,20,-7
7,15,194,11,9,2
7,15,195,7,4,3
7,15,196,7,24,-17
7,15,197,8,5,3
7,15,198,36,14,22
7,15,199,19,10,9
7,15,200,26,15,11
7,15,201,18,10,8
7,15,202,13,11,2
7,15,203,16,20,-4
7,15,204,14,13,1
7,15,205,20,21,-1
7,15,206,9,5,4
7,15,207,15,14,1
7,15,208,17,16,1
7,15,209,11,5,6
7,15,210,27,29,-2
7,15,211,24,9,15
7,15,212,26,22,4
7,15,213,16,12,4
7,15,214,21,15,6
7,15,215,6,10,-4
7,15,216,12,11,1
7,15,217,14,25,-11
7,15,218,6,4,2
7,15,219,16,25,-9
7,15,220,19,12,7
7,15,221,15,4,11
7,15,222,8,8,0
7,15,223,21,14,7
7,15,224,20,9,11
7,15,225,8,20,-12
7,15,226,8,9,-1
7,15,227,33,16,17
7,15,228,18,14,4
7,15,229,24,15,9
7,15,230,12,5,7
7,15,231,14,12,2
7,15,232,22,18,4
7,15,233,12,15,-3
7,15,234,18,15,3
7,15,235,10,9,1
7,15,236,20,11,9
7,15,237,10,11,-1
7,15,238,17,32,-15
7,15,239,39,13,26
7,15,240,33,6,27
7,15,241,20,8,12
7,15,242,36,12,24
7,15,243,8,18,-10
7,15,244,16,11,5
7,15,245,19,14,5
7,15,246,26,13,13
7,15,247,9,15,-6
7,15,248,15,25,-10
7,15,249,39,16,23
7,15,250,18,16,2
7,15,251,38,16,22
7,15,252,10,25,-15
7,15,253,27,20,7
7,15,254,5,14,-9
7,15,255,17,11,6
7,15,256,14,14,0
7,15,257,15,6,9
7,15,258,16,16,0
7,15,259,9,14,-5
7,15,260,11,10,1
7,15,261,20,15,5
7,15,262,19,11,8
7,15,263,22,14,8
7,15,264,18,14,4
7,15,265,12,9,3
7,15,266,19,23,-4
7,15,267,14,9,5
7,15,268,24,10,14
7,15,269,25,14,11
7,15,270,35,16,19
7,15,271,22,23,-1
7,15,272,15,18,-3
7,15,273,12,13,-1
7,15,274,16,5,11
7,15,275,15,11,4
7,15,276,18,10,8
7,15,277,14,14,0
7,15,278,32,14,18
7,15,279,22,19,3
7,15,280,17,21,-4
7,15,281,15,12,3
7,15,282,21,6,15
7,15,283,28,23,5
7,15,284,23,12,11
7,15,285,23,15,8
7,15,286,14,10,4
7,15,287,24,15,9
7,15,288,16,18,-2
7,15,289,17,13,4
7,15,290,13,31,-18
7,15,291,12,7,5
7,15,292,13,9,4
7,15,293,20,22,-2
7,15,294,15,17,-2
7,15,295,20,24,-4
7,15,296,18,10,8
7,15,297,12,14,-2
7,15,298,17,20,-3
7,15,299,11,5,6
7,16,0,6,7,-1
7,16,1,16,7,9
7,16,2,27,17,10
7,16,3,25,8,17
7,16,4,18,22,-4
7,16,5,20,13,7
7,16,6,21,27,-6
7,16,7,18,20,-2
7,16,8,3,7,-4
7,16,9,24,27,-3
7,16,10,23,12,11
7,16,11,28,20,8
7,16,12,24,25,-1
7,16,13,18,13,5
7,16,14,21,14,7
7,16,15,12,7,5
7,16,16,28,10,18
7,16,17,24,13,11
7,16,18,19,25,-6
7,16,19,13,3,10
7,16,20,30,12,18
7,16,21,25,29,-4
7,16,22,23,5,18
7,16,23,11,7,4
7,16,24,27,11,16
7,16,25,25,17,8
7,16,26,11,13,-2
7,16,27,17,23,-6
7,16,28,10,9,1
7,16,29,24,23,1
7,16,30,10,20,-10
7,16,31,17,8,9
7,16,32,13,10,3
7,16,33,14,22,-8
7,16,34,18,18,0
7,16,35,19,14,5
7,16,36,11,15,-4
7,16,37,22,11,11
7,16,38,17,16,1
7,16,39,9,22,-13
7,16,40,11,19,-8
7,16,41,9,21,-12
7,16,42,12,12,0
7,16,43,19,18,1
7,16,44,14,11,3
7,16,45,22,30,-8
7,16,46,11,3,8
7,16,47,17,20,-3
7,16,48,21,12,9
7,16,49,6,10,-4
7,16,50,14,11,3
7,16,51,20,19,1
7,16,52,26,24,2
7,16,53,13,18,-5
7,16,54,9,24,-15
7,16,55,0,9,-9
7,16,56,16,12,4
7,16,57,17,9,8
7,16,58,16,28,-12
7,16,59,21,6,15
7,16,60,13,6,7
7,16,61,34,9,25
7,16,62,12,13,-1
7,16,63,10,3,7
7,16,64,17,19,-2
7,16,65,20,11,9
7,16,66,10,8,2
7,16,67,11,18,-7
7,16,68,28,19,9
7,16,69,20,18,2
7,16,70,12,15,-3
7,16,71,20,15,5
7,16,72,30,12,18
7,16,73,16,9,7
7,16,74,15,7,8
7,16,75,26,17,9
7,16,76,23,15,8
7,16,77,14,16,-2
7,16,78,16,8,8
7,16,79,20,22,-2
7,16,80,26,14,12
7,16,81,9,18,-9
7,16,82,8,8,0
7,16,83,16,11,5
7,16,84,11,33,-22
7,16,85,26,22,4
7,16,86,17,11,6
7,16,87,10,6,4
7,16,88,21,10,11
7,16,89,8,3,5
7,16,90,11,14,-3
7,16,91,14,16,-2
7,16,92,20,12,8
7,16,93,10,7,3
7,16,94,14,20,-6
7,16,95,16,13,3
7,16,96,35,13,22
7,16,97,19,16,3
7,16,98,22,14,8
7,16,99,9,15,-6
7,16,100,19,9,10
7,16,101,18,13,5
7,16,102,12,20,-8
7,16,103,7,12,-5
7,16,104,20,11,9
7,16,105,10,13,-3
7,16,106,13,6,7
7,16,107,7,15,-8
7,16,108,24,24,0
7,16,109,13,13,0
7,16,110,24,15,9
7,16,111,16,18,-2
7,16,112,14,8,6
7,16,113,24,8,16
7,16,114,18,13,5
7,16,115,16,15,1
7,16,116,13,22,-9
7,16,117,22,10,12
7,16,118,10,12,-2
7,16,119,22,3,19
7,16,120,19,12,7
7,16,121,6,14,-8
7,16,122,18,10,8
7,16,123,34,11,23
7,16,124,9,9,0
7,16,125,11,12,-1
7,16,126,20,22,-2
7,16,127,23,18,5
7,16,128,25,5,20
7,16,129,27,16,11
7,16,130,7,2,5
7,16,131,18,15,3
7,16,132,20,10,10
7,16,133,12,7,5
7,16,134,13,11,2
7,16,135,18,21,-3
7,16,136,21,24,-3
7,16,137,19,13,6
7,16,138,26,25,1
7,16,139,18,3,15
7,16,140,25,13,12
7,16,141,12,27,-15
7,16,142,15,9,6
7,16,143,34,22,12
7,16,144,9,14,-5
7,16,145,25,11,14
7,16,146,16,15,1
7,16,147,18,13,5
7,16,148,13,9,4
7,16,149,24,18,6
7,16,150,15,18,-3
7,16,151,20,20,0
7,16,152,23,9,14
7,16,153,17,20,-3
7,16,154,20,14,6
7,16,155,14,20,-6
7,16,156,19,13,6
7,16,157,24,9,15
7,16,158,14,12,2
7,16,159,14,16,-2
7,16,160,20,24,-4
7,16,161,9,4,5
7,16,162,21,20,1
7,16,163,26,13,13
7,16,164,20,19,1
7,16,165,11,12,-1
7,16,166,17,12,5
7,16,167,14,20,-6
7,16,168,30,20,10
7,16,169,17,6,11
7,16,170,15,17,-2
7,16,171,12,17,-5
7,16,172,22,24,-2
7,16,173,10,7,3
7,16,174,30,11,19
7,16,175,17,19,-2
7,16,176,22,15,7
7,16,177,18,18,0
7,16,178,11,11,0
7,16,179,11,12,-1
7,16,180,20,9,11
7,16,181,13,5,8
7,16,182,12,6,6
7,16,183,14,16,-2
7,16,184,17,32,-15
7,16,185,13,8,5
7,16,186,23,39,-16
7,16,187,10,8,2
7,16,188,34,25,9
7,16,189,19,12,7
7,16,190,10,10,0
7,16,191,20,13,7
7,16,192,13,9,4
7,16,193,11,17,-6
7,16,194,17,22,-5
7,16,195,15,7,8
7,16,196,32,14,18
7,16,197,24,16,8
7,16,198,19,11,8
7,16,199,12,13,-1
7,16,200,16,6,10
7,16,201,18,14,4
7,16,202,15,21,-6
7,16,203,22,19,3
7,16,204,18,3,15
7,16,205,14,11,3
7,16,206,9,11,-2
7,16,207,8,8,0
7,16,208,12,15,-3
7,16,209,9,11,-2
7,16,210,16,14,2
7,16,211,15,11,4
7,16,212,17,9,8
7,16,213,17,13,4
7,16,214,15,11,4
7,16,215,15,13,2
7,16,216,4,20,-16
7,16,217,9,7,2
7,16,218,17,10,7
7,16,219,21,23,-2
7,16,220,10,8,2
7,16,221,21,18,3
7,16,222,19,23,-4
7,16,223,19,12,7
7,16,224,22,22,0
7,16,225,22,15,7
7,16,226,20,14,6
7,16,227,26,14,12
7,16,228,23,20,3
7,16,229,23,16,7
7,16,230,17,11,6
7,16,231,20,24,-4
7,16,232,8,21,-13
7,16,233,17,14,3
7,16,234,20,9,11
7,16,235,19,11,8
7,16,236,12,16,-4
7,16,237,12,6,6
7,16,238,34,13,21
7,16,239,25,17,8
7,16,240,20,12,8
7,16,241,23,15,8
7,16,242,19,16,3
7,16,243,9,6,3
7,16,244,12,11,1
7,16,245,19,19,0
7,16,246,21,29,-8
7,16,247,15,9,6
7,16,248,37,4,33
7,16,249,13,17,-4
7,16,250,21,14,7
7,16,251,17,13,4
7,16,252,11,18,-7
7,16,253,5,22,-17
7,16,254,10,8,2
7,16,255,31,20,11
7,16,256,14,8,6
7,16,257,13,9,4
7,16,258,31,11,20
7,16,259,5,9,-4
7,16,260,11,7,4
7,16,261,13,15,-2
7,16,262,36,29,7
7,16,263,18,13,5
7,16,264,21,12,9
7,16,265,15,10,5
7,16,266,24,21,3
7,16,267,21,14,7
7,16,268,15,17,-2
7,16,269,17,19,-2
7,16,270,13,10,3
7,16,271,14,17,-3
7,16,272,8,12,-4
7,16,273,26,27,-1
7,16,274,29,17,12
7,16,275,19,6,13
7,16,276,18,13,5
7,16,277,11,8,3
7,16,278,26,20,6
7,16,279,14,18,-4
7,16,280,13,9,4
7,16,281,18,13,5
7,16,282,16,12,4
7,16,283,22,16,6
7,16,284,17,13,4
7,16,285,12,13,-1
7,16,286,19,17,2
7,16,287,30,22,8
7,16,288,23,7,16
7,16,289,20,8,12
7,16,290,12,9,3
7,16,291,10,7,3
7,16,292,13,12,1
7,16,293,20,9,11
7,16,294,19,13,6
7,16,295,12,21,-9
7,16,296,21,13,8
7,16,297,24,13,11
7,16,298,13,13,0
7,16,299,23,13,10
7,17,0,20,20,0
7,17,1,24,7,17
7,17,2,15,5,10
7,17,3,18,12,6
7,17,4,25,16,9
7,17,5,24,15,9
7,17,6,27,6,21
7,17,7,13,9,4
7,17,8,25,18,7
7,17,9,23,15,8
7,17,10,17,9,8
7,17,11,22,15,7
7,17,12,12,22,-10
7,17,13,21,6,15
7,17,14,31,10,21
7,17,15,18,11,7
7,17,16,17,10,7
7,17,17,21,7,14
7,17,18,21,31,-10
7,17,19,14,11,3
7,17,20,20,12,8
7,17,21,29,10,19
7,17,22,22,10,12
7,17,23,14,13,1
7,17,24,26,9,17
7,17,25,6,6,0
7,17,26,19,19,0
7,17,27,9,8,1
7,17,28,7,7,0
7,17,29,14,4,10
7,17,30,17,10,7
7,17,31,15,22,-7
7,17,32,15,6,9
7,17,33,11,17,-6
7,17,34,29,29,0
7,17,35,15,5,10
7,17,36,17,8,9
7,17,37,11,8,3
7,17,38,21,20,1
7,17,39,15,6,9
7,17,40,23,17,6
7,17,41,17,7,10
7,17,42,11,20,-9
7,17,43,14,14,0
7,17,44,16,11,5
7,17,45,14,15,-1
7,17,46,14,12,2
7,17,47,9,10,-1
7,17,48,12,10,2
7,17,49,20,12,8
7,17,50,14,8,6
7,17,51,11,10,1
7,17,52,19,14,5
7,17,53,15,8,7
7,17,54,14,8,6
7,17,55,8,3,5
7,17,56,16,10,6
7,17,57,8,14,-6
7,17,58,25,17,8
7,17,59,22,13,9
7,17,60,24,6,18
7,17,61,16,19,-3
7,17,62,34,19,15
7,17,63,24,12,12
7,17,64,24,13,11
7,17,65,14,20,-6
7,17,66,17,24,-7
7,17,67,17,19,-2
7,17,68,21,6,15
7,17,69,16,12,4
7,17,70,10,14,-4
7,17,71,17,6,11
7,17,72,17,7,10
7,17,73,16,29,-13
7,17,74,17,3,14
7,17,75,19,14,5
7,17,76,13,8,5
7,17,77,18,10,8
7,17,78,8,13,-5
7,17,79,15,9,6
7,17,80,8,19,-11
7,17,81,21,11,10
7,17,82,32,15,17
7,17,83,11,10,1
7,17,84,14,14,0
7,17,85,36,11,25
7,17,86,16,21,-5
7,17,87,30,22,8
7,17,88,10,13,-3
7,17,89,9,9,0
7,17,90,9,17,-8
7,17,91,20,9,11
7,17,92,21,16,5
7,17,93,15,15,0
7,17,94,21,13,8
7,17,95,19,23,-4
7,17,96,21,29,-8
7,17,97,13,15,-2
7,17,98,7,18,-11
7,17,99,13,8,5
7,17,100,10,14,-4
7,17,101,27,19,8
7,17,102,27,22,5
7,17,103,13,5,8
7,17,104,9,10,-1
7,17,105,19,21,-2
7,17,106,25,14,11
7,17,107,21,12,9
7,17,108,18,10,8
7,17,109,18,13,5
7,17,110,11,9,2
7,17,111,8,4,4
7,17,112,13,2,11
7,17,113,21,14,7
7,17,114,20,14,6
7,17,115,25,24,1
7,17,116,7,15,-8
7,17,117,20,28,-8
7,17,118,22,7,15
7,17,119,13,21,-8
7,17,120,14,6,8
7,17,121,20,13,7
7,17,122,12,26,-14
7,17,123,17,23,-6
7,17,124,16,9,7
7,17,125,22,14,8
7,17,126,15,15,0
7,17,127,9,4,5
7,17,128,27,6,21
7,17,129,21,9,12
7,17,130,17,17,0
7,17,131,12,11,1
7,17,132,17,19,-2
7,17,133,6,5,1
7,17,134,3,14,-11
7,17,135,11,10,1
7,17,136,8,9,-1
7,17,137,18,11,7
7,17,138,18,17,1
7,17,139,2,3,-1
7,17,140,25,14,11
7,17,141,13,5,8
7,17,142,6,5,1
7,17,143,17,13,4
7,17,144,12,8,4
7,17,145,15,19,-4
7,17,146,11,16,-5
7,17,147,23,11,12
7,17,148,14,8,6
7,17,149,17,10,7
7,17,150,16,8,8
7,17,151,11,12,-1
7,17,152,14,20,-6
7,17,153,22,12,10
7,17,154,17,17,0
7,17,155,18,8,10
7,17,156,20,22,-2
7,17,157,15,10,5
7,17,158,30,26,4
7,17,159,27,14,13
7,17,160,14,14,0
7,17,161,14,19,-5
7,17,162,24,11,13
7,17,163,7,12,-5
7,17,164,26,17,9
7,17,165,15,9,6
7,17,166,23,8,15
7,17,167,9,14,-5
7,17,168,24,11,13
7,17,169,9,23,-14
7,17,170,19,15,4
7,17,171,24,15,9
7,17,172,21,13,8
7,17,173,17,20,-3
7,17,174,17,12,5
7,17,175,22,24,-2
7,17,176,15,12,3
7,17,177,19,15,4
7,17,178,14,10,4
7,17,179,12,11,1
7,17,180,21,5,16
7,17,181,9,5,4
7,17,182,13,13,0
7,17,183,23,11,12
7,17,184,13,10,3
7,17,185,10,7,3
7,17,186,12,11,1
7,17,187,16,8,8
7,17,188,21,15,6
7,17,189,13,17,-4
7,17,190,20,16,4
7,17,191,29,7,22
7,17,192,17,21,-4
7,17,193,4,9,-5
7,17,194,19,9,10
7,17,195,13,23,-10
7,17,196,17,9,8
7,17,197,28,15,13
7,17,198,15,10,5
7,17,199,14,7,7
7,17,200,15,11,4
7,17,201,27,22,5
7,17,202,8,9,-1
7,17,203,11,9,2
7,17,204,21,13,8
7,17,205,15,22,-7
7,17,206,20,17,3
7,17,207,14,11,3
7,17,208,8,2,6
7,17,209,21,14,7
7,17,210,15,12,3
7,17,211,20,24,-4
7,17,212,27,21,6
7,17,213,16,14,2
7,17,214,18,11,7
7,17,215,20,17,3
7,17,216,13,17,-4
7,17,217,17,12,5
7,17,218,17,17,0
7,17,219,16,13,3
7,17,220,20,19,1
7,17,221,19,7,12
7,17,222,13,7,6
7,17,223,25,25,0
7,17,224,9,10,-1
7,17,225,20,6,14
7,17,226,20,19,1
7,17,227,15,15,0
7,17,228,22,14,8
7,17,229,22,15,7
7,17,230,30,9,21
7,17,231,14,9,5
7,17,232,14,10,4
7,17,233,19,6,13
7,17,234,6,13,-7
7,17,235,20,14,6
7,17,236,16,9,7
7,17,237,10,12,-2
7,17,238,18,13,5
7,17,239,18,10,8
7,17,240,23,21,2
7,17,241,10,16,-6
7,17,242,16,16,0
7,17,243,9,10,-1
7,17,244,13,11,2
7,17,245,9,8,1
7,17,246,26,29,-3
7,17,247,26,13,13
7,17,248,5,9,-4
7,17,249,12,10,2
7,17,250,20,17,3
7,17,251,35,14,21
7,17,252,23,7,16
7,17,253,22,27,-5
7,17,254,24,13,11
7,17,255,15,12,3
7,17,256,10,20,-10
7,17,257,20,14,6
7,17,258,18,9,9
7,17,259,18,11,7
7,17,260,20,14,6
7,17,261,16,15,1
7,17,262,20,23,-3
7,17,263,22,9,13
7,17,264,8,5,3
7,17,265,13,5,8
7,17,266,20,8,12
7,17,267,24,18,6
7,17,268,34,13,21
7,17,269,18,15,3
7,17,270,16,20,-4
7,17,271,14,12,2
7,17,272,7,16,-9
7,17,273,7,7,0
7,17,274,16,12,4
7,17,275,16,10,6
7,17,276,7,10,-3
7,17,277,22,24,-2
7,17,278,19,28,-9
7,17,279,17,9,8
7,17,280,19,15,4
7,17,281,15,13,2
7,17,282,25,14,11
7,17,283,4,2,2
7,17,284,20,12,8
7,17,285,23,16,7
7,17,286,21,20,1
7,17,287,21,9,12
7,17,288,9,6,3
7,17,289,23,27,-4
7,17,290,17,13,4
7,17,291,21,19,2
7,17,292,16,16,0
7,17,293,9,3,6
7,17,294,17,16,1
7,17,295,18,12,6
7,17,296,14,19,-5
7,17,297,16,10,6
7,17,298,16,12,4
7,17,299,9,6,3
7,18,0,25,12,13
7,18,1,14,14,0
7,18,2,13,6,7
7,18,3,19,18,1
7,18,4,13,11,2
7,18,5,10,14,-4
7,18,6,12,11,1
7,18,7,6,5,1
7,18,8,15,5,10
7,18,9,22,16,6
7,18,10,23,9,14
7,18,11,17,24,-7
7,18,12,17,19,-2
7,18,13,10,7,3
7,18,14,15,12,3
7,18,15,10,3,7
7,18,16,6,9,-3
7,18,17,22,10,12
7,18,18,14,14,0
7,18,19,21,17,4
7,18,20,14,9,5
7,18,21,20,19,1
7,18,22,18,6,12
7,18,23,27,9,18
7,18,24,26,12,14
7,18,25,16,14,2
7,18,26,26,19,7
7,18,27,18,7,11
7,18,28,23,19,4
7,18,29,14,3,11
7,18,30,14,10,4
7,18,31,21,17,4
7,18,32,13,10,3
7,18,33,21,9,12
7,18,34,6,7,-1
7,18,35,19,8,11
7,18,36,25,12,13
7,18,37,8,7,1
7,18,38,13,14,-1
7,18,39,11,14,-3
7,18,40,9,12,-3
7,18,41,16,8,8
7,18,42,11,17,-6
7,18,43,9,5,4
7,18,44,16,6,10
7,18,45,24,21,3
7,18,46,18,13,5
7,18,47,23,22,1
7,18,48,21,21,0
7,18,49,22,7,15
7,18,50,17,30,-13
7,18,51,12,14,-2
7,18,52,25,19,6
7,18,53,23,13,10
7,18,54,15,10,5
7,18,55,25,15,10
7,18,56,25,10,15
7,18,57,25,14,11
7,18,58,27,8,19
7,18,59,21,9,12
7,18,60,7,8,-1
7,18,61,25,15,10
7,18,62,12,12,0
7,18,63,27,13,14
7,18,64,20,8,12
7,18,65,16,6,10
7,18,66,17,21,-4
7,18,67,14,7,7
7,18,68,20,10,10
7,18,69,18,22,-4
7,18,70,17,10,7
7,18,71,23,8,15
7,18,72,13,8,5
7,18,73,26,11,15
7,18,74,24,11,13
7,18,75,31,14,17
7,18,76,13,3,10
7,18,77,30,11,19
7,18,78,13,6,7
7,18,79,14,8,6
7,18,80,13,10,3
7,18,81,8,4,4
7,18,82,5,13,-8
7,18,83,25,12,13
7,18,84,27,15,12
7,18,85,14,15,-1
7,18,86,22,10,12
7,18,87,26,21,5
7,18,88,12,12,0
7,18,89,13,9,4
7,18,90,18,28,-10
7,18,91,19,15,4
7,18,92,19,16,3
7,18,93,17,6,11
7,18,94,14,12,2
7,18,95,9,14,-5
7,18,96,13,12,1
7,18,97,14,5,9
7,18,98,16,11,5
7,18,99,11,7,4
7,18,100,21,2,19
7,18,101,15,13,2
7,18,102,26,16,10
7,18,103,19,18,1
7,18,104,25,7,18
7,18,105,27,20,7
7,18,106,23,24,-1
7,18,107,12,17,-5
7,18,108,12,6,6
7,18,109,16,6,10
7,18,110,18,18,0
7,18,111,8,7,1
7,18,112,23,14,9
7,18,113,26,14,12
7,18,114,6,5,1
7,18,115,17,13,4
7,18,116,22,29,-7
7,18,117,16,19,-3
7,18,118,15,3,12
7,18,119,16,13,3
7,18,120,13,9,4
7,18,121,16,11,5
7,18,122,23,25,-2
7,18,123,21,13,8
7,18,124,20,19,1
7,18,125,22,12,10
7,18,126,17,8,9
7,18,127,7,4,3
7,18,128,19,9,10
7,18,129,19,16,3
7,18,130,15,10,5
7,18,131,23,20,3
7,18,132,12,15,-3
7,18,133,27,15,12
7,18,134,15,13,2
7,18,135,21,11,10
7,18,136,31,4,27
7,18,137,20,9,11
7,18,138,24,24,0
7,18,139,13,6,7
7,18,140,20,19,1
7,18,141,24,16,8
7,18,142,15,7,8
7,18,143,30,28,2
7,18,144,19,14,5
7,18,145,18,13,5
7,18,146,24,20,4
7,18,147,23,20,3
7,18,148,18,15,3
7,18,149,17,20,-3
7,18,150,10,8,2
7,18,151,14,13,1
7,18,152,11,5,6
7,18,153,10,11,-1
7,18,154,17,17,0
7,18,155,17,19,-2
7,18,156,7,6,1
7,18,157,20,12,8
7,18,158,29,15,14
7,18,159,12,10,2
7,18,160,29,10,19
7,18,161,15,5,10
7,18,162,28,16,12
7,18,163,23,17,6
7,18,164,20,16,4
7,18,165,27,19,8
7,18,166,25,11,14
7,18,167,14,13,1
7,18,168,21,19,2
7,18,169,24,11,13
7,18,170,12,7,5
7,18,171,19,11,8
7,18,172,14,5,9
7,18,173,23,20,3
7,18,174,13,8,5
7,18,175,21,14,7
7,18,176,15,17,-2
7,18,177,14,12,2
7,18,178,22,9,13
7,18,179,15,13,2
7,18,180,15,15,0
7,18,181,24,18,6
7,18,182,29,13,16
7,18,183,12,14,-2
7,18,184,16,8,8
7,18,185,15,10,5
7,18,186,19,20,-1
7,18,187,19,26,-7
7,18,188,27,19,8
7,18,189,18,10,8
7,18,190,19,8,11
7,18,191,20,4,16
7,18,192,18,9,9
7,18,193,7,8,-1
7,18,194,20,17,3
7,18,195,24,13,11
7,18,196,24,19,5
7,18,197,9,10,-1
7,18,198,20,9,11
7,18,199,11,15,-4
7,18,200,15,13,2
7,18,201,17,15,2
7,18,202,12,11,1
7,18,203,35,14,21
7,18,204,19,20,-1
7,18,205,14,17,-3
7,18,206,20,20,0
7,18,207,6,6,0
7,18,208,17,12,5
7,18,209,24,13,11
7,18,210,20,11,9
7,18,211,26,19,7
7,18,212,15,10,5
7,18,213,19,8,11
7,18,214,18,7,11
7,18,215,16,20,-4
7,18,216,7,8,-1
7,18,217,11,21,-10
7,18,218,11,7,4
7,18,219,28,12,16
7,18,220,18,4,14
7,18,221,7,7,0
7,18,222,20,14,6
7,18,223,6,13,-7
7,18,224,16,5,11
7,18,225,19,17,2
7,18,226,19,6,13
7,18,227,17,5,12
7,18,228,16,7,9
7,18,229,21,10,11
7,18,230,17,15,2
7,18,231,10,9,1
7,18,232,10,5,5
7,18,233,21,12,9
7,18,234,6,13,-7
7,18,235,13,9,4
7,18,236,17,10,7
7,18,237,23,16,7
7,18,238,12,11,1
7,18,239,17,17,0
7,18,240,13,11,2
7,18,241,19,9,10
7,18,242,32,16,16
7,18,243,10,9,1
7,18,244,26,20,6
7,18,245,18,8,10
7,18,246,10,18,-8
7,18,247,20,15,5
7,18,248,16,9,7
7,18,249,5,4,1
7,18,250,20,13,7
7,18,251,14,10,4
7,18,252,8,11,-3
7,18,253,30,18,12
7,18,254,11,3,8
7,18,255,16,10,6
7,18,256,15,10,5
7,18,257,18,11,7
7,18,258,30,18,12
7,18,259,15,22,-7
7,18,260,19,22,-3
7,18,261,11,7,4
7,18,262,23,24,-1
7,18,263,19,10,9
7,18,264,19,15,4
7,18,265,27,14,13
7,18,266,9,18,-9
7,18,267,18,17,1
7,18,268,22,25,-3
7,18,269,27,13,14
7,18,270,35,4,31
7,18,271,15,12,3
7,18,272,19,20,-1
7,18,273,13,5,8
7,18,274,18,10,8
7,18,275,14,8,6
7,18,276,14,8,6
7,18,277,13,19,-6
7,18,278,16,8,8
7,18,279,17,23,-6
7,18,280,7,5,2
7,18,281,19,10,9
7,18,282,20,16,4
7,18,283,26,17,9
7,18,284,11,12,-1
7,18,285,16,17,-1
7,18,286,20,17,3
7,18,287,22,14,8
7,18,288,33,12,21
7,18,289,9,12,-3
7,18,290,32,19,13
7,18,291,16,14,2
7,18,292,13,15,-2
7,18,293,19,13,6
7,18,294,13,13,0
7,18,295,19,11,8
7,18,296,13,5,8
7,18,297,26,21,5
7,18,298,23,12,11
7,18,299,19,16,3
7,19,0,27,9,18
7,19,1,17,10,7
7,19,2,31,14,17
7,19,3,12,16,-4
7,19,4,27,16,11
7,19,5,16,8,8
7,19,6,31,16,15
7,19,7,36,9,27
7,19,8,25,7,18
7,19,9,16,7,9
7,19,10,20,19,1
7,19,11,20,7,13
7,19,12,22,12,10
7,19,13,27,13,14
7,19,14,14,10,4
7,19,15,18,13,5
7,19,16,26,7,19
7,19,17,26,10,16
7,19,18,23,9,14
7,19,19,31,23,8
7,19,20,19,8,11
7,19,21,18,16,2
7,19,22,17,10,7
7,19,23,10,6,4
7,19,24,14,13,1
7,19,25,18,20,-2
7,19,26,9,13,-4
7,19,27,7,1,6
7,19,28,26,14,12
7,19,29,21,7,14
7,19,30,12,12,0
7,19,31,7,9,-2
7,19,32,17,6,11
7,19,33,19,15,4
7,19,34,13,7,6
7,19,35,19,6,13
7,19,36,22,10,12
7,19,37,24,8,16
7,19,38,20,18,2
7,19,39,18,17,1
7,19,40,10,16,-6
7,19,41,24,21,3
7,19,42,16,17,-1
7,19,43,7,5,2
7,19,44,9,7,2
7,19,45,15,13,2
7,19,46,18,24,-6
7,19,47,9,6,3
7,19,48,17,13,4
7,19,49,33,27,6
7,19,50,27,10,17
7,19,51,26,21,5
7,19,52,22,16,6
7,19,53,15,3,12
7,19,54,18,10,8
7,19,55,27,6,21
7,19,56,20,16,4
7,19,57,12,12,0
7,19,58,17,20,-3
7,19,59,7,3,4
7,19,60,23,16,7
7,19,61,25,18,7
7,19,62,12,13,-1
7,19,63,6,9,-3
7,19,64,29,17,12
7,19,65,14,12,2
7,19,66,22,19,3
7,19,67,28,16,12
7,19,68,13,16,-3
7,19,69,15,15,0
7,19,70,30,19,11
7,19,71,6,4,2
7,19,72,18,14,4
7,19,73,16,14,2
7,19,74,19,11,8
7,19,75,19,9,10
7,19,76,30,21,9
7,19,77,31,16,15
7,19,78,19,15,4
7,19,79,9,12,-3
7,19,80,19,9,10
7,19,81,26,19,7
7,19,82,11,14,-3
7,19,83,26,9,17
7,19,84,22,17,5
7,19,85,25,17,8
7,19,86,12,12,0
7,19,87,4,8,-4
7,19,88,16,0,16
7,19,89,15,8,7
7,19,90,8,18,-10
7,19,91,21,16,5
7,19,92,23,8,15
7,19,93,20,13,7
7,19,94,25,16,9
7,19,95,22,14,8
7,19,96,19,15,4
7,19,97,16,9,7
7,19,98,17,6,11
7,19,99,20,16,4
7,19,100,30,23,7
7,19,101,35,9,26
7,19,102,24,10,14
7,19,103,29,19,10
7,19,104,15,8,7
7,19,105,13,8,5
7,19,106,14,14,0
7,19,107,22,18,4
7,19,108,15,5,10
7,19,109,14,10,4
7,19,110,22,10,12
7,19,111,24,20,4
7,19,112,15,7,8
7,19,113,6,10,-4
7,19,114,22,9,13
7,19,115,30,13,17
7,19,116,24,13,11
7,19,117,15,8,7
7,19,118,18,18,0
7,19,119,22,11,11
7,19,120,14,17,-3
7,19,121,14,8,6
7,19,122,16,8,8
7,19,123,16,19,-3
7,19,124,14,9,5
7,19,125,15,12,3
7,19,126,11,7,4
7,19,127,22,15,7
7,19,128,16,11,5
7,19,129,31,12,19
7,19,130,24,20,4
7,19,131,21,19,2
7,19,132,18,11,7
7,19,133,30,9,21
7,19,134,15,15,0
7,19,135,18,14,4
7,19,136,14,10,4
7,19,137,21,9,12
7,19,138,32,18,14
7,19,139,12,19,-7
7,19,140,18,12,6
7,19,141,21,17,4
7,19,142,22,11,11
7,19,143,44,27,17
7,19,144,19,14,5
7,19,145,14,9,5
7,19,146,12,14,-2
7,19,147,27,13,14
7,19,148,14,6,8
7,19,149,14,17,-3
7,19,150,39,22,17
7,19,151,14,11,3
7,19,152,14,7,7
7,19,153,18,4,14
7,19,154,22,12,10
7,19,155,20,17,3
7,19,156,10,11,-1
7,19,157,20,8,12
7,19,158,23,12,11
7,19,159,8,4,4
7,19,160,26,10,16
7,19,161,7,7,0
7,19,162,31,20,11
7,19,163,21,4,17
7,19,164,8,13,-5
7,19,165,17,7,10
7,19,166,18,16,2
7,19,167,37,23,14
7,19,168,14,16,-2
7,19,169,15,12,3
7,19,170,23,15,8
7,19,171,9,2,7
7,19,172,23,20,3
7,19,173,17,24,-7
7,19,174,15,14,1
7,19,175,15,16,-1
7,19,176,20,19,1
7,19,177,17,16,1
7,19,178,4,8,-4
7,19,179,26,29,-3
7,19,180,14,12,2
7,19,181,8,11,-3
7,19,182,13,10,3
7,19,183,24,13,11
7,19,184,18,11,7
7,19,185,7,5,2
7,19,186,27,5,22
7,19,187,24,22,2
7,19,188,14,10,4
7,19,189,16,18,-2
7,19,190,20,18,2
7,19,191,16,16,0
7,19,192,21,32,-11
7,19,193,32,20,12
7,19,194,23,16,7
7,19,195,11,7,4
7,19,196,9,5,4
7,19,197,9,11,-2
7,19,198,19,21,-2
7,19,199,11,8,3
7,19,200,21,13,8
7,19,201,11,15,-4
7,19,202,8,12,-4
7,19,203,18,18,0
7,19,204,16,15,1
7,19,205,17,18,-1
7,19,206,20,6,14
7,19,207,18,10,8
7,19,208,14,5,9
7,19,209,13,7,6
7,19,210,20,16,4
7,19,211,17,10,7
7,19,212,25,14,11
7,19,213,15,5,10
7,19,214,18,13,5
7,19,215,13,14,-1
7,19,216,26,7,19
7,19,217,11,16,-5
7,19,218,16,10,6
7,19,219,26,10,16
7,19,220,19,21,-2
7,19,221,20,9,11
7,19,222,12,14,-2
7,19,223,19,11,8
7,19,224,17,6,11
7,19,225,10,8,2
7,19,226,19,1,18
7,19,227,18,5,13
7,19,228,25,19,6
7,19,229,12,4,8
7,19,230,17,10,7
7,19,231,25,21,4
7,19,232,11,9,2
7,19,233,14,9,5
7,19,234,13,10,3
7,19,235,19,14,5
7,19,236,28,8,20
7,19,237,20,10,10
7,19,238,12,17,-5
7,19,239,19,17,2
7,19,240,19,20,-1
7,19,241,18,10,8
7,19,242,12,15,-3
7,19,243,21,23,-2
7,19,244,18,21,-3
7,19,245,9,8,1
7,19,246,13,10,3
7,19,247,21,20,1
7,19,248,17,12,5
7,19,249,10,20,-10
7,19,250,13,13,0
7,19,251,14,17,-3
7,19,252,28,22,6
7,19,253,29,10,19
7,19,254,22,15,7
7,19,255,12,7,5
7,19,256,25,13,12
7,19,257,15,10,5
7,19,258,28,6,22
7,19,259,27,9,18
7,19,260,24,16,8
7,19,261,17,18,-1
7,19,262,24,9,15
7,19,263,13,6,7
7,19,264,16,5,11
7,19,265,21,20,1
7,19,266,23,12,11
7,19,267,21,15,6
7,19,268,15,13,2
7,19,269,15,16,-1
7,19,270,25,17,8
7,19,271,8,7,1
7,19,272,28,14,14
7,19,273,14,14,0
7,19,274,15,9,6
7,19,275,29,18,11
7,19,276,15,18,-3
7,19,277,21,20,1
7,19,278,22,18,4
7,19,279,15,12,3
7,19,280,17,4,13
7,19,281,11,8,3
7,19,282,12,5,7
7,19,283,20,21,-1
7,19,284,14,20,-6
7,19,285,13,21,-8
7,19,286,30,17,13
7,19,287,26,20,6
7,19,288,7,7,0
7,19,289,11,24,-13
7,19,290,30,11,19
7,19,291,23,8,15
7,19,292,34,13,21
7,19,293,23,17,6
7,19,294,20,17,3
7,19,295,14,13,1
7,19,296,14,4,10
7,19,297,17,18,-1
7,19,298,14,12,2
7,19,299,10,4,6
7,20,0,12,4,8
7,20,1,13,15,-2
7,20,2,19,18,1
7,20,3,9,3,6
7,20,4,17,6,11
7,20,5,18,24,-6
7,20,6,25,26,-1
7,20,7,8,11,-3
7,20,8,21,13,8
7,20,9,21,18,3
7,20,10,30,13,17
7,20,11,16,12,4
7,20,12,15,10,5
7,20,13,18,14,4
7,20,14,23,19,4
7,20,15,14,6,8
7,20,16,10,13,-3
7,20,17,22,15,7
7,20,18,22,20,2
7,20,19,12,13,-1
7,20,20,20,23,-3
7,20,21,26,18,8
7,20,22,28,12,16
7,20,23,20,8,12
7,20,24,8,10,-2
7,20,25,22,8,14
7,20,26,25,12,13
7,20,27,16,25,-9
7,20,28,12,9,3
7,20,29,5,8,-3
7,20,30,24,12,12
7,20,31,14,15,-1
7,20,32,16,15,1
7,20,33,14,15,-1
7,20,34,17,16,1
7,20,35,22,7,15
7,20,36,20,14,6
7,20,37,6,20,-14
7,20,38,20,8,12
7,20,39,15,9,6
7,20,40,17,20,-3
7,20,41,27,8,19
7,20,42,8,8,0
7,20,43,22,14,8
7,20,44,16,15,1
7,20,45,18,5,13
7,20,46,10,11,-1
7,20,47,23,17,6
7,20,48,33,30,3
7,20,49,34,19,15
7,20,50,16,9,7
7,20,51,16,6,10
7,20,52,14,9,5
7,20,53,23,12,11
7,20,54,15,7,8
7,20,55,21,11,10
7,20,56,30,22,8
7,20,57,9,14,-5
7,20,58,15,12,3
7,20,59,14,17,-3
7,20,60,20,20,0
7,20,61,34,11,23
7,20,62,15,23,-8
7,20,63,22,14,8
7,20,64,29,19,10
7,20,65,18,7,11
7,20,66,14,14,0
7,20,67,15,7,8
7,20,68,11,5,6
7,20,69,16,6,10
7,20,70,20,7,13
7,20,71,22,14,8
7,20,72,10,5,5
7,20,73,5,2,3
7,20,74,32,15,17
7,20,75,17,24,-7
7,20,76,34,15,19
7,20,77,17,11,6
7,20,78,18,19,-1
7,20,79,20,18,2
7,20,80,9,9,0
7,20,81,21,8,13
7,20,82,23,25,-2
7,20,83,12,16,-4
7,20,84,16,10,6
7,20,85,13,19,-6
7,20,86,15,8,7
7,20,87,31,22,9
7,20,88,10,5,5
7,20,89,11,13,-2
7,20,90,13,12,1
7,20,91,25,12,13
7,20,92,15,7,8
7,20,93,17,13,4
7,20,94,16,12,4
7,20,95,23,11,12
7,20,96,17,16,1
7,20,97,29,14,15
7,20,98,12,7,5
7,20,99,23,15,8
7,20,100,15,8,7
7,20,101,17,13,4
7,20,102,22,20,2
7,20,103,15,10,5
7,20,104,19,10,9
7,20,105,17,16,1
7,20,106,17,12,5
7,20,107,15,19,-4
7,20,108,16,15,1
7,20,109,15,13,2
7,20,110,30,12,18
7,20,111,13,4,9
7,20,112,14,7,7
7,20,113,8,8,0
7,20,114,22,16,6
7,20,115,8,8,0
7,20,116,18,9,9
7,20,117,18,10,8
7,20,118,9,8,1
7,20,119,15,19,-4
7,20,120,20,12,8
7,20,121,18,14,4
7,20,122,27,15,12
7,20,123,6,6,0
7,20,124,17,18,-1
7,20,125,39,21,18
7,20,126,19,12,7
7,20,127,15,11,4
7,20,128,9,8,1
7,20,129,9,8,1
7,20,130,21,6,15
7,20,131,12,8,4
7,20,132,21,15,6
7,20,133,10,15,-5
7,20,134,19,20,-1
7,20,135,18,10,8
7,20,136,28,12,16
7,20,137,25,9,16
7,20,138,20,19,1
7,20,139,15,11,4
7,20,140,13,18,-5
7,20,141,22,13,9
7,20,142,25,11,14
7,20,143,18,11,7
7,20,144,11,3,8
7,20,145,25,2,23
7,20,146,16,10,6
7,20,147,12,11,1
7,20,148,23,8,15
7,20,149,15,9,6
7,20,150,23,7,16
7,20,151,6,3,3
7,20,152,22,12,10
7,20,153,28,13,15
7,20,154,13,18,-5
7,20,155,9,18,-9
7,20,156,10,3,7
7,20,157,14,7,7
7,20,158,17,8,9
7,20,159,10,8,2
7,20,160,11,9,2
7,20,161,16,15,1
7,20,162,11,10,1
7,20,163,20,9,11
7,20,164,28,25,3
7,20,165,15,15,0
7,20,166,34,19,15
7,20,167,21,25,-4
7,20,168,13,8,5
7,20,169,6,7,-1
7,20,170,6,15,-9
7,20,171,19,7,12
7,20,172,25,4,21
7,20,173,22,13,9
7,20,174,10,4,6
7,20,175,19,8,11
7,20,176,13,7,6
7,20,177,17,16,1
7,20,178,20,9,11
7,20,179,17,11,6
7,20,180,20,5,15
7,20,181,13,8,5
7,20,182,12,13,-1
7,20,183,22,15,7
7,20,184,22,7,15
7,20,185,19,14,5
7,20,186,25,9,16
7,20,187,12,16,-4
7,20,188,21,1,20
7,20,189,13,15,-2
7,20,190,23,15,8
7,20,191,20,10,10
7,20,192,29,16,13
7,20,193,23,17,6
7,20,194,19,24,-5
7,20,195,12,18,-6
7,20,196,11,14,-3
7,20,197,18,23,-5
7,20,198,29,18,11
7,20,199,10,11,-1
7,20,200,13,4,9
7,20,201,13,11,2
7,20,202,27,20,7
7,20,203,26,12,14
7,20,204,10,5,5
7,20,205,26,9,17
7,20,206,19,3,16
7,20,207,26,15,11
7,20,208,10,11,-1
7,20,209,19,17,2
7,20,210,9,18,-9
7,20,211,16,13,3
7,20,212,15,12,3
7,20,213,13,16,-3
7,20,214,35,16,19
7,20,215,16,18,-2
7,20,216,13,14,-1
7,20,217,25,10,15
7,20,218,12,23,-11
7,20,219,29,17,12
7,20,220,21,14,7
7,20,221,27,13,14
7,20,222,14,16,-2
7,20,223,20,22,-2
7,20,224,23,10,13
7,20,225,27,18,9
7,20,226,17,9,8
7,20,227,22,12,10
7,20,228,22,17,5
7,20,229,21,12,9
7,20,230,20,9,11
7,20,231,23,20,3
7,20,232,19,4,15
7,20,233,20,16,4
7,20,234,15,14,1
7,20,235,19,14,5
7,20,236,27,11,16
7,20,237,19,17,2
7,20,238,27,17,10
7,20,239,27,20,7
7,20,240,18,14,4
7,20,241,20,21,-1
7,20,242,9,12,-3
7,20,243,9,10,-1
7,20,244,17,15,2
7,20,245,12,6,6
7,20,246,29,21,8
7,20,247,20,12,8
7,20,248,25,11,14
7,20,249,20,9,11
7,20,250,14,17,-3
7,20,251,17,21,-4
7,20,252,15,14,1
7,20,253,21,7,14
7,20,254,16,13,3
7,20,255,14,13,1
7,20,256,21,17,4
7,20,257,12,9,3
7,20,258,28,24,4
7,20,259,21,17,4
7,20,260,20,15,5
7,20,261,26,9,17
7,20,262,17,11,6
7,20,263,15,10,5
7,20,264,32,13,19
7,20,265,26,12,14
7,20,266,25,11,14
7,20,267,10,17,-7
7,20,268,16,8,8
7,20,269,16,8,8
7,20,270,11,16,-5
7,20,271,11,21,-10
7,20,272,13,14,-1
7,20,273,27,17,10
7,20,274,17,11,6
7,20,275,15,11,4
7,20,276,17,20,-3
7,20,277,15,9,6
7,20,278,15,9,6
7,20,279,16,12,4
7,20,280,24,15,9
7,20,281,13,8,5
7,20,282,26,12,14
7,20,283,21,9,12
7,20,284,14,15,-1
7,20,285,18,12,6
7,20,286,22,19,3
7,20,287,20,15,5
7,20,288,17,12,5
7,20,289,26,22,4
7,20,290,20,19,1
7,20,291,25,10,15
7,20,292,10,9,1
7,20,293,8,14,-6
7,20,294,19,15,4
7,20,295,19,21,-2
7,20,296,27,15,12
7,20,297,8,10,-2
7,20,298,22,20,2
7,20,299,11,21,-10
7,21,0,7,20,-13
7,21,1,20,12,8
7,21,2,22,15,7
7,21,3,7,16,-9
7,21,4,13,22,-9
7,21,5,7,11,-4
7,21,6,8,7,1
7,21,7,13,7,6
7,21,8,11,9,2
7,21,9,15,11,4
7,21,10,14,16,-2
7,21,11,18,10,8
7,21,12,15,14,1
7,21,13,18,12,6
7,21,14,13,15,-2
7,21,15,25,10,15
7,21,16,25,15,10
7,21,17,22,11,11
7,21,18,18,17,1
7,21,19,22,17,5
7,21,20,23,20,3
7,21,21,18,4,14
7,21,22,24,12,12
7,21,23,17,8,9
7,21,24,21,11,10
7,21,25,9,13,-4
7,21,26,25,16,9
7,21,27,23,19,4
7,21,28,16,7,9
7,21,29,8,8,0
7,21,30,15,15,0
7,21,31,15,10,5
7,21,32,21,15,6
7,21,33,17,17,0
7,21,34,15,8,7
7,21,35,29,11,18
7,21,36,14,8,6
7,21,37,20,5,15
7,21,38,22,7,15
7,21,39,24,18,6
7,21,40,20,16,4
7,21,41,21,13,8
7,21,42,13,9,4
7,21,43,11,8,3
7,21,44,10,17,-7
7,21,45,22,6,16
7,21,46,18,9,9
7,21,47,20,15,5
7,21,48,46,15,31
7,21,49,25,16,9
7,21,50,18,16,2
7,21,51,16,6,10
7,21,52,26,13,13
7,21,53,21,7,14
7,21,54,15,12,3
7,21,55,19,14,5
7,21,56,23,15,8
7,21,57,17,24,-7
7,21,58,14,10,4
7,21,59,15,12,3
7,21,60,24,9,15
7,21,61,31,16,15
7,21,62,27,15,12
7,21,63,15,23,-8
7,21,64,28,16,12
7,21,65,22,11,11
7,21,66,20,22,-2
7,21,67,22,16,6
7,21,68,14,11,3
7,21,69,16,13,3
7,21,70,31,13,18
7,21,71,13,17,-4
7,21,72,29,8,21
7,21,73,11,5,6
7,21,74,14,9,5
7,21,75,20,21,-1
7,21,76,18,11,7
7,21,77,11,15,-4
7,21,78,21,15,6
7,21,79,6,21,-15
7,21,80,30,14,16
7,21,81,20,7,13
7,21,82,21,8,13
7,21,83,31,16,15
7,21,84,16,7,9
7,21,85,12,12,0
7,21,86,23,15,8
7,21,87,13,13,0
7,21,88,23,19,4
7,21,89,17,14,3
7,21,90,18,16,2
7,21,91,22,7,15
7,21,92,11,9,2
7,21,93,13,18,-5
7,21,94,18,23,-5
7,21,95,15,17,-2
7,21,96,18,6,12
7,21,97,8,9,-1
7,21,98,27,9,18
7,21,99,20,25,-5
7,21,100,32,14,18
7,21,101,16,18,-2
7,21,102,27,18,9
7,21,103,17,17,0
7,21,104,19,3,16
7,21,105,15,17,-2
7,21,106,16,15,1
7,21,107,15,5,10
7,21,108,23,9,14
7,21,109,16,15,1
7,21,110,20,11,9
7,21,111,16,9,7
7,21,112,19,9,10
7,21,113,28,9,19
7,21,114,17,24,-7
7,21,115,17,3,14
7,21,116,25,19,6
7,21,117,17,12,5
7,21,118,16,21,-5
7,21,119,13,18,-5
7,21,120,22,22,0
7,21,121,13,6,7
7,21,122,10,17,-7
7,21,123,22,16,6
7,21,124,30,20,10
7,21,125,13,11,2
7,21,126,30,8,22
7,21,127,10,6,4
7,21,128,20,13,7
7,21,129,18,13,5
7,21,130,12,5,7
7,21,131,29,12,17
7,21,132,13,1,12
7,21,133,19,7,12
7,21,134,18,17,1
7,21,135,13,5,8
7,21,136,16,6,10
7,21,137,13,8,5
7,21,138,17,20,-3
7,21,139,25,13,12
7,21,140,4,10,-6
7,21,141,31,20,11
7,21,142,9,8,1
7,21,143,9,10,-1
7,21,144,19,14,5
7,21,145,25,4,21
7,21,146,9,2,7
7,21,147,17,14,3
7,21,148,18,7,11
7,21,149,29,11,18
7,21,150,22,17,5
7,21,151,20,21,-1
7,21,152,10,11,-1
7,21,153,28,13,15
7,21,154,20,11,9
7,21,155,17,8,9
7,21,156,17,14,3
7,21,157,21,8,13
7,21,158,6,9,-3
7,21,159,6,2,4
7,21,160,17,11,6
7,21,161,4,7,-3
7,21,162,13,10,3
7,21,163,9,9,0
7,21,164,15,8,7
7,21,165,8,8,0
7,21,166,26,21,5
7,21,167,9,13,-4
7,21,168,18,17,1
7,21,169,12,15,-3
7,21,170,11,6,5
7,21,171,24,10,14
7,21,172,27,9,18
7,21,173,32,13,19
7,21,174,13,13,0
7,21,175,29,30,-1
7,21,176,12,16,-4
7,21,177,25,7,18
7,21,178,21,17,4
7,21,179,13,10,3
7,21,180,13,12,1
7,21,181,21,11,10
7,21,182,31,17,14
7,21,183,18,7,11
7,21,184,24,12,12
7,21,185,20,14,6
7,21,186,28,16,12
7,21,187,22,18,4
7,21,188,18,12,6
7,21,189,20,24,-4
7,21,190,13,12,1
7,21,191,15,4,11
7,21,192,16,15,1
7,21,193,8,10,-2
7,21,194,27,8,19
7,21,195,26,8,18
7,21,196,18,12,6
7,21,197,8,16,-8
7,21,198,11,9,2
7,21,199,16,13,3
7,21,200,36,14,22
7,21,201,16,5,11
7,21,202,24,13,11
7,21,203,23,13,10
7,21,204,14,13,1
7,21,205,8,10,-2
7,21,206,24,18,6
7,21,207,18,7,11
7,21,208,20,11,9
7,21,209,35,12,23
7,21,210,19,21,-2
7,21,211,20,14,6
7,21,212,5,11,-6
7,21,213,20,6,14
7,21,214,18,10,8
7,21,215,17,12,5
7,21,216,20,8,12
7,21,217,19,13,6
7,21,218,9,7,2
7,21,219,21,20,1
7,21,220,17,16,1
7,21,221,31,19,12
7,21,222,23,4,19
7,21,223,39,16,23
7,21,224,23,23,0
7,21,225,26,24,2
7,21,226,12,10,2
7,21,227,29,13,16
7,21,228,23,11,12
7,21,229,17,6,11
7,21,230,11,12,-1
7,21,231,11,8,3
7,21,232,21,6,15
7,21,233,11,7,4
7,21,234,16,4,12
7,21,235,10,6,4
7,21,236,23,14,9
7,21,237,15,8,7
7,21,238,13,6,7
7,21,239,5,7,-2
7,21,240,15,9,6
7,21,241,17,14,3
7,21,242,14,23,-9
7,21,243,23,23,0
7,21,244,11,9,2
7,21,245,22,12,10
7,21,246,13,7,6
7,21,247,19,14,5
7,21,248,16,7,9
7,21,249,24,21,3
7,21,250,23,18,5
7,21,251,20,7,13
7,21,252,11,10,1
7,21,253,19,6,13
7,21,254,12,5,7
7,21,255,14,8,6
7,21,256,16,8,8
7,21,257,10,8,2
7,21,258,27,21,6
7,21,259,21,22,-1
7,21,260,5,8,-3
7,21,261,20,12,8
7,21,262,14,6,8
7,21,263,17,18,-1
7,21,264,25,10,15
7,21,265,38,7,31
7,21,266,18,19,-1
7,21,267,16,13,3
7,21,268,16,13,3
7,21,269,23,6,17
7,21,270,21,15,6
7,21,271,20,12,8
7,21,272,14,14,0
7,21,273,28,11,17
7,21,274,23,14,9
7,21,275,16,14,2
7,21,276,17,13,4
7,21,277,15,16,-1
7,21,278,34,21,13
7,21,279,21,17,4
7,21,280,24,19,5
7,21,281,22,18,4
7,21,282,22,10,12
7,21,283,32,8,24
7,21,284,23,13,10
7,21,285,18,1,17
7,21,286,21,19,2
7,21,287,18,15,3
7,21,288,21,16,5
7,21,289,13,9,4
7,21,290,9,23,-14
7,21,291,27,17,10
7,21,292,22,29,-7
7,21,293,19,9,10
7,21,294,30,19,11
7,21,295,22,25,-3
7,21,296,10,6,4
7,21,297,25,16,9
7,21,298,30,8,22
7,21,299,23,13,10
7,22,0,17,11,6
7,22,1,14,11,3
7,22,2,26,14,12
7,22,3,11,8,3
7,22,4,7,10,-3
7,22,5,28,17,11
7,22,6,11,7,4
7,22,7,14,13,1
7,22,8,17,11,6
7,22,9,38,12,26
7,22,10,24,18,6
7,22,11,15,15,0
7,22,12,9,4,5
7,22,13,21,9,12
7,22,14,14,11,3
7,22,15,36,10,26
7,22,16,14,8,6
7,22,17,35,8,27
7,22,18,19,6,13
7,22,19,29,16,13
7,22,20,22,17,5
7,22,21,12,8,4
7,22,22,13,8,5
7,22,23,15,14,1
7,22,24,24,16,8
7,22,25,13,2,11
7,22,26,17,13,4
7,22,27,20,13,7
7,22,28,15,12,3
7,22,29,19,5,14
7,22,30,19,13,6
7,22,31,17,12,5
7,22,32,10,6,4
7,22,33,10,14,-4
7,22,34,19,13,6
7,22,35,11,7,4
7,22,36,13,8,5
7,22,37,23,11,12
7,22,38,12,8,4
7,22,39,15,4,11
7,22,40,12,12,0
7,22,41,34,6,28
7,22,42,15,4,11
7,22,43,12,11,1
7,22,44,25,12,13
7,22,45,22,7,15
7,22,46,18,11,7
7,22,47,22,13,9
7,22,48,25,7,18
7,22,49,34,26,8
7,22,50,20,14,6
7,22,51,19,11,8
7,22,52,17,10,7
7,22,53,18,15,3
7,22,54,13,8,5
7,22,55,23,8,15
7,22,56,15,10,5
7,22,57,35,18,17
7,22,58,13,10,3
7,22,59,22,11,11
7,22,60,18,9,9
7,22,61,6,11,-5
7,22,62,8,3,5
7,22,63,11,18,-7
7,22,64,13,11,2
7,22,65,20,9,11
7,22,66,27,13,14
7,22,67,16,6,10
7,22,68,12,3,9
7,22,69,16,10,6
7,22,70,8,5,3
7,22,71,10,15,-5
7,22,72,18,17,1
7,22,73,14,9,5
7,22,74,19,9,10
7,22,75,34,8,26
7,22,76,13,5,8
7,22,77,23,15,8
7,22,78,15,13,2
7,22,79,24,9,15
7,22,80,25,9,16
7,22,81,23,6,17
7,22,82,27,6,21
7,22,83,10,9,1
7,22,84,19,7,12
7,22,85,35,7,28
7,22,86,12,8,4
7,22,87,18,10,8
7,22,88,26,8,18
7,22,89,21,10,11
7,22,90,25,20,5
7,22,91,16,14,2
7,22,92,14,21,-7
7,22,93,20,17,3
7,22,94,20,11,9
7,22,95,17,17,0
7,22,96,8,10,-2
7,22,97,19,8,11
7,22,98,18,15,3
7,22,99,13,1,12
7,22,100,13,3,10
7,22,101,10,6,4
7,22,102,12,11,1
7,22,103,15,3,12
7,22,104,26,13,13
7,22,105,13,6,7
7,22,106,19,13,6
7,22,107,24,29,-5
7,22,108,12,11,1
7,22,109,24,18,6
7,22,110,13,12,1
7,22,111,25,9,16
7,22,112,19,7,12
7,22,113,24,28,-4
7,22,114,25,21,4
7,22,115,12,25,-13
7,22,116,25,15,10
7,22,117,10,18,-8
7,22,118,10,10,0
7,22,119,9,3,6
7,22,120,24,15,9
7,22,121,16,16,0
7,22,122,21,16,5
7,22,123,12,8,4
7,22,124,9,5,4
7,22,125,15,18,-3
7,22,126,22,19,3
7,22,127,10,12,-2
7,22,128,14,19,-5
7,22,129,10,7,3
7,22,130,13,6,7
7,22,131,17,12,5
7,22,132,19,12,7
7,22,133,24,10,14
7,22,134,18,7,11
7,22,135,24,7,17
7,22,136,22,29,-7
7,22,137,5,12,-7
7,22,138,21,10,11
7,22,139,11,13,-2
7,22,140,20,7,13
7,22,141,14,9,5
7,22,142,3,10,-7
7,22,143,18,20,-2
7,22,144,15,5,10
7,22,145,21,10,11
7,22,146,14,10,4
7,22,147,21,13,8
7,22,148,19,13,6
7,22,149,17,25,-8
7,22,150,10,9,1
7,22,151,22,9,13
7,22,152,10,7,3
7,22,153,29,12,17
7,22,154,12,10,2
7,22,155,27,15,12
7,22,156,18,14,4
7,22,157,9,4,5
7,22,158,16,9,7
7,22,159,22,10,12
7,22,160,19,8,11
7,22,161,18,7,11
7,22,162,12,4,8
7,22,163,28,16,12
7,22,164,18,17,1
7,22,165,25,10,15
7,22,166,14,9,5
7,22,167,23,20,3
7,22,168,36,17,19
7,22,169,21,21,0
7,22,170,13,6,7
7,22,171,19,8,11
7,22,172,22,12,10
7,22,173,25,26,-1
7,22,174,24,7,17
7,22,175,24,13,11
7,22,176,19,16,3
7,22,177,13,4,9
7,22,178,19,21,-2
7,22,179,18,13,5
7,22,180,20,16,4
7,22,181,16,12,4
7,22,182,13,15,-2
7,22,183,15,6,9
7,22,184,26,14,12
7,22,185,13,15,-2
7,22,186,22,13,9
7,22,187,13,12,1
7,22,188,18,9,9
7,22,189,10,5,5
7,22,190,21,18,3
7,22,191,13,3,10
7,22,192,26,24,2
7,22,193,18,16,2
7,22,194,18,11,7
7,22,195,11,13,-2
7,22,196,22,13,9
7,22,197,31,17,14
7,22,198,33,10,23
7,22,199,11,8,3
7,22,200,12,5,7
7,22,201,22,14,8
7,22,202,6,5,1
7,22,203,29,5,24
7,22,204,11,9,2
7,22,205,16,7,9
7,22,206,20,20,0
7,22,207,16,12,4
7,22,208,8,9,-1
7,22,209,11,4,7
7,22,210,15,14,1
7,22,211,22,14,8
7,22,212,23,18,5
7,22,213,16,7,9
7,22,214,19,26,-7
7,22,215,17,11,6
7,22,216,10,4,6
7,22,217,13,15,-2
7,22,218,34,13,21
7,22,219,15,14,1
7,22,220,13,9,4
7,22,221,12,11,1
7,22,222,9,20,-11
7,22,223,35,22,13
7,22,224,24,8,16
7,22,225,24,10,14
7,22,226,19,11,8
7,22,227,16,13,3
7,22,228,18,10,8
7,22,229,28,21,7
7,22,230,21,2,19
7,22,231,36,12,24
7,22,232,9,10,-1
7,22,233,20,19,1
7,22,234,26,24,2
7,22,235,12,18,-6
7,22,236,17,8,9
7,22,237,10,5,5
7,22,238,15,13,2
7,22,239,9,13,-4
7,22,240,12,8,4
7,22,241,12,8,4
7,22,242,16,8,8
7,22,243,18,9,9
7,22,244,12,9,3
7,22,245,13,11,2
7,22,246,8,9,-1
7,22,247,18,9,9
7,22,248,33,13,20
7,22,249,24,21,3
7,22,250,18,12,6
7,22,251,28,18,10
7,22,252,17,3,14
7,22,253,28,4,24
7,22,254,30,6,24
7,22,255,14,19,-5
7,22,256,15,12,3
7,22,257,20,9,11
7,22,258,13,11,2
7,22,259,14,18,-4
7,22,260,25,15,10
7,22,261,15,3,12
7,22,262,10,12,-2
7,22,263,29,13,16
7,22,264,25,15,10
7,22,265,17,9,8
7,22,266,37,14,23
7,22,267,29,18,11
7,22,268,17,9,8
7,22,269,19,9,10
7,22,270,10,15,-5
7,22,271,7,12,-5
7,22,272,17,17,0
7,22,273,21,7,14
7,22,274,27,9,18
7,22,275,20,8,12
7,22,276,28,15,13
7,22,277,10,11,-1
7,22,278,18,21,-3
7,22,279,28,19,9
7,22,280,22,10,12
7,22,281,10,10,0
7,22,282,27,22,5
7,22,283,22,13,9
7,22,284,36,15,21
7,22,285,13,7,6
7,22,286,12,6,6
7,22,287,15,1,14
7,22,288,12,2,10
7,22,289,37,18,19
7,22,290,10,8,2
7,22,291,20,9,11
7,22,292,14,14,0
7,22,293,21,14,7
7,22,294,14,7,7
7,22,295,18,27,-9
7,22,296,15,12,3
7,22,297,7,15,-8
7,22,298,11,14,-3
7,22,299,12,10,2
7,23,0,32,10,22
7,23,1,21,11,10
7,23,2,11,14,-3
7,23,3,24,18,6
7,23,4,23,14,9
7,23,5,22,17,5
7,23,6,32,16,16
7,23,7,25,11,14
7,23,8,13,3,10
7,23,9,16,11,5
7,23,10,8,5,3
7,23,11,35,13,22
7,23,12,20,7,13
7,23,13,11,5,6
7,23,14,16,8,8
7,23,15,20,15,5
7,23,16,12,13,-1
7,23,17,16,2,14
7,23,18,27,19,8
7,23,19,15,7,8
7,23,20,11,8,3
7,23,21,13,13,0
7,23,22,14,9,5
7,23,23,12,13,-1
7,23,24,12,10,2
7,23,25,19,13,6
7,23,26,30,17,13
7,23,27,16,11,5
7,23,28,27,9,18
7,23,29,23,10,13
7,23,30,12,14,-2
7,23,31,40,21,19
7,23,32,29,19,10
7,23,33,14,11,3
7,23,34,14,15,-1
7,23,35,6,7,-1
7,23,36,19,14,5
7,23,37,30,18,12
7,23,38,15,13,2
7,23,39,33,13,20
7,23,40,20,16,4
7,23,41,6,8,-2
7,23,42,15,7,8
7,23,43,19,12,7
7,23,44,31,12,19
7,23,45,29,11,18
7,23,46,16,13,3
7,23,47,40,13,27
7,23,48,10,12,-2
7,23,49,27,17,10
7,23,50,25,17,8
7,23,51,24,9,15
7,23,52,26,9,17
7,23,53,33,15,18
7,23,54,31,18,13
7,23,55,27,21,6
7,23,56,24,18,6
7,23,57,26,16,10
7,23,58,16,13,3
7,23,59,16,14,2
7,23,60,24,6,18
7,23,61,14,8,6
7,23,62,28,15,13
7,23,63,37,11,26
7,23,64,36,5,31
7,23,65,16,9,7
7,23,66,15,0,15
7,23,67,40,23,17
7,23,68,16,18,-2
7,23,69,17,13,4
7,23,70,19,9,10
7,23,71,24,6,18
7,23,72,31,5,26
7,23,73,16,10,6
7,23,74,16,11,5
7,23,75,12,13,-1
7,23,76,23,11,12
7,23,77,26,7,19
7,23,78,37,19,18
7,23,79,23,13,10
7,23,80,22,7,15
7,23,81,11,3,8
7,23,82,14,19,-5
7,23,83,24,18,6
7,23,84,10,8,2
7,23,85,14,22,-8
7,23,86,25,9,16
7,23,87,12,10,2
7,23,88,11,19,-8
7,23,89,13,11,2
7,23,90,16,14,2
7,23,91,16,10,6
7,23,92,30,16,14
7,23,93,20,19,1
7,23,94,20,8,12
7,23,95,28,10,18
7,23,96,7,7,0
7,23,97,15,10,5
7,23,98,33,12,21
7,23,99,20,9,11
7,23,100,9,2,7
7,23,101,19,5,14
7,23,102,19,13,6
7,23,103,22,9,13
7,23,104,25,14,11
7,23,105,19,3,16
7,23,106,18,18,0
7,23,107,25,7,18
7,23,108,16,2,14
7,23,109,31,4,27
7,23,110,18,7,11
7,23,111,15,8,7
7,23,112,8,9,-1
7,23,113,20,8,12
7,23,114,16,9,7
7,23,115,25,13,12
7,23,116,21,7,14
7,23,117,17,7,10
7,23,118,9,13,-4
7,23,119,23,11,12
7,23,120,17,8,9
7,23,121,12,24,-12
7,23,122,20,13,7
7,23,123,15,8,7
7,23,124,22,12,10
7,23,125,23,18,5
7,23,126,10,14,-4
7,23,127,8,13,-5
7,23,128,32,10,22
7,23,129,19,17,2
7,23,130,21,7,14
7,23,131,34,12,22
7,23,132,17,13,4
7,23,133,21,8,13
7,23,134,16,13,3
7,23,135,18,12,6
7,23,136,24,28,-4
7,23,137,19,36,-17
7,23,138,17,10,7
7,23,139,17,17,0
7,23,140,13,4,9
7,23,141,18,15,3
7,23,142,12,15,-3
7,23,143,5,7,-2
7,23,144,39,15,24
7,23,145,18,15,3
7,23,146,12,11,1
7,23,147,31,5,26
7,23,148,17,5,12
7,23,149,22,7,15
7,23,150,37,19,18
7,23,151,17,9,8
7,23,152,18,9,9
7,23,153,12,12,0
7,23,154,25,13,12
7,23,155,16,14,2
7,23,156,36,13,23
7,23,157,21,18,3
7,23,158,18,12,6
7,23,159,16,14,2
7,23,160,19,13,6
7,23,161,15,11,4
7,23,162,12,15,-3
7,23,163,16,18,-2
7,23,164,14,11,3
7,23,165,22,22,0
7,23,166,17,16,1
7,23,167,17,10,7
7,23,168,11,16,-5
7,23,169,16,8,8
7,23,170,31,26,5
7,23,171,13,10,3
7,23,172,21,11,10
7,23,173,25,11,14
7,23,174,32,14,18
7,23,175,15,16,-1
7,23,176,23,13,10
7,23,177,15,13,2
7,23,178,6,9,-3
7,23,179,25,17,8
7,23,180,10,7,3
7,23,181,15,6,9
7,23,182,18,10,8
7,23,183,13,8,5
7,23,184,22,14,8
7,23,185,17,12,5
7,23,186,26,6,20
7,23,187,19,11,8
7,23,188,17,10,7
7,23,189,13,11,2
7,23,190,15,8,7
7,23,191,23,13,10
7,23,192,26,13,13
7,23,193,23,14,9
7,23,194,15,14,1
7,23,195,24,13,11
7,23,196,17,7,10
7,23,197,19,15,4
7,23,198,18,13,5
7,23,199,22,7,15
7,23,200,20,11,9
7,23,201,32,14,18
7,23,202,22,19,3
7,23,203,24,22,2
7,23,204,23,8,15
7,23,205,16,7,9
7,23,206,19,10,9
7,23,207,18,6,12
7,23,208,17,11,6
7,23,209,32,15,17
7,23,210,30,17,13
7,23,211,16,10,6
7,23,212,17,11,6
7,23,213,25,17,8
7,23,214,20,19,1
7,23,215,16,7,9
7,23,216,13,5,8
7,23,217,18,16,2
7,23,218,3,12,-9
7,23,219,31,15,16
7,23,220,23,14,9
7,23,221,27,14,13
7,23,222,14,9,5
7,23,223,10,11,-1
7,23,224,20,5,15
7,23,225,11,3,8
7,23,226,31,26,5
7,23,227,10,7,3
7,23,228,8,5,3
7,23,229,15,17,-2
7,23,230,18,24,-6
7,23,231,25,10,15
7,23,232,17,12,5
7,23,233,12,11,1
7,23,234,24,19,5
7,23,235,26,8,18
7,23,236,26,16,10
7,23,237,15,7,8
7,23,238,24,6,18
7,23,239,14,5,9
7,23,240,18,12,6
7,23,241,6,14,-8
7,23,242,26,16,10
7,23,243,32,24,8
7,23,244,25,13,12
7,23,245,22,9,13
7,23,246,33,12,21
7,23,247,25,15,10
7,23,248,13,12,1
7,23,249,38,15,23
7,23,250,28,20,8
7,23,251,31,15,16
7,23,252,19,16,3
7,23,253,24,12,12
7,23,254,19,15,4
7,23,255,23,19,4
7,23,256,21,10,11
7,23,257,18,5,13
7,23,258,16,3,13
7,23,259,43,29,14
7,23,260,15,11,4
7,23,261,18,15,3
7,23,262,16,9,7
7,23,263,23,11,12
7,23,264,18,7,11
7,23,265,27,24,3
7,23,266,12,8,4
7,23,267,6,7,-1
7,23,268,26,19,7
7,23,269,19,15,4
7,23,270,23,7,16
7,23,271,6,9,-3
7,23,272,13,13,0
7,23,273,19,15,4
7,23,274,22,0,22
7,23,275,14,15,-1
7,23,276,16,15,1
7,23,277,18,11,7
7,23,278,16,14,2
7,23,279,16,9,7
7,23,280,23,9,14
7,23,281,12,16,-4
7,23,282,27,13,14
7,23,283,14,7,7
7,23,284,26,9,17
7,23,285,24,14,10
7,23,286,24,19,5
7,23,287,9,15,-6
7,23,288,19,15,4
7,23,289,11,6,5
7,23,290,24,14,10
7,23,291,19,9,10
7,23,292,16,9,7
7,23,293,15,10,5
7,23,294,33,10,23
7,23,295,18,10,8
7,23,296,41,8,33
7,23,297,12,6,6
7,23,298,22,12,10
7,23,299,18,18,0
7,24,0,21,10,11
7,24,1,19,16,3
7,24,2,18,7,11
7,24,3,17,12,5
7,24,4,9,9,0
7,24,5,20,14,6
7,24,6,20,15,5
7,24,7,9,10,-1
7,24,8,16,9,7
7,24,9,21,14,7
7,24,10,16,7,9
7,24,11,25,7,18
7,24,12,24,11,13
7,24,13,17,12,5
7,24,14,34,18,16
7,24,15,23,9,14
7,24,16,29,15,14
7,24,17,20,10,10
7,24,18,21,14,7
7,24,19,18,9,9
7,24,20,24,16,8
7,24,21,13,9,4
7,24,22,33,8,25
7,24,23,14,3,11
7,24,24,18,14,4
7,24,25,20,14,6
7,24,26,22,11,11
7,24,27,8,5,3
7,24,28,16,11,5
7,24,29,18,1,17
7,24,30,28,6,22
7,24,31,17,8,9
7,24,32,18,10,8
7,24,33,21,13,8
7,24,34,19,8,11
7,24,35,22,10,12
7,24,36,12,9,3
7,24,37,14,16,-2
7,24,38,16,7,9
7,24,39,11,4,7
7,24,40,15,8,7
7,24,41,16,10,6
7,24,42,27,21,6
7,24,43,27,7,20
7,24,44,15,17,-2
7,24,45,11,7,4
7,24,46,14,11,3
7,24,47,19,7,12
7,24,48,23,11,12
7,24,49,5,7,-2
7,24,50,11,9,2
7,24,51,22,15,7
7,24,52,18,16,2
7,24,53,7,9,-2
7,24,54,13,15,-2
7,24,55,15,2,13
7,24,56,10,3,7
7,24,57,16,16,0
7,24,58,23,2,21
7,24,59,17,4,13
7,24,60,18,1,17
7,24,61,19,14,5
7,24,62,18,14,4
7,24,63,12,19,-7
7,24,64,24,12,12
7,24,65,17,5,12
7,24,66,27,7,20
7,24,67,25,13,12
7,24,68,18,19,-1
7,24,69,14,4,10
7,24,70,22,15,7
7,24,71,17,14,3
7,24,72,19,9,10
7,24,73,6,8,-2
7,24,74,20,8,12
7,24,75,22,6,16
7,24,76,24,9,15
7,24,77,20,13,7
7,24,78,50,8,42
7,24,79,22,14,8
7,24,80,22,5,17
7,24,81,15,13,2
7,24,82,27,12,15
7,24,83,19,9,10
7,24,84,17,10,7
7,24,85,21,9,12
7,24,86,20,18,2
7,24,87,21,21,0
7,24,88,26,13,13
7,24,89,28,15,13
7,24,90,32,17,15
7,24,91,28,7,21
7,24,92,14,16,-2
7,24,93,26,6,20
7,24,94,8,5,3
7,24,95,17,19,-2
7,24,96,19,13,6
7,24,97,30,8,22
7,24,98,28,17,11
7,24,99,18,10,8
7,24,100,27,8,19
7,24,101,17,16,1
7,24,102,13,14,-1
7,24,103,23,16,7
7,24,104,13,19,-6
7,24,105,11,13,-2
7,24,106,15,16,-1
7,24,107,13,12,1
7,24,108,13,3,10
7,24,109,11,11,0
7,24,110,6,4,2
7,24,111,26,27,-1
7,24,112,8,19,-11
7,24,113,17,21,-4
7,24,114,15,14,1
7,24,115,34,10,24
7,24,116,15,4,11
7,24,117,14,12,2
7,24,118,10,6,4
7,24,119,18,12,6
7,24,120,18,14,4
7,24,121,30,10,20
7,24,122,15,16,-1
7,24,123,13,16,-3
7,24,124,19,11,8
7,24,125,21,20,1
7,24,126,22,14,8
7,24,127,16,14,2
7,24,128,12,11,1
7,24,129,21,11,10
7,24,130,39,18,21
7,24,131,16,19,-3
7,24,132,11,8,3
7,24,133,18,11,7
7,24,134,13,11,2
7,24,135,18,12,6
7,24,136,19,8,11
7,24,137,29,24,5
7,24,138,8,4,4
7,24,139,25,9,16
7,24,140,21,11,10
7,24,141,27,9,18
7,24,142,32,14,18
7,24,143,15,17,-2
7,24,144,32,14,18
7,24,145,12,6,6
7,24,146,18,3,15
7,24,147,21,9,12
7,24,148,24,10,14
7,24,149,24,10,14
7,24,150,38,8,30
7,24,151,13,8,5
7,24,152,15,22,-7
7,24,153,16,13,3
7,24,154,20,4,16
7,24,155,26,4,22
7,24,156,16,12,4
7,24,157,31,5,26
7,24,158,22,15,7
7,24,159,16,9,7
7,24,160,1,4,-3
7,24,161,35,11,24
7,24,162,25,16,9
7,24,163,12,3,9
7,24,164,16,7,9
7,24,165,14,12,2
7,24,166,9,17,-8
7,24,167,21,11,10
7,24,168,21,7,14
7,24,169,32,11,21
7,24,170,21,10,11
7,24,171,20,12,8
7,24,172,13,3,10
7,24,173,13,5,8
7,24,174,15,15,0
7,24,175,9,8,1
7,24,176,15,16,-1
7,24,177,22,30,-8
7,24,178,35,13,22
7,24,179,19,19,0
7,24,180,11,18,-7
7,24,181,16,11,5
7,24,182,29,13,16
7,24,183,29,14,15
7,24,184,33,16,17
7,24,185,9,12,-3
7,24,186,18,11,7
7,24,187,29,13,16
7,24,188,12,17,-5
7,24,189,16,10,6
7,24,190,18,12,6
7,24,191,15,13,2
7,24,192,17,8,9
7,24,193,14,12,2
7,24,194,15,5,10
7,24,195,6,5,1
7,24,196,28,12,16
7,24,197,14,12,2
7,24,198,14,15,-1
7,24,199,19,19,0
7,24,200,30,21,9
7,24,201,27,19,8
7,24,202,18,12,6
7,24,203,19,13,6
7,24,204,34,8,26
7,24,205,16,9,7
7,24,206,15,5,10
7,24,207,11,21,-10
7,24,208,9,17,-8
7,24,209,22,8,14
7,24,210,12,12,0
7,24,211,8,19,-11
7,24,212,12,8,4
7,24,213,25,19,6
7,24,214,21,11,10
7,24,215,14,10,4
7,24,216,19,4,15
7,24,217,14,11,3
7,24,218,21,16,5
7,24,219,10,17,-7
7,24,220,21,19,2
7,24,221,15,12,3
7,24,222,25,19,6
7,24,223,31,16,15
7,24,224,11,11,0
7,24,225,13,14,-1
7,24,226,15,13,2
7,24,227,38,22,16
7,24,228,27,14,13
7,24,229,14,8,6
7,24,230,11,8,3
7,24,231,12,8,4
7,24,232,18,16,2
7,24,233,22,8,14
7,24,234,32,33,-1
7,24,235,27,16,11
7,24,236,21,21,0
7,24,237,15,6,9
7,24,238,17,4,13
7,24,239,15,9,6
7,24,240,11,11,0
7,24,241,33,29,4
7,24,242,19,21,-2
7,24,243,29,17,12
7,24,244,29,17,12
7,24,245,19,11,8
7,24,246,24,19,5
7,24,247,9,7,2
7,24,248,18,14,4
7,24,249,21,21,0
7,24,250,19,8,11
7,24,251,4,5,-1
7,24,252,9,16,-7
7,24,253,22,13,9
7,24,254,27,10,17
7,24,255,28,10,18
7,24,256,23,19,4
7,24,257,23,11,12
7,24,258,28,20,8
7,24,259,19,16,3
7,24,260,18,12,6
7,24,261,30,10,20
7,24,262,31,27,4
7,24,263,26,17,9
7,24,264,12,11,1
7,24,265,19,8,11
7,24,266,19,8,11
7,24,267,11,14,-3
7,24,268,17,19,-2
7,24,269,24,11,13
7,24,270,25,12,13
7,24,271,15,8,7
7,24,272,14,9,5
7,24,273,16,8,8
7,24,274,20,6,14
7,24,275,19,12,7
7,24,276,10,12,-2
7,24,277,22,9,13
7,24,278,19,17,2
7,24,279,21,15,6
7,24,280,29,13,16
7,24,281,30,11,19
7,24,282,7,9,-2
7,24,283,17,8,9
7,24,284,21,9,12
7,24,285,23,14,9
7,24,286,31,9,22
7,24,287,12,13,-1
7,24,288,18,20,-2
7,24,289,25,16,9
7,24,290,17,10,7
7,24,291,11,13,-2
7,24,292,18,9,9
7,24,293,14,5,9
7,24,294,17,10,7
7,24,295,19,9,10
7,24,296,27,12,15
7,24,297,8,20,-12
7,24,298,7,7,0
7,24,299,9,5,4
7,25,0,18,8,10
7,25,1,26,16,10
7,25,2,26,13,13
7,25,3,19,6,13
7,25,4,16,16,0
7,25,5,19,11,8
7,25,6,25,16,9
7,25,7,19,9,10
7,25,8,24,11,13
7,25,9,15,8,7
7,25,10,16,7,9
7,25,11,10,18,-8
7,25,12,27,15,12
7,25,13,28,10,18
7,25,14,18,4,14
7,25,15,10,3,7
7,25,16,30,32,-2
7,25,17,17,11,6
7,25,18,22,14,8
7,25,19,22,19,3
7,25,20,7,8,-1
7,25,21,21,12,9
7,25,22,19,14,5
7,25,23,20,12,8
7,25,24,23,6,17
7,25,25,35,19,16
7,25,26,15,8,7
7,25,27,25,15,10
7,25,28,18,9,9
7,25,29,23,17,6
7,25,30,17,8,9
7,25,31,11,9,2
7,25,32,21,8,13
7,25,33,15,16,-1
7,25,34,18,13,5
7,25,35,27,13,14
7,25,36,25,7,18
7,25,37,17,11,6
7,25,38,19,6,13
7,25,39,17,7,10
7,25,40,18,12,6
7,25,41,12,7,5
7,25,42,19,11,8
7,25,43,17,12,5
7,25,44,16,12,4
7,25,45,3,5,-2
7,25,46,17,10,7
7,25,47,28,21,7
7,25,48,23,20,3
7,25,49,10,10,0
7,25,50,26,7,19
7,25,51,23,8,15
7,25,52,5,11,-6
7,25,53,12,10,2
7,25,54,31,4,27
7,25,55,21,11,10
7,25,56,13,7,6
7,25,57,13,8,5
7,25,58,18,8,10
7,25,59,17,20,-3
7,25,60,18,8,10
7,25,61,44,10,34
7,25,62,12,7,5
7,25,63,23,26,-3
7,25,64,24,16,8
7,25,65,21,20,1
7,25,66,14,9,5
7,25,67,22,7,15
7,25,68,30,9,21
7,25,69,23,18,5
7,25,70,19,7,12
7,25,71,42,20,22
7,25,72,22,10,12
7,25,73,31,15,16
7,25,74,8,7,1
7,25,75,13,6,7
7,25,76,38,13,25
7,25,77,6,7,-1
7,25,78,21,19,2
7,25,79,26,7,19
7,25,80,13,15,-2
7,25,81,19,5,14
7,25,82,9,8,1
7,25,83,22,11,11
7,25,84,17,6,11
7,25,85,36,12,24
7,25,86,15,8,7
7,25,87,15,6,9
7,25,88,9,9,0
7,25,89,27,11,16
7,25,90,32,13,19
7,25,91,19,3,16
7,25,92,14,15,-1
7,25,93,28,15,13
7,25,94,20,23,-3
7,25,95,13,6,7
7,25,96,10,11,-1
7,25,97,12,9,3
7,25,98,22,18,4
7,25,99,10,7,3
7,25,100,31,18,13
7,25,101,14,12,2
7,25,102,25,22,3
7,25,103,16,15,1
7,25,104,27,13,14
7,25,105,12,10,2
7,25,106,7,9,-2
7,25,107,25,18,7
7,25,108,44,17,27
7,25,109,17,7,10
7,25,110,18,10,8
7,25,111,19,14,5
7,25,112,14,14,0
7,25,113,20,6,14
7,25,114,18,17,1
7,25,115,21,9,12
7,25,116,21,12,9
7,25,117,6,4,2
7,25,118,5,8,-3
7,25,119,21,8,13
7,25,120,23,10,13
7,25,121,14,8,6
7,25,122,16,11,5
7,25,123,23,11,12
7,25,124,14,3,11
7,25,125,28,12,16
7,25,126,30,20,10
7,25,127,22,17,5
7,25,128,17,17,0
7,25,129,6,13,-7
7,25,130,23,23,0
7,25,131,23,15,8
7,25,132,18,17,1
7,25,133,18,15,3
7,25,134,23,16,7
7,25,135,20,21,-1
7,25,136,14,20,-6
7,25,137,12,7,5
7,25,138,17,10,7
7,25,139,16,12,4
7,25,140,19,11,8
7,25,141,11,21,-10
7,25,142,12,3,9
7,25,143,23,11,12
7,25,144,32,19,13
7,25,145,20,17,3
7,25,146,28,8,20
7,25,147,22,14,8
7,25,148,28,10,18
7,25,149,23,12,11
7,25,150,29,5,24
7,25,151,20,13,7
7,25,152,28,9,19
7,25,153,29,11,18
7,25,154,16,11,5
7,25,155,16,11,5
7,25,156,15,13,2
7,25,157,13,7,6
7,25,158,27,11,16
7,25,159,5,10,-5
7,25,160,16,13,3
7,25,161,29,18,11
7,25,162,23,11,12
7,25,163,23,16,7
7,25,164,21,4,17
7,25,165,19,9,10
7,25,166,36,14,22
7,25,167,25,17,8
7,25,168,21,13,8
7,25,169,9,6,3
7,25,170,6,8,-2
7,25,171,17,6,11
7,25,172,29,23,6
7,25,173,16,13,3
7,25,174,14,10,4
7,25,175,21,12,9
7,25,176,12,9,3
7,25,177,19,10,9
7,25,178,18,16,2
7,25,179,15,15,0
7,25,180,18,10,8
7,25,181,13,9,4
7,25,182,22,9,13
7,25,183,36,18,18
7,25,184,15,6,9
7,25,185,29,21,8
7,25,186,25,18,7
7,25,187,7,11,-4
7,25,188,15,18,-3
7,25,189,17,20,-3
7,25,190,19,8,11
7,25,191,9,9,0
7,25,192,15,17,-2
7,25,193,21,27,-6
7,25,194,23,14,9
7,25,195,19,9,10
7,25,196,29,10,19
7,25,197,16,8,8
7,25,198,22,16,6
7,25,199,14,9,5
7,25,200,23,14,9
7,25,201,15,10,5
7,25,202,15,8,7
7,25,203,20,9,11
7,25,204,21,13,8
7,25,205,25,17,8
7,25,206,7,11,-4
7,25,207,28,10,18
7,25,208,12,9,3
7,25,209,33,9,24
7,25,210,24,7,17
7,25,211,20,7,13
7,25,212,19,13,6
7,25,213,31,13,18
7,25,214,15,5,10
7,25,215,22,22,0
7,25,216,42,15,27
7,25,217,10,12,-2
7,25,218,24,6,18
7,25,219,15,9,6
7,25,220,11,7,4
7,25,221,12,9,3
7,25,222,15,5,10
7,25,223,9,9,0
7,25,224,16,15,1
7,25,225,13,9,4
7,25,226,14,9,5
7,25,227,31,15,16
7,25,228,24,9,15
7,25,229,10,7,3
7,25,230,26,13,13
7,25,231,7,12,-5
7,25,232,18,19,-1
7,25,233,12,10,2
7,25,234,18,18,0
7,25,235,28,14,14
7,25,236,23,11,12
7,25,237,24,12,12
7,25,238,20,11,9
7,25,239,9,7,2
7,25,240,30,16,14
7,25,241,26,12,14
7,25,242,12,11,1
7,25,243,23,17,6
7,25,244,11,12,-1
7,25,245,24,8,16
7,25,246,17,9,8
7,25,247,23,5,18
7,25,248,23,19,4
7,25,249,18,21,-3
7,25,250,31,12,19
7,25,251,19,6,13
7,25,252,19,16,3
7,25,253,16,0,16
7,25,254,13,9,4
7,25,255,26,14,12
7,25,256,29,7,22
7,25,257,28,13,15
7,25,258,20,9,11
7,25,259,18,12,6
7,25,260,22,8,14
7,25,261,30,11,19
7,25,262,16,15,1
7,25,263,18,7,11
7,25,264,29,10,19
7,25,265,27,13,14
7,25,266,26,18,8
7,25,267,17,9,8
7,25,268,25,13,12
7,25,269,25,10,15
7,25,270,19,12,7
7,25,271,19,15,4
7,25,272,20,7,13
7,25,273,25,3,22
7,25,274,20,12,8
7,25,275,25,12,13
7,25,276,9,10,-1
7,25,277,5,4,1
7,25,278,21,8,13
7,25,279,16,10,6
7,25,280,27,5,22
7,25,281,22,13,9
7,25,282,38,8,30
7,25,283,35,14,21
7,25,284,10,4,6
7,25,285,29,7,22
7,25,286,17,11,6
7,25,287,23,18,5
7,25,288,10,16,-6
7,25,289,31,16,15
7,25,290,20,13,7
7,25,291,31,12,19
7,25,292,20,4,16
7,25,293,23,9,14
7,25,294,24,8,16
7,25,295,19,14,5
7,25,296,16,9,7
7,25,297,16,15,1
7,25,298,15,16,-1
7,25,299,24,5,19
7,26,0,6,13,-7
7,26,1,26,19,7
7,26,2,5,5,0
7,26,3,28,11,17
7,26,4,21,3,18
7,26,5,23,11,12
7,26,6,15,9,6
7,26,7,32,17,15
7,26,8,26,19,7
7,26,9,30,8,22
7,26,10,19,12,7
7,26,11,13,4,9
7,26,12,24,10,14
7,26,13,13,9,4
7,26,14,15,14,1
7,26,15,21,19,2
7,26,16,20,20,0
7,26,17,24,10,14
7,26,18,17,7,10
7,26,19,16,0,16
7,26,20,21,18,3
7,26,21,18,12,6
7,26,22,20,7,13
7,26,23,13,14,-1
7,26,24,19,8,11
7,26,25,26,17,9
7,26,26,22,21,1
7,26,27,13,2,11
7,26,28,20,16,4
7,26,29,18,5,13
7,26,30,19,25,-6
7,26,31,24,15,9
7,26,32,27,19,8
7,26,33,14,11,3
7,26,34,14,9,5
7,26,35,16,12,4
7,26,36,21,18,3
7,26,37,25,16,9
7,26,38,27,8,19
7,26,39,18,16,2
7,26,40,18,14,4
7,26,41,10,12,-2
7,26,42,24,4,20
7,26,43,26,6,20
7,26,44,15,9,6
7,26,45,11,13,-2
7,26,46,16,0,16
7,26,47,19,12,7
7,26,48,18,8,10
7,26,49,19,26,-7
7,26,50,11,9,2
7,26,51,15,9,6
7,26,52,9,13,-4
7,26,53,19,28,-9
7,26,54,21,9,12
7,26,55,24,7,17
7,26,56,26,14,12
7,26,57,34,13,21
7,26,58,19,15,4
7,26,59,13,7,6
7,26,60,16,12,4
7,26,61,3,12,-9
7,26,62,19,4,15
7,26,63,26,18,8
7,26,64,23,13,10
7,26,65,37,9,28
7,26,66,12,2,10
7,26,67,22,16,6
7,26,68,18,16,2
7,26,69,24,8,16
7,26,70,11,10,1
7,26,71,25,8,17
7,26,72,7,5,2
7,26,73,32,15,17
7,26,74,25,22,3
7,26,75,19,0,19
7,26,76,23,19,4
7,26,77,23,6,17
7,26,78,8,8,0
7,26,79,19,12,7
7,26,80,20,17,3
7,26,81,14,8,6
7,26,82,24,8,16
7,26,83,27,11,16
7,26,84,23,21,2
7,26,85,19,5,14
7,26,86,17,5,12
7,26,87,16,9,7
7,26,88,19,9,10
7,26,89,23,8,15
7,26,90,32,15,17
7,26,91,20,10,10
7,26,92,19,10,9
7,26,93,10,10,0
7,26,94,15,8,7
7,26,95,28,10,18
7,26,96,11,6,5
7,26,97,20,9,11
7,26,98,23,10,13
7,26,99,18,12,6
7,26,100,21,23,-2
7,26,101,29,12,17
7,26,102,13,2,11
7,26,103,14,16,-2
7,26,104,11,5,6
7,26,105,16,7,9
7,26,106,25,5,20
7,26,107,22,9,13
7,26,108,13,5,8
7,26,109,24,10,14
7,26,110,17,13,4
7,26,111,24,5,19
7,26,112,26,5,21
7,26,113,18,7,11
7,26,114,24,7,17
7,26,115,9,24,-15
7,26,116,10,10,0
7,26,117,16,4,12
7,26,118,19,9,10
7,26,119,22,12,10
7,26,120,18,14,4
7,26,121,28,8,20
7,26,122,17,11,6
7,26,123,25,10,15
7,26,124,29,9,20
7,26,125,15,15,0
7,26,126,18,9,9
7,26,127,37,15,22
7,26,128,25,11,14
7,26,129,21,15,6
7,26,130,17,7,10
7,26,131,22,13,9
7,26,132,19,13,6
7,26,133,11,15,-4
7,26,134,10,11,-1
7,26,135,51,17,34
7,26,136,25,12,13
7,26,137,17,16,1
7,26,138,8,6,2
7,26,139,13,6,7
7,26,140,14,16,-2
7,26,141,12,5,7
7,26,142,12,3,9
7,26,143,21,5,16
7,26,144,17,18,-1
7,26,145,25,14,11
7,26,146,18,11,7
7,26,147,17,21,-4
7,26,148,14,11,3
7,26,149,20,15,5
7,26,150,16,16,0
7,26,151,26,12,14
7,26,152,19,9,10
7,26,153,18,5,13
7,26,154,14,5,9
7,26,155,18,7,11
7,26,156,10,1,9
7,26,157,26,18,8
7,26,158,19,14,5
7,26,159,23,15,8
7,26,160,16,4,12
7,26,161,36,16,20
7,26,162,20,25,-5
7,26,163,22,15,7
7,26,164,26,8,18
7,26,165,24,14,10
7,26,166,24,10,14
7,26,167,33,5,28
7,26,168,20,11,9
7,26,169,30,7,23
7,26,170,22,11,11
7,26,171,18,13,5
7,26,172,14,6,8
7,26,173,27,25,2
7,26,174,22,10,12
7,26,175,15,16,-1
7,26,176,12,21,-9
7,26,177,18,11,7
7,26,178,19,12,7
7,26,179,26,19,7
7,26,180,18,9,9
7,26,181,25,16,9
7,26,182,13,10,3
7,26,183,16,21,-5
7,26,184,18,9,9
7,26,185,11,8,3
7,26,186,18,5,13
7,26,187,20,7,13
7,26,188,21,16,5
7,26,189,14,3,11
7,26,190,15,7,8
7,26,191,34,10,24
7,26,192,17,14,3
7,26,193,24,12,12
7,26,194,31,3,28
7,26,195,22,17,5
7,26,196,27,4,23
7,26,197,19,12,7
7,26,198,22,7,15
7,26,199,15,7,8
7,26,200,14,8,6
7,26,201,22,13,9
7,26,202,13,19,-6
7,26,203,26,20,6
7,26,204,20,16,4
7,26,205,26,7,19
7,26,206,18,13,5
7,26,207,15,9,6
7,26,208,12,12,0
7,26,209,31,11,20
7,26,210,9,6,3
7,26,211,20,14,6
7,26,212,21,7,14
7,26,213,22,15,7
7,26,214,18,10,8
7,26,215,34,14,20
7,26,216,16,7,9
7,26,217,19,15,4
7,26,218,20,9,11
7,26,219,15,9,6
7,26,220,24,10,14
7,26,221,35,11,24
7,26,222,12,9,3
7,26,223,23,12,11
7,26,224,2,4,-2
7,26,225,9,4,5
7,26,226,36,19,17
7,26,227,25,13,12
7,26,228,18,6,12
7,26,229,12,4,8
7,26,230,7,13,-6
7,26,231,20,24,-4
7,26,232,30,12,18
7,26,233,14,12,2
7,26,234,19,15,4
7,26,235,25,15,10
7,26,236,12,6,6
7,26,237,3,3,0
7,26,238,14,14,0
7,26,239,26,23,3
7,26,240,9,6,3
7,26,241,15,10,5
7,26,242,19,10,9
7,26,243,32,13,19
7,26,244,27,9,18
7,26,245,19,6,13
7,26,246,18,9,9
7,26,247,16,5,11
7,26,248,13,7,6
7,26,249,18,9,9
7,26,250,14,8,6
7,26,251,12,8,4
7,26,252,7,9,-2
7,26,253,20,14,6
7,26,254,16,34,-18
7,26,255,12,12,0
7,26,256,22,6,16
7,26,257,12,4,8
7,26,258,19,9,10
7,26,259,15,12,3
7,26,260,29,21,8
7,26,261,27,11,16
7,26,262,10,6,4
7,26,263,10,2,8
7,26,264,13,8,5
7,26,265,32,14,18
7,26,266,15,25,-10
7,26,267,14,14,0
7,26,268,17,5,12
7,26,269,13,10,3
7,26,270,21,8,13
7,26,271,19,5,14
7,26,272,21,16,5
7,26,273,18,5,13
7,26,274,16,11,5
7,26,275,18,13,5
7,26,276,27,9,18
7,26,277,12,4,8
7,26,278,24,13,11
7,26,279,28,12,16
7,26,280,12,10,2
7,26,281,9,8,1
7,26,282,21,7,14
7,26,283,19,9,10
7,26,284,13,7,6
7,26,285,23,15,8
7,26,286,21,13,8
7,26,287,22,9,13
7,26,288,37,5,32
7,26,289,4,4,0
7,26,290,30,19,11
7,26,291,17,21,-4
7,26,292,15,10,5
7,26,293,21,6,15
7,26,294,14,9,5
7,26,295,21,9,12
7,26,296,20,10,10
7,26,297,24,7,17
7,26,298,11,12,-1
7,26,299,27,12,15
7,27,0,18,12,6
7,27,1,8,20,-12
7,27,2,12,13,-1
7,27,3,50,22,28
7,27,4,8,10,-2
7,27,5,26,8,18
7,27,6,21,12,9
7,27,7,5,0,5
7,27,8,7,11,-4
7,27,9,22,8,14
7,27,10,18,14,4
7,27,11,20,13,7
7,27,12,13,8,5
7,27,13,18,7,11
7,27,14,10,16,-6
7,27,15,5,8,-3
7,27,16,36,7,29
7,27,17,15,11,4
7,27,18,21,10,11
7,27,19,18,12,6
7,27,20,23,12,11
7,27,21,21,15,6
7,27,22,24,15,9
7,27,23,12,12,0
7,27,24,22,7,15
7,27,25,22,10,12
7,27,26,15,2,13
7,27,27,30,6,24
7,27,28,27,10,17
7,27,29,17,17,0
7,27,30,18,10,8
7,27,31,13,12,1
7,27,32,25,13,12
7,27,33,27,24,3
7,27,34,39,22,17
7,27,35,29,18,11
7,27,36,19,8,11
7,27,37,14,16,-2
7,27,38,27,5,22
7,27,39,8,5,3
7,27,40,20,7,13
7,27,41,17,5,12
7,27,42,29,11,18
7,27,43,39,19,20
7,27,44,13,8,5
7,27,45,24,5,19
7,27,46,24,12,12
7,27,47,29,11,18
7,27,48,25,4,21
7,27,49,18,18,0
7,27,50,11,13,-2
7,27,51,18,13,5
7,27,52,18,7,11
7,27,53,20,12,8
7,27,54,17,9,8
7,27,55,26,15,11
7,27,56,18,9,9
7,27,57,21,9,12
7,27,58,22,17,5
7,27,59,23,13,10
7,27,60,29,15,14
7,27,61,20,12,8
7,27,62,23,6,17
7,27,63,27,12,15
7,27,64,17,14,3
7,27,65,34,5,29
7,27,66,13,2,11
7,27,67,22,12,10
7,27,68,28,31,-3
7,27,69,32,11,21
7,27,70,8,5,3
7,27,71,25,19,6
7,27,72,10,5,5
7,27,73,13,21,-8
7,27,74,31,4,27
7,27,75,20,11,9
7,27,76,13,6,7
7,27,77,21,14,7
7,27,78,19,9,10
7,27,79,15,13,2
7,27,80,29,7,22
7,27,81,19,20,-1
7,27,82,14,8,6
7,27,83,12,9,3
7,27,84,52,12,40
7,27,85,23,8,15
7,27,86,21,14,7
7,27,87,21,5,16
7,27,88,13,9,4
7,27,89,17,8,9
7,27,90,22,5,17
7,27,91,17,15,2
7,27,92,21,16,5
7,27,93,16,16,0
7,27,94,17,14,3
7,27,95,11,6,5
7,27,96,22,13,9
7,27,97,24,14,10
7,27,98,20,13,7
7,27,99,23,16,7
7,27,100,31,13,18
7,27,101,23,5,18
7,27,102,20,5,15
7,27,103,14,14,0
7,27,104,14,16,-2
7,27,105,19,4,15
7,27,106,23,19,4
7,27,107,12,16,-4
7,27,108,4,3,1
7,27,109,21,9,12
7,27,110,25,12,13
7,27,111,23,19,4
7,27,112,28,20,8
7,27,113,11,7,4
7,27,114,20,4,16
7,27,115,8,6,2
7,27,116,21,17,4
7,27,117,23,7,16
7,27,118,6,18,-12
7,27,119,16,12,4
7,27,120,3,2,1
7,27,121,23,14,9
7,27,122,19,10,9
7,27,123,16,12,4
7,27,124,30,9,21
7,27,125,20,6,14
7,27,126,19,10,9
7,27,127,13,8,5
7,27,128,16,8,8
7,27,129,14,4,10
7,27,130,26,11,15
7,27,131,21,10,11
7,27,132,18,10,8
7,27,133,35,15,20
7,27,134,19,12,7
7,27,135,25,17,8
7,27,136,10,4,6
7,27,137,25,17,8
7,27,138,28,9,19
7,27,139,17,10,7
7,27,140,15,9,6
7,27,141,14,11,3
7,27,142,23,12,11
7,27,143,17,11,6
7,27,144,8,5,3
7,27,145,11,11,0
7,27,146,8,1,7
7,27,147,22,12,10
7,27,148,22,24,-2
7,27,149,20,10,10
7,27,150,15,10,5
7,27,151,23,12,11
7,27,152,15,12,3
7,27,153,23,9,14
7,27,154,5,11,-6
7,27,155,31,15,16
7,27,156,19,13,6
7,27,157,19,13,6
7,27,158,27,15,12
7,27,159,29,6,23
7,27,160,13,8,5
7,27,161,23,12,11
7,27,162,29,14,15
7,27,163,20,10,10
7,27,164,17,12,5
7,27,165,14,9,5
7,27,166,14,5,9
7,27,167,32,3,29
7,27,168,26,6,20
7,27,169,4,8,-4
7,27,170,19,17,2
7,27,171,26,5,21
7,27,172,23,14,9
7,27,173,12,10,2
7,27,174,19,11,8
7,27,175,8,15,-7
7,27,176,18,9,9
7,27,177,6,2,4
7,27,178,22,14,8
7,27,179,33,9,24
7,27,180,22,12,10
7,27,181,33,10,23
7,27,182,15,4,11
7,27,183,26,11,15
7,27,184,27,12,15
7,27,185,42,26,16
7,27,186,24,10,14
7,27,187,16,4,12
7,27,188,18,10,8
7,27,189,31,9,22
7,27,190,17,6,11
7,27,191,14,10,4
7,27,192,28,13,15
7,27,193,26,7,19
7,27,194,13,10,3
7,27,195,25,17,8
7,27,196,4,6,-2
7,27,197,20,13,7
7,27,198,21,19,2
7,27,199,18,11,7
7,27,200,18,8,10
7,27,201,18,10,8
7,27,202,6,7,-1
7,27,203,18,6,12
7,27,204,15,6,9
7,27,205,11,11,0
7,27,206,12,7,5
7,27,207,12,13,-1
7,27,208,24,11,13
7,27,209,34,19,15
7,27,210,8,4,4
7,27,211,24,15,9
7,27,212,20,16,4
7,27,213,22,11,11
7,27,214,17,12,5
7,27,215,14,9,5
7,27,216,28,5,23
7,27,217,12,16,-4
7,27,218,13,12,1
7,27,219,15,5,10
7,27,220,16,22,-6
7,27,221,17,20,-3
7,27,222,13,4,9
7,27,223,24,12,12
7,27,224,23,10,13
7,27,225,26,10,16
7,27,226,14,3,11
7,27,227,18,15,3
7,27,228,17,12,5
7,27,229,12,12,0
7,27,230,24,9,15
7,27,231,17,10,7
7,27,232,11,6,5
7,27,233,9,17,-8
7,27,234,25,13,12
7,27,235,19,6,13
7,27,236,23,10,13
7,27,237,22,9,13
7,27,238,12,6,6
7,27,239,19,5,14
7,27,240,14,7,7
7,27,241,22,18,4
7,27,242,7,9,-2
7,27,243,16,15,1
7,27,244,12,13,-1
7,27,245,11,18,-7
7,27,246,19,12,7
7,27,247,13,8,5
7,27,248,15,8,7
7,27,249,11,13,-2
7,27,250,18,10,8
7,27,251,29,6,23
7,27,252,18,14,4
7,27,253,32,25,7
7,27,254,42,14,28
7,27,255,15,9,6
7,27,256,22,7,15
7,27,257,19,8,11
7,27,258,22,18,4
7,27,259,23,17,6
7,27,260,12,6,6
7,27,261,20,13,7
7,27,262,18,10,8
7,27,263,26,16,10
7,27,264,27,13,14
7,27,265,13,7,6
7,27,266,21,11,10
7,27,267,17,20,-3
7,27,268,22,11,11
7,27,269,10,6,4
7,27,270,22,15,7
7,27,271,14,7,7
7,27,272,29,15,14
7,27,273,24,14,10
7,27,274,23,11,12
7,27,275,16,9,7
7,27,276,16,12,4
7,27,277,27,17,10
7,27,278,25,11,14
7,27,279,11,9,2
7,27,280,15,4,11
7,27,281,29,13,16
7,27,282,18,15,3
7,27,283,18,16,2
7,27,284,21,2,19
7,27,285,23,5,18
7,27,286,17,16,1
7,27,287,19,15,4
7,27,288,30,22,8
7,27,289,19,6,13
7,27,290,25,12,13
7,27,291,23,6,17
7,27,292,28,3,25
7,27,293,12,6,6
7,27,294,13,10,3
7,27,295,23,18,5
7,27,296,23,9,14
7,27,297,20,7,13
7,27,298,12,8,4
7,27,299,18,6,12
7,28,0,23,21,2
7,28,1,41,16,25
7,28,2,20,10,10
7,28,3,17,3,14
7,28,4,30,15,15
7,28,5,21,5,16
7,28,6,20,11,9
7,28,7,5,9,-4
7,28,8,13,3,10
7,28,9,23,12,11
7,28,10,15,4,11
7,28,11,10,12,-2
7,28,12,28,16,12
7,28,13,15,3,12
7,28,14,18,7,11
7,28,15,29,16,13
7,28,16,24,12,12
7,28,17,17,3,14
7,28,18,35,22,13
7,28,19,28,20,8
7,28,20,27,11,16
7,28,21,29,15,14
7,28,22,23,15,8
7,28,23,21,8,13
7,28,24,23,19,4
7,28,25,19,16,3
7,28,26,25,7,18
7,28,27,19,12,7
7,28,28,28,4,24
7,28,29,14,11,3
7,28,30,18,9,9
7,28,31,6,7,-1
7,28,32,32,10,22
7,28,33,22,12,10
7,28,34,26,18,8
7,28,35,10,8,2
7,28,36,8,17,-9
7,28,37,22,26,-4
7,28,38,11,12,-1
7,28,39,16,7,9
7,28,40,22,6,16
7,28,41,32,18,14
7,28,42,13,13,0
7,28,43,35,13,22
7,28,44,8,21,-13
7,28,45,25,11,14
7,28,46,17,7,10
7,28,47,13,9,4
7,28,48,31,7,24
7,28,49,14,11,3
7,28,50,22,11,11
7,28,51,15,20,-5
7,28,52,18,8,10
7,28,53,18,8,10
7,28,54,36,20,16
7,28,55,19,9,10
7,28,56,19,11,8
7,28,57,18,6,12
7,28,58,25,12,13
7,28,59,26,4,22
7,28,60,20,9,11
7,28,61,30,7,23
7,28,62,35,13,22
7,28,63,13,4,9
7,28,64,16,8,8
7,28,65,34,11,23
7,28,66,20,11,9
7,28,67,9,11,-2
7,28,68,17,13,4
7,28,69,20,18,2
7,28,70,17,9,8
7,28,71,16,12,4
7,28,72,24,5,19
7,28,73,14,1,13
7,28,74,25,16,9
7,28,75,14,9,5
7,28,76,21,10,11
7,28,77,9,5,4
7,28,78,44,16,28
7,28,79,23,10,13
7,28,80,31,7,24
7,28,81,22,20,2
7,28,82,23,14,9
7,28,83,20,10,10
7,28,84,15,16,-1
7,28,85,6,5,1
7,28,86,17,4,13
7,28,87,12,9,3
7,28,88,32,11,21
7,28,89,27,18,9
7,28,90,27,12,15
7,28,91,13,4,9
7,28,92,28,15,13
7,28,93,35,10,25
7,28,94,20,4,16
7,28,95,8,4,4
7,28,96,7,16,-9
7,28,97,22,11,11
7,28,98,25,15,10
7,28,99,18,11,7
7,28,100,27,20,7
7,28,101,13,5,8
7,28,102,27,10,17
7,28,103,27,4,23
7,28,104,20,10,10
7,28,105,39,6,33
7,28,106,16,8,8
7,28,107,10,6,4
7,28,108,7,8,-1
7,28,109,27,8,19
7,28,110,21,9,12
7,28,111,18,7,11
7,28,112,15,6,9
7,28,113,23,12,11
7,28,114,17,9,8
7,28,115,35,2,33
7,28,116,9,3,6
7,28,117,29,9,20
7,28,118,38,11,27
7,28,119,34,12,22
7,28,120,11,10,1
7,28,121,27,15,12
7,28,122,10,8,2
7,28,123,24,10,14
7,28,124,34,15,19
7,28,125,22,11,11
7,28,126,14,6,8
7,28,127,12,5,7
7,28,128,12,10,2
7,28,129,19,17,2
7,28,130,23,15,8
7,28,131,26,23,3
7,28,132,13,6,7
7,28,133,5,3,2
7,28,134,20,14,6
7,28,135,15,18,-3
7,28,136,14,9,5
7,28,137,25,27,-2
7,28,138,17,9,8
7,28,139,25,14,11
7,28,140,33,20,13
7,28,141,19,7,12
7,28,142,11,18,-7
7,28,143,17,5,12
7,28,144,12,23,-11
7,28,145,28,11,17
7,28,146,16,14,2
7,28,147,25,22,3
7,28,148,27,17,10
7,28,149,13,14,-1
7,28,150,7,13,-6
7,28,151,24,12,12
7,28,152,30,11,19
7,28,153,15,4,11
7,28,154,38,19,19
7,28,155,18,12,6
7,28,156,15,10,5
7,28,157,24,22,2
7,28,158,17,8,9
7,28,159,14,9,5
7,28,160,15,6,9
7,28,161,24,6,18
7,28,162,21,16,5
7,28,163,21,8,13
7,28,164,31,8,23
7,28,165,7,6,1
7,28,166,17,8,9
7,28,167,9,10,-1
7,28,168,13,3,10
7,28,169,16,7,9
7,28,170,18,4,14
7,28,171,33,16,17
7,28,172,11,17,-6
7,28,173,17,10,7
7,28,174,17,6,11
7,28,175,19,6,13
7,28,176,13,8,5
7,28,177,25,16,9
7,28,178,21,17,4
7,28,179,18,9,9
7,28,180,9,5,4
7,28,181,20,13,7
7,28,182,17,17,0
7,28,183,18,5,13
7,28,184,19,11,8
7,28,185,14,17,-3
7,28,186,14,19,-5
7,28,187,21,9,12
7,28,188,5,5,0
7,28,189,15,10,5
7,28,190,42,16,26
7,28,191,19,8,11
7,28,192,25,13,12
7,28,193,12,16,-4
7,28,194,23,12,11
7,28,195,11,2,9
7,28,196,21,27,-6
7,28,197,23,5,18
7,28,198,19,15,4
7,28,199,20,9,11
7,28,200,25,8,17
7,28,201,16,4,12
7,28,202,16,8,8
7,28,203,14,7,7
7,28,204,27,8,19
7,28,205,16,5,11
7,28,206,18,7,11
7,28,207,41,15,26
7,28,208,7,5,2
7,28,209,23,8,15
7,28,210,12,9,3
7,28,211,19,25,-6
7,28,212,17,14,3
7,28,213,21,15,6
7,28,214,20,22,-2
7,28,215,16,15,1
7,28,216,26,13,13
7,28,217,20,13,7
7,28,218,23,9,14
7,28,219,17,9,8
7,28,220,11,22,-11
7,28,221,27,7,20
7,28,222,23,16,7
7,28,223,10,9,1
7,28,224,16,3,13
7,28,225,26,15,11
7,28,226,24,18,6
7,28,227,30,11,19
7,28,228,21,13,8
7,28,229,21,9,12
7,28,230,16,11,5
7,28,231,12,9,3
7,28,232,14,6,8
7,28,233,26,17,9
7,28,234,17,11,6
7,28,235,13,2,11
7,28,236,19,9,10
7,28,237,6,11,-5
7,28,238,33,20,13
7,28,239,10,1,9
7,28,240,18,7,11
7,28,241,36,12,24
7,28,242,18,7,11
7,28,243,28,10,18
7,28,244,20,19,1
7,28,245,23,11,12
7,28,246,9,2,7
7,28,247,2,9,-7
7,28,248,11,5,6
7,28,249,33,21,12
7,28,250,19,12,7
7,28,251,12,6,6
7,28,252,19,13,6
7,28,253,7,12,-5
7,28,254,17,10,7
7,28,255,25,12,13
7,28,256,19,10,9
7,28,257,24,17,7
7,28,258,19,14,5
7,28,259,28,7,21
7,28,260,28,22,6
7,28,261,43,24,19
7,28,262,16,13,3
7,28,263,18,15,3
7,28,264,14,15,-1
7,28,265,17,10,7
7,28,266,8,16,-8
7,28,267,13,1,12
7,28,268,14,9,5
7,28,269,20,8,12
7,28,270,29,12,17
7,28,271,16,12,4
7,28,272,13,10,3
7,28,273,21,6,15
7,28,274,10,11,-1
7,28,275,21,9,12
7,28,276,25,15,10
7,28,277,21,10,11
7,28,278,14,6,8
7,28,279,12,6,6
7,28,280,19,6,13
7,28,281,15,8,7
7,28,282,25,14,11
7,28,283,30,10,20
7,28,284,21,15,6
7,28,285,8,10,-2
7,28,286,13,10,3
7,28,287,17,12,5
7,28,288,13,12,1
7,28,289,15,5,10
7,28,290,30,11,19
7,28,291,23,6,17
7,28,292,30,9,21
7,28,293,14,9,5
7,28,294,17,7,10
7,28,295,25,10,15
7,28,296,40,13,27
7,28,297,27,19,8
7,28,298,10,13,-3
7,28,299,26,19,7
7,29,0,22,12,10
7,29,1,18,7,11
7,29,2,26,32,-6
7,29,3,19,2,17
7,29,4,26,16,10
7,29,5,10,5,5
7,29,6,12,2,10
7,29,7,17,12,5
7,29,8,26,7,19
7,29,9,27,12,15
7,29,10,14,10,4
7,29,11,21,12,9
7,29,12,24,12,12
7,29,13,25,8,17
7,29,14,15,12,3
7,29,15,8,5,3
7,29,16,19,12,7
7,29,17,21,9,12
7,29,18,33,25,8
7,29,19,28,13,15
7,29,20,13,12,1
7,29,21,16,7,9
7,29,22,18,18,0
7,29,23,7,13,-6
7,29,24,27,20,7
7,29,25,24,13,11
7,29,26,24,8,16
7,29,27,14,6,8
7,29,28,14,5,9
7,29,29,26,12,14
7,29,30,11,7,4
7,29,31,21,6,15
7,29,32,17,15,2
7,29,33,37,13,24
7,29,34,15,5,10
7,29,35,18,11,7
7,29,36,18,5,13
7,29,37,17,11,6
7,29,38,14,14,0
7,29,39,15,11,4
7,29,40,22,15,7
7,29,41,21,25,-4
7,29,42,20,6,14
7,29,43,23,7,16
7,29,44,15,10,5
7,29,45,28,6,22
7,29,46,21,11,10
7,29,47,25,17,8
7,29,48,5,6,-1
7,29,49,33,6,27
7,29,50,27,11,16
7,29,51,17,13,4
7,29,52,33,4,29
7,29,53,18,9,9
7,29,54,13,16,-3
7,29,55,22,8,14
7,29,56,12,7,5
7,29,57,23,17,6
7,29,58,10,10,0
7,29,59,12,9,3
7,29,60,24,7,17
7,29,61,26,10,16
7,29,62,8,12,-4
7,29,63,28,11,17
7,29,64,18,21,-3
7,29,65,11,10,1
7,29,66,24,12,12
7,29,67,33,9,24
7,29,68,23,16,7
7,29,69,18,11,7
7,29,70,12,8,4
7,29,71,36,13,23
7,29,72,19,4,15
7,29,73,22,8,14
7,29,74,31,14,17
7,29,75,18,5,13
7,29,76,18,24,-6
7,29,77,27,19,8
7,29,78,20,10,10
7,29,79,19,8,11
7,29,80,26,29,-3
7,29,81,30,6,24
7,29,82,28,10,18
7,29,83,33,13,20
7,29,84,21,14,7
7,29,85,17,13,4
7,29,86,26,9,17
7,29,87,17,4,13
7,29,88,22,11,11
7,29,89,20,7,13
7,29,90,4,5,-1
7,29,91,31,2,29
7,29,92,18,14,4
7,29,93,26,13,13
7,29,94,14,6,8
7,29,95,20,14,6
7,29,96,18,5,13
7,29,97,23,12,11
7,29,98,29,10,19
7,29,99,6,4,2
7,29,100,16,1,15
7,29,101,27,5,22
7,29,102,24,6,18
7,29,103,29,9,20
7,29,104,23,13,10
7,29,105,16,10,6
7,29,106,17,6,11
7,29,107,11,14,-3
7,29,108,15,9,6
7,29,109,14,10,4
7,29,110,35,17,18
7,29,111,14,7,7
7,29,112,20,14,6
7,29,113,18,9,9
7,29,114,18,5,13
7,29,115,26,10,16
7,29,116,2,2,0
7,29,117,12,14,-2
7,29,118,17,5,12
7,29,119,30,22,8
7,29,120,16,7,9
7,29,121,32,14,18
7,29,122,22,1,21
7,29,123,30,8,22
7,29,124,30,16,14
7,29,125,15,6,9
7,29,126,14,5,9
7,29,127,14,5,9
7,29,128,26,20,6
7,29,129,21,11,10
7,29,130,19,3,16
7,29,131,25,12,13
7,29,132,29,12,17
7,29,133,21,10,11
7,29,134,21,7,14
7,29,135,21,13,8
7,29,136,18,11,7
7,29,137,19,6,13
7,29,138,30,11,19
7,29,139,32,14,18
7,29,140,18,4,14
7,29,141,17,5,12
7,29,142,9,11,-2
7,29,143,20,7,13
7,29,144,13,13,0
7,29,145,27,2,25
7,29,146,10,8,2
7,29,147,30,13,17
7,29,148,42,10,32
7,29,149,29,20,9
7,29,150,18,12,6
7,29,151,25,18,7
7,29,152,28,12,16
7,29,153,22,12,10
7,29,154,17,9,8
7,29,155,11,11,0
7,29,156,17,7,10
7,29,157,17,17,0
7,29,158,11,2,9
7,29,159,12,9,3
7,29,160,19,8,11
7,29,161,19,11,8
7,29,162,9,10,-1
7,29,163,21,13,8
7,29,164,19,18,1
7,29,165,26,19,7
7,29,166,25,23,2
7,29,167,13,8,5
7,29,168,25,9,16
7,29,169,30,11,19
7,29,170,22,5,17
7,29,171,21,5,16
7,29,172,17,7,10
7,29,173,32,8,24
7,29,174,14,12,2
7,29,175,11,11,0
7,29,176,11,14,-3
7,29,177,25,5,20
7,29,178,17,14,3
7,29,179,17,9,8
7,29,180,19,2,17
7,29,181,16,8,8
7,29,182,20,12,8
7,29,183,19,15,4
7,29,184,16,8,8
7,29,185,22,8,14
7,29,186,9,11,-2
7,29,187,7,5,2
7,29,188,11,12,-1
7,29,189,20,10,10
7,29,190,10,8,2
7,29,191,32,9,23
7,29,192,25,2,23
7,29,193,25,10,15
7,29,194,36,11,25
7,29,195,25,15,10
7,29,196,30,3,27
7,29,197,11,8,3
7,29,198,27,9,18
7,29,199,13,14,-1
7,29,200,37,12,25
7,29,201,29,11,18
7,29,202,16,14,2
7,29,203,26,5,21
7,29,204,18,7,11
7,29,205,47,22,25
7,29,206,22,16,6
7,29,207,13,7,6
7,29,208,11,8,3
7,29,209,12,8,4
7,29,210,7,4,3
7,29,211,15,6,9
7,29,212,20,18,2
7,29,213,23,13,10
7,29,214,8,6,2
7,29,215,12,8,4
7,29,216,12,10,2
7,29,217,20,9,11
7,29,218,31,11,20
7,29,219,17,13,4
7,29,220,31,12,19
7,29,221,23,12,11
7,29,222,11,7,4
7,29,223,4,6,-2
7,29,224,15,5,10
7,29,225,6,12,-6
7,29,226,16,4,12
7,29,227,17,11,6
7,29,228,31,14,17
7,29,229,20,10,10
7,29,230,20,9,11
7,29,231,29,14,15
7,29,232,22,11,11
7,29,233,11,4,7
7,29,234,23,13,10
7,29,235,11,3,8
7,29,236,12,14,-2
7,29,237,17,5,12
7,29,238,16,8,8
7,29,239,13,11,2
7,29,240,23,12,11
7,29,241,24,7,17
7,29,242,14,14,0
7,29,243,11,10,1
7,29,244,7,7,0
7,29,245,25,8,17
7,29,246,22,10,12
7,29,247,13,8,5
7,29,248,21,14,7
7,29,249,26,7,19
7,29,250,14,9,5
7,29,251,20,15,5
7,29,252,32,2,30
7,29,253,15,16,-1
7,29,254,13,4,9
7,29,255,15,8,7
7,29,256,29,11,18
7,29,257,10,5,5
7,29,258,33,16,17
7,29,259,16,10,6
7,29,260,17,12,5
7,29,261,7,5,2
7,29,262,24,5,19
7,29,263,29,13,16
7,29,264,26,9,17
7,29,265,20,13,7
7,29,266,23,9,14
7,29,267,18,16,2
7,29,268,21,17,4
7,29,269,21,11,10
7,29,270,26,15,11
7,29,271,14,12,2
7,29,272,14,7,7
7,29,273,22,12,10
7,29,274,8,10,-2
7,29,275,10,12,-2
7,29,276,8,4,4
7,29,277,18,7,11
7,29,278,27,7,20
7,29,279,22,10,12
7,29,280,24,13,11
7,29,281,28,18,10
7,29,282,18,8,10
7,29,283,20,2,18
7,29,284,21,20,1
7,29,285,16,12,4
7,29,286,34,8,26
7,29,287,16,11,5
7,29,288,20,13,7
7,29,289,36,14,22
7,29,290,21,14,7
7,29,291,24,6,18
7,29,292,10,6,4
7,29,293,23,10,13
7,29,294,22,7,15
7,29,295,27,18,9
7,29,296,30,8,22
7,29,297,16,7,9
7,29,298,32,7,25
7,29,299,24,12,12
7,30,0,24,10,14
7,30,1,5,6,-1
7,30,2,6,11,-5
7,30,3,13,13,0
7,30,4,23,11,12
7,30,5,21,11,10
7,30,6,24,7,17
7,30,7,10,6,4
7,30,8,16,11,5
7,30,9,9,10,-1
7,30,10,18,10,8
7,30,11,27,14,13
7,30,12,16,16,0
7,30,13,21,11,10
7,30,14,23,12,11
7,30,15,10,4,6
7,30,16,24,4,20
7,30,17,15,13,2
7,30,18,15,10,5
7,30,19,22,2,20
7,30,20,10,1,9
7,30,21,20,15,5
7,30,22,23,8,15
7,30,23,7,6,1
7,30,24,24,9,15
7,30,25,16,7,9
7,30,26,21,11,10
7,30,27,23,8,15
7,30,28,23,11,12
7,30,29,23,9,14
7,30,30,19,8,11
7,30,31,13,8,5
7,30,32,14,12,2
7,30,33,8,3,5
7,30,34,7,1,6
7,30,35,9,10,-1
7,30,36,18,5,13
7,30,37,35,11,24
7,30,38,18,11,7
7,30,39,24,10,14
7,30,40,41,18,23
7,30,41,14,5,9
7,30,42,15,4,11
7,30,43,27,6,21
7,30,44,10,8,2
7,30,45,21,7,14
7,30,46,20,11,9
7,30,47,12,9,3
7,30,48,25,8,17
7,30,49,14,7,7
7,30,50,11,11,0
7,30,51,19,19,0
7,30,52,19,9,10
7,30,53,20,6,14
7,30,54,21,11,10
7,30,55,12,11,1
7,30,56,26,12,14
7,30,57,17,6,11
7,30,58,8,7,1
7,30,59,19,11,8
7,30,60,12,8,4
7,30,61,23,14,9
7,30,62,15,12,3
7,30,63,26,12,14
7,30,64,26,12,14
7,30,65,14,5,9
7,30,66,23,7,16
7,30,67,20,6,14
7,30,68,15,10,5
7,30,69,18,8,10
7,30,70,7,10,-3
7,30,71,15,6,9
7,30,72,25,12,13
7,30,73,23,5,18
7,30,74,19,13,6
7,30,75,26,12,14
7,30,76,14,10,4
7,30,77,17,15,2
7,30,78,14,11,3
7,30,79,12,15,-3
7,30,80,21,12,9
7,30,81,33,19,14
7,30,82,20,17,3
7,30,83,11,5,6
7,30,84,15,8,7
7,30,85,6,1,5
7,30,86,20,12,8
7,30,87,27,11,16
7,30,88,18,7,11
7,30,89,21,5,16
7,30,90,28,4,24
7,30,91,18,6,12
7,30,92,22,19,3
7,30,93,16,5,11
7,30,94,29,4,25
7,30,95,23,9,14
7,30,96,9,5,4
7,30,97,8,3,5
7,30,98,30,16,14
7,30,99,24,11,13
7,30,100,18,17,1
7,30,101,21,6,15
7,30,102,22,7,15
7,30,103,26,9,17
7,30,104,29,13,16
7,30,105,26,11,15
7,30,106,21,7,14
7,30,107,18,9,9
7,30,108,22,12,10
7,30,109,19,2,17
7,30,110,8,7,1
7,30,111,21,12,9
7,30,112,16,8,8
7,30,113,24,0,24
7,30,114,15,8,7
7,30,115,24,6,18
7,30,116,14,4,10
7,30,117,9,11,-2
7,30,118,22,8,14
7,30,119,13,7,6
7,30,120,16,8,8
7,30,121,27,14,13
7,30,122,26,14,12
7,30,123,29,17,12
7,30,124,15,7,8
7,30,125,9,13,-4
7,30,126,13,16,-3
7,30,127,35,16,19
7,30,128,14,9,5
7,30,129,19,15,4
7,30,130,17,23,-6
7,30,131,22,5,17
7,30,132,21,17,4
7,30,133,12,7,5
7,30,134,20,9,11
7,30,135,22,11,11
7,30,136,21,7,14
7,30,137,13,5,8
7,30,138,25,18,7
7,30,139,17,13,4
7,30,140,13,9,4
7,30,141,20,8,12
7,30,142,13,6,7
7,30,143,22,12,10
7,30,144,18,10,8
7,30,145,25,10,15
7,30,146,1,3,-2
7,30,147,23,7,16
7,30,148,28,12,16
7,30,149,20,11,9
7,30,150,36,15,21
7,30,151,16,5,11
7,30,152,27,12,15
7,30,153,34,15,19
7,30,154,14,12,2
7,30,155,33,10,23
7,30,156,8,9,-1
7,30,157,16,14,2
7,30,158,20,11,9
7,30,159,21,9,12
7,30,160,19,3,16
7,30,161,12,10,2
7,30,162,19,10,9
7,30,163,26,9,17
7,30,164,10,8,2
7,30,165,17,13,4
7,30,166,19,14,5
7,30,167,20,9,11
7,30,168,25,11,14
7,30,169,18,10,8
7,30,170,17,12,5
7,30,171,33,2,31
7,30,172,28,7,21
7,30,173,36,6,30
7,30,174,22,8,14
7,30,175,14,6,8
7,30,176,11,11,0
7,30,177,18,9,9
7,30,178,27,6,21
7,30,179,14,5,9
7,30,180,16,4,12
7,30,181,20,13,7
7,30,182,33,14,19
7,30,183,14,2,12
7,30,184,22,18,4
7,30,185,21,12,9
7,30,186,19,10,9
7,30,187,27,13,14
7,30,188,17,11,6
7,30,189,26,13,13
7,30,190,13,9,4
7,30,191,26,14,12
7,30,192,27,20,7
7,30,193,23,13,10
7,30,194,12,8,4
7,30,195,18,11,7
7,30,196,24,9,15
7,30,197,20,9,11
7,30,198,16,16,0
7,30,199,27,10,17
7,30,200,26,11,15
7,30,201,5,2,3
7,30,202,29,17,12
7,30,203,20,9,11
7,30,204,23,10,13
7,30,205,25,6,19
7,30,206,33,9,24
7,30,207,16,9,7
7,30,208,15,8,7
7,30,209,18,11,7
7,30,210,26,11,15
7,30,211,14,5,9
7,30,212,16,9,7
7,30,213,16,6,10
7,30,214,10,4,6
7,30,215,25,4,21
7,30,216,16,5,11
7,30,217,27,10,17
7,30,218,13,8,5
7,30,219,24,8,16
7,30,220,22,11,11
7,30,221,25,9,16
7,30,222,27,6,21
7,30,223,14,5,9
7,30,224,26,15,11
7,30,225,20,18,2
7,30,226,27,18,9
7,30,227,27,8,19
7,30,228,22,3,19
7,30,229,14,8,6
7,30,230,22,10,12
7,30,231,10,4,6
7,30,232,18,7,11
7,30,233,23,13,10
7,30,234,15,6,9
7,30,235,12,9,3
7,30,236,25,7,18
7,30,237,26,5,21
7,30,238,25,8,17
7,30,239,28,11,17
7,30,240,17,10,7
7,30,241,28,8,20
7,30,242,25,7,18
7,30,243,21,11,10
7,30,244,23,8,15
7,30,245,16,16,0
7,30,246,35,11,24
7,30,247,21,8,13
7,30,248,42,8,34
7,30,249,25,15,10
7,30,250,22,15,7
7,30,251,26,11,15
7,30,252,15,13,2
7,30,253,21,12,9
7,30,254,16,6,10
7,30,255,20,15,5
7,30,256,25,9,16
7,30,257,35,13,22
7,30,258,14,5,9
7,30,259,15,6,9
7,30,260,13,5,8
7,30,261,19,23,-4
7,30,262,12,14,-2
7,30,263,15,13,2
7,30,264,13,14,-1
7,30,265,24,12,12
7,30,266,27,7,20
7,30,267,19,14,5
7,30,268,20,10,10
7,30,269,30,16,14
7,30,270,25,10,15
7,30,271,20,10,10
7,30,272,22,8,14
7,30,273,29,21,8
7,30,274,24,3,21
7,30,275,19,7,12
7,30,276,30,6,24
7,30,277,20,11,9
7,30,278,14,12,2
7,30,279,10,10,0
7,30,280,14,6,8
7,30,281,33,10,23
7,30,282,7,6,1
7,30,283,25,10,15
7,30,284,12,6,6
7,30,285,12,6,6
7,30,286,25,14,11
7,30,287,18,11,7
7,30,288,23,6,17
7,30,289,20,11,9
7,30,290,23,12,11
7,30,291,24,9,15
7,30,292,22,20,2
7,30,293,17,10,7
7,30,294,23,12,11
7,30,295,24,18,6
7,30,296,22,5,17
7,30,297,21,5,16
7,30,298,9,11,-2
7,30,299,22,6,16
8,1,0,5,7,-2
8,1,1,21,16,5
8,1,2,4,9,-5
8,1,3,0,1,-1
8,1,4,20,21,-1
8,1,5,9,13,-4
8,1,6,9,9,0
8,1,7,10,21,-11
8,1,8,10,8,2
8,1,9,2,5,-3
8,1,10,10,4,6
8,1,11,9,8,1
8,1,12,11,4,7
8,1,13,20,25,-5
8,1,14,7,10,-3
8,1,15,18,14,4
8,1,16,14,29,-15
8,1,17,11,8,3
8,1,18,9,8,1
8,1,19,9,14,-5
8,1,20,6,10,-4
8,1,21,7,9,-2
8,1,22,5,12,-7
8,1,23,7,11,-4
8,1,24,8,13,-5
8,1,25,8,2,6
8,1,26,15,16,-1
8,1,27,11,15,-4
8,1,28,18,15,3
8,1,29,12,10,2
8,1,30,3,5,-2
8,1,31,7,15,-8
8,1,32,4,5,-1
8,1,33,8,17,-9
8,1,34,17,24,-7
8,1,35,10,4,6
8,1,36,3,2,1
8,1,37,3,13,-10
8,1,38,15,13,2
8,1,39,8,3,5
8,1,40,2,2,0
8,1,41,5,5,0
8,1,42,8,8,0
8,1,43,22,14,8
8,1,44,15,12,3
8,1,45,6,7,-1
8,1,46,5,14,-9
8,1,47,12,17,-5
8,1,48,13,10,3
8,1,49,15,10,5
8,1,50,0,8,-8
8,1,51,21,14,7
8,1,52,3,10,-7
8,1,53,4,11,-7
8,1,54,14,6,8
8,1,55,4,13,-9
8,1,56,10,8,2
8,1,57,9,5,4
8,1,58,12,25,-13
8,1,59,9,4,5
8,1,60,15,11,4
8,1,61,8,6,2
8,1,62,12,16,-4
8,1,63,9,11,-2
8,1,64,13,9,4
8,1,65,13,12,1
8,1,66,13,9,4
8,1,67,3,6,-3
8,1,68,6,7,-1
8,1,69,4,6,-2
8,1,70,3,12,-9
8,1,71,10,18,-8
8,1,72,19,16,3
8,1,73,11,5,6
8,1,74,21,9,12
8,1,75,13,12,1
8,1,76,2,13,-11
8,1,77,15,12,3
8,1,78,12,7,5
8,1,79,9,5,4
8,1,80,6,7,-1
8,1,81,15,11,4
8,1,82,6,11,-5
8,1,83,14,8,6
8,1,84,7,4,3
8,1,85,11,13,-2
8,1,86,7,6,1
8,1,87,5,14,-9
8,1,88,7,13,-6
8,1,89,14,13,1
8,1,90,14,27,-13
8,1,91,4,3,1
8,1,92,6,8,-2
8,1,93,2,15,-13
8,1,94,25,19,6
8,1,95,5,15,-10
8,1,96,11,10,1
8,1,97,11,8,3
8,1,98,16,24,-8
8,1,99,8,26,-18
8,1,100,21,7,14
8,1,101,7,7,0
8,1,102,10,6,4
8,1,103,12,19,-7
8,1,104,6,15,-9
8,1,105,2,8,-6
8,1,106,13,11,2
8,1,107,5,10,-5
8,1,108,2,4,-2
8,1,109,7,12,-5
8,1,110,8,12,-4
8,1,111,9,18,-9
8,1,112,4,18,-14
8,1,113,8,7,1
8,1,114,9,11,-2
8,1,115,4,13,-9
8,1,116,3,11,-8
8,1,117,5,20,-15
8,1,118,4,3,1
8,1,119,11,11,0
8,1,120,6,9,-3
8,1,121,3,3,0
8,1,122,6,3,3
8,1,123,8,15,-7
8,1,124,12,14,-2
8,1,125,7,15,-8
8,1,126,6,9,-3
8,1,127,7,8,-1
8,1,128,17,14,3
8,1,129,5,6,-1
8,1,130,15,14,1
8,1,131,8,19,-11
8,1,132,11,11,0
8,1,133,7,13,-6
8,1,134,8,13,-5
8,1,135,20,15,5
8,1,136,6,15,-9
8,1,137,1,8,-7
8,1,138,3,13,-10
8,1,139,4,18,-14
8,1,140,4,10,-6
8,1,141,13,11,2
8,1,142,2,22,-20
8,1,143,14,14,0
8,1,144,4,7,-3
8,1,145,7,18,-11
8,1,146,12,13,-1
8,1,147,5,9,-4
8,1,148,7,2,5
8,1,149,6,15,-9
8,1,150,8,9,-1
8,1,151,6,6,0
8,1,152,13,5,8
8,1,153,5,12,-7
8,1,154,6,9,-3
8,1,155,2,2,0
8,1,156,6,14,-8
8,1,157,10,11,-1
8,1,158,17,18,-1
8,1,159,8,11,-3
8,1,160,5,5,0
8,1,161,4,4,0
8,1,162,6,12,-6
8,1,163,8,12,-4
8,1,164,7,12,-5
8,1,165,12,17,-5
8,1,166,6,19,-13
8,1,167,15,22,-7
8,1,168,13,22,-9
8,1,169,3,12,-9
8,1,170,12,17,-5
8,1,171,2,8,-6
8,1,172,6,8,-2
8,1,173,9,11,-2
8,1,174,4,14,-10
8,1,175,10,16,-6
8,1,176,16,11,5
8,1,177,6,5,1
8,1,178,13,12,1
8,1,179,12,19,-7
8,1,180,4,6,-2
8,1,181,7,13,-6
8,1,182,6,11,-5
8,1,183,4,12,-8
8,1,184,11,18,-7
8,1,185,11,24,-13
8,1,186,8,9,-1
8,1,187,20,30,-10
8,1,188,14,10,4
8,1,189,10,14,-4
8,1,190,16,9,7
8,1,191,14,11,3
8,1,192,11,19,-8
8,1,193,13,17,-4
8,1,194,1,9,-8
8,1,195,2,13,-11
8,1,196,0,8,-8
8,1,197,12,11,1
8,1,198,12,21,-9
8,1,199,8,8,0
8,1,200,3,5,-2
8,1,201,4,7,-3
8,1,202,13,16,-3
8,1,203,9,21,-12
8,1,204,2,3,-1
8,1,205,7,14,-7
8,1,206,10,11,-1
8,1,207,22,12,10
8,1,208,11,5,6
8,1,209,8,10,-2
8,1,210,18,20,-2
8,1,211,7,8,-1
8,1,212,11,20,-9
8,1,213,8,15,-7
8,1,214,9,16,-7
8,1,215,8,28,-20
8,1,216,12,13,-1
8,1,217,6,8,-2
8,1,218,15,4,11
8,1,219,5,16,-11
8,1,220,7,13,-6
8,1,221,8,9,-1
8,1,222,8,15,-7
8,1,223,11,13,-2
8,1,224,12,20,-8
8,1,225,15,28,-13
8,1,226,17,21,-4
8,1,227,14,13,1
8,1,228,5,11,-6
8,1,229,9,7,2
8,1,230,14,6,8
8,1,231,2,14,-12
8,1,232,6,12,-6
8,1,233,2,11,-9
8,1,234,10,15,-5
8,1,235,11,10,1
8,1,236,3,13,-10
8,1,237,11,13,-2
8,1,238,6,7,-1
8,1,239,7,23,-16
8,1,240,7,28,-21
8,1,241,11,22,-11
8,1,242,10,8,2
8,1,243,25,14,11
8,1,244,4,14,-10
8,1,245,5,10,-5
8,1,246,15,24,-9
8,1,247,5,9,-4
8,1,248,9,13,-4
8,1,249,14,9,5
8,1,250,11,12,-1
8,1,251,4,15,-11
8,1,252,9,13,-4
8,1,253,11,10,1
8,1,254,11,20,-9
8,1,255,16,18,-2
8,1,256,12,13,-1
8,1,257,7,5,2
8,1,258,20,22,-2
8,1,259,4,14,-10
8,1,260,12,12,0
8,1,261,9,13,-4
8,1,262,14,21,-7
8,1,263,14,21,-7
8,1,264,9,13,-4
8,1,265,12,10,2
8,1,266,13,10,3
8,1,267,12,17,-5
8,1,268,13,13,0
8,1,269,13,23,-10
8,1,270,11,6,5
8,1,271,2,20,-18
8,1,272,13,12,1
8,1,273,3,9,-6
8,1,274,9,8,1
8,1,275,8,5,3
8,1,276,7,9,-2
8,1,277,20,21,-1
8,1,278,11,17,-6
8,1,279,9,4,5
8,1,280,7,5,2
8,1,281,7,9,-2
8,1,282,11,17,-6
8,1,283,13,13,0
8,1,284,29,10,19
8,1,285,15,18,-3
8,1,286,12,15,-3
8,1,287,10,13,-3
8,1,288,12,12,0
8,1,289,6,9,-3
8,1,290,20,13,7
8,1,291,5,9,-4
8,1,292,12,12,0
8,1,293,5,10,-5
8,1,294,5,8,-3
8,1,295,7,19,-12
8,1,296,4,14,-10
8,1,297,6,8,-2
8,1,298,2,1,1
8,1,299,22,22,0
8,2,0,11,30,-19
8,2,1,14,12,2
8,2,2,6,9,-3
8,2,3,11,25,-14
8,2,4,13,19,-6
8,2,5,4,6,-2
8,2,6,8,17,-9
8,2,7,7,4,3
8,2,8,10,11,-1
8,2,9,2,6,-4
8,2,10,6,14,-8
8,2,11,15,15,0
8,2,12,14,19,-5
8,2,13,12,24,-12
8,2,14,7,20,-13
8,2,15,17,18,-1
8,2,16,3,13,-10
8,2,17,6,9,-3
8,2,18,7,16,-9
8,2,19,11,18,-7
8,2,20,8,25,-17
8,2,21,8,5,3
8,2,22,8,8,0
8,2,23,13,21,-8
8,2,24,14,10,4
8,2,25,6,10,-4
8,2,26,16,14,2
8,2,27,10,16,-6
8,2,28,2,5,-3
8,2,29,7,11,-4
8,2,30,7,7,0
8,2,31,12,13,-1
8,2,32,4,10,-6
8,2,33,6,9,-3
8,2,34,4,8,-4
8,2,35,9,10,-1
8,2,36,13,12,1
8,2,37,14,15,-1
8,2,38,11,1,10
8,2,39,12,16,-4
8,2,40,4,11,-7
8,2,41,9,7,2
8,2,42,7,7,0
8,2,43,23,14,9
8,2,44,7,14,-7
8,2,45,8,20,-12
8,2,46,4,5,-1
8,2,47,15,11,4
8,2,48,8,19,-11
8,2,49,8,13,-5
8,2,50,6,12,-6
8,2,51,3,9,-6
8,2,52,19,12,7
8,2,53,1,5,-4
8,2,54,14,12,2
8,2,55,4,8,-4
8,2,56,8,15,-7
8,2,57,12,21,-9
8,2,58,6,15,-9
8,2,59,15,18,-3
8,2,60,6,9,-3
8,2,61,13,11,2
8,2,62,3,11,-8
8,2,63,4,8,-4
8,2,64,12,7,5
8,2,65,7,12,-5
8,2,66,13,21,-8
8,2,67,16,10,6
8,2,68,8,14,-6
8,2,69,10,15,-5
8,2,70,14,16,-2
8,2,71,6,15,-9
8,2,72,9,5,4
8,2,73,10,13,-3
8,2,74,9,11,-2
8,2,75,6,17,-11
8,2,76,10,13,-3
8,2,77,8,7,1
8,2,78,8,26,-18
8,2,79,14,18,-4
8,2,80,6,5,1
8,2,81,6,12,-6
8,2,82,7,13,-6
8,2,83,12,8,4
8,2,84,6,17,-11
8,2,85,10,11,-1
8,2,86,9,11,-2
8,2,87,9,21,-12
8,2,88,24,17,7
8,2,89,4,16,-12
8,2,90,7,6,1
8,2,91,14,10,4
8,2,92,8,8,0
8,2,93,17,24,-7
8,2,94,10,14,-4
8,2,95,11,19,-8
8,2,96,13,21,-8
8,2,97,7,19,-12
8,2,98,11,14,-3
8,2,99,5,18,-13
8,2,100,9,11,-2
8,2,101,6,9,-3
8,2,102,4,4,0
8,2,103,2,2,0
8,2,104,5,12,-7
8,2,105,9,19,-10
8,2,106,13,5,8
8,2,107,20,14,6
8,2,108,12,16,-4
8,2,109,12,20,-8
8,2,110,12,11,1
8,2,111,4,3,1
8,2,112,19,18,1
8,2,113,20,6,14
8,2,114,8,16,-8
8,2,115,15,14,1
8,2,116,12,19,-7
8,2,117,14,15,-1
8,2,118,6,14,-8
8,2,119,20,23,-3
8,2,120,33,27,6
8,2,121,6,11,-5
8,2,122,6,14,-8
8,2,123,19,24,-5
8,2,124,10,14,-4
8,2,125,21,16,5
8,2,126,14,14,0
8,2,127,11,14,-3
8,2,128,8,11,-3
8,2,129,13,13,0
8,2,130,11,16,-5
8,2,131,7,11,-4
8,2,132,12,20,-8
8,2,133,19,15,4
8,2,134,3,12,-9
8,2,135,15,24,-9
8,2,136,15,5,10
8,2,137,6,11,-5
8,2,138,21,18,3
8,2,139,11,18,-7
8,2,140,19,16,3
8,2,141,8,16,-8
8,2,142,20,20,0
8,2,143,4,20,-16
8,2,144,4,11,-7
8,2,145,17,7,10
8,2,146,11,16,-5
8,2,147,16,14,2
8,2,148,9,12,-3
8,2,149,11,13,-2
8,2,150,7,26,-19
8,2,151,12,12,0
8,2,152,7,11,-4
8,2,153,6,6,0
8,2,154,8,22,-14
8,2,155,12,13,-1
8,2,156,3,21,-18
8,2,157,4,9,-5
8,2,158,10,7,3
8,2,159,8,12,-4
8,2,160,3,20,-17
8,2,161,14,17,-3
8,2,162,6,18,-12
8,2,163,6,5,1
8,2,164,13,14,-1
8,2,165,5,6,-1
8,2,166,10,7,3
8,2,167,8,6,2
8,2,168,14,13,1
8,2,169,6,9,-3
8,2,170,11,10,1
8,2,171,8,13,-5
8,2,172,3,3,0
8,2,173,12,21,-9
8,2,174,14,7,7
8,2,175,9,16,-7
8,2,176,9,15,-6
8,2,177,11,10,1
8,2,178,14,16,-2
8,2,179,7,7,0
8,2,180,16,8,8
8,2,181,7,11,-4
8,2,182,8,21,-13
8,2,183,4,10,-6
8,2,184,9,24,-15
8,2,185,5,13,-8
8,2,186,9,6,3
8,2,187,12,16,-4
8,2,188,13,8,5
8,2,189,12,8,4
8,2,190,7,10,-3
8,2,191,15,0,15
8,2,192,7,17,-10
8,2,193,20,19,1
8,2,194,5,13,-8
8,2,195,9,16,-7
8,2,196,10,19,-9
8,2,197,6,10,-4
8,2,198,3,4,-1
8,2,199,8,15,-7
8,2,200,10,9,1
8,2,201,8,18,-10
8,2,202,16,12,4
8,2,203,13,12,1
8,2,204,21,9,12
8,2,205,13,20,-7
8,2,206,21,8,13
8,2,207,15,11,4
8,2,208,1,5,-4
8,2,209,9,12,-3
8,2,210,18,19,-1
8,2,211,2,12,-10
8,2,212,4,16,-12
8,2,213,14,2,12
8,2,214,12,19,-7
8,2,215,20,12,8
8,2,216,10,20,-10
8,2,217,5,14,-9
8,2,218,8,6,2
8,2,219,12,21,-9
8,2,220,4,7,-3
8,2,221,25,10,15
8,2,222,25,10,15
8,2,223,14,24,-10
8,2,224,13,21,-8
8,2,225,13,9,4
8,2,226,12,12,0
8,2,227,7,14,-7
8,2,228,23,18,5
8,2,229,4,4,0
8,2,230,17,7,10
8,2,231,14,23,-9
8,2,232,15,16,-1
8,2,233,2,10,-8
8,2,234,12,10,2
8,2,235,13,12,1
8,2,236,1,6,-5
8,2,237,6,16,-10
8,2,238,8,8,0
8,2,239,13,13,0
8,2,240,12,10,2
8,2,241,6,10,-4
8,2,242,13,10,3
8,2,243,14,21,-7
8,2,244,11,6,5
8,2,245,7,12,-5
8,2,246,15,18,-3
8,2,247,7,10,-3
8,2,248,7,10,-3
8,2,249,9,7,2
8,2,250,11,8,3
8,2,251,2,11,-9
8,2,252,4,5,-1
8,2,253,13,9,4
8,2,254,9,7,2
8,2,255,9,3,6
8,2,256,13,12,1
8,2,257,17,18,-1
8,2,258,9,19,-10
8,2,259,17,16,1
8,2,260,13,23,-10
8,2,261,17,15,2
8,2,262,8,11,-3
8,2,263,10,15,-5
8,2,264,14,24,-10
8,2,265,9,14,-5
8,2,266,9,15,-6
8,2,267,22,24,-2
8,2,268,9,17,-8
8,2,269,5,15,-10
8,2,270,19,10,9
8,2,271,8,9,-1
8,2,272,8,6,2
8,2,273,9,12,-3
8,2,274,24,3,21
8,2,275,11,11,0
8,2,276,5,20,-15
8,2,277,8,12,-4
8,2,278,11,18,-7
8,2,279,4,12,-8
8,2,280,8,15,-7
8,2,281,3,13,-10
8,2,282,7,18,-11
8,2,283,11,10,1
8,2,284,13,13,0
8,2,285,15,20,-5
8,2,286,18,13,5
8,2,287,18,7,11
8,2,288,15,14,1
8,2,289,2,9,-7
8,2,290,10,23,-13
8,2,291,17,17,0
8,2,292,4,7,-3
8,2,293,8,7,1
8,2,294,17,13,4
8,2,295,7,11,-4
8,2,296,9,6,3
8,2,297,9,6,3
8,2,298,6,9,-3
8,2,299,7,11,-4
8,3,0,11,13,-2
8,3,1,8,18,-10
8,3,2,8,10,-2
8,3,3,10,17,-7
8,3,4,9,14,-5
8,3,5,9,7,2
8,3,6,6,7,-1
8,3,7,9,13,-4
8,3,8,8,8,0
8,3,9,9,13,-4
8,3,10,3,13,-10
8,3,11,13,18,-5
8,3,12,17,24,-7
8,3,13,8,7,1
8,3,14,12,26,-14
8,3,15,7,11,-4
8,3,16,10,13,-3
8,3,17,18,12,6
8,3,18,15,18,-3
8,3,19,7,13,-6
8,3,20,11,23,-12
8,3,21,13,13,0
8,3,22,13,19,-6
8,3,23,11,8,3
8,3,24,8,7,1
8,3,25,9,11,-2
8,3,26,6,6,0
8,3,27,11,10,1
8,3,28,12,8,4
8,3,29,17,18,-1
8,3,30,15,15,0
8,3,31,10,17,-7
8,3,32,7,22,-15
8,3,33,20,3,17
8,3,34,11,22,-11
8,3,35,9,11,-2
8,3,36,4,8,-4
8,3,37,11,16,-5
8,3,38,19,23,-4
8,3,39,11,25,-14
8,3,40,10,34,-24
8,3,41,9,16,-7
8,3,42,11,10,1
8,3,43,9,22,-13
8,3,44,13,20,-7
8,3,45,13,13,0
8,3,46,17,27,-10
8,3,47,5,7,-2
8,3,48,15,7,8
8,3,49,11,14,-3
8,3,50,9,11,-2
8,3,51,19,9,10
8,3,52,4,14,-10
8,3,53,14,14,0
8,3,54,6,8,-2
8,3,55,18,18,0
8,3,56,4,5,-1
8,3,57,13,12,1
8,3,58,8,16,-8
8,3,59,8,15,-7
8,3,60,13,14,-1
8,3,61,12,14,-2
8,3,62,7,6,1
8,3,63,9,7,2
8,3,64,18,27,-9
8,3,65,4,9,-5
8,3,66,6,3,3
8,3,67,7,17,-10
8,3,68,19,16,3
8,3,69,3,9,-6
8,3,70,6,3,3
8,3,71,13,11,2
8,3,72,12,18,-6
8,3,73,17,20,-3
8,3,74,14,10,4
8,3,75,2,8,-6
8,3,76,10,23,-13
8,3,77,9,16,-7
8,3,78,10,24,-14
8,3,79,11,13,-2
8,3,80,11,22,-11
8,3,81,13,26,-13
8,3,82,6,12,-6
8,3,83,11,22,-11
8,3,84,11,22,-11
8,3,85,19,16,3
8,3,86,12,17,-5
8,3,87,6,10,-4
8,3,88,14,24,-10
8,3,89,13,19,-6
8,3,90,9,14,-5
8,3,91,8,16,-8
8,3,92,10,21,-11
8,3,93,9,25,-16
8,3,94,7,11,-4
8,3,95,11,26,-15
8,3,96,7,14,-7
8,3,97,17,7,10
8,3,98,20,18,2
8,3,99,19,20,-1
8,3,100,9,9,0
8,3,101,6,19,-13
8,3,102,7,9,-2
8,3,103,6,20,-14
8,3,104,10,21,-11
8,3,105,8,8,0
8,3,106,9,7,2
8,3,107,10,17,-7
8,3,108,8,8,0
8,3,109,6,4,2
8,3,110,12,23,-11
8,3,111,13,10,3
8,3,112,15,11,4
8,3,113,16,13,3
8,3,114,7,19,-12
8,3,115,9,10,-1
8,3,116,10,13,-3
8,3,117,9,19,-10
8,3,118,12,19,-7
8,3,119,12,13,-1
8,3,120,6,19,-13
8,3,121,12,18,-6
8,3,122,7,10,-3
8,3,123,17,18,-1
8,3,124,15,8,7
8,3,125,13,9,4
8,3,126,15,23,-8
8,3,127,24,15,9
8,3,128,18,17,1
8,3,129,16,15,1
8,3,130,4,11,-7
8,3,131,12,13,-1
8,3,132,3,7,-4
8,3,133,10,14,-4
8,3,134,6,4,2
8,3,135,15,26,-11
8,3,136,10,23,-13
8,3,137,9,19,-10
8,3,138,7,8,-1
8,3,139,5,12,-7
8,3,140,15,17,-2
8,3,141,15,19,-4
8,3,142,7,11,-4
8,3,143,6,2,4
8,3,144,5,4,1
8,3,145,18,25,-7
8,3,146,8,19,-11
8,3,147,4,10,-6
8,3,148,5,3,2
8,3,149,8,7,1
8,3,150,9,11,-2
8,3,151,11,8,3
8,3,152,10,14,-4
8,3,153,9,8,1
8,3,154,15,23,-8
8,3,155,19,17,2
8,3,156,12,18,-6
8,3,157,15,15,0
8,3,158,10,19,-9
8,3,159,5,6,-1
8,3,160,9,18,-9
8,3,161,10,13,-3
8,3,162,8,11,-3
8,3,163,8,9,-1
8,3,164,16,27,-11
8,3,165,6,4,2
8,3,166,12,13,-1
8,3,167,9,18,-9
8,3,168,6,17,-11
8,3,169,15,17,-2
8,3,170,15,21,-6
8,3,171,27,29,-2
8,3,172,6,24,-18
8,3,173,19,15,4
8,3,174,11,15,-4
8,3,175,7,9,-2
8,3,176,13,14,-1
8,3,177,0,5,-5
8,3,178,11,16,-5
8,3,179,6,4,2
8,3,180,10,16,-6
8,3,181,11,13,-2
8,3,182,10,18,-8
8,3,183,9,18,-9
8,3,184,12,13,-1
8,3,185,1,13,-12
8,3,186,7,3,4
8,3,187,12,24,-12
8,3,188,10,9,1
8,3,189,8,12,-4
8,3,190,8,20,-12
8,3,191,14,16,-2
8,3,192,7,16,-9
8,3,193,9,9,0
8,3,194,8,20,-12
8,3,195,25,16,9
8,3,196,16,21,-5
8,3,197,11,9,2
8,3,198,16,18,-2
8,3,199,7,21,-14
8,3,200,7,9,-2
8,3,201,10,16,-6
8,3,202,6,16,-10
8,3,203,11,12,-1
8,3,204,8,16,-8
8,3,205,15,20,-5
8,3,206,8,15,-7
8,3,207,4,9,-5
8,3,208,23,19,4
8,3,209,7,12,-5
8,3,210,7,6,1
8,3,211,4,15,-11
8,3,212,11,12,-1
8,3,213,19,20,-1
8,3,214,15,18,-3
8,3,215,12,12,0
8,3,216,17,12,5
8,3,217,4,6,-2
8,3,218,9,26,-17
8,3,219,9,21,-12
8,3,220,7,12,-5
8,3,221,16,9,7
8,3,222,18,20,-2
8,3,223,4,9,-5
8,3,224,9,21,-12
8,3,225,31,17,14
8,3,226,16,26,-10
8,3,227,6,9,-3
8,3,228,15,14,1
8,3,229,11,32,-21
8,3,230,5,7,-2
8,3,231,23,16,7
8,3,232,8,10,-2
8,3,233,14,14,0
8,3,234,11,4,7
8,3,235,11,14,-3
8,3,236,16,16,0
8,3,237,12,10,2
8,3,238,8,3,5
8,3,239,14,7,7
8,3,240,4,3,1
8,3,241,10,21,-11
8,3,242,7,9,-2
8,3,243,16,11,5
8,3,244,22,15,7
8,3,245,10,18,-8
8,3,246,16,21,-5
8,3,247,5,4,1
8,3,248,10,14,-4
8,3,249,17,22,-5
8,3,250,14,11,3
8,3,251,13,11,2
8,3,252,8,22,-14
8,3,253,16,25,-9
8,3,254,21,18,3
8,3,255,13,16,-3
8,3,256,15,10,5
8,3,257,9,23,-14
8,3,258,9,5,4
8,3,259,2,10,-8
8,3,260,4,19,-15
8,3,261,7,8,-1
8,3,262,13,21,-8
8,3,263,12,23,-11
8,3,264,9,12,-3
8,3,265,9,6,3
8,3,266,8,7,1
8,3,267,15,10,5
8,3,268,20,5,15
8,3,269,16,8,8
8,3,270,20,19,1
8,3,271,11,11,0
8,3,272,11,15,-4
8,3,273,15,14,1
8,3,274,3,15,-12
8,3,275,11,9,2
8,3,276,11,8,3
8,3,277,9,21,-12
8,3,278,9,18,-9
8,3,279,13,22,-9
8,3,280,15,7,8
8,3,281,7,12,-5
8,3,282,14,12,2
8,3,283,2,7,-5
8,3,284,6,4,2
8,3,285,7,15,-8
8,3,286,10,20,-10
8,3,287,24,20,4
8,3,288,8,11,-3
8,3,289,28,15,13
8,3,290,1,13,-12
8,3,291,16,15,1
8,3,292,12,13,-1
8,3,293,20,21,-1
8,3,294,8,13,-5
8,3,295,10,24,-14
8,3,296,21,19,2
8,3,297,14,9,5
8,3,298,11,9,2
8,3,299,7,9,-2
8,4,0,11,13,-2
8,4,1,8,12,-4
8,4,2,12,15,-3
8,4,3,17,9,8
8,4,4,1,15,-14
8,4,5,7,10,-3
8,4,6,6,6,0
8,4,7,6,21,-15
8,4,8,6,7,-1
8,4,9,6,15,-9
8,4,10,12,10,2
8,4,11,12,16,-4
8,4,12,6,20,-14
8,4,13,11,24,-13
8,4,14,9,10,-1
8,4,15,9,10,-1
8,4,16,8,14,-6
8,4,17,16,17,-1
8,4,18,19,10,9
8,4,19,6,15,-9
8,4,20,13,13,0
8,4,21,13,19,-6
8,4,22,14,13,1
8,4,23,3,0,3
8,4,24,11,16,-5
8,4,25,15,3,12
8,4,26,10,28,-18
8,4,27,9,12,-3
8,4,28,10,16,-6
8,4,29,5,11,-6
8,4,30,12,15,-3
8,4,31,25,12,13
8,4,32,5,22,-17
8,4,33,18,18,0
8,4,34,20,26,-6
8,4,35,26,22,4
8,4,36,12,6,6
8,4,37,20,24,-4
8,4,38,24,22,2
8,4,39,8,1,7
8,4,40,4,16,-12
8,4,41,7,12,-5
8,4,42,14,3,11
8,4,43,16,18,-2
8,4,44,14,10,4
8,4,45,0,13,-13
8,4,46,12,17,-5
8,4,47,15,18,-3
8,4,48,13,8,5
8,4,49,8,9,-1
8,4,50,2,14,-12
8,4,51,19,13,6
8,4,52,10,13,-3
8,4,53,9,16,-7
8,4,54,9,11,-2
8,4,55,16,16,0
8,4,56,17,16,1
8,4,57,11,29,-18
8,4,58,5,9,-4
8,4,59,26,23,3
8,4,60,22,20,2
8,4,61,7,11,-4
8,4,62,8,18,-10
8,4,63,3,13,-10
8,4,64,9,9,0
8,4,65,18,16,2
8,4,66,13,23,-10
8,4,67,10,18,-8
8,4,68,13,12,1
8,4,69,6,7,-1
8,4,70,11,10,1
8,4,71,15,16,-1
8,4,72,5,11,-6
8,4,73,12,14,-2
8,4,74,7,18,-11
8,4,75,12,21,-9
8,4,76,13,8,5
8,4,77,10,13,-3
8,4,78,11,8,3
8,4,79,9,12,-3
8,4,80,11,15,-4
8,4,81,4,15,-11
8,4,82,7,11,-4
8,4,83,12,9,3
8,4,84,13,21,-8
8,4,85,3,18,-15
8,4,86,8,7,1
8,4,87,11,19,-8
8,4,88,4,7,-3
8,4,89,12,19,-7
8,4,90,12,10,2
8,4,91,7,24,-17
8,4,92,6,11,-5
8,4,93,13,13,0
8,4,94,10,6,4
8,4,95,9,10,-1
8,4,96,3,12,-9
8,4,97,12,27,-15
8,4,98,15,12,3
8,4,99,5,8,-3
8,4,100,16,18,-2
8,4,101,16,19,-3
8,4,102,8,12,-4
8,4,103,31,18,13
8,4,104,15,30,-15
8,4,105,11,11,0
8,4,106,15,1,14
8,4,107,6,7,-1
8,4,108,15,22,-7
8,4,109,9,8,1
8,4,110,13,18,-5
8,4,111,12,27,-15
8,4,112,13,22,-9
8,4,113,10,17,-7
8,4,114,18,10,8
8,4,115,18,30,-12
8,4,116,18,22,-4
8,4,117,9,11,-2
8,4,118,13,25,-12
8,4,119,12,13,-1
8,4,120,7,10,-3
8,4,121,14,14,0
8,4,122,19,15,4
8,4,123,19,9,10
8,4,124,16,14,2
8,4,125,10,26,-16
8,4,126,15,19,-4
8,4,127,9,9,0
8,4,128,22,10,12
8,4,129,17,12,5
8,4,130,3,11,-8
8,4,131,13,23,-10
8,4,132,6,21,-15
8,4,133,5,6,-1
8,4,134,6,23,-17
8,4,135,12,10,2
8,4,136,18,12,6
8,4,137,16,21,-5
8,4,138,8,24,-16
8,4,139,9,6,3
8,4,140,16,14,2
8,4,141,15,13,2
8,4,142,17,17,0
8,4,143,17,22,-5
8,4,144,10,11,-1
8,4,145,10,16,-6
8,4,146,16,15,1
8,4,147,26,13,13
8,4,148,17,13,4
8,4,149,9,14,-5
8,4,150,9,20,-11
8,4,151,16,18,-2
8,4,152,13,18,-5
8,4,153,7,21,-14
8,4,154,13,13,0
8,4,155,8,9,-1
8,4,156,21,18,3
8,4,157,20,18,2
8,4,158,18,6,12
8,4,159,12,14,-2
8,4,160,14,15,-1
8,4,161,9,20,-11
8,4,162,6,9,-3
8,4,163,8,16,-8
8,4,164,18,16,2
8,4,165,11,7,4
8,4,166,12,9,3
8,4,167,10,23,-13
8,4,168,10,13,-3
8,4,169,16,21,-5
8,4,170,18,23,-5
8,4,171,15,30,-15
8,4,172,10,12,-2
8,4,173,11,6,5
8,4,174,4,15,-11
8,4,175,19,22,-3
8,4,176,9,16,-7
8,4,177,11,11,0
8,4,178,12,21,-9
8,4,179,13,21,-8
8,4,180,30,23,7
8,4,181,11,25,-14
8,4,182,12,6,6
8,4,183,14,18,-4
8,4,184,12,22,-10
8,4,185,10,16,-6
8,4,186,8,22,-14
8,4,187,10,9,1
8,4,188,1,17,-16
8,4,189,12,12,0
8,4,190,6,4,2
8,4,191,9,19,-10
8,4,192,19,22,-3
8,4,193,10,11,-1
8,4,194,18,13,5
8,4,195,17,13,4
8,4,196,21,22,-1
8,4,197,14,13,1
8,4,198,11,15,-4
8,4,199,12,18,-6
8,4,200,14,8,6
8,4,201,9,9,0
8,4,202,16,15,1
8,4,203,12,5,7
8,4,204,14,22,-8
8,4,205,21,9,12
8,4,206,13,7,6
8,4,207,16,17,-1
8,4,208,7,8,-1
8,4,209,11,9,2
8,4,210,9,13,-4
8,4,211,18,23,-5
8,4,212,4,19,-15
8,4,213,11,11,0
8,4,214,14,10,4
8,4,215,12,14,-2
8,4,216,10,13,-3
8,4,217,14,14,0
8,4,218,15,13,2
8,4,219,29,15,14
8,4,220,8,8,0
8,4,221,7,16,-9
8,4,222,11,15,-4
8,4,223,9,19,-10
8,4,224,7,16,-9
8,4,225,10,12,-2
8,4,226,12,10,2
8,4,227,2,8,-6
8,4,228,6,10,-4
8,4,229,14,18,-4
8,4,230,6,47,-41
8,4,231,4,16,-12
8,4,232,19,17,2
8,4,233,6,9,-3
8,4,234,7,10,-3
8,4,235,5,14,-9
8,4,236,10,9,1
8,4,237,26,15,11
8,4,238,13,12,1
8,4,239,9,12,-3
8,4,240,12,18,-6
8,4,241,16,15,1
8,4,242,14,20,-6
8,4,243,16,11,5
8,4,244,12,11,1
8,4,245,14,19,-5
8,4,246,10,20,-10
8,4,247,9,12,-3
8,4,248,8,13,-5
8,4,249,17,21,-4
8,4,250,14,16,-2
8,4,251,4,7,-3
8,4,252,5,18,-13
8,4,253,8,7,1
8,4,254,3,13,-10
8,4,255,18,15,3
8,4,256,5,2,3
8,4,257,12,16,-4
8,4,258,9,14,-5
8,4,259,17,16,1
8,4,260,11,13,-2
8,4,261,16,21,-5
8,4,262,8,25,-17
8,4,263,8,15,-7
8,4,264,15,21,-6
8,4,265,16,16,0
8,4,266,20,15,5
8,4,267,8,18,-10
8,4,268,4,10,-6
8,4,269,13,14,-1
8,4,270,12,8,4
8,4,271,8,14,-6
8,4,272,21,26,-5
8,4,273,12,12,0
8,4,274,17,31,-14
8,4,275,7,10,-3
8,4,276,12,5,7
8,4,277,2,11,-9
8,4,278,22,17,5
8,4,279,5,9,-4
8,4,280,30,31,-1
8,4,281,9,13,-4
8,4,282,12,19,-7
8,4,283,7,4,3
8,4,284,7,12,-5
8,4,285,20,19,1
8,4,286,11,16,-5
8,4,287,18,18,0
8,4,288,19,22,-3
8,4,289,11,11,0
8,4,290,7,24,-17
8,4,291,19,28,-9
8,4,292,14,17,-3
8,4,293,11,13,-2
8,4,294,13,10,3
8,4,295,13,21,-8
8,4,296,11,20,-9
8,4,297,11,31,-20
8,4,298,14,14,0
8,4,299,5,14,-9
8,5,0,13,27,-14
8,5,1,12,20,-8
8,5,2,2,8,-6
8,5,3,10,18,-8
8,5,4,12,12,0
8,5,5,10,17,-7
8,5,6,9,8,1
8,5,7,16,11,5
8,5,8,14,8,6
8,5,9,21,19,2
8,5,10,10,19,-9
8,5,11,13,15,-2
8,5,12,14,17,-3
8,5,13,16,16,0
8,5,14,18,12,6
8,5,15,16,6,10
8,5,16,15,6,9
8,5,17,16,7,9
8,5,18,10,14,-4
8,5,19,10,11,-1
8,5,20,10,10,0
8,5,21,23,18,5
8,5,22,14,22,-8
8,5,23,7,10,-3
8,5,24,16,15,1
8,5,25,5,11,-6
8,5,26,17,17,0
8,5,27,14,11,3
8,5,28,4,10,-6
8,5,29,14,23,-9
8,5,30,9,9,0
8,5,31,11,19,-8
8,5,32,12,16,-4
8,5,33,9,15,-6
8,5,34,11,14,-3
8,5,35,10,16,-6
8,5,36,8,10,-2
8,5,37,11,12,-1
8,5,38,8,23,-15
8,5,39,15,25,-10
8,5,40,21,12,9
8,5,41,7,21,-14
8,5,42,11,11,0
8,5,43,22,15,7
8,5,44,12,16,-4
8,5,45,14,25,-11
8,5,46,9,9,0
8,5,47,10,14,-4
8,5,48,17,28,-11
8,5,49,15,12,3
8,5,50,10,6,4
8,5,51,3,9,-6
8,5,52,17,29,-12
8,5,53,12,11,1
8,5,54,26,17,9
8,5,55,12,24,-12
8,5,56,13,15,-2
8,5,57,11,5,6
8,5,58,8,3,5
8,5,59,7,7,0
8,5,60,6,7,-1
8,5,61,14,8,6
8,5,62,24,24,0
8,5,63,19,18,1
8,5,64,8,4,4
8,5,65,17,11,6
8,5,66,15,18,-3
8,5,67,22,14,8
8,5,68,8,5,3
8,5,69,2,11,-9
8,5,70,14,15,-1
8,5,71,11,10,1
8,5,72,9,19,-10
8,5,73,15,12,3
8,5,74,20,16,4
8,5,75,15,15,0
8,5,76,10,18,-8
8,5,77,5,13,-8
8,5,78,15,14,1
8,5,79,6,8,-2
8,5,80,13,24,-11
8,5,81,14,14,0
8,5,82,16,15,1
8,5,83,12,12,0
8,5,84,11,9,2
8,5,85,13,30,-17
8,5,86,20,20,0
8,5,87,13,24,-11
8,5,88,6,10,-4
8,5,89,5,8,-3
8,5,90,16,19,-3
8,5,91,12,12,0
8,5,92,26,21,5
8,5,93,2,7,-5
8,5,94,11,16,-5
8,5,95,16,16,0
8,5,96,14,28,-14
8,5,97,16,27,-11
8,5,98,20,13,7
8,5,99,5,10,-5
8,5,100,13,10,3
8,5,101,9,19,-10
8,5,102,8,12,-4
8,5,103,5,4,1
8,5,104,9,18,-9
8,5,105,10,12,-2
8,5,106,4,15,-11
8,5,107,14,12,2
8,5,108,14,14,0
8,5,109,13,14,-1
8,5,110,18,14,4
8,5,111,14,28,-14
8,5,112,12,23,-11
8,5,113,9,25,-16
8,5,114,22,21,1
8,5,115,12,8,4
8,5,116,15,14,1
8,5,117,9,14,-5
8,5,118,13,18,-5
8,5,119,3,9,-6
8,5,120,8,14,-6
8,5,121,14,20,-6
8,5,122,9,21,-12
8,5,123,13,11,2
8,5,124,22,17,5
8,5,125,8,12,-4
8,5,126,13,14,-1
8,5,127,9,10,-1
8,5,128,10,14,-4
8,5,129,15,17,-2
8,5,130,17,21,-4
8,5,131,8,18,-10
8,5,132,12,26,-14
8,5,133,23,12,11
8,5,134,10,34,-24
8,5,135,10,17,-7
8,5,136,16,9,7
8,5,137,4,11,-7
8,5,138,25,29,-4
8,5,139,15,18,-3
8,5,140,5,13,-8
8,5,141,16,14,2
8,5,142,9,13,-4
8,5,143,17,25,-8
8,5,144,15,7,8
8,5,145,6,11,-5
8,5,146,14,28,-14
8,5,147,13,12,1
8,5,148,12,19,-7
8,5,149,10,13,-3
8,5,150,6,16,-10
8,5,151,18,18,0
8,5,152,11,11,0
8,5,153,14,14,0
8,5,154,19,14,5
8,5,155,11,15,-4
8,5,156,19,27,-8
8,5,157,17,12,5
8,5,158,19,18,1
8,5,159,19,10,9
8,5,160,22,12,10
8,5,161,8,25,-17
8,5,162,1,8,-7
8,5,163,9,20,-11
8,5,164,14,9,5
8,5,165,8,18,-10
8,5,166,7,9,-2
8,5,167,12,10,2
8,5,168,17,6,11
8,5,169,15,19,-4
8,5,170,6,9,-3
8,5,171,14,20,-6
8,5,172,26,18,8
8,5,173,14,9,5
8,5,174,7,19,-12
8,5,175,14,9,5
8,5,176,16,18,-2
8,5,177,7,7,0
8,5,178,12,20,-8
8,5,179,7,19,-12
8,5,180,16,10,6
8,5,181,18,10,8
8,5,182,8,8,0
8,5,183,14,17,-3
8,5,184,11,16,-5
8,5,185,11,21,-10
8,5,186,10,28,-18
8,5,187,9,26,-17
8,5,188,9,13,-4
8,5,189,8,20,-12
8,5,190,20,11,9
8,5,191,16,22,-6
8,5,192,12,23,-11
8,5,193,23,23,0
8,5,194,8,14,-6
8,5,195,14,16,-2
8,5,196,15,15,0
8,5,197,7,9,-2
8,5,198,15,11,4
8,5,199,8,14,-6
8,5,200,15,20,-5
8,5,201,15,8,7
8,5,202,12,15,-3
8,5,203,16,17,-1
8,5,204,13,8,5
8,5,205,5,11,-6
8,5,206,10,12,-2
8,5,207,8,13,-5
8,5,208,28,20,8
8,5,209,16,23,-7
8,5,210,10,9,1
8,5,211,14,24,-10
8,5,212,7,12,-5
8,5,213,10,9,1
8,5,214,14,12,2
8,5,215,10,5,5
8,5,216,24,20,4
8,5,217,23,15,8
8,5,218,17,11,6
8,5,219,6,13,-7
8,5,220,12,10,2
8,5,221,18,12,6
8,5,222,16,14,2
8,5,223,17,18,-1
8,5,224,10,9,1
8,5,225,12,18,-6
8,5,226,12,16,-4
8,5,227,8,8,0
8,5,228,17,15,2
8,5,229,4,7,-3
8,5,230,16,23,-7
8,5,231,18,20,-2
8,5,232,12,16,-4
8,5,233,13,8,5
8,5,234,6,6,0
8,5,235,14,16,-2
8,5,236,11,15,-4
8,5,237,16,18,-2
8,5,238,11,19,-8
8,5,239,17,13,4
8,5,240,14,20,-6
8,5,241,12,12,0
8,5,242,22,19,3
8,5,243,15,16,-1
8,5,244,5,16,-11
8,5,245,17,22,-5
8,5,246,27,24,3
8,5,247,7,27,-20
8,5,248,13,11,2
8,5,249,8,15,-7
8,5,250,21,21,0
8,5,251,6,8,-2
8,5,252,8,18,-10
8,5,253,14,20,-6
8,5,254,17,12,5
8,5,255,9,5,4
8,5,256,16,27,-11
8,5,257,17,22,-5
8,5,258,15,22,-7
8,5,259,8,9,-1
8,5,260,14,8,6
8,5,261,15,16,-1
8,5,262,15,23,-8
8,5,263,9,16,-7
8,5,264,18,17,1
8,5,265,22,18,4
8,5,266,13,12,1
8,5,267,11,16,-5
8,5,268,18,19,-1
8,5,269,13,20,-7
8,5,270,16,16,0
8,5,271,10,10,0
8,5,272,7,8,-1
8,5,273,20,28,-8
8,5,274,12,14,-2
8,5,275,15,16,-1
8,5,276,9,10,-1
8,5,277,22,26,-4
8,5,278,13,8,5
8,5,279,15,24,-9
8,5,280,16,18,-2
8,5,281,15,20,-5
8,5,282,18,12,6
8,5,283,5,17,-12
8,5,284,9,11,-2
8,5,285,10,9,1
8,5,286,15,25,-10
8,5,287,22,16,6
8,5,288,10,4,6
8,5,289,12,19,-7
8,5,290,19,20,-1
8,5,291,17,15,2
8,5,292,13,17,-4
8,5,293,12,11,1
8,5,294,14,22,-8
8,5,295,14,17,-3
8,5,296,10,12,-2
8,5,297,7,20,-13
8,5,298,11,19,-8
8,5,299,3,10,-7
8,6,0,18,16,2
8,6,1,22,8,14
8,6,2,9,14,-5
8,6,3,8,15,-7
8,6,4,15,15,0
8,6,5,11,25,-14
8,6,6,18,14,4
8,6,7,24,29,-5
8,6,8,3,14,-11
8,6,9,16,19,-3
8,6,10,15,13,2
8,6,11,12,19,-7
8,6,12,11,10,1
8,6,13,26,10,16
8,6,14,11,14,-3
8,6,15,10,22,-12
8,6,16,8,11,-3
8,6,17,3,15,-12
8,6,18,15,25,-10
8,6,19,19,16,3
8,6,20,9,19,-10
8,6,21,10,16,-6
8,6,22,12,13,-1
8,6,23,10,7,3
8,6,24,10,17,-7
8,6,25,15,33,-18
8,6,26,21,23,-2
8,6,27,17,21,-4
8,6,28,10,19,-9
8,6,29,8,13,-5
8,6,30,14,24,-10
8,6,31,30,20,10
8,6,32,10,19,-9
8,6,33,15,25,-10
8,6,34,26,24,2
8,6,35,10,14,-4
8,6,36,21,16,5
8,6,37,20,18,2
8,6,38,18,21,-3
8,6,39,19,17,2
8,6,40,13,16,-3
8,6,41,15,21,-6
8,6,42,10,9,1
8,6,43,9,11,-2
8,6,44,9,3,6
8,6,45,12,13,-1
8,6,46,14,12,2
8,6,47,23,13,10
8,6,48,26,11,15
8,6,49,15,26,-11
8,6,50,5,21,-16
8,6,51,16,13,3
8,6,52,7,8,-1
8,6,53,5,24,-19
8,6,54,30,24,6
8,6,55,5,11,-6
8,6,56,10,19,-9
8,6,57,18,15,3
8,6,58,19,12,7
8,6,59,16,18,-2
8,6,60,21,25,-4
8,6,61,15,7,8
8,6,62,19,13,6
8,6,63,11,17,-6
8,6,64,12,19,-7
8,6,65,4,13,-9
8,6,66,19,13,6
8,6,67,11,24,-13
8,6,68,13,17,-4
8,6,69,8,14,-6
8,6,70,13,20,-7
8,6,71,13,14,-1
8,6,72,11,24,-13
8,6,73,9,7,2
8,6,74,12,20,-8
8,6,75,20,11,9
8,6,76,12,16,-4
8,6,77,11,12,-1
8,6,78,15,11,4
8,6,79,19,33,-14
8,6,80,26,54,-28
8,6,81,11,20,-9
8,6,82,15,13,2
8,6,83,11,12,-1
8,6,84,19,26,-7
8,6,85,13,16,-3
8,6,86,19,14,5
8,6,87,10,12,-2
8,6,88,13,9,4
8,6,89,14,17,-3
8,6,90,12,13,-1
8,6,91,15,21,-6
8,6,92,10,12,-2
8,6,93,15,19,-4
8,6,94,11,9,2
8,6,95,16,17,-1
8,6,96,14,21,-7
8,6,97,7,12,-5
8,6,98,6,12,-6
8,6,99,12,14,-2
8,6,100,16,15,1
8,6,101,9,9,0
8,6,102,14,10,4
8,6,103,18,17,1
8,6,104,6,5,1
8,6,105,11,11,0
8,6,106,16,25,-9
8,6,107,20,15,5
8,6,108,13,8,5
8,6,109,16,13,3
8,6,110,11,17,-6
8,6,111,7,6,1
8,6,112,25,20,5
8,6,113,14,9,5
8,6,114,24,15,9
8,6,115,12,27,-15
8,6,116,5,11,-6
8,6,117,14,12,2
8,6,118,18,14,4
8,6,119,13,11,2
8,6,120,12,12,0
8,6,121,21,13,8
8,6,122,11,11,0
8,6,123,22,9,13
8,6,124,16,25,-9
8,6,125,8,11,-3
8,6,126,31,15,16
8,6,127,19,12,7
8,6,128,14,9,5
8,6,129,14,21,-7
8,6,130,10,10,0
8,6,131,10,12,-2
8,6,132,18,18,0
8,6,133,7,3,4
8,6,134,17,23,-6
8,6,135,15,25,-10
8,6,136,18,22,-4
8,6,137,24,16,8
8,6,138,7,14,-7
8,6,139,9,16,-7
8,6,140,16,12,4
8,6,141,21,40,-19
8,6,142,13,26,-13
8,6,143,17,12,5
8,6,144,8,7,1
8,6,145,16,17,-1
8,6,146,16,23,-7
8,6,147,10,14,-4
8,6,148,5,8,-3
8,6,149,18,20,-2
8,6,150,23,19,4
8,6,151,19,18,1
8,6,152,16,21,-5
8,6,153,9,20,-11
8,6,154,14,7,7
8,6,155,16,20,-4
8,6,156,4,15,-11
8,6,157,11,23,-12
8,6,158,12,15,-3
8,6,159,5,17,-12
8,6,160,8,6,2
8,6,161,14,12,2
8,6,162,15,9,6
8,6,163,14,21,-7
8,6,164,30,14,16
8,6,165,8,14,-6
8,6,166,11,15,-4
8,6,167,11,16,-5
8,6,168,12,20,-8
8,6,169,11,21,-10
8,6,170,15,9,6
8,6,171,9,31,-22
8,6,172,16,12,4
8,6,173,21,16,5
8,6,174,24,12,12
8,6,175,21,26,-5
8,6,176,15,16,-1
8,6,177,5,16,-11
8,6,178,16,8,8
8,6,179,10,8,2
8,6,180,13,22,-9
8,6,181,20,14,6
8,6,182,21,16,5
8,6,183,15,16,-1
8,6,184,12,13,-1
8,6,185,11,14,-3
8,6,186,9,9,0
8,6,187,13,9,4
8,6,188,12,21,-9
8,6,189,10,13,-3
8,6,190,13,13,0
8,6,191,12,4,8
8,6,192,21,15,6
8,6,193,5,14,-9
8,6,194,16,14,2
8,6,195,7,12,-5
8,6,196,22,14,8
8,6,197,8,19,-11
8,6,198,11,15,-4
8,6,199,4,13,-9
8,6,200,22,16,6
8,6,201,7,9,-2
8,6,202,9,10,-1
8,6,203,18,17,1
8,6,204,19,17,2
8,6,205,9,15,-6
8,6,206,9,15,-6
8,6,207,15,19,-4
8,6,208,5,15,-10
8,6,209,6,20,-14
8,6,210,13,38,-25
8,6,211,14,14,0
8,6,212,9,19,-10
8,6,213,16,12,4
8,6,214,5,13,-8
8,6,215,2,13,-11
8,6,216,20,20,0
8,6,217,19,20,-1
8,6,218,16,21,-5
8,6,219,15,9,6
8,6,220,10,17,-7
8,6,221,17,18,-1
8,6,222,14,30,-16
8,6,223,8,15,-7
8,6,224,19,5,14
8,6,225,10,12,-2
8,6,226,20,16,4
8,6,227,5,10,-5
8,6,228,6,8,-2
8,6,229,18,22,-4
8,6,230,10,16,-6
8,6,231,21,13,8
8,6,232,13,12,1
8,6,233,5,8,-3
8,6,234,20,14,6
8,6,235,15,15,0
8,6,236,18,24,-6
8,6,237,16,19,-3
8,6,238,11,14,-3
8,6,239,14,19,-5
8,6,240,15,16,-1
8,6,241,9,11,-2
8,6,242,26,12,14
8,6,243,6,14,-8
8,6,244,9,19,-10
8,6,245,8,16,-8
8,6,246,10,14,-4
8,6,247,4,14,-10
8,6,248,22,26,-4
8,6,249,7,16,-9
8,6,250,22,11,11
8,6,251,11,11,0
8,6,252,19,14,5
8,6,253,16,19,-3
8,6,254,13,29,-16
8,6,255,25,30,-5
8,6,256,13,16,-3
8,6,257,8,8,0
8,6,258,25,8,17
8,6,259,17,21,-4
8,6,260,13,22,-9
8,6,261,6,11,-5
8,6,262,10,10,0
8,6,263,19,13,6
8,6,264,7,5,2
8,6,265,5,12,-7
8,6,266,12,3,9
8,6,267,17,19,-2
8,6,268,20,13,7
8,6,269,17,25,-8
8,6,270,12,31,-19
8,6,271,14,20,-6
8,6,272,15,23,-8
8,6,273,7,13,-6
8,6,274,13,22,-9
8,6,275,11,23,-12
8,6,276,13,31,-18
8,6,277,12,16,-4
8,6,278,18,14,4
8,6,279,23,16,7
8,6,280,26,18,8
8,6,281,22,19,3
8,6,282,14,14,0
8,6,283,15,20,-5
8,6,284,15,7,8
8,6,285,12,24,-12
8,6,286,10,13,-3
8,6,287,13,13,0
8,6,288,13,11,2
8,6,289,9,10,-1
8,6,290,7,24,-17
8,6,291,18,15,3
8,6,292,17,15,2
8,6,293,6,15,-9
8,6,294,14,9,5
8,6,295,18,6,12
8,6,296,12,22,-10
8,6,297,25,11,14
8,6,298,6,15,-9
8,6,299,14,14,0
8,7,0,9,12,-3
8,7,1,15,26,-11
8,7,2,23,18,5
8,7,3,8,10,-2
8,7,4,11,10,1
8,7,5,16,19,-3
8,7,6,15,17,-2
8,7,7,17,22,-5
8,7,8,12,19,-7
8,7,9,11,4,7
8,7,10,12,8,4
8,7,11,13,22,-9
8,7,12,17,14,3
8,7,13,8,7,1
8,7,14,4,7,-3
8,7,15,6,21,-15
8,7,16,11,10,1
8,7,17,7,13,-6
8,7,18,11,11,0
8,7,19,10,16,-6
8,7,20,6,22,-16
8,7,21,9,12,-3
8,7,22,16,11,5
8,7,23,17,10,7
8,7,24,15,28,-13
8,7,25,9,12,-3
8,7,26,12,17,-5
8,7,27,9,15,-6
8,7,28,17,18,-1
8,7,29,6,9,-3
8,7,30,13,10,3
8,7,31,10,21,-11
8,7,32,20,20,0
8,7,33,19,14,5
8,7,34,10,16,-6
8,7,35,8,9,-1
8,7,36,9,22,-13
8,7,37,18,18,0
8,7,38,23,9,14
8,7,39,22,13,9
8,7,40,18,22,-4
8,7,41,4,8,-4
8,7,42,9,11,-2
8,7,43,23,12,11
8,7,44,7,21,-14
8,7,45,15,12,3
8,7,46,14,33,-19
8,7,47,19,25,-6
8,7,48,20,18,2
8,7,49,12,18,-6
8,7,50,21,19,2
8,7,51,15,28,-13
8,7,52,8,10,-2
8,7,53,11,19,-8
8,7,54,24,16,8
8,7,55,13,19,-6
8,7,56,16,23,-7
8,7,57,9,30,-21
8,7,58,6,13,-7
8,7,59,18,19,-1
8,7,60,18,6,12
8,7,61,23,13,10
8,7,62,15,22,-7
8,7,63,13,26,-13
8,7,64,24,13,11
8,7,65,18,5,13
8,7,66,25,15,10
8,7,67,8,10,-2
8,7,68,14,20,-6
8,7,69,12,14,-2
8,7,70,11,18,-7
8,7,71,11,17,-6
8,7,72,13,17,-4
8,7,73,18,8,10
8,7,74,12,12,0
8,7,75,6,11,-5
8,7,76,18,21,-3
8,7,77,21,8,13
8,7,78,33,11,22
8,7,79,11,23,-12
8,7,80,24,13,11
8,7,81,16,17,-1
8,7,82,13,18,-5
8,7,83,14,13,1
8,7,84,8,8,0
8,7,85,20,19,1
8,7,86,3,3,0
8,7,87,17,14,3
8,7,88,5,17,-12
8,7,89,8,13,-5
8,7,90,10,13,-3
8,7,91,17,16,1
8,7,92,6,18,-12
8,7,93,15,17,-2
8,7,94,13,27,-14
8,7,95,8,5,3
8,7,96,17,18,-1
8,7,97,16,35,-19
8,7,98,14,16,-2
8,7,99,12,14,-2
8,7,100,14,10,4
8,7,101,19,12,7
8,7,102,6,7,-1
8,7,103,17,12,5
8,7,104,10,8,2
8,7,105,24,21,3
8,7,106,12,17,-5
8,7,107,13,24,-11
8,7,108,27,11,16
8,7,109,16,23,-7
8,7,110,18,21,-3
8,7,111,7,21,-14
8,7,112,10,25,-15
8,7,113,8,10,-2
8,7,114,8,14,-6
8,7,115,18,19,-1
8,7,116,14,23,-9
8,7,117,20,13,7
8,7,118,20,37,-17
8,7,119,17,14,3
8,7,120,19,20,-1
8,7,121,3,5,-2
8,7,122,20,29,-9
8,7,123,19,11,8
8,7,124,8,19,-11
8,7,125,7,8,-1
8,7,126,18,21,-3
8,7,127,20,25,-5
8,7,128,9,10,-1
8,7,129,13,18,-5
8,7,130,16,7,9
8,7,131,13,20,-7
8,7,132,20,13,7
8,7,133,14,22,-8
8,7,134,9,12,-3
8,7,135,16,18,-2
8,7,136,13,16,-3
8,7,137,9,3,6
8,7,138,15,8,7
8,7,139,12,8,4
8,7,140,14,14,0
8,7,141,27,21,6
8,7,142,8,6,2
8,7,143,7,11,-4
8,7,144,4,7,-3
8,7,145,21,14,7
8,7,146,16,20,-4
8,7,147,9,9,0
8,7,148,6,10,-4
8,7,149,17,18,-1
8,7,150,9,16,-7
8,7,151,12,17,-5
8,7,152,9,19,-10
8,7,153,20,10,10
8,7,154,6,13,-7
8,7,155,11,6,5
8,7,156,6,8,-2
8,7,157,9,13,-4
8,7,158,12,18,-6
8,7,159,17,10,7
8,7,160,12,7,5
8,7,161,11,15,-4
8,7,162,19,16,3
8,7,163,11,13,-2
8,7,164,13,15,-2
8,7,165,14,19,-5
8,7,166,8,17,-9
8,7,167,18,18,0
8,7,168,22,23,-1
8,7,169,20,20,0
8,7,170,18,24,-6
8,7,171,14,18,-4
8,7,172,14,10,4
8,7,173,11,13,-2
8,7,174,21,11,10
8,7,175,15,18,-3
8,7,176,8,5,3
8,7,177,19,28,-9
8,7,178,18,19,-1
8,7,179,7,6,1
8,7,180,14,27,-13
8,7,181,17,24,-7
8,7,182,9,11,-2
8,7,183,13,17,-4
8,7,184,15,24,-9
8,7,185,10,15,-5
8,7,186,13,21,-8
8,7,187,10,6,4
8,7,188,9,12,-3
8,7,189,6,13,-7
8,7,190,13,10,3
8,7,191,12,19,-7
8,7,192,17,17,0
8,7,193,17,19,-2
8,7,194,13,14,-1
8,7,195,24,21,3
8,7,196,21,20,1
8,7,197,21,15,6
8,7,198,3,11,-8
8,7,199,7,7,0
8,7,200,12,14,-2
8,7,201,13,14,-1
8,7,202,11,18,-7
8,7,203,5,10,-5
8,7,204,14,17,-3
8,7,205,16,18,-2
8,7,206,7,7,0
8,7,207,19,20,-1
8,7,208,2,15,-13
8,7,209,17,14,3
8,7,210,5,12,-7
8,7,211,19,23,-4
8,7,212,19,17,2
8,7,213,10,11,-1
8,7,214,14,15,-1
8,7,215,14,6,8
8,7,216,9,15,-6
8,7,217,7,7,0
8,7,218,7,10,-3
8,7,219,9,23,-14
8,7,220,24,18,6
8,7,221,25,11,14
8,7,222,14,8,6
8,7,223,13,17,-4
8,7,224,15,12,3
8,7,225,14,13,1
8,7,226,19,16,3
8,7,227,14,14,0
8,7,228,16,15,1
8,7,229,6,19,-13
8,7,230,6,10,-4
8,7,231,10,9,1
8,7,232,27,19,8
8,7,233,16,20,-4
8,7,234,20,16,4
8,7,235,8,20,-12
8,7,236,10,23,-13
8,7,237,19,20,-1
8,7,238,10,12,-2
8,7,239,9,23,-14
8,7,240,20,16,4
8,7,241,10,12,-2
8,7,242,1,12,-11
8,7,243,18,18,0
8,7,244,12,19,-7
8,7,245,17,35,-18
8,7,246,18,24,-6
8,7,247,5,12,-7
8,7,248,16,19,-3
8,7,249,11,14,-3
8,7,250,15,17,-2
8,7,251,11,14,-3
8,7,252,7,11,-4
8,7,253,10,9,1
8,7,254,20,16,4
8,7,255,12,12,0
8,7,256,13,14,-1
8,7,257,15,15,0
8,7,258,17,13,4
8,7,259,4,18,-14
8,7,260,10,25,-15
8,7,261,9,4,5
8,7,262,8,21,-13
8,7,263,15,15,0
8,7,264,9,10,-1
8,7,265,12,11,1
8,7,266,13,4,9
8,7,267,12,6,6
8,7,268,9,4,5
8,7,269,14,18,-4
8,7,270,13,23,-10
8,7,271,18,16,2
8,7,272,3,18,-15
8,7,273,15,19,-4
8,7,274,15,12,3
8,7,275,11,14,-3
8,7,276,10,19,-9
8,7,277,10,20,-10
8,7,278,14,13,1
8,7,279,28,12,16
8,7,280,16,7,9
8,7,281,15,17,-2
8,7,282,18,16,2
8,7,283,15,23,-8
8,7,284,14,14,0
8,7,285,21,16,5
8,7,286,15,3,12
8,7,287,20,13,7
8,7,288,9,9,0
8,7,289,25,8,17
8,7,290,18,35,-17
8,7,291,10,13,-3
8,7,292,15,26,-11
8,7,293,21,20,1
8,7,294,21,22,-1
8,7,295,14,10,4
8,7,296,21,24,-3
8,7,297,16,18,-2
8,7,298,22,15,7
8,7,299,15,19,-4
8,8,0,12,12,0
8,8,1,14,16,-2
8,8,2,19,23,-4
8,8,3,19,19,0
8,8,4,12,20,-8
8,8,5,17,12,5
8,8,6,6,8,-2
8,8,7,8,9,-1
8,8,8,10,10,0
8,8,9,9,17,-8
8,8,10,6,11,-5
8,8,11,15,9,6
8,8,12,17,17,0
8,8,13,13,22,-9
8,8,14,17,16,1
8,8,15,7,13,-6
8,8,16,22,30,-8
8,8,17,6,15,-9
8,8,18,17,16,1
8,8,19,19,14,5
8,8,20,13,8,5
8,8,21,12,12,0
8,8,22,13,9,4
8,8,23,16,22,-6
8,8,24,11,24,-13
8,8,25,19,14,5
8,8,26,18,15,3
8,8,27,13,17,-4
8,8,28,6,9,-3
8,8,29,17,15,2
8,8,30,14,17,-3
8,8,31,10,23,-13
8,8,32,16,18,-2
8,8,33,5,14,-9
8,8,34,11,9,2
8,8,35,9,9,0
8,8,36,23,24,-1
8,8,37,14,23,-9
8,8,38,10,6,4
8,8,39,10,16,-6
8,8,40,7,11,-4
8,8,41,27,11,16
8,8,42,8,14,-6
8,8,43,18,17,1
8,8,44,11,18,-7
8,8,45,29,17,12
8,8,46,17,21,-4
8,8,47,11,10,1
8,8,48,14,7,7
8,8,49,19,33,-14
8,8,50,9,8,1
8,8,51,8,16,-8
8,8,52,29,15,14
8,8,53,12,8,4
8,8,54,16,7,9
8,8,55,12,20,-8
8,8,56,11,14,-3
8,8,57,15,16,-1
8,8,58,25,25,0
8,8,59,14,10,4
8,8,60,10,4,6
8,8,61,15,11,4
8,8,62,14,19,-5
8,8,63,10,12,-2
8,8,64,6,10,-4
8,8,65,11,25,-14
8,8,66,9,10,-1
8,8,67,11,6,5
8,8,68,8,16,-8
8,8,69,10,27,-17
8,8,70,3,2,1
8,8,71,11,7,4
8,8,72,17,21,-4
8,8,73,14,25,-11
8,8,74,11,24,-13
8,8,75,14,20,-6
8,8,76,7,11,-4
8,8,77,2,12,-10
8,8,78,9,17,-8
8,8,79,11,12,-1
8,8,80,7,13,-6
8,8,81,13,18,-5
8,8,82,9,8,1
8,8,83,7,16,-9
8,8,84,27,26,1
8,8,85,4,6,-2
8,8,86,18,22,-4
8,8,87,12,12,0
8,8,88,9,24,-15
8,8,89,17,16,1
8,8,90,9,20,-11
8,8,91,7,18,-11
8,8,92,14,6,8
8,8,93,7,15,-8
8,8,94,14,9,5
8,8,95,11,9,2
8,8,96,14,11,3
8,8,97,12,28,-16
8,8,98,16,15,1
8,8,99,14,24,-10
8,8,100,14,10,4
8,8,101,17,15,2
8,8,102,10,19,-9
8,8,103,13,24,-11
8,8,104,13,24,-11
8,8,105,21,20,1
8,8,106,23,16,7
8,8,107,19,15,4
8,8,108,3,8,-5
8,8,109,11,14,-3
8,8,110,14,24,-10
8,8,111,5,8,-3
8,8,112,13,17,-4
8,8,113,12,24,-12
8,8,114,14,18,-4
8,8,115,5,15,-10
8,8,116,29,42,-13
8,8,117,28,17,11
8,8,118,10,15,-5
8,8,119,14,19,-5
8,8,120,21,21,0
8,8,121,14,12,2
8,8,122,14,7,7
8,8,123,11,15,-4
8,8,124,16,17,-1
8,8,125,7,14,-7
8,8,126,9,6,3
8,8,127,15,15,0
8,8,128,14,21,-7
8,8,129,13,14,-1
8,8,130,19,14,5
8,8,131,27,22,5
8,8,132,15,13,2
8,8,133,12,16,-4
8,8,134,10,26,-16
8,8,135,19,16,3
8,8,136,15,12,3
8,8,137,14,12,2
8,8,138,11,10,1
8,8,139,16,19,-3
8,8,140,16,21,-5
8,8,141,5,8,-3
8,8,142,6,10,-4
8,8,143,11,19,-8
8,8,144,15,18,-3
8,8,145,23,12,11
8,8,146,12,20,-8
8,8,147,24,15,9
8,8,148,19,14,5
8,8,149,13,19,-6
8,8,150,7,10,-3
8,8,151,12,24,-12
8,8,152,7,12,-5
8,8,153,25,24,1
8,8,154,14,16,-2
8,8,155,18,16,2
8,8,156,9,10,-1
8,8,157,9,5,4
8,8,158,18,29,-11
8,8,159,18,8,10
8,8,160,20,21,-1
8,8,161,9,13,-4
8,8,162,10,13,-3
8,8,163,15,9,6
8,8,164,25,16,9
8,8,165,20,17,3
8,8,166,16,8,8
8,8,167,18,23,-5
8,8,168,9,9,0
8,8,169,29,35,-6
8,8,170,9,15,-6
8,8,171,12,16,-4
8,8,172,18,23,-5
8,8,173,24,23,1
8,8,174,6,11,-5
8,8,175,11,5,6
8,8,176,21,15,6
8,8,177,14,24,-10
8,8,178,14,25,-11
8,8,179,7,25,-18
8,8,180,11,18,-7
8,8,181,26,17,9
8,8,182,10,8,2
8,8,183,14,12,2
8,8,184,19,22,-3
8,8,185,19,11,8
8,8,186,30,22,8
8,8,187,16,36,-20
8,8,188,12,9,3
8,8,189,11,19,-8
8,8,190,2,10,-8
8,8,191,14,17,-3
8,8,192,10,11,-1
8,8,193,7,15,-8
8,8,194,14,11,3
8,8,195,17,19,-2
8,8,196,16,16,0
8,8,197,10,8,2
8,8,198,15,16,-1
8,8,199,9,33,-24
8,8,200,14,17,-3
8,8,201,18,8,10
8,8,202,16,10,6
8,8,203,10,11,-1
8,8,204,18,12,6
8,8,205,15,28,-13
8,8,206,7,15,-8
8,8,207,22,19,3
8,8,208,5,17,-12
8,8,209,18,16,2
8,8,210,17,21,-4
8,8,211,8,18,-10
8,8,212,9,16,-7
8,8,213,24,16,8
8,8,214,11,9,2
8,8,215,16,12,4
8,8,216,14,22,-8
8,8,217,11,20,-9
8,8,218,17,16,1
8,8,219,13,24,-11
8,8,220,11,12,-1
8,8,221,13,21,-8
8,8,222,11,13,-2
8,8,223,9,12,-3
8,8,224,14,26,-12
8,8,225,6,15,-9
8,8,226,8,22,-14
8,8,227,10,17,-7
8,8,228,13,28,-15
8,8,229,20,20,0
8,8,230,19,7,12
8,8,231,8,12,-4
8,8,232,12,17,-5
8,8,233,26,22,4
8,8,234,12,12,0
8,8,235,19,5,14
8,8,236,13,11,2
8,8,237,19,15,4
8,8,238,13,6,7
8,8,239,9,16,-7
8,8,240,11,14,-3
8,8,241,8,8,0
8,8,242,17,18,-1
8,8,243,15,19,-4
8,8,244,11,12,-1
8,8,245,22,12,10
8,8,246,15,18,-3
8,8,247,13,15,-2
8,8,248,12,12,0
8,8,249,9,10,-1
8,8,250,18,19,-1
8,8,251,15,18,-3
8,8,252,14,21,-7
8,8,253,9,7,2
8,8,254,17,22,-5
8,8,255,11,6,5
8,8,256,12,15,-3
8,8,257,22,23,-1
8,8,258,9,14,-5
8,8,259,17,15,2
8,8,260,11,22,-11
8,8,261,6,22,-16
8,8,262,16,10,6
8,8,263,16,24,-8
8,8,264,1,14,-13
8,8,265,11,12,-1
8,8,266,8,13,-5
8,8,267,15,15,0
8,8,268,10,18,-8
8,8,269,15,11,4
8,8,270,24,24,0
8,8,271,20,26,-6
8,8,272,12,11,1
8,8,273,12,12,0
8,8,274,14,22,-8
8,8,275,9,15,-6
8,8,276,14,20,-6
8,8,277,15,13,2
8,8,278,14,16,-2
8,8,279,15,8,7
8,8,280,17,19,-2
8,8,281,10,12,-2
8,8,282,15,10,5
8,8,283,9,6,3
8,8,284,18,16,2
8,8,285,13,18,-5
8,8,286,16,15,1
8,8,287,13,13,0
8,8,288,14,13,1
8,8,289,14,18,-4
8,8,290,23,14,9
8,8,291,15,18,-3
8,8,292,14,18,-4
8,8,293,27,23,4
8,8,294,21,14,7
8,8,295,15,22,-7
8,8,296,11,11,0
8,8,297,8,10,-2
8,8,298,20,19,1
8,8,299,16,28,-12
8,9,0,24,12,12
8,9,1,13,7,6
8,9,2,3,8,-5
8,9,3,12,9,3
8,9,4,33,22,11
8,9,5,20,20,0
8,9,6,10,13,-3
8,9,7,13,12,1
8,9,8,23,18,5
8,9,9,25,18,7
8,9,10,17,18,-1
8,9,11,16,9,7
8,9,12,20,22,-2
8,9,13,15,20,-5
8,9,14,26,23,3
8,9,15,21,12,9
8,9,16,16,24,-8
8,9,17,17,16,1
8,9,18,20,14,6
8,9,19,18,17,1
8,9,20,15,27,-12
8,9,21,18,9,9
8,9,22,10,19,-9
8,9,23,14,6,8
8,9,24,22,8,14
8,9,25,11,22,-11
8,9,26,6,6,0
8,9,27,18,14,4
8,9,28,27,22,5
8,9,29,23,17,6
8,9,30,16,23,-7
8,9,31,12,23,-11
8,9,32,6,10,-4
8,9,33,8,12,-4
8,9,34,17,15,2
8,9,35,16,18,-2
8,9,36,16,13,3
8,9,37,7,6,1
8,9,38,14,15,-1
8,9,39,14,20,-6
8,9,40,19,10,9
8,9,41,12,11,1
8,9,42,10,12,-2
8,9,43,17,12,5
8,9,44,11,14,-3
8,9,45,26,33,-7
8,9,46,13,17,-4
8,9,47,19,16,3
8,9,48,23,17,6
8,9,49,15,23,-8
8,9,50,20,20,0
8,9,51,11,10,1
8,9,52,10,12,-2
8,9,53,14,23,-9
8,9,54,18,14,4
8,9,55,18,22,-4
8,9,56,24,11,13
8,9,57,17,15,2
8,9,58,6,9,-3
8,9,59,21,23,-2
8,9,60,7,12,-5
8,9,61,8,6,2
8,9,62,19,7,12
8,9,63,12,10,2
8,9,64,10,16,-6
8,9,65,15,12,3
8,9,66,25,25,0
8,9,67,14,12,2
8,9,68,15,12,3
8,9,69,22,17,5
8,9,70,26,28,-2
8,9,71,14,17,-3
8,9,72,11,7,4
8,9,73,7,13,-6
8,9,74,15,17,-2
8,9,75,20,16,4
8,9,76,9,27,-18
8,9,77,14,24,-10
8,9,78,14,12,2
8,9,79,17,18,-1
8,9,80,12,15,-3
8,9,81,19,29,-10
8,9,82,11,10,1
8,9,83,17,5,12
8,9,84,10,7,3
8,9,85,8,17,-9
8,9,86,22,19,3
8,9,87,10,24,-14
8,9,88,12,6,6
8,9,89,11,12,-1
8,9,90,14,19,-5
8,9,91,14,12,2
8,9,92,11,11,0
8,9,93,11,10,1
8,9,94,13,13,0
8,9,95,11,4,7
8,9,96,8,16,-8
8,9,97,26,23,3
8,9,98,3,7,-4
8,9,99,13,26,-13
8,9,100,20,15,5
8,9,101,18,12,6
8,9,102,16,11,5
8,9,103,17,16,1
8,9,104,14,19,-5
8,9,105,18,28,-10
8,9,106,10,15,-5
8,9,107,19,10,9
8,9,108,15,30,-15
8,9,109,7,6,1
8,9,110,13,14,-1
8,9,111,17,11,6
8,9,112,8,16,-8
8,9,113,9,18,-9
8,9,114,11,16,-5
8,9,115,16,9,7
8,9,116,9,17,-8
8,9,117,12,18,-6
8,9,118,13,14,-1
8,9,119,30,16,14
8,9,120,19,11,8
8,9,121,10,23,-13
8,9,122,19,19,0
8,9,123,11,19,-8
8,9,124,18,22,-4
8,9,125,22,13,9
8,9,126,16,17,-1
8,9,127,13,19,-6
8,9,128,13,10,3
8,9,129,24,19,5
8,9,130,9,9,0
8,9,131,22,27,-5
8,9,132,20,11,9
8,9,133,14,14,0
8,9,134,14,22,-8
8,9,135,13,18,-5
8,9,136,14,11,3
8,9,137,10,17,-7
8,9,138,21,19,2
8,9,139,11,16,-5
8,9,140,18,20,-2
8,9,141,24,20,4
8,9,142,12,19,-7
8,9,143,13,14,-1
8,9,144,22,9,13
8,9,145,19,17,2
8,9,146,10,11,-1
8,9,147,13,13,0
8,9,148,13,15,-2
8,9,149,14,14,0
8,9,150,34,19,15
8,9,151,10,9,1
8,9,152,15,8,7
8,9,153,8,7,1
8,9,154,15,10,5
8,9,155,17,15,2
8,9,156,20,8,12
8,9,157,18,9,9
8,9,158,9,14,-5
8,9,159,16,12,4
8,9,160,18,9,9
8,9,161,6,15,-9
8,9,162,20,13,7
8,9,163,15,24,-9
8,9,164,14,14,0
8,9,165,28,12,16
8,9,166,13,16,-3
8,9,167,13,13,0
8,9,168,15,18,-3
8,9,169,14,10,4
8,9,170,12,28,-16
8,9,171,10,15,-5
8,9,172,17,18,-1
8,9,173,24,17,7
8,9,174,12,20,-8
8,9,175,28,13,15
8,9,176,10,13,-3
8,9,177,15,6,9
8,9,178,16,26,-10
8,9,179,16,14,2
8,9,180,16,10,6
8,9,181,18,20,-2
8,9,182,21,10,11
8,9,183,15,17,-2
8,9,184,23,20,3
8,9,185,20,14,6
8,9,186,17,13,4
8,9,187,18,33,-15
8,9,188,4,13,-9
8,9,189,16,10,6
8,9,190,31,21,10
8,9,191,22,18,4
8,9,192,21,14,7
8,9,193,10,3,7
8,9,194,19,19,0
8,9,195,25,16,9
8,9,196,11,13,-2
8,9,197,17,24,-7
8,9,198,11,15,-4
8,9,199,14,9,5
8,9,200,7,15,-8
8,9,201,17,12,5
8,9,202,8,14,-6
8,9,203,10,16,-6
8,9,204,13,13,0
8,9,205,25,20,5
8,9,206,9,10,-1
8,9,207,16,16,0
8,9,208,14,23,-9
8,9,209,4,9,-5
8,9,210,12,11,1
8,9,211,16,9,7
8,9,212,10,9,1
8,9,213,19,28,-9
8,9,214,18,32,-14
8,9,215,14,16,-2
8,9,216,16,23,-7
8,9,217,18,16,2
8,9,218,17,17,0
8,9,219,13,6,7
8,9,220,22,21,1
8,9,221,19,23,-4
8,9,222,14,10,4
8,9,223,21,23,-2
8,9,224,20,8,12
8,9,225,15,20,-5
8,9,226,21,20,1
8,9,227,8,15,-7
8,9,228,24,9,15
8,9,229,18,28,-10
8,9,230,24,24,0
8,9,231,16,11,5
8,9,232,9,16,-7
8,9,233,16,12,4
8,9,234,8,13,-5
8,9,235,15,25,-10
8,9,236,17,15,2
8,9,237,24,10,14
8,9,238,24,32,-8
8,9,239,17,12,5
8,9,240,17,5,12
8,9,241,25,15,10
8,9,242,9,10,-1
8,9,243,25,14,11
8,9,244,15,24,-9
8,9,245,27,26,1
8,9,246,7,16,-9
8,9,247,24,19,5
8,9,248,24,16,8
8,9,249,7,6,1
8,9,250,13,16,-3
8,9,251,8,20,-12
8,9,252,12,19,-7
8,9,253,6,19,-13
8,9,254,15,12,3
8,9,255,6,16,-10
8,9,256,8,23,-15
8,9,257,14,12,2
8,9,258,19,26,-7
8,9,259,8,19,-11
8,9,260,20,20,0
8,9,261,18,20,-2
8,9,262,8,10,-2
8,9,263,11,17,-6
8,9,264,19,8,11
8,9,265,22,13,9
8,9,266,13,16,-3
8,9,267,20,19,1
8,9,268,18,16,2
8,9,269,19,27,-8
8,9,270,10,14,-4
8,9,271,13,19,-6
8,9,272,10,7,3
8,9,273,13,26,-13
8,9,274,19,9,10
8,9,275,17,14,3
8,9,276,10,10,0
8,9,277,18,22,-4
8,9,278,11,7,4
8,9,279,19,10,9
8,9,280,7,11,-4
8,9,281,13,15,-2
8,9,282,6,12,-6
8,9,283,13,17,-4
8,9,284,25,20,5
8,9,285,13,12,1
8,9,286,13,13,0
8,9,287,14,13,1
8,9,288,18,13,5
8,9,289,27,15,12
8,9,290,19,21,-2
8,9,291,17,30,-13
8,9,292,15,22,-7
8,9,293,17,20,-3
8,9,294,9,17,-8
8,9,295,17,16,1
8,9,296,21,6,15
8,9,297,15,11,4
8,9,298,20,20,0
8,9,299,9,12,-3
8,10,0,15,14,1
8,10,1,10,23,-13
8,10,2,16,7,9
8,10,3,11,24,-13
8,10,4,14,4,10
8,10,5,11,21,-10
8,10,6,8,9,-1
8,10,7,12,9,3
8,10,8,17,17,0
8,10,9,9,6,3
8,10,10,14,12,2
8,10,11,19,25,-6
8,10,12,5,18,-13
8,10,13,26,16,10
8,10,14,48,18,30
8,10,15,12,12,0
8,10,16,20,32,-12
8,10,17,14,20,-6
8,10,18,14,15,-1
8,10,19,17,18,-1
8,10,20,5,6,-1
8,10,21,10,17,-7
8,10,22,4,15,-11
8,10,23,8,11,-3
8,10,24,16,11,5
8,10,25,18,28,-10
8,10,26,11,7,4
8,10,27,14,15,-1
8,10,28,27,9,18
8,10,29,9,29,-20
8,10,30,16,17,-1
8,10,31,11,7,4
8,10,32,10,14,-4
8,10,33,18,18,0
8,10,34,16,14,2
8,10,35,11,8,3
8,10,36,6,22,-16
8,10,37,29,18,11
8,10,38,11,23,-12
8,10,39,7,9,-2
8,10,40,16,14,2
8,10,41,22,15,7
8,10,42,21,26,-5
8,10,43,18,15,3
8,10,44,15,12,3
8,10,45,19,15,4
8,10,46,15,32,-17
8,10,47,13,10,3
8,10,48,16,18,-2
8,10,49,1,5,-4
8,10,50,14,17,-3
8,10,51,16,18,-2
8,10,52,12,23,-11
8,10,53,28,14,14
8,10,54,19,20,-1
8,10,55,18,13,5
8,10,56,5,7,-2
8,10,57,5,9,-4
8,10,58,21,12,9
8,10,59,12,6,6
8,10,60,15,20,-5
8,10,61,20,18,2
8,10,62,14,12,2
8,10,63,15,22,-7
8,10,64,13,12,1
8,10,65,24,29,-5
8,10,66,15,21,-6
8,10,67,11,11,0
8,10,68,18,22,-4
8,10,69,8,26,-18
8,10,70,11,12,-1
8,10,71,14,20,-6
8,10,72,22,12,10
8,10,73,10,9,1
8,10,74,17,9,8
8,10,75,10,8,2
8,10,76,7,10,-3
8,10,77,36,19,17
8,10,78,16,10,6
8,10,79,24,12,12
8,10,80,19,14,5
8,10,81,20,13,7
8,10,82,23,13,10
8,10,83,10,13,-3
8,10,84,10,11,-1
8,10,85,21,18,3
8,10,86,20,24,-4
8,10,87,23,22,1
8,10,88,17,7,10
8,10,89,17,12,5
8,10,90,12,9,3
8,10,91,24,31,-7
8,10,92,15,4,11
8,10,93,17,5,12
8,10,94,17,20,-3
8,10,95,12,8,4
8,10,96,10,14,-4
8,10,97,16,16,0
8,10,98,37,22,15
8,10,99,9,14,-5
8,10,100,21,17,4
8,10,101,18,11,7
8,10,102,20,11,9
8,10,103,13,9,4
8,10,104,12,17,-5
8,10,105,12,17,-5
8,10,106,8,3,5
8,10,107,19,20,-1
8,10,108,11,22,-11
8,10,109,22,8,14
8,10,110,18,10,8
8,10,111,13,23,-10
8,10,112,7,13,-6
8,10,113,12,24,-12
8,10,114,11,9,2
8,10,115,18,18,0
8,10,116,20,15,5
8,10,117,22,6,16
8,10,118,17,22,-5
8,10,119,22,22,0
8,10,120,18,19,-1
8,10,121,13,6,7
8,10,122,14,13,1
8,10,123,8,2,6
8,10,124,19,28,-9
8,10,125,30,20,10
8,10,126,24,17,7
8,10,127,9,6,3
8,10,128,19,23,-4
8,10,129,12,24,-12
8,10,130,8,7,1
8,10,131,6,6,0
8,10,132,13,22,-9
8,10,133,14,17,-3
8,10,134,8,11,-3
8,10,135,15,6,9
8,10,136,13,16,-3
8,10,137,9,7,2
8,10,138,7,20,-13
8,10,139,18,14,4
8,10,140,28,9,19
8,10,141,13,11,2
8,10,142,15,7,8
8,10,143,8,20,-12
8,10,144,21,13,8
8,10,145,15,30,-15
8,10,146,7,9,-2
8,10,147,19,12,7
8,10,148,11,16,-5
8,10,149,10,13,-3
8,10,150,9,18,-9
8,10,151,15,19,-4
8,10,152,11,15,-4
8,10,153,15,8,7
8,10,154,14,11,3
8,10,155,10,28,-18
8,10,156,14,15,-1
8,10,157,14,16,-2
8,10,158,8,13,-5
8,10,159,12,6,6
8,10,160,5,7,-2
8,10,161,10,15,-5
8,10,162,12,20,-8
8,10,163,20,20,0
8,10,164,18,9,9
8,10,165,20,15,5
8,10,166,13,10,3
8,10,167,8,10,-2
8,10,168,12,13,-1
8,10,169,16,13,3
8,10,170,13,24,-11
8,10,171,9,11,-2
8,10,172,18,13,5
8,10,173,11,11,0
8,10,174,19,23,-4
8,10,175,16,19,-3
8,10,176,2,10,-8
8,10,177,28,23,5
8,10,178,18,18,0
8,10,179,16,14,2
8,10,180,16,17,-1
8,10,181,10,11,-1
8,10,182,25,17,8
8,10,183,21,15,6
8,10,184,15,18,-3
8,10,185,15,19,-4
8,10,186,21,11,10
8,10,187,24,34,-10
8,10,188,12,6,6
8,10,189,9,18,-9
8,10,190,13,9,4
8,10,191,16,23,-7
8,10,192,23,21,2
8,10,193,21,24,-3
8,10,194,24,23,1
8,10,195,14,12,2
8,10,196,19,15,4
8,10,197,14,23,-9
8,10,198,13,16,-3
8,10,199,12,12,0
8,10,200,7,8,-1
8,10,201,6,5,1
8,10,202,8,8,0
8,10,203,6,16,-10
8,10,204,15,22,-7
8,10,205,9,21,-12
8,10,206,9,12,-3
8,10,207,22,21,1
8,10,208,14,22,-8
8,10,209,20,10,10
8,10,210,18,17,1
8,10,211,9,14,-5
8,10,212,17,16,1
8,10,213,13,14,-1
8,10,214,13,10,3
8,10,215,13,10,3
8,10,216,11,8,3
8,10,217,11,13,-2
8,10,218,24,14,10
8,10,219,10,13,-3
8,10,220,7,11,-4
8,10,221,15,16,-1
8,10,222,16,16,0
8,10,223,17,20,-3
8,10,224,24,20,4
8,10,225,11,28,-17
8,10,226,9,16,-7
8,10,227,19,8,11
8,10,228,24,21,3
8,10,229,8,12,-4
8,10,230,10,28,-18
8,10,231,25,23,2
8,10,232,15,15,0
8,10,233,15,17,-2
8,10,234,12,19,-7
8,10,235,10,14,-4
8,10,236,11,14,-3
8,10,237,12,26,-14
8,10,238,15,28,-13
8,10,239,15,28,-13
8,10,240,14,14,0
8,10,241,16,6,10
8,10,242,16,26,-10
8,10,243,10,9,1
8,10,244,22,13,9
8,10,245,21,18,3
8,10,246,9,9,0
8,10,247,11,24,-13
8,10,248,12,15,-3
8,10,249,16,18,-2
8,10,250,9,17,-8
8,10,251,10,10,0
8,10,252,11,10,1
8,10,253,10,14,-4
8,10,254,11,13,-2
8,10,255,18,21,-3
8,10,256,14,15,-1
8,10,257,16,11,5
8,10,258,14,18,-4
8,10,259,9,26,-17
8,10,260,13,15,-2
8,10,261,7,14,-7
8,10,262,9,19,-10
8,10,263,9,2,7
8,10,264,16,11,5
8,10,265,10,10,0
8,10,266,11,11,0
8,10,267,33,16,17
8,10,268,12,14,-2
8,10,269,14,12,2
8,10,270,21,13,8
8,10,271,26,26,0
8,10,272,11,11,0
8,10,273,13,18,-5
8,10,274,15,16,-1
8,10,275,22,16,6
8,10,276,12,13,-1
8,10,277,12,15,-3
8,10,278,9,10,-1
8,10,279,13,10,3
8,10,280,9,14,-5
8,10,281,13,12,1
8,10,282,20,19,1
8,10,283,5,16,-11
8,10,284,9,18,-9
8,10,285,15,16,-1
8,10,286,12,25,-13
8,10,287,10,13,-3
8,10,288,23,15,8
8,10,289,12,11,1
8,10,290,14,14,0
8,10,291,13,12,1
8,10,292,27,14,13
8,10,293,13,18,-5
8,10,294,16,16,0
8,10,295,17,7,10
8,10,296,10,15,-5
8,10,297,24,13,11
8,10,298,7,11,-4
8,10,299,13,25,-12
8,11,0,6,10,-4
8,11,1,13,11,2
8,11,2,27,24,3
8,11,3,15,23,-8
8,11,4,8,8,0
8,11,5,26,21,5
8,11,6,13,23,-10
8,11,7,16,19,-3
8,11,8,19,9,10
8,11,9,14,17,-3
8,11,10,13,17,-4
8,11,11,19,13,6
8,11,12,8,10,-2
8,11,13,2,6,-4
8,11,14,17,4,13
8,11,15,32,10,22
8,11,16,11,8,3
8,11,17,19,14,5
8,11,18,12,10,2
8,11,19,22,18,4
8,11,20,8,4,4
8,11,21,16,11,5
8,11,22,20,15,5
8,11,23,23,34,-11
8,11,24,8,13,-5
8,11,25,9,16,-7
8,11,26,18,27,-9
8,11,27,10,14,-4
8,11,28,5,11,-6
8,11,29,12,12,0
8,11,30,19,11,8
8,11,31,16,12,4
8,11,32,13,14,-1
8,11,33,24,26,-2
8,11,34,24,10,14
8,11,35,4,9,-5
8,11,36,17,18,-1
8,11,37,9,16,-7
8,11,38,15,12,3
8,11,39,9,5,4
8,11,40,10,6,4
8,11,41,17,15,2
8,11,42,7,12,-5
8,11,43,24,9,15
8,11,44,27,18,9
8,11,45,11,12,-1
8,11,46,18,16,2
8,11,47,15,21,-6
8,11,48,18,28,-10
8,11,49,19,31,-12
8,11,50,15,13,2
8,11,51,32,23,9
8,11,52,11,7,4
8,11,53,16,13,3
8,11,54,15,8,7
8,11,55,19,18,1
8,11,56,21,22,-1
8,11,57,20,29,-9
8,11,58,10,15,-5
8,11,59,25,15,10
8,11,60,19,22,-3
8,11,61,12,10,2
8,11,62,28,15,13
8,11,63,12,13,-1
8,11,64,1,11,-10
8,11,65,14,15,-1
8,11,66,15,19,-4
8,11,67,9,18,-9
8,11,68,12,15,-3
8,11,69,23,17,6
8,11,70,8,14,-6
8,11,71,14,25,-11
8,11,72,20,24,-4
8,11,73,19,16,3
8,11,74,27,28,-1
8,11,75,13,15,-2
8,11,76,24,25,-1
8,11,77,8,8,0
8,11,78,17,12,5
8,11,79,8,9,-1
8,11,80,20,14,6
8,11,81,24,12,12
8,11,82,17,12,5
8,11,83,15,23,-8
8,11,84,15,11,4
8,11,85,16,8,8
8,11,86,12,15,-3
8,11,87,17,29,-12
8,11,88,10,19,-9
8,11,89,7,15,-8
8,11,90,7,16,-9
8,11,91,9,13,-4
8,11,92,19,12,7
8,11,93,8,15,-7
8,11,94,10,8,2
8,11,95,4,7,-3
8,11,96,22,18,4
8,11,97,8,15,-7
8,11,98,12,14,-2
8,11,99,9,24,-15
8,11,100,25,17,8
8,11,101,14,9,5
8,11,102,20,15,5
8,11,103,7,19,-12
8,11,104,9,9,0
8,11,105,13,13,0
8,11,106,19,25,-6
8,11,107,24,12,12
8,11,108,18,18,0
8,11,109,21,15,6
8,11,110,10,15,-5
8,11,111,14,17,-3
8,11,112,27,21,6
8,11,113,11,21,-10
8,11,114,33,17,16
8,11,115,9,12,-3
8,11,116,11,19,-8
8,11,117,8,9,-1
8,11,118,10,18,-8
8,11,119,21,11,10
8,11,120,21,20,1
8,11,121,15,10,5
8,11,122,15,13,2
8,11,123,9,11,-2
8,11,124,14,25,-11
8,11,125,21,18,3
8,11,126,10,11,-1
8,11,127,16,13,3
8,11,128,18,21,-3
8,11,129,9,20,-11
8,11,130,10,15,-5
8,11,131,9,27,-18
8,11,132,19,26,-7
8,11,133,11,17,-6
8,11,134,13,14,-1
8,11,135,23,13,10
8,11,136,7,18,-11
8,11,137,18,20,-2
8,11,138,11,18,-7
8,11,139,8,9,-1
8,11,140,14,13,1
8,11,141,11,17,-6
8,11,142,1,12,-11
8,11,143,12,13,-1
8,11,144,14,3,11
8,11,145,18,18,0
8,11,146,16,28,-12
8,11,147,25,17,8
8,11,148,35,17,18
8,11,149,29,11,18
8,11,150,22,16,6
8,11,151,28,27,1
8,11,152,3,7,-4
8,11,153,16,13,3
8,11,154,9,7,2
8,11,155,11,13,-2
8,11,156,15,16,-1
8,11,157,19,7,12
8,11,158,23,14,9
8,11,159,7,12,-5
8,11,160,29,22,7
8,11,161,19,11,8
8,11,162,26,9,17
8,11,163,24,15,9
8,11,164,8,20,-12
8,11,165,13,15,-2
8,11,166,20,11,9
8,11,167,14,9,5
8,11,168,21,8,13
8,11,169,10,11,-1
8,11,170,20,15,5
8,11,171,19,18,1
8,11,172,24,35,-11
8,11,173,11,5,6
8,11,174,16,7,9
8,11,175,20,9,11
8,11,176,18,42,-24
8,11,177,7,12,-5
8,11,178,10,12,-2
8,11,179,15,16,-1
8,11,180,19,9,10
8,11,181,14,23,-9
8,11,182,9,5,4
8,11,183,11,12,-1
8,11,184,18,14,4
8,11,185,13,8,5
8,11,186,12,8,4
8,11,187,21,7,14
8,11,188,15,15,0
8,11,189,14,16,-2
8,11,190,7,8,-1
8,11,191,13,7,6
8,11,192,10,12,-2
8,11,193,12,22,-10
8,11,194,14,24,-10
8,11,195,12,8,4
8,11,196,17,15,2
8,11,197,16,15,1
8,11,198,21,9,12
8,11,199,23,21,2
8,11,200,10,10,0
8,11,201,17,24,-7
8,11,202,11,15,-4
8,11,203,11,11,0
8,11,204,14,0,14
8,11,205,16,18,-2
8,11,206,19,20,-1
8,11,207,10,13,-3
8,11,208,12,18,-6
8,11,209,20,16,4
8,11,210,16,21,-5
8,11,211,15,19,-4
8,11,212,12,10,2
8,11,213,18,10,8
8,11,214,17,7,10
8,11,215,13,16,-3
8,11,216,11,13,-2
8,11,217,8,16,-8
8,11,218,14,18,-4
8,11,219,3,12,-9
8,11,220,11,22,-11
8,11,221,9,12,-3
8,11,222,18,12,6
8,11,223,14,12,2
8,11,224,24,21,3
8,11,225,14,11,3
8,11,226,10,17,-7
8,11,227,15,24,-9
8,11,228,35,20,15
8,11,229,13,11,2
8,11,230,12,13,-1
8,11,231,15,12,3
8,11,232,17,17,0
8,11,233,17,12,5
8,11,234,19,13,6
8,11,235,11,14,-3
8,11,236,19,12,7
8,11,237,22,14,8
8,11,238,11,15,-4
8,11,239,21,15,6
8,11,240,11,13,-2
8,11,241,8,9,-1
8,11,242,19,25,-6
8,11,243,18,11,7
8,11,244,19,13,6
8,11,245,23,18,5
8,11,246,17,10,7
8,11,247,19,15,4
8,11,248,13,14,-1
8,11,249,17,18,-1
8,11,250,19,12,7
8,11,251,21,15,6
8,11,252,12,8,4
8,11,253,6,21,-15
8,11,254,16,7,9
8,11,255,7,12,-5
8,11,256,14,13,1
8,11,257,23,24,-1
8,11,258,23,7,16
8,11,259,17,12,5
8,11,260,10,10,0
8,11,261,19,20,-1
8,11,262,16,7,9
8,11,263,21,14,7
8,11,264,9,6,3
8,11,265,19,6,13
8,11,266,9,6,3
8,11,267,12,16,-4
8,11,268,16,9,7
8,11,269,26,34,-8
8,11,270,9,12,-3
8,11,271,10,2,8
8,11,272,13,11,2
8,11,273,22,17,5
8,11,274,15,19,-4
8,11,275,17,26,-9
8,11,276,16,19,-3
8,11,277,29,15,14
8,11,278,15,4,11
8,11,279,17,22,-5
8,11,280,16,7,9
8,11,281,13,16,-3
8,11,282,17,18,-1
8,11,283,15,9,6
8,11,284,11,9,2
8,11,285,20,18,2
8,11,286,8,4,4
8,11,287,21,13,8
8,11,288,15,8,7
8,11,289,11,14,-3
8,11,290,8,10,-2
8,11,291,1,10,-9
8,11,292,13,16,-3
8,11,293,15,15,0
8,11,294,18,11,7
8,11,295,8,10,-2
8,11,296,26,9,17
8,11,297,12,18,-6
8,11,298,10,7,3
8,11,299,18,9,9
8,12,0,14,11,3
8,12,1,20,11,9
8,12,2,14,8,6
8,12,3,12,12,0
8,12,4,16,14,2
8,12,5,8,7,1
8,12,6,23,12,11
8,12,7,6,17,-11
8,12,8,7,10,-3
8,12,9,21,7,14
8,12,10,15,12,3
8,12,11,18,14,4
8,12,12,10,6,4
8,12,13,30,17,13
8,12,14,16,18,-2
8,12,15,17,10,7
8,12,16,18,24,-6
8,12,17,15,9,6
8,12,18,25,8,17
8,12,19,13,4,9
8,12,20,12,15,-3
8,12,21,36,18,18
8,12,22,18,16,2
8,12,23,21,14,7
8,12,24,4,4,0
8,12,25,21,11,10
8,12,26,16,13,3
8,12,27,18,11,7
8,12,28,15,9,6
8,12,29,10,22,-12
8,12,30,20,10,10
8,12,31,22,11,11
8,12,32,18,16,2
8,12,33,20,6,14
8,12,34,11,12,-1
8,12,35,19,10,9
8,12,36,13,15,-2
8,12,37,20,22,-2
8,12,38,19,8,11
8,12,39,20,15,5
8,12,40,23,11,12
8,12,41,16,13,3
8,12,42,8,10,-2
8,12,43,18,11,7
8,12,44,9,9,0
8,12,45,20,11,9
8,12,46,10,6,4
8,12,47,11,10,1
8,12,48,21,13,8
8,12,49,13,10,3
8,12,50,12,21,-9
8,12,51,19,21,-2
8,12,52,21,15,6
8,12,53,14,22,-8
8,12,54,18,16,2
8,12,55,4,8,-4
8,12,56,16,11,5
8,12,57,20,17,3
8,12,58,11,8,3
8,12,59,7,13,-6
8,12,60,11,14,-3
8,12,61,19,16,3
8,12,62,21,25,-4
8,12,63,12,20,-8
8,12,64,9,17,-8
8,12,65,20,4,16
8,12,66,16,13,3
8,12,67,12,10,2
8,12,68,21,16,5
8,12,69,33,26,7
8,12,70,9,18,-9
8,12,71,14,2,12
8,12,72,25,12,13
8,12,73,15,22,-7
8,12,74,15,13,2
8,12,75,9,1,8
8,12,76,15,11,4
8,12,77,16,8,8
8,12,78,20,23,-3
8,12,79,32,11,21
8,12,80,10,12,-2
8,12,81,15,7,8
8,12,82,16,15,1
8,12,83,12,12,0
8,12,84,8,5,3
8,12,85,16,14,2
8,12,86,11,4,7
8,12,87,31,32,-1
8,12,88,21,25,-4
8,12,89,32,14,18
8,12,90,17,16,1
8,12,91,16,21,-5
8,12,92,18,7,11
8,12,93,9,15,-6
8,12,94,14,4,10
8,12,95,18,20,-2
8,12,96,13,15,-2
8,12,97,32,18,14
8,12,98,18,7,11
8,12,99,7,4,3
8,12,100,18,26,-8
8,12,101,21,13,8
8,12,102,21,16,5
8,12,103,31,18,13
8,12,104,13,22,-9
8,12,105,17,18,-1
8,12,106,13,12,1
8,12,107,10,12,-2
8,12,108,20,17,3
8,12,109,20,12,8
8,12,110,27,37,-10
8,12,111,16,22,-6
8,12,112,19,22,-3
8,12,113,17,5,12
8,12,114,18,24,-6
8,12,115,18,18,0
8,12,116,21,17,4
8,12,117,8,13,-5
8,12,118,11,18,-7
8,12,119,9,10,-1
8,12,120,31,16,15
8,12,121,16,6,10
8,12,122,7,6,1
8,12,123,16,21,-5
8,12,124,27,18,9
8,12,125,11,9,2
8,12,126,14,20,-6
8,12,127,13,21,-8
8,12,128,10,7,3
8,12,129,16,17,-1
8,12,130,20,20,0
8,12,131,18,19,-1
8,12,132,15,15,0
8,12,133,14,18,-4
8,12,134,19,9,10
8,12,135,8,14,-6
8,12,136,18,20,-2
8,12,137,22,20,2
8,12,138,20,13,7
8,12,139,9,8,1
8,12,140,8,6,2
8,12,141,16,32,-16
8,12,142,16,12,4
8,12,143,11,14,-3
8,12,144,26,13,13
8,12,145,14,24,-10
8,12,146,17,16,1
8,12,147,6,12,-6
8,12,148,21,19,2
8,12,149,23,14,9
8,12,150,26,21,5
8,12,151,14,7,7
8,12,152,14,19,-5
8,12,153,10,11,-1
8,12,154,14,26,-12
8,12,155,21,16,5
8,12,156,16,19,-3
8,12,157,17,14,3
8,12,158,18,19,-1
8,12,159,12,14,-2
8,12,160,23,27,-4
8,12,161,15,12,3
8,12,162,13,4,9
8,12,163,20,16,4
8,12,164,28,25,3
8,12,165,14,15,-1
8,12,166,7,28,-21
8,12,167,9,18,-9
8,12,168,3,6,-3
8,12,169,26,19,7
8,12,170,13,31,-18
8,12,171,14,21,-7
8,12,172,26,17,9
8,12,173,11,16,-5
8,12,174,20,18,2
8,12,175,24,12,12
8,12,176,21,16,5
8,12,177,14,13,1
8,12,178,17,15,2
8,12,179,14,11,3
8,12,180,13,12,1
8,12,181,13,11,2
8,12,182,20,19,1
8,12,183,36,14,22
8,12,184,16,17,-1
8,12,185,4,15,-11
8,12,186,15,12,3
8,12,187,20,17,3
8,12,188,4,13,-9
8,12,189,11,5,6
8,12,190,4,8,-4
8,12,191,17,6,11
8,12,192,15,28,-13
8,12,193,12,10,2
8,12,194,9,11,-2
8,12,195,10,14,-4
8,12,196,8,12,-4
8,12,197,10,16,-6
8,12,198,17,12,5
8,12,199,10,17,-7
8,12,200,20,24,-4
8,12,201,13,6,7
8,12,202,8,10,-2
8,12,203,16,7,9
8,12,204,8,14,-6
8,12,205,22,30,-8
8,12,206,28,24,4
8,12,207,7,7,0
8,12,208,19,10,9
8,12,209,18,14,4
8,12,210,24,23,1
8,12,211,25,11,14
8,12,212,10,16,-6
8,12,213,31,22,9
8,12,214,15,14,1
8,12,215,7,11,-4
8,12,216,29,14,15
8,12,217,18,16,2
8,12,218,14,17,-3
8,12,219,13,13,0
8,12,220,24,12,12
8,12,221,17,11,6
8,12,222,19,5,14
8,12,223,15,10,5
8,12,224,21,22,-1
8,12,225,20,20,0
8,12,226,23,22,1
8,12,227,19,14,5
8,12,228,11,11,0
8,12,229,8,14,-6
8,12,230,20,21,-1
8,12,231,14,9,5
8,12,232,12,8,4
8,12,233,20,31,-11
8,12,234,14,23,-9
8,12,235,15,6,9
8,12,236,23,24,-1
8,12,237,20,8,12
8,12,238,22,20,2
8,12,239,10,16,-6
8,12,240,18,8,10
8,12,241,9,11,-2
8,12,242,12,11,1
8,12,243,17,23,-6
8,12,244,20,16,4
8,12,245,11,17,-6
8,12,246,19,15,4
8,12,247,36,19,17
8,12,248,13,11,2
8,12,249,14,17,-3
8,12,250,22,15,7
8,12,251,23,18,5
8,12,252,14,18,-4
8,12,253,17,11,6
8,12,254,9,15,-6
8,12,255,8,7,1
8,12,256,15,15,0
8,12,257,14,11,3
8,12,258,18,16,2
8,12,259,9,8,1
8,12,260,19,15,4
8,12,261,15,4,11
8,12,262,26,5,21
8,12,263,14,15,-1
8,12,264,9,15,-6
8,12,265,16,18,-2
8,12,266,14,8,6
8,12,267,17,16,1
8,12,268,23,11,12
8,12,269,15,19,-4
8,12,270,26,19,7
8,12,271,17,16,1
8,12,272,16,15,1
8,12,273,16,17,-1
8,12,274,7,9,-2
8,12,275,15,16,-1
8,12,276,18,15,3
8,12,277,16,23,-7
8,12,278,10,18,-8
8,12,279,20,15,5
8,12,280,12,15,-3
8,12,281,11,23,-12
8,12,282,18,8,10
8,12,283,25,10,15
8,12,284,11,14,-3
8,12,285,8,7,1
8,12,286,16,25,-9
8,12,287,10,16,-6
8,12,288,13,18,-5
8,12,289,25,16,9
8,12,290,15,18,-3
8,12,291,20,13,7
8,12,292,18,19,-1
8,12,293,20,35,-15
8,12,294,16,13,3
8,12,295,17,7,10
8,12,296,15,22,-7
8,12,297,15,11,4
8,12,298,11,15,-4
8,12,299,15,13,2
8,13,0,13,17,-4
8,13,1,25,8,17
8,13,2,17,15,2
8,13,3,18,18,0
8,13,4,31,18,13
8,13,5,18,13,5
8,13,6,23,8,15
8,13,7,8,9,-1
8,13,8,13,11,2
8,13,9,15,25,-10
8,13,10,16,15,1
8,13,11,26,13,13
8,13,12,7,12,-5
8,13,13,11,22,-11
8,13,14,21,6,15
8,13,15,14,8,6
8,13,16,13,18,-5
8,13,17,9,32,-23
8,13,18,16,13,3
8,13,19,16,20,-4
8,13,20,11,11,0
8,13,21,18,9,9
8,13,22,12,14,-2
8,13,23,15,11,4
8,13,24,23,15,8
8,13,25,12,14,-2
8,13,26,10,15,-5
8,13,27,16,15,1
8,13,28,14,10,4
8,13,29,15,15,0
8,13,30,15,12,3
8,13,31,15,8,7
8,13,32,12,15,-3
8,13,33,10,10,0
8,13,34,14,15,-1
8,13,35,19,9,10
8,13,36,4,13,-9
8,13,37,17,14,3
8,13,38,15,9,6
8,13,39,31,37,-6
8,13,40,20,13,7
8,13,41,19,11,8
8,13,42,19,8,11
8,13,43,13,14,-1
8,13,44,31,13,18
8,13,45,24,12,12
8,13,46,19,9,10
8,13,47,13,9,4
8,13,48,15,18,-3
8,13,49,12,19,-7
8,13,50,12,14,-2
8,13,51,8,26,-18
8,13,52,11,10,1
8,13,53,18,16,2
8,13,54,24,13,11
8,13,55,35,25,10
8,13,56,10,18,-8
8,13,57,21,22,-1
8,13,58,13,18,-5
8,13,59,26,17,9
8,13,60,20,8,12
8,13,61,11,23,-12
8,13,62,27,12,15
8,13,63,16,13,3
8,13,64,8,16,-8
8,13,65,10,5,5
8,13,66,20,18,2
8,13,67,13,14,-1
8,13,68,13,18,-5
8,13,69,14,17,-3
8,13,70,22,10,12
8,13,71,9,10,-1
8,13,72,24,10,14
8,13,73,12,14,-2
8,13,74,18,23,-5
8,13,75,13,17,-4
8,13,76,21,12,9
8,13,77,24,18,6
8,13,78,16,14,2
8,13,79,11,6,5
8,13,80,15,5,10
8,13,81,14,22,-8
8,13,82,11,18,-7
8,13,83,9,7,2
8,13,84,18,19,-1
8,13,85,19,17,2
8,13,86,12,10,2
8,13,87,22,14,8
8,13,88,5,7,-2
8,13,89,17,8,9
8,13,90,6,16,-10
8,13,91,8,6,2
8,13,92,9,14,-5
8,13,93,10,12,-2
8,13,94,27,6,21
8,13,95,11,10,1
8,13,96,21,18,3
8,13,97,11,20,-9
8,13,98,12,23,-11
8,13,99,29,24,5
8,13,100,27,22,5
8,13,101,11,11,0
8,13,102,7,25,-18
8,13,103,21,9,12
8,13,104,19,7,12
8,13,105,12,11,1
8,13,106,25,13,12
8,13,107,21,10,11
8,13,108,10,9,1
8,13,109,28,20,8
8,13,110,19,6,13
8,13,111,13,19,-6
8,13,112,23,17,6
8,13,113,14,14,0
8,13,114,20,11,9
8,13,115,17,15,2
8,13,116,16,8,8
8,13,117,16,16,0
8,13,118,10,10,0
8,13,119,21,20,1
8,13,120,10,10,0
8,13,121,12,10,2
8,13,122,19,6,13
8,13,123,16,19,-3
8,13,124,16,25,-9
8,13,125,17,7,10
8,13,126,18,11,7
8,13,127,17,11,6
8,13,128,25,17,8
8,13,129,26,11,15
8,13,130,10,5,5
8,13,131,10,11,-1
8,13,132,35,26,9
8,13,133,16,8,8
8,13,134,7,12,-5
8,13,135,19,16,3
8,13,136,14,20,-6
8,13,137,12,3,9
8,13,138,20,13,7
8,13,139,27,20,7
8,13,140,19,9,10
8,13,141,11,9,2
8,13,142,20,22,-2
8,13,143,13,15,-2
8,13,144,6,10,-4
8,13,145,13,23,-10
8,13,146,15,16,-1
8,13,147,16,18,-2
8,13,148,40,17,23
8,13,149,21,21,0
8,13,150,7,10,-3
8,13,151,9,13,-4
8,13,152,15,11,4
8,13,153,21,21,0
8,13,154,33,16,17
8,13,155,8,20,-12
8,13,156,15,19,-4
8,13,157,5,14,-9
8,13,158,17,13,4
8,13,159,28,19,9
8,13,160,14,9,5
8,13,161,7,12,-5
8,13,162,11,11,0
8,13,163,7,5,2
8,13,164,19,19,0
8,13,165,33,9,24
8,13,166,11,14,-3
8,13,167,15,5,10
8,13,168,25,11,14
8,13,169,9,19,-10
8,13,170,15,24,-9
8,13,171,10,24,-14
8,13,172,17,15,2
8,13,173,12,19,-7
8,13,174,15,14,1
8,13,175,25,16,9
8,13,176,3,8,-5
8,13,177,19,15,4
8,13,178,9,10,-1
8,13,179,15,15,0
8,13,180,28,20,8
8,13,181,12,21,-9
8,13,182,18,19,-1
8,13,183,3,14,-11
8,13,184,30,16,14
8,13,185,12,23,-11
8,13,186,17,12,5
8,13,187,13,10,3
8,13,188,21,15,6
8,13,189,5,16,-11
8,13,190,16,10,6
8,13,191,18,12,6
8,13,192,23,29,-6
8,13,193,16,13,3
8,13,194,13,18,-5
8,13,195,15,8,7
8,13,196,27,17,10
8,13,197,17,9,8
8,13,198,18,10,8
8,13,199,5,13,-8
8,13,200,9,6,3
8,13,201,18,15,3
8,13,202,6,19,-13
8,13,203,24,14,10
8,13,204,19,17,2
8,13,205,14,14,0
8,13,206,20,16,4
8,13,207,21,22,-1
8,13,208,21,14,7
8,13,209,12,16,-4
8,13,210,21,11,10
8,13,211,18,14,4
8,13,212,12,9,3
8,13,213,12,18,-6
8,13,214,24,16,8
8,13,215,31,14,17
8,13,216,22,17,5
8,13,217,22,7,15
8,13,218,14,24,-10
8,13,219,26,17,9
8,13,220,25,16,9
8,13,221,25,21,4
8,13,222,17,16,1
8,13,223,13,16,-3
8,13,224,18,17,1
8,13,225,8,10,-2
8,13,226,28,23,5
8,13,227,26,18,8
8,13,228,14,13,1
8,13,229,18,18,0
8,13,230,15,15,0
8,13,231,10,8,2
8,13,232,28,13,15
8,13,233,10,9,1
8,13,234,19,15,4
8,13,235,6,7,-1
8,13,236,24,10,14
8,13,237,9,16,-7
8,13,238,19,11,8
8,13,239,31,15,16
8,13,240,15,19,-4
8,13,241,24,23,1
8,13,242,18,17,1
8,13,243,17,9,8
8,13,244,11,13,-2
8,13,245,26,31,-5
8,13,246,13,13,0
8,13,247,9,9,0
8,13,248,24,14,10
8,13,249,20,14,6
8,13,250,10,16,-6
8,13,251,28,18,10
8,13,252,8,16,-8
8,13,253,9,6,3
8,13,254,20,18,2
8,13,255,11,12,-1
8,13,256,10,10,0
8,13,257,23,20,3
8,13,258,26,14,12
8,13,259,25,21,4
8,13,260,22,12,10
8,13,261,3,7,-4
8,13,262,4,5,-1
8,13,263,9,15,-6
8,13,264,25,11,14
8,13,265,18,12,6
8,13,266,21,18,3
8,13,267,20,9,11
8,13,268,14,12,2
8,13,269,20,14,6
8,13,270,23,14,9
8,13,271,10,17,-7
8,13,272,10,15,-5
8,13,273,19,14,5
8,13,274,16,9,7
8,13,275,14,13,1
8,13,276,13,18,-5
8,13,277,20,24,-4
8,13,278,26,22,4
8,13,279,20,13,7
8,13,280,13,7,6
8,13,281,21,15,6
8,13,282,20,19,1
8,13,283,14,9,5
8,13,284,18,14,4
8,13,285,21,22,-1
8,13,286,34,20,14
8,13,287,33,9,24
8,13,288,12,17,-5
8,13,289,18,19,-1
8,13,290,17,22,-5
8,13,291,15,17,-2
8,13,292,23,19,4
8,13,293,22,11,11
8,13,294,12,24,-12
8,13,295,7,13,-6
8,13,296,12,29,-17
8,13,297,9,19,-10
8,13,298,14,13,1
8,13,299,15,17,-2
8,14,0,21,13,8
8,14,1,23,18,5
8,14,2,9,13,-4
8,14,3,23,17,6
8,14,4,23,25,-2
8,14,5,13,11,2
8,14,6,24,10,14
8,14,7,11,8,3
8,14,8,18,19,-1
8,14,9,20,20,0
8,14,10,12,26,-14
8,14,11,13,10,3
8,14,12,16,11,5
8,14,13,8,10,-2
8,14,14,22,20,2
8,14,15,17,26,-9
8,14,16,8,15,-7
8,14,17,17,7,10
8,14,18,14,5,9
8,14,19,12,13,-1
8,14,20,17,14,3
8,14,21,13,9,4
8,14,22,19,22,-3
8,14,23,11,15,-4
8,14,24,18,15,3
8,14,25,18,14,4
8,14,26,18,15,3
8,14,27,9,17,-8
8,14,28,17,14,3
8,14,29,26,11,15
8,14,30,3,5,-2
8,14,31,18,19,-1
8,14,32,25,8,17
8,14,33,15,16,-1
8,14,34,14,11,3
8,14,35,13,17,-4
8,14,36,8,16,-8
8,14,37,14,8,6
8,14,38,16,9,7
8,14,39,10,13,-3
8,14,40,13,7,6
8,14,41,14,15,-1
8,14,42,20,17,3
8,14,43,20,15,5
8,14,44,11,10,1
8,14,45,18,21,-3
8,14,46,20,9,11
8,14,47,36,17,19
8,14,48,19,12,7
8,14,49,13,12,1
8,14,50,3,9,-6
8,14,51,24,15,9
8,14,52,4,5,-1
8,14,53,15,16,-1
8,14,54,37,19,18
8,14,55,9,23,-14
8,14,56,19,15,4
8,14,57,7,24,-17
8,14,58,12,16,-4
8,14,59,15,16,-1
8,14,60,25,14,11
8,14,61,17,14,3
8,14,62,20,12,8
8,14,63,9,9,0
8,14,64,8,13,-5
8,14,65,19,14,5
8,14,66,15,11,4
8,14,67,20,18,2
8,14,68,10,14,-4
8,14,69,11,15,-4
8,14,70,20,11,9
8,14,71,18,8,10
8,14,72,18,9,9
8,14,73,16,13,3
8,14,74,15,16,-1
8,14,75,12,21,-9
8,14,76,13,9,4
8,14,77,27,19,8
8,14,78,18,15,3
8,14,79,27,18,9
8,14,80,9,6,3
8,14,81,35,18,17
8,14,82,6,14,-8
8,14,83,14,6,8
8,14,84,19,22,-3
8,14,85,12,8,4
8,14,86,20,14,6
8,14,87,19,13,6
8,14,88,20,28,-8
8,14,89,23,9,14
8,14,90,11,8,3
8,14,91,16,12,4
8,14,92,17,6,11
8,14,93,37,19,18
8,14,94,17,10,7
8,14,95,17,13,4
8,14,96,19,10,9
8,14,97,25,0,25
8,14,98,22,15,7
8,14,99,34,25,9
8,14,100,11,19,-8
8,14,101,11,17,-6
8,14,102,16,12,4
8,14,103,19,13,6
8,14,104,19,7,12
8,14,105,37,26,11
8,14,106,27,25,2
8,14,107,11,23,-12
8,14,108,15,10,5
8,14,109,23,15,8
8,14,110,11,3,8
8,14,111,6,7,-1
8,14,112,15,15,0
8,14,113,24,21,3
8,14,114,19,18,1
8,14,115,20,8,12
8,14,116,7,7,0
8,14,117,11,19,-8
8,14,118,25,15,10
8,14,119,21,18,3
8,14,120,18,18,0
8,14,121,37,15,22
8,14,122,26,16,10
8,14,123,9,11,-2
8,14,124,9,6,3
8,14,125,11,8,3
8,14,126,12,9,3
8,14,127,19,13,6
8,14,128,4,7,-3
8,14,129,25,17,8
8,14,130,29,23,6
8,14,131,23,13,10
8,14,132,16,12,4
8,14,133,32,25,7
8,14,134,24,24,0
8,14,135,18,22,-4
8,14,136,9,6,3
8,14,137,15,11,4
8,14,138,16,10,6
8,14,139,13,15,-2
8,14,140,21,14,7
8,14,141,21,15,6
8,14,142,12,23,-11
8,14,143,11,21,-10
8,14,144,18,8,10
8,14,145,23,20,3
8,14,146,8,7,1
8,14,147,12,9,3
8,14,148,28,15,13
8,14,149,18,9,9
8,14,150,20,10,10
8,14,151,14,17,-3
8,14,152,15,13,2
8,14,153,8,1,7
8,14,154,22,12,10
8,14,155,13,14,-1
8,14,156,9,9,0
8,14,157,17,16,1
8,14,158,10,8,2
8,14,159,17,13,4
8,14,160,8,16,-8
8,14,161,23,17,6
8,14,162,16,20,-4
8,14,163,10,13,-3
8,14,164,13,16,-3
8,14,165,9,11,-2
8,14,166,23,12,11
8,14,167,16,20,-4
8,14,168,13,12,1
8,14,169,18,11,7
8,14,170,9,18,-9
8,14,171,8,6,2
8,14,172,15,9,6
8,14,173,17,11,6
8,14,174,9,23,-14
8,14,175,10,19,-9
8,14,176,17,22,-5
8,14,177,27,11,16
8,14,178,14,17,-3
8,14,179,20,20,0
8,14,180,15,3,12
8,14,181,13,8,5
8,14,182,6,7,-1
8,14,183,23,11,12
8,14,184,23,11,12
8,14,185,17,1,16
8,14,186,13,15,-2
8,14,187,19,11,8
8,14,188,12,9,3
8,14,189,18,15,3
8,14,190,9,11,-2
8,14,191,22,20,2
8,14,192,24,36,-12
8,14,193,14,13,1
8,14,194,18,16,2
8,14,195,5,5,0
8,14,196,13,14,-1
8,14,197,30,16,14
8,14,198,9,6,3
8,14,199,11,16,-5
8,14,200,11,15,-4
8,14,201,10,18,-8
8,14,202,16,9,7
8,14,203,25,30,-5
8,14,204,22,22,0
8,14,205,22,23,-1
8,14,206,22,19,3
8,14,207,13,20,-7
8,14,208,18,16,2
8,14,209,10,17,-7
8,14,210,15,16,-1
8,14,211,19,12,7
8,14,212,15,15,0
8,14,213,7,17,-10
8,14,214,20,20,0
8,14,215,18,12,6
8,14,216,29,23,6
8,14,217,28,16,12
8,14,218,18,11,7
8,14,219,16,23,-7
8,14,220,13,8,5
8,14,221,2,5,-3
8,14,222,7,17,-10
8,14,223,10,10,0
8,14,224,16,12,4
8,14,225,15,13,2
8,14,226,26,20,6
8,14,227,29,7,22
8,14,228,26,20,6
8,14,229,8,10,-2
8,14,230,14,9,5
8,14,231,10,4,6
8,14,232,25,8,17
8,14,233,16,7,9
8,14,234,24,15,9
8,14,235,22,18,4
8,14,236,8,13,-5
8,14,237,14,11,3
8,14,238,12,14,-2
8,14,239,22,20,2
8,14,240,27,25,2
8,14,241,22,18,4
8,14,242,26,10,16
8,14,243,28,24,4
8,14,244,17,15,2
8,14,245,21,16,5
8,14,246,15,14,1
8,14,247,8,14,-6
8,14,248,21,18,3
8,14,249,26,14,12
8,14,250,14,11,3
8,14,251,10,11,-1
8,14,252,9,24,-15
8,14,253,15,16,-1
8,14,254,28,14,14
8,14,255,7,20,-13
8,14,256,13,12,1
8,14,257,23,16,7
8,14,258,17,12,5
8,14,259,19,18,1
8,14,260,8,11,-3
8,14,261,15,20,-5
8,14,262,28,28,0
8,14,263,9,14,-5
8,14,264,25,15,10
8,14,265,26,19,7
8,14,266,17,23,-6
8,14,267,16,11,5
8,14,268,25,16,9
8,14,269,15,20,-5
8,14,270,21,17,4
8,14,271,21,10,11
8,14,272,16,13,3
8,14,273,17,13,4
8,14,274,17,15,2
8,14,275,22,15,7
8,14,276,17,28,-11
8,14,277,18,18,0
8,14,278,17,24,-7
8,14,279,11,13,-2
8,14,280,32,21,11
8,14,281,13,9,4
8,14,282,25,14,11
8,14,283,23,22,1
8,14,284,16,14,2
8,14,285,15,7,8
8,14,286,12,20,-8
8,14,287,11,9,2
8,14,288,5,16,-11
8,14,289,18,14,4
8,14,290,20,11,9
8,14,291,9,13,-4
8,14,292,22,21,1
8,14,293,30,17,13
8,14,294,15,13,2
8,14,295,16,8,8
8,14,296,17,16,1
8,14,297,12,12,0
8,14,298,8,14,-6
8,14,299,15,23,-8
8,15,0,20,20,0
8,15,1,17,17,0
8,15,2,13,10,3
8,15,3,16,29,-13
8,15,4,20,16,4
8,15,5,12,8,4
8,15,6,18,17,1
8,15,7,13,10,3
8,15,8,18,13,5
8,15,9,14,28,-14
8,15,10,26,18,8
8,15,11,11,7,4
8,15,12,15,16,-1
8,15,13,29,25,4
8,15,14,9,14,-5
8,15,15,15,11,4
8,15,16,18,10,8
8,15,17,13,5,8
8,15,18,19,13,6
8,15,19,7,9,-2
8,15,20,26,12,14
8,15,21,22,17,5
8,15,22,14,13,1
8,15,23,17,13,4
8,15,24,10,16,-6
8,15,25,12,8,4
8,15,26,15,17,-2
8,15,27,16,15,1
8,15,28,24,20,4
8,15,29,11,10,1
8,15,30,25,8,17
8,15,31,18,18,0
8,15,32,10,16,-6
8,15,33,16,13,3
8,15,34,31,22,9
8,15,35,6,12,-6
8,15,36,8,8,0
8,15,37,14,25,-11
8,15,38,7,9,-2
8,15,39,19,13,6
8,15,40,16,15,1
8,15,41,43,14,29
8,15,42,19,11,8
8,15,43,14,11,3
8,15,44,14,20,-6
8,15,45,21,20,1
8,15,46,18,18,0
8,15,47,29,20,9
8,15,48,25,12,13
8,15,49,25,26,-1
8,15,50,21,11,10
8,15,51,13,11,2
8,15,52,9,9,0
8,15,53,16,16,0
8,15,54,24,16,8
8,15,55,18,10,8
8,15,56,11,16,-5
8,15,57,12,10,2
8,15,58,14,13,1
8,15,59,20,8,12
8,15,60,20,17,3
8,15,61,16,18,-2
8,15,62,14,15,-1
8,15,63,24,7,17
8,15,64,1,8,-7
8,15,65,13,16,-3
8,15,66,16,16,0
8,15,67,16,18,-2
8,15,68,25,11,14
8,15,69,10,15,-5
8,15,70,18,12,6
8,15,71,8,6,2
8,15,72,13,14,-1
8,15,73,25,12,13
8,15,74,18,11,7
8,15,75,23,22,1
8,15,76,24,21,3
8,15,77,11,27,-16
8,15,78,30,12,18
8,15,79,23,9,14
8,15,80,17,14,3
8,15,81,21,12,9
8,15,82,24,27,-3
8,15,83,18,8,10
8,15,84,16,12,4
8,15,85,15,7,8
8,15,86,22,8,14
8,15,87,16,9,7
8,15,88,28,14,14
8,15,89,10,7,3
8,15,90,6,17,-11
8,15,91,10,15,-5
8,15,92,19,12,7
8,15,93,13,23,-10
8,15,94,15,16,-1
8,15,95,18,9,9
8,15,96,19,11,8
8,15,97,8,10,-2
8,15,98,14,13,1
8,15,99,17,16,1
8,15,100,23,12,11
8,15,101,11,10,1
8,15,102,19,9,10
8,15,103,17,11,6
8,15,104,21,9,12
8,15,105,8,12,-4
8,15,106,8,11,-3
8,15,107,11,9,2
8,15,108,9,8,1
8,15,109,19,7,12
8,15,110,15,14,1
8,15,111,17,34,-17
8,15,112,16,6,10
8,15,113,28,7,21
8,15,114,14,13,1
8,15,115,22,19,3
8,15,116,31,16,15
8,15,117,14,12,2
8,15,118,21,14,7
8,15,119,17,12,5
8,15,120,6,9,-3
8,15,121,10,4,6
8,15,122,23,8,15
8,15,123,13,20,-7
8,15,124,16,13,3
8,15,125,15,7,8
8,15,126,13,11,2
8,15,127,11,17,-6
8,15,128,12,14,-2
8,15,129,19,14,5
8,15,130,14,7,7
8,15,131,19,23,-4
8,15,132,22,20,2
8,15,133,28,24,4
8,15,134,16,8,8
8,15,135,24,23,1
8,15,136,13,7,6
8,15,137,27,8,19
8,15,138,17,17,0
8,15,139,16,9,7
8,15,140,10,2,8
8,15,141,21,16,5
8,15,142,18,7,11
8,15,143,27,19,8
8,15,144,7,7,0
8,15,145,16,16,0
8,15,146,10,12,-2
8,15,147,19,11,8
8,15,148,17,10,7
8,15,149,20,11,9
8,15,150,15,9,6
8,15,151,15,8,7
8,15,152,25,17,8
8,15,153,18,14,4
8,15,154,13,9,4
8,15,155,13,7,6
8,15,156,20,8,12
8,15,157,24,16,8
8,15,158,10,16,-6
8,15,159,20,13,7
8,15,160,9,7,2
8,15,161,12,6,6
8,15,162,19,7,12
8,15,163,19,24,-5
8,15,164,18,8,10
8,15,165,15,23,-8
8,15,166,16,12,4
8,15,167,28,14,14
8,15,168,13,18,-5
8,15,169,23,19,4
8,15,170,31,12,19
8,15,171,11,18,-7
8,15,172,20,11,9
8,15,173,5,20,-15
8,15,174,28,22,6
8,15,175,21,21,0
8,15,176,17,27,-10
8,15,177,11,13,-2
8,15,178,7,2,5
8,15,179,34,18,16
8,15,180,17,16,1
8,15,181,36,20,16
8,15,182,20,19,1
8,15,183,16,13,3
8,15,184,20,22,-2
8,15,185,23,9,14
8,15,186,15,9,6
8,15,187,3,2,1
8,15,188,20,12,8
8,15,189,30,14,16
8,15,190,23,13,10
8,15,191,11,15,-4
8,15,192,25,12,13
8,15,193,8,9,-1
8,15,194,7,8,-1
8,15,195,18,11,7
8,15,196,29,15,14
8,15,197,3,11,-8
8,15,198,13,8,5
8,15,199,11,12,-1
8,15,200,16,15,1
8,15,201,16,13,3
8,15,202,16,9,7
8,15,203,16,16,0
8,15,204,12,19,-7
8,15,205,19,2,17
8,15,206,13,9,4
8,15,207,11,8,3
8,15,208,15,11,4
8,15,209,26,22,4
8,15,210,16,9,7
8,15,211,20,16,4
8,15,212,29,21,8
8,15,213,13,17,-4
8,15,214,14,6,8
8,15,215,12,14,-2
8,15,216,14,21,-7
8,15,217,30,18,12
8,15,218,19,12,7
8,15,219,25,12,13
8,15,220,15,18,-3
8,15,221,21,21,0
8,15,222,17,7,10
8,15,223,19,9,10
8,15,224,12,10,2
8,15,225,19,6,13
8,15,226,33,11,22
8,15,227,18,10,8
8,15,228,25,23,2
8,15,229,14,23,-9
8,15,230,9,14,-5
8,15,231,28,30,-2
8,15,232,21,8,13
8,15,233,13,6,7
8,15,234,14,15,-1
8,15,235,35,18,17
8,15,236,15,12,3
8,15,237,11,15,-4
8,15,238,22,11,11
8,15,239,15,12,3
8,15,240,28,16,12
8,15,241,27,20,7
8,15,242,9,20,-11
8,15,243,17,6,11
8,15,244,12,8,4
8,15,245,10,19,-9
8,15,246,12,11,1
8,15,247,9,11,-2
8,15,248,14,10,4
8,15,249,20,14,6
8,15,250,15,22,-7
8,15,251,18,18,0
8,15,252,5,9,-4
8,15,253,19,12,7
8,15,254,13,15,-2
8,15,255,19,23,-4
8,15,256,21,22,-1
8,15,257,20,12,8
8,15,258,27,15,12
8,15,259,16,17,-1
8,15,260,25,14,11
8,15,261,19,8,11
8,15,262,11,12,-1
8,15,263,15,10,5
8,15,264,16,22,-6
8,15,265,15,20,-5
8,15,266,16,17,-1
8,15,267,24,9,15
8,15,268,40,11,29
8,15,269,11,5,6
8,15,270,10,18,-8
8,15,271,14,15,-1
8,15,272,20,13,7
8,15,273,31,25,6
8,15,274,34,22,12
8,15,275,26,11,15
8,15,276,17,16,1
8,15,277,18,19,-1
8,15,278,26,23,3
8,15,279,16,19,-3
8,15,280,19,22,-3
8,15,281,7,5,2
8,15,282,20,15,5
8,15,283,13,20,-7
8,15,284,13,17,-4
8,15,285,15,9,6
8,15,286,19,17,2
8,15,287,21,9,12
8,15,288,13,17,-4
8,15,289,25,25,0
8,15,290,21,13,8
8,15,291,14,14,0
8,15,292,10,6,4
8,15,293,36,12,24
8,15,294,24,20,4
8,15,295,21,14,7
8,15,296,18,15,3
8,15,297,12,9,3
8,15,298,25,3,22
8,15,299,16,21,-5
8,16,0,23,22,1
8,16,1,15,24,-9
8,16,2,16,15,1
8,16,3,12,16,-4
8,16,4,9,11,-2
8,16,5,17,12,5
8,16,6,21,10,11
8,16,7,17,12,5
8,16,8,8,8,0
8,16,9,35,21,14
8,16,10,10,22,-12
8,16,11,12,19,-7
8,16,12,15,4,11
8,16,13,8,5,3
8,16,14,17,6,11
8,16,15,8,9,-1
8,16,16,9,15,-6
8,16,17,2,3,-1
8,16,18,15,15,0
8,16,19,18,23,-5
8,16,20,24,20,4
8,16,21,21,8,13
8,16,22,21,14,7
8,16,23,14,18,-4
8,16,24,18,11,7
8,16,25,19,10,9
8,16,26,18,12,6
8,16,27,14,25,-11
8,16,28,12,12,0
8,16,29,19,15,4
8,16,30,16,11,5
8,16,31,14,8,6
8,16,32,25,14,11
8,16,33,14,12,2
8,16,34,18,16,2
8,16,35,17,11,6
8,16,36,16,8,8
8,16,37,19,14,5
8,16,38,15,19,-4
8,16,39,20,17,3
8,16,40,33,15,18
8,16,41,12,7,5
8,16,42,20,17,3
8,16,43,26,12,14
8,16,44,19,15,4
8,16,45,16,15,1
8,16,46,17,14,3
8,16,47,27,16,11
8,16,48,21,21,0
8,16,49,8,3,5
8,16,50,11,9,2
8,16,51,12,19,-7
8,16,52,10,22,-12
8,16,53,23,16,7
8,16,54,18,8,10
8,16,55,21,13,8
8,16,56,41,21,20
8,16,57,15,16,-1
8,16,58,14,20,-6
8,16,59,21,21,0
8,16,60,5,20,-15
8,16,61,25,12,13
8,16,62,18,15,3
8,16,63,15,15,0
8,16,64,11,7,4
8,16,65,18,15,3
8,16,66,19,16,3
8,16,67,19,25,-6
8,16,68,20,19,1
8,16,69,19,7,12
8,16,70,29,7,22
8,16,71,12,8,4
8,16,72,17,2,15
8,16,73,9,6,3
8,16,74,22,2,20
8,16,75,16,17,-1
8,16,76,13,14,-1
8,16,77,23,13,10
8,16,78,16,19,-3
8,16,79,23,13,10
8,16,80,8,17,-9
8,16,81,16,26,-10
8,16,82,17,13,4
8,16,83,19,9,10
8,16,84,9,9,0
8,16,85,20,23,-3
8,16,86,15,31,-16
8,16,87,16,15,1
8,16,88,12,11,1
8,16,89,17,23,-6
8,16,90,29,11,18
8,16,91,28,11,17
8,16,92,11,7,4
8,16,93,24,12,12
8,16,94,12,21,-9
8,16,95,15,4,11
8,16,96,17,8,9
8,16,97,27,19,8
8,16,98,20,10,10
8,16,99,17,17,0
8,16,100,20,19,1
8,16,101,30,19,11
8,16,102,12,13,-1
8,16,103,26,26,0
8,16,104,9,12,-3
8,16,105,21,24,-3
8,16,106,20,18,2
8,16,107,27,9,18
8,16,108,6,7,-1
8,16,109,16,9,7
8,16,110,40,15,25
8,16,111,24,11,13
8,16,112,18,19,-1
8,16,113,16,7,9
8,16,114,7,7,0
8,16,115,22,11,11
8,16,116,19,11,8
8,16,117,19,21,-2
8,16,118,13,19,-6
8,16,119,15,12,3
8,16,120,15,15,0
8,16,121,27,16,11
8,16,122,34,14,20
8,16,123,18,16,2
8,16,124,26,10,16
8,16,125,7,17,-10
8,16,126,14,19,-5
8,16,127,18,15,3
8,16,128,32,11,21
8,16,129,23,10,13
8,16,130,5,8,-3
8,16,131,17,13,4
8,16,132,16,6,10
8,16,133,13,14,-1
8,16,134,26,8,18
8,16,135,21,12,9
8,16,136,17,19,-2
8,16,137,22,3,19
8,16,138,17,12,5
8,16,139,17,19,-2
8,16,140,16,4,12
8,16,141,10,22,-12
8,16,142,15,13,2
8,16,143,11,4,7
8,16,144,8,9,-1
8,16,145,14,28,-14
8,16,146,8,11,-3
8,16,147,20,12,8
8,16,148,17,10,7
8,16,149,17,13,4
8,16,150,12,18,-6
8,16,151,15,10,5
8,16,152,22,11,11
8,16,153,8,9,-1
8,16,154,16,5,11
8,16,155,22,15,7
8,16,156,18,10,8
8,16,157,17,18,-1
8,16,158,10,1,9
8,16,159,20,17,3
8,16,160,26,36,-10
8,16,161,11,12,-1
8,16,162,15,6,9
8,16,163,19,18,1
8,16,164,23,17,6
8,16,165,11,8,3
8,16,166,12,11,1
8,16,167,12,8,4
8,16,168,25,22,3
8,16,169,29,22,7
8,16,170,22,19,3
8,16,171,19,12,7
8,16,172,15,20,-5
8,16,173,35,12,23
8,16,174,16,11,5
8,16,175,19,17,2
8,16,176,20,11,9
8,16,177,18,7,11
8,16,178,13,9,4
8,16,179,10,20,-10
8,16,180,19,16,3
8,16,181,21,10,11
8,16,182,20,6,14
8,16,183,19,15,4
8,16,184,23,25,-2
8,16,185,22,12,10
8,16,186,25,13,12
8,16,187,14,22,-8
8,16,188,32,34,-2
8,16,189,12,10,2
8,16,190,14,11,3
8,16,191,18,12,6
8,16,192,12,11,1
8,16,193,8,7,1
8,16,194,10,17,-7
8,16,195,9,10,-1
8,16,196,32,6,26
8,16,197,16,30,-14
8,16,198,22,19,3
8,16,199,11,12,-1
8,16,200,15,14,1
8,16,201,28,15,13
8,16,202,12,7,5
8,16,203,21,10,11
8,16,204,14,2,12
8,16,205,9,20,-11
8,16,206,26,15,11
8,16,207,15,11,4
8,16,208,6,13,-7
8,16,209,29,25,4
8,16,210,13,8,5
8,16,211,17,14,3
8,16,212,11,15,-4
8,16,213,22,10,12
8,16,214,10,7,3
8,16,215,16,14,2
8,16,216,22,16,6
8,16,217,26,12,14
8,16,218,14,19,-5
8,16,219,13,15,-2
8,16,220,20,10,10
8,16,221,18,10,8
8,16,222,5,30,-25
8,16,223,19,22,-3
8,16,224,8,8,0
8,16,225,19,14,5
8,16,226,20,10,10
8,16,227,25,21,4
8,16,228,11,13,-2
8,16,229,22,12,10
8,16,230,11,8,3
8,16,231,9,14,-5
8,16,232,18,8,10
8,16,233,9,12,-3
8,16,234,16,15,1
8,16,235,13,12,1
8,16,236,21,21,0
8,16,237,3,10,-7
8,16,238,21,21,0
8,16,239,9,14,-5
8,16,240,20,13,7
8,16,241,19,8,11
8,16,242,24,28,-4
8,16,243,29,15,14
8,16,244,20,19,1
8,16,245,24,12,12
8,16,246,5,19,-14
8,16,247,25,5,20
8,16,248,15,11,4
8,16,249,23,13,10
8,16,250,17,12,5
8,16,251,22,9,13
8,16,252,22,12,10
8,16,253,25,13,12
8,16,254,13,14,-1
8,16,255,9,12,-3
8,16,256,20,9,11
8,16,257,22,15,7
8,16,258,22,9,13
8,16,259,13,11,2
8,16,260,36,23,13
8,16,261,16,12,4
8,16,262,6,12,-6
8,16,263,19,15,4
8,16,264,24,14,10
8,16,265,12,15,-3
8,16,266,29,19,10
8,16,267,11,11,0
8,16,268,12,18,-6
8,16,269,19,18,1
8,16,270,8,23,-15
8,16,271,15,15,0
8,16,272,37,24,13
8,16,273,12,14,-2
8,16,274,18,11,7
8,16,275,11,13,-2
8,16,276,9,11,-2
8,16,277,15,12,3
8,16,278,22,17,5
8,16,279,14,12,2
8,16,280,25,23,2
8,16,281,16,14,2
8,16,282,25,17,8
8,16,283,17,15,2
8,16,284,15,9,6
8,16,285,9,5,4
8,16,286,13,17,-4
8,16,287,20,6,14
8,16,288,12,17,-5
8,16,289,13,12,1
8,16,290,23,14,9
8,16,291,13,19,-6
8,16,292,28,13,15
8,16,293,22,15,7
8,16,294,23,14,9
8,16,295,17,11,6
8,16,296,22,16,6
8,16,297,16,13,3
8,16,298,8,16,-8
8,16,299,11,20,-9
8,17,0,19,24,-5
8,17,1,19,21,-2
8,17,2,10,13,-3
8,17,3,28,6,22
8,17,4,20,12,8
8,17,5,12,12,0
8,17,6,30,9,21
8,17,7,7,8,-1
8,17,8,22,9,13
8,17,9,11,19,-8
8,17,10,20,16,4
8,17,11,9,7,2
8,17,12,23,11,12
8,17,13,17,7,10
8,17,14,18,11,7
8,17,15,25,10,15
8,17,16,7,14,-7
8,17,17,12,6,6
8,17,18,24,19,5
8,17,19,18,14,4
8,17,20,21,18,3
8,17,21,27,8,19
8,17,22,19,13,6
8,17,23,18,5,13
8,17,24,18,20,-2
8,17,25,22,8,14
8,17,26,24,3,21
8,17,27,19,13,6
8,17,28,13,13,0
8,17,29,18,8,10
8,17,30,18,25,-7
8,17,31,22,16,6
8,17,32,17,9,8
8,17,33,24,8,16
8,17,34,21,8,13
8,17,35,21,19,2
8,17,36,14,10,4
8,17,37,26,17,9
8,17,38,15,13,2
8,17,39,10,13,-3
8,17,40,5,14,-9
8,17,41,12,9,3
8,17,42,19,7,12
8,17,43,16,15,1
8,17,44,29,9,20
8,17,45,10,14,-4
8,17,46,25,23,2
8,17,47,15,27,-12
8,17,48,26,21,5
8,17,49,26,8,18
8,17,50,7,14,-7
8,17,51,19,11,8
8,17,52,35,15,20
8,17,53,7,9,-2
8,17,54,20,13,7
8,17,55,22,22,0
8,17,56,26,15,11
8,17,57,22,6,16
8,17,58,21,10,11
8,17,59,28,20,8
8,17,60,17,17,0
8,17,61,17,13,4
8,17,62,19,24,-5
8,17,63,13,6,7
8,17,64,17,23,-6
8,17,65,22,29,-7
8,17,66,13,14,-1
8,17,67,14,14,0
8,17,68,13,18,-5
8,17,69,14,12,2
8,17,70,5,6,-1
8,17,71,24,16,8
8,17,72,12,8,4
8,17,73,9,9,0
8,17,74,24,7,17
8,17,75,13,28,-15
8,17,76,30,26,4
8,17,77,27,14,13
8,17,78,19,5,14
8,17,79,15,11,4
8,17,80,14,11,3
8,17,81,31,22,9
8,17,82,15,17,-2
8,17,83,22,17,5
8,17,84,13,12,1
8,17,85,20,17,3
8,17,86,26,21,5
8,17,87,19,6,13
8,17,88,16,14,2
8,17,89,16,17,-1
8,17,90,24,21,3
8,17,91,17,18,-1
8,17,92,22,20,2
8,17,93,13,16,-3
8,17,94,27,10,17
8,17,95,24,13,11
8,17,96,11,7,4
8,17,97,11,18,-7
8,17,98,17,11,6
8,17,99,12,22,-10
8,17,100,21,14,7
8,17,101,17,11,6
8,17,102,10,15,-5
8,17,103,25,18,7
8,17,104,18,4,14
8,17,105,16,10,6
8,17,106,19,23,-4
8,17,107,11,15,-4
8,17,108,13,20,-7
8,17,109,35,11,24
8,17,110,14,4,10
8,17,111,18,22,-4
8,17,112,39,14,25
8,17,113,20,9,11
8,17,114,17,28,-11
8,17,115,13,22,-9
8,17,116,7,8,-1
8,17,117,18,7,11
8,17,118,7,6,1
8,17,119,21,21,0
8,17,120,5,9,-4
8,17,121,22,7,15
8,17,122,28,18,10
8,17,123,15,6,9
8,17,124,13,13,0
8,17,125,10,11,-1
8,17,126,17,8,9
8,17,127,13,10,3
8,17,128,13,6,7
8,17,129,19,16,3
8,17,130,39,19,20
8,17,131,12,4,8
8,17,132,18,11,7
8,17,133,28,17,11
8,17,134,28,21,7
8,17,135,21,9,12
8,17,136,29,37,-8
8,17,137,13,10,3
8,17,138,24,14,10
8,17,139,6,15,-9
8,17,140,16,19,-3
8,17,141,6,5,1
8,17,142,23,8,15
8,17,143,12,6,6
8,17,144,19,13,6
8,17,145,22,11,11
8,17,146,15,7,8
8,17,147,7,15,-8
8,17,148,11,15,-4
8,17,149,23,12,11
8,17,150,15,21,-6
8,17,151,26,21,5
8,17,152,22,13,9
8,17,153,22,22,0
8,17,154,25,33,-8
8,17,155,14,8,6
8,17,156,20,2,18
8,17,157,13,4,9
8,17,158,22,24,-2
8,17,159,20,23,-3
8,17,160,12,17,-5
8,17,161,26,20,6
8,17,162,17,14,3
8,17,163,29,24,5
8,17,164,18,13,5
8,17,165,22,7,15
8,17,166,23,16,7
8,17,167,16,18,-2
8,17,168,14,15,-1
8,17,169,24,7,17
8,17,170,25,16,9
8,17,171,18,15,3
8,17,172,13,14,-1
8,17,173,15,17,-2
8,17,174,15,16,-1
8,17,175,23,14,9
8,17,176,21,9,12
8,17,177,18,16,2
8,17,178,14,12,2
8,17,179,8,8,0
8,17,180,10,11,-1
8,17,181,16,13,3
8,17,182,14,4,10
8,17,183,27,23,4
8,17,184,14,5,9
8,17,185,17,20,-3
8,17,186,17,31,-14
8,17,187,13,16,-3
8,17,188,11,18,-7
8,17,189,13,10,3
8,17,190,21,18,3
8,17,191,12,16,-4
8,17,192,20,24,-4
8,17,193,19,12,7
8,17,194,13,11,2
8,17,195,30,7,23
8,17,196,13,13,0
8,17,197,24,20,4
8,17,198,28,15,13
8,17,199,10,5,5
8,17,200,12,11,1
8,17,201,15,15,0
8,17,202,23,7,16
8,17,203,25,7,18
8,17,204,8,16,-8
8,17,205,14,14,0
8,17,206,7,19,-12
8,17,207,20,21,-1
8,17,208,11,10,1
8,17,209,26,18,8
8,17,210,22,11,11
8,17,211,21,8,13
8,17,212,15,21,-6
8,17,213,38,23,15
8,17,214,16,16,0
8,17,215,15,7,8
8,17,216,8,7,1
8,17,217,9,8,1
8,17,218,13,14,-1
8,17,219,8,15,-7
8,17,220,29,15,14
8,17,221,13,14,-1
8,17,222,32,19,13
8,17,223,10,8,2
8,17,224,12,10,2
8,17,225,22,5,17
8,17,226,7,13,-6
8,17,227,14,15,-1
8,17,228,9,7,2
8,17,229,23,6,17
8,17,230,20,14,6
8,17,231,10,5,5
8,17,232,24,13,11
8,17,233,4,18,-14
8,17,234,26,15,11
8,17,235,14,14,0
8,17,236,13,14,-1
8,17,237,21,18,3
8,17,238,9,5,4
8,17,239,14,14,0
8,17,240,17,23,-6
8,17,241,11,14,-3
8,17,242,17,12,5
8,17,243,23,10,13
8,17,244,14,12,2
8,17,245,21,16,5
8,17,246,15,25,-10
8,17,247,19,24,-5
8,17,248,18,10,8
8,17,249,23,11,12
8,17,250,12,10,2
8,17,251,22,12,10
8,17,252,10,22,-12
8,17,253,17,22,-5
8,17,254,17,10,7
8,17,255,22,9,13
8,17,256,25,18,7
8,17,257,12,10,2
8,17,258,26,11,15
8,17,259,13,15,-2
8,17,260,21,17,4
8,17,261,15,7,8
8,17,262,25,13,12
8,17,263,26,12,14
8,17,264,12,9,3
8,17,265,21,4,17
8,17,266,11,4,7
8,17,267,15,9,6
8,17,268,17,18,-1
8,17,269,22,11,11
8,17,270,16,15,1
8,17,271,12,8,4
8,17,272,20,8,12
8,17,273,31,11,20
8,17,274,17,10,7
8,17,275,12,5,7
8,17,276,14,15,-1
8,17,277,24,3,21
8,17,278,20,29,-9
8,17,279,7,6,1
8,17,280,23,19,4
8,17,281,20,11,9
8,17,282,9,12,-3
8,17,283,20,12,8
8,17,284,30,22,8
8,17,285,21,10,11
8,17,286,32,22,10
8,17,287,14,15,-1
8,17,288,16,12,4
8,17,289,14,6,8
8,17,290,10,5,5
8,17,291,14,16,-2
8,17,292,13,15,-2
8,17,293,8,15,-7
8,17,294,18,17,1
8,17,295,15,10,5
8,17,296,13,10,3
8,17,297,9,4,5
8,17,298,14,5,9
8,17,299,28,13,15
8,18,0,20,24,-4
8,18,1,24,10,14
8,18,2,28,8,20
8,18,3,25,15,10
8,18,4,17,30,-13
8,18,5,15,14,1
8,18,6,23,19,4
8,18,7,34,19,15
8,18,8,21,4,17
8,18,9,14,9,5
8,18,10,17,9,8
8,18,11,11,4,7
8,18,12,16,8,8
8,18,13,13,1,12
8,18,14,17,15,2
8,18,15,29,3,26
8,18,16,15,11,4
8,18,17,20,18,2
8,18,18,29,13,16
8,18,19,15,7,8
8,18,20,25,14,11
8,18,21,17,3,14
8,18,22,24,11,13
8,18,23,9,14,-5
8,18,24,16,13,3
8,18,25,20,12,8
8,18,26,4,4,0
8,18,27,17,4,13
8,18,28,16,14,2
8,18,29,17,15,2
8,18,30,22,19,3
8,18,31,30,12,18
8,18,32,9,8,1
8,18,33,24,11,13
8,18,34,14,2,12
8,18,35,10,11,-1
8,18,36,9,22,-13
8,18,37,13,12,1
8,18,38,9,11,-2
8,18,39,9,10,-1
8,18,40,11,13,-2
8,18,41,14,14,0
8,18,42,9,11,-2
8,18,43,20,10,10
8,18,44,20,8,12
8,18,45,15,18,-3
8,18,46,8,6,2
8,18,47,17,13,4
8,18,48,16,12,4
8,18,49,24,20,4
8,18,50,30,16,14
8,18,51,16,4,12
8,18,52,17,8,9
8,18,53,8,9,-1
8,18,54,14,9,5
8,18,55,26,14,12
8,18,56,20,28,-8
8,18,57,30,11,19
8,18,58,7,12,-5
8,18,59,19,7,12
8,18,60,11,12,-1
8,18,61,12,12,0
8,18,62,27,14,13
8,18,63,21,10,11
8,18,64,25,15,10
8,18,65,12,14,-2
8,18,66,12,17,-5
8,18,67,15,19,-4
8,18,68,14,8,6
8,18,69,19,14,5
8,18,70,25,21,4
8,18,71,23,9,14
8,18,72,9,4,5
8,18,73,17,15,2
8,18,74,34,21,13
8,18,75,16,12,4
8,18,76,13,14,-1
8,18,77,18,17,1
8,18,78,8,7,1
8,18,79,16,16,0
8,18,80,23,13,10
8,18,81,22,17,5
8,18,82,25,16,9
8,18,83,23,12,11
8,18,84,9,1,8
8,18,85,8,9,-1
8,18,86,13,12,1
8,18,87,19,21,-2
8,18,88,19,8,11
8,18,89,8,11,-3
8,18,90,14,15,-1
8,18,91,18,16,2
8,18,92,14,15,-1
8,18,93,17,6,11
8,18,94,26,14,12
8,18,95,21,18,3
8,18,96,14,15,-1
8,18,97,16,10,6
8,18,98,15,9,6
8,18,99,11,8,3
8,18,100,23,27,-4
8,18,101,14,5,9
8,18,102,16,12,4
8,18,103,12,4,8
8,18,104,28,24,4
8,18,105,35,14,21
8,18,106,12,13,-1
8,18,107,15,8,7
8,18,108,17,21,-4
8,18,109,20,14,6
8,18,110,23,17,6
8,18,111,10,7,3
8,18,112,16,15,1
8,18,113,32,20,12
8,18,114,20,13,7
8,18,115,17,10,7
8,18,116,21,17,4
8,18,117,31,14,17
8,18,118,13,4,9
8,18,119,16,16,0
8,18,120,9,4,5
8,18,121,21,15,6
8,18,122,53,24,29
8,18,123,14,10,4
8,18,124,29,11,18
8,18,125,13,4,9
8,18,126,17,13,4
8,18,127,18,23,-5
8,18,128,18,7,11
8,18,129,15,14,1
8,18,130,25,13,12
8,18,131,19,12,7
8,18,132,21,34,-13
8,18,133,15,14,1
8,18,134,25,10,15
8,18,135,9,6,3
8,18,136,28,15,13
8,18,137,33,20,13
8,18,138,17,18,-1
8,18,139,22,21,1
8,18,140,30,9,21
8,18,141,24,7,17
8,18,142,29,6,23
8,18,143,16,15,1
8,18,144,21,12,9
8,18,145,10,5,5
8,18,146,20,27,-7
8,18,147,20,14,6
8,18,148,23,7,16
8,18,149,29,10,19
8,18,150,16,10,6
8,18,151,11,5,6
8,18,152,16,12,4
8,18,153,14,18,-4
8,18,154,11,13,-2
8,18,155,15,7,8
8,18,156,11,18,-7
8,18,157,17,12,5
8,18,158,14,8,6
8,18,159,19,14,5
8,18,160,20,14,6
8,18,161,19,15,4
8,18,162,29,15,14
8,18,163,31,18,13
8,18,164,20,27,-7
8,18,165,20,35,-15
8,18,166,18,11,7
8,18,167,25,29,-4
8,18,168,20,8,12
8,18,169,1,5,-4
8,18,170,15,14,1
8,18,171,23,15,8
8,18,172,16,13,3
8,18,173,9,8,1
8,18,174,7,27,-20
8,18,175,22,12,10
8,18,176,20,20,0
8,18,177,18,22,-4
8,18,178,22,15,7
8,18,179,11,5,6
8,18,180,8,7,1
8,18,181,20,10,10
8,18,182,15,4,11
8,18,183,24,16,8
8,18,184,13,10,3
8,18,185,22,24,-2
8,18,186,15,11,4
8,18,187,13,16,-3
8,18,188,28,26,2
8,18,189,11,13,-2
8,18,190,24,17,7
8,18,191,17,19,-2
8,18,192,15,11,4
8,18,193,21,13,8
8,18,194,19,7,12
8,18,195,23,9,14
8,18,196,13,15,-2
8,18,197,25,19,6
8,18,198,17,16,1
8,18,199,20,8,12
8,18,200,11,21,-10
8,18,201,18,8,10
8,18,202,24,17,7
8,18,203,30,13,17
8,18,204,19,15,4
8,18,205,19,21,-2
8,18,206,12,6,6
8,18,207,4,9,-5
8,18,208,19,21,-2
8,18,209,13,17,-4
8,18,210,16,5,11
8,18,211,21,11,10
8,18,212,18,13,5
8,18,213,14,15,-1
8,18,214,16,4,12
8,18,215,16,5,11
8,18,216,16,16,0
8,18,217,12,5,7
8,18,218,38,17,21
8,18,219,26,16,10
8,18,220,27,28,-1
8,18,221,19,8,11
8,18,222,18,13,5
8,18,223,21,16,5
8,18,224,23,11,12
8,18,225,6,3,3
8,18,226,12,13,-1
8,18,227,26,11,15
8,18,228,11,10,1
8,18,229,14,20,-6
8,18,230,10,21,-11
8,18,231,13,2,11
8,18,232,23,13,10
8,18,233,17,12,5
8,18,234,13,18,-5
8,18,235,34,20,14
8,18,236,13,18,-5
8,18,237,20,10,10
8,18,238,24,17,7
8,18,239,12,5,7
8,18,240,30,19,11
8,18,241,20,26,-6
8,18,242,11,23,-12
8,18,243,14,16,-2
8,18,244,11,8,3
8,18,245,13,8,5
8,18,246,9,33,-24
8,18,247,30,11,19
8,18,248,8,5,3
8,18,249,10,9,1
8,18,250,17,11,6
8,18,251,27,12,15
8,18,252,16,13,3
8,18,253,21,17,4
8,18,254,10,8,2
8,18,255,20,13,7
8,18,256,14,26,-12
8,18,257,14,9,5
8,18,258,16,6,10
8,18,259,15,9,6
8,18,260,22,9,13
8,18,261,18,18,0
8,18,262,21,12,9
8,18,263,24,9,15
8,18,264,16,5,11
8,18,265,24,19,5
8,18,266,23,19,4
8,18,267,18,22,-4
8,18,268,25,16,9
8,18,269,27,21,6
8,18,270,17,8,9
8,18,271,20,19,1
8,18,272,22,23,-1
8,18,273,17,17,0
8,18,274,16,15,1
8,18,275,27,15,12
8,18,276,16,8,8
8,18,277,20,22,-2
8,18,278,24,18,6
8,18,279,13,9,4
8,18,280,16,21,-5
8,18,281,21,18,3
8,18,282,13,9,4
8,18,283,11,19,-8
8,18,284,28,19,9
8,18,285,24,25,-1
8,18,286,9,7,2
8,18,287,16,8,8
8,18,288,10,9,1
8,18,289,22,33,-11
8,18,290,25,13,12
8,18,291,9,0,9
8,18,292,15,9,6
8,18,293,25,18,7
8,18,294,15,17,-2
8,18,295,25,15,10
8,18,296,25,26,-1
8,18,297,5,5,0
8,18,298,28,19,9
8,18,299,16,18,-2
8,19,0,17,10,7
8,19,1,15,18,-3
8,19,2,12,11,1
8,19,3,9,11,-2
8,19,4,11,17,-6
8,19,5,27,18,9
8,19,6,9,6,3
8,19,7,21,8,13
8,19,8,24,9,15
8,19,9,10,21,-11
8,19,10,10,12,-2
8,19,11,9,9,0
8,19,12,7,10,-3
8,19,13,22,17,5
8,19,14,7,12,-5
8,19,15,30,23,7
8,19,16,17,8,9
8,19,17,9,16,-7
8,19,18,8,9,-1
8,19,19,14,14,0
8,19,20,24,28,-4
8,19,21,30,18,12
8,19,22,20,16,4
8,19,23,12,15,-3
8,19,24,21,17,4
8,19,25,10,10,0
8,19,26,20,23,-3
8,19,27,21,9,12
8,19,28,28,16,12
8,19,29,14,11,3
8,19,30,13,9,4
8,19,31,9,10,-1
8,19,32,19,15,4
8,19,33,13,5,8
8,19,34,12,15,-3
8,19,35,14,5,9
8,19,36,26,10,16
8,19,37,28,9,19
8,19,38,16,14,2
8,19,39,30,13,17
8,19,40,26,5,21
8,19,41,21,28,-7
8,19,42,18,14,4
8,19,43,17,13,4
8,19,44,13,17,-4
8,19,45,26,10,16
8,19,46,15,12,3
8,19,47,17,18,-1
8,19,48,13,11,2
8,19,49,30,19,11
8,19,50,14,17,-3
8,19,51,23,19,4
8,19,52,20,18,2
8,19,53,30,24,6
8,19,54,20,23,-3
8,19,55,21,13,8
8,19,56,22,14,8
8,19,57,11,5,6
8,19,58,12,10,2
8,19,59,15,18,-3
8,19,60,27,14,13
8,19,61,27,11,16
8,19,62,23,12,11
8,19,63,19,32,-13
8,19,64,26,8,18
8,19,65,22,16,6
8,19,66,21,14,7
8,19,67,18,9,9
8,19,68,14,9,5
8,19,69,18,20,-2
8,19,70,27,26,1
8,19,71,28,16,12
8,19,72,13,8,5
8,19,73,10,13,-3
8,19,74,14,10,4
8,19,75,14,6,8
8,19,76,14,17,-3
8,19,77,9,14,-5
8,19,78,27,17,10
8,19,79,28,18,10
8,19,80,6,5,1
8,19,81,16,17,-1
8,19,82,20,24,-4
8,19,83,16,14,2
8,19,84,12,12,0
8,19,85,27,11,16
8,19,86,20,10,10
8,19,87,6,9,-3
8,19,88,18,20,-2
8,19,89,31,12,19
8,19,90,26,14,12
8,19,91,13,12,1
8,19,92,17,9,8
8,19,93,10,4,6
8,19,94,15,12,3
8,19,95,14,12,2
8,19,96,23,11,12
8,19,97,25,10,15
8,19,98,23,16,7
8,19,99,14,12,2
8,19,100,16,14,2
8,19,101,18,13,5
8,19,102,33,28,5
8,19,103,14,18,-4
8,19,104,9,7,2
8,19,105,13,13,0
8,19,106,14,11,3
8,19,107,21,13,8
8,19,108,14,9,5
8,19,109,17,21,-4
8,19,110,21,12,9
8,19,111,23,13,10
8,19,112,28,11,17
8,19,113,15,12,3
8,19,114,12,17,-5
8,19,115,8,5,3
8,19,116,22,28,-6
8,19,117,17,6,11
8,19,118,17,13,4
8,19,119,10,22,-12
8,19,120,18,10,8
8,19,121,21,27,-6
8,19,122,9,16,-7
8,19,123,13,15,-2
8,19,124,38,15,23
8,19,125,13,15,-2
8,19,126,32,21,11
8,19,127,24,12,12
8,19,128,13,9,4
8,19,129,27,7,20
8,19,130,14,16,-2
8,19,131,19,10,9
8,19,132,14,12,2
8,19,133,15,11,4
8,19,134,12,12,0
8,19,135,5,23,-18
8,19,136,15,15,0
8,19,137,13,11,2
8,19,138,19,26,-7
8,19,139,27,31,-4
8,19,140,13,14,-1
8,19,141,25,32,-7
8,19,142,16,15,1
8,19,143,16,33,-17
8,19,144,28,11,17
8,19,145,22,11,11
8,19,146,21,8,13
8,19,147,14,13,1
8,19,148,17,11,6
8,19,149,23,17,6
8,19,150,14,15,-1
8,19,151,20,18,2
8,19,152,22,11,11
8,19,153,20,22,-2
8,19,154,18,16,2
8,19,155,27,13,14
8,19,156,26,12,14
8,19,157,19,17,2
8,19,158,22,19,3
8,19,159,2,7,-5
8,19,160,17,12,5
8,19,161,21,13,8
8,19,162,16,11,5
8,19,163,21,4,17
8,19,164,24,18,6
8,19,165,32,15,17
8,19,166,6,7,-1
8,19,167,14,12,2
8,19,168,23,16,7
8,19,169,20,11,9
8,19,170,16,22,-6
8,19,171,15,8,7
8,19,172,13,19,-6
8,19,173,25,4,21
8,19,174,13,16,-3
8,19,175,11,17,-6
8,19,176,13,16,-3
8,19,177,12,10,2
8,19,178,31,13,18
8,19,179,20,17,3
8,19,180,21,13,8
8,19,181,19,11,8
8,19,182,19,7,12
8,19,183,22,16,6
8,19,184,10,14,-4
8,19,185,13,11,2
8,19,186,21,15,6
8,19,187,10,9,1
8,19,188,20,13,7
8,19,189,22,9,13
8,19,190,34,18,16
8,19,191,21,12,9
8,19,192,19,9,10
8,19,193,19,20,-1
8,19,194,16,14,2
8,19,195,27,8,19
8,19,196,26,6,20
8,19,197,22,10,12
8,19,198,11,16,-5
8,19,199,12,15,-3
8,19,200,15,15,0
8,19,201,20,17,3
8,19,202,35,18,17
8,19,203,9,16,-7
8,19,204,8,13,-5
8,19,205,24,16,8
8,19,206,24,13,11
8,19,207,19,20,-1
8,19,208,23,16,7
8,19,209,20,14,6
8,19,210,24,14,10
8,19,211,22,24,-2
8,19,212,13,4,9
8,19,213,15,15,0
8,19,214,21,20,1
8,19,215,23,19,4
8,19,216,22,13,9
8,19,217,15,20,-5
8,19,218,42,13,29
8,19,219,16,7,9
8,19,220,33,16,17
8,19,221,17,16,1
8,19,222,28,14,14
8,19,223,24,7,17
8,19,224,8,11,-3
8,19,225,12,19,-7
8,19,226,16,18,-2
8,19,227,17,13,4
8,19,228,10,11,-1
8,19,229,8,9,-1
8,19,230,21,18,3
8,19,231,40,4,36
8,19,232,12,12,0
8,19,233,9,8,1
8,19,234,10,5,5
8,19,235,18,21,-3
8,19,236,44,16,28
8,19,237,16,24,-8
8,19,238,12,15,-3
8,19,239,16,13,3
8,19,240,18,2,16
8,19,241,20,7,13
8,19,242,13,11,2
8,19,243,14,15,-1
8,19,244,23,5,18
8,19,245,21,9,12
8,19,246,19,5,14
8,19,247,19,12,7
8,19,248,19,21,-2
8,19,249,20,10,10
8,19,250,16,7,9
8,19,251,18,15,3
8,19,252,12,19,-7
8,19,253,28,20,8
8,19,254,22,15,7
8,19,255,10,20,-10
8,19,256,28,16,12
8,19,257,13,8,5
8,19,258,21,11,10
8,19,259,19,7,12
8,19,260,8,12,-4
8,19,261,14,11,3
8,19,262,12,7,5
8,19,263,13,9,4
8,19,264,25,19,6
8,19,265,13,21,-8
8,19,266,15,7,8
8,19,267,18,12,6
8,19,268,5,10,-5
8,19,269,19,11,8
8,19,270,17,10,7
8,19,271,3,11,-8
8,19,272,13,8,5
8,19,273,17,8,9
8,19,274,15,22,-7
8,19,275,23,17,6
8,19,276,13,7,6
8,19,277,25,13,12
8,19,278,15,17,-2
8,19,279,14,7,7
8,19,280,13,19,-6
8,19,281,24,12,12
8,19,282,18,4,14
8,19,283,22,9,13
8,19,284,10,12,-2
8,19,285,22,18,4
8,19,286,12,21,-9
8,19,287,21,12,9
8,19,288,17,9,8
8,19,289,24,15,9
8,19,290,9,1,8
8,19,291,19,8,11
8,19,292,15,13,2
8,19,293,6,4,2
8,19,294,18,18,0
8,19,295,14,14,0
8,19,296,20,14,6
8,19,297,16,11,5
8,19,298,15,9,6
8,19,299,16,18,-2
8,20,0,10,5,5
8,20,1,19,14,5
8,20,2,9,6,3
8,20,3,12,8,4
8,20,4,13,13,0
8,20,5,24,11,13
8,20,6,26,8,18
8,20,7,17,16,1
8,20,8,27,10,17
8,20,9,16,6,10
8,20,10,18,16,2
8,20,11,14,13,1
8,20,12,10,8,2
8,20,13,13,13,0
8,20,14,11,13,-2
8,20,15,21,20,1
8,20,16,21,25,-4
8,20,17,13,16,-3
8,20,18,21,11,10
8,20,19,23,17,6
8,20,20,23,15,8
8,20,21,36,13,23
8,20,22,42,5,37
8,20,23,5,3,2
8,20,24,12,22,-10
8,20,25,14,12,2
8,20,26,30,18,12
8,20,27,23,9,14
8,20,28,17,5,12
8,20,29,23,11,12
8,20,30,24,12,12
8,20,31,17,10,7
8,20,32,23,16,7
8,20,33,14,17,-3
8,20,34,23,14,9
8,20,35,27,21,6
8,20,36,46,12,34
8,20,37,30,16,14
8,20,38,17,12,5
8,20,39,16,17,-1
8,20,40,12,12,0
8,20,41,17,16,1
8,20,42,14,4,10
8,20,43,19,15,4
8,20,44,34,12,22
8,20,45,12,10,2
8,20,46,26,18,8
8,20,47,31,20,11
8,20,48,20,14,6
8,20,49,26,15,11
8,20,50,25,12,13
8,20,51,15,12,3
8,20,52,34,16,18
8,20,53,13,12,1
8,20,54,19,14,5
8,20,55,21,13,8
8,20,56,17,16,1
8,20,57,24,21,3
8,20,58,15,15,0
8,20,59,18,3,15
8,20,60,14,18,-4
8,20,61,14,10,4
8,20,62,11,6,5
8,20,63,10,13,-3
8,20,64,14,9,5
8,20,65,16,13,3
8,20,66,24,9,15
8,20,67,13,19,-6
8,20,68,13,10,3
8,20,69,29,16,13
8,20,70,14,6,8
8,20,71,23,12,11
8,20,72,21,10,11
8,20,73,29,15,14
8,20,74,4,6,-2
8,20,75,15,6,9
8,20,76,24,17,7
8,20,77,19,6,13
8,20,78,24,6,18
8,20,79,13,12,1
8,20,80,14,20,-6
8,20,81,14,15,-1
8,20,82,18,12,6
8,20,83,22,12,10
8,20,84,20,13,7
8,20,85,30,17,13
8,20,86,20,11,9
8,20,87,17,8,9
8,20,88,19,12,7
8,20,89,11,16,-5
8,20,90,14,10,4
8,20,91,14,17,-3
8,20,92,17,24,-7
8,20,93,29,20,9
8,20,94,12,9,3
8,20,95,20,9,11
8,20,96,21,17,4
8,20,97,8,9,-1
8,20,98,16,6,10
8,20,99,9,13,-4
8,20,100,22,4,18
8,20,101,25,17,8
8,20,102,22,15,7
8,20,103,13,12,1
8,20,104,19,8,11
8,20,105,18,14,4
8,20,106,26,21,5
8,20,107,24,14,10
8,20,108,14,25,-11
8,20,109,7,7,0
8,20,110,20,19,1
8,20,111,24,10,14
8,20,112,11,19,-8
8,20,113,16,15,1
8,20,114,10,14,-4
8,20,115,25,13,12
8,20,116,22,30,-8
8,20,117,22,14,8
8,20,118,22,11,11
8,20,119,16,13,3
8,20,120,25,15,10
8,20,121,23,16,7
8,20,122,28,17,11
8,20,123,17,13,4
8,20,124,22,19,3
8,20,125,15,16,-1
8,20,126,19,8,11
8,20,127,13,6,7
8,20,128,17,20,-3
8,20,129,15,14,1
8,20,130,25,5,20
8,20,131,19,6,13
8,20,132,21,16,5
8,20,133,15,30,-15
8,20,134,8,8,0
8,20,135,20,14,6
8,20,136,29,14,15
8,20,137,14,8,6
8,20,138,10,17,-7
8,20,139,15,15,0
8,20,140,24,6,18
8,20,141,18,9,9
8,20,142,13,6,7
8,20,143,13,10,3
8,20,144,21,11,10
8,20,145,15,14,1
8,20,146,11,4,7
8,20,147,12,16,-4
8,20,148,26,10,16
8,20,149,16,8,8
8,20,150,19,13,6
8,20,151,20,22,-2
8,20,152,23,27,-4
8,20,153,20,12,8
8,20,154,7,8,-1
8,20,155,12,12,0
8,20,156,21,21,0
8,20,157,17,17,0
8,20,158,19,14,5
8,20,159,13,16,-3
8,20,160,15,4,11
8,20,161,13,19,-6
8,20,162,13,10,3
8,20,163,15,20,-5
8,20,164,20,12,8
8,20,165,12,14,-2
8,20,166,18,18,0
8,20,167,19,26,-7
8,20,168,16,14,2
8,20,169,26,11,15
8,20,170,12,12,0
8,20,171,26,13,13
8,20,172,24,14,10
8,20,173,31,24,7
8,20,174,14,14,0
8,20,175,14,13,1
8,20,176,31,8,23
8,20,177,10,7,3
8,20,178,10,5,5
8,20,179,18,14,4
8,20,180,25,28,-3
8,20,181,15,13,2
8,20,182,22,16,6
8,20,183,25,12,13
8,20,184,14,16,-2
8,20,185,12,3,9
8,20,186,17,11,6
8,20,187,33,12,21
8,20,188,13,19,-6
8,20,189,16,13,3
8,20,190,15,25,-10
8,20,191,19,11,8
8,20,192,13,10,3
8,20,193,15,16,-1
8,20,194,17,4,13
8,20,195,12,9,3
8,20,196,9,14,-5
8,20,197,17,19,-2
8,20,198,16,11,5
8,20,199,22,12,10
8,20,200,22,7,15
8,20,201,12,17,-5
8,20,202,20,4,16
8,20,203,19,13,6
8,20,204,22,8,14
8,20,205,11,10,1
8,20,206,12,12,0
8,20,207,24,15,9
8,20,208,31,20,11
8,20,209,21,25,-4
8,20,210,19,16,3
8,20,211,26,24,2
8,20,212,9,4,5
8,20,213,24,13,11
8,20,214,26,17,9
8,20,215,9,8,1
8,20,216,10,10,0
8,20,217,19,21,-2
8,20,218,35,21,14
8,20,219,16,16,0
8,20,220,24,28,-4
8,20,221,18,8,10
8,20,222,26,19,7
8,20,223,13,18,-5
8,20,224,30,18,12
8,20,225,11,8,3
8,20,226,11,10,1
8,20,227,14,1,13
8,20,228,9,13,-4
8,20,229,14,22,-8
8,20,230,18,11,7
8,20,231,20,16,4
8,20,232,12,8,4
8,20,233,13,20,-7
8,20,234,19,8,11
8,20,235,24,11,13
8,20,236,16,12,4
8,20,237,24,15,9
8,20,238,20,13,7
8,20,239,28,12,16
8,20,240,19,12,7
8,20,241,24,24,0
8,20,242,16,15,1
8,20,243,19,6,13
8,20,244,20,6,14
8,20,245,13,12,1
8,20,246,19,19,0
8,20,247,24,11,13
8,20,248,18,8,10
8,20,249,13,9,4
8,20,250,7,8,-1
8,20,251,15,7,8
8,20,252,25,13,12
8,20,253,18,6,12
8,20,254,26,14,12
8,20,255,22,12,10
8,20,256,27,14,13
8,20,257,27,16,11
8,20,258,17,15,2
8,20,259,26,18,8
8,20,260,6,7,-1
8,20,261,16,0,16
8,20,262,24,14,10
8,20,263,20,12,8
8,20,264,21,18,3
8,20,265,24,11,13
8,20,266,28,10,18
8,20,267,13,7,6
8,20,268,8,12,-4
8,20,269,11,20,-9
8,20,270,13,13,0
8,20,271,9,15,-6
8,20,272,17,12,5
8,20,273,12,3,9
8,20,274,17,17,0
8,20,275,31,13,18
8,20,276,12,6,6
8,20,277,3,4,-1
8,20,278,12,2,10
8,20,279,10,4,6
8,20,280,18,11,7
8,20,281,7,7,0
8,20,282,8,4,4
8,20,283,22,8,14
8,20,284,6,6,0
8,20,285,13,20,-7
8,20,286,18,19,-1
8,20,287,16,11,5
8,20,288,19,9,10
8,20,289,14,9,5
8,20,290,11,22,-11
8,20,291,14,19,-5
8,20,292,11,12,-1
8,20,293,21,16,5
8,20,294,13,5,8
8,20,295,20,13,7
8,20,296,22,9,13
8,20,297,24,18,6
8,20,298,25,21,4
8,20,299,15,9,6
8,21,0,21,12,9
8,21,1,17,14,3
8,21,2,22,19,3
8,21,3,19,8,11
8,21,4,14,8,6
8,21,5,21,12,9
8,21,6,17,10,7
8,21,7,9,8,1
8,21,8,8,7,1
8,21,9,16,19,-3
8,21,10,30,17,13
8,21,11,10,23,-13
8,21,12,29,25,4
8,21,13,30,13,17
8,21,14,20,14,6
8,21,15,12,5,7
8,21,16,16,9,7
8,21,17,15,8,7
8,21,18,20,8,12
8,21,19,12,17,-5
8,21,20,14,14,0
8,21,21,39,15,24
8,21,22,15,17,-2
8,21,23,37,6,31
8,21,24,24,8,16
8,21,25,11,9,2
8,21,26,7,11,-4
8,21,27,10,17,-7
8,21,28,15,9,6
8,21,29,23,20,3
8,21,30,25,13,12
8,21,31,17,11,6
8,21,32,19,6,13
8,21,33,18,8,10
8,21,34,10,8,2
8,21,35,28,14,14
8,21,36,11,9,2
8,21,37,19,10,9
8,21,38,25,6,19
8,21,39,24,31,-7
8,21,40,27,18,9
8,21,41,23,12,11
8,21,42,14,4,10
8,21,43,15,16,-1
8,21,44,13,12,1
8,21,45,16,12,4
8,21,46,9,5,4
8,21,47,13,7,6
8,21,48,24,12,12
8,21,49,15,5,10
8,21,50,27,8,19
8,21,51,4,15,-11
8,21,52,18,15,3
8,21,53,11,7,4
8,21,54,12,12,0
8,21,55,15,8,7
8,21,56,29,21,8
8,21,57,16,18,-2
8,21,58,17,5,12
8,21,59,32,7,25
8,21,60,16,8,8
8,21,61,17,9,8
8,21,62,15,14,1
8,21,63,11,9,2
8,21,64,16,10,6
8,21,65,24,11,13
8,21,66,25,10,15
8,21,67,8,15,-7
8,21,68,13,9,4
8,21,69,6,10,-4
8,21,70,16,20,-4
8,21,71,25,14,11
8,21,72,6,4,2
8,21,73,17,14,3
8,21,74,16,15,1
8,21,75,23,6,17
8,21,76,35,15,20
8,21,77,19,16,3
8,21,78,18,6,12
8,21,79,16,6,10
8,21,80,4,11,-7
8,21,81,21,15,6
8,21,82,20,11,9
8,21,83,22,37,-15
8,21,84,19,22,-3
8,21,85,18,25,-7
8,21,86,16,10,6
8,21,87,22,10,12
8,21,88,18,9,9
8,21,89,28,5,23
8,21,90,17,17,0
8,21,91,15,12,3
8,21,92,20,9,11
8,21,93,23,7,16
8,21,94,12,6,6
8,21,95,21,17,4
8,21,96,18,6,12
8,21,97,27,19,8
8,21,98,9,14,-5
8,21,99,30,22,8
8,21,100,23,19,4
8,21,101,12,8,4
8,21,102,16,19,-3
8,21,103,27,19,8
8,21,104,7,8,-1
8,21,105,26,5,21
8,21,106,16,14,2
8,21,107,13,12,1
8,21,108,15,10,5
8,21,109,13,5,8
8,21,110,10,9,1
8,21,111,29,7,22
8,21,112,11,12,-1
8,21,113,15,4,11
8,21,114,24,8,16
8,21,115,20,12,8
8,21,116,17,12,5
8,21,117,18,11,7
8,21,118,28,14,14
8,21,119,30,29,1
8,21,120,15,20,-5
8,21,121,29,6,23
8,21,122,8,12,-4
8,21,123,13,5,8
8,21,124,28,12,16
8,21,125,19,17,2
8,21,126,17,5,12
8,21,127,22,12,10
8,21,128,23,12,11
8,21,129,32,16,16
8,21,130,14,10,4
8,21,131,27,15,12
8,21,132,33,7,26
8,21,133,19,9,10
8,21,134,15,12,3
8,21,135,9,8,1
8,21,136,24,16,8
8,21,137,18,11,7
8,21,138,26,11,15
8,21,139,8,9,-1
8,21,140,23,18,5
8,21,141,31,22,9
8,21,142,19,9,10
8,21,143,18,19,-1
8,21,144,12,12,0
8,21,145,22,20,2
8,21,146,22,16,6
8,21,147,23,16,7
8,21,148,7,1,6
8,21,149,30,14,16
8,21,150,24,12,12
8,21,151,17,31,-14
8,21,152,22,17,5
8,21,153,10,16,-6
8,21,154,12,8,4
8,21,155,36,9,27
8,21,156,15,16,-1
8,21,157,17,17,0
8,21,158,15,17,-2
8,21,159,19,15,4
8,21,160,11,13,-2
8,21,161,36,13,23
8,21,162,36,25,11
8,21,163,13,10,3
8,21,164,16,8,8
8,21,165,14,15,-1
8,21,166,16,16,0
8,21,167,16,15,1
8,21,168,15,17,-2
8,21,169,12,6,6
8,21,170,24,16,8
8,21,171,10,3,7
8,21,172,26,13,13
8,21,173,20,7,13
8,21,174,31,11,20
8,21,175,16,10,6
8,21,176,20,18,2
8,21,177,9,10,-1
8,21,178,28,10,18
8,21,179,22,8,14
8,21,180,11,7,4
8,21,181,14,13,1
8,21,182,18,8,10
8,21,183,14,13,1
8,21,184,17,12,5
8,21,185,10,13,-3
8,21,186,21,7,14
8,21,187,9,15,-6
8,21,188,25,20,5
8,21,189,14,9,5
8,21,190,11,14,-3
8,21,191,11,9,2
8,21,192,24,10,14
8,21,193,20,22,-2
8,21,194,24,6,18
8,21,195,24,13,11
8,21,196,20,14,6
8,21,197,21,33,-12
8,21,198,32,19,13
8,21,199,9,10,-1
8,21,200,5,8,-3
8,21,201,13,19,-6
8,21,202,14,7,7
8,21,203,15,8,7
8,21,204,15,12,3
8,21,205,24,15,9
8,21,206,21,11,10
8,21,207,19,14,5
8,21,208,25,15,10
8,21,209,16,13,3
8,21,210,20,9,11
8,21,211,16,5,11
8,21,212,18,9,9
8,21,213,11,3,8
8,21,214,21,12,9
8,21,215,13,13,0
8,21,216,26,9,17
8,21,217,15,13,2
8,21,218,12,11,1
8,21,219,23,10,13
8,21,220,26,19,7
8,21,221,17,14,3
8,21,222,21,8,13
8,21,223,14,13,1
8,21,224,6,14,-8
8,21,225,27,17,10
8,21,226,12,15,-3
8,21,227,14,7,7
8,21,228,28,16,12
8,21,229,2,7,-5
8,21,230,19,8,11
8,21,231,18,10,8
8,21,232,12,9,3
8,21,233,16,15,1
8,21,234,13,15,-2
8,21,235,18,12,6
8,21,236,19,10,9
8,21,237,22,14,8
8,21,238,21,3,18
8,21,239,21,16,5
8,21,240,20,13,7
8,21,241,14,15,-1
8,21,242,21,16,5
8,21,243,23,18,5
8,21,244,17,18,-1
8,21,245,9,5,4
8,21,246,16,22,-6
8,21,247,10,17,-7
8,21,248,25,16,9
8,21,249,18,6,12
8,21,250,14,19,-5
8,21,251,11,19,-8
8,21,252,21,12,9
8,21,253,18,4,14
8,21,254,14,10,4
8,21,255,18,9,9
8,21,256,17,9,8
8,21,257,13,14,-1
8,21,258,15,7,8
8,21,259,26,17,9
8,21,260,27,17,10
8,21,261,18,8,10
8,21,262,15,12,3
8,21,263,33,14,19
8,21,264,21,14,7
8,21,265,10,8,2
8,21,266,30,16,14
8,21,267,16,13,3
8,21,268,32,18,14
8,21,269,23,10,13
8,21,270,11,7,4
8,21,271,18,13,5
8,21,272,13,14,-1
8,21,273,27,12,15
8,21,274,18,7,11
8,21,275,17,16,1
8,21,276,18,11,7
8,21,277,15,8,7
8,21,278,21,6,15
8,21,279,17,10,7
8,21,280,30,12,18
8,21,281,24,18,6
8,21,282,21,13,8
8,21,283,19,5,14
8,21,284,9,7,2
8,21,285,21,20,1
8,21,286,15,7,8
8,21,287,15,18,-3
8,21,288,16,7,9
8,21,289,14,9,5
8,21,290,18,9,9
8,21,291,23,13,10
8,21,292,17,8,9
8,21,293,18,6,12
8,21,294,14,10,4
8,21,295,15,13,2
8,21,296,25,10,15
8,21,297,21,12,9
8,21,298,12,7,5
8,21,299,6,6,0
8,22,0,17,11,6
8,22,1,18,11,7
8,22,2,24,16,8
8,22,3,22,16,6
8,22,4,20,12,8
8,22,5,10,7,3
8,22,6,29,22,7
8,22,7,13,6,7
8,22,8,28,9,19
8,22,9,23,9,14
8,22,10,17,20,-3
8,22,11,22,14,8
8,22,12,17,6,11
8,22,13,19,10,9
8,22,14,18,22,-4
8,22,15,16,6,10
8,22,16,13,4,9
8,22,17,23,17,6
8,22,18,9,10,-1
8,22,19,15,12,3
8,22,20,21,13,8
8,22,21,20,4,16
8,22,22,10,14,-4
8,22,23,24,12,12
8,22,24,25,11,14
8,22,25,22,10,12
8,22,26,29,8,21
8,22,27,13,5,8
8,22,28,23,13,10
8,22,29,18,10,8
8,22,30,24,8,16
8,22,31,26,10,16
8,22,32,19,5,14
8,22,33,18,13,5
8,22,34,22,21,1
8,22,35,11,2,9
8,22,36,10,11,-1
8,22,37,17,13,4
8,22,38,8,12,-4
8,22,39,10,7,3
8,22,40,11,6,5
8,22,41,10,8,2
8,22,42,25,18,7
8,22,43,11,10,1
8,22,44,20,18,2
8,22,45,28,15,13
8,22,46,21,10,11
8,22,47,26,11,15
8,22,48,8,9,-1
8,22,49,12,3,9
8,22,50,24,19,5
8,22,51,17,16,1
8,22,52,22,13,9
8,22,53,23,9,14
8,22,54,16,22,-6
8,22,55,15,11,4
8,22,56,20,11,9
8,22,57,13,15,-2
8,22,58,12,11,1
8,22,59,20,15,5
8,22,60,7,4,3
8,22,61,24,14,10
8,22,62,17,5,12
8,22,63,4,11,-7
8,22,64,26,12,14
8,22,65,33,9,24
8,22,66,9,6,3
8,22,67,17,7,10
8,22,68,23,12,11
8,22,69,27,13,14
8,22,70,22,6,16
8,22,71,13,11,2
8,22,72,18,3,15
8,22,73,17,4,13
8,22,74,19,8,11
8,22,75,15,13,2
8,22,76,6,10,-4
8,22,77,11,7,4
8,22,78,14,18,-4
8,22,79,17,17,0
8,22,80,16,16,0
8,22,81,32,12,20
8,22,82,14,8,6
8,22,83,13,20,-7
8,22,84,20,8,12
8,22,85,19,14,5
8,22,86,17,12,5
8,22,87,16,12,4
8,22,88,14,8,6
8,22,89,3,3,0
8,22,90,12,2,10
8,22,91,19,15,4
8,22,92,14,12,2
8,22,93,15,15,0
8,22,94,13,6,7
8,22,95,10,9,1
8,22,96,10,9,1
8,22,97,25,21,4
8,22,98,31,15,16
8,22,99,9,12,-3
8,22,100,19,7,12
8,22,101,17,16,1
8,22,102,28,4,24
8,22,103,31,22,9
8,22,104,12,4,8
8,22,105,21,11,10
8,22,106,28,22,6
8,22,107,16,10,6
8,22,108,9,1,8
8,22,109,20,18,2
8,22,110,17,20,-3
8,22,111,23,17,6
8,22,112,16,12,4
8,22,113,27,13,14
8,22,114,18,14,4
8,22,115,24,11,13
8,22,116,12,14,-2
8,22,117,10,5,5
8,22,118,20,16,4
8,22,119,10,4,6
8,22,120,19,4,15
8,22,121,27,10,17
8,22,122,11,22,-11
8,22,123,30,9,21
8,22,124,18,4,14
8,22,125,21,26,-5
8,22,126,19,8,11
8,22,127,14,3,11
8,22,128,9,9,0
8,22,129,22,5,17
8,22,130,5,15,-10
8,22,131,10,5,5
8,22,132,18,19,-1
8,22,133,27,20,7
8,22,134,17,16,1
8,22,135,13,18,-5
8,22,136,20,24,-4
8,22,137,26,23,3
8,22,138,6,1,5
8,22,139,16,11,5
8,22,140,17,13,4
8,22,141,11,9,2
8,22,142,26,10,16
8,22,143,21,12,9
8,22,144,15,11,4
8,22,145,20,12,8
8,22,146,23,18,5
8,22,147,13,11,2
8,22,148,22,9,13
8,22,149,9,5,4
8,22,150,13,16,-3
8,22,151,16,8,8
8,22,152,26,6,20
8,22,153,18,11,7
8,22,154,23,6,17
8,22,155,22,13,9
8,22,156,28,30,-2
8,22,157,18,10,8
8,22,158,30,16,14
8,22,159,23,25,-2
8,22,160,17,5,12
8,22,161,29,18,11
8,22,162,17,9,8
8,22,163,17,16,1
8,22,164,16,10,6
8,22,165,13,7,6
8,22,166,23,9,14
8,22,167,21,14,7
8,22,168,11,16,-5
8,22,169,12,14,-2
8,22,170,24,2,22
8,22,171,16,19,-3
8,22,172,22,9,13
8,22,173,28,16,12
8,22,174,5,11,-6
8,22,175,18,20,-2
8,22,176,9,8,1
8,22,177,25,4,21
8,22,178,19,7,12
8,22,179,22,12,10
8,22,180,16,6,10
8,22,181,23,11,12
8,22,182,18,17,1
8,22,183,24,6,18
8,22,184,21,8,13
8,22,185,17,10,7
8,22,186,17,13,4
8,22,187,24,13,11
8,22,188,22,33,-11
8,22,189,22,13,9
8,22,190,18,11,7
8,22,191,26,17,9
8,22,192,17,13,4
8,22,193,26,14,12
8,22,194,19,20,-1
8,22,195,17,20,-3
8,22,196,13,18,-5
8,22,197,24,7,17
8,22,198,24,16,8
8,22,199,14,7,7
8,22,200,18,9,9
8,22,201,18,13,5
8,22,202,15,15,0
8,22,203,12,17,-5
8,22,204,22,11,11
8,22,205,18,11,7
8,22,206,25,13,12
8,22,207,28,12,16
8,22,208,27,23,4
8,22,209,28,23,5
8,22,210,17,2,15
8,22,211,34,13,21
8,22,212,29,16,13
8,22,213,21,13,8
8,22,214,10,12,-2
8,22,215,9,13,-4
8,22,216,29,15,14
8,22,217,21,13,8
8,22,218,7,7,0
8,22,219,21,8,13
8,22,220,17,15,2
8,22,221,10,8,2
8,22,222,11,13,-2
8,22,223,16,13,3
8,22,224,15,9,6
8,22,225,22,5,17
8,22,226,14,13,1
8,22,227,14,15,-1
8,22,228,12,14,-2
8,22,229,11,10,1
8,22,230,21,11,10
8,22,231,23,10,13
8,22,232,11,14,-3
8,22,233,21,5,16
8,22,234,19,14,5
8,22,235,34,11,23
8,22,236,16,7,9
8,22,237,18,11,7
8,22,238,29,14,15
8,22,239,25,18,7
8,22,240,19,12,7
8,22,241,19,19,0
8,22,242,19,12,7
8,22,243,15,7,8
8,22,244,29,15,14
8,22,245,10,9,1
8,22,246,30,11,19
8,22,247,17,17,0
8,22,248,24,13,11
8,22,249,20,14,6
8,22,250,24,19,5
8,22,251,14,12,2
8,22,252,12,3,9
8,22,253,33,16,17
8,22,254,8,9,-1
8,22,255,20,15,5
8,22,256,21,12,9
8,22,257,29,17,12
8,22,258,24,14,10
8,22,259,22,16,6
8,22,260,29,10,19
8,22,261,32,13,19
8,22,262,19,14,5
8,22,263,36,18,18
8,22,264,15,13,2
8,22,265,12,4,8
8,22,266,22,27,-5
8,22,267,9,17,-8
8,22,268,24,13,11
8,22,269,18,11,7
8,22,270,14,14,0
8,22,271,22,6,16
8,22,272,17,13,4
8,22,273,21,11,10
8,22,274,3,3,0
8,22,275,22,8,14
8,22,276,7,15,-8
8,22,277,27,14,13
8,22,278,15,5,10
8,22,279,11,13,-2
8,22,280,18,9,9
8,22,281,16,12,4
8,22,282,16,21,-5
8,22,283,16,8,8
8,22,284,24,11,13
8,22,285,43,20,23
8,22,286,22,8,14
8,22,287,17,13,4
8,22,288,10,3,7
8,22,289,21,9,12
8,22,290,15,13,2
8,22,291,13,8,5
8,22,292,11,8,3
8,22,293,22,10,12
8,22,294,14,7,7
8,22,295,10,14,-4
8,22,296,26,13,13
8,22,297,13,8,5
8,22,298,21,9,12
8,22,299,13,13,0
8,23,0,8,4,4
8,23,1,23,16,7
8,23,2,15,20,-5
8,23,3,29,15,14
8,23,4,13,16,-3
8,23,5,12,13,-1
8,23,6,12,22,-10
8,23,7,24,15,9
8,23,8,23,9,14
8,23,9,11,1,10
8,23,10,26,9,17
8,23,11,30,13,17
8,23,12,22,6,16
8,23,13,31,15,16
8,23,14,26,14,12
8,23,15,21,10,11
8,23,16,19,8,11
8,23,17,14,20,-6
8,23,18,25,12,13
8,23,19,17,8,9
8,23,20,11,6,5
8,23,21,14,9,5
8,23,22,17,14,3
8,23,23,19,12,7
8,23,24,26,14,12
8,23,25,6,11,-5
8,23,26,15,12,3
8,23,27,10,13,-3
8,23,28,19,16,3
8,23,29,24,6,18
8,23,30,25,13,12
8,23,31,16,14,2
8,23,32,13,21,-8
8,23,33,22,8,14
8,23,34,32,9,23
8,23,35,13,5,8
8,23,36,19,4,15
8,23,37,21,14,7
8,23,38,24,6,18
8,23,39,25,15,10
8,23,40,25,14,11
8,23,41,18,10,8
8,23,42,18,13,5
8,23,43,7,6,1
8,23,44,26,15,11
8,23,45,13,13,0
8,23,46,25,19,6
8,23,47,26,18,8
8,23,48,25,12,13
8,23,49,11,14,-3
8,23,50,21,18,3
8,23,51,29,9,20
8,23,52,35,19,16
8,23,53,25,19,6
8,23,54,6,7,-1
8,23,55,19,22,-3
8,23,56,5,1,4
8,23,57,20,18,2
8,23,58,20,13,7
8,23,59,30,13,17
8,23,60,18,24,-6
8,23,61,13,6,7
8,23,62,24,18,6
8,23,63,20,6,14
8,23,64,18,14,4
8,23,65,24,8,16
8,23,66,38,12,26
8,23,67,19,3,16
8,23,68,21,15,6
8,23,69,12,10,2
8,23,70,26,16,10
8,23,71,20,12,8
8,23,72,21,4,17
8,23,73,36,16,20
8,23,74,22,18,4
8,23,75,10,14,-4
8,23,76,26,17,9
8,23,77,22,15,7
8,23,78,24,11,13
8,23,79,18,16,2
8,23,80,32,16,16
8,23,81,30,8,22
8,23,82,16,17,-1
8,23,83,21,11,10
8,23,84,17,3,14
8,23,85,20,13,7
8,23,86,31,16,15
8,23,87,21,13,8
8,23,88,23,17,6
8,23,89,25,24,1
8,23,90,22,12,10
8,23,91,15,5,10
8,23,92,19,8,11
8,23,93,24,17,7
8,23,94,17,9,8
8,23,95,19,12,7
8,23,96,24,15,9
8,23,97,6,2,4
8,23,98,27,13,14
8,23,99,12,16,-4
8,23,100,21,8,13
8,23,101,23,20,3
8,23,102,26,8,18
8,23,103,14,20,-6
8,23,104,18,27,-9
8,23,105,22,17,5
8,23,106,21,3,18
8,23,107,29,20,9
8,23,108,17,7,10
8,23,109,26,10,16
8,23,110,9,7,2
8,23,111,22,9,13
8,23,112,34,16,18
8,23,113,12,6,6
8,23,114,15,12,3
8,23,115,23,10,13
8,23,116,17,2,15
8,23,117,13,15,-2
8,23,118,24,8,16
8,23,119,25,11,14
8,23,120,26,14,12
8,23,121,14,12,2
8,23,122,14,15,-1
8,23,123,17,14,3
8,23,124,24,7,17
8,23,125,17,10,7
8,23,126,24,12,12
8,23,127,19,16,3
8,23,128,11,17,-6
8,23,129,17,11,6
8,23,130,23,16,7
8,23,131,17,13,4
8,23,132,12,1,11
8,23,133,33,16,17
8,23,134,29,16,13
8,23,135,17,9,8
8,23,136,14,4,10
8,23,137,34,16,18
8,23,138,29,11,18
8,23,139,26,16,10
8,23,140,22,3,19
8,23,141,20,12,8
8,23,142,13,8,5
8,23,143,9,13,-4
8,23,144,11,18,-7
8,23,145,15,7,8
8,23,146,24,9,15
8,23,147,8,19,-11
8,23,148,24,19,5
8,23,149,13,16,-3
8,23,150,20,9,11
8,23,151,33,10,23
8,23,152,34,6,28
8,23,153,8,13,-5
8,23,154,19,12,7
8,23,155,7,2,5
8,23,156,16,15,1
8,23,157,31,14,17
8,23,158,12,17,-5
8,23,159,14,13,1
8,23,160,11,18,-7
8,23,161,22,12,10
8,23,162,17,15,2
8,23,163,33,13,20
8,23,164,24,15,9
8,23,165,23,8,15
8,23,166,26,9,17
8,23,167,25,11,14
8,23,168,17,13,4
8,23,169,25,7,18
8,23,170,32,18,14
8,23,171,29,37,-8
8,23,172,25,21,4
8,23,173,17,10,7
8,23,174,15,15,0
8,23,175,24,6,18
8,23,176,20,12,8
8,23,177,18,7,11
8,23,178,19,9,10
8,23,179,35,19,16
8,23,180,16,14,2
8,23,181,15,7,8
8,23,182,40,22,18
8,23,183,21,13,8
8,23,184,12,6,6
8,23,185,12,19,-7
8,23,186,19,5,14
8,23,187,24,7,17
8,23,188,23,11,12
8,23,189,22,21,1
8,23,190,27,6,21
8,23,191,31,7,24
8,23,192,20,7,13
8,23,193,16,10,6
8,23,194,26,21,5
8,23,195,16,14,2
8,23,196,12,14,-2
8,23,197,7,5,2
8,23,198,8,5,3
8,23,199,18,11,7
8,23,200,13,8,5
8,23,201,16,13,3
8,23,202,7,10,-3
8,23,203,8,1,7
8,23,204,27,12,15
8,23,205,19,17,2
8,23,206,27,12,15
8,23,207,23,23,0
8,23,208,27,6,21
8,23,209,8,7,1
8,23,210,9,16,-7
8,23,211,24,7,17
8,23,212,23,15,8
8,23,213,15,13,2
8,23,214,12,9,3
8,23,215,23,11,12
8,23,216,8,10,-2
8,23,217,13,11,2
8,23,218,13,9,4
8,23,219,21,13,8
8,23,220,14,16,-2
8,23,221,29,13,16
8,23,222,9,9,0
8,23,223,18,1,17
8,23,224,22,19,3
8,23,225,27,10,17
8,23,226,22,19,3
8,23,227,7,12,-5
8,23,228,16,12,4
8,23,229,18,8,10
8,23,230,20,7,13
8,23,231,15,12,3
8,23,232,12,15,-3
8,23,233,25,7,18
8,23,234,25,13,12
8,23,235,38,20,18
8,23,236,20,24,-4
8,23,237,23,13,10
8,23,238,21,24,-3
8,23,239,13,11,2
8,23,240,21,6,15
8,23,241,13,11,2
8,23,242,19,9,10
8,23,243,8,15,-7
8,23,244,21,5,16
8,23,245,21,2,19
8,23,246,25,9,16
8,23,247,14,9,5
8,23,248,7,12,-5
8,23,249,26,14,12
8,23,250,20,7,13
8,23,251,11,11,0
8,23,252,24,17,7
8,23,253,23,6,17
8,23,254,20,9,11
8,23,255,18,9,9
8,23,256,22,6,16
8,23,257,21,8,13
8,23,258,26,13,13
8,23,259,17,5,12
8,23,260,19,12,7
8,23,261,19,9,10
8,23,262,24,18,6
8,23,263,22,12,10
8,23,264,23,19,4
8,23,265,18,14,4
8,23,266,15,8,7
8,23,267,18,4,14
8,23,268,26,17,9
8,23,269,34,16,18
8,23,270,22,9,13
8,23,271,22,12,10
8,23,272,10,13,-3
8,23,273,25,4,21
8,23,274,12,7,5
8,23,275,21,25,-4
8,23,276,20,10,10
8,23,277,19,9,10
8,23,278,39,21,18
8,23,279,22,17,5
8,23,280,16,14,2
8,23,281,14,19,-5
8,23,282,13,8,5
8,23,283,27,27,0
8,23,284,17,13,4
8,23,285,16,9,7
8,23,286,19,13,6
8,23,287,31,28,3
8,23,288,18,7,11
8,23,289,15,18,-3
8,23,290,18,10,8
8,23,291,16,8,8
8,23,292,19,10,9
8,23,293,32,19,13
8,23,294,14,16,-2
8,23,295,17,13,4
8,23,296,20,5,15
8,23,297,15,7,8
8,23,298,22,18,4
8,23,299,36,17,19
8,24,0,24,16,8
8,24,1,16,7,9
8,24,2,15,16,-1
8,24,3,11,11,0
8,24,4,12,17,-5
8,24,5,16,15,1
8,24,6,26,14,12
8,24,7,12,9,3
8,24,8,24,13,11
8,24,9,6,9,-3
8,24,10,14,8,6
8,24,11,26,7,19
8,24,12,6,6,0
8,24,13,23,14,9
8,24,14,26,13,13
8,24,15,20,8,12
8,24,16,16,7,9
8,24,17,16,18,-2
8,24,18,18,4,14
8,24,19,13,8,5
8,24,20,27,11,16
8,24,21,23,8,15
8,24,22,22,8,14
8,24,23,16,3,13
8,24,24,25,21,4
8,24,25,30,15,15
8,24,26,19,8,11
8,24,27,29,10,19
8,24,28,12,11,1
8,24,29,12,8,4
8,24,30,13,8,5
8,24,31,19,4,15
8,24,32,13,5,8
8,24,33,26,7,19
8,24,34,18,18,0
8,24,35,28,17,11
8,24,36,24,17,7
8,24,37,1,4,-3
8,24,38,7,6,1
8,24,39,18,14,4
8,24,40,23,12,11
8,24,41,24,13,11
8,24,42,27,26,1
8,24,43,18,25,-7
8,24,44,25,17,8
8,24,45,23,25,-2
8,24,46,20,15,5
8,24,47,26,16,10
8,24,48,17,10,7
8,24,49,16,9,7
8,24,50,37,21,16
8,24,51,24,25,-1
8,24,52,14,12,2
8,24,53,27,13,14
8,24,54,31,5,26
8,24,55,5,4,1
8,24,56,32,8,24
8,24,57,23,14,9
8,24,58,26,19,7
8,24,59,17,5,12
8,24,60,16,16,0
8,24,61,22,21,1
8,24,62,27,7,20
8,24,63,24,12,12
8,24,64,19,11,8
8,24,65,13,5,8
8,24,66,13,4,9
8,24,67,15,8,7
8,24,68,27,16,11
8,24,69,14,9,5
8,24,70,12,13,-1
8,24,71,20,23,-3
8,24,72,24,16,8
8,24,73,10,7,3
8,24,74,22,7,15
8,24,75,15,12,3
8,24,76,30,17,13
8,24,77,28,23,5
8,24,78,25,18,7
8,24,79,12,3,9
8,24,80,21,17,4
8,24,81,12,20,-8
8,24,82,17,11,6
8,24,83,27,10,17
8,24,84,22,23,-1
8,24,85,16,11,5
8,24,86,20,10,10
8,24,87,24,10,14
8,24,88,17,10,7
8,24,89,17,14,3
8,24,90,33,17,16
8,24,91,42,14,28
8,24,92,13,14,-1
8,24,93,28,11,17
8,24,94,17,14,3
8,24,95,26,20,6
8,24,96,24,12,12
8,24,97,12,7,5
8,24,98,14,10,4
8,24,99,19,20,-1
8,24,100,15,8,7
8,24,101,18,9,9
8,24,102,17,6,11
8,24,103,11,7,4
8,24,104,38,25,13
8,24,105,16,5,11
8,24,106,25,18,7
8,24,107,23,21,2
8,24,108,19,15,4
8,24,109,12,5,7
8,24,110,17,3,14
8,24,111,28,9,19
8,24,112,13,7,6
8,24,113,21,4,17
8,24,114,6,2,4
8,24,115,17,17,0
8,24,116,22,16,6
8,24,117,26,9,17
8,24,118,11,10,1
8,24,119,23,14,9
8,24,120,12,10,2
8,24,121,21,15,6
8,24,122,21,10,11
8,24,123,25,20,5
8,24,124,11,23,-12
8,24,125,8,5,3
8,24,126,24,17,7
8,24,127,26,9,17
8,24,128,31,21,10
8,24,129,17,15,2
8,24,130,14,13,1
8,24,131,20,24,-4
8,24,132,15,8,7
8,24,133,22,17,5
8,24,134,23,12,11
8,24,135,26,12,14
8,24,136,18,13,5
8,24,137,23,28,-5
8,24,138,15,5,10
8,24,139,22,17,5
8,24,140,17,11,6
8,24,141,28,16,12
8,24,142,19,13,6
8,24,143,20,7,13
8,24,144,22,7,15
8,24,145,4,11,-7
8,24,146,21,3,18
8,24,147,21,13,8
8,24,148,23,9,14
8,24,149,24,7,17
8,24,150,18,16,2
8,24,151,22,12,10
8,24,152,14,8,6
8,24,153,12,13,-1
8,24,154,15,12,3
8,24,155,12,9,3
8,24,156,12,5,7
8,24,157,36,19,17
8,24,158,9,4,5
8,24,159,27,14,13
8,24,160,21,12,9
8,24,161,8,6,2
8,24,162,19,8,11
8,24,163,37,25,12
8,24,164,27,10,17
8,24,165,14,8,6
8,24,166,22,15,7
8,24,167,16,10,6
8,24,168,25,8,17
8,24,169,19,4,15
8,24,170,17,15,2
8,24,171,25,8,17
8,24,172,21,14,7
8,24,173,35,24,11
8,24,174,17,7,10
8,24,175,13,9,4
8,24,176,18,3,15
8,24,177,16,12,4
8,24,178,13,7,6
8,24,179,17,12,5
8,24,180,10,12,-2
8,24,181,17,18,-1
8,24,182,14,13,1
8,24,183,16,10,6
8,24,184,9,26,-17
8,24,185,19,20,-1
8,24,186,16,13,3
8,24,187,19,10,9
8,24,188,27,14,13
8,24,189,23,8,15
8,24,190,23,14,9
8,24,191,21,15,6
8,24,192,16,10,6
8,24,193,14,11,3
8,24,194,11,8,3
8,24,195,11,9,2
8,24,196,16,11,5
8,24,197,16,22,-6
8,24,198,22,18,4
8,24,199,17,11,6
8,24,200,26,8,18
8,24,201,18,7,11
8,24,202,11,4,7
8,24,203,21,15,6
8,24,204,12,5,7
8,24,205,18,8,10
8,24,206,9,13,-4
8,24,207,10,10,0
8,24,208,11,9,2
8,24,209,17,18,-1
8,24,210,9,18,-9
8,24,211,10,6,4
8,24,212,10,2,8
8,24,213,4,4,0
8,24,214,8,4,4
8,24,215,8,11,-3
8,24,216,23,9,14
8,24,217,23,17,6
8,24,218,13,10,3
8,24,219,9,19,-10
8,24,220,19,14,5
8,24,221,9,10,-1
8,24,222,14,16,-2
8,24,223,29,12,17
8,24,224,13,16,-3
8,24,225,24,10,14
8,24,226,6,4,2
8,24,227,29,8,21
8,24,228,20,4,16
8,24,229,25,9,16
8,24,230,28,19,9
8,24,231,15,11,4
8,24,232,16,2,14
8,24,233,12,15,-3
8,24,234,20,24,-4
8,24,235,30,11,19
8,24,236,27,13,14
8,24,237,12,8,4
8,24,238,20,6,14
8,24,239,21,7,14
8,24,240,9,9,0
8,24,241,13,12,1
8,24,242,19,12,7
8,24,243,20,16,4
8,24,244,19,11,8
8,24,245,12,6,6
8,24,246,22,7,15
8,24,247,13,5,8
8,24,248,25,19,6
8,24,249,30,13,17
8,24,250,14,15,-1
8,24,251,26,15,11
8,24,252,13,17,-4
8,24,253,23,14,9
8,24,254,17,19,-2
8,24,255,18,6,12
8,24,256,12,3,9
8,24,257,9,6,3
8,24,258,27,10,17
8,24,259,29,9,20
8,24,260,25,5,20
8,24,261,18,7,11
8,24,262,24,10,14
8,24,263,14,8,6
8,24,264,19,18,1
8,24,265,31,20,11
8,24,266,18,9,9
8,24,267,10,4,6
8,24,268,16,24,-8
8,24,269,27,22,5
8,24,270,11,12,-1
8,24,271,16,13,3
8,24,272,31,11,20
8,24,273,25,6,19
8,24,274,19,17,2
8,24,275,12,3,9
8,24,276,28,16,12
8,24,277,11,17,-6
8,24,278,31,22,9
8,24,279,21,9,12
8,24,280,24,10,14
8,24,281,20,7,13
8,24,282,18,5,13
8,24,283,21,11,10
8,24,284,15,10,5
8,24,285,17,14,3
8,24,286,16,6,10
8,24,287,16,12,4
8,24,288,26,19,7
8,24,289,16,4,12
8,24,290,17,11,6
8,24,291,18,14,4
8,24,292,4,12,-8
8,24,293,18,13,5
8,24,294,19,10,9
8,24,295,15,9,6
8,24,296,3,13,-10
8,24,297,9,5,4
8,24,298,14,14,0
8,24,299,19,12,7
8,25,0,16,8,8
8,25,1,21,21,0
8,25,2,32,26,6
8,25,3,16,13,3
8,25,4,21,6,15
8,25,5,22,10,12
8,25,6,20,15,5
8,25,7,15,6,9
8,25,8,18,7,11
8,25,9,27,10,17
8,25,10,17,13,4
8,25,11,45,14,31
8,25,12,28,11,17
8,25,13,14,6,8
8,25,14,12,8,4
8,25,15,25,17,8
8,25,16,20,10,10
8,25,17,18,10,8
8,25,18,4,14,-10
8,25,19,11,19,-8
8,25,20,14,15,-1
8,25,21,20,13,7
8,25,22,19,14,5
8,25,23,11,3,8
8,25,24,28,23,5
8,25,25,23,16,7
8,25,26,16,6,10
8,25,27,18,12,6
8,25,28,25,14,11
8,25,29,30,23,7
8,25,30,21,7,14
8,25,31,26,18,8
8,25,32,16,13,3
8,25,33,18,14,4
8,25,34,14,11,3
8,25,35,21,20,1
8,25,36,10,12,-2
8,25,37,14,7,7
8,25,38,21,14,7
8,25,39,21,7,14
8,25,40,24,11,13
8,25,41,18,11,7
8,25,42,10,5,5
8,25,43,18,15,3
8,25,44,18,12,6
8,25,45,21,19,2
8,25,46,31,8,23
8,25,47,14,12,2
8,25,48,23,10,13
8,25,49,13,8,5
8,25,50,9,10,-1
8,25,51,28,26,2
8,25,52,19,4,15
8,25,53,18,11,7
8,25,54,17,4,13
8,25,55,30,16,14
8,25,56,19,12,7
8,25,57,28,17,11
8,25,58,19,7,12
8,25,59,18,18,0
8,25,60,10,7,3
8,25,61,15,8,7
8,25,62,21,8,13
8,25,63,14,16,-2
8,25,64,30,15,15
8,25,65,16,13,3
8,25,66,11,12,-1
8,25,67,17,12,5
8,25,68,23,11,12
8,25,69,22,17,5
8,25,70,17,15,2
8,25,71,19,5,14
8,25,72,18,15,3
8,25,73,11,15,-4
8,25,74,16,5,11
8,25,75,18,6,12
8,25,76,13,14,-1
8,25,77,18,14,4
8,25,78,32,12,20
8,25,79,14,1,13
8,25,80,21,13,8
8,25,81,16,14,2
8,25,82,29,9,20
8,25,83,18,17,1
8,25,84,17,9,8
8,25,85,19,10,9
8,25,86,17,8,9
8,25,87,22,7,15
8,25,88,15,6,9
8,25,89,15,15,0
8,25,90,19,24,-5
8,25,91,25,12,13
8,25,92,15,3,12
8,25,93,19,11,8
8,25,94,14,13,1
8,25,95,14,7,7
8,25,96,23,14,9
8,25,97,27,18,9
8,25,98,12,11,1
8,25,99,17,11,6
8,25,100,22,15,7
8,25,101,13,14,-1
8,25,102,25,12,13
8,25,103,18,17,1
8,25,104,15,14,1
8,25,105,15,6,9
8,25,106,17,10,7
8,25,107,11,18,-7
8,25,108,32,10,22
8,25,109,10,7,3
8,25,110,20,12,8
8,25,111,29,15,14
8,25,112,8,11,-3
8,25,113,21,13,8
8,25,114,15,6,9
8,25,115,24,20,4
8,25,116,19,9,10
8,25,117,15,10,5
8,25,118,26,5,21
8,25,119,13,6,7
8,25,120,14,9,5
8,25,121,14,4,10
8,25,122,31,20,11
8,25,123,20,5,15
8,25,124,19,11,8
8,25,125,23,13,10
8,25,126,16,7,9
8,25,127,35,14,21
8,25,128,22,11,11
8,25,129,17,3,14
8,25,130,17,4,13
8,25,131,11,7,4
8,25,132,27,8,19
8,25,133,26,15,11
8,25,134,12,17,-5
8,25,135,12,12,0
8,25,136,17,13,4
8,25,137,12,9,3
8,25,138,26,15,11
8,25,139,17,9,8
8,25,140,17,4,13
8,25,141,22,12,10
8,25,142,16,10,6
8,25,143,7,11,-4
8,25,144,18,9,9
8,25,145,14,6,8
8,25,146,11,14,-3
8,25,147,25,9,16
8,25,148,9,13,-4
8,25,149,8,7,1
8,25,150,11,12,-1
8,25,151,23,12,11
8,25,152,30,18,12
8,25,153,25,15,10
8,25,154,16,14,2
8,25,155,31,7,24
8,25,156,13,10,3
8,25,157,28,11,17
8,25,158,23,8,15
8,25,159,16,14,2
8,25,160,21,12,9
8,25,161,29,8,21
8,25,162,23,18,5
8,25,163,17,17,0
8,25,164,27,23,4
8,25,165,19,7,12
8,25,166,18,12,6
8,25,167,11,5,6
8,25,168,17,13,4
8,25,169,16,27,-11
8,25,170,15,10,5
8,25,171,12,13,-1
8,25,172,10,8,2
8,25,173,6,6,0
8,25,174,22,16,6
8,25,175,13,6,7
8,25,176,34,20,14
8,25,177,22,6,16
8,25,178,9,5,4
8,25,179,13,8,5
8,25,180,36,15,21
8,25,181,19,8,11
8,25,182,17,8,9
8,25,183,30,11,19
8,25,184,20,6,14
8,25,185,8,4,4
8,25,186,17,11,6
8,25,187,12,8,4
8,25,188,25,8,17
8,25,189,7,13,-6
8,25,190,22,15,7
8,25,191,9,8,1
8,25,192,7,12,-5
8,25,193,29,5,24
8,25,194,18,12,6
8,25,195,22,15,7
8,25,196,16,9,7
8,25,197,16,18,-2
8,25,198,21,11,10
8,25,199,29,12,17
8,25,200,30,10,20
8,25,201,23,7,16
8,25,202,26,12,14
8,25,203,17,15,2
8,25,204,10,10,0
8,25,205,22,15,7
8,25,206,16,2,14
8,25,207,30,22,8
8,25,208,22,17,5
8,25,209,19,9,10
8,25,210,11,14,-3
8,25,211,29,11,18
8,25,212,11,8,3
8,25,213,7,11,-4
8,25,214,38,19,19
8,25,215,29,8,21
8,25,216,12,13,-1
8,25,217,18,4,14
8,25,218,9,20,-11
8,25,219,18,13,5
8,25,220,8,9,-1
8,25,221,38,24,14
8,25,222,25,14,11
8,25,223,27,12,15
8,25,224,24,13,11
8,25,225,2,6,-4
8,25,226,14,18,-4
8,25,227,15,10,5
8,25,228,26,14,12
8,25,229,27,8,19
8,25,230,18,8,10
8,25,231,29,17,12
8,25,232,13,5,8
8,25,233,16,12,4
8,25,234,12,10,2
8,25,235,8,5,3
8,25,236,9,4,5
8,25,237,24,10,14
8,25,238,11,7,4
8,25,239,10,14,-4
8,25,240,17,20,-3
8,25,241,20,9,11
8,25,242,7,3,4
8,25,243,27,17,10
8,25,244,21,14,7
8,25,245,30,12,18
8,25,246,22,15,7
8,25,247,21,3,18
8,25,248,9,4,5
8,25,249,13,11,2
8,25,250,13,8,5
8,25,251,21,9,12
8,25,252,28,16,12
8,25,253,34,6,28
8,25,254,8,17,-9
8,25,255,22,14,8
8,25,256,16,18,-2
8,25,257,18,10,8
8,25,258,15,8,7
8,25,259,24,14,10
8,25,260,20,20,0
8,25,261,24,11,13
8,25,262,13,5,8
8,25,263,30,17,13
8,25,264,37,15,22
8,25,265,12,4,8
8,25,266,7,12,-5
8,25,267,24,11,13
8,25,268,10,6,4
8,25,269,10,8,2
8,25,270,18,7,11
8,25,271,29,14,15
8,25,272,38,17,21
8,25,273,15,3,12
8,25,274,19,11,8
8,25,275,27,16,11
8,25,276,18,16,2
8,25,277,19,13,6
8,25,278,22,11,11
8,25,279,17,1,16
8,25,280,16,9,7
8,25,281,28,10,18
8,25,282,25,14,11
8,25,283,30,9,21
8,25,284,17,12,5
8,25,285,12,10,2
8,25,286,23,12,11
8,25,287,11,9,2
8,25,288,16,5,11
8,25,289,25,23,2
8,25,290,12,20,-8
8,25,291,8,11,-3
8,25,292,29,14,15
8,25,293,7,6,1
8,25,294,16,5,11
8,25,295,22,7,15
8,25,296,13,10,3
8,25,297,15,17,-2
8,25,298,13,9,4
8,25,299,16,14,2
8,26,0,18,6,12
8,26,1,35,20,15
8,26,2,12,2,10
8,26,3,32,10,22
8,26,4,18,14,4
8,26,5,19,8,11
8,26,6,31,9,22
8,26,7,18,17,1
8,26,8,22,11,11
8,26,9,17,6,11
8,26,10,21,22,-1
8,26,11,15,4,11
8,26,12,10,6,4
8,26,13,18,14,4
8,26,14,19,7,12
8,26,15,22,9,13
8,26,16,8,6,2
8,26,17,15,8,7
8,26,18,24,7,17
8,26,19,27,15,12
8,26,20,26,9,17
8,26,21,6,9,-3
8,26,22,25,14,11
8,26,23,11,3,8
8,26,24,18,5,13
8,26,25,20,19,1
8,26,26,24,13,11
8,26,27,14,9,5
8,26,28,17,3,14
8,26,29,20,13,7
8,26,30,13,7,6
8,26,31,9,4,5
8,26,32,23,11,12
8,26,33,17,8,9
8,26,34,24,14,10
8,26,35,22,4,18
8,26,36,32,4,28
8,26,37,18,7,11
8,26,38,18,7,11
8,26,39,21,16,5
8,26,40,32,11,21
8,26,41,23,14,9
8,26,42,24,14,10
8,26,43,26,4,22
8,26,44,16,10,6
8,26,45,19,19,0
8,26,46,22,16,6
8,26,47,10,6,4
8,26,48,36,24,12
8,26,49,10,8,2
8,26,50,27,6,21
8,26,51,6,9,-3
8,26,52,21,14,7
8,26,53,23,14,9
8,26,54,9,13,-4
8,26,55,11,16,-5
8,26,56,22,13,9
8,26,57,25,13,12
8,26,58,25,10,15
8,26,59,15,10,5
8,26,60,34,10,24
8,26,61,20,12,8
8,26,62,23,17,6
8,26,63,8,2,6
8,26,64,40,12,28
8,26,65,13,6,7
8,26,66,26,11,15
8,26,67,23,10,13
8,26,68,21,12,9
8,26,69,18,10,8
8,26,70,14,14,0
8,26,71,20,6,14
8,26,72,17,8,9
8,26,73,21,12,9
8,26,74,9,2,7
8,26,75,16,13,3
8,26,76,9,1,8
8,26,77,20,5,15
8,26,78,13,6,7
8,26,79,25,8,17
8,26,80,20,4,16
8,26,81,27,7,20
8,26,82,15,5,10
8,26,83,18,15,3
8,26,84,14,6,8
8,26,85,20,13,7
8,26,86,17,6,11
8,26,87,13,8,5
8,26,88,13,16,-3
8,26,89,17,12,5
8,26,90,12,15,-3
8,26,91,12,10,2
8,26,92,19,15,4
8,26,93,25,6,19
8,26,94,27,14,13
8,26,95,12,13,-1
8,26,96,28,15,13
8,26,97,21,8,13
8,26,98,15,8,7
8,26,99,18,13,5
8,26,100,3,6,-3
8,26,101,14,10,4
8,26,102,27,12,15
8,26,103,15,14,1
8,26,104,16,11,5
8,26,105,36,8,28
8,26,106,15,15,0
8,26,107,26,15,11
8,26,108,14,12,2
8,26,109,17,14,3
8,26,110,20,18,2
8,26,111,18,6,12
8,26,112,14,13,1
8,26,113,13,10,3
8,26,114,27,16,11
8,26,115,16,9,7
8,26,116,22,15,7
8,26,117,14,9,5
8,26,118,14,12,2
8,26,119,23,6,17
8,26,120,11,12,-1
8,26,121,25,13,12
8,26,122,14,7,7
8,26,123,6,14,-8
8,26,124,15,9,6
8,26,125,20,3,17
8,26,126,16,17,-1
8,26,127,23,11,12
8,26,128,26,17,9
8,26,129,15,11,4
8,26,130,26,16,10
8,26,131,23,8,15
8,26,132,13,5,8
8,26,133,29,17,12
8,26,134,19,17,2
8,26,135,18,11,7
8,26,136,27,21,6
8,26,137,18,12,6
8,26,138,25,9,16
8,26,139,34,9,25
8,26,140,15,12,3
8,26,141,17,13,4
8,26,142,11,12,-1
8,26,143,21,14,7
8,26,144,14,18,-4
8,26,145,25,11,14
8,26,146,19,12,7
8,26,147,21,12,9
8,26,148,13,11,2
8,26,149,8,11,-3
8,26,150,10,6,4
8,26,151,15,17,-2
8,26,152,26,4,22
8,26,153,23,6,17
8,26,154,32,5,27
8,26,155,16,5,11
8,26,156,21,16,5
8,26,157,24,17,7
8,26,158,8,6,2
8,26,159,11,6,5
8,26,160,11,7,4
8,26,161,14,17,-3
8,26,162,32,8,24
8,26,163,15,15,0
8,26,164,22,19,3
8,26,165,18,6,12
8,26,166,29,20,9
8,26,167,30,2,28
8,26,168,21,17,4
8,26,169,20,4,16
8,26,170,25,12,13
8,26,171,26,16,10
8,26,172,16,9,7
8,26,173,32,11,21
8,26,174,33,15,18
8,26,175,28,15,13
8,26,176,36,5,31
8,26,177,12,6,6
8,26,178,26,10,16
8,26,179,24,18,6
8,26,180,12,8,4
8,26,181,6,8,-2
8,26,182,13,4,9
8,26,183,18,11,7
8,26,184,27,19,8
8,26,185,16,11,5
8,26,186,21,9,12
8,26,187,30,9,21
8,26,188,19,6,13
8,26,189,20,4,16
8,26,190,15,9,6
8,26,191,20,6,14
8,26,192,24,10,14
8,26,193,29,15,14
8,26,194,10,12,-2
8,26,195,34,27,7
8,26,196,17,3,14
8,26,197,15,16,-1
8,26,198,22,14,8
8,26,199,21,11,10
8,26,200,25,13,12
8,26,201,24,12,12
8,26,202,13,16,-3
8,26,203,20,6,14
8,26,204,18,12,6
8,26,205,23,12,11
8,26,206,18,13,5
8,26,207,16,5,11
8,26,208,29,13,16
8,26,209,9,11,-2
8,26,210,9,5,4
8,26,211,19,15,4
8,26,212,18,13,5
8,26,213,20,6,14
8,26,214,19,10,9
8,26,215,23,15,8
8,26,216,16,4,12
8,26,217,4,3,1
8,26,218,19,6,13
8,26,219,17,9,8
8,26,220,13,16,-3
8,26,221,25,11,14
8,26,222,15,17,-2
8,26,223,15,6,9
8,26,224,22,7,15
8,26,225,23,8,15
8,26,226,17,13,4
8,26,227,33,13,20
8,26,228,23,6,17
8,26,229,32,21,11
8,26,230,21,13,8
8,26,231,23,7,16
8,26,232,30,16,14
8,26,233,22,12,10
8,26,234,32,12,20
8,26,235,13,6,7
8,26,236,25,6,19
8,26,237,13,9,4
8,26,238,18,16,2
8,26,239,18,12,6
8,26,240,14,10,4
8,26,241,22,15,7
8,26,242,18,15,3
8,26,243,32,8,24
8,26,244,20,10,10
8,26,245,19,10,9
8,26,246,18,4,14
8,26,247,24,7,17
8,26,248,28,14,14
8,26,249,31,10,21
8,26,250,18,4,14
8,26,251,20,8,12
8,26,252,19,12,7
8,26,253,17,18,-1
8,26,254,3,18,-15
8,26,255,36,6,30
8,26,256,17,9,8
8,26,257,20,18,2
8,26,258,31,7,24
8,26,259,23,16,7
8,26,260,34,13,21
8,26,261,19,20,-1
8,26,262,21,8,13
8,26,263,16,3,13
8,26,264,5,5,0
8,26,265,14,13,1
8,26,266,13,10,3
8,26,267,21,16,5
8,26,268,12,13,-1
8,26,269,17,7,10
8,26,270,14,5,9
8,26,271,15,15,0
8,26,272,12,12,0
8,26,273,9,13,-4
8,26,274,16,16,0
8,26,275,12,9,3
8,26,276,15,10,5
8,26,277,14,14,0
8,26,278,13,14,-1
8,26,279,23,13,10
8,26,280,18,24,-6
8,26,281,16,7,9
8,26,282,9,4,5
8,26,283,21,8,13
8,26,284,16,14,2
8,26,285,16,24,-8
8,26,286,16,13,3
8,26,287,22,11,11
8,26,288,17,3,14
8,26,289,16,12,4
8,26,290,15,11,4
8,26,291,30,11,19
8,26,292,22,13,9
8,26,293,24,10,14
8,26,294,12,20,-8
8,26,295,12,8,4
8,26,296,8,4,4
8,26,297,20,8,12
8,26,298,17,15,2
8,26,299,29,20,9
8,27,0,29,14,15
8,27,1,17,14,3
8,27,2,13,18,-5
8,27,3,17,6,11
8,27,4,15,11,4
8,27,5,14,11,3
8,27,6,21,9,12
8,27,7,18,8,10
8,27,8,40,18,22
8,27,9,14,9,5
8,27,10,15,14,1
8,27,11,19,3,16
8,27,12,13,8,5
8,27,13,31,10,21
8,27,14,16,9,7
8,27,15,13,9,4
8,27,16,17,17,0
8,27,17,21,13,8
8,27,18,22,6,16
8,27,19,30,13,17
8,27,20,16,8,8
8,27,21,21,13,8
8,27,22,31,13,18
8,27,23,17,17,0
8,27,24,12,10,2
8,27,25,31,17,14
8,27,26,11,17,-6
8,27,27,8,6,2
8,27,28,13,8,5
8,27,29,14,8,6
8,27,30,25,12,13
8,27,31,24,11,13
8,27,32,15,14,1
8,27,33,22,9,13
8,27,34,29,7,22
8,27,35,23,12,11
8,27,36,19,24,-5
8,27,37,26,7,19
8,27,38,17,14,3
8,27,39,13,5,8
8,27,40,22,10,12
8,27,41,22,2,20
8,27,42,16,7,9
8,27,43,15,9,6
8,27,44,22,13,9
8,27,45,24,8,16
8,27,46,12,8,4
8,27,47,15,10,5
8,27,48,18,14,4
8,27,49,6,17,-11
8,27,50,28,8,20
8,27,51,32,13,19
8,27,52,20,7,13
8,27,53,28,14,14
8,27,54,23,8,15
8,27,55,15,14,1
8,27,56,26,13,13
8,27,57,9,8,1
8,27,58,24,7,17
8,27,59,28,3,25
8,27,60,18,8,10
8,27,61,6,6,0
8,27,62,17,12,5
8,27,63,18,15,3
8,27,64,21,12,9
8,27,65,9,11,-2
8,27,66,12,9,3
8,27,67,11,11,0
8,27,68,22,14,8
8,27,69,27,12,15
8,27,70,24,8,16
8,27,71,16,11,5
8,27,72,24,17,7
8,27,73,24,11,13
8,27,74,25,14,11
8,27,75,27,27,0
8,27,76,28,15,13
8,27,77,14,6,8
8,27,78,24,8,16
8,27,79,12,11,1
8,27,80,14,10,4
8,27,81,15,10,5
8,27,82,14,8,6
8,27,83,12,12,0
8,27,84,18,13,5
8,27,85,15,6,9
8,27,86,17,9,8
8,27,87,12,15,-3
8,27,88,19,15,4
8,27,89,9,16,-7
8,27,90,39,19,20
8,27,91,15,21,-6
8,27,92,34,8,26
8,27,93,19,6,13
8,27,94,29,9,20
8,27,95,9,7,2
8,27,96,11,10,1
8,27,97,16,12,4
8,27,98,14,17,-3
8,27,99,7,16,-9
8,27,100,11,13,-2
8,27,101,24,9,15
8,27,102,16,6,10
8,27,103,33,19,14
8,27,104,31,20,11
8,27,105,13,10,3
8,27,106,10,11,-1
8,27,107,24,10,14
8,27,108,25,6,19
8,27,109,9,8,1
8,27,110,22,9,13
8,27,111,25,9,16
8,27,112,30,12,18
8,27,113,13,7,6
8,27,114,22,19,3
8,27,115,11,12,-1
8,27,116,25,12,13
8,27,117,20,12,8
8,27,118,15,8,7
8,27,119,17,14,3
8,27,120,8,2,6
8,27,121,9,3,6
8,27,122,10,9,1
8,27,123,19,12,7
8,27,124,24,8,16
8,27,125,37,17,20
8,27,126,26,10,16
8,27,127,27,19,8
8,27,128,18,13,5
8,27,129,21,4,17
8,27,130,19,11,8
8,27,131,24,13,11
8,27,132,31,10,21
8,27,133,17,12,5
8,27,134,22,13,9
8,27,135,10,8,2
8,27,136,14,14,0
8,27,137,22,16,6
8,27,138,18,12,6
8,27,139,27,14,13
8,27,140,12,9,3
8,27,141,21,14,7
8,27,142,22,15,7
8,27,143,22,17,5
8,27,144,23,9,14
8,27,145,26,9,17
8,27,146,29,7,22
8,27,147,11,12,-1
8,27,148,20,9,11
8,27,149,15,6,9
8,27,150,29,8,21
8,27,151,26,14,12
8,27,152,22,7,15
8,27,153,12,4,8
8,27,154,12,10,2
8,27,155,20,15,5
8,27,156,21,17,4
8,27,157,21,6,15
8,27,158,19,6,13
8,27,159,18,13,5
8,27,160,12,9,3
8,27,161,17,3,14
8,27,162,36,10,26
8,27,163,19,15,4
8,27,164,10,8,2
8,27,165,12,7,5
8,27,166,17,11,6
8,27,167,22,3,19
8,27,168,38,28,10
8,27,169,24,9,15
8,27,170,11,8,3
8,27,171,13,14,-1
8,27,172,29,13,16
8,27,173,22,11,11
8,27,174,23,13,10
8,27,175,31,22,9
8,27,176,18,11,7
8,27,177,16,8,8
8,27,178,22,2,20
8,27,179,31,14,17
8,27,180,12,11,1
8,27,181,23,9,14
8,27,182,30,5,25
8,27,183,24,10,14
8,27,184,19,14,5
8,27,185,21,8,13
8,27,186,11,4,7
8,27,187,34,11,23
8,27,188,18,12,6
8,27,189,15,11,4
8,27,190,24,5,19
8,27,191,21,15,6
8,27,192,14,8,6
8,27,193,21,10,11
8,27,194,8,8,0
8,27,195,20,28,-8
8,27,196,16,11,5
8,27,197,15,11,4
8,27,198,35,12,23
8,27,199,19,17,2
8,27,200,10,12,-2
8,27,201,31,18,13
8,27,202,21,5,16
8,27,203,33,16,17
8,27,204,21,11,10
8,27,205,13,5,8
8,27,206,18,18,0
8,27,207,25,2,23
8,27,208,9,3,6
8,27,209,12,11,1
8,27,210,9,5,4
8,27,211,25,9,16
8,27,212,31,15,16
8,27,213,19,3,16
8,27,214,24,20,4
8,27,215,18,8,10
8,27,216,11,4,7
8,27,217,26,7,19
8,27,218,3,5,-2
8,27,219,21,13,8
8,27,220,15,17,-2
8,27,221,19,13,6
8,27,222,27,15,12
8,27,223,15,6,9
8,27,224,22,11,11
8,27,225,15,12,3
8,27,226,19,10,9
8,27,227,18,27,-9
8,27,228,18,10,8
8,27,229,23,17,6
8,27,230,14,7,7
8,27,231,14,7,7
8,27,232,8,4,4
8,27,233,15,21,-6
8,27,234,15,10,5
8,27,235,12,22,-10
8,27,236,28,10,18
8,27,237,15,8,7
8,27,238,19,6,13
8,27,239,34,5,29
8,27,240,26,14,12
8,27,241,20,15,5
8,27,242,28,18,10
8,27,243,29,10,19
8,27,244,14,12,2
8,27,245,16,5,11
8,27,246,27,12,15
8,27,247,25,7,18
8,27,248,24,12,12
8,27,249,12,7,5
8,27,250,16,3,13
8,27,251,42,13,29
8,27,252,13,10,3
8,27,253,23,10,13
8,27,254,20,11,9
8,27,255,17,10,7
8,27,256,14,7,7
8,27,257,15,10,5
8,27,258,22,13,9
8,27,259,35,17,18
8,27,260,21,6,15
8,27,261,19,10,9
8,27,262,13,7,6
8,27,263,20,12,8
8,27,264,12,8,4
8,27,265,17,4,13
8,27,266,28,6,22
8,27,267,13,10,3
8,27,268,19,10,9
8,27,269,7,8,-1
8,27,270,22,11,11
8,27,271,23,16,7
8,27,272,22,14,8
8,27,273,20,15,5
8,27,274,8,11,-3
8,27,275,28,13,15
8,27,276,34,12,22
8,27,277,26,12,14
8,27,278,9,6,3
8,27,279,14,5,9
8,27,280,27,12,15
8,27,281,17,5,12
8,27,282,15,8,7
8,27,283,12,10,2
8,27,284,14,6,8
8,27,285,30,14,16
8,27,286,21,12,9
8,27,287,23,13,10
8,27,288,16,16,0
8,27,289,28,12,16
8,27,290,14,11,3
8,27,291,21,10,11
8,27,292,10,11,-1
8,27,293,28,5,23
8,27,294,21,10,11
8,27,295,22,10,12
8,27,296,4,9,-5
8,27,297,21,13,8
8,27,298,17,11,6
8,27,299,12,10,2
8,28,0,18,21,-3
8,28,1,19,14,5
8,28,2,19,9,10
8,28,3,14,13,1
8,28,4,27,10,17
8,28,5,23,13,10
8,28,6,13,10,3
8,28,7,17,10,7
8,28,8,12,8,4
8,28,9,16,13,3
8,28,10,20,13,7
8,28,11,18,9,9
8,28,12,10,8,2
8,28,13,18,16,2
8,28,14,27,13,14
8,28,15,21,12,9
8,28,16,24,7,17
8,28,17,15,8,7
8,28,18,26,17,9
8,28,19,29,12,17
8,28,20,14,7,7
8,28,21,30,16,14
8,28,22,12,11,1
8,28,23,17,10,7
8,28,24,22,10,12
8,28,25,20,14,6
8,28,26,13,12,1
8,28,27,9,4,5
8,28,28,19,13,6
8,28,29,28,13,15
8,28,30,14,18,-4
8,28,31,27,9,18
8,28,32,18,12,6
8,28,33,7,7,0
8,28,34,16,10,6
8,28,35,24,13,11
8,28,36,9,9,0
8,28,37,12,8,4
8,28,38,11,14,-3
8,28,39,17,18,-1
8,28,40,17,14,3
8,28,41,13,12,1
8,28,42,11,4,7
8,28,43,19,12,7
8,28,44,14,18,-4
8,28,45,22,17,5
8,28,46,13,5,8
8,28,47,26,13,13
8,28,48,32,13,19
8,28,49,19,15,4
8,28,50,22,13,9
8,28,51,20,12,8
8,28,52,7,12,-5
8,28,53,15,5,10
8,28,54,34,25,9
8,28,55,14,11,3
8,28,56,8,7,1
8,28,57,21,11,10
8,28,58,17,6,11
8,28,59,29,15,14
8,28,60,27,7,20
8,28,61,21,13,8
8,28,62,26,6,20
8,28,63,20,9,11
8,28,64,16,13,3
8,28,65,10,4,6
8,28,66,6,3,3
8,28,67,17,9,8
8,28,68,34,13,21
8,28,69,25,9,16
8,28,70,29,9,20
8,28,71,28,19,9
8,28,72,15,17,-2
8,28,73,32,15,17
8,28,74,17,10,7
8,28,75,19,19,0
8,28,76,21,9,12
8,28,77,8,8,0
8,28,78,21,14,7
8,28,79,30,14,16
8,28,80,31,9,22
8,28,81,22,10,12
8,28,82,20,11,9
8,28,83,9,5,4
8,28,84,17,8,9
8,28,85,18,13,5
8,28,86,22,8,14
8,28,87,23,16,7
8,28,88,13,29,-16
8,28,89,27,10,17
8,28,90,20,16,4
8,28,91,30,5,25
8,28,92,16,4,12
8,28,93,22,9,13
8,28,94,20,5,15
8,28,95,25,18,7
8,28,96,11,17,-6
8,28,97,25,18,7
8,28,98,14,8,6
8,28,99,15,11,4
8,28,100,23,15,8
8,28,101,38,11,27
8,28,102,32,2,30
8,28,103,30,15,15
8,28,104,36,9,27
8,28,105,23,10,13
8,28,106,18,5,13
8,28,107,22,8,14
8,28,108,10,7,3
8,28,109,15,10,5
8,28,110,7,13,-6
8,28,111,30,13,17
8,28,112,23,6,17
8,28,113,12,9,3
8,28,114,18,14,4
8,28,115,12,15,-3
8,28,116,21,9,12
8,28,117,12,10,2
8,28,118,18,10,8
8,28,119,18,13,5
8,28,120,4,5,-1
8,28,121,17,5,12
8,28,122,19,15,4
8,28,123,27,8,19
8,28,124,22,9,13
8,28,125,24,16,8
8,28,126,18,11,7
8,28,127,15,11,4
8,28,128,22,14,8
8,28,129,20,14,6
8,28,130,16,4,12
8,28,131,17,3,14
8,28,132,25,6,19
8,28,133,19,27,-8
8,28,134,21,11,10
8,28,135,23,27,-4
8,28,136,26,14,12
8,28,137,23,14,9
8,28,138,27,4,23
8,28,139,18,10,8
8,28,140,26,9,17
8,28,141,35,18,17
8,28,142,12,6,6
8,28,143,7,8,-1
8,28,144,36,4,32
8,28,145,23,6,17
8,28,146,11,6,5
8,28,147,18,6,12
8,28,148,29,12,17
8,28,149,31,18,13
8,28,150,17,8,9
8,28,151,16,8,8
8,28,152,23,17,6
8,28,153,19,7,12
8,28,154,27,17,10
8,28,155,30,8,22
8,28,156,27,29,-2
8,28,157,31,16,15
8,28,158,26,14,12
8,28,159,13,9,4
8,28,160,32,30,2
8,28,161,13,9,4
8,28,162,9,14,-5
8,28,163,17,9,8
8,28,164,21,11,10
8,28,165,24,15,9
8,28,166,12,4,8
8,28,167,37,14,23
8,28,168,9,16,-7
8,28,169,31,14,17
8,28,170,20,5,15
8,28,171,17,7,10
8,28,172,15,13,2
8,28,173,33,10,23
8,28,174,26,10,16
8,28,175,15,10,5
8,28,176,21,12,9
8,28,177,15,3,12
8,28,178,10,11,-1
8,28,179,11,13,-2
8,28,180,20,13,7
8,28,181,30,16,14
8,28,182,23,13,10
8,28,183,31,11,20
8,28,184,26,10,16
8,28,185,26,12,14
8,28,186,28,12,16
8,28,187,19,20,-1
8,28,188,26,12,14
8,28,189,13,16,-3
8,28,190,17,18,-1
8,28,191,21,9,12
8,28,192,19,12,7
8,28,193,12,3,9
8,28,194,9,4,5
8,28,195,14,5,9
8,28,196,40,12,28
8,28,197,25,4,21
8,28,198,9,10,-1
8,28,199,10,5,5
8,28,200,13,10,3
8,28,201,26,13,13
8,28,202,21,9,12
8,28,203,23,12,11
8,28,204,23,23,0
8,28,205,37,8,29
8,28,206,16,17,-1
8,28,207,21,17,4
8,28,208,15,11,4
8,28,209,14,19,-5
8,28,210,20,9,11
8,28,211,15,5,10
8,28,212,17,11,6
8,28,213,21,11,10
8,28,214,14,11,3
8,28,215,20,6,14
8,28,216,17,1,16
8,28,217,28,7,21
8,28,218,16,15,1
8,28,219,19,5,14
8,28,220,19,12,7
8,28,221,21,8,13
8,28,222,21,27,-6
8,28,223,8,10,-2
8,28,224,26,16,10
8,28,225,19,9,10
8,28,226,38,16,22
8,28,227,25,5,20
8,28,228,18,1,17
8,28,229,11,7,4
8,28,230,19,20,-1
8,28,231,29,14,15
8,28,232,18,9,9
8,28,233,23,4,19
8,28,234,16,4,12
8,28,235,22,6,16
8,28,236,11,9,2
8,28,237,8,5,3
8,28,238,24,6,18
8,28,239,5,4,1
8,28,240,16,16,0
8,28,241,9,3,6
8,28,242,14,3,11
8,28,243,19,11,8
8,28,244,23,17,6
8,28,245,8,1,7
8,28,246,17,15,2
8,28,247,17,10,7
8,28,248,15,6,9
8,28,249,14,10,4
8,28,250,23,15,8
8,28,251,18,6,12
8,28,252,30,16,14
8,28,253,9,7,2
8,28,254,24,14,10
8,28,255,9,9,0
8,28,256,21,23,-2
8,28,257,13,12,1
8,28,258,10,6,4
8,28,259,18,19,-1
8,28,260,19,7,12
8,28,261,27,10,17
8,28,262,35,9,26
8,28,263,21,10,11
8,28,264,23,13,10
8,28,265,21,14,7
8,28,266,23,8,15
8,28,267,21,17,4
8,28,268,29,14,15
8,28,269,25,10,15
8,28,270,37,17,20
8,28,271,25,13,12
8,28,272,18,11,7
8,28,273,16,3,13
8,28,274,32,15,17
8,28,275,17,11,6
8,28,276,25,8,17
8,28,277,16,16,0
8,28,278,7,9,-2
8,28,279,24,18,6
8,28,280,16,17,-1
8,28,281,28,12,16
8,28,282,17,10,7
8,28,283,23,10,13
8,28,284,26,14,12
8,28,285,9,6,3
8,28,286,17,2,15
8,28,287,11,22,-11
8,28,288,17,4,13
8,28,289,35,18,17
8,28,290,27,18,9
8,28,291,21,5,16
8,28,292,8,3,5
8,28,293,26,8,18
8,28,294,32,11,21
8,28,295,23,14,9
8,28,296,19,10,9
8,28,297,24,18,6
8,28,298,19,8,11
8,28,299,22,13,9
8,29,0,18,8,10
8,29,1,26,20,6
8,29,2,8,14,-6
8,29,3,19,7,12
8,29,4,19,11,8
8,29,5,22,10,12
8,29,6,21,15,6
8,29,7,19,19,0
8,29,8,7,7,0
8,29,9,18,13,5
8,29,10,21,8,13
8,29,11,23,18,5
8,29,12,19,10,9
8,29,13,27,24,3
8,29,14,12,5,7
8,29,15,17,14,3
8,29,16,22,11,11
8,29,17,13,5,8
8,29,18,28,5,23
8,29,19,14,9,5
8,29,20,29,16,13
8,29,21,16,3,13
8,29,22,37,14,23
8,29,23,14,5,9
8,29,24,28,14,14
8,29,25,27,10,17
8,29,26,27,12,15
8,29,27,14,16,-2
8,29,28,13,10,3
8,29,29,20,7,13
8,29,30,20,5,15
8,29,31,31,6,25
8,29,32,20,25,-5
8,29,33,28,2,26
8,29,34,17,10,7
8,29,35,23,12,11
8,29,36,35,19,16
8,29,37,9,13,-4
8,29,38,25,17,8
8,29,39,22,6,16
8,29,40,16,5,11
8,29,41,23,1,22
8,29,42,23,5,18
8,29,43,17,4,13
8,29,44,16,14,2
8,29,45,34,11,23
8,29,46,20,18,2
8,29,47,26,21,5
8,29,48,24,8,16
8,29,49,18,9,9
8,29,50,19,12,7
8,29,51,14,16,-2
8,29,52,31,12,19
8,29,53,20,13,7
8,29,54,23,6,17
8,29,55,7,3,4
8,29,56,16,7,9
8,29,57,16,8,8
8,29,58,16,8,8
8,29,59,23,12,11
8,29,60,13,14,-1
8,29,61,16,5,11
8,29,62,31,11,20
8,29,63,19,9,10
8,29,64,15,16,-1
8,29,65,24,15,9
8,29,66,17,4,13
8,29,67,30,11,19
8,29,68,25,21,4
8,29,69,25,14,11
8,29,70,19,16,3
8,29,71,13,3,10
8,29,72,10,8,2
8,29,73,16,8,8
8,29,74,16,6,10
8,29,75,27,19,8
8,29,76,24,7,17
8,29,77,27,5,22
8,29,78,13,10,3
8,29,79,13,6,7
8,29,80,16,6,10
8,29,81,9,10,-1
8,29,82,17,7,10
8,29,83,20,3,17
8,29,84,18,10,8
8,29,85,28,9,19
8,29,86,12,7,5
8,29,87,26,6,20
8,29,88,23,6,17
8,29,89,20,9,11
8,29,90,17,14,3
8,29,91,31,9,22
8,29,92,23,14,9
8,29,93,16,11,5
8,29,94,38,20,18
8,29,95,15,13,2
8,29,96,23,11,12
8,29,97,13,9,4
8,29,98,18,13,5
8,29,99,27,6,21
8,29,100,26,13,13
8,29,101,20,3,17
8,29,102,22,19,3
8,29,103,21,18,3
8,29,104,20,16,4
8,29,105,12,9,3
8,29,106,11,9,2
8,29,107,17,24,-7
8,29,108,19,7,12
8,29,109,28,9,19
8,29,110,23,20,3
8,29,111,28,13,15
8,29,112,21,8,13
8,29,113,18,15,3
8,29,114,20,10,10
8,29,115,13,8,5
8,29,116,18,5,13
8,29,117,23,14,9
8,29,118,24,8,16
8,29,119,19,12,7
8,29,120,17,13,4
8,29,121,19,13,6
8,29,122,8,8,0
8,29,123,12,6,6
8,29,124,24,2,22
8,29,125,26,8,18
8,29,126,16,13,3
8,29,127,32,9,23
8,29,128,25,15,10
8,29,129,20,8,12
8,29,130,26,17,9
8,29,131,13,15,-2
8,29,132,21,10,11
8,29,133,18,8,10
8,29,134,20,28,-8
8,29,135,15,10,5
8,29,136,9,2,7
8,29,137,17,11,6
8,29,138,13,7,6
8,29,139,14,9,5
8,29,140,24,11,13
8,29,141,30,16,14
8,29,142,35,10,25
8,29,143,30,23,7
8,29,144,19,15,4
8,29,145,19,10,9
8,29,146,8,0,8
8,29,147,19,7,12
8,29,148,25,2,23
8,29,149,18,10,8
8,29,150,14,15,-1
8,29,151,19,11,8
8,29,152,15,4,11
8,29,153,26,22,4
8,29,154,16,6,10
8,29,155,9,13,-4
8,29,156,12,7,5
8,29,157,25,9,16
8,29,158,18,17,1
8,29,159,7,2,5
8,29,160,16,4,12
8,29,161,28,16,12
8,29,162,14,17,-3
8,29,163,29,8,21
8,29,164,24,7,17
8,29,165,14,7,7
8,29,166,12,3,9
8,29,167,26,14,12
8,29,168,20,5,15
8,29,169,12,13,-1
8,29,170,28,10,18
8,29,171,9,8,1
8,29,172,12,10,2
8,29,173,22,5,17
8,29,174,23,15,8
8,29,175,17,11,6
8,29,176,30,4,26
8,29,177,30,12,18
8,29,178,8,6,2
8,29,179,10,4,6
8,29,180,20,8,12
8,29,181,20,9,11
8,29,182,8,20,-12
8,29,183,19,10,9
8,29,184,18,3,15
8,29,185,12,9,3
8,29,186,30,11,19
8,29,187,28,14,14
8,29,188,20,18,2
8,29,189,26,12,14
8,29,190,16,7,9
8,29,191,26,14,12
8,29,192,17,7,10
8,29,193,12,6,6
8,29,194,27,16,11
8,29,195,25,11,14
8,29,196,29,5,24
8,29,197,27,19,8
8,29,198,12,14,-2
8,29,199,8,11,-3
8,29,200,20,6,14
8,29,201,22,13,9
8,29,202,20,21,-1
8,29,203,23,19,4
8,29,204,25,16,9
8,29,205,16,20,-4
8,29,206,16,7,9
8,29,207,21,8,13
8,29,208,21,14,7
8,29,209,24,18,6
8,29,210,21,14,7
8,29,211,29,15,14
8,29,212,33,17,16
8,29,213,10,15,-5
8,29,214,20,5,15
8,29,215,10,13,-3
8,29,216,21,9,12
8,29,217,10,7,3
8,29,218,16,13,3
8,29,219,21,5,16
8,29,220,20,14,6
8,29,221,8,8,0
8,29,222,16,12,4
8,29,223,13,12,1
8,29,224,32,13,19
8,29,225,47,15,32
8,29,226,14,8,6
8,29,227,13,8,5
8,29,228,21,11,10
8,29,229,15,15,0
8,29,230,13,15,-2
8,29,231,15,9,6
8,29,232,24,7,17
8,29,233,15,8,7
8,29,234,24,6,18
8,29,235,18,13,5
8,29,236,11,6,5
8,29,237,29,2,27
8,29,238,20,6,14
8,29,239,11,7,4
8,29,240,8,11,-3
8,29,241,24,11,13
8,29,242,27,13,14
8,29,243,23,14,9
8,29,244,10,9,1
8,29,245,8,5,3
8,29,246,27,11,16
8,29,247,34,19,15
8,29,248,24,5,19
8,29,249,10,10,0
8,29,250,31,25,6
8,29,251,19,14,5
8,29,252,19,16,3
8,29,253,15,5,10
8,29,254,26,16,10
8,29,255,12,20,-8
8,29,256,22,14,8
8,29,257,14,9,5
8,29,258,14,6,8
8,29,259,14,8,6
8,29,260,15,8,7
8,29,261,18,10,8
8,29,262,15,10,5
8,29,263,19,16,3
8,29,264,17,7,10
8,29,265,16,11,5
8,29,266,20,17,3
8,29,267,21,9,12
8,29,268,20,9,11
8,29,269,21,13,8
8,29,270,11,10,1
8,29,271,24,19,5
8,29,272,10,9,1
8,29,273,15,6,9
8,29,274,38,13,25
8,29,275,22,15,7
8,29,276,12,8,4
8,29,277,21,5,16
8,29,278,14,13,1
8,29,279,19,6,13
8,29,280,19,10,9
8,29,281,21,13,8
8,29,282,22,18,4
8,29,283,15,10,5
8,29,284,18,4,14
8,29,285,17,17,0
8,29,286,16,5,11
8,29,287,33,19,14
8,29,288,34,7,27
8,29,289,14,12,2
8,29,290,17,3,14
8,29,291,19,18,1
8,29,292,40,7,33
8,29,293,20,15,5
8,29,294,21,7,14
8,29,295,11,9,2
8,29,296,24,5,19
8,29,297,23,3,20
8,29,298,16,14,2
8,29,299,16,10,6
8,30,0,13,6,7
8,30,1,31,11,20
8,30,2,15,3,12
8,30,3,10,4,6
8,30,4,11,10,1
8,30,5,15,6,9
8,30,6,16,12,4
8,30,7,18,6,12
8,30,8,29,11,18
8,30,9,24,8,16
8,30,10,16,5,11
8,30,11,26,19,7
8,30,12,12,15,-3
8,30,13,37,24,13
8,30,14,19,9,10
8,30,15,21,13,8
8,30,16,16,12,4
8,30,17,17,4,13
8,30,18,18,9,9
8,30,19,15,12,3
8,30,20,28,12,16
8,30,21,31,18,13
8,30,22,11,2,9
8,30,23,8,11,-3
8,30,24,12,8,4
8,30,25,9,6,3
8,30,26,18,6,12
8,30,27,30,6,24
8,30,28,16,10,6
8,30,29,21,15,6
8,30,30,13,11,2
8,30,31,18,7,11
8,30,32,22,1,21
8,30,33,15,5,10
8,30,34,26,28,-2
8,30,35,18,8,10
8,30,36,20,8,12
8,30,37,29,10,19
8,30,38,32,19,13
8,30,39,18,14,4
8,30,40,26,15,11
8,30,41,9,16,-7
8,30,42,32,10,22
8,30,43,16,15,1
8,30,44,20,14,6
8,30,45,21,11,10
8,30,46,26,17,9
8,30,47,16,14,2
8,30,48,18,8,10
8,30,49,23,5,18
8,30,50,17,12,5
8,30,51,32,11,21
8,30,52,22,6,16
8,30,53,18,15,3
8,30,54,28,25,3
8,30,55,26,9,17
8,30,56,29,6,23
8,30,57,12,16,-4
8,30,58,32,17,15
8,30,59,21,12,9
8,30,60,29,7,22
8,30,61,22,6,16
8,30,62,26,8,18
8,30,63,29,5,24
8,30,64,21,9,12
8,30,65,13,5,8
8,30,66,11,8,3
8,30,67,18,17,1
8,30,68,27,11,16
8,30,69,17,3,14
8,30,70,17,5,12
8,30,71,21,9,12
8,30,72,20,8,12
8,30,73,22,11,11
8,30,74,22,13,9
8,30,75,26,4,22
8,30,76,30,8,22
8,30,77,29,11,18
8,30,78,14,5,9
8,30,79,25,15,10
8,30,80,16,5,11
8,30,81,31,11,20
8,30,82,10,18,-8
8,30,83,11,7,4
8,30,84,23,6,17
8,30,85,14,7,7
8,30,86,16,6,10
8,30,87,16,2,14
8,30,88,15,21,-6
8,30,89,22,9,13
8,30,90,8,13,-5
8,30,91,25,16,9
8,30,92,18,19,-1
8,30,93,2,9,-7
8,30,94,19,7,12
8,30,95,35,19,16
8,30,96,24,9,15
8,30,97,25,7,18
8,30,98,18,10,8
8,30,99,23,4,19
8,30,100,20,13,7
8,30,101,23,7,16
8,30,102,19,8,11
8,30,103,27,18,9
8,30,104,29,14,15
8,30,105,12,13,-1
8,30,106,14,10,4
8,30,107,14,14,0
8,30,108,25,11,14
8,30,109,5,7,-2
8,30,110,15,9,6
8,30,111,14,9,5
8,30,112,17,8,9
8,30,113,26,2,24
8,30,114,15,4,11
8,30,115,16,14,2
8,30,116,34,23,11
8,30,117,22,11,11
8,30,118,23,3,20
8,30,119,16,10,6
8,30,120,13,9,4
8,30,121,8,3,5
8,30,122,16,10,6
8,30,123,22,9,13
8,30,124,19,7,12
8,30,125,12,11,1
8,30,126,11,5,6
8,30,127,25,8,17
8,30,128,28,14,14
8,30,129,21,16,5
8,30,130,23,16,7
8,30,131,18,20,-2
8,30,132,21,17,4
8,30,133,23,20,3
8,30,134,18,7,11
8,30,135,13,13,0
8,30,136,47,13,34
8,30,137,22,1,21
8,30,138,7,6,1
8,30,139,14,12,2
8,30,140,19,9,10
8,30,141,23,7,16
8,30,142,17,16,1
8,30,143,16,11,5
8,30,144,24,9,15
8,30,145,28,13,15
8,30,146,14,5,9
8,30,147,17,6,11
8,30,148,15,13,2
8,30,149,30,13,17
8,30,150,13,12,1
8,30,151,25,14,11
8,30,152,34,17,17
8,30,153,12,9,3
8,30,154,18,14,4
8,30,155,25,15,10
8,30,156,16,7,9
8,30,157,19,17,2
8,30,158,19,11,8
8,30,159,16,16,0
8,30,160,17,14,3
8,30,161,23,7,16
8,30,162,23,6,17
8,30,163,25,15,10
8,30,164,25,10,15
8,30,165,20,11,9
8,30,166,22,12,10
8,30,167,21,9,12
8,30,168,22,1,21
8,30,169,19,7,12
8,30,170,30,8,22
8,30,171,24,6,18
8,30,172,29,14,15
8,30,173,6,8,-2
8,30,174,11,4,7
8,30,175,16,8,8
8,30,176,16,12,4
8,30,177,17,12,5
8,30,178,11,4,7
8,30,179,24,18,6
8,30,180,25,15,10
8,30,181,24,6,18
8,30,182,18,9,9
8,30,183,18,10,8
8,30,184,18,8,10
8,30,185,30,6,24
8,30,186,19,16,3
8,30,187,23,22,1
8,30,188,30,12,18
8,30,189,31,7,24
8,30,190,28,13,15
8,30,191,19,5,14
8,30,192,22,7,15
8,30,193,16,7,9
8,30,194,19,7,12
8,30,195,23,11,12
8,30,196,19,5,14
8,30,197,21,6,15
8,30,198,23,17,6
8,30,199,15,12,3
8,30,200,31,11,20
8,30,201,15,10,5
8,30,202,13,20,-7
8,30,203,23,13,10
8,30,204,26,8,18
8,30,205,18,9,9
8,30,206,32,6,26
8,30,207,12,11,1
8,30,208,14,9,5
8,30,209,28,17,11
8,30,210,20,7,13
8,30,211,21,6,15
8,30,212,21,13,8
8,30,213,18,12,6
8,30,214,20,9,11
8,30,215,27,13,14
8,30,216,11,10,1
8,30,217,24,11,13
8,30,218,33,19,14
8,30,219,17,13,4
8,30,220,23,9,14
8,30,221,13,11,2
8,30,222,34,14,20
8,30,223,15,6,9
8,30,224,31,25,6
8,30,225,21,7,14
8,30,226,16,2,14
8,30,227,36,9,27
8,30,228,16,9,7
8,30,229,17,7,10
8,30,230,24,4,20
8,30,231,12,10,2
8,30,232,13,7,6
8,30,233,14,12,2
8,30,234,19,6,13
8,30,235,16,8,8
8,30,236,35,5,30
8,30,237,18,8,10
8,30,238,24,13,11
8,30,239,34,14,20
8,30,240,13,1,12
8,30,241,27,10,17
8,30,242,16,2,14
8,30,243,15,1,14
8,30,244,18,15,3
8,30,245,18,6,12
8,30,246,30,8,22
8,30,247,23,16,7
8,30,248,23,24,-1
8,30,249,26,22,4
8,30,250,19,7,12
8,30,251,17,4,13
8,30,252,9,8,1
8,30,253,19,16,3
8,30,254,8,3,5
8,30,255,25,18,7
8,30,256,31,17,14
8,30,257,21,8,13
8,30,258,29,18,11
8,30,259,29,10,19
8,30,260,15,10,5
8,30,261,36,16,20
8,30,262,17,15,2
8,30,263,10,6,4
8,30,264,11,21,-10
8,30,265,15,2,13
8,30,266,15,14,1
8,30,267,20,22,-2
8,30,268,16,13,3
8,30,269,16,4,12
8,30,270,16,11,5
8,30,271,13,7,6
8,30,272,33,6,27
8,30,273,29,15,14
8,30,274,25,13,12
8,30,275,23,8,15
8,30,276,10,5,5
8,30,277,32,21,11
8,30,278,11,10,1
8,30,279,40,15,25
8,30,280,28,9,19
8,30,281,26,15,11
8,30,282,22,13,9
8,30,283,14,14,0
8,30,284,16,8,8
8,30,285,23,6,17
8,30,286,33,5,28
8,30,287,16,12,4
8,30,288,13,6,7
8,30,289,17,16,1
8,30,290,17,10,7
8,30,291,16,15,1
8,30,292,13,11,2
8,30,293,24,17,7
8,30,294,11,14,-3
8,30,295,15,8,7
8,30,296,21,7,14
8,30,297,22,2,20
8,30,298,41,12,29
8,30,299,21,6,15
9,1,0,2,4,-2
9,1,1,8,19,-11
9,1,2,16,16,0
9,1,3,4,11,-7
9,1,4,12,19,-7
9,1,5,6,9,-3
9,1,6,8,17,-9
9,1,7,11,20,-9
9,1,8,7,6,1
9,1,9,4,11,-7
9,1,10,21,15,6
9,1,11,7,6,1
9,1,12,5,6,-1
9,1,13,11,9,2
9,1,14,17,18,-1
9,1,15,4,21,-17
9,1,16,11,18,-7
9,1,17,3,5,-2
9,1,18,11,11,0
9,1,19,4,10,-6
9,1,20,7,22,-15
9,1,21,7,13,-6
9,1,22,10,10,0
9,1,23,6,9,-3
9,1,24,1,7,-6
9,1,25,4,15,-11
9,1,26,10,13,-3
9,1,27,19,20,-1
9,1,28,6,5,1
9,1,29,7,11,-4
9,1,30,8,4,4
9,1,31,4,1,3
9,1,32,6,20,-14
9,1,33,13,9,4
9,1,34,9,10,-1
9,1,35,4,17,-13
9,1,36,11,4,7
9,1,37,8,9,-1
9,1,38,16,11,5
9,1,39,9,11,-2
9,1,40,1,4,-3
9,1,41,22,16,6
9,1,42,17,14,3
9,1,43,6,16,-10
9,1,44,6,8,-2
9,1,45,9,8,1
9,1,46,15,28,-13
9,1,47,7,8,-1
9,1,48,5,10,-5
9,1,49,10,10,0
9,1,50,12,21,-9
9,1,51,7,6,1
9,1,52,16,14,2
9,1,53,6,15,-9
9,1,54,6,21,-15
9,1,55,3,7,-4
9,1,56,12,11,1
9,1,57,9,8,1
9,1,58,8,8,0
9,1,59,5,7,-2
9,1,60,12,9,3
9,1,61,7,15,-8
9,1,62,8,11,-3
9,1,63,9,13,-4
9,1,64,7,4,3
9,1,65,10,12,-2
9,1,66,10,12,-2
9,1,67,12,18,-6
9,1,68,9,15,-6
9,1,69,17,14,3
9,1,70,5,9,-4
9,1,71,12,12,0
9,1,72,13,12,1
9,1,73,8,13,-5
9,1,74,8,16,-8
9,1,75,2,15,-13
9,1,76,4,15,-11
9,1,77,8,9,-1
9,1,78,7,12,-5
9,1,79,3,10,-7
9,1,80,7,17,-10
9,1,81,14,10,4
9,1,82,12,21,-9
9,1,83,10,7,3
9,1,84,20,14,6
9,1,85,7,15,-8
9,1,86,4,7,-3
9,1,87,6,13,-7
9,1,88,2,7,-5
9,1,89,3,13,-10
9,1,90,5,12,-7
9,1,91,8,11,-3
9,1,92,16,17,-1
9,1,93,9,8,1
9,1,94,9,19,-10
9,1,95,7,8,-1
9,1,96,4,3,1
9,1,97,14,16,-2
9,1,98,4,20,-16
9,1,99,9,12,-3
9,1,100,12,27,-15
9,1,101,13,12,1
9,1,102,8,8,0
9,1,103,11,5,6
9,1,104,5,9,-4
9,1,105,8,3,5
9,1,106,3,7,-4
9,1,107,4,11,-7
9,1,108,11,6,5
9,1,109,5,7,-2
9,1,110,7,10,-3
9,1,111,11,12,-1
9,1,112,23,10,13
9,1,113,4,3,1
9,1,114,3,9,-6
9,1,115,18,10,8
9,1,116,7,10,-3
9,1,117,15,9,6
9,1,118,8,9,-1
9,1,119,9,14,-5
9,1,120,3,16,-13
9,1,121,9,16,-7
9,1,122,9,3,6
9,1,123,15,15,0
9,1,124,11,13,-2
9,1,125,13,19,-6
9,1,126,3,8,-5
9,1,127,9,12,-3
9,1,128,7,22,-15
9,1,129,19,8,11
9,1,130,6,14,-8
9,1,131,10,26,-16
9,1,132,11,25,-14
9,1,133,4,4,0
9,1,134,0,8,-8
9,1,135,6,8,-2
9,1,136,10,7,3
9,1,137,18,15,3
9,1,138,18,16,2
9,1,139,7,15,-8
9,1,140,10,15,-5
9,1,141,7,17,-10
9,1,142,5,6,-1
9,1,143,4,10,-6
9,1,144,4,18,-14
9,1,145,10,7,3
9,1,146,11,9,2
9,1,147,9,13,-4
9,1,148,17,32,-15
9,1,149,14,17,-3
9,1,150,23,17,6
9,1,151,19,13,6
9,1,152,5,20,-15
9,1,153,10,13,-3
9,1,154,12,23,-11
9,1,155,5,12,-7
9,1,156,11,9,2
9,1,157,7,22,-15
9,1,158,4,3,1
9,1,159,8,10,-2
9,1,160,13,17,-4
9,1,161,11,5,6
9,1,162,14,11,3
9,1,163,15,15,0
9,1,164,14,20,-6
9,1,165,15,18,-3
9,1,166,11,17,-6
9,1,167,2,9,-7
9,1,168,8,15,-7
9,1,169,10,14,-4
9,1,170,5,9,-4
9,1,171,8,16,-8
9,1,172,6,7,-1
9,1,173,11,16,-5
9,1,174,12,17,-5
9,1,175,9,10,-1
9,1,176,12,14,-2
9,1,177,2,9,-7
9,1,178,4,11,-7
9,1,179,10,17,-7
9,1,180,3,18,-15
9,1,181,3,1,2
9,1,182,11,17,-6
9,1,183,5,10,-5
9,1,184,3,8,-5
9,1,185,14,27,-13
9,1,186,13,13,0
9,1,187,8,5,3
9,1,188,14,17,-3
9,1,189,10,13,-3
9,1,190,7,19,-12
9,1,191,3,11,-8
9,1,192,12,12,0
9,1,193,9,10,-1
9,1,194,7,12,-5
9,1,195,7,12,-5
9,1,196,4,11,-7
9,1,197,8,6,2
9,1,198,6,17,-11
9,1,199,3,8,-5
9,1,200,2,18,-16
9,1,201,23,31,-8
9,1,202,18,15,3
9,1,203,8,4,4
9,1,204,22,16,6
9,1,205,17,12,5
9,1,206,5,10,-5
9,1,207,3,3,0
9,1,208,12,11,1
9,1,209,10,5,5
9,1,210,9,14,-5
9,1,211,14,17,-3
9,1,212,4,12,-8
9,1,213,10,12,-2
9,1,214,11,10,1
9,1,215,12,11,1
9,1,216,7,5,2
9,1,217,7,13,-6
9,1,218,6,19,-13
9,1,219,7,25,-18
9,1,220,9,15,-6
9,1,221,2,7,-5
9,1,222,5,5,0
9,1,223,5,2,3
9,1,224,9,11,-2
9,1,225,7,10,-3
9,1,226,7,23,-16
9,1,227,5,10,-5
9,1,228,9,8,1
9,1,229,10,10,0
9,1,230,5,6,-1
9,1,231,7,10,-3
9,1,232,11,14,-3
9,1,233,9,13,-4
9,1,234,15,13,2
9,1,235,14,11,3
9,1,236,11,28,-17
9,1,237,17,16,1
9,1,238,5,9,-4
9,1,239,5,9,-4
9,1,240,3,10,-7
9,1,241,15,11,4
9,1,242,5,17,-12
9,1,243,4,14,-10
9,1,244,2,8,-6
9,1,245,19,12,7
9,1,246,6,3,3
9,1,247,3,10,-7
9,1,248,12,15,-3
9,1,249,9,23,-14
9,1,250,10,14,-4
9,1,251,9,11,-2
9,1,252,10,15,-5
9,1,253,9,13,-4
9,1,254,13,23,-10
9,1,255,15,4,11
9,1,256,6,5,1
9,1,257,6,5,1
9,1,258,14,15,-1
9,1,259,7,15,-8
9,1,260,12,15,-3
9,1,261,12,10,2
9,1,262,6,7,-1
9,1,263,8,13,-5
9,1,264,8,18,-10
9,1,265,12,10,2
9,1,266,8,9,-1
9,1,267,11,16,-5
9,1,268,8,20,-12
9,1,269,7,16,-9
9,1,270,17,5,12
9,1,271,7,27,-20
9,1,272,5,12,-7
9,1,273,6,9,-3
9,1,274,14,16,-2
9,1,275,18,7,11
9,1,276,13,14,-1
9,1,277,15,10,5
9,1,278,12,4,8
9,1,279,14,19,-5
9,1,280,11,7,4
9,1,281,12,8,4
9,1,282,12,13,-1
9,1,283,10,13,-3
9,1,284,7,11,-4
9,1,285,9,11,-2
9,1,286,10,12,-2
9,1,287,17,10,7
9,1,288,11,6,5
9,1,289,9,17,-8
9,1,290,15,8,7
9,1,291,11,17,-6
9,1,292,8,10,-2
9,1,293,6,14,-8
9,1,294,11,18,-7
9,1,295,3,0,3
9,1,296,4,4,0
9,1,297,14,9,5
9,1,298,22,20,2
9,1,299,3,14,-11
9,2,0,16,7,9
9,2,1,6,5,1
9,2,2,13,23,-10
9,2,3,12,7,5
9,2,4,9,14,-5
9,2,5,8,12,-4
9,2,6,4,15,-11
9,2,7,6,17,-11
9,2,8,8,21,-13
9,2,9,15,21,-6
9,2,10,2,5,-3
9,2,11,4,9,-5
9,2,12,17,16,1
9,2,13,14,13,1
9,2,14,1,6,-5
9,2,15,8,12,-4
9,2,16,8,9,-1
9,2,17,7,18,-11
9,2,18,10,14,-4
9,2,19,9,13,-4
9,2,20,3,8,-5
9,2,21,1,9,-8
9,2,22,4,12,-8
9,2,23,10,12,-2
9,2,24,15,12,3
9,2,25,10,10,0
9,2,26,7,6,1
9,2,27,5,2,3
9,2,28,18,14,4
9,2,29,10,13,-3
9,2,30,7,6,1
9,2,31,13,12,1
9,2,32,17,24,-7
9,2,33,6,8,-2
9,2,34,10,10,0
9,2,35,5,22,-17
9,2,36,9,9,0
9,2,37,15,16,-1
9,2,38,6,6,0
9,2,39,17,14,3
9,2,40,6,1,5
9,2,41,19,37,-18
9,2,42,4,18,-14
9,2,43,13,17,-4
9,2,44,8,12,-4
9,2,45,5,6,-1
9,2,46,10,8,2
9,2,47,7,17,-10
9,2,48,5,17,-12
9,2,49,18,31,-13
9,2,50,10,18,-8
9,2,51,6,8,-2
9,2,52,8,6,2
9,2,53,9,18,-9
9,2,54,4,17,-13
9,2,55,3,13,-10
9,2,56,15,8,7
9,2,57,10,15,-5
9,2,58,10,22,-12
9,2,59,16,13,3
9,2,60,17,6,11
9,2,61,5,3,2
9,2,62,19,19,0
9,2,63,8,16,-8
9,2,64,14,30,-16
9,2,65,7,15,-8
9,2,66,9,10,-1
9,2,67,6,10,-4
9,2,68,8,10,-2
9,2,69,9,18,-9
9,2,70,8,8,0
9,2,71,10,35,-25
9,2,72,10,13,-3
9,2,73,11,26,-15
9,2,74,10,15,-5
9,2,75,13,13,0
9,2,76,11,7,4
9,2,77,6,10,-4
9,2,78,5,8,-3
9,2,79,9,19,-10
9,2,80,13,11,2
9,2,81,20,24,-4
9,2,82,9,9,0
9,2,83,4,21,-17
9,2,84,6,10,-4
9,2,85,17,24,-7
9,2,86,8,16,-8
9,2,87,8,4,4
9,2,88,10,6,4
9,2,89,12,13,-1
9,2,90,23,22,1
9,2,91,2,14,-12
9,2,92,8,12,-4
9,2,93,13,9,4
9,2,94,26,16,10
9,2,95,14,26,-12
9,2,96,1,12,-11
9,2,97,8,11,-3
9,2,98,18,12,6
9,2,99,8,10,-2
9,2,100,16,11,5
9,2,101,12,18,-6
9,2,102,7,20,-13
9,2,103,12,14,-2
9,2,104,17,26,-9
9,2,105,8,5,3
9,2,106,14,20,-6
9,2,107,6,12,-6
9,2,108,10,10,0
9,2,109,13,12,1
9,2,110,17,13,4
9,2,111,8,9,-1
9,2,112,7,7,0
9,2,113,5,3,2
9,2,114,14,15,-1
9,2,115,4,8,-4
9,2,116,17,18,-1
9,2,117,10,17,-7
9,2,118,9,9,0
9,2,119,7,4,3
9,2,120,13,21,-8
9,2,121,4,10,-6
9,2,122,10,8,2
9,2,123,6,8,-2
9,2,124,5,21,-16
9,2,125,5,15,-10
9,2,126,9,9,0
9,2,127,12,19,-7
9,2,128,8,11,-3
9,2,129,8,10,-2
9,2,130,6,14,-8
9,2,131,5,12,-7
9,2,132,4,11,-7
9,2,133,11,20,-9
9,2,134,10,32,-22
9,2,135,11,23,-12
9,2,136,17,21,-4
9,2,137,13,8,5
9,2,138,6,15,-9
9,2,139,13,30,-17
9,2,140,7,15,-8
9,2,141,8,9,-1
9,2,142,8,15,-7
9,2,143,10,15,-5
9,2,144,6,8,-2
9,2,145,6,14,-8
9,2,146,16,12,4
9,2,147,9,7,2
9,2,148,16,16,0
9,2,149,10,11,-1
9,2,150,6,8,-2
9,2,151,12,12,0
9,2,152,6,22,-16
9,2,153,16,28,-12
9,2,154,8,5,3
9,2,155,2,8,-6
9,2,156,27,10,17
9,2,157,9,8,1
9,2,158,10,12,-2
9,2,159,11,15,-4
9,2,160,17,7,10
9,2,161,12,21,-9
9,2,162,11,18,-7
9,2,163,2,2,0
9,2,164,7,14,-7
9,2,165,22,19,3
9,2,166,5,10,-5
9,2,167,14,19,-5
9,2,168,6,10,-4
9,2,169,7,14,-7
9,2,170,3,17,-14
9,2,171,8,21,-13
9,2,172,12,24,-12
9,2,173,7,21,-14
9,2,174,21,22,-1
9,2,175,3,8,-5
9,2,176,8,10,-2
9,2,177,3,14,-11
9,2,178,8,21,-13
9,2,179,35,8,27
9,2,180,8,5,3
9,2,181,14,22,-8
9,2,182,3,11,-8
9,2,183,8,12,-4
9,2,184,12,14,-2
9,2,185,7,9,-2
9,2,186,2,4,-2
9,2,187,4,5,-1
9,2,188,9,32,-23
9,2,189,8,17,-9
9,2,190,5,4,1
9,2,191,4,16,-12
9,2,192,15,20,-5
9,2,193,5,16,-11
9,2,194,22,24,-2
9,2,195,12,14,-2
9,2,196,11,19,-8
9,2,197,10,15,-5
9,2,198,15,11,4
9,2,199,8,8,0
9,2,200,11,7,4
9,2,201,8,12,-4
9,2,202,6,2,4
9,2,203,12,13,-1
9,2,204,13,10,3
9,2,205,9,11,-2
9,2,206,9,13,-4
9,2,207,14,26,-12
9,2,208,13,16,-3
9,2,209,11,10,1
9,2,210,16,17,-1
9,2,211,17,17,0
9,2,212,6,9,-3
9,2,213,11,14,-3
9,2,214,12,14,-2
9,2,215,12,19,-7
9,2,216,13,12,1
9,2,217,8,20,-12
9,2,218,12,10,2
9,2,219,7,12,-5
9,2,220,7,14,-7
9,2,221,3,15,-12
9,2,222,8,16,-8
9,2,223,11,9,2
9,2,224,6,4,2
9,2,225,12,13,-1
9,2,226,3,10,-7
9,2,227,5,10,-5
9,2,228,6,6,0
9,2,229,11,9,2
9,2,230,10,13,-3
9,2,231,12,8,4
9,2,232,6,20,-14
9,2,233,2,12,-10
9,2,234,11,21,-10
9,2,235,19,31,-12
9,2,236,14,20,-6
9,2,237,16,12,4
9,2,238,8,9,-1
9,2,239,15,17,-2
9,2,240,21,18,3
9,2,241,5,4,1
9,2,242,8,7,1
9,2,243,13,16,-3
9,2,244,6,4,2
9,2,245,12,10,2
9,2,246,13,9,4
9,2,247,13,13,0
9,2,248,11,20,-9
9,2,249,10,11,-1
9,2,250,19,13,6
9,2,251,7,10,-3
9,2,252,9,10,-1
9,2,253,20,18,2
9,2,254,9,6,3
9,2,255,4,7,-3
9,2,256,11,18,-7
9,2,257,3,8,-5
9,2,258,5,16,-11
9,2,259,8,13,-5
9,2,260,10,12,-2
9,2,261,8,13,-5
9,2,262,14,14,0
9,2,263,7,17,-10
9,2,264,8,19,-11
9,2,265,5,20,-15
9,2,266,16,16,0
9,2,267,17,8,9
9,2,268,13,19,-6
9,2,269,14,12,2
9,2,270,15,22,-7
9,2,271,15,13,2
9,2,272,9,20,-11
9,2,273,12,17,-5
9,2,274,14,19,-5
9,2,275,11,14,-3
9,2,276,12,10,2
9,2,277,8,7,1
9,2,278,8,22,-14
9,2,279,9,14,-5
9,2,280,15,19,-4
9,2,281,7,28,-21
9,2,282,5,9,-4
9,2,283,11,9,2
9,2,284,15,22,-7
9,2,285,10,10,0
9,2,286,9,8,1
9,2,287,19,35,-16
9,2,288,6,8,-2
9,2,289,12,8,4
9,2,290,4,6,-2
9,2,291,6,7,-1
9,2,292,2,6,-4
9,2,293,4,14,-10
9,2,294,7,21,-14
9,2,295,15,18,-3
9,2,296,22,12,10
9,2,297,5,18,-13
9,2,298,7,17,-10
9,2,299,4,11,-7
9,3,0,8,30,-22
9,3,1,10,15,-5
9,3,2,4,11,-7
9,3,3,8,13,-5
9,3,4,10,4,6
9,3,5,10,12,-2
9,3,6,5,12,-7
9,3,7,7,16,-9
9,3,8,8,18,-10
9,3,9,15,14,1
9,3,10,16,16,0
9,3,11,11,12,-1
9,3,12,10,19,-9
9,3,13,11,7,4
9,3,14,16,17,-1
9,3,15,15,10,5
9,3,16,11,11,0
9,3,17,16,10,6
9,3,18,13,18,-5
9,3,19,6,15,-9
9,3,20,15,24,-9
9,3,21,14,12,2
9,3,22,5,15,-10
9,3,23,12,14,-2
9,3,24,11,8,3
9,3,25,18,12,6
9,3,26,19,20,-1
9,3,27,12,4,8
9,3,28,13,30,-17
9,3,29,17,13,4
9,3,30,15,19,-4
9,3,31,12,16,-4
9,3,32,11,12,-1
9,3,33,14,9,5
9,3,34,15,13,2
9,3,35,8,15,-7
9,3,36,7,13,-6
9,3,37,18,11,7
9,3,38,11,12,-1
9,3,39,19,15,4
9,3,40,18,14,4
9,3,41,5,19,-14
9,3,42,21,18,3
9,3,43,15,24,-9
9,3,44,14,20,-6
9,3,45,9,21,-12
9,3,46,8,19,-11
9,3,47,5,5,0
9,3,48,7,9,-2
9,3,49,18,17,1
9,3,50,2,11,-9
9,3,51,9,15,-6
9,3,52,8,12,-4
9,3,53,7,16,-9
9,3,54,7,17,-10
9,3,55,11,9,2
9,3,56,6,12,-6
9,3,57,7,10,-3
9,3,58,8,15,-7
9,3,59,17,22,-5
9,3,60,10,7,3
9,3,61,13,21,-8
9,3,62,15,18,-3
9,3,63,16,15,1
9,3,64,4,26,-22
9,3,65,10,14,-4
9,3,66,7,12,-5
9,3,67,9,24,-15
9,3,68,5,14,-9
9,3,69,6,7,-1
9,3,70,12,17,-5
9,3,71,5,15,-10
9,3,72,8,16,-8
9,3,73,11,12,-1
9,3,74,19,19,0
9,3,75,9,16,-7
9,3,76,12,7,5
9,3,77,16,22,-6
9,3,78,7,11,-4
9,3,79,22,37,-15
9,3,80,4,4,0
9,3,81,7,9,-2
9,3,82,11,16,-5
9,3,83,22,19,3
9,3,84,7,13,-6
9,3,85,7,11,-4
9,3,86,11,9,2
9,3,87,6,17,-11
9,3,88,2,12,-10
9,3,89,12,22,-10
9,3,90,17,12,5
9,3,91,9,14,-5
9,3,92,14,12,2
9,3,93,17,11,6
9,3,94,8,23,-15
9,3,95,14,21,-7
9,3,96,12,9,3
9,3,97,6,11,-5
9,3,98,12,8,4
9,3,99,10,16,-6
9,3,100,17,20,-3
9,3,101,19,19,0
9,3,102,6,15,-9
9,3,103,7,13,-6
9,3,104,17,31,-14
9,3,105,15,20,-5
9,3,106,11,11,0
9,3,107,12,11,1
9,3,108,3,17,-14
9,3,109,21,23,-2
9,3,110,8,12,-4
9,3,111,13,26,-13
9,3,112,7,10,-3
9,3,113,20,16,4
9,3,114,19,23,-4
9,3,115,3,18,-15
9,3,116,13,17,-4
9,3,117,5,12,-7
9,3,118,21,25,-4
9,3,119,5,7,-2
9,3,120,8,8,0
9,3,121,9,13,-4
9,3,122,13,8,5
9,3,123,21,18,3
9,3,124,13,9,4
9,3,125,17,19,-2
9,3,126,12,21,-9
9,3,127,9,12,-3
9,3,128,13,13,0
9,3,129,3,8,-5
9,3,130,10,12,-2
9,3,131,19,26,-7
9,3,132,13,14,-1
9,3,133,12,25,-13
9,3,134,7,12,-5
9,3,135,5,13,-8
9,3,136,8,12,-4
9,3,137,10,12,-2
9,3,138,9,31,-22
9,3,139,7,7,0
9,3,140,15,8,7
9,3,141,9,13,-4
9,3,142,20,15,5
9,3,143,6,24,-18
9,3,144,4,19,-15
9,3,145,9,15,-6
9,3,146,17,30,-13
9,3,147,8,14,-6
9,3,148,5,25,-20
9,3,149,5,14,-9
9,3,150,6,14,-8
9,3,151,17,25,-8
9,3,152,14,12,2
9,3,153,11,13,-2
9,3,154,8,10,-2
9,3,155,17,14,3
9,3,156,16,11,5
9,3,157,10,13,-3
9,3,158,13,29,-16
9,3,159,7,7,0
9,3,160,30,22,8
9,3,161,7,13,-6
9,3,162,9,9,0
9,3,163,14,13,1
9,3,164,6,13,-7
9,3,165,13,17,-4
9,3,166,13,18,-5
9,3,167,5,10,-5
9,3,168,19,12,7
9,3,169,7,11,-4
9,3,170,5,8,-3
9,3,171,8,14,-6
9,3,172,23,17,6
9,3,173,7,12,-5
9,3,174,10,16,-6
9,3,175,4,6,-2
9,3,176,7,12,-5
9,3,177,17,19,-2
9,3,178,5,13,-8
9,3,179,21,16,5
9,3,180,14,18,-4
9,3,181,19,16,3
9,3,182,18,15,3
9,3,183,17,22,-5
9,3,184,14,14,0
9,3,185,16,11,5
9,3,186,8,9,-1
9,3,187,17,23,-6
9,3,188,8,16,-8
9,3,189,18,23,-5
9,3,190,12,15,-3
9,3,191,15,20,-5
9,3,192,3,8,-5
9,3,193,13,15,-2
9,3,194,5,14,-9
9,3,195,12,9,3
9,3,196,14,15,-1
9,3,197,20,23,-3
9,3,198,13,28,-15
9,3,199,6,7,-1
9,3,200,8,28,-20
9,3,201,9,13,-4
9,3,202,10,16,-6
9,3,203,15,12,3
9,3,204,4,4,0
9,3,205,7,4,3
9,3,206,9,6,3
9,3,207,19,14,5
9,3,208,8,12,-4
9,3,209,19,13,6
9,3,210,7,25,-18
9,3,211,14,13,1
9,3,212,18,12,6
9,3,213,11,13,-2
9,3,214,17,14,3
9,3,215,14,17,-3
9,3,216,18,21,-3
9,3,217,22,13,9
9,3,218,11,14,-3
9,3,219,23,24,-1
9,3,220,5,8,-3
9,3,221,9,19,-10
9,3,222,7,7,0
9,3,223,12,8,4
9,3,224,3,8,-5
9,3,225,7,20,-13
9,3,226,11,25,-14
9,3,227,31,16,15
9,3,228,5,11,-6
9,3,229,9,11,-2
9,3,230,11,18,-7
9,3,231,13,7,6
9,3,232,16,18,-2
9,3,233,13,11,2
9,3,234,4,11,-7
9,3,235,9,9,0
9,3,236,10,11,-1
9,3,237,7,14,-7
9,3,238,5,8,-3
9,3,239,17,9,8
9,3,240,4,8,-4
9,3,241,0,8,-8
9,3,242,8,12,-4
9,3,243,4,8,-4
9,3,244,4,14,-10
9,3,245,9,6,3
9,3,246,12,9,3
9,3,247,6,15,-9
9,3,248,8,22,-14
9,3,249,17,16,1
9,3,250,3,7,-4
9,3,251,10,18,-8
9,3,252,11,24,-13
9,3,253,11,9,2
9,3,254,14,18,-4
9,3,255,9,21,-12
9,3,256,9,9,0
9,3,257,10,20,-10
9,3,258,4,12,-8
9,3,259,9,12,-3
9,3,260,13,12,1
9,3,261,5,21,-16
9,3,262,12,16,-4
9,3,263,9,14,-5
9,3,264,11,10,1
9,3,265,12,9,3
9,3,266,22,21,1
9,3,267,4,4,0
9,3,268,12,15,-3
9,3,269,11,16,-5
9,3,270,5,11,-6
9,3,271,15,23,-8
9,3,272,10,27,-17
9,3,273,13,17,-4
9,3,274,6,11,-5
9,3,275,11,7,4
9,3,276,2,0,2
9,3,277,11,20,-9
9,3,278,15,5,10
9,3,279,7,12,-5
9,3,280,13,22,-9
9,3,281,10,11,-1
9,3,282,16,4,12
9,3,283,17,10,7
9,3,284,8,17,-9
9,3,285,8,8,0
9,3,286,11,14,-3
9,3,287,13,8,5
9,3,288,4,12,-8
9,3,289,23,28,-5
9,3,290,15,20,-5
9,3,291,11,17,-6
9,3,292,12,15,-3
9,3,293,16,19,-3
9,3,294,13,20,-7
9,3,295,7,9,-2
9,3,296,12,20,-8
9,3,297,14,9,5
9,3,298,12,31,-19
9,3,299,15,23,-8
9,4,0,11,23,-12
9,4,1,11,13,-2
9,4,2,6,18,-12
9,4,3,9,16,-7
9,4,4,16,14,2
9,4,5,15,6,9
9,4,6,12,18,-6
9,4,7,15,19,-4
9,4,8,11,18,-7
9,4,9,12,17,-5
9,4,10,9,17,-8
9,4,11,10,26,-16
9,4,12,15,16,-1
9,4,13,19,17,2
9,4,14,7,14,-7
9,4,15,16,17,-1
9,4,16,7,18,-11
9,4,17,9,22,-13
9,4,18,10,6,4
9,4,19,6,28,-22
9,4,20,12,20,-8
9,4,21,4,9,-5
9,4,22,12,14,-2
9,4,23,7,10,-3
9,4,24,12,13,-1
9,4,25,8,15,-7
9,4,26,7,14,-7
9,4,27,14,10,4
9,4,28,10,20,-10
9,4,29,12,12,0
9,4,30,15,14,1
9,4,31,6,8,-2
9,4,32,9,6,3
9,4,33,8,15,-7
9,4,34,18,28,-10
9,4,35,14,23,-9
9,4,36,15,16,-1
9,4,37,10,15,-5
9,4,38,4,1,3
9,4,39,9,6,3
9,4,40,6,9,-3
9,4,41,6,11,-5
9,4,42,14,22,-8
9,4,43,8,10,-2
9,4,44,13,11,2
9,4,45,6,11,-5
9,4,46,11,14,-3
9,4,47,12,24,-12
9,4,48,2,6,-4
9,4,49,12,37,-25
9,4,50,3,4,-1
9,4,51,14,9,5
9,4,52,13,22,-9
9,4,53,5,17,-12
9,4,54,9,22,-13
9,4,55,4,6,-2
9,4,56,11,17,-6
9,4,57,6,19,-13
9,4,58,17,18,-1
9,4,59,7,11,-4
9,4,60,12,15,-3
9,4,61,15,16,-1
9,4,62,6,9,-3
9,4,63,8,8,0
9,4,64,16,16,0
9,4,65,7,22,-15
9,4,66,9,15,-6
9,4,67,6,11,-5
9,4,68,14,23,-9
9,4,69,7,8,-1
9,4,70,18,19,-1
9,4,71,11,21,-10
9,4,72,8,17,-9
9,4,73,18,18,0
9,4,74,6,4,2
9,4,75,14,17,-3
9,4,76,9,11,-2
9,4,77,21,15,6
9,4,78,15,25,-10
9,4,79,12,5,7
9,4,80,12,17,-5
9,4,81,9,12,-3
9,4,82,16,7,9
9,4,83,7,11,-4
9,4,84,24,19,5
9,4,85,8,20,-12
9,4,86,11,11,0
9,4,87,14,9,5
9,4,88,14,10,4
9,4,89,10,14,-4
9,4,90,5,19,-14
9,4,91,5,21,-16
9,4,92,11,11,0
9,4,93,2,28,-26
9,4,94,20,17,3
9,4,95,13,16,-3
9,4,96,12,13,-1
9,4,97,5,9,-4
9,4,98,10,41,-31
9,4,99,15,8,7
9,4,100,15,11,4
9,4,101,9,17,-8
9,4,102,11,15,-4
9,4,103,23,21,2
9,4,104,20,23,-3
9,4,105,14,12,2
9,4,106,7,16,-9
9,4,107,8,11,-3
9,4,108,21,21,0
9,4,109,10,24,-14
9,4,110,10,8,2
9,4,111,10,12,-2
9,4,112,17,16,1
9,4,113,6,10,-4
9,4,114,15,20,-5
9,4,115,11,11,0
9,4,116,35,25,10
9,4,117,19,18,1
9,4,118,14,16,-2
9,4,119,5,8,-3
9,4,120,10,17,-7
9,4,121,20,13,7
9,4,122,11,14,-3
9,4,123,24,22,2
9,4,124,12,24,-12
9,4,125,6,14,-8
9,4,126,6,6,0
9,4,127,15,7,8
9,4,128,17,8,9
9,4,129,10,12,-2
9,4,130,26,21,5
9,4,131,8,10,-2
9,4,132,14,22,-8
9,4,133,10,18,-8
9,4,134,8,24,-16
9,4,135,15,15,0
9,4,136,17,12,5
9,4,137,14,13,1
9,4,138,24,18,6
9,4,139,16,19,-3
9,4,140,18,16,2
9,4,141,16,20,-4
9,4,142,19,10,9
9,4,143,14,9,5
9,4,144,11,6,5
9,4,145,19,14,5
9,4,146,19,24,-5
9,4,147,25,21,4
9,4,148,9,12,-3
9,4,149,3,7,-4
9,4,150,15,21,-6
9,4,151,11,19,-8
9,4,152,11,14,-3
9,4,153,2,7,-5
9,4,154,2,4,-2
9,4,155,11,23,-12
9,4,156,11,6,5
9,4,157,10,19,-9
9,4,158,22,17,5
9,4,159,20,24,-4
9,4,160,15,18,-3
9,4,161,6,16,-10
9,4,162,7,22,-15
9,4,163,22,13,9
9,4,164,11,24,-13
9,4,165,11,21,-10
9,4,166,14,12,2
9,4,167,9,10,-1
9,4,168,10,16,-6
9,4,169,13,17,-4
9,4,170,1,12,-11
9,4,171,15,18,-3
9,4,172,5,13,-8
9,4,173,25,27,-2
9,4,174,2,10,-8
9,4,175,19,15,4
9,4,176,8,19,-11
9,4,177,22,19,3
9,4,178,14,12,2
9,4,179,19,9,10
9,4,180,13,13,0
9,4,181,15,21,-6
9,4,182,11,10,1
9,4,183,13,27,-14
9,4,184,10,11,-1
9,4,185,10,7,3
9,4,186,5,11,-6
9,4,187,15,13,2
9,4,188,7,17,-10
9,4,189,20,20,0
9,4,190,8,18,-10
9,4,191,6,21,-15
9,4,192,8,19,-11
9,4,193,12,23,-11
9,4,194,8,18,-10
9,4,195,13,9,4
9,4,196,8,18,-10
9,4,197,16,22,-6
9,4,198,12,16,-4
9,4,199,13,4,9
9,4,200,16,20,-4
9,4,201,6,13,-7
9,4,202,12,19,-7
9,4,203,3,20,-17
9,4,204,13,18,-5
9,4,205,8,14,-6
9,4,206,15,16,-1
9,4,207,4,20,-16
9,4,208,11,12,-1
9,4,209,6,9,-3
9,4,210,12,14,-2
9,4,211,9,17,-8
9,4,212,12,17,-5
9,4,213,20,12,8
9,4,214,11,10,1
9,4,215,16,27,-11
9,4,216,15,19,-4
9,4,217,8,21,-13
9,4,218,9,8,1
9,4,219,27,28,-1
9,4,220,13,17,-4
9,4,221,11,16,-5
9,4,222,15,22,-7
9,4,223,12,22,-10
9,4,224,13,5,8
9,4,225,18,18,0
9,4,226,4,6,-2
9,4,227,6,11,-5
9,4,228,3,15,-12
9,4,229,14,13,1
9,4,230,14,13,1
9,4,231,10,18,-8
9,4,232,6,6,0
9,4,233,14,31,-17
9,4,234,2,6,-4
9,4,235,13,12,1
9,4,236,12,13,-1
9,4,237,5,10,-5
9,4,238,10,26,-16
9,4,239,6,17,-11
9,4,240,11,17,-6
9,4,241,13,9,4
9,4,242,20,20,0
9,4,243,7,7,0
9,4,244,17,23,-6
9,4,245,15,33,-18
9,4,246,13,15,-2
9,4,247,17,13,4
9,4,248,10,9,1
9,4,249,8,9,-1
9,4,250,15,9,6
9,4,251,8,45,-37
9,4,252,2,4,-2
9,4,253,3,12,-9
9,4,254,25,32,-7
9,4,255,9,12,-3
9,4,256,10,14,-4
9,4,257,8,12,-4
9,4,258,7,10,-3
9,4,259,8,13,-5
9,4,260,14,17,-3
9,4,261,15,17,-2
9,4,262,18,19,-1
9,4,263,9,19,-10
9,4,264,4,11,-7
9,4,265,3,22,-19
9,4,266,6,9,-3
9,4,267,11,11,0
9,4,268,7,12,-5
9,4,269,4,7,-3
9,4,270,11,22,-11
9,4,271,17,19,-2
9,4,272,11,16,-5
9,4,273,12,32,-20
9,4,274,8,8,0
9,4,275,4,7,-3
9,4,276,15,16,-1
9,4,277,9,16,-7
9,4,278,17,24,-7
9,4,279,14,35,-21
9,4,280,9,11,-2
9,4,281,12,19,-7
9,4,282,14,22,-8
9,4,283,4,9,-5
9,4,284,11,12,-1
9,4,285,16,12,4
9,4,286,3,17,-14
9,4,287,16,11,5
9,4,288,11,11,0
9,4,289,15,13,2
9,4,290,16,14,2
9,4,291,10,14,-4
9,4,292,11,14,-3
9,4,293,8,11,-3
9,4,294,11,11,0
9,4,295,7,17,-10
9,4,296,11,18,-7
9,4,297,12,29,-17
9,4,298,26,27,-1
9,4,299,24,22,2
9,5,0,9,15,-6
9,5,1,21,14,7
9,5,2,8,12,-4
9,5,3,14,14,0
9,5,4,8,22,-14
9,5,5,6,19,-13
9,5,6,22,13,9
9,5,7,11,9,2
9,5,8,16,24,-8
9,5,9,9,16,-7
9,5,10,10,17,-7
9,5,11,9,9,0
9,5,12,13,12,1
9,5,13,17,17,0
9,5,14,8,16,-8
9,5,15,21,22,-1
9,5,16,21,11,10
9,5,17,6,12,-6
9,5,18,8,10,-2
9,5,19,9,14,-5
9,5,20,10,16,-6
9,5,21,12,15,-3
9,5,22,8,27,-19
9,5,23,5,15,-10
9,5,24,12,14,-2
9,5,25,27,21,6
9,5,26,20,20,0
9,5,27,12,20,-8
9,5,28,6,16,-10
9,5,29,10,13,-3
9,5,30,20,21,-1
9,5,31,11,16,-5
9,5,32,12,20,-8
9,5,33,6,21,-15
9,5,34,8,11,-3
9,5,35,27,19,8
9,5,36,15,18,-3
9,5,37,9,12,-3
9,5,38,25,15,10
9,5,39,10,11,-1
9,5,40,2,12,-10
9,5,41,8,19,-11
9,5,42,13,18,-5
9,5,43,11,24,-13
9,5,44,9,22,-13
9,5,45,20,14,6
9,5,46,11,8,3
9,5,47,30,11,19
9,5,48,7,17,-10
9,5,49,17,27,-10
9,5,50,21,22,-1
9,5,51,13,12,1
9,5,52,30,18,12
9,5,53,11,23,-12
9,5,54,3,11,-8
9,5,55,16,16,0
9,5,56,10,13,-3
9,5,57,16,23,-7
9,5,58,9,18,-9
9,5,59,17,18,-1
9,5,60,17,17,0
9,5,61,17,18,-1
9,5,62,13,7,6
9,5,63,2,21,-19
9,5,64,27,13,14
9,5,65,5,10,-5
9,5,66,14,11,3
9,5,67,10,13,-3
9,5,68,15,23,-8
9,5,69,17,13,4
9,5,70,17,37,-20
9,5,71,7,11,-4
9,5,72,10,19,-9
9,5,73,18,10,8
9,5,74,5,13,-8
9,5,75,8,21,-13
9,5,76,18,19,-1
9,5,77,25,22,3
9,5,78,13,25,-12
9,5,79,16,12,4
9,5,80,10,25,-15
9,5,81,4,9,-5
9,5,82,10,6,4
9,5,83,0,2,-2
9,5,84,13,10,3
9,5,85,16,17,-1
9,5,86,15,18,-3
9,5,87,17,19,-2
9,5,88,5,23,-18
9,5,89,15,14,1
9,5,90,2,16,-14
9,5,91,6,7,-1
9,5,92,4,9,-5
9,5,93,12,22,-10
9,5,94,19,12,7
9,5,95,8,15,-7
9,5,96,10,25,-15
9,5,97,14,19,-5
9,5,98,21,11,10
9,5,99,18,22,-4
9,5,100,12,15,-3
9,5,101,10,22,-12
9,5,102,24,12,12
9,5,103,17,20,-3
9,5,104,11,31,-20
9,5,105,13,22,-9
9,5,106,17,11,6
9,5,107,13,6,7
9,5,108,13,20,-7
9,5,109,7,12,-5
9,5,110,8,19,-11
9,5,111,16,7,9
9,5,112,20,17,3
9,5,113,17,26,-9
9,5,114,14,13,1
9,5,115,16,16,0
9,5,116,7,21,-14
9,5,117,10,15,-5
9,5,118,14,14,0
9,5,119,7,20,-13
9,5,120,4,15,-11
9,5,121,9,21,-12
9,5,122,18,13,5
9,5,123,13,18,-5
9,5,124,7,18,-11
9,5,125,11,14,-3
9,5,126,7,15,-8
9,5,127,16,19,-3
9,5,128,16,20,-4
9,5,129,6,17,-11
9,5,130,10,19,-9
9,5,131,16,24,-8
9,5,132,7,13,-6
9,5,133,8,11,-3
9,5,134,7,10,-3
9,5,135,15,20,-5
9,5,136,16,11,5
9,5,137,10,17,-7
9,5,138,10,19,-9
9,5,139,16,17,-1
9,5,140,12,11,1
9,5,141,11,16,-5
9,5,142,6,23,-17
9,5,143,6,14,-8
9,5,144,5,14,-9
9,5,145,7,14,-7
9,5,146,10,27,-17
9,5,147,13,7,6
9,5,148,5,5,0
9,5,149,17,4,13
9,5,150,21,20,1
9,5,151,13,15,-2
9,5,152,14,7,7
9,5,153,14,16,-2
9,5,154,14,16,-2
9,5,155,10,23,-13
9,5,156,3,5,-2
9,5,157,13,14,-1
9,5,158,11,9,2
9,5,159,4,9,-5
9,5,160,16,25,-9
9,5,161,9,11,-2
9,5,162,0,9,-9
9,5,163,13,7,6
9,5,164,13,17,-4
9,5,165,15,16,-1
9,5,166,4,10,-6
9,5,167,26,26,0
9,5,168,6,8,-2
9,5,169,12,19,-7
9,5,170,16,16,0
9,5,171,12,24,-12
9,5,172,15,14,1
9,5,173,16,16,0
9,5,174,8,15,-7
9,5,175,21,10,11
9,5,176,5,2,3
9,5,177,17,18,-1
9,5,178,6,16,-10
9,5,179,15,20,-5
9,5,180,23,16,7
9,5,181,10,23,-13
9,5,182,8,12,-4
9,5,183,19,21,-2
9,5,184,14,22,-8
9,5,185,8,13,-5
9,5,186,11,18,-7
9,5,187,5,17,-12
9,5,188,14,13,1
9,5,189,12,21,-9
9,5,190,16,15,1
9,5,191,12,6,6
9,5,192,17,13,4
9,5,193,12,21,-9
9,5,194,13,14,-1
9,5,195,5,17,-12
9,5,196,6,8,-2
9,5,197,9,19,-10
9,5,198,28,34,-6
9,5,199,6,19,-13
9,5,200,11,20,-9
9,5,201,25,23,2
9,5,202,10,24,-14
9,5,203,9,20,-11
9,5,204,12,10,2
9,5,205,10,20,-10
9,5,206,16,14,2
9,5,207,11,13,-2
9,5,208,9,9,0
9,5,209,10,14,-4
9,5,210,26,26,0
9,5,211,20,16,4
9,5,212,28,19,9
9,5,213,19,19,0
9,5,214,22,16,6
9,5,215,16,15,1
9,5,216,23,12,11
9,5,217,8,15,-7
9,5,218,13,13,0
9,5,219,9,9,0
9,5,220,8,7,1
9,5,221,12,23,-11
9,5,222,12,11,1
9,5,223,7,11,-4
9,5,224,12,16,-4
9,5,225,15,13,2
9,5,226,17,15,2
9,5,227,21,21,0
9,5,228,13,17,-4
9,5,229,17,7,10
9,5,230,15,26,-11
9,5,231,19,17,2
9,5,232,13,17,-4
9,5,233,25,18,7
9,5,234,8,11,-3
9,5,235,17,12,5
9,5,236,11,16,-5
9,5,237,13,9,4
9,5,238,6,15,-9
9,5,239,14,11,3
9,5,240,16,15,1
9,5,241,4,6,-2
9,5,242,10,10,0
9,5,243,11,14,-3
9,5,244,4,23,-19
9,5,245,6,14,-8
9,5,246,10,18,-8
9,5,247,7,16,-9
9,5,248,8,16,-8
9,5,249,20,11,9
9,5,250,9,19,-10
9,5,251,12,18,-6
9,5,252,18,12,6
9,5,253,10,10,0
9,5,254,21,28,-7
9,5,255,10,9,1
9,5,256,11,11,0
9,5,257,10,16,-6
9,5,258,16,21,-5
9,5,259,16,15,1
9,5,260,3,10,-7
9,5,261,13,3,10
9,5,262,17,7,10
9,5,263,18,19,-1
9,5,264,16,18,-2
9,5,265,18,12,6
9,5,266,7,12,-5
9,5,267,17,18,-1
9,5,268,4,13,-9
9,5,269,2,10,-8
9,5,270,10,5,5
9,5,271,10,10,0
9,5,272,15,17,-2
9,5,273,10,18,-8
9,5,274,8,10,-2
9,5,275,6,10,-4
9,5,276,10,19,-9
9,5,277,14,8,6
9,5,278,9,12,-3
9,5,279,19,22,-3
9,5,280,25,14,11
9,5,281,10,16,-6
9,5,282,9,25,-16
9,5,283,14,14,0
9,5,284,9,13,-4
9,5,285,5,17,-12
9,5,286,12,9,3
9,5,287,16,15,1
9,5,288,9,13,-4
9,5,289,8,15,-7
9,5,290,6,23,-17
9,5,291,15,10,5
9,5,292,4,12,-8
9,5,293,17,18,-1
9,5,294,12,10,2
9,5,295,20,34,-14
9,5,296,5,11,-6
9,5,297,16,13,3
9,5,298,21,18,3
9,5,299,10,30,-20
9,6,0,24,29,-5
9,6,1,16,12,4
9,6,2,7,18,-11
9,6,3,14,15,-1
9,6,4,16,20,-4
9,6,5,8,15,-7
9,6,6,7,16,-9
9,6,7,8,22,-14
9,6,8,13,20,-7
9,6,9,12,9,3
9,6,10,7,14,-7
9,6,11,9,17,-8
9,6,12,7,3,4
9,6,13,5,16,-11
9,6,14,1,14,-13
9,6,15,23,9,14
9,6,16,18,16,2
9,6,17,21,13,8
9,6,18,8,10,-2
9,6,19,18,16,2
9,6,20,20,10,10
9,6,21,7,16,-9
9,6,22,18,19,-1
9,6,23,10,16,-6
9,6,24,5,10,-5
9,6,25,8,5,3
9,6,26,8,13,-5
9,6,27,6,16,-10
9,6,28,16,11,5
9,6,29,20,19,1
9,6,30,10,15,-5
9,6,31,10,19,-9
9,6,32,6,5,1
9,6,33,13,22,-9
9,6,34,13,17,-4
9,6,35,18,20,-2
9,6,36,13,23,-10
9,6,37,13,16,-3
9,6,38,13,12,1
9,6,39,5,12,-7
9,6,40,22,16,6
9,6,41,13,9,4
9,6,42,13,8,5
9,6,43,18,15,3
9,6,44,9,18,-9
9,6,45,10,7,3
9,6,46,17,16,1
9,6,47,10,16,-6
9,6,48,15,23,-8
9,6,49,15,23,-8
9,6,50,17,20,-3
9,6,51,17,20,-3
9,6,52,25,31,-6
9,6,53,17,27,-10
9,6,54,21,29,-8
9,6,55,9,11,-2
9,6,56,12,20,-8
9,6,57,18,21,-3
9,6,58,16,20,-4
9,6,59,4,19,-15
9,6,60,9,7,2
9,6,61,38,26,12
9,6,62,8,11,-3
9,6,63,9,11,-2
9,6,64,29,17,12
9,6,65,13,24,-11
9,6,66,15,10,5
9,6,67,21,22,-1
9,6,68,14,14,0
9,6,69,21,13,8
9,6,70,14,16,-2
9,6,71,4,14,-10
9,6,72,17,14,3
9,6,73,16,18,-2
9,6,74,11,17,-6
9,6,75,6,9,-3
9,6,76,10,27,-17
9,6,77,12,11,1
9,6,78,19,16,3
9,6,79,8,10,-2
9,6,80,20,21,-1
9,6,81,6,8,-2
9,6,82,19,19,0
9,6,83,3,13,-10
9,6,84,19,13,6
9,6,85,15,15,0
9,6,86,9,7,2
9,6,87,8,14,-6
9,6,88,23,8,15
9,6,89,9,9,0
9,6,90,15,5,10
9,6,91,15,21,-6
9,6,92,19,20,-1
9,6,93,5,2,3
9,6,94,14,19,-5
9,6,95,14,18,-4
9,6,96,9,15,-6
9,6,97,12,30,-18
9,6,98,15,22,-7
9,6,99,16,20,-4
9,6,100,21,13,8
9,6,101,19,22,-3
9,6,102,17,15,2
9,6,103,10,18,-8
9,6,104,20,16,4
9,6,105,21,19,2
9,6,106,6,10,-4
9,6,107,14,29,-15
9,6,108,11,14,-3
9,6,109,26,21,5
9,6,110,18,21,-3
9,6,111,9,22,-13
9,6,112,10,16,-6
9,6,113,19,8,11
9,6,114,29,22,7
9,6,115,9,19,-10
9,6,116,26,24,2
9,6,117,14,5,9
9,6,118,30,21,9
9,6,119,26,20,6
9,6,120,18,17,1
9,6,121,4,23,-19
9,6,122,18,18,0
9,6,123,25,19,6
9,6,124,36,17,19
9,6,125,14,14,0
9,6,126,14,10,4
9,6,127,21,21,0
9,6,128,11,18,-7
9,6,129,10,23,-13
9,6,130,15,19,-4
9,6,131,3,19,-16
9,6,132,15,20,-5
9,6,133,25,22,3
9,6,134,11,7,4
9,6,135,20,6,14
9,6,136,10,18,-8
9,6,137,24,20,4
9,6,138,20,11,9
9,6,139,17,26,-9
9,6,140,15,20,-5
9,6,141,8,24,-16
9,6,142,10,13,-3
9,6,143,22,17,5
9,6,144,12,24,-12
9,6,145,9,23,-14
9,6,146,17,19,-2
9,6,147,16,18,-2
9,6,148,12,16,-4
9,6,149,21,13,8
9,6,150,7,25,-18
9,6,151,11,13,-2
9,6,152,17,19,-2
9,6,153,20,17,3
9,6,154,14,14,0
9,6,155,16,18,-2
9,6,156,8,26,-18
9,6,157,10,13,-3
9,6,158,4,11,-7
9,6,159,11,22,-11
9,6,160,12,7,5
9,6,161,5,26,-21
9,6,162,16,18,-2
9,6,163,17,20,-3
9,6,164,12,11,1
9,6,165,20,21,-1
9,6,166,15,16,-1
9,6,167,8,18,-10
9,6,168,7,20,-13
9,6,169,27,23,4
9,6,170,12,15,-3
9,6,171,10,14,-4
9,6,172,8,13,-5
9,6,173,14,17,-3
9,6,174,15,20,-5
9,6,175,10,15,-5
9,6,176,16,22,-6
9,6,177,4,20,-16
9,6,178,6,15,-9
9,6,179,9,20,-11
9,6,180,12,18,-6
9,6,181,12,15,-3
9,6,182,1,21,-20
9,6,183,23,16,7
9,6,184,15,10,5
9,6,185,21,23,-2
9,6,186,11,10,1
9,6,187,16,27,-11
9,6,188,16,31,-15
9,6,189,4,13,-9
9,6,190,17,17,0
9,6,191,20,19,1
9,6,192,13,22,-9
9,6,193,21,17,4
9,6,194,8,22,-14
9,6,195,13,10,3
9,6,196,17,20,-3
9,6,197,20,7,13
9,6,198,10,10,0
9,6,199,24,17,7
9,6,200,11,28,-17
9,6,201,30,20,10
9,6,202,6,10,-4
9,6,203,6,16,-10
9,6,204,14,15,-1
9,6,205,21,23,-2
9,6,206,10,13,-3
9,6,207,19,22,-3
9,6,208,4,16,-12
9,6,209,24,20,4
9,6,210,15,20,-5
9,6,211,19,23,-4
9,6,212,15,15,0
9,6,213,19,21,-2
9,6,214,15,16,-1
9,6,215,7,14,-7
9,6,216,12,11,1
9,6,217,27,26,1
9,6,218,17,19,-2
9,6,219,11,21,-10
9,6,220,6,13,-7
9,6,221,11,10,1
9,6,222,14,12,2
9,6,223,5,13,-8
9,6,224,3,22,-19
9,6,225,24,12,12
9,6,226,8,6,2
9,6,227,18,11,7
9,6,228,13,8,5
9,6,229,16,7,9
9,6,230,8,13,-5
9,6,231,13,10,3
9,6,232,5,15,-10
9,6,233,20,23,-3
9,6,234,7,8,-1
9,6,235,5,9,-4
9,6,236,13,18,-5
9,6,237,20,18,2
9,6,238,13,11,2
9,6,239,9,10,-1
9,6,240,11,25,-14
9,6,241,20,28,-8
9,6,242,10,20,-10
9,6,243,19,23,-4
9,6,244,3,13,-10
9,6,245,11,14,-3
9,6,246,13,14,-1
9,6,247,13,18,-5
9,6,248,13,9,4
9,6,249,12,21,-9
9,6,250,13,18,-5
9,6,251,13,11,2
9,6,252,14,12,2
9,6,253,20,17,3
9,6,254,6,11,-5
9,6,255,14,11,3
9,6,256,13,18,-5
9,6,257,22,17,5
9,6,258,11,21,-10
9,6,259,9,26,-17
9,6,260,27,23,4
9,6,261,15,24,-9
9,6,262,4,15,-11
9,6,263,19,17,2
9,6,264,17,20,-3
9,6,265,8,15,-7
9,6,266,24,6,18
9,6,267,6,2,4
9,6,268,13,9,4
9,6,269,14,17,-3
9,6,270,17,23,-6
9,6,271,16,14,2
9,6,272,16,10,6
9,6,273,14,21,-7
9,6,274,10,3,7
9,6,275,14,22,-8
9,6,276,23,21,2
9,6,277,7,17,-10
9,6,278,11,26,-15
9,6,279,11,18,-7
9,6,280,16,26,-10
9,6,281,6,22,-16
9,6,282,11,10,1
9,6,283,15,16,-1
9,6,284,18,25,-7
9,6,285,17,17,0
9,6,286,20,31,-11
9,6,287,16,22,-6
9,6,288,8,17,-9
9,6,289,18,18,0
9,6,290,16,12,4
9,6,291,18,10,8
9,6,292,14,18,-4
9,6,293,11,20,-9
9,6,294,12,11,1
9,6,295,16,21,-5
9,6,296,10,16,-6
9,6,297,17,29,-12
9,6,298,7,5,2
9,6,299,12,12,0
9,7,0,7,11,-4
9,7,1,19,16,3
9,7,2,15,15,0
9,7,3,20,16,4
9,7,4,4,18,-14
9,7,5,16,15,1
9,7,6,6,34,-28
9,7,7,25,20,5
9,7,8,13,15,-2
9,7,9,17,15,2
9,7,10,4,8,-4
9,7,11,11,15,-4
9,7,12,15,35,-20
9,7,13,6,5,1
9,7,14,4,5,-1
9,7,15,18,18,0
9,7,16,15,16,-1
9,7,17,15,25,-10
9,7,18,4,12,-8
9,7,19,14,16,-2
9,7,20,15,12,3
9,7,21,10,8,2
9,7,22,16,21,-5
9,7,23,15,19,-4
9,7,24,12,11,1
9,7,25,14,26,-12
9,7,26,14,18,-4
9,7,27,5,15,-10
9,7,28,9,20,-11
9,7,29,10,16,-6
9,7,30,11,20,-9
9,7,31,14,13,1
9,7,32,15,13,2
9,7,33,7,17,-10
9,7,34,13,16,-3
9,7,35,9,13,-4
9,7,36,19,20,-1
9,7,37,12,15,-3
9,7,38,15,9,6
9,7,39,10,13,-3
9,7,40,22,11,11
9,7,41,7,5,2
9,7,42,12,21,-9
9,7,43,11,28,-17
9,7,44,22,18,4
9,7,45,8,6,2
9,7,46,7,20,-13
9,7,47,15,17,-2
9,7,48,22,11,11
9,7,49,12,10,2
9,7,50,15,7,8
9,7,51,23,25,-2
9,7,52,28,20,8
9,7,53,14,14,0
9,7,54,19,16,3
9,7,55,6,9,-3
9,7,56,13,21,-8
9,7,57,18,8,10
9,7,58,11,20,-9
9,7,59,28,15,13
9,7,60,15,12,3
9,7,61,19,11,8
9,7,62,19,25,-6
9,7,63,5,10,-5
9,7,64,13,10,3
9,7,65,12,12,0
9,7,66,12,14,-2
9,7,67,13,13,0
9,7,68,7,16,-9
9,7,69,18,7,11
9,7,70,13,7,6
9,7,71,14,19,-5
9,7,72,9,15,-6
9,7,73,4,11,-7
9,7,74,9,12,-3
9,7,75,14,17,-3
9,7,76,5,10,-5
9,7,77,17,15,2
9,7,78,14,17,-3
9,7,79,17,21,-4
9,7,80,2,19,-17
9,7,81,6,19,-13
9,7,82,15,23,-8
9,7,83,18,21,-3
9,7,84,15,15,0
9,7,85,18,16,2
9,7,86,6,18,-12
9,7,87,10,11,-1
9,7,88,11,15,-4
9,7,89,23,14,9
9,7,90,23,17,6
9,7,91,8,16,-8
9,7,92,8,16,-8
9,7,93,14,22,-8
9,7,94,30,25,5
9,7,95,28,20,8
9,7,96,21,22,-1
9,7,97,16,16,0
9,7,98,24,20,4
9,7,99,7,11,-4
9,7,100,6,20,-14
9,7,101,15,18,-3
9,7,102,16,4,12
9,7,103,4,5,-1
9,7,104,10,6,4
9,7,105,10,10,0
9,7,106,12,17,-5
9,7,107,14,17,-3
9,7,108,10,22,-12
9,7,109,12,21,-9
9,7,110,15,12,3
9,7,111,23,20,3
9,7,112,18,26,-8
9,7,113,11,14,-3
9,7,114,10,20,-10
9,7,115,10,18,-8
9,7,116,6,5,1
9,7,117,16,17,-1
9,7,118,14,19,-5
9,7,119,15,29,-14
9,7,120,11,16,-5
9,7,121,9,14,-5
9,7,122,31,12,19
9,7,123,24,17,7
9,7,124,7,5,2
9,7,125,15,17,-2
9,7,126,14,17,-3
9,7,127,7,13,-6
9,7,128,11,17,-6
9,7,129,22,17,5
9,7,130,10,10,0
9,7,131,19,15,4
9,7,132,8,28,-20
9,7,133,17,19,-2
9,7,134,11,16,-5
9,7,135,8,5,3
9,7,136,21,22,-1
9,7,137,13,11,2
9,7,138,21,16,5
9,7,139,21,28,-7
9,7,140,18,14,4
9,7,141,12,9,3
9,7,142,13,18,-5
9,7,143,24,8,16
9,7,144,21,17,4
9,7,145,17,12,5
9,7,146,11,20,-9
9,7,147,12,24,-12
9,7,148,19,18,1
9,7,149,2,13,-11
9,7,150,15,22,-7
9,7,151,9,17,-8
9,7,152,16,23,-7
9,7,153,16,21,-5
9,7,154,8,13,-5
9,7,155,10,24,-14
9,7,156,13,14,-1
9,7,157,19,11,8
9,7,158,11,10,1
9,7,159,10,19,-9
9,7,160,11,18,-7
9,7,161,16,16,0
9,7,162,16,16,0
9,7,163,10,11,-1
9,7,164,22,17,5
9,7,165,23,21,2
9,7,166,17,12,5
9,7,167,20,32,-12
9,7,168,10,17,-7
9,7,169,12,22,-10
9,7,170,10,21,-11
9,7,171,16,32,-16
9,7,172,19,9,10
9,7,173,8,18,-10
9,7,174,7,20,-13
9,7,175,14,21,-7
9,7,176,13,15,-2
9,7,177,24,15,9
9,7,178,11,16,-5
9,7,179,17,13,4
9,7,180,9,20,-11
9,7,181,7,15,-8
9,7,182,9,6,3
9,7,183,16,16,0
9,7,184,10,13,-3
9,7,185,11,15,-4
9,7,186,5,7,-2
9,7,187,10,11,-1
9,7,188,15,36,-21
9,7,189,19,26,-7
9,7,190,7,26,-19
9,7,191,10,8,2
9,7,192,15,9,6
9,7,193,18,15,3
9,7,194,15,33,-18
9,7,195,12,13,-1
9,7,196,14,13,1
9,7,197,15,28,-13
9,7,198,24,22,2
9,7,199,13,10,3
9,7,200,8,8,0
9,7,201,8,7,1
9,7,202,22,14,8
9,7,203,23,21,2
9,7,204,15,21,-6
9,7,205,13,19,-6
9,7,206,10,15,-5
9,7,207,20,13,7
9,7,208,21,12,9
9,7,209,26,20,6
9,7,210,10,15,-5
9,7,211,14,22,-8
9,7,212,26,15,11
9,7,213,1,12,-11
9,7,214,9,19,-10
9,7,215,21,9,12
9,7,216,11,23,-12
9,7,217,17,18,-1
9,7,218,11,23,-12
9,7,219,20,19,1
9,7,220,26,16,10
9,7,221,12,26,-14
9,7,222,22,22,0
9,7,223,13,22,-9
9,7,224,11,25,-14
9,7,225,16,9,7
9,7,226,4,17,-13
9,7,227,9,17,-8
9,7,228,13,28,-15
9,7,229,12,38,-26
9,7,230,14,14,0
9,7,231,12,17,-5
9,7,232,14,12,2
9,7,233,7,11,-4
9,7,234,5,18,-13
9,7,235,10,14,-4
9,7,236,22,27,-5
9,7,237,15,13,2
9,7,238,20,21,-1
9,7,239,14,18,-4
9,7,240,13,18,-5
9,7,241,7,9,-2
9,7,242,19,18,1
9,7,243,17,15,2
9,7,244,11,16,-5
9,7,245,7,12,-5
9,7,246,9,21,-12
9,7,247,3,2,1
9,7,248,14,12,2
9,7,249,12,19,-7
9,7,250,12,13,-1
9,7,251,10,5,5
9,7,252,26,32,-6
9,7,253,12,17,-5
9,7,254,12,11,1
9,7,255,15,25,-10
9,7,256,18,14,4
9,7,257,6,11,-5
9,7,258,7,19,-12
9,7,259,6,12,-6
9,7,260,19,23,-4
9,7,261,14,10,4
9,7,262,18,15,3
9,7,263,17,15,2
9,7,264,8,13,-5
9,7,265,10,8,2
9,7,266,22,20,2
9,7,267,5,16,-11
9,7,268,6,10,-4
9,7,269,20,18,2
9,7,270,24,25,-1
9,7,271,24,11,13
9,7,272,7,8,-1
9,7,273,15,17,-2
9,7,274,8,13,-5
9,7,275,14,16,-2
9,7,276,12,14,-2
9,7,277,19,14,5
9,7,278,21,14,7
9,7,279,20,27,-7
9,7,280,7,10,-3
9,7,281,10,6,4
9,7,282,22,14,8
9,7,283,16,3,13
9,7,284,6,7,-1
9,7,285,8,7,1
9,7,286,11,16,-5
9,7,287,10,15,-5
9,7,288,11,12,-1
9,7,289,19,11,8
9,7,290,22,18,4
9,7,291,11,11,0
9,7,292,11,6,5
9,7,293,27,15,12
9,7,294,30,22,8
9,7,295,31,16,15
9,7,296,16,22,-6
9,7,297,9,23,-14
9,7,298,23,17,6
9,7,299,10,16,-6
9,8,0,18,15,3
9,8,1,20,23,-3
9,8,2,12,0,12
9,8,3,20,13,7
9,8,4,11,11,0
9,8,5,13,11,2
9,8,6,21,9,12
9,8,7,20,10,10
9,8,8,24,9,15
9,8,9,10,21,-11
9,8,10,11,13,-2
9,8,11,21,7,14
9,8,12,4,11,-7
9,8,13,12,16,-4
9,8,14,7,8,-1
9,8,15,18,22,-4
9,8,16,7,21,-14
9,8,17,19,15,4
9,8,18,13,11,2
9,8,19,15,14,1
9,8,20,15,21,-6
9,8,21,16,10,6
9,8,22,8,21,-13
9,8,23,18,24,-6
9,8,24,13,11,2
9,8,25,12,17,-5
9,8,26,18,13,5
9,8,27,17,17,0
9,8,28,4,5,-1
9,8,29,11,14,-3
9,8,30,18,20,-2
9,8,31,10,13,-3
9,8,32,12,7,5
9,8,33,8,18,-10
9,8,34,24,22,2
9,8,35,2,9,-7
9,8,36,8,15,-7
9,8,37,15,24,-9
9,8,38,24,6,18
9,8,39,15,21,-6
9,8,40,1,23,-22
9,8,41,12,10,2
9,8,42,12,15,-3
9,8,43,11,41,-30
9,8,44,18,19,-1
9,8,45,9,21,-12
9,8,46,13,17,-4
9,8,47,10,14,-4
9,8,48,17,9,8
9,8,49,18,20,-2
9,8,50,17,15,2
9,8,51,7,17,-10
9,8,52,21,10,11
9,8,53,9,14,-5
9,8,54,19,24,-5
9,8,55,19,18,1
9,8,56,21,16,5
9,8,57,17,25,-8
9,8,58,24,17,7
9,8,59,10,18,-8
9,8,60,10,10,0
9,8,61,18,15,3
9,8,62,16,9,7
9,8,63,12,26,-14
9,8,64,20,16,4
9,8,65,22,13,9
9,8,66,15,16,-1
9,8,67,14,22,-8
9,8,68,18,18,0
9,8,69,10,16,-6
9,8,70,5,11,-6
9,8,71,13,21,-8
9,8,72,11,11,0
9,8,73,4,12,-8
9,8,74,20,18,2
9,8,75,12,31,-19
9,8,76,6,4,2
9,8,77,11,15,-4
9,8,78,14,16,-2
9,8,79,31,10,21
9,8,80,15,24,-9
9,8,81,17,19,-2
9,8,82,11,25,-14
9,8,83,5,20,-15
9,8,84,16,13,3
9,8,85,16,13,3
9,8,86,13,14,-1
9,8,87,2,6,-4
9,8,88,8,7,1
9,8,89,10,14,-4
9,8,90,19,20,-1
9,8,91,20,37,-17
9,8,92,17,10,7
9,8,93,25,13,12
9,8,94,12,13,-1
9,8,95,4,18,-14
9,8,96,17,17,0
9,8,97,13,20,-7
9,8,98,5,16,-11
9,8,99,2,10,-8
9,8,100,15,21,-6
9,8,101,20,16,4
9,8,102,17,46,-29
9,8,103,16,19,-3
9,8,104,14,16,-2
9,8,105,16,22,-6
9,8,106,21,19,2
9,8,107,23,16,7
9,8,108,11,14,-3
9,8,109,19,11,8
9,8,110,6,9,-3
9,8,111,16,23,-7
9,8,112,8,10,-2
9,8,113,12,11,1
9,8,114,12,11,1
9,8,115,15,26,-11
9,8,116,19,43,-24
9,8,117,6,16,-10
9,8,118,12,12,0
9,8,119,11,14,-3
9,8,120,9,17,-8
9,8,121,11,14,-3
9,8,122,7,16,-9
9,8,123,26,15,11
9,8,124,5,16,-11
9,8,125,22,22,0
9,8,126,13,10,3
9,8,127,20,13,7
9,8,128,23,27,-4
9,8,129,13,8,5
9,8,130,13,22,-9
9,8,131,13,9,4
9,8,132,13,12,1
9,8,133,5,13,-8
9,8,134,6,10,-4
9,8,135,19,19,0
9,8,136,13,23,-10
9,8,137,10,11,-1
9,8,138,20,14,6
9,8,139,10,9,1
9,8,140,10,16,-6
9,8,141,13,14,-1
9,8,142,13,16,-3
9,8,143,9,18,-9
9,8,144,4,23,-19
9,8,145,15,24,-9
9,8,146,9,17,-8
9,8,147,11,9,2
9,8,148,12,13,-1
9,8,149,17,27,-10
9,8,150,13,13,0
9,8,151,16,18,-2
9,8,152,22,17,5
9,8,153,23,18,5
9,8,154,22,21,1
9,8,155,17,10,7
9,8,156,16,16,0
9,8,157,22,16,6
9,8,158,9,19,-10
9,8,159,11,22,-11
9,8,160,21,13,8
9,8,161,8,21,-13
9,8,162,11,9,2
9,8,163,14,12,2
9,8,164,12,9,3
9,8,165,16,11,5
9,8,166,18,15,3
9,8,167,15,8,7
9,8,168,20,19,1
9,8,169,8,8,0
9,8,170,17,16,1
9,8,171,20,17,3
9,8,172,11,16,-5
9,8,173,9,22,-13
9,8,174,18,26,-8
9,8,175,12,25,-13
9,8,176,17,8,9
9,8,177,7,10,-3
9,8,178,9,17,-8
9,8,179,21,12,9
9,8,180,14,10,4
9,8,181,10,13,-3
9,8,182,15,22,-7
9,8,183,15,14,1
9,8,184,12,24,-12
9,8,185,12,24,-12
9,8,186,11,20,-9
9,8,187,16,19,-3
9,8,188,19,12,7
9,8,189,4,9,-5
9,8,190,13,20,-7
9,8,191,13,21,-8
9,8,192,6,16,-10
9,8,193,10,11,-1
9,8,194,16,13,3
9,8,195,5,12,-7
9,8,196,6,12,-6
9,8,197,10,11,-1
9,8,198,14,14,0
9,8,199,14,12,2
9,8,200,23,10,13
9,8,201,20,20,0
9,8,202,7,9,-2
9,8,203,12,22,-10
9,8,204,14,23,-9
9,8,205,13,9,4
9,8,206,12,14,-2
9,8,207,12,24,-12
9,8,208,9,23,-14
9,8,209,17,16,1
9,8,210,9,21,-12
9,8,211,4,3,1
9,8,212,6,15,-9
9,8,213,15,28,-13
9,8,214,14,15,-1
9,8,215,12,17,-5
9,8,216,11,22,-11
9,8,217,10,10,0
9,8,218,12,16,-4
9,8,219,13,22,-9
9,8,220,17,22,-5
9,8,221,21,15,6
9,8,222,23,15,8
9,8,223,22,25,-3
9,8,224,11,14,-3
9,8,225,15,15,0
9,8,226,7,14,-7
9,8,227,16,13,3
9,8,228,11,19,-8
9,8,229,7,10,-3
9,8,230,7,8,-1
9,8,231,19,16,3
9,8,232,10,24,-14
9,8,233,13,29,-16
9,8,234,17,24,-7
9,8,235,7,14,-7
9,8,236,13,15,-2
9,8,237,12,15,-3
9,8,238,14,16,-2
9,8,239,8,6,2
9,8,240,21,23,-2
9,8,241,15,10,5
9,8,242,10,10,0
9,8,243,15,8,7
9,8,244,30,30,0
9,8,245,32,31,1
9,8,246,22,20,2
9,8,247,23,16,7
9,8,248,17,6,11
9,8,249,31,22,9
9,8,250,19,10,9
9,8,251,9,5,4
9,8,252,19,16,3
9,8,253,17,12,5
9,8,254,16,11,5
9,8,255,12,17,-5
9,8,256,9,15,-6
9,8,257,5,18,-13
9,8,258,5,18,-13
9,8,259,15,19,-4
9,8,260,13,13,0
9,8,261,17,15,2
9,8,262,13,15,-2
9,8,263,18,11,7
9,8,264,21,24,-3
9,8,265,13,14,-1
9,8,266,16,17,-1
9,8,267,18,17,1
9,8,268,13,16,-3
9,8,269,10,20,-10
9,8,270,17,17,0
9,8,271,9,25,-16
9,8,272,26,19,7
9,8,273,5,6,-1
9,8,274,16,12,4
9,8,275,11,8,3
9,8,276,4,13,-9
9,8,277,10,13,-3
9,8,278,16,15,1
9,8,279,12,14,-2
9,8,280,19,25,-6
9,8,281,11,15,-4
9,8,282,27,11,16
9,8,283,13,11,2
9,8,284,10,26,-16
9,8,285,18,10,8
9,8,286,22,23,-1
9,8,287,15,12,3
9,8,288,12,23,-11
9,8,289,17,12,5
9,8,290,14,18,-4
9,8,291,16,12,4
9,8,292,12,11,1
9,8,293,20,21,-1
9,8,294,26,15,11
9,8,295,13,9,4
9,8,296,13,26,-13
9,8,297,20,32,-12
9,8,298,12,13,-1
9,8,299,16,8,8
9,9,0,11,13,-2
9,9,1,18,7,11
9,9,2,10,17,-7
9,9,3,13,27,-14
9,9,4,6,15,-9
9,9,5,19,21,-2
9,9,6,15,13,2
9,9,7,10,11,-1
9,9,8,7,11,-4
9,9,9,15,10,5
9,9,10,2,25,-23
9,9,11,17,31,-14
9,9,12,9,17,-8
9,9,13,12,19,-7
9,9,14,15,21,-6
9,9,15,9,17,-8
9,9,16,19,7,12
9,9,17,21,8,13
9,9,18,14,16,-2
9,9,19,8,13,-5
9,9,20,9,10,-1
9,9,21,10,17,-7
9,9,22,22,20,2
9,9,23,9,7,2
9,9,24,8,19,-11
9,9,25,23,12,11
9,9,26,14,19,-5
9,9,27,15,18,-3
9,9,28,5,6,-1
9,9,29,17,8,9
9,9,30,9,15,-6
9,9,31,22,20,2
9,9,32,8,16,-8
9,9,33,19,16,3
9,9,34,13,23,-10
9,9,35,13,6,7
9,9,36,14,15,-1
9,9,37,22,8,14
9,9,38,11,16,-5
9,9,39,18,12,6
9,9,40,19,22,-3
9,9,41,22,16,6
9,9,42,3,9,-6
9,9,43,16,15,1
9,9,44,12,15,-3
9,9,45,18,40,-22
9,9,46,11,14,-3
9,9,47,20,21,-1
9,9,48,14,15,-1
9,9,49,9,17,-8
9,9,50,9,7,2
9,9,51,16,17,-1
9,9,52,20,22,-2
9,9,53,15,18,-3
9,9,54,8,18,-10
9,9,55,5,20,-15
9,9,56,13,14,-1
9,9,57,20,10,10
9,9,58,13,15,-2
9,9,59,17,28,-11
9,9,60,2,6,-4
9,9,61,12,15,-3
9,9,62,12,20,-8
9,9,63,23,16,7
9,9,64,17,11,6
9,9,65,28,17,11
9,9,66,12,17,-5
9,9,67,27,12,15
9,9,68,4,16,-12
9,9,69,13,17,-4
9,9,70,4,12,-8
9,9,71,26,19,7
9,9,72,15,28,-13
9,9,73,9,14,-5
9,9,74,20,25,-5
9,9,75,16,10,6
9,9,76,7,11,-4
9,9,77,9,14,-5
9,9,78,16,17,-1
9,9,79,17,9,8
9,9,80,14,20,-6
9,9,81,13,12,1
9,9,82,18,20,-2
9,9,83,20,13,7
9,9,84,8,11,-3
9,9,85,12,15,-3
9,9,86,8,13,-5
9,9,87,22,12,10
9,9,88,23,26,-3
9,9,89,10,22,-12
9,9,90,24,20,4
9,9,91,12,16,-4
9,9,92,13,25,-12
9,9,93,11,13,-2
9,9,94,8,9,-1
9,9,95,12,14,-2
9,9,96,18,31,-13
9,9,97,11,14,-3
9,9,98,12,20,-8
9,9,99,14,30,-16
9,9,100,5,15,-10
9,9,101,18,13,5
9,9,102,12,11,1
9,9,103,17,10,7
9,9,104,15,11,4
9,9,105,14,12,2
9,9,106,18,10,8
9,9,107,18,12,6
9,9,108,19,9,10
9,9,109,8,8,0
9,9,110,12,35,-23
9,9,111,10,21,-11
9,9,112,20,19,1
9,9,113,15,10,5
9,9,114,13,25,-12
9,9,115,21,13,8
9,9,116,18,29,-11
9,9,117,11,15,-4
9,9,118,11,6,5
9,9,119,12,13,-1
9,9,120,22,8,14
9,9,121,14,28,-14
9,9,122,21,31,-10
9,9,123,23,23,0
9,9,124,17,15,2
9,9,125,13,11,2
9,9,126,21,25,-4
9,9,127,16,4,12
9,9,128,10,8,2
9,9,129,7,11,-4
9,9,130,10,5,5
9,9,131,11,12,-1
9,9,132,10,11,-1
9,9,133,18,17,1
9,9,134,14,14,0
9,9,135,16,11,5
9,9,136,14,16,-2
9,9,137,13,16,-3
9,9,138,22,8,14
9,9,139,22,13,9
9,9,140,8,14,-6
9,9,141,14,15,-1
9,9,142,6,8,-2
9,9,143,11,23,-12
9,9,144,15,18,-3
9,9,145,14,29,-15
9,9,146,14,16,-2
9,9,147,14,20,-6
9,9,148,3,4,-1
9,9,149,15,12,3
9,9,150,20,17,3
9,9,151,6,11,-5
9,9,152,26,15,11
9,9,153,25,18,7
9,9,154,12,13,-1
9,9,155,19,6,13
9,9,156,17,10,7
9,9,157,19,10,9
9,9,158,6,11,-5
9,9,159,8,8,0
9,9,160,11,29,-18
9,9,161,21,21,0
9,9,162,7,11,-4
9,9,163,8,14,-6
9,9,164,20,17,3
9,9,165,9,1,8
9,9,166,18,19,-1
9,9,167,11,20,-9
9,9,168,19,20,-1
9,9,169,5,24,-19
9,9,170,22,22,0
9,9,171,14,23,-9
9,9,172,15,20,-5
9,9,173,28,10,18
9,9,174,18,10,8
9,9,175,13,20,-7
9,9,176,8,8,0
9,9,177,17,16,1
9,9,178,18,21,-3
9,9,179,6,11,-5
9,9,180,19,21,-2
9,9,181,12,15,-3
9,9,182,5,4,1
9,9,183,16,23,-7
9,9,184,8,13,-5
9,9,185,17,12,5
9,9,186,16,18,-2
9,9,187,17,21,-4
9,9,188,12,17,-5
9,9,189,6,9,-3
9,9,190,28,10,18
9,9,191,12,12,0
9,9,192,22,16,6
9,9,193,3,13,-10
9,9,194,8,20,-12
9,9,195,6,9,-3
9,9,196,14,22,-8
9,9,197,12,24,-12
9,9,198,13,17,-4
9,9,199,17,14,3
9,9,200,11,27,-16
9,9,201,16,24,-8
9,9,202,16,22,-6
9,9,203,12,13,-1
9,9,204,17,22,-5
9,9,205,17,10,7
9,9,206,11,15,-4
9,9,207,11,11,0
9,9,208,33,20,13
9,9,209,19,15,4
9,9,210,24,23,1
9,9,211,11,9,2
9,9,212,11,13,-2
9,9,213,30,11,19
9,9,214,10,5,5
9,9,215,15,21,-6
9,9,216,11,4,7
9,9,217,19,23,-4
9,9,218,11,7,4
9,9,219,6,9,-3
9,9,220,28,30,-2
9,9,221,22,19,3
9,9,222,4,16,-12
9,9,223,15,12,3
9,9,224,10,19,-9
9,9,225,20,22,-2
9,9,226,8,12,-4
9,9,227,15,21,-6
9,9,228,24,17,7
9,9,229,19,15,4
9,9,230,11,29,-18
9,9,231,13,12,1
9,9,232,18,21,-3
9,9,233,17,21,-4
9,9,234,6,21,-15
9,9,235,3,16,-13
9,9,236,12,15,-3
9,9,237,14,16,-2
9,9,238,6,15,-9
9,9,239,13,14,-1
9,9,240,17,14,3
9,9,241,16,7,9
9,9,242,16,15,1
9,9,243,13,18,-5
9,9,244,22,17,5
9,9,245,8,13,-5
9,9,246,19,26,-7
9,9,247,8,8,0
9,9,248,6,10,-4
9,9,249,6,17,-11
9,9,250,13,11,2
9,9,251,17,16,1
9,9,252,11,11,0
9,9,253,20,21,-1
9,9,254,20,15,5
9,9,255,17,10,7
9,9,256,19,23,-4
9,9,257,17,9,8
9,9,258,13,5,8
9,9,259,5,13,-8
9,9,260,12,5,7
9,9,261,10,10,0
9,9,262,8,20,-12
9,9,263,17,14,3
9,9,264,17,11,6
9,9,265,21,26,-5
9,9,266,18,34,-16
9,9,267,14,13,1
9,9,268,11,30,-19
9,9,269,27,13,14
9,9,270,18,15,3
9,9,271,24,27,-3
9,9,272,20,12,8
9,9,273,29,28,1
9,9,274,21,13,8
9,9,275,9,16,-7
9,9,276,13,12,1
9,9,277,25,19,6
9,9,278,22,25,-3
9,9,279,18,16,2
9,9,280,6,20,-14
9,9,281,24,27,-3
9,9,282,22,14,8
9,9,283,17,10,7
9,9,284,11,21,-10
9,9,285,12,23,-11
9,9,286,10,10,0
9,9,287,18,14,4
9,9,288,24,11,13
9,9,289,7,10,-3
9,9,290,1,9,-8
9,9,291,10,21,-11
9,9,292,12,16,-4
9,9,293,15,10,5
9,9,294,4,7,-3
9,9,295,14,24,-10
9,9,296,16,16,0
9,9,297,10,16,-6
9,9,298,13,17,-4
9,9,299,12,20,-8
9,10,0,9,7,2
9,10,1,15,9,6
9,10,2,4,11,-7
9,10,3,24,17,7
9,10,4,17,14,3
9,10,5,18,3,15
9,10,6,22,14,8
9,10,7,15,17,-2
9,10,8,14,8,6
9,10,9,15,23,-8
9,10,10,10,14,-4
9,10,11,10,19,-9
9,10,12,15,22,-7
9,10,13,20,8,12
9,10,14,2,6,-4
9,10,15,17,15,2
9,10,16,27,16,11
9,10,17,18,21,-3
9,10,18,13,19,-6
9,10,19,15,12,3
9,10,20,19,31,-12
9,10,21,14,14,0
9,10,22,16,12,4
9,10,23,19,17,2
9,10,24,11,6,5
9,10,25,8,15,-7
9,10,26,5,16,-11
9,10,27,18,21,-3
9,10,28,14,10,4
9,10,29,9,20,-11
9,10,30,25,17,8
9,10,31,23,25,-2
9,10,32,16,15,1
9,10,33,11,17,-6
9,10,34,19,8,11
9,10,35,17,19,-2
9,10,36,9,13,-4
9,10,37,6,11,-5
9,10,38,15,8,7
9,10,39,7,8,-1
9,10,40,6,6,0
9,10,41,8,13,-5
9,10,42,8,13,-5
9,10,43,18,21,-3
9,10,44,12,11,1
9,10,45,17,8,9
9,10,46,30,19,11
9,10,47,13,17,-4
9,10,48,20,7,13
9,10,49,22,24,-2
9,10,50,9,23,-14
9,10,51,8,9,-1
9,10,52,12,16,-4
9,10,53,9,18,-9
9,10,54,18,17,1
9,10,55,6,13,-7
9,10,56,18,12,6
9,10,57,19,23,-4
9,10,58,5,7,-2
9,10,59,23,23,0
9,10,60,16,17,-1
9,10,61,12,7,5
9,10,62,29,16,13
9,10,63,13,8,5
9,10,64,13,19,-6
9,10,65,22,20,2
9,10,66,19,21,-2
9,10,67,5,11,-6
9,10,68,13,17,-4
9,10,69,13,7,6
9,10,70,9,7,2
9,10,71,9,19,-10
9,10,72,8,11,-3
9,10,73,17,12,5
9,10,74,17,9,8
9,10,75,16,18,-2
9,10,76,14,9,5
9,10,77,15,18,-3
9,10,78,26,26,0
9,10,79,15,14,1
9,10,80,10,18,-8
9,10,81,11,26,-15
9,10,82,10,5,5
9,10,83,16,21,-5
9,10,84,16,22,-6
9,10,85,19,18,1
9,10,86,25,25,0
9,10,87,13,14,-1
9,10,88,8,7,1
9,10,89,9,16,-7
9,10,90,18,13,5
9,10,91,10,27,-17
9,10,92,4,6,-2
9,10,93,20,23,-3
9,10,94,21,18,3
9,10,95,7,24,-17
9,10,96,5,5,0
9,10,97,11,19,-8
9,10,98,18,17,1
9,10,99,17,19,-2
9,10,100,12,13,-1
9,10,101,13,14,-1
9,10,102,17,12,5
9,10,103,27,18,9
9,10,104,8,21,-13
9,10,105,19,20,-1
9,10,106,9,9,0
9,10,107,19,25,-6
9,10,108,11,12,-1
9,10,109,15,15,0
9,10,110,14,25,-11
9,10,111,16,14,2
9,10,112,11,16,-5
9,10,113,13,11,2
9,10,114,16,14,2
9,10,115,20,21,-1
9,10,116,19,12,7
9,10,117,14,12,2
9,10,118,34,21,13
9,10,119,4,2,2
9,10,120,25,22,3
9,10,121,18,18,0
9,10,122,24,18,6
9,10,123,19,5,14
9,10,124,12,19,-7
9,10,125,8,7,1
9,10,126,19,6,13
9,10,127,14,20,-6
9,10,128,19,21,-2
9,10,129,28,18,10
9,10,130,15,20,-5
9,10,131,19,15,4
9,10,132,27,26,1
9,10,133,24,20,4
9,10,134,11,9,2
9,10,135,25,31,-6
9,10,136,7,13,-6
9,10,137,19,16,3
9,10,138,3,19,-16
9,10,139,25,14,11
9,10,140,17,23,-6
9,10,141,16,23,-7
9,10,142,10,9,1
9,10,143,13,9,4
9,10,144,13,26,-13
9,10,145,11,26,-15
9,10,146,21,16,5
9,10,147,16,10,6
9,10,148,12,13,-1
9,10,149,5,7,-2
9,10,150,22,14,8
9,10,151,17,25,-8
9,10,152,11,7,4
9,10,153,10,14,-4
9,10,154,8,18,-10
9,10,155,15,17,-2
9,10,156,18,13,5
9,10,157,20,19,1
9,10,158,19,20,-1
9,10,159,10,24,-14
9,10,160,11,21,-10
9,10,161,22,25,-3
9,10,162,23,14,9
9,10,163,9,21,-12
9,10,164,14,14,0
9,10,165,24,18,6
9,10,166,23,14,9
9,10,167,13,16,-3
9,10,168,24,14,10
9,10,169,15,14,1
9,10,170,18,12,6
9,10,171,11,14,-3
9,10,172,10,29,-19
9,10,173,15,15,0
9,10,174,11,19,-8
9,10,175,25,18,7
9,10,176,17,8,9
9,10,177,6,17,-11
9,10,178,8,12,-4
9,10,179,12,24,-12
9,10,180,4,17,-13
9,10,181,9,11,-2
9,10,182,15,23,-8
9,10,183,8,9,-1
9,10,184,21,15,6
9,10,185,25,14,11
9,10,186,9,17,-8
9,10,187,13,20,-7
9,10,188,14,11,3
9,10,189,25,21,4
9,10,190,17,23,-6
9,10,191,14,15,-1
9,10,192,17,9,8
9,10,193,15,17,-2
9,10,194,15,11,4
9,10,195,22,13,9
9,10,196,12,19,-7
9,10,197,18,12,6
9,10,198,31,22,9
9,10,199,12,14,-2
9,10,200,12,13,-1
9,10,201,12,4,8
9,10,202,15,13,2
9,10,203,14,10,4
9,10,204,17,20,-3
9,10,205,23,15,8
9,10,206,17,19,-2
9,10,207,19,18,1
9,10,208,25,24,1
9,10,209,30,18,12
9,10,210,21,12,9
9,10,211,20,13,7
9,10,212,10,12,-2
9,10,213,13,15,-2
9,10,214,11,10,1
9,10,215,20,10,10
9,10,216,15,13,2
9,10,217,22,21,1
9,10,218,17,32,-15
9,10,219,7,4,3
9,10,220,10,10,0
9,10,221,13,6,7
9,10,222,17,8,9
9,10,223,19,13,6
9,10,224,16,15,1
9,10,225,20,22,-2
9,10,226,12,15,-3
9,10,227,9,22,-13
9,10,228,13,16,-3
9,10,229,10,14,-4
9,10,230,10,11,-1
9,10,231,21,16,5
9,10,232,16,31,-15
9,10,233,11,7,4
9,10,234,13,12,1
9,10,235,12,7,5
9,10,236,7,8,-1
9,10,237,14,12,2
9,10,238,14,15,-1
9,10,239,12,8,4
9,10,240,10,7,3
9,10,241,6,7,-1
9,10,242,9,20,-11
9,10,243,10,21,-11
9,10,244,9,14,-5
9,10,245,4,21,-17
9,10,246,11,23,-12
9,10,247,13,20,-7
9,10,248,11,8,3
9,10,249,21,4,17
9,10,250,12,14,-2
9,10,251,11,15,-4
9,10,252,21,17,4
9,10,253,27,20,7
9,10,254,14,17,-3
9,10,255,16,14,2
9,10,256,5,12,-7
9,10,257,16,25,-9
9,10,258,15,16,-1
9,10,259,20,25,-5
9,10,260,16,19,-3
9,10,261,26,12,14
9,10,262,18,24,-6
9,10,263,8,4,4
9,10,264,9,12,-3
9,10,265,24,22,2
9,10,266,20,23,-3
9,10,267,9,21,-12
9,10,268,17,20,-3
9,10,269,5,7,-2
9,10,270,13,10,3
9,10,271,14,14,0
9,10,272,21,20,1
9,10,273,10,16,-6
9,10,274,12,12,0
9,10,275,18,13,5
9,10,276,15,19,-4
9,10,277,4,10,-6
9,10,278,13,16,-3
9,10,279,15,8,7
9,10,280,19,17,2
9,10,281,13,24,-11
9,10,282,13,23,-10
9,10,283,7,14,-7
9,10,284,7,7,0
9,10,285,10,11,-1
9,10,286,7,15,-8
9,10,287,12,8,4
9,10,288,6,8,-2
9,10,289,4,8,-4
9,10,290,10,12,-2
9,10,291,18,24,-6
9,10,292,16,17,-1
9,10,293,19,11,8
9,10,294,12,18,-6
9,10,295,22,19,3
9,10,296,13,16,-3
9,10,297,12,13,-1
9,10,298,16,17,-1
9,10,299,15,22,-7
9,11,0,13,19,-6
9,11,1,17,18,-1
9,11,2,16,24,-8
9,11,3,30,25,5
9,11,4,24,21,3
9,11,5,20,17,3
9,11,6,11,13,-2
9,11,7,19,13,6
9,11,8,21,12,9
9,11,9,11,12,-1
9,11,10,16,13,3
9,11,11,11,16,-5
9,11,12,15,15,0
9,11,13,20,20,0
9,11,14,20,15,5
9,11,15,16,14,2
9,11,16,8,15,-7
9,11,17,18,20,-2
9,11,18,9,13,-4
9,11,19,21,20,1
9,11,20,22,9,13
9,11,21,19,9,10
9,11,22,23,4,19
9,11,23,11,12,-1
9,11,24,14,18,-4
9,11,25,9,6,3
9,11,26,10,11,-1
9,11,27,19,13,6
9,11,28,22,21,1
9,11,29,21,5,16
9,11,30,25,10,15
9,11,31,14,11,3
9,11,32,22,23,-1
9,11,33,10,14,-4
9,11,34,18,24,-6
9,11,35,17,9,8
9,11,36,11,25,-14
9,11,37,12,5,7
9,11,38,14,24,-10
9,11,39,17,20,-3
9,11,40,19,17,2
9,11,41,15,23,-8
9,11,42,18,13,5
9,11,43,3,8,-5
9,11,44,10,5,5
9,11,45,23,20,3
9,11,46,19,10,9
9,11,47,4,6,-2
9,11,48,9,24,-15
9,11,49,14,9,5
9,11,50,7,16,-9
9,11,51,17,13,4
9,11,52,17,10,7
9,11,53,26,32,-6
9,11,54,15,14,1
9,11,55,14,17,-3
9,11,56,15,20,-5
9,11,57,23,19,4
9,11,58,9,31,-22
9,11,59,15,27,-12
9,11,60,26,15,11
9,11,61,12,15,-3
9,11,62,26,12,14
9,11,63,7,14,-7
9,11,64,9,3,6
9,11,65,8,8,0
9,11,66,17,18,-1
9,11,67,30,30,0
9,11,68,19,23,-4
9,11,69,21,23,-2
9,11,70,10,7,3
9,11,71,34,21,13
9,11,72,17,24,-7
9,11,73,19,10,9
9,11,74,19,25,-6
9,11,75,10,10,0
9,11,76,4,14,-10
9,11,77,11,8,3
9,11,78,20,18,2
9,11,79,19,25,-6
9,11,80,26,17,9
9,11,81,12,16,-4
9,11,82,19,5,14
9,11,83,7,14,-7
9,11,84,9,6,3
9,11,85,13,28,-15
9,11,86,12,21,-9
9,11,87,13,15,-2
9,11,88,12,3,9
9,11,89,11,30,-19
9,11,90,6,21,-15
9,11,91,12,11,1
9,11,92,13,15,-2
9,11,93,6,9,-3
9,11,94,8,15,-7
9,11,95,6,9,-3
9,11,96,16,7,9
9,11,97,17,5,12
9,11,98,12,19,-7
9,11,99,9,16,-7
9,11,100,8,10,-2
9,11,101,26,8,18
9,11,102,17,9,8
9,11,103,22,17,5
9,11,104,17,12,5
9,11,105,12,15,-3
9,11,106,8,17,-9
9,11,107,23,15,8
9,11,108,14,4,10
9,11,109,17,22,-5
9,11,110,15,20,-5
9,11,111,5,7,-2
9,11,112,22,6,16
9,11,113,20,25,-5
9,11,114,23,17,6
9,11,115,13,17,-4
9,11,116,9,5,4
9,11,117,26,15,11
9,11,118,11,31,-20
9,11,119,9,17,-8
9,11,120,11,18,-7
9,11,121,12,4,8
9,11,122,18,20,-2
9,11,123,14,11,3
9,11,124,13,24,-11
9,11,125,17,15,2
9,11,126,21,20,1
9,11,127,16,15,1
9,11,128,19,18,1
9,11,129,6,3,3
9,11,130,14,14,0
9,11,131,9,25,-16
9,11,132,16,14,2
9,11,133,16,15,1
9,11,134,20,18,2
9,11,135,12,11,1
9,11,136,25,11,14
9,11,137,10,22,-12
9,11,138,11,21,-10
9,11,139,16,10,6
9,11,140,13,9,4
9,11,141,7,8,-1
9,11,142,18,15,3
9,11,143,11,9,2
9,11,144,14,22,-8
9,11,145,18,17,1
9,11,146,18,12,6
9,11,147,16,15,1
9,11,148,9,16,-7
9,11,149,8,13,-5
9,11,150,16,15,1
9,11,151,13,23,-10
9,11,152,19,19,0
9,11,153,16,17,-1
9,11,154,15,12,3
9,11,155,18,15,3
9,11,156,9,19,-10
9,11,157,18,15,3
9,11,158,13,17,-4
9,11,159,9,14,-5
9,11,160,13,7,6
9,11,161,15,13,2
9,11,162,28,8,20
9,11,163,25,21,4
9,11,164,19,14,5
9,11,165,17,11,6
9,11,166,24,21,3
9,11,167,10,19,-9
9,11,168,22,23,-1
9,11,169,7,9,-2
9,11,170,22,19,3
9,11,171,16,9,7
9,11,172,14,20,-6
9,11,173,26,20,6
9,11,174,16,18,-2
9,11,175,23,13,10
9,11,176,21,19,2
9,11,177,10,3,7
9,11,178,7,17,-10
9,11,179,6,15,-9
9,11,180,30,25,5
9,11,181,8,6,2
9,11,182,15,20,-5
9,11,183,14,22,-8
9,11,184,10,7,3
9,11,185,25,25,0
9,11,186,12,17,-5
9,11,187,13,15,-2
9,11,188,4,10,-6
9,11,189,12,14,-2
9,11,190,20,11,9
9,11,191,6,13,-7
9,11,192,35,20,15
9,11,193,17,13,4
9,11,194,19,16,3
9,11,195,17,9,8
9,11,196,6,10,-4
9,11,197,18,18,0
9,11,198,27,22,5
9,11,199,14,15,-1
9,11,200,13,15,-2
9,11,201,18,14,4
9,11,202,19,22,-3
9,11,203,18,4,14
9,11,204,12,13,-1
9,11,205,15,26,-11
9,11,206,5,14,-9
9,11,207,14,21,-7
9,11,208,23,11,12
9,11,209,19,13,6
9,11,210,15,11,4
9,11,211,7,9,-2
9,11,212,11,9,2
9,11,213,20,20,0
9,11,214,30,19,11
9,11,215,17,13,4
9,11,216,30,13,17
9,11,217,9,8,1
9,11,218,12,11,1
9,11,219,17,11,6
9,11,220,31,19,12
9,11,221,9,10,-1
9,11,222,9,21,-12
9,11,223,15,7,8
9,11,224,12,21,-9
9,11,225,18,11,7
9,11,226,8,11,-3
9,11,227,12,14,-2
9,11,228,18,16,2
9,11,229,7,8,-1
9,11,230,7,10,-3
9,11,231,13,33,-20
9,11,232,14,14,0
9,11,233,18,10,8
9,11,234,11,2,9
9,11,235,27,27,0
9,11,236,17,19,-2
9,11,237,13,21,-8
9,11,238,9,15,-6
9,11,239,11,8,3
9,11,240,16,16,0
9,11,241,26,25,1
9,11,242,12,10,2
9,11,243,28,11,17
9,11,244,10,8,2
9,11,245,20,11,9
9,11,246,16,23,-7
9,11,247,14,12,2
9,11,248,14,21,-7
9,11,249,3,11,-8
9,11,250,5,7,-2
9,11,251,19,16,3
9,11,252,23,14,9
9,11,253,9,10,-1
9,11,254,10,12,-2
9,11,255,11,22,-11
9,11,256,14,12,2
9,11,257,24,22,2
9,11,258,20,22,-2
9,11,259,8,10,-2
9,11,260,6,6,0
9,11,261,18,13,5
9,11,262,9,8,1
9,11,263,12,6,6
9,11,264,26,16,10
9,11,265,14,9,5
9,11,266,11,20,-9
9,11,267,5,8,-3
9,11,268,16,13,3
9,11,269,24,15,9
9,11,270,11,15,-4
9,11,271,15,8,7
9,11,272,13,18,-5
9,11,273,25,14,11
9,11,274,9,24,-15
9,11,275,11,23,-12
9,11,276,14,14,0
9,11,277,20,18,2
9,11,278,25,12,13
9,11,279,13,16,-3
9,11,280,11,11,0
9,11,281,11,15,-4
9,11,282,12,14,-2
9,11,283,17,12,5
9,11,284,13,10,3
9,11,285,20,16,4
9,11,286,4,3,1
9,11,287,28,21,7
9,11,288,15,21,-6
9,11,289,11,5,6
9,11,290,26,32,-6
9,11,291,21,27,-6
9,11,292,20,17,3
9,11,293,10,12,-2
9,11,294,18,10,8
9,11,295,12,10,2
9,11,296,14,11,3
9,11,297,12,25,-13
9,11,298,16,26,-10
9,11,299,13,22,-9
9,12,0,12,8,4
9,12,1,21,19,2
9,12,2,18,15,3
9,12,3,18,12,6
9,12,4,16,16,0
9,12,5,11,23,-12
9,12,6,15,20,-5
9,12,7,28,20,8
9,12,8,21,8,13
9,12,9,31,15,16
9,12,10,21,24,-3
9,12,11,26,14,12
9,12,12,16,15,1
9,12,13,19,14,5
9,12,14,21,8,13
9,12,15,2,10,-8
9,12,16,3,13,-10
9,12,17,14,13,1
9,12,18,8,10,-2
9,12,19,12,9,3
9,12,20,20,19,1
9,12,21,11,21,-10
9,12,22,17,14,3
9,12,23,10,22,-12
9,12,24,15,15,0
9,12,25,13,11,2
9,12,26,14,16,-2
9,12,27,9,14,-5
9,12,28,9,20,-11
9,12,29,23,23,0
9,12,30,10,17,-7
9,12,31,9,11,-2
9,12,32,11,12,-1
9,12,33,13,22,-9
9,12,34,11,11,0
9,12,35,15,22,-7
9,12,36,6,13,-7
9,12,37,28,8,20
9,12,38,14,15,-1
9,12,39,7,12,-5
9,12,40,19,20,-1
9,12,41,11,8,3
9,12,42,9,3,6
9,12,43,6,13,-7
9,12,44,16,19,-3
9,12,45,23,16,7
9,12,46,7,15,-8
9,12,47,10,15,-5
9,12,48,15,10,5
9,12,49,14,11,3
9,12,50,27,20,7
9,12,51,14,17,-3
9,12,52,8,11,-3
9,12,53,16,11,5
9,12,54,18,21,-3
9,12,55,15,15,0
9,12,56,13,16,-3
9,12,57,14,10,4
9,12,58,17,16,1
9,12,59,7,17,-10
9,12,60,32,6,26
9,12,61,17,21,-4
9,12,62,21,18,3
9,12,63,18,22,-4
9,12,64,16,17,-1
9,12,65,7,15,-8
9,12,66,20,21,-1
9,12,67,11,14,-3
9,12,68,27,22,5
9,12,69,9,6,3
9,12,70,19,10,9
9,12,71,15,12,3
9,12,72,5,12,-7
9,12,73,20,12,8
9,12,74,13,22,-9
9,12,75,14,9,5
9,12,76,21,18,3
9,12,77,8,19,-11
9,12,78,16,10,6
9,12,79,16,15,1
9,12,80,9,10,-1
9,12,81,25,22,3
9,12,82,18,7,11
9,12,83,16,10,6
9,12,84,8,6,2
9,12,85,16,19,-3
9,12,86,27,15,12
9,12,87,26,13,13
9,12,88,18,22,-4
9,12,89,20,16,4
9,12,90,23,9,14
9,12,91,24,12,12
9,12,92,33,16,17
9,12,93,12,22,-10
9,12,94,12,14,-2
9,12,95,7,10,-3
9,12,96,18,18,0
9,12,97,20,26,-6
9,12,98,18,7,11
9,12,99,23,17,6
9,12,100,4,8,-4
9,12,101,14,14,0
9,12,102,25,11,14
9,12,103,25,21,4
9,12,104,17,11,6
9,12,105,19,22,-3
9,12,106,13,13,0
9,12,107,14,21,-7
9,12,108,23,20,3
9,12,109,19,12,7
9,12,110,12,22,-10
9,12,111,9,8,1
9,12,112,12,16,-4
9,12,113,32,22,10
9,12,114,21,10,11
9,12,115,22,4,18
9,12,116,14,9,5
9,12,117,20,25,-5
9,12,118,21,15,6
9,12,119,13,13,0
9,12,120,12,16,-4
9,12,121,27,17,10
9,12,122,8,2,6
9,12,123,10,19,-9
9,12,124,14,5,9
9,12,125,31,14,17
9,12,126,11,13,-2
9,12,127,19,18,1
9,12,128,17,19,-2
9,12,129,21,32,-11
9,12,130,11,22,-11
9,12,131,18,15,3
9,12,132,21,23,-2
9,12,133,16,17,-1
9,12,134,13,12,1
9,12,135,18,12,6
9,12,136,9,9,0
9,12,137,13,11,2
9,12,138,19,16,3
9,12,139,16,8,8
9,12,140,23,14,9
9,12,141,11,15,-4
9,12,142,10,9,1
9,12,143,11,12,-1
9,12,144,18,11,7
9,12,145,12,17,-5
9,12,146,26,12,14
9,12,147,19,13,6
9,12,148,8,14,-6
9,12,149,10,16,-6
9,12,150,12,11,1
9,12,151,18,14,4
9,12,152,7,11,-4
9,12,153,27,11,16
9,12,154,18,21,-3
9,12,155,7,12,-5
9,12,156,5,7,-2
9,12,157,12,11,1
9,12,158,17,8,9
9,12,159,17,9,8
9,12,160,13,4,9
9,12,161,11,18,-7
9,12,162,22,12,10
9,12,163,6,8,-2
9,12,164,11,7,4
9,12,165,24,14,10
9,12,166,24,24,0
9,12,167,19,21,-2
9,12,168,7,8,-1
9,12,169,30,17,13
9,12,170,5,5,0
9,12,171,20,17,3
9,12,172,14,23,-9
9,12,173,26,13,13
9,12,174,12,20,-8
9,12,175,16,12,4
9,12,176,15,12,3
9,12,177,19,11,8
9,12,178,14,16,-2
9,12,179,11,8,3
9,12,180,29,24,5
9,12,181,16,14,2
9,12,182,20,24,-4
9,12,183,7,20,-13
9,12,184,22,18,4
9,12,185,18,9,9
9,12,186,17,11,6
9,12,187,15,15,0
9,12,188,23,16,7
9,12,189,17,17,0
9,12,190,12,20,-8
9,12,191,27,21,6
9,12,192,23,11,12
9,12,193,12,18,-6
9,12,194,17,27,-10
9,12,195,20,19,1
9,12,196,10,18,-8
9,12,197,24,15,9
9,12,198,14,11,3
9,12,199,20,11,9
9,12,200,8,12,-4
9,12,201,10,17,-7
9,12,202,30,17,13
9,12,203,25,9,16
9,12,204,14,18,-4
9,12,205,12,7,5
9,12,206,24,20,4
9,12,207,16,19,-3
9,12,208,12,8,4
9,12,209,23,9,14
9,12,210,14,17,-3
9,12,211,25,24,1
9,12,212,25,36,-11
9,12,213,21,15,6
9,12,214,12,13,-1
9,12,215,15,18,-3
9,12,216,15,33,-18
9,12,217,18,16,2
9,12,218,23,19,4
9,12,219,5,9,-4
9,12,220,17,10,7
9,12,221,14,33,-19
9,12,222,11,20,-9
9,12,223,15,23,-8
9,12,224,9,10,-1
9,12,225,12,12,0
9,12,226,16,21,-5
9,12,227,26,26,0
9,12,228,11,22,-11
9,12,229,20,23,-3
9,12,230,18,16,2
9,12,231,22,12,10
9,12,232,24,8,16
9,12,233,32,11,21
9,12,234,17,18,-1
9,12,235,19,13,6
9,12,236,17,21,-4
9,12,237,5,32,-27
9,12,238,29,14,15
9,12,239,10,13,-3
9,12,240,12,19,-7
9,12,241,32,17,15
9,12,242,12,17,-5
9,12,243,13,14,-1
9,12,244,18,20,-2
9,12,245,18,12,6
9,12,246,11,15,-4
9,12,247,16,24,-8
9,12,248,26,18,8
9,12,249,10,11,-1
9,12,250,30,20,10
9,12,251,12,21,-9
9,12,252,19,11,8
9,12,253,8,10,-2
9,12,254,24,19,5
9,12,255,20,15,5
9,12,256,17,20,-3
9,12,257,11,8,3
9,12,258,27,17,10
9,12,259,20,13,7
9,12,260,22,28,-6
9,12,261,16,2,14
9,12,262,5,6,-1
9,12,263,11,17,-6
9,12,264,15,6,9
9,12,265,11,7,4
9,12,266,18,20,-2
9,12,267,12,8,4
9,12,268,15,8,7
9,12,269,18,13,5
9,12,270,12,8,4
9,12,271,12,11,1
9,12,272,6,18,-12
9,12,273,18,16,2
9,12,274,20,10,10
9,12,275,15,6,9
9,12,276,27,16,11
9,12,277,10,10,0
9,12,278,16,24,-8
9,12,279,18,23,-5
9,12,280,7,9,-2
9,12,281,14,13,1
9,12,282,11,17,-6
9,12,283,12,19,-7
9,12,284,12,12,0
9,12,285,8,7,1
9,12,286,12,10,2
9,12,287,17,8,9
9,12,288,15,7,8
9,12,289,12,13,-1
9,12,290,20,23,-3
9,12,291,13,16,-3
9,12,292,12,22,-10
9,12,293,17,21,-4
9,12,294,1,7,-6
9,12,295,17,19,-2
9,12,296,12,11,1
9,12,297,12,14,-2
9,12,298,8,13,-5
9,12,299,13,14,-1
9,13,0,20,24,-4
9,13,1,21,22,-1
9,13,2,6,9,-3
9,13,3,14,7,7
9,13,4,17,20,-3
9,13,5,15,14,1
9,13,6,13,16,-3
9,13,7,18,23,-5
9,13,8,12,10,2
9,13,9,28,12,16
9,13,10,28,9,19
9,13,11,15,12,3
9,13,12,14,9,5
9,13,13,13,10,3
9,13,14,15,16,-1
9,13,15,12,12,0
9,13,16,11,7,4
9,13,17,18,8,10
9,13,18,20,11,9
9,13,19,15,22,-7
9,13,20,16,7,9
9,13,21,15,12,3
9,13,22,15,22,-7
9,13,23,17,16,1
9,13,24,4,7,-3
9,13,25,19,20,-1
9,13,26,21,17,4
9,13,27,21,16,5
9,13,28,11,8,3
9,13,29,10,15,-5
9,13,30,15,14,1
9,13,31,18,20,-2
9,13,32,16,9,7
9,13,33,28,16,12
9,13,34,14,17,-3
9,13,35,11,9,2
9,13,36,23,14,9
9,13,37,14,17,-3
9,13,38,15,27,-12
9,13,39,18,16,2
9,13,40,21,18,3
9,13,41,10,13,-3
9,13,42,30,5,25
9,13,43,8,16,-8
9,13,44,21,14,7
9,13,45,13,18,-5
9,13,46,27,18,9
9,13,47,7,11,-4
9,13,48,21,20,1
9,13,49,21,16,5
9,13,50,12,8,4
9,13,51,15,24,-9
9,13,52,8,12,-4
9,13,53,20,12,8
9,13,54,12,21,-9
9,13,55,24,24,0
9,13,56,9,17,-8
9,13,57,11,17,-6
9,13,58,11,14,-3
9,13,59,19,19,0
9,13,60,12,9,3
9,13,61,19,31,-12
9,13,62,6,12,-6
9,13,63,21,28,-7
9,13,64,16,14,2
9,13,65,35,15,20
9,13,66,8,9,-1
9,13,67,12,18,-6
9,13,68,12,26,-14
9,13,69,29,25,4
9,13,70,20,16,4
9,13,71,33,27,6
9,13,72,5,6,-1
9,13,73,28,28,0
9,13,74,11,15,-4
9,13,75,8,13,-5
9,13,76,11,12,-1
9,13,77,13,18,-5
9,13,78,11,28,-17
9,13,79,9,13,-4
9,13,80,32,13,19
9,13,81,13,15,-2
9,13,82,15,17,-2
9,13,83,12,7,5
9,13,84,16,15,1
9,13,85,7,12,-5
9,13,86,21,10,11
9,13,87,10,8,2
9,13,88,11,6,5
9,13,89,14,12,2
9,13,90,12,12,0
9,13,91,18,12,6
9,13,92,27,12,15
9,13,93,23,11,12
9,13,94,13,10,3
9,13,95,13,14,-1
9,13,96,20,25,-5
9,13,97,16,12,4
9,13,98,5,8,-3
9,13,99,11,12,-1
9,13,100,12,15,-3
9,13,101,8,18,-10
9,13,102,18,14,4
9,13,103,14,25,-11
9,13,104,15,24,-9
9,13,105,5,4,1
9,13,106,18,16,2
9,13,107,15,19,-4
9,13,108,16,11,5
9,13,109,24,23,1
9,13,110,15,13,2
9,13,111,17,19,-2
9,13,112,14,11,3
9,13,113,18,19,-1
9,13,114,21,14,7
9,13,115,19,12,7
9,13,116,11,11,0
9,13,117,22,18,4
9,13,118,14,8,6
9,13,119,18,25,-7
9,13,120,9,19,-10
9,13,121,8,10,-2
9,13,122,7,10,-3
9,13,123,8,9,-1
9,13,124,12,13,-1
9,13,125,31,14,17
9,13,126,11,20,-9
9,13,127,16,16,0
9,13,128,11,19,-8
9,13,129,11,17,-6
9,13,130,26,27,-1
9,13,131,13,14,-1
9,13,132,14,10,4
9,13,133,21,19,2
9,13,134,16,11,5
9,13,135,18,17,1
9,13,136,16,32,-16
9,13,137,15,9,6
9,13,138,25,26,-1
9,13,139,17,13,4
9,13,140,7,12,-5
9,13,141,24,7,17
9,13,142,15,12,3
9,13,143,11,11,0
9,13,144,27,21,6
9,13,145,13,13,0
9,13,146,6,11,-5
9,13,147,13,12,1
9,13,148,11,18,-7
9,13,149,19,17,2
9,13,150,14,6,8
9,13,151,26,19,7
9,13,152,5,5,0
9,13,153,9,13,-4
9,13,154,24,12,12
9,13,155,16,22,-6
9,13,156,27,22,5
9,13,157,17,10,7
9,13,158,25,18,7
9,13,159,9,9,0
9,13,160,25,13,12
9,13,161,11,13,-2
9,13,162,22,16,6
9,13,163,12,5,7
9,13,164,13,7,6
9,13,165,18,21,-3
9,13,166,23,15,8
9,13,167,35,16,19
9,13,168,31,23,8
9,13,169,15,21,-6
9,13,170,6,20,-14
9,13,171,14,14,0
9,13,172,8,22,-14
9,13,173,12,15,-3
9,13,174,21,18,3
9,13,175,18,22,-4
9,13,176,16,7,9
9,13,177,8,19,-11
9,13,178,23,14,9
9,13,179,18,13,5
9,13,180,8,23,-15
9,13,181,8,13,-5
9,13,182,10,14,-4
9,13,183,26,14,12
9,13,184,15,16,-1
9,13,185,17,25,-8
9,13,186,26,18,8
9,13,187,11,20,-9
9,13,188,11,12,-1
9,13,189,14,19,-5
9,13,190,16,20,-4
9,13,191,7,16,-9
9,13,192,20,22,-2
9,13,193,3,15,-12
9,13,194,28,15,13
9,13,195,27,15,12
9,13,196,25,22,3
9,13,197,15,24,-9
9,13,198,14,14,0
9,13,199,20,19,1
9,13,200,13,16,-3
9,13,201,19,12,7
9,13,202,6,13,-7
9,13,203,25,22,3
9,13,204,12,17,-5
9,13,205,17,19,-2
9,13,206,15,29,-14
9,13,207,17,19,-2
9,13,208,28,16,12
9,13,209,10,15,-5
9,13,210,27,10,17
9,13,211,14,18,-4
9,13,212,6,13,-7
9,13,213,15,17,-2
9,13,214,18,15,3
9,13,215,18,19,-1
9,13,216,15,12,3
9,13,217,5,10,-5
9,13,218,12,9,3
9,13,219,16,12,4
9,13,220,24,25,-1
9,13,221,13,11,2
9,13,222,22,27,-5
9,13,223,25,11,14
9,13,224,12,14,-2
9,13,225,18,15,3
9,13,226,15,15,0
9,13,227,21,23,-2
9,13,228,19,17,2
9,13,229,8,13,-5
9,13,230,14,16,-2
9,13,231,15,20,-5
9,13,232,15,18,-3
9,13,233,13,23,-10
9,13,234,23,10,13
9,13,235,10,18,-8
9,13,236,6,7,-1
9,13,237,12,17,-5
9,13,238,23,15,8
9,13,239,13,18,-5
9,13,240,19,22,-3
9,13,241,18,14,4
9,13,242,28,12,16
9,13,243,24,16,8
9,13,244,21,12,9
9,13,245,20,15,5
9,13,246,12,11,1
9,13,247,13,21,-8
9,13,248,5,6,-1
9,13,249,3,30,-27
9,13,250,7,14,-7
9,13,251,32,16,16
9,13,252,17,22,-5
9,13,253,9,14,-5
9,13,254,15,17,-2
9,13,255,11,5,6
9,13,256,16,25,-9
9,13,257,20,12,8
9,13,258,18,33,-15
9,13,259,12,22,-10
9,13,260,23,16,7
9,13,261,11,12,-1
9,13,262,18,24,-6
9,13,263,5,12,-7
9,13,264,15,27,-12
9,13,265,12,13,-1
9,13,266,18,16,2
9,13,267,15,14,1
9,13,268,12,11,1
9,13,269,12,13,-1
9,13,270,6,6,0
9,13,271,17,11,6
9,13,272,4,14,-10
9,13,273,12,22,-10
9,13,274,9,11,-2
9,13,275,4,8,-4
9,13,276,22,9,13
9,13,277,26,19,7
9,13,278,17,12,5
9,13,279,21,13,8
9,13,280,29,28,1
9,13,281,11,13,-2
9,13,282,10,10,0
9,13,283,8,6,2
9,13,284,15,15,0
9,13,285,21,18,3
9,13,286,13,21,-8
9,13,287,30,15,15
9,13,288,18,14,4
9,13,289,16,21,-5
9,13,290,19,14,5
9,13,291,14,8,6
9,13,292,16,15,1
9,13,293,14,12,2
9,13,294,22,12,10
9,13,295,14,21,-7
9,13,296,15,18,-3
9,13,297,10,16,-6
9,13,298,26,22,4
9,13,299,14,19,-5
9,14,0,15,24,-9
9,14,1,18,16,2
9,14,2,15,16,-1
9,14,3,4,10,-6
9,14,4,13,22,-9
9,14,5,15,12,3
9,14,6,15,20,-5
9,14,7,21,8,13
9,14,8,14,11,3
9,14,9,14,4,10
9,14,10,12,8,4
9,14,11,16,15,1
9,14,12,24,11,13
9,14,13,22,12,10
9,14,14,10,19,-9
9,14,15,11,6,5
9,14,16,27,17,10
9,14,17,4,10,-6
9,14,18,14,13,1
9,14,19,10,11,-1
9,14,20,4,22,-18
9,14,21,21,18,3
9,14,22,18,21,-3
9,14,23,15,9,6
9,14,24,16,11,5
9,14,25,16,22,-6
9,14,26,11,23,-12
9,14,27,28,11,17
9,14,28,16,19,-3
9,14,29,18,7,11
9,14,30,12,18,-6
9,14,31,14,14,0
9,14,32,30,6,24
9,14,33,23,19,4
9,14,34,4,6,-2
9,14,35,21,8,13
9,14,36,25,39,-14
9,14,37,18,17,1
9,14,38,12,12,0
9,14,39,29,21,8
9,14,40,11,10,1
9,14,41,28,20,8
9,14,42,25,24,1
9,14,43,21,17,4
9,14,44,18,11,7
9,14,45,19,21,-2
9,14,46,23,27,-4
9,14,47,5,22,-17
9,14,48,28,17,11
9,14,49,19,24,-5
9,14,50,11,15,-4
9,14,51,13,15,-2
9,14,52,15,14,1
9,14,53,12,18,-6
9,14,54,8,8,0
9,14,55,9,12,-3
9,14,56,13,14,-1
9,14,57,14,16,-2
9,14,58,18,9,9
9,14,59,9,18,-9
9,14,60,13,19,-6
9,14,61,10,7,3
9,14,62,23,17,6
9,14,63,21,12,9
9,14,64,13,9,4
9,14,65,23,24,-1
9,14,66,16,18,-2
9,14,67,9,3,6
9,14,68,10,2,8
9,14,69,11,9,2
9,14,70,17,14,3
9,14,71,16,15,1
9,14,72,14,17,-3
9,14,73,23,13,10
9,14,74,11,8,3
9,14,75,28,11,17
9,14,76,31,22,9
9,14,77,19,18,1
9,14,78,18,8,10
9,14,79,12,9,3
9,14,80,17,12,5
9,14,81,12,11,1
9,14,82,21,22,-1
9,14,83,30,20,10
9,14,84,30,25,5
9,14,85,18,20,-2
9,14,86,14,14,0
9,14,87,16,19,-3
9,14,88,18,17,1
9,14,89,23,18,5
9,14,90,10,29,-19
9,14,91,6,7,-1
9,14,92,18,22,-4
9,14,93,11,12,-1
9,14,94,24,10,14
9,14,95,28,23,5
9,14,96,29,26,3
9,14,97,16,23,-7
9,14,98,16,11,5
9,14,99,9,11,-2
9,14,100,19,30,-11
9,14,101,42,22,20
9,14,102,11,9,2
9,14,103,28,6,22
9,14,104,11,5,6
9,14,105,18,15,3
9,14,106,11,18,-7
9,14,107,12,19,-7
9,14,108,22,11,11
9,14,109,17,12,5
9,14,110,19,14,5
9,14,111,11,18,-7
9,14,112,20,10,10
9,14,113,12,0,12
9,14,114,14,17,-3
9,14,115,15,11,4
9,14,116,16,12,4
9,14,117,10,15,-5
9,14,118,4,8,-4
9,14,119,16,18,-2
9,14,120,13,9,4
9,14,121,26,13,13
9,14,122,11,14,-3
9,14,123,16,9,7
9,14,124,15,12,3
9,14,125,18,10,8
9,14,126,9,9,0
9,14,127,10,20,-10
9,14,128,15,21,-6
9,14,129,16,24,-8
9,14,130,13,4,9
9,14,131,17,16,1
9,14,132,26,23,3
9,14,133,15,21,-6
9,14,134,21,6,15
9,14,135,20,18,2
9,14,136,10,13,-3
9,14,137,24,16,8
9,14,138,17,8,9
9,14,139,8,9,-1
9,14,140,17,13,4
9,14,141,16,10,6
9,14,142,22,11,11
9,14,143,21,16,5
9,14,144,12,12,0
9,14,145,20,8,12
9,14,146,21,15,6
9,14,147,22,11,11
9,14,148,15,16,-1
9,14,149,12,7,5
9,14,150,17,14,3
9,14,151,32,8,24
9,14,152,14,21,-7
9,14,153,16,5,11
9,14,154,15,17,-2
9,14,155,20,12,8
9,14,156,12,8,4
9,14,157,16,18,-2
9,14,158,14,6,8
9,14,159,16,18,-2
9,14,160,25,18,7
9,14,161,21,6,15
9,14,162,15,5,10
9,14,163,39,33,6
9,14,164,20,13,7
9,14,165,11,9,2
9,14,166,13,25,-12
9,14,167,14,16,-2
9,14,168,12,10,2
9,14,169,14,24,-10
9,14,170,19,24,-5
9,14,171,13,13,0
9,14,172,12,17,-5
9,14,173,18,13,5
9,14,174,17,13,4
9,14,175,18,14,4
9,14,176,7,14,-7
9,14,177,14,19,-5
9,14,178,24,14,10
9,14,179,9,13,-4
9,14,180,17,17,0
9,14,181,27,13,14
9,14,182,18,12,6
9,14,183,21,20,1
9,14,184,14,15,-1
9,14,185,26,16,10
9,14,186,31,22,9
9,14,187,23,18,5
9,14,188,10,13,-3
9,14,189,13,11,2
9,14,190,20,9,11
9,14,191,13,13,0
9,14,192,10,13,-3
9,14,193,13,20,-7
9,14,194,22,9,13
9,14,195,19,16,3
9,14,196,12,7,5
9,14,197,18,14,4
9,14,198,15,17,-2
9,14,199,19,11,8
9,14,200,18,19,-1
9,14,201,20,11,9
9,14,202,18,12,6
9,14,203,16,6,10
9,14,204,21,10,11
9,14,205,26,21,5
9,14,206,11,20,-9
9,14,207,17,12,5
9,14,208,11,19,-8
9,14,209,12,16,-4
9,14,210,16,24,-8
9,14,211,18,16,2
9,14,212,17,12,5
9,14,213,12,15,-3
9,14,214,21,10,11
9,14,215,15,13,2
9,14,216,20,26,-6
9,14,217,9,9,0
9,14,218,22,10,12
9,14,219,19,17,2
9,14,220,13,13,0
9,14,221,20,16,4
9,14,222,11,14,-3
9,14,223,26,20,6
9,14,224,24,21,3
9,14,225,14,11,3
9,14,226,17,22,-5
9,14,227,23,18,5
9,14,228,13,12,1
9,14,229,10,5,5
9,14,230,17,13,4
9,14,231,22,11,11
9,14,232,7,16,-9
9,14,233,25,11,14
9,14,234,11,5,6
9,14,235,16,21,-5
9,14,236,13,6,7
9,14,237,16,21,-5
9,14,238,9,7,2
9,14,239,27,11,16
9,14,240,21,9,12
9,14,241,13,12,1
9,14,242,22,15,7
9,14,243,15,13,2
9,14,244,24,6,18
9,14,245,15,21,-6
9,14,246,18,8,10
9,14,247,16,21,-5
9,14,248,12,11,1
9,14,249,30,15,15
9,14,250,14,12,2
9,14,251,13,19,-6
9,14,252,33,21,12
9,14,253,10,17,-7
9,14,254,30,21,9
9,14,255,14,14,0
9,14,256,8,25,-17
9,14,257,22,10,12
9,14,258,22,18,4
9,14,259,25,29,-4
9,14,260,26,24,2
9,14,261,22,17,5
9,14,262,6,9,-3
9,14,263,36,19,17
9,14,264,12,15,-3
9,14,265,23,16,7
9,14,266,17,19,-2
9,14,267,23,22,1
9,14,268,8,20,-12
9,14,269,12,6,6
9,14,270,21,21,0
9,14,271,36,12,24
9,14,272,19,11,8
9,14,273,12,5,7
9,14,274,16,13,3
9,14,275,18,18,0
9,14,276,25,28,-3
9,14,277,4,10,-6
9,14,278,10,11,-1
9,14,279,15,11,4
9,14,280,17,9,8
9,14,281,20,14,6
9,14,282,8,14,-6
9,14,283,15,12,3
9,14,284,10,7,3
9,14,285,4,9,-5
9,14,286,20,7,13
9,14,287,13,9,4
9,14,288,17,21,-4
9,14,289,31,16,15
9,14,290,6,7,-1
9,14,291,7,12,-5
9,14,292,17,15,2
9,14,293,21,15,6
9,14,294,17,21,-4
9,14,295,9,22,-13
9,14,296,11,15,-4
9,14,297,21,18,3
9,14,298,8,15,-7
9,14,299,15,16,-1
9,15,0,18,12,6
9,15,1,21,16,5
9,15,2,2,16,-14
9,15,3,12,24,-12
9,15,4,13,7,6
9,15,5,24,21,3
9,15,6,12,5,7
9,15,7,14,23,-9
9,15,8,18,14,4
9,15,9,14,30,-16
9,15,10,21,21,0
9,15,11,13,23,-10
9,15,12,30,13,17
9,15,13,16,9,7
9,15,14,15,28,-13
9,15,15,17,7,10
9,15,16,19,16,3
9,15,17,9,12,-3
9,15,18,23,19,4
9,15,19,17,22,-5
9,15,20,17,10,7
9,15,21,19,7,12
9,15,22,8,9,-1
9,15,23,12,20,-8
9,15,24,13,21,-8
9,15,25,13,12,1
9,15,26,21,21,0
9,15,27,11,15,-4
9,15,28,13,13,0
9,15,29,10,7,3
9,15,30,15,19,-4
9,15,31,16,16,0
9,15,32,21,21,0
9,15,33,28,22,6
9,15,34,37,19,18
9,15,35,3,6,-3
9,15,36,15,20,-5
9,15,37,23,12,11
9,15,38,26,23,3
9,15,39,20,15,5
9,15,40,18,13,5
9,15,41,11,14,-3
9,15,42,15,24,-9
9,15,43,18,22,-4
9,15,44,11,11,0
9,15,45,6,16,-10
9,15,46,5,11,-6
9,15,47,19,11,8
9,15,48,21,22,-1
9,15,49,6,19,-13
9,15,50,24,25,-1
9,15,51,15,14,1
9,15,52,17,15,2
9,15,53,14,12,2
9,15,54,14,17,-3
9,15,55,18,14,4
9,15,56,9,11,-2
9,15,57,15,16,-1
9,15,58,26,14,12
9,15,59,22,19,3
9,15,60,2,6,-4
9,15,61,12,11,1
9,15,62,20,10,10
9,15,63,10,8,2
9,15,64,18,13,5
9,15,65,14,10,4
9,15,66,19,9,10
9,15,67,13,21,-8
9,15,68,20,14,6
9,15,69,18,13,5
9,15,70,14,13,1
9,15,71,12,10,2
9,15,72,9,9,0
9,15,73,15,23,-8
9,15,74,26,18,8
9,15,75,15,12,3
9,15,76,17,7,10
9,15,77,9,16,-7
9,15,78,26,17,9
9,15,79,25,13,12
9,15,80,8,18,-10
9,15,81,27,20,7
9,15,82,11,8,3
9,15,83,18,22,-4
9,15,84,20,21,-1
9,15,85,22,16,6
9,15,86,8,18,-10
9,15,87,17,25,-8
9,15,88,27,24,3
9,15,89,31,18,13
9,15,90,7,6,1
9,15,91,14,9,5
9,15,92,11,14,-3
9,15,93,22,27,-5
9,15,94,9,7,2
9,15,95,23,10,13
9,15,96,18,11,7
9,15,97,17,8,9
9,15,98,19,23,-4
9,15,99,31,19,12
9,15,100,24,20,4
9,15,101,18,9,9
9,15,102,14,13,1
9,15,103,19,20,-1
9,15,104,11,10,1
9,15,105,23,19,4
9,15,106,10,23,-13
9,15,107,13,13,0
9,15,108,14,14,0
9,15,109,28,16,12
9,15,110,17,22,-5
9,15,111,16,6,10
9,15,112,15,20,-5
9,15,113,14,17,-3
9,15,114,13,9,4
9,15,115,14,10,4
9,15,116,32,9,23
9,15,117,14,13,1
9,15,118,18,18,0
9,15,119,23,11,12
9,15,120,13,20,-7
9,15,121,39,14,25
9,15,122,13,6,7
9,15,123,11,10,1
9,15,124,12,7,5
9,15,125,11,27,-16
9,15,126,21,11,10
9,15,127,13,9,4
9,15,128,24,21,3
9,15,129,20,19,1
9,15,130,21,16,5
9,15,131,16,13,3
9,15,132,22,10,12
9,15,133,24,16,8
9,15,134,20,19,1
9,15,135,14,21,-7
9,15,136,18,12,6
9,15,137,12,14,-2
9,15,138,17,9,8
9,15,139,15,14,1
9,15,140,15,11,4
9,15,141,15,9,6
9,15,142,9,17,-8
9,15,143,19,12,7
9,15,144,30,15,15
9,15,145,19,10,9
9,15,146,21,18,3
9,15,147,21,14,7
9,15,148,12,3,9
9,15,149,12,9,3
9,15,150,21,15,6
9,15,151,27,19,8
9,15,152,15,14,1
9,15,153,33,20,13
9,15,154,18,19,-1
9,15,155,23,13,10
9,15,156,14,7,7
9,15,157,13,16,-3
9,15,158,25,23,2
9,15,159,10,13,-3
9,15,160,19,13,6
9,15,161,4,13,-9
9,15,162,12,16,-4
9,15,163,33,25,8
9,15,164,13,10,3
9,15,165,13,10,3
9,15,166,19,31,-12
9,15,167,23,14,9
9,15,168,5,18,-13
9,15,169,22,13,9
9,15,170,13,10,3
9,15,171,10,7,3
9,15,172,14,11,3
9,15,173,15,26,-11
9,15,174,19,13,6
9,15,175,23,16,7
9,15,176,14,17,-3
9,15,177,19,9,10
9,15,178,29,15,14
9,15,179,14,11,3
9,15,180,15,13,2
9,15,181,24,26,-2
9,15,182,20,14,6
9,15,183,14,14,0
9,15,184,10,14,-4
9,15,185,25,25,0
9,15,186,12,18,-6
9,15,187,11,3,8
9,15,188,14,16,-2
9,15,189,17,24,-7
9,15,190,8,14,-6
9,15,191,5,21,-16
9,15,192,11,16,-5
9,15,193,18,9,9
9,15,194,15,13,2
9,15,195,15,15,0
9,15,196,12,15,-3
9,15,197,11,12,-1
9,15,198,9,12,-3
9,15,199,15,11,4
9,15,200,9,7,2
9,15,201,17,22,-5
9,15,202,26,15,11
9,15,203,10,18,-8
9,15,204,18,26,-8
9,15,205,8,12,-4
9,15,206,22,24,-2
9,15,207,12,11,1
9,15,208,21,14,7
9,15,209,30,13,17
9,15,210,27,19,8
9,15,211,15,10,5
9,15,212,17,12,5
9,15,213,20,10,10
9,15,214,16,3,13
9,15,215,22,19,3
9,15,216,22,14,8
9,15,217,20,6,14
9,15,218,16,16,0
9,15,219,33,25,8
9,15,220,10,16,-6
9,15,221,18,18,0
9,15,222,25,22,3
9,15,223,9,10,-1
9,15,224,20,9,11
9,15,225,10,1,9
9,15,226,20,12,8
9,15,227,11,14,-3
9,15,228,32,18,14
9,15,229,17,30,-13
9,15,230,16,8,8
9,15,231,16,14,2
9,15,232,14,14,0
9,15,233,19,9,10
9,15,234,10,23,-13
9,15,235,7,6,1
9,15,236,14,9,5
9,15,237,17,13,4
9,15,238,13,21,-8
9,15,239,19,14,5
9,15,240,12,20,-8
9,15,241,15,10,5
9,15,242,10,5,5
9,15,243,13,11,2
9,15,244,18,23,-5
9,15,245,4,1,3
9,15,246,19,12,7
9,15,247,22,18,4
9,15,248,15,16,-1
9,15,249,15,18,-3
9,15,250,20,19,1
9,15,251,20,13,7
9,15,252,25,16,9
9,15,253,17,26,-9
9,15,254,4,12,-8
9,15,255,16,18,-2
9,15,256,8,12,-4
9,15,257,15,19,-4
9,15,258,16,23,-7
9,15,259,22,16,6
9,15,260,18,11,7
9,15,261,13,15,-2
9,15,262,22,17,5
9,15,263,12,15,-3
9,15,264,17,14,3
9,15,265,12,13,-1
9,15,266,3,11,-8
9,15,267,24,25,-1
9,15,268,15,10,5
9,15,269,15,10,5
9,15,270,22,29,-7
9,15,271,17,16,1
9,15,272,8,13,-5
9,15,273,30,26,4
9,15,274,21,13,8
9,15,275,15,17,-2
9,15,276,12,7,5
9,15,277,18,16,2
9,15,278,28,20,8
9,15,279,7,10,-3
9,15,280,33,17,16
9,15,281,26,18,8
9,15,282,14,14,0
9,15,283,20,20,0
9,15,284,19,11,8
9,15,285,19,18,1
9,15,286,14,18,-4
9,15,287,5,13,-8
9,15,288,18,14,4
9,15,289,9,10,-1
9,15,290,18,8,10
9,15,291,20,13,7
9,15,292,15,23,-8
9,15,293,28,5,23
9,15,294,14,15,-1
9,15,295,22,35,-13
9,15,296,9,9,0
9,15,297,20,12,8
9,15,298,10,14,-4
9,15,299,24,22,2
9,16,0,7,23,-16
9,16,1,19,13,6
9,16,2,14,9,5
9,16,3,20,2,18
9,16,4,15,9,6
9,16,5,23,12,11
9,16,6,17,15,2
9,16,7,19,12,7
9,16,8,24,20,4
9,16,9,25,18,7
9,16,10,22,23,-1
9,16,11,8,7,1
9,16,12,10,8,2
9,16,13,7,4,3
9,16,14,15,13,2
9,16,15,13,17,-4
9,16,16,14,12,2
9,16,17,17,11,6
9,16,18,18,9,9
9,16,19,16,10,6
9,16,20,18,19,-1
9,16,21,40,9,31
9,16,22,12,14,-2
9,16,23,17,12,5
9,16,24,11,18,-7
9,16,25,17,24,-7
9,16,26,14,9,5
9,16,27,23,25,-2
9,16,28,19,16,3
9,16,29,17,9,8
9,16,30,14,9,5
9,16,31,9,26,-17
9,16,32,10,6,4
9,16,33,32,17,15
9,16,34,12,9,3
9,16,35,31,25,6
9,16,36,16,14,2
9,16,37,11,18,-7
9,16,38,12,37,-25
9,16,39,18,7,11
9,16,40,23,20,3
9,16,41,20,12,8
9,16,42,19,16,3
9,16,43,18,9,9
9,16,44,11,8,3
9,16,45,22,21,1
9,16,46,22,19,3
9,16,47,15,15,0
9,16,48,20,25,-5
9,16,49,8,9,-1
9,16,50,14,9,5
9,16,51,27,12,15
9,16,52,8,11,-3
9,16,53,16,28,-12
9,16,54,26,20,6
9,16,55,19,14,5
9,16,56,13,9,4
9,16,57,15,18,-3
9,16,58,20,18,2
9,16,59,21,32,-11
9,16,60,12,5,7
9,16,61,12,11,1
9,16,62,14,7,7
9,16,63,16,7,9
9,16,64,22,14,8
9,16,65,10,9,1
9,16,66,18,12,6
9,16,67,11,15,-4
9,16,68,13,16,-3
9,16,69,17,14,3
9,16,70,14,13,1
9,16,71,10,13,-3
9,16,72,22,15,7
9,16,73,16,16,0
9,16,74,15,12,3
9,16,75,8,4,4
9,16,76,28,21,7
9,16,77,16,12,4
9,16,78,18,15,3
9,16,79,23,17,6
9,16,80,27,26,1
9,16,81,10,12,-2
9,16,82,5,4,1
9,16,83,3,0,3
9,16,84,16,18,-2
9,16,85,14,6,8
9,16,86,7,17,-10
9,16,87,15,6,9
9,16,88,21,15,6
9,16,89,21,21,0
9,16,90,22,9,13
9,16,91,21,11,10
9,16,92,19,24,-5
9,16,93,19,10,9
9,16,94,6,7,-1
9,16,95,12,15,-3
9,16,96,10,11,-1
9,16,97,13,23,-10
9,16,98,25,8,17
9,16,99,22,13,9
9,16,100,22,8,14
9,16,101,24,23,1
9,16,102,23,11,12
9,16,103,14,6,8
9,16,104,15,16,-1
9,16,105,7,12,-5
9,16,106,31,18,13
9,16,107,22,18,4
9,16,108,25,17,8
9,16,109,21,18,3
9,16,110,24,12,12
9,16,111,25,9,16
9,16,112,16,16,0
9,16,113,2,2,0
9,16,114,16,10,6
9,16,115,9,8,1
9,16,116,17,9,8
9,16,117,9,14,-5
9,16,118,10,17,-7
9,16,119,24,21,3
9,16,120,14,6,8
9,16,121,36,29,7
9,16,122,12,16,-4
9,16,123,22,11,11
9,16,124,16,10,6
9,16,125,18,8,10
9,16,126,8,27,-19
9,16,127,12,6,6
9,16,128,12,8,4
9,16,129,18,8,10
9,16,130,17,12,5
9,16,131,10,13,-3
9,16,132,22,24,-2
9,16,133,20,18,2
9,16,134,24,13,11
9,16,135,16,10,6
9,16,136,22,10,12
9,16,137,13,7,6
9,16,138,19,8,11
9,16,139,19,6,13
9,16,140,9,11,-2
9,16,141,22,15,7
9,16,142,24,23,1
9,16,143,9,13,-4
9,16,144,9,10,-1
9,16,145,18,13,5
9,16,146,26,19,7
9,16,147,15,18,-3
9,16,148,17,15,2
9,16,149,16,13,3
9,16,150,40,25,15
9,16,151,24,18,6
9,16,152,14,11,3
9,16,153,20,10,10
9,16,154,35,25,10
9,16,155,17,10,7
9,16,156,19,18,1
9,16,157,7,19,-12
9,16,158,21,12,9
9,16,159,13,8,5
9,16,160,18,20,-2
9,16,161,15,11,4
9,16,162,18,19,-1
9,16,163,13,18,-5
9,16,164,15,11,4
9,16,165,17,13,4
9,16,166,22,8,14
9,16,167,18,9,9
9,16,168,10,6,4
9,16,169,25,13,12
9,16,170,21,12,9
9,16,171,15,15,0
9,16,172,20,11,9
9,16,173,13,15,-2
9,16,174,9,17,-8
9,16,175,13,12,1
9,16,176,21,11,10
9,16,177,12,7,5
9,16,178,29,11,18
9,16,179,19,5,14
9,16,180,18,17,1
9,16,181,15,9,6
9,16,182,24,15,9
9,16,183,15,19,-4
9,16,184,22,14,8
9,16,185,19,13,6
9,16,186,15,12,3
9,16,187,26,14,12
9,16,188,2,12,-10
9,16,189,7,10,-3
9,16,190,11,18,-7
9,16,191,26,17,9
9,16,192,11,4,7
9,16,193,19,13,6
9,16,194,12,28,-16
9,16,195,21,18,3
9,16,196,18,13,5
9,16,197,9,10,-1
9,16,198,7,7,0
9,16,199,24,15,9
9,16,200,18,20,-2
9,16,201,13,12,1
9,16,202,16,16,0
9,16,203,20,17,3
9,16,204,11,13,-2
9,16,205,17,18,-1
9,16,206,11,7,4
9,16,207,17,21,-4
9,16,208,12,16,-4
9,16,209,25,10,15
9,16,210,13,8,5
9,16,211,16,7,9
9,16,212,22,10,12
9,16,213,25,21,4
9,16,214,15,11,4
9,16,215,13,10,3
9,16,216,5,14,-9
9,16,217,16,21,-5
9,16,218,14,25,-11
9,16,219,27,12,15
9,16,220,20,19,1
9,16,221,10,8,2
9,16,222,22,21,1
9,16,223,13,12,1
9,16,224,17,16,1
9,16,225,13,12,1
9,16,226,19,15,4
9,16,227,15,14,1
9,16,228,6,7,-1
9,16,229,16,19,-3
9,16,230,20,8,12
9,16,231,14,8,6
9,16,232,14,17,-3
9,16,233,8,5,3
9,16,234,11,7,4
9,16,235,7,8,-1
9,16,236,15,5,10
9,16,237,18,10,8
9,16,238,25,21,4
9,16,239,18,12,6
9,16,240,12,28,-16
9,16,241,26,9,17
9,16,242,5,11,-6
9,16,243,25,23,2
9,16,244,12,9,3
9,16,245,15,10,5
9,16,246,29,30,-1
9,16,247,9,18,-9
9,16,248,10,16,-6
9,16,249,12,15,-3
9,16,250,4,7,-3
9,16,251,22,19,3
9,16,252,19,23,-4
9,16,253,31,16,15
9,16,254,19,10,9
9,16,255,13,3,10
9,16,256,8,7,1
9,16,257,11,22,-11
9,16,258,25,23,2
9,16,259,31,13,18
9,16,260,23,21,2
9,16,261,14,9,5
9,16,262,17,23,-6
9,16,263,1,4,-3
9,16,264,19,13,6
9,16,265,24,22,2
9,16,266,7,7,0
9,16,267,15,11,4
9,16,268,27,15,12
9,16,269,20,18,2
9,16,270,9,10,-1
9,16,271,12,16,-4
9,16,272,20,14,6
9,16,273,16,13,3
9,16,274,18,16,2
9,16,275,18,15,3
9,16,276,25,8,17
9,16,277,26,12,14
9,16,278,18,11,7
9,16,279,33,20,13
9,16,280,20,26,-6
9,16,281,22,7,15
9,16,282,26,20,6
9,16,283,18,26,-8
9,16,284,12,13,-1
9,16,285,6,8,-2
9,16,286,23,16,7
9,16,287,16,5,11
9,16,288,12,9,3
9,16,289,22,23,-1
9,16,290,16,9,7
9,16,291,13,16,-3
9,16,292,8,7,1
9,16,293,9,8,1
9,16,294,15,14,1
9,16,295,17,21,-4
9,16,296,21,12,9
9,16,297,13,23,-10
9,16,298,5,21,-16
9,16,299,12,20,-8
9,17,0,16,19,-3
9,17,1,16,23,-7
9,17,2,27,11,16
9,17,3,16,29,-13
9,17,4,12,11,1
9,17,5,20,15,5
9,17,6,14,17,-3
9,17,7,26,12,14
9,17,8,16,18,-2
9,17,9,25,16,9
9,17,10,13,16,-3
9,17,11,13,13,0
9,17,12,17,13,4
9,17,13,18,10,8
9,17,14,23,14,9
9,17,15,9,15,-6
9,17,16,16,16,0
9,17,17,17,13,4
9,17,18,11,5,6
9,17,19,21,24,-3
9,17,20,9,11,-2
9,17,21,7,8,-1
9,17,22,23,23,0
9,17,23,24,12,12
9,17,24,13,18,-5
9,17,25,32,12,20
9,17,26,17,16,1
9,17,27,13,25,-12
9,17,28,7,7,0
9,17,29,3,9,-6
9,17,30,16,11,5
9,17,31,22,21,1
9,17,32,26,17,9
9,17,33,26,15,11
9,17,34,15,9,6
9,17,35,18,24,-6
9,17,36,16,24,-8
9,17,37,19,15,4
9,17,38,19,14,5
9,17,39,17,14,3
9,17,40,21,6,15
9,17,41,19,8,11
9,17,42,22,19,3
9,17,43,11,13,-2
9,17,44,13,9,4
9,17,45,20,19,1
9,17,46,27,21,6
9,17,47,17,9,8
9,17,48,16,4,12
9,17,49,20,17,3
9,17,50,29,16,13
9,17,51,23,14,9
9,17,52,13,7,6
9,17,53,38,17,21
9,17,54,18,13,5
9,17,55,22,16,6
9,17,56,18,15,3
9,17,57,11,18,-7
9,17,58,11,15,-4
9,17,59,18,10,8
9,17,60,34,16,18
9,17,61,20,18,2
9,17,62,12,9,3
9,17,63,36,8,28
9,17,64,14,14,0
9,17,65,20,12,8
9,17,66,27,11,16
9,17,67,8,6,2
9,17,68,18,19,-1
9,17,69,11,17,-6
9,17,70,11,18,-7
9,17,71,17,16,1
9,17,72,36,17,19
9,17,73,19,10,9
9,17,74,15,9,6
9,17,75,15,13,2
9,17,76,12,23,-11
9,17,77,24,19,5
9,17,78,16,16,0
9,17,79,19,15,4
9,17,80,16,11,5
9,17,81,15,14,1
9,17,82,16,13,3
9,17,83,20,17,3
9,17,84,15,12,3
9,17,85,17,16,1
9,17,86,16,14,2
9,17,87,24,28,-4
9,17,88,22,9,13
9,17,89,14,10,4
9,17,90,11,16,-5
9,17,91,7,5,2
9,17,92,20,10,10
9,17,93,33,15,18
9,17,94,22,8,14
9,17,95,24,25,-1
9,17,96,22,15,7
9,17,97,7,8,-1
9,17,98,16,13,3
9,17,99,28,20,8
9,17,100,21,16,5
9,17,101,18,14,4
9,17,102,19,12,7
9,17,103,22,14,8
9,17,104,18,15,3
9,17,105,13,8,5
9,17,106,13,7,6
9,17,107,19,14,5
9,17,108,20,30,-10
9,17,109,17,13,4
9,17,110,24,16,8
9,17,111,16,15,1
9,17,112,14,22,-8
9,17,113,18,15,3
9,17,114,11,5,6
9,17,115,17,11,6
9,17,116,15,10,5
9,17,117,16,12,4
9,17,118,7,12,-5
9,17,119,12,11,1
9,17,120,18,17,1
9,17,121,41,19,22
9,17,122,15,23,-8
9,17,123,16,18,-2
9,17,124,15,15,0
9,17,125,19,16,3
9,17,126,19,14,5
9,17,127,24,10,14
9,17,128,9,14,-5
9,17,129,12,15,-3
9,17,130,13,15,-2
9,17,131,15,8,7
9,17,132,6,8,-2
9,17,133,15,13,2
9,17,134,23,8,15
9,17,135,18,10,8
9,17,136,22,4,18
9,17,137,8,19,-11
9,17,138,19,4,15
9,17,139,14,16,-2
9,17,140,21,8,13
9,17,141,9,7,2
9,17,142,13,20,-7
9,17,143,19,16,3
9,17,144,12,15,-3
9,17,145,29,20,9
9,17,146,17,11,6
9,17,147,22,13,9
9,17,148,11,8,3
9,17,149,21,11,10
9,17,150,27,23,4
9,17,151,3,13,-10
9,17,152,13,10,3
9,17,153,20,8,12
9,17,154,23,18,5
9,17,155,27,16,11
9,17,156,14,10,4
9,17,157,25,28,-3
9,17,158,27,13,14
9,17,159,22,16,6
9,17,160,25,13,12
9,17,161,25,17,8
9,17,162,10,9,1
9,17,163,22,13,9
9,17,164,15,6,9
9,17,165,18,16,2
9,17,166,23,15,8
9,17,167,14,10,4
9,17,168,12,4,8
9,17,169,10,4,6
9,17,170,5,18,-13
9,17,171,17,4,13
9,17,172,20,11,9
9,17,173,21,22,-1
9,17,174,20,11,9
9,17,175,13,12,1
9,17,176,11,15,-4
9,17,177,12,19,-7
9,17,178,20,14,6
9,17,179,30,17,13
9,17,180,12,20,-8
9,17,181,14,16,-2
9,17,182,25,10,15
9,17,183,15,34,-19
9,17,184,7,11,-4
9,17,185,18,7,11
9,17,186,12,9,3
9,17,187,10,11,-1
9,17,188,18,7,11
9,17,189,9,14,-5
9,17,190,15,12,3
9,17,191,36,9,27
9,17,192,12,10,2
9,17,193,21,9,12
9,17,194,18,12,6
9,17,195,20,16,4
9,17,196,18,22,-4
9,17,197,36,15,21
9,17,198,7,20,-13
9,17,199,13,21,-8
9,17,200,24,17,7
9,17,201,35,34,1
9,17,202,17,16,1
9,17,203,18,13,5
9,17,204,20,19,1
9,17,205,7,9,-2
9,17,206,22,15,7
9,17,207,10,13,-3
9,17,208,8,15,-7
9,17,209,8,5,3
9,17,210,22,13,9
9,17,211,18,15,3
9,17,212,16,11,5
9,17,213,13,19,-6
9,17,214,16,14,2
9,17,215,21,6,15
9,17,216,15,18,-3
9,17,217,19,24,-5
9,17,218,22,7,15
9,17,219,35,6,29
9,17,220,25,10,15
9,17,221,15,6,9
9,17,222,25,18,7
9,17,223,11,9,2
9,17,224,24,19,5
9,17,225,10,6,4
9,17,226,17,20,-3
9,17,227,33,19,14
9,17,228,16,13,3
9,17,229,12,7,5
9,17,230,14,14,0
9,17,231,12,4,8
9,17,232,6,22,-16
9,17,233,22,7,15
9,17,234,31,13,18
9,17,235,24,18,6
9,17,236,18,18,0
9,17,237,30,15,15
9,17,238,17,9,8
9,17,239,11,2,9
9,17,240,11,13,-2
9,17,241,22,5,17
9,17,242,12,7,5
9,17,243,15,18,-3
9,17,244,28,7,21
9,17,245,11,29,-18
9,17,246,19,15,4
9,17,247,26,17,9
9,17,248,19,11,8
9,17,249,16,5,11
9,17,250,8,5,3
9,17,251,12,10,2
9,17,252,15,6,9
9,17,253,6,11,-5
9,17,254,23,18,5
9,17,255,26,17,9
9,17,256,12,10,2
9,17,257,16,16,0
9,17,258,15,16,-1
9,17,259,25,16,9
9,17,260,19,10,9
9,17,261,18,13,5
9,17,262,10,1,9
9,17,263,13,13,0
9,17,264,24,17,7
9,17,265,16,7,9
9,17,266,12,14,-2
9,17,267,18,13,5
9,17,268,19,15,4
9,17,269,21,10,11
9,17,270,16,13,3
9,17,271,16,19,-3
9,17,272,18,14,4
9,17,273,11,7,4
9,17,274,11,17,-6
9,17,275,21,16,5
9,17,276,17,22,-5
9,17,277,17,9,8
9,17,278,9,13,-4
9,17,279,28,19,9
9,17,280,19,15,4
9,17,281,21,6,15
9,17,282,13,23,-10
9,17,283,17,8,9
9,17,284,17,16,1
9,17,285,14,12,2
9,17,286,17,6,11
9,17,287,12,12,0
9,17,288,32,16,16
9,17,289,27,9,18
9,17,290,11,9,2
9,17,291,21,12,9
9,17,292,9,11,-2
9,17,293,30,5,25
9,17,294,20,9,11
9,17,295,20,19,1
9,17,296,13,10,3
9,17,297,10,12,-2
9,17,298,22,12,10
9,17,299,21,13,8
9,18,0,25,9,16
9,18,1,32,11,21
9,18,2,4,13,-9
9,18,3,14,6,8
9,18,4,29,17,12
9,18,5,13,14,-1
9,18,6,21,7,14
9,18,7,24,23,1
9,18,8,13,11,2
9,18,9,14,13,1
9,18,10,27,4,23
9,18,11,14,4,10
9,18,12,15,11,4
9,18,13,11,10,1
9,18,14,21,10,11
9,18,15,22,19,3
9,18,16,12,19,-7
9,18,17,15,13,2
9,18,18,10,11,-1
9,18,19,11,9,2
9,18,20,8,12,-4
9,18,21,15,18,-3
9,18,22,16,10,6
9,18,23,15,10,5
9,18,24,12,26,-14
9,18,25,22,13,9
9,18,26,8,8,0
9,18,27,14,13,1
9,18,28,21,17,4
9,18,29,8,7,1
9,18,30,12,17,-5
9,18,31,14,9,5
9,18,32,18,13,5
9,18,33,24,13,11
9,18,34,18,7,11
9,18,35,15,18,-3
9,18,36,24,15,9
9,18,37,25,7,18
9,18,38,15,21,-6
9,18,39,33,15,18
9,18,40,28,11,17
9,18,41,37,19,18
9,18,42,20,18,2
9,18,43,19,15,4
9,18,44,31,9,22
9,18,45,13,14,-1
9,18,46,21,3,18
9,18,47,24,11,13
9,18,48,16,10,6
9,18,49,26,21,5
9,18,50,8,18,-10
9,18,51,19,21,-2
9,18,52,14,16,-2
9,18,53,8,6,2
9,18,54,11,17,-6
9,18,55,20,10,10
9,18,56,21,15,6
9,18,57,22,16,6
9,18,58,26,22,4
9,18,59,21,25,-4
9,18,60,9,10,-1
9,18,61,15,14,1
9,18,62,14,15,-1
9,18,63,13,13,0
9,18,64,16,17,-1
9,18,65,23,15,8
9,18,66,33,21,12
9,18,67,14,20,-6
9,18,68,19,13,6
9,18,69,20,8,12
9,18,70,12,15,-3
9,18,71,18,12,6
9,18,72,21,5,16
9,18,73,25,19,6
9,18,74,13,9,4
9,18,75,19,12,7
9,18,76,18,19,-1
9,18,77,20,17,3
9,18,78,10,10,0
9,18,79,7,8,-1
9,18,80,20,14,6
9,18,81,19,20,-1
9,18,82,15,10,5
9,18,83,21,22,-1
9,18,84,17,12,5
9,18,85,17,15,2
9,18,86,11,17,-6
9,18,87,15,13,2
9,18,88,12,7,5
9,18,89,15,8,7
9,18,90,23,18,5
9,18,91,13,10,3
9,18,92,17,11,6
9,18,93,40,20,20
9,18,94,9,5,4
9,18,95,11,13,-2
9,18,96,18,10,8
9,18,97,23,17,6
9,18,98,30,16,14
9,18,99,18,16,2
9,18,100,15,19,-4
9,18,101,15,8,7
9,18,102,12,9,3
9,18,103,7,4,3
9,18,104,27,13,14
9,18,105,13,2,11
9,18,106,21,23,-2
9,18,107,16,15,1
9,18,108,21,10,11
9,18,109,24,17,7
9,18,110,29,12,17
9,18,111,11,9,2
9,18,112,21,13,8
9,18,113,14,12,2
9,18,114,28,17,11
9,18,115,14,10,4
9,18,116,30,34,-4
9,18,117,15,10,5
9,18,118,15,9,6
9,18,119,19,15,4
9,18,120,17,17,0
9,18,121,14,14,0
9,18,122,15,16,-1
9,18,123,15,7,8
9,18,124,13,16,-3
9,18,125,23,15,8
9,18,126,9,10,-1
9,18,127,20,15,5
9,18,128,18,11,7
9,18,129,19,10,9
9,18,130,19,25,-6
9,18,131,14,12,2
9,18,132,12,12,0
9,18,133,27,23,4
9,18,134,11,5,6
9,18,135,13,17,-4
9,18,136,22,8,14
9,18,137,5,11,-6
9,18,138,14,6,8
9,18,139,10,10,0
9,18,140,20,15,5
9,18,141,20,18,2
9,18,142,12,21,-9
9,18,143,17,11,6
9,18,144,3,12,-9
9,18,145,13,10,3
9,18,146,17,21,-4
9,18,147,31,7,24
9,18,148,26,11,15
9,18,149,12,14,-2
9,18,150,8,6,2
9,18,151,20,16,4
9,18,152,18,7,11
9,18,153,15,12,3
9,18,154,22,17,5
9,18,155,33,26,7
9,18,156,2,6,-4
9,18,157,21,23,-2
9,18,158,14,14,0
9,18,159,11,9,2
9,18,160,16,13,3
9,18,161,16,18,-2
9,18,162,11,15,-4
9,18,163,22,17,5
9,18,164,12,11,1
9,18,165,15,13,2
9,18,166,13,17,-4
9,18,167,11,10,1
9,18,168,15,7,8
9,18,169,16,9,7
9,18,170,9,17,-8
9,18,171,13,13,0
9,18,172,28,9,19
9,18,173,25,18,7
9,18,174,15,12,3
9,18,175,17,14,3
9,18,176,13,15,-2
9,18,177,17,16,1
9,18,178,19,26,-7
9,18,179,17,13,4
9,18,180,23,15,8
9,18,181,20,21,-1
9,18,182,11,12,-1
9,18,183,16,10,6
9,18,184,19,14,5
9,18,185,17,9,8
9,18,186,26,18,8
9,18,187,23,15,8
9,18,188,11,23,-12
9,18,189,22,15,7
9,18,190,28,8,20
9,18,191,16,15,1
9,18,192,15,12,3
9,18,193,18,16,2
9,18,194,18,22,-4
9,18,195,15,27,-12
9,18,196,22,17,5
9,18,197,13,17,-4
9,18,198,8,6,2
9,18,199,17,11,6
9,18,200,30,22,8
9,18,201,11,8,3
9,18,202,18,18,0
9,18,203,14,13,1
9,18,204,11,13,-2
9,18,205,13,17,-4
9,18,206,15,18,-3
9,18,207,11,15,-4
9,18,208,13,11,2
9,18,209,23,10,13
9,18,210,17,13,4
9,18,211,14,12,2
9,18,212,38,15,23
9,18,213,17,11,6
9,18,214,13,6,7
9,18,215,19,7,12
9,18,216,13,26,-13
9,18,217,12,10,2
9,18,218,15,7,8
9,18,219,13,10,3
9,18,220,23,9,14
9,18,221,12,12,0
9,18,222,21,14,7
9,18,223,22,26,-4
9,18,224,15,12,3
9,18,225,36,13,23
9,18,226,19,4,15
9,18,227,14,8,6
9,18,228,19,15,4
9,18,229,16,13,3
9,18,230,17,5,12
9,18,231,17,22,-5
9,18,232,20,9,11
9,18,233,14,12,2
9,18,234,10,5,5
9,18,235,27,16,11
9,18,236,18,19,-1
9,18,237,27,12,15
9,18,238,5,2,3
9,18,239,10,12,-2
9,18,240,8,7,1
9,18,241,12,12,0
9,18,242,5,14,-9
9,18,243,22,21,1
9,18,244,12,10,2
9,18,245,11,4,7
9,18,246,13,11,2
9,18,247,26,14,12
9,18,248,8,5,3
9,18,249,12,22,-10
9,18,250,6,7,-1
9,18,251,19,14,5
9,18,252,19,7,12
9,18,253,15,27,-12
9,18,254,5,14,-9
9,18,255,23,15,8
9,18,256,18,14,4
9,18,257,21,7,14
9,18,258,19,13,6
9,18,259,12,13,-1
9,18,260,19,12,7
9,18,261,20,19,1
9,18,262,9,6,3
9,18,263,11,8,3
9,18,264,21,11,10
9,18,265,13,17,-4
9,18,266,18,13,5
9,18,267,13,16,-3
9,18,268,18,5,13
9,18,269,10,18,-8
9,18,270,22,22,0
9,18,271,23,8,15
9,18,272,24,25,-1
9,18,273,21,9,12
9,18,274,21,17,4
9,18,275,22,12,10
9,18,276,26,12,14
9,18,277,9,11,-2
9,18,278,7,15,-8
9,18,279,15,7,8
9,18,280,10,12,-2
9,18,281,15,17,-2
9,18,282,28,15,13
9,18,283,17,18,-1
9,18,284,17,11,6
9,18,285,22,8,14
9,18,286,23,18,5
9,18,287,7,13,-6
9,18,288,11,12,-1
9,18,289,16,12,4
9,18,290,18,23,-5
9,18,291,15,16,-1
9,18,292,26,19,7
9,18,293,24,23,1
9,18,294,16,15,1
9,18,295,17,12,5
9,18,296,15,12,3
9,18,297,16,16,0
9,18,298,25,13,12
9,18,299,16,15,1
9,19,0,12,16,-4
9,19,1,19,13,6
9,19,2,19,5,14
9,19,3,8,11,-3
9,19,4,17,8,9
9,19,5,25,14,11
9,19,6,19,12,7
9,19,7,4,10,-6
9,19,8,18,12,6
9,19,9,18,8,10
9,19,10,9,11,-2
9,19,11,10,11,-1
9,19,12,12,7,5
9,19,13,14,25,-11
9,19,14,35,23,12
9,19,15,16,8,8
9,19,16,19,13,6
9,19,17,24,18,6
9,19,18,12,11,1
9,19,19,16,7,9
9,19,20,17,15,2
9,19,21,18,17,1
9,19,22,22,18,4
9,19,23,13,25,-12
9,19,24,28,18,10
9,19,25,3,7,-4
9,19,26,16,20,-4
9,19,27,20,10,10
9,19,28,19,13,6
9,19,29,25,14,11
9,19,30,24,17,7
9,19,31,14,24,-10
9,19,32,36,23,13
9,19,33,24,12,12
9,19,34,17,8,9
9,19,35,21,18,3
9,19,36,20,13,7
9,19,37,16,18,-2
9,19,38,17,15,2
9,19,39,17,18,-1
9,19,40,23,14,9
9,19,41,22,23,-1
9,19,42,24,26,-2
9,19,43,18,14,4
9,19,44,6,6,0
9,19,45,9,8,1
9,19,46,30,18,12
9,19,47,24,20,4
9,19,48,14,18,-4
9,19,49,21,21,0
9,19,50,8,13,-5
9,19,51,19,8,11
9,19,52,14,6,8
9,19,53,22,14,8
9,19,54,8,9,-1
9,19,55,16,23,-7
9,19,56,11,13,-2
9,19,57,11,8,3
9,19,58,11,23,-12
9,19,59,23,15,8
9,19,60,18,6,12
9,19,61,32,19,13
9,19,62,20,17,3
9,19,63,24,20,4
9,19,64,19,19,0
9,19,65,15,7,8
9,19,66,25,22,3
9,19,67,19,12,7
9,19,68,12,4,8
9,19,69,13,18,-5
9,19,70,14,17,-3
9,19,71,41,15,26
9,19,72,12,11,1
9,19,73,21,16,5
9,19,74,21,11,10
9,19,75,18,18,0
9,19,76,11,11,0
9,19,77,25,29,-4
9,19,78,16,12,4
9,19,79,17,7,10
9,19,80,19,12,7
9,19,81,13,14,-1
9,19,82,10,11,-1
9,19,83,13,12,1
9,19,84,20,13,7
9,19,85,7,5,2
9,19,86,15,6,9
9,19,87,20,14,6
9,19,88,20,15,5
9,19,89,12,12,0
9,19,90,11,12,-1
9,19,91,20,12,8
9,19,92,19,16,3
9,19,93,9,10,-1
9,19,94,20,12,8
9,19,95,16,16,0
9,19,96,24,18,6
9,19,97,5,15,-10
9,19,98,15,11,4
9,19,99,25,22,3
9,19,100,12,6,6
9,19,101,21,26,-5
9,19,102,15,13,2
9,19,103,23,20,3
9,19,104,22,20,2
9,19,105,17,11,6
9,19,106,22,21,1
9,19,107,11,17,-6
9,19,108,14,6,8
9,19,109,15,12,3
9,19,110,20,11,9
9,19,111,19,11,8
9,19,112,37,16,21
9,19,113,14,12,2
9,19,114,11,9,2
9,19,115,19,22,-3
9,19,116,25,11,14
9,19,117,22,18,4
9,19,118,26,10,16
9,19,119,16,10,6
9,19,120,16,19,-3
9,19,121,28,8,20
9,19,122,14,15,-1
9,19,123,25,11,14
9,19,124,15,12,3
9,19,125,16,16,0
9,19,126,16,7,9
9,19,127,19,13,6
9,19,128,14,5,9
9,19,129,15,11,4
9,19,130,18,10,8
9,19,131,18,20,-2
9,19,132,24,7,17
9,19,133,22,20,2
9,19,134,21,13,8
9,19,135,17,15,2
9,19,136,15,20,-5
9,19,137,11,7,4
9,19,138,22,19,3
9,19,139,19,19,0
9,19,140,23,28,-5
9,19,141,29,16,13
9,19,142,23,9,14
9,19,143,14,18,-4
9,19,144,20,7,13
9,19,145,23,22,1
9,19,146,14,10,4
9,19,147,14,8,6
9,19,148,34,13,21
9,19,149,14,17,-3
9,19,150,27,13,14
9,19,151,23,13,10
9,19,152,19,17,2
9,19,153,19,15,4
9,19,154,16,12,4
9,19,155,19,11,8
9,19,156,26,22,4
9,19,157,25,11,14
9,19,158,23,17,6
9,19,159,15,15,0
9,19,160,25,17,8
9,19,161,18,10,8
9,19,162,16,9,7
9,19,163,16,15,1
9,19,164,20,24,-4
9,19,165,14,13,1
9,19,166,13,6,7
9,19,167,19,16,3
9,19,168,26,9,17
9,19,169,20,18,2
9,19,170,23,9,14
9,19,171,10,16,-6
9,19,172,7,8,-1
9,19,173,23,15,8
9,19,174,10,16,-6
9,19,175,21,20,1
9,19,176,10,13,-3
9,19,177,28,21,7
9,19,178,20,19,1
9,19,179,23,12,11
9,19,180,30,19,11
9,19,181,10,11,-1
9,19,182,29,18,11
9,19,183,17,6,11
9,19,184,11,12,-1
9,19,185,24,22,2
9,19,186,17,17,0
9,19,187,23,12,11
9,19,188,33,12,21
9,19,189,13,5,8
9,19,190,24,16,8
9,19,191,26,17,9
9,19,192,20,35,-15
9,19,193,13,5,8
9,19,194,10,8,2
9,19,195,17,16,1
9,19,196,24,9,15
9,19,197,11,17,-6
9,19,198,2,13,-11
9,19,199,19,19,0
9,19,200,15,36,-21
9,19,201,17,12,5
9,19,202,14,13,1
9,19,203,18,18,0
9,19,204,20,23,-3
9,19,205,21,12,9
9,19,206,16,3,13
9,19,207,13,3,10
9,19,208,22,20,2
9,19,209,11,7,4
9,19,210,12,10,2
9,19,211,22,12,10
9,19,212,18,18,0
9,19,213,11,7,4
9,19,214,7,11,-4
9,19,215,15,17,-2
9,19,216,31,14,17
9,19,217,9,8,1
9,19,218,12,19,-7
9,19,219,22,4,18
9,19,220,31,11,20
9,19,221,9,10,-1
9,19,222,12,18,-6
9,19,223,16,15,1
9,19,224,15,14,1
9,19,225,13,12,1
9,19,226,14,22,-8
9,19,227,13,16,-3
9,19,228,21,13,8
9,19,229,11,6,5
9,19,230,7,6,1
9,19,231,6,15,-9
9,19,232,21,16,5
9,19,233,11,10,1
9,19,234,10,13,-3
9,19,235,23,14,9
9,19,236,27,20,7
9,19,237,26,30,-4
9,19,238,18,9,9
9,19,239,20,26,-6
9,19,240,18,23,-5
9,19,241,10,15,-5
9,19,242,15,16,-1
9,19,243,18,17,1
9,19,244,14,11,3
9,19,245,24,11,13
9,19,246,18,25,-7
9,19,247,17,25,-8
9,19,248,34,15,19
9,19,249,16,14,2
9,19,250,14,6,8
9,19,251,18,15,3
9,19,252,21,18,3
9,19,253,6,16,-10
9,19,254,17,17,0
9,19,255,19,8,11
9,19,256,20,29,-9
9,19,257,10,30,-20
9,19,258,12,9,3
9,19,259,31,18,13
9,19,260,8,22,-14
9,19,261,15,16,-1
9,19,262,15,6,9
9,19,263,14,22,-8
9,19,264,17,18,-1
9,19,265,21,20,1
9,19,266,14,13,1
9,19,267,16,10,6
9,19,268,22,14,8
9,19,269,13,11,2
9,19,270,15,13,2
9,19,271,21,17,4
9,19,272,12,23,-11
9,19,273,24,16,8
9,19,274,19,11,8
9,19,275,13,12,1
9,19,276,23,37,-14
9,19,277,11,14,-3
9,19,278,19,4,15
9,19,279,34,15,19
9,19,280,15,32,-17
9,19,281,9,9,0
9,19,282,21,9,12
9,19,283,13,13,0
9,19,284,18,15,3
9,19,285,28,18,10
9,19,286,25,15,10
9,19,287,19,14,5
9,19,288,10,13,-3
9,19,289,20,19,1
9,19,290,10,9,1
9,19,291,22,16,6
9,19,292,12,16,-4
9,19,293,21,21,0
9,19,294,13,12,1
9,19,295,8,4,4
9,19,296,30,16,14
9,19,297,25,11,14
9,19,298,12,13,-1
9,19,299,19,17,2
9,20,0,1,4,-3
9,20,1,12,11,1
9,20,2,23,16,7
9,20,3,25,12,13
9,20,4,15,11,4
9,20,5,24,24,0
9,20,6,14,17,-3
9,20,7,17,7,10
9,20,8,14,10,4
9,20,9,16,9,7
9,20,10,11,22,-11
9,20,11,5,12,-7
9,20,12,26,18,8
9,20,13,26,30,-4
9,20,14,15,17,-2
9,20,15,28,15,13
9,20,16,5,7,-2
9,20,17,17,4,13
9,20,18,26,12,14
9,20,19,13,13,0
9,20,20,15,12,3
9,20,21,26,18,8
9,20,22,26,17,9
9,20,23,29,13,16
9,20,24,17,10,7
9,20,25,15,16,-1
9,20,26,34,9,25
9,20,27,18,17,1
9,20,28,22,11,11
9,20,29,16,18,-2
9,20,30,6,14,-8
9,20,31,13,11,2
9,20,32,12,10,2
9,20,33,15,27,-12
9,20,34,15,11,4
9,20,35,23,22,1
9,20,36,17,10,7
9,20,37,19,16,3
9,20,38,18,14,4
9,20,39,7,12,-5
9,20,40,19,16,3
9,20,41,13,9,4
9,20,42,8,6,2
9,20,43,22,16,6
9,20,44,9,9,0
9,20,45,28,34,-6
9,20,46,14,6,8
9,20,47,26,11,15
9,20,48,13,8,5
9,20,49,14,10,4
9,20,50,22,16,6
9,20,51,28,15,13
9,20,52,9,11,-2
9,20,53,28,13,15
9,20,54,10,5,5
9,20,55,35,24,11
9,20,56,28,12,16
9,20,57,14,8,6
9,20,58,8,17,-9
9,20,59,14,12,2
9,20,60,14,7,7
9,20,61,9,17,-8
9,20,62,29,13,16
9,20,63,14,5,9
9,20,64,14,8,6
9,20,65,18,11,7
9,20,66,25,18,7
9,20,67,13,9,4
9,20,68,31,16,15
9,20,69,13,9,4
9,20,70,4,4,0
9,20,71,19,14,5
9,20,72,15,15,0
9,20,73,15,16,-1
9,20,74,21,14,7
9,20,75,24,9,15
9,20,76,17,24,-7
9,20,77,25,16,9
9,20,78,20,13,7
9,20,79,21,22,-1
9,20,80,29,14,15
9,20,81,26,12,14
9,20,82,14,18,-4
9,20,83,23,4,19
9,20,84,14,21,-7
9,20,85,14,11,3
9,20,86,22,12,10
9,20,87,20,18,2
9,20,88,16,18,-2
9,20,89,18,11,7
9,20,90,12,10,2
9,20,91,25,23,2
9,20,92,18,24,-6
9,20,93,18,18,0
9,20,94,16,14,2
9,20,95,22,13,9
9,20,96,20,14,6
9,20,97,10,3,7
9,20,98,32,17,15
9,20,99,12,22,-10
9,20,100,14,22,-8
9,20,101,37,20,17
9,20,102,14,12,2
9,20,103,17,8,9
9,20,104,23,28,-5
9,20,105,17,5,12
9,20,106,11,10,1
9,20,107,15,24,-9
9,20,108,15,17,-2
9,20,109,23,17,6
9,20,110,14,5,9
9,20,111,19,13,6
9,20,112,14,13,1
9,20,113,19,9,10
9,20,114,16,4,12
9,20,115,25,9,16
9,20,116,12,7,5
9,20,117,19,10,9
9,20,118,13,9,4
9,20,119,14,11,3
9,20,120,7,22,-15
9,20,121,21,21,0
9,20,122,13,10,3
9,20,123,16,20,-4
9,20,124,19,11,8
9,20,125,14,14,0
9,20,126,37,9,28
9,20,127,11,13,-2
9,20,128,21,16,5
9,20,129,17,18,-1
9,20,130,9,12,-3
9,20,131,13,11,2
9,20,132,16,12,4
9,20,133,15,16,-1
9,20,134,15,8,7
9,20,135,33,18,15
9,20,136,10,11,-1
9,20,137,30,18,12
9,20,138,13,6,7
9,20,139,11,8,3
9,20,140,19,12,7
9,20,141,15,16,-1
9,20,142,8,11,-3
9,20,143,19,7,12
9,20,144,7,7,0
9,20,145,20,1,19
9,20,146,21,9,12
9,20,147,23,9,14
9,20,148,7,13,-6
9,20,149,17,19,-2
9,20,150,14,14,0
9,20,151,7,6,1
9,20,152,13,14,-1
9,20,153,4,2,2
9,20,154,22,14,8
9,20,155,20,10,10
9,20,156,19,15,4
9,20,157,18,17,1
9,20,158,9,15,-6
9,20,159,21,10,11
9,20,160,18,11,7
9,20,161,16,20,-4
9,20,162,18,7,11
9,20,163,24,27,-3
9,20,164,14,10,4
9,20,165,16,5,11
9,20,166,9,15,-6
9,20,167,18,18,0
9,20,168,24,15,9
9,20,169,24,8,16
9,20,170,6,5,1
9,20,171,14,6,8
9,20,172,22,17,5
9,20,173,15,16,-1
9,20,174,10,20,-10
9,20,175,12,13,-1
9,20,176,16,6,10
9,20,177,14,23,-9
9,20,178,12,13,-1
9,20,179,16,17,-1
9,20,180,21,9,12
9,20,181,11,19,-8
9,20,182,16,9,7
9,20,183,30,12,18
9,20,184,16,24,-8
9,20,185,7,6,1
9,20,186,8,6,2
9,20,187,21,15,6
9,20,188,10,15,-5
9,20,189,17,23,-6
9,20,190,18,12,6
9,20,191,21,9,12
9,20,192,24,14,10
9,20,193,26,5,21
9,20,194,20,16,4
9,20,195,27,22,5
9,20,196,13,4,9
9,20,197,20,14,6
9,20,198,29,6,23
9,20,199,11,13,-2
9,20,200,41,35,6
9,20,201,13,10,3
9,20,202,10,7,3
9,20,203,19,16,3
9,20,204,16,15,1
9,20,205,24,23,1
9,20,206,16,6,10
9,20,207,24,11,13
9,20,208,13,3,10
9,20,209,10,10,0
9,20,210,20,20,0
9,20,211,13,13,0
9,20,212,17,12,5
9,20,213,11,27,-16
9,20,214,24,14,10
9,20,215,19,17,2
9,20,216,18,5,13
9,20,217,19,3,16
9,20,218,24,21,3
9,20,219,13,5,8
9,20,220,14,11,3
9,20,221,18,17,1
9,20,222,20,18,2
9,20,223,13,12,1
9,20,224,14,12,2
9,20,225,13,15,-2
9,20,226,27,10,17
9,20,227,14,15,-1
9,20,228,5,14,-9
9,20,229,20,4,16
9,20,230,12,13,-1
9,20,231,26,30,-4
9,20,232,21,18,3
9,20,233,21,14,7
9,20,234,15,10,5
9,20,235,24,15,9
9,20,236,27,11,16
9,20,237,18,21,-3
9,20,238,30,16,14
9,20,239,18,18,0
9,20,240,16,23,-7
9,20,241,15,12,3
9,20,242,15,11,4
9,20,243,33,20,13
9,20,244,34,16,18
9,20,245,10,10,0
9,20,246,20,25,-5
9,20,247,13,12,1
9,20,248,16,12,4
9,20,249,11,15,-4
9,20,250,20,5,15
9,20,251,20,13,7
9,20,252,10,13,-3
9,20,253,19,12,7
9,20,254,19,10,9
9,20,255,14,19,-5
9,20,256,20,22,-2
9,20,257,20,27,-7
9,20,258,16,18,-2
9,20,259,24,13,11
9,20,260,17,13,4
9,20,261,13,10,3
9,20,262,7,3,4
9,20,263,37,18,19
9,20,264,12,19,-7
9,20,265,25,16,9
9,20,266,21,7,14
9,20,267,15,15,0
9,20,268,16,7,9
9,20,269,18,20,-2
9,20,270,14,7,7
9,20,271,23,19,4
9,20,272,7,7,0
9,20,273,23,25,-2
9,20,274,29,11,18
9,20,275,12,11,1
9,20,276,23,15,8
9,20,277,10,6,4
9,20,278,7,14,-7
9,20,279,22,12,10
9,20,280,14,13,1
9,20,281,25,11,14
9,20,282,18,11,7
9,20,283,11,17,-6
9,20,284,10,10,0
9,20,285,17,14,3
9,20,286,17,12,5
9,20,287,17,37,-20
9,20,288,5,7,-2
9,20,289,15,12,3
9,20,290,16,8,8
9,20,291,16,14,2
9,20,292,10,10,0
9,20,293,4,10,-6
9,20,294,23,19,4
9,20,295,20,10,10
9,20,296,19,18,1
9,20,297,21,18,3
9,20,298,15,18,-3
9,20,299,17,6,11
9,21,0,14,7,7
9,21,1,21,9,12
9,21,2,22,8,14
9,21,3,15,6,9
9,21,4,17,6,11
9,21,5,22,18,4
9,21,6,33,13,20
9,21,7,15,18,-3
9,21,8,16,15,1
9,21,9,18,7,11
9,21,10,23,17,6
9,21,11,11,13,-2
9,21,12,14,19,-5
9,21,13,17,9,8
9,21,14,24,14,10
9,21,15,12,10,2
9,21,16,27,20,7
9,21,17,14,6,8
9,21,18,10,16,-6
9,21,19,12,6,6
9,21,20,31,14,17
9,21,21,19,8,11
9,21,22,15,17,-2
9,21,23,22,21,1
9,21,24,18,18,0
9,21,25,23,15,8
9,21,26,9,18,-9
9,21,27,16,11,5
9,21,28,34,19,15
9,21,29,18,5,13
9,21,30,12,13,-1
9,21,31,15,8,7
9,21,32,16,8,8
9,21,33,17,13,4
9,21,34,28,22,6
9,21,35,15,19,-4
9,21,36,12,12,0
9,21,37,8,1,7
9,21,38,16,16,0
9,21,39,29,13,16
9,21,40,24,11,13
9,21,41,3,8,-5
9,21,42,26,30,-4
9,21,43,23,28,-5
9,21,44,15,15,0
9,21,45,19,17,2
9,21,46,20,14,6
9,21,47,14,19,-5
9,21,48,10,13,-3
9,21,49,31,13,18
9,21,50,16,18,-2
9,21,51,22,14,8
9,21,52,26,17,9
9,21,53,20,15,5
9,21,54,22,5,17
9,21,55,5,13,-8
9,21,56,19,8,11
9,21,57,13,8,5
9,21,58,13,10,3
9,21,59,10,16,-6
9,21,60,7,10,-3
9,21,61,6,6,0
9,21,62,26,7,19
9,21,63,11,12,-1
9,21,64,22,15,7
9,21,65,3,11,-8
9,21,66,11,16,-5
9,21,67,16,12,4
9,21,68,26,14,12
9,21,69,18,14,4
9,21,70,30,13,17
9,21,71,25,9,16
9,21,72,14,12,2
9,21,73,20,12,8
9,21,74,17,17,0
9,21,75,16,15,1
9,21,76,14,15,-1
9,21,77,12,10,2
9,21,78,18,14,4
9,21,79,27,12,15
9,21,80,11,11,0
9,21,81,18,15,3
9,21,82,16,3,13
9,21,83,25,19,6
9,21,84,17,28,-11
9,21,85,14,15,-1
9,21,86,18,12,6
9,21,87,17,6,11
9,21,88,13,12,1
9,21,89,11,9,2
9,21,90,13,15,-2
9,21,91,13,14,-1
9,21,92,23,10,13
9,21,93,11,6,5
9,21,94,34,9,25
9,21,95,7,7,0
9,21,96,14,23,-9
9,21,97,17,11,6
9,21,98,20,6,14
9,21,99,32,15,17
9,21,100,27,27,0
9,21,101,11,8,3
9,21,102,14,8,6
9,21,103,21,16,5
9,21,104,19,17,2
9,21,105,17,12,5
9,21,106,22,16,6
9,21,107,17,19,-2
9,21,108,6,22,-16
9,21,109,16,13,3
9,21,110,31,16,15
9,21,111,19,15,4
9,21,112,32,15,17
9,21,113,13,7,6
9,21,114,16,3,13
9,21,115,19,17,2
9,21,116,25,10,15
9,21,117,19,20,-1
9,21,118,25,29,-4
9,21,119,38,12,26
9,21,120,22,11,11
9,21,121,26,17,9
9,21,122,20,13,7
9,21,123,6,10,-4
9,21,124,16,7,9
9,21,125,23,10,13
9,21,126,14,8,6
9,21,127,9,13,-4
9,21,128,18,15,3
9,21,129,14,14,0
9,21,130,32,12,20
9,21,131,20,12,8
9,21,132,21,18,3
9,21,133,13,5,8
9,21,134,12,15,-3
9,21,135,20,15,5
9,21,136,14,8,6
9,21,137,8,8,0
9,21,138,15,12,3
9,21,139,16,12,4
9,21,140,22,4,18
9,21,141,15,16,-1
9,21,142,13,15,-2
9,21,143,9,12,-3
9,21,144,16,10,6
9,21,145,25,19,6
9,21,146,18,24,-6
9,21,147,9,9,0
9,21,148,13,5,8
9,21,149,6,7,-1
9,21,150,16,13,3
9,21,151,25,15,10
9,21,152,28,10,18
9,21,153,17,19,-2
9,21,154,27,16,11
9,21,155,15,20,-5
9,21,156,23,9,14
9,21,157,12,15,-3
9,21,158,20,9,11
9,21,159,15,17,-2
9,21,160,7,6,1
9,21,161,17,10,7
9,21,162,17,13,4
9,21,163,8,8,0
9,21,164,20,14,6
9,21,165,18,11,7
9,21,166,27,8,19
9,21,167,17,14,3
9,21,168,5,20,-15
9,21,169,19,11,8
9,21,170,18,13,5
9,21,171,21,9,12
9,21,172,14,13,1
9,21,173,17,6,11
9,21,174,21,13,8
9,21,175,7,17,-10
9,21,176,38,8,30
9,21,177,19,23,-4
9,21,178,9,8,1
9,21,179,20,13,7
9,21,180,16,13,3
9,21,181,8,13,-5
9,21,182,25,12,13
9,21,183,22,10,12
9,21,184,19,13,6
9,21,185,16,22,-6
9,21,186,32,8,24
9,21,187,16,11,5
9,21,188,26,18,8
9,21,189,22,12,10
9,21,190,5,11,-6
9,21,191,22,12,10
9,21,192,24,13,11
9,21,193,30,16,14
9,21,194,21,28,-7
9,21,195,25,13,12
9,21,196,26,23,3
9,21,197,27,7,20
9,21,198,19,11,8
9,21,199,11,9,2
9,21,200,12,20,-8
9,21,201,10,22,-12
9,21,202,18,10,8
9,21,203,5,7,-2
9,21,204,21,11,10
9,21,205,19,9,10
9,21,206,22,20,2
9,21,207,19,3,16
9,21,208,29,18,11
9,21,209,11,16,-5
9,21,210,26,6,20
9,21,211,29,16,13
9,21,212,15,8,7
9,21,213,28,19,9
9,21,214,17,15,2
9,21,215,7,14,-7
9,21,216,26,18,8
9,21,217,11,21,-10
9,21,218,17,12,5
9,21,219,11,9,2
9,21,220,14,4,10
9,21,221,26,6,20
9,21,222,21,14,7
9,21,223,27,21,6
9,21,224,33,20,13
9,21,225,17,22,-5
9,21,226,18,11,7
9,21,227,36,18,18
9,21,228,16,11,5
9,21,229,14,14,0
9,21,230,20,15,5
9,21,231,21,23,-2
9,21,232,19,13,6
9,21,233,13,13,0
9,21,234,16,13,3
9,21,235,11,14,-3
9,21,236,12,6,6
9,21,237,22,16,6
9,21,238,21,16,5
9,21,239,18,7,11
9,21,240,30,19,11
9,21,241,15,17,-2
9,21,242,22,8,14
9,21,243,18,17,1
9,21,244,22,14,8
9,21,245,16,14,2
9,21,246,33,16,17
9,21,247,25,18,7
9,21,248,12,4,8
9,21,249,25,12,13
9,21,250,29,18,11
9,21,251,9,18,-9
9,21,252,12,15,-3
9,21,253,14,4,10
9,21,254,10,9,1
9,21,255,18,8,10
9,21,256,19,8,11
9,21,257,21,22,-1
9,21,258,20,9,11
9,21,259,32,19,13
9,21,260,18,13,5
9,21,261,17,26,-9
9,21,262,10,21,-11
9,21,263,19,10,9
9,21,264,15,14,1
9,21,265,11,9,2
9,21,266,8,10,-2
9,21,267,15,26,-11
9,21,268,14,14,0
9,21,269,24,12,12
9,21,270,13,17,-4
9,21,271,12,5,7
9,21,272,18,8,10
9,21,273,12,13,-1
9,21,274,3,8,-5
9,21,275,27,16,11
9,21,276,17,12,5
9,21,277,13,15,-2
9,21,278,10,13,-3
9,21,279,18,9,9
9,21,280,12,5,7
9,21,281,16,23,-7
9,21,282,8,5,3
9,21,283,26,19,7
9,21,284,26,19,7
9,21,285,21,24,-3
9,21,286,13,13,0
9,21,287,14,8,6
9,21,288,14,16,-2
9,21,289,24,17,7
9,21,290,11,18,-7
9,21,291,20,7,13
9,21,292,24,15,9
9,21,293,32,6,26
9,21,294,4,14,-10
9,21,295,20,6,14
9,21,296,28,17,11
9,21,297,27,19,8
9,21,298,9,6,3
9,21,299,21,19,2
9,22,0,9,7,2
9,22,1,14,5,9
9,22,2,27,11,16
9,22,3,18,17,1
9,22,4,15,11,4
9,22,5,24,5,19
9,22,6,8,9,-1
9,22,7,24,25,-1
9,22,8,19,13,6
9,22,9,32,19,13
9,22,10,7,8,-1
9,22,11,28,22,6
9,22,12,16,10,6
9,22,13,24,14,10
9,22,14,23,15,8
9,22,15,6,23,-17
9,22,16,18,10,8
9,22,17,22,15,7
9,22,18,15,20,-5
9,22,19,19,16,3
9,22,20,8,13,-5
9,22,21,9,13,-4
9,22,22,17,13,4
9,22,23,21,12,9
9,22,24,9,9,0
9,22,25,9,12,-3
9,22,26,15,15,0
9,22,27,23,18,5
9,22,28,10,7,3
9,22,29,11,8,3
9,22,30,35,7,28
9,22,31,13,32,-19
9,22,32,27,4,23
9,22,33,6,12,-6
9,22,34,26,21,5
9,22,35,24,9,15
9,22,36,20,7,13
9,22,37,22,6,16
9,22,38,13,15,-2
9,22,39,19,17,2
9,22,40,9,12,-3
9,22,41,6,6,0
9,22,42,21,14,7
9,22,43,21,12,9
9,22,44,11,18,-7
9,22,45,28,14,14
9,22,46,23,7,16
9,22,47,22,12,10
9,22,48,17,19,-2
9,22,49,24,20,4
9,22,50,18,10,8
9,22,51,15,10,5
9,22,52,24,11,13
9,22,53,13,17,-4
9,22,54,21,18,3
9,22,55,10,8,2
9,22,56,25,18,7
9,22,57,18,16,2
9,22,58,16,8,8
9,22,59,16,25,-9
9,22,60,21,22,-1
9,22,61,17,14,3
9,22,62,25,12,13
9,22,63,21,16,5
9,22,64,19,16,3
9,22,65,16,11,5
9,22,66,16,8,8
9,22,67,22,14,8
9,22,68,21,10,11
9,22,69,17,12,5
9,22,70,16,12,4
9,22,71,15,14,1
9,22,72,16,20,-4
9,22,73,42,8,34
9,22,74,22,14,8
9,22,75,11,9,2
9,22,76,21,21,0
9,22,77,8,1,7
9,22,78,17,9,8
9,22,79,21,16,5
9,22,80,16,17,-1
9,22,81,24,3,21
9,22,82,19,16,3
9,22,83,20,21,-1
9,22,84,12,10,2
9,22,85,15,7,8
9,22,86,10,10,0
9,22,87,21,11,10
9,22,88,7,14,-7
9,22,89,23,11,12
9,22,90,19,7,12
9,22,91,22,3,19
9,22,92,14,15,-1
9,22,93,2,6,-4
9,22,94,22,9,13
9,22,95,16,8,8
9,22,96,15,20,-5
9,22,97,32,19,13
9,22,98,33,6,27
9,22,99,14,6,8
9,22,100,13,16,-3
9,22,101,12,11,1
9,22,102,14,7,7
9,22,103,21,10,11
9,22,104,18,12,6
9,22,105,28,15,13
9,22,106,30,12,18
9,22,107,27,10,17
9,22,108,11,8,3
9,22,109,15,6,9
9,22,110,27,25,2
9,22,111,29,9,20
9,22,112,12,20,-8
9,22,113,16,13,3
9,22,114,17,10,7
9,22,115,25,19,6
9,22,116,26,23,3
9,22,117,14,10,4
9,22,118,8,7,1
9,22,119,28,22,6
9,22,120,16,8,8
9,22,121,16,3,13
9,22,122,17,18,-1
9,22,123,8,10,-2
9,22,124,22,8,14
9,22,125,30,24,6
9,22,126,8,6,2
9,22,127,33,13,20
9,22,128,15,9,6
9,22,129,11,9,2
9,22,130,12,16,-4
9,22,131,26,19,7
9,22,132,25,9,16
9,22,133,7,7,0
9,22,134,13,9,4
9,22,135,14,3,11
9,22,136,26,10,16
9,22,137,19,23,-4
9,22,138,25,20,5
9,22,139,14,7,7
9,22,140,15,8,7
9,22,141,21,10,11
9,22,142,20,10,10
9,22,143,36,8,28
9,22,144,24,17,7
9,22,145,11,6,5
9,22,146,24,12,12
9,22,147,24,13,11
9,22,148,14,9,5
9,22,149,21,12,9
9,22,150,16,14,2
9,22,151,19,11,8
9,22,152,15,14,1
9,22,153,12,9,3
9,22,154,15,9,6
9,22,155,15,7,8
9,22,156,22,21,1
9,22,157,32,13,19
9,22,158,35,10,25
9,22,159,34,6,28
9,22,160,27,15,12
9,22,161,18,11,7
9,22,162,20,13,7
9,22,163,17,8,9
9,22,164,18,14,4
9,22,165,26,23,3
9,22,166,1,18,-17
9,22,167,19,7,12
9,22,168,15,11,4
9,22,169,21,7,14
9,22,170,7,1,6
9,22,171,14,1,13
9,22,172,26,11,15
9,22,173,29,15,14
9,22,174,24,13,11
9,22,175,20,7,13
9,22,176,27,22,5
9,22,177,23,16,7
9,22,178,19,22,-3
9,22,179,21,13,8
9,22,180,19,12,7
9,22,181,13,17,-4
9,22,182,10,13,-3
9,22,183,7,11,-4
9,22,184,15,24,-9
9,22,185,9,13,-4
9,22,186,18,2,16
9,22,187,17,8,9
9,22,188,42,20,22
9,22,189,24,12,12
9,22,190,24,5,19
9,22,191,27,13,14
9,22,192,17,14,3
9,22,193,12,8,4
9,22,194,24,13,11
9,22,195,29,17,12
9,22,196,12,14,-2
9,22,197,14,8,6
9,22,198,19,15,4
9,22,199,12,6,6
9,22,200,13,5,8
9,22,201,17,12,5
9,22,202,15,7,8
9,22,203,29,9,20
9,22,204,6,1,5
9,22,205,14,16,-2
9,22,206,22,19,3
9,22,207,22,11,11
9,22,208,25,10,15
9,22,209,22,18,4
9,22,210,14,12,2
9,22,211,21,12,9
9,22,212,20,15,5
9,22,213,13,6,7
9,22,214,30,19,11
9,22,215,31,24,7
9,22,216,9,10,-1
9,22,217,17,9,8
9,22,218,16,17,-1
9,22,219,15,18,-3
9,22,220,29,17,12
9,22,221,15,10,5
9,22,222,9,5,4
9,22,223,22,17,5
9,22,224,24,11,13
9,22,225,13,12,1
9,22,226,23,9,14
9,22,227,12,11,1
9,22,228,14,9,5
9,22,229,18,9,9
9,22,230,6,14,-8
9,22,231,14,11,3
9,22,232,25,12,13
9,22,233,17,12,5
9,22,234,15,9,6
9,22,235,9,10,-1
9,22,236,17,10,7
9,22,237,18,11,7
9,22,238,21,17,4
9,22,239,12,13,-1
9,22,240,18,18,0
9,22,241,24,15,9
9,22,242,7,10,-3
9,22,243,28,12,16
9,22,244,12,6,6
9,22,245,14,4,10
9,22,246,27,10,17
9,22,247,20,14,6
9,22,248,16,6,10
9,22,249,7,4,3
9,22,250,13,20,-7
9,22,251,19,16,3
9,22,252,9,13,-4
9,22,253,25,12,13
9,22,254,18,13,5
9,22,255,17,11,6
9,22,256,18,20,-2
9,22,257,13,13,0
9,22,258,10,17,-7
9,22,259,19,7,12
9,22,260,6,9,-3
9,22,261,42,24,18
9,22,262,20,5,15
9,22,263,22,14,8
9,22,264,21,20,1
9,22,265,18,19,-1
9,22,266,27,8,19
9,22,267,33,15,18
9,22,268,17,19,-2
9,22,269,14,9,5
9,22,270,16,18,-2
9,22,271,14,7,7
9,22,272,21,15,6
9,22,273,18,11,7
9,22,274,16,6,10
9,22,275,16,21,-5
9,22,276,16,26,-10
9,22,277,15,12,3
9,22,278,17,12,5
9,22,279,31,9,22
9,22,280,13,15,-2
9,22,281,23,11,12
9,22,282,20,21,-1
9,22,283,17,7,10
9,22,284,13,4,9
9,22,285,21,4,17
9,22,286,21,6,15
9,22,287,23,18,5
9,22,288,2,11,-9
9,22,289,25,14,11
9,22,290,18,19,-1
9,22,291,15,19,-4
9,22,292,17,9,8
9,22,293,7,6,1
9,22,294,29,10,19
9,22,295,20,12,8
9,22,296,18,9,9
9,22,297,23,10,13
9,22,298,12,10,2
9,22,299,13,18,-5
9,23,0,14,17,-3
9,23,1,13,14,-1
9,23,2,23,12,11
9,23,3,19,8,11
9,23,4,15,29,-14
9,23,5,13,15,-2
9,23,6,22,13,9
9,23,7,15,4,11
9,23,8,18,9,9
9,23,9,19,9,10
9,23,10,21,9,12
9,23,11,12,15,-3
9,23,12,18,13,5
9,23,13,24,7,17
9,23,14,10,1,9
9,23,15,22,17,5
9,23,16,14,17,-3
9,23,17,25,12,13
9,23,18,16,7,9
9,23,19,16,1,15
9,23,20,19,17,2
9,23,21,22,14,8
9,23,22,7,15,-8
9,23,23,13,14,-1
9,23,24,18,8,10
9,23,25,23,14,9
9,23,26,16,22,-6
9,23,27,14,8,6
9,23,28,21,18,3
9,23,29,19,14,5
9,23,30,15,9,6
9,23,31,24,17,7
9,23,32,22,14,8
9,23,33,23,20,3
9,23,34,9,10,-1
9,23,35,20,14,6
9,23,36,19,13,6
9,23,37,18,10,8
9,23,38,13,17,-4
9,23,39,8,1,7
9,23,40,24,16,8
9,23,41,25,24,1
9,23,42,19,2,17
9,23,43,26,10,16
9,23,44,15,18,-3
9,23,45,17,12,5
9,23,46,40,4,36
9,23,47,10,16,-6
9,23,48,22,16,6
9,23,49,17,3,14
9,23,50,24,17,7
9,23,51,17,13,4
9,23,52,8,13,-5
9,23,53,15,11,4
9,23,54,23,19,4
9,23,55,19,16,3
9,23,56,8,21,-13
9,23,57,43,19,24
9,23,58,7,10,-3
9,23,59,20,17,3
9,23,60,18,12,6
9,23,61,21,4,17
9,23,62,23,20,3
9,23,63,17,15,2
9,23,64,7,13,-6
9,23,65,24,13,11
9,23,66,20,26,-6
9,23,67,13,11,2
9,23,68,18,12,6
9,23,69,23,21,2
9,23,70,22,14,8
9,23,71,15,17,-2
9,23,72,12,7,5
9,23,73,18,24,-6
9,23,74,22,14,8
9,23,75,7,13,-6
9,23,76,17,5,12
9,23,77,15,10,5
9,23,78,17,3,14
9,23,79,13,8,5
9,23,80,10,10,0
9,23,81,20,15,5
9,23,82,26,10,16
9,23,83,25,14,11
9,23,84,15,4,11
9,23,85,12,8,4
9,23,86,20,6,14
9,23,87,13,13,0
9,23,88,16,9,7
9,23,89,20,10,10
9,23,90,16,11,5
9,23,91,17,19,-2
9,23,92,18,13,5
9,23,93,18,8,10
9,23,94,21,16,5
9,23,95,8,10,-2
9,23,96,19,22,-3
9,23,97,12,19,-7
9,23,98,11,6,5
9,23,99,21,13,8
9,23,100,18,20,-2
9,23,101,40,20,20
9,23,102,33,15,18
9,23,103,18,13,5
9,23,104,18,18,0
9,23,105,19,13,6
9,23,106,10,11,-1
9,23,107,14,11,3
9,23,108,20,18,2
9,23,109,14,4,10
9,23,110,11,7,4
9,23,111,24,19,5
9,23,112,19,13,6
9,23,113,14,11,3
9,23,114,25,22,3
9,23,115,20,9,11
9,23,116,31,15,16
9,23,117,16,20,-4
9,23,118,23,18,5
9,23,119,16,14,2
9,23,120,18,8,10
9,23,121,15,10,5
9,23,122,14,7,7
9,23,123,18,10,8
9,23,124,16,14,2
9,23,125,26,13,13
9,23,126,8,7,1
9,23,127,14,8,6
9,23,128,18,15,3
9,23,129,21,15,6
9,23,130,17,18,-1
9,23,131,22,15,7
9,23,132,16,15,1
9,23,133,22,13,9
9,23,134,37,15,22
9,23,135,11,25,-14
9,23,136,19,7,12
9,23,137,16,11,5
9,23,138,26,5,21
9,23,139,9,12,-3
9,23,140,24,17,7
9,23,141,10,8,2
9,23,142,14,3,11
9,23,143,17,18,-1
9,23,144,14,11,3
9,23,145,16,11,5
9,23,146,18,9,9
9,23,147,11,28,-17
9,23,148,11,15,-4
9,23,149,9,16,-7
9,23,150,19,4,15
9,23,151,16,10,6
9,23,152,29,13,16
9,23,153,19,16,3
9,23,154,15,14,1
9,23,155,15,12,3
9,23,156,21,12,9
9,23,157,20,9,11
9,23,158,21,9,12
9,23,159,21,12,9
9,23,160,15,6,9
9,23,161,21,14,7
9,23,162,19,6,13
9,23,163,11,12,-1
9,23,164,29,18,11
9,23,165,18,11,7
9,23,166,12,13,-1
9,23,167,5,12,-7
9,23,168,14,12,2
9,23,169,34,12,22
9,23,170,25,12,13
9,23,171,10,20,-10
9,23,172,21,11,10
9,23,173,22,18,4
9,23,174,13,21,-8
9,23,175,15,10,5
9,23,176,29,20,9
9,23,177,19,13,6
9,23,178,21,14,7
9,23,179,24,11,13
9,23,180,13,20,-7
9,23,181,12,9,3
9,23,182,25,6,19
9,23,183,21,18,3
9,23,184,8,7,1
9,23,185,29,10,19
9,23,186,13,25,-12
9,23,187,22,3,19
9,23,188,12,19,-7
9,23,189,23,5,18
9,23,190,20,5,15
9,23,191,13,10,3
9,23,192,14,16,-2
9,23,193,14,15,-1
9,23,194,9,5,4
9,23,195,17,19,-2
9,23,196,19,21,-2
9,23,197,17,10,7
9,23,198,25,22,3
9,23,199,18,13,5
9,23,200,10,3,7
9,23,201,12,12,0
9,23,202,17,10,7
9,23,203,18,19,-1
9,23,204,24,20,4
9,23,205,23,12,11
9,23,206,26,21,5
9,23,207,24,16,8
9,23,208,31,10,21
9,23,209,22,11,11
9,23,210,12,12,0
9,23,211,14,10,4
9,23,212,23,9,14
9,23,213,29,11,18
9,23,214,24,18,6
9,23,215,24,23,1
9,23,216,16,16,0
9,23,217,22,7,15
9,23,218,17,10,7
9,23,219,14,11,3
9,23,220,15,12,3
9,23,221,23,13,10
9,23,222,30,15,15
9,23,223,15,12,3
9,23,224,28,15,13
9,23,225,18,13,5
9,23,226,16,12,4
9,23,227,19,10,9
9,23,228,11,17,-6
9,23,229,25,18,7
9,23,230,18,27,-9
9,23,231,15,7,8
9,23,232,12,7,5
9,23,233,13,9,4
9,23,234,26,18,8
9,23,235,35,20,15
9,23,236,22,7,15
9,23,237,10,9,1
9,23,238,22,27,-5
9,23,239,16,11,5
9,23,240,16,15,1
9,23,241,16,14,2
9,23,242,16,11,5
9,23,243,24,8,16
9,23,244,15,8,7
9,23,245,17,14,3
9,23,246,14,7,7
9,23,247,14,17,-3
9,23,248,12,12,0
9,23,249,14,9,5
9,23,250,17,19,-2
9,23,251,16,8,8
9,23,252,8,9,-1
9,23,253,8,5,3
9,23,254,19,18,1
9,23,255,15,9,6
9,23,256,34,18,16
9,23,257,7,11,-4
9,23,258,17,13,4
9,23,259,27,17,10
9,23,260,6,10,-4
9,23,261,20,7,13
9,23,262,6,7,-1
9,23,263,21,12,9
9,23,264,4,11,-7
9,23,265,16,14,2
9,23,266,26,16,10
9,23,267,8,9,-1
9,23,268,16,8,8
9,23,269,22,16,6
9,23,270,19,18,1
9,23,271,16,24,-8
9,23,272,6,10,-4
9,23,273,21,16,5
9,23,274,12,16,-4
9,23,275,13,9,4
9,23,276,18,10,8
9,23,277,12,14,-2
9,23,278,21,19,2
9,23,279,17,10,7
9,23,280,10,9,1
9,23,281,11,2,9
9,23,282,17,19,-2
9,23,283,10,8,2
9,23,284,9,17,-8
9,23,285,18,8,10
9,23,286,13,16,-3
9,23,287,32,10,22
9,23,288,21,16,5
9,23,289,14,11,3
9,23,290,21,7,14
9,23,291,13,6,7
9,23,292,11,8,3
9,23,293,19,14,5
9,23,294,25,6,19
9,23,295,17,13,4
9,23,296,15,9,6
9,23,297,24,12,12
9,23,298,14,8,6
9,23,299,29,16,13
9,24,0,16,10,6
9,24,1,22,17,5
9,24,2,12,6,6
9,24,3,19,4,15
9,24,4,18,9,9
9,24,5,22,4,18
9,24,6,11,7,4
9,24,7,17,9,8
9,24,8,11,10,1
9,24,9,20,24,-4
9,24,10,19,3,16
9,24,11,19,9,10
9,24,12,34,18,16
9,24,13,11,5,6
9,24,14,16,11,5
9,24,15,17,11,6
9,24,16,5,4,1
9,24,17,18,7,11
9,24,18,21,19,2
9,24,19,13,14,-1
9,24,20,7,9,-2
9,24,21,21,20,1
9,24,22,23,6,17
9,24,23,13,17,-4
9,24,24,24,14,10
9,24,25,21,18,3
9,24,26,15,7,8
9,24,27,13,10,3
9,24,28,9,12,-3
9,24,29,21,8,13
9,24,30,23,7,16
9,24,31,20,8,12
9,24,32,12,7,5
9,24,33,22,11,11
9,24,34,17,9,8
9,24,35,12,17,-5
9,24,36,15,15,0
9,24,37,13,4,9
9,24,38,26,10,16
9,24,39,21,13,8
9,24,40,11,9,2
9,24,41,15,13,2
9,24,42,19,11,8
9,24,43,15,11,4
9,24,44,12,9,3
9,24,45,15,12,3
9,24,46,29,6,23
9,24,47,18,9,9
9,24,48,28,16,12
9,24,49,33,13,20
9,24,50,13,8,5
9,24,51,20,11,9
9,24,52,3,4,-1
9,24,53,15,12,3
9,24,54,14,13,1
9,24,55,28,18,10
9,24,56,16,8,8
9,24,57,10,7,3
9,24,58,27,12,15
9,24,59,13,9,4
9,24,60,19,15,4
9,24,61,20,14,6
9,24,62,14,11,3
9,24,63,18,15,3
9,24,64,14,15,-1
9,24,65,22,14,8
9,24,66,28,16,12
9,24,67,18,9,9
9,24,68,14,19,-5
9,24,69,29,15,14
9,24,70,3,8,-5
9,24,71,22,14,8
9,24,72,15,12,3
9,24,73,9,8,1
9,24,74,12,5,7
9,24,75,13,17,-4
9,24,76,26,4,22
9,24,77,10,3,7
9,24,78,27,12,15
9,24,79,7,3,4
9,24,80,22,8,14
9,24,81,10,13,-3
9,24,82,17,17,0
9,24,83,21,20,1
9,24,84,17,12,5
9,24,85,11,11,0
9,24,86,15,14,1
9,24,87,13,10,3
9,24,88,24,15,9
9,24,89,20,16,4
9,24,90,19,9,10
9,24,91,35,22,13
9,24,92,15,16,-1
9,24,93,13,13,0
9,24,94,11,9,2
9,24,95,19,34,-15
9,24,96,19,11,8
9,24,97,22,23,-1
9,24,98,30,14,16
9,24,99,21,18,3
9,24,100,27,8,19
9,24,101,12,13,-1
9,24,102,15,5,10
9,24,103,14,18,-4
9,24,104,24,15,9
9,24,105,26,3,23
9,24,106,25,9,16
9,24,107,16,8,8
9,24,108,23,14,9
9,24,109,19,20,-1
9,24,110,15,17,-2
9,24,111,18,11,7
9,24,112,25,11,14
9,24,113,22,18,4
9,24,114,16,9,7
9,24,115,15,8,7
9,24,116,14,6,8
9,24,117,13,8,5
9,24,118,17,14,3
9,24,119,14,5,9
9,24,120,13,8,5
9,24,121,15,9,6
9,24,122,17,12,5
9,24,123,24,11,13
9,24,124,16,11,5
9,24,125,19,7,12
9,24,126,8,7,1
9,24,127,14,12,2
9,24,128,12,9,3
9,24,129,29,14,15
9,24,130,18,5,13
9,24,131,9,7,2
9,24,132,20,20,0
9,24,133,19,20,-1
9,24,134,26,8,18
9,24,135,20,3,17
9,24,136,14,15,-1
9,24,137,29,14,15
9,24,138,24,15,9
9,24,139,31,9,22
9,24,140,16,6,10
9,24,141,7,5,2
9,24,142,14,14,0
9,24,143,21,17,4
9,24,144,31,12,19
9,24,145,11,6,5
9,24,146,11,13,-2
9,24,147,24,18,6
9,24,148,16,4,12
9,24,149,34,15,19
9,24,150,17,21,-4
9,24,151,28,13,15
9,24,152,16,9,7
9,24,153,31,11,20
9,24,154,25,10,15
9,24,155,25,18,7
9,24,156,34,25,9
9,24,157,21,27,-6
9,24,158,21,11,10
9,24,159,23,19,4
9,24,160,17,11,6
9,24,161,12,12,0
9,24,162,19,15,4
9,24,163,33,23,10
9,24,164,22,15,7
9,24,165,18,9,9
9,24,166,27,16,11
9,24,167,22,13,9
9,24,168,20,27,-7
9,24,169,13,6,7
9,24,170,17,13,4
9,24,171,16,11,5
9,24,172,11,8,3
9,24,173,19,17,2
9,24,174,20,7,13
9,24,175,23,10,13
9,24,176,35,17,18
9,24,177,17,10,7
9,24,178,18,16,2
9,24,179,9,13,-4
9,24,180,13,21,-8
9,24,181,32,15,17
9,24,182,16,17,-1
9,24,183,16,6,10
9,24,184,13,9,4
9,24,185,20,13,7
9,24,186,17,7,10
9,24,187,20,17,3
9,24,188,21,13,8
9,24,189,32,9,23
9,24,190,16,13,3
9,24,191,24,20,4
9,24,192,18,17,1
9,24,193,23,14,9
9,24,194,8,2,6
9,24,195,17,17,0
9,24,196,9,7,2
9,24,197,25,20,5
9,24,198,20,9,11
9,24,199,17,14,3
9,24,200,22,5,17
9,24,201,9,12,-3
9,24,202,13,8,5
9,24,203,7,11,-4
9,24,204,24,18,6
9,24,205,18,12,6
9,24,206,21,24,-3
9,24,207,19,9,10
9,24,208,38,37,1
9,24,209,7,10,-3
9,24,210,35,26,9
9,24,211,22,16,6
9,24,212,13,17,-4
9,24,213,16,11,5
9,24,214,16,12,4
9,24,215,20,9,11
9,24,216,14,12,2
9,24,217,16,9,7
9,24,218,16,18,-2
9,24,219,13,14,-1
9,24,220,11,9,2
9,24,221,10,11,-1
9,24,222,19,15,4
9,24,223,17,16,1
9,24,224,18,11,7
9,24,225,13,10,3
9,24,226,18,14,4
9,24,227,6,10,-4
9,24,228,25,27,-2
9,24,229,21,13,8
9,24,230,19,13,6
9,24,231,17,9,8
9,24,232,30,22,8
9,24,233,10,14,-4
9,24,234,26,19,7
9,24,235,11,4,7
9,24,236,13,5,8
9,24,237,27,14,13
9,24,238,19,6,13
9,24,239,27,17,10
9,24,240,31,19,12
9,24,241,15,10,5
9,24,242,16,14,2
9,24,243,22,22,0
9,24,244,25,14,11
9,24,245,17,16,1
9,24,246,17,14,3
9,24,247,27,4,23
9,24,248,22,5,17
9,24,249,17,22,-5
9,24,250,24,9,15
9,24,251,3,7,-4
9,24,252,14,14,0
9,24,253,11,11,0
9,24,254,11,3,8
9,24,255,18,16,2
9,24,256,14,5,9
9,24,257,12,7,5
9,24,258,38,20,18
9,24,259,22,13,9
9,24,260,29,19,10
9,24,261,17,19,-2
9,24,262,22,10,12
9,24,263,14,17,-3
9,24,264,18,8,10
9,24,265,22,16,6
9,24,266,27,18,9
9,24,267,11,8,3
9,24,268,18,14,4
9,24,269,16,16,0
9,24,270,17,6,11
9,24,271,15,10,5
9,24,272,23,11,12
9,24,273,18,9,9
9,24,274,11,7,4
9,24,275,34,19,15
9,24,276,7,5,2
9,24,277,24,8,16
9,24,278,12,5,7
9,24,279,16,13,3
9,24,280,17,11,6
9,24,281,19,11,8
9,24,282,16,10,6
9,24,283,20,7,13
9,24,284,17,21,-4
9,24,285,16,7,9
9,24,286,15,18,-3
9,24,287,12,11,1
9,24,288,17,11,6
9,24,289,13,11,2
9,24,290,22,13,9
9,24,291,18,17,1
9,24,292,20,15,5
9,24,293,20,12,8
9,24,294,27,12,15
9,24,295,19,12,7
9,24,296,18,18,0
9,24,297,7,13,-6
9,24,298,16,15,1
9,24,299,18,6,12
9,25,0,18,5,13
9,25,1,15,8,7
9,25,2,18,8,10
9,25,3,13,5,8
9,25,4,16,14,2
9,25,5,39,8,31
9,25,6,19,20,-1
9,25,7,9,11,-2
9,25,8,14,12,2
9,25,9,20,12,8
9,25,10,7,7,0
9,25,11,20,14,6
9,25,12,26,16,10
9,25,13,10,2,8
9,25,14,14,3,11
9,25,15,20,7,13
9,25,16,29,13,16
9,25,17,19,8,11
9,25,18,8,8,0
9,25,19,12,13,-1
9,25,20,15,11,4
9,25,21,21,19,2
9,25,22,23,9,14
9,25,23,12,8,4
9,25,24,9,12,-3
9,25,25,25,18,7
9,25,26,23,11,12
9,25,27,11,6,5
9,25,28,11,4,7
9,25,29,10,14,-4
9,25,30,20,15,5
9,25,31,7,8,-1
9,25,32,16,9,7
9,25,33,27,6,21
9,25,34,17,18,-1
9,25,35,14,2,12
9,25,36,16,19,-3
9,25,37,22,14,8
9,25,38,11,16,-5
9,25,39,20,8,12
9,25,40,14,6,8
9,25,41,25,12,13
9,25,42,16,7,9
9,25,43,19,7,12
9,25,44,18,7,11
9,25,45,9,15,-6
9,25,46,24,5,19
9,25,47,22,23,-1
9,25,48,17,10,7
9,25,49,27,27,0
9,25,50,12,2,10
9,25,51,30,20,10
9,25,52,20,8,12
9,25,53,20,17,3
9,25,54,11,18,-7
9,25,55,21,7,14
9,25,56,22,21,1
9,25,57,25,17,8
9,25,58,17,15,2
9,25,59,27,22,5
9,25,60,16,14,2
9,25,61,17,10,7
9,25,62,15,12,3
9,25,63,12,11,1
9,25,64,26,11,15
9,25,65,17,16,1
9,25,66,21,8,13
9,25,67,25,13,12
9,25,68,15,9,6
9,25,69,40,17,23
9,25,70,11,9,2
9,25,71,19,21,-2
9,25,72,6,4,2
9,25,73,28,15,13
9,25,74,4,3,1
9,25,75,15,9,6
9,25,76,12,11,1
9,25,77,14,9,5
9,25,78,14,12,2
9,25,79,19,10,9
9,25,80,19,9,10
9,25,81,11,0,11
9,25,82,28,12,16
9,25,83,17,13,4
9,25,84,23,16,7
9,25,85,22,14,8
9,25,86,24,6,18
9,25,87,21,12,9
9,25,88,34,10,24
9,25,89,12,5,7
9,25,90,11,8,3
9,25,91,16,5,11
9,25,92,20,14,6
9,25,93,13,14,-1
9,25,94,15,21,-6
9,25,95,33,26,7
9,25,96,13,12,1
9,25,97,22,11,11
9,25,98,19,5,14
9,25,99,15,7,8
9,25,100,14,18,-4
9,25,101,8,13,-5
9,25,102,19,14,5
9,25,103,28,22,6
9,25,104,30,11,19
9,25,105,11,12,-1
9,25,106,19,16,3
9,25,107,33,12,21
9,25,108,11,8,3
9,25,109,18,8,10
9,25,110,25,7,18
9,25,111,15,21,-6
9,25,112,12,18,-6
9,25,113,23,10,13
9,25,114,18,18,0
9,25,115,25,19,6
9,25,116,22,13,9
9,25,117,19,16,3
9,25,118,18,6,12
9,25,119,27,9,18
9,25,120,19,11,8
9,25,121,11,8,3
9,25,122,13,9,4
9,25,123,18,8,10
9,25,124,20,19,1
9,25,125,10,25,-15
9,25,126,19,8,11
9,25,127,1,3,-2
9,25,128,17,11,6
9,25,129,24,18,6
9,25,130,16,23,-7
9,25,131,13,4,9
9,25,132,13,9,4
9,25,133,16,15,1
9,25,134,26,6,20
9,25,135,12,10,2
9,25,136,7,5,2
9,25,137,10,10,0
9,25,138,18,16,2
9,25,139,13,15,-2
9,25,140,18,7,11
9,25,141,27,17,10
9,25,142,14,11,3
9,25,143,19,13,6
9,25,144,12,12,0
9,25,145,35,8,27
9,25,146,17,14,3
9,25,147,15,6,9
9,25,148,23,21,2
9,25,149,7,8,-1
9,25,150,7,8,-1
9,25,151,19,21,-2
9,25,152,10,10,0
9,25,153,23,15,8
9,25,154,20,5,15
9,25,155,20,13,7
9,25,156,12,9,3
9,25,157,18,8,10
9,25,158,15,12,3
9,25,159,29,20,9
9,25,160,18,11,7
9,25,161,28,12,16
9,25,162,20,9,11
9,25,163,29,16,13
9,25,164,13,12,1
9,25,165,32,17,15
9,25,166,8,8,0
9,25,167,12,5,7
9,25,168,16,13,3
9,25,169,8,11,-3
9,25,170,22,18,4
9,25,171,12,8,4
9,25,172,21,18,3
9,25,173,24,22,2
9,25,174,17,15,2
9,25,175,19,13,6
9,25,176,29,18,11
9,25,177,20,11,9
9,25,178,11,14,-3
9,25,179,16,14,2
9,25,180,8,8,0
9,25,181,24,6,18
9,25,182,22,14,8
9,25,183,15,7,8
9,25,184,20,7,13
9,25,185,12,8,4
9,25,186,22,16,6
9,25,187,18,5,13
9,25,188,34,15,19
9,25,189,10,18,-8
9,25,190,25,5,20
9,25,191,20,8,12
9,25,192,13,15,-2
9,25,193,9,3,6
9,25,194,29,17,12
9,25,195,25,21,4
9,25,196,20,16,4
9,25,197,25,14,11
9,25,198,25,18,7
9,25,199,18,8,10
9,25,200,12,6,6
9,25,201,23,8,15
9,25,202,12,4,8
9,25,203,7,6,1
9,25,204,14,17,-3
9,25,205,25,3,22
9,25,206,5,8,-3
9,25,207,19,10,9
9,25,208,15,11,4
9,25,209,21,14,7
9,25,210,18,17,1
9,25,211,34,15,19
9,25,212,26,5,21
9,25,213,30,12,18
9,25,214,21,12,9
9,25,215,15,9,6
9,25,216,9,11,-2
9,25,217,6,5,1
9,25,218,23,11,12
9,25,219,28,18,10
9,25,220,5,5,0
9,25,221,33,19,14
9,25,222,15,13,2
9,25,223,19,6,13
9,25,224,28,11,17
9,25,225,36,12,24
9,25,226,11,8,3
9,25,227,47,13,34
9,25,228,11,19,-8
9,25,229,23,10,13
9,25,230,16,6,10
9,25,231,29,6,23
9,25,232,20,8,12
9,25,233,15,13,2
9,25,234,20,4,16
9,25,235,17,3,14
9,25,236,38,16,22
9,25,237,18,11,7
9,25,238,17,9,8
9,25,239,19,10,9
9,25,240,27,14,13
9,25,241,20,12,8
9,25,242,33,21,12
9,25,243,22,8,14
9,25,244,16,13,3
9,25,245,19,16,3
9,25,246,14,11,3
9,25,247,11,5,6
9,25,248,7,8,-1
9,25,249,17,12,5
9,25,250,21,13,8
9,25,251,16,9,7
9,25,252,11,5,6
9,25,253,17,12,5
9,25,254,18,22,-4
9,25,255,34,17,17
9,25,256,23,9,14
9,25,257,24,9,15
9,25,258,25,21,4
9,25,259,20,20,0
9,25,260,26,12,14
9,25,261,16,19,-3
9,25,262,10,16,-6
9,25,263,24,10,14
9,25,264,13,18,-5
9,25,265,13,10,3
9,25,266,20,13,7
9,25,267,21,14,7
9,25,268,13,6,7
9,25,269,15,6,9
9,25,270,17,16,1
9,25,271,18,19,-1
9,25,272,17,12,5
9,25,273,35,19,16
9,25,274,23,18,5
9,25,275,41,27,14
9,25,276,35,3,32
9,25,277,17,11,6
9,25,278,17,13,4
9,25,279,27,25,2
9,25,280,18,18,0
9,25,281,21,3,18
9,25,282,24,9,15
9,25,283,29,21,8
9,25,284,12,9,3
9,25,285,18,13,5
9,25,286,13,7,6
9,25,287,13,5,8
9,25,288,23,11,12
9,25,289,17,16,1
9,25,290,26,16,10
9,25,291,16,16,0
9,25,292,16,15,1
9,25,293,8,12,-4
9,25,294,10,3,7
9,25,295,23,16,7
9,25,296,26,14,12
9,25,297,19,11,8
9,25,298,24,12,12
9,25,299,31,14,17
9,26,0,17,5,12
9,26,1,8,8,0
9,26,2,25,11,14
9,26,3,11,8,3
9,26,4,20,12,8
9,26,5,18,15,3
9,26,6,14,6,8
9,26,7,34,12,22
9,26,8,11,18,-7
9,26,9,17,14,3
9,26,10,12,11,1
9,26,11,18,8,10
9,26,12,7,12,-5
9,26,13,18,8,10
9,26,14,17,4,13
9,26,15,15,17,-2
9,26,16,21,6,15
9,26,17,23,8,15
9,26,18,14,13,1
9,26,19,8,8,0
9,26,20,7,5,2
9,26,21,21,11,10
9,26,22,34,22,12
9,26,23,15,7,8
9,26,24,19,8,11
9,26,25,20,9,11
9,26,26,23,10,13
9,26,27,26,10,16
9,26,28,16,7,9
9,26,29,23,15,8
9,26,30,26,6,20
9,26,31,10,15,-5
9,26,32,16,15,1
9,26,33,26,13,13
9,26,34,22,4,18
9,26,35,18,23,-5
9,26,36,19,16,3
9,26,37,46,6,40
9,26,38,23,16,7
9,26,39,9,13,-4
9,26,40,12,8,4
9,26,41,13,7,6
9,26,42,19,7,12
9,26,43,28,16,12
9,26,44,38,24,14
9,26,45,19,9,10
9,26,46,18,5,13
9,26,47,9,16,-7
9,26,48,18,7,11
9,26,49,10,9,1
9,26,50,17,10,7
9,26,51,32,7,25
9,26,52,16,8,8
9,26,53,16,15,1
9,26,54,14,14,0
9,26,55,7,1,6
9,26,56,10,7,3
9,26,57,23,10,13
9,26,58,8,10,-2
9,26,59,15,5,10
9,26,60,12,9,3
9,26,61,15,15,0
9,26,62,15,9,6
9,26,63,20,10,10
9,26,64,19,2,17
9,26,65,14,7,7
9,26,66,13,16,-3
9,26,67,9,12,-3
9,26,68,18,5,13
9,26,69,11,7,4
9,26,70,18,11,7
9,26,71,4,8,-4
9,26,72,27,16,11
9,26,73,8,6,2
9,26,74,14,5,9
9,26,75,15,8,7
9,26,76,12,7,5
9,26,77,16,11,5
9,26,78,14,8,6
9,26,79,24,11,13
9,26,80,7,12,-5
9,26,81,13,17,-4
9,26,82,15,8,7
9,26,83,28,9,19
9,26,84,31,13,18
9,26,85,17,16,1
9,26,86,23,19,4
9,26,87,26,15,11
9,26,88,11,13,-2
9,26,89,26,6,20
9,26,90,26,15,11
9,26,91,21,10,11
9,26,92,16,24,-8
9,26,93,14,14,0
9,26,94,20,17,3
9,26,95,26,4,22
9,26,96,12,19,-7
9,26,97,32,15,17
9,26,98,20,9,11
9,26,99,16,8,8
9,26,100,25,15,10
9,26,101,22,14,8
9,26,102,10,12,-2
9,26,103,8,15,-7
9,26,104,21,15,6
9,26,105,21,9,12
9,26,106,10,8,2
9,26,107,12,8,4
9,26,108,17,14,3
9,26,109,16,11,5
9,26,110,29,10,19
9,26,111,23,15,8
9,26,112,17,13,4
9,26,113,13,9,4
9,26,114,27,25,2
9,26,115,15,15,0
9,26,116,14,9,5
9,26,117,31,19,12
9,26,118,13,16,-3
9,26,119,21,8,13
9,26,120,12,12,0
9,26,121,13,12,1
9,26,122,29,20,9
9,26,123,21,6,15
9,26,124,23,10,13
9,26,125,26,14,12
9,26,126,15,14,1
9,26,127,19,14,5
9,26,128,15,18,-3
9,26,129,24,12,12
9,26,130,15,15,0
9,26,131,22,10,12
9,26,132,16,11,5
9,26,133,13,14,-1
9,26,134,25,10,15
9,26,135,20,5,15
9,26,136,10,11,-1
9,26,137,33,7,26
9,26,138,18,11,7
9,26,139,12,14,-2
9,26,140,18,10,8
9,26,141,13,19,-6
9,26,142,12,16,-4
9,26,143,6,1,5
9,26,144,13,2,11
9,26,145,25,24,1
9,26,146,27,10,17
9,26,147,14,15,-1
9,26,148,20,16,4
9,26,149,13,4,9
9,26,150,27,14,13
9,26,151,17,12,5
9,26,152,7,7,0
9,26,153,24,19,5
9,26,154,24,9,15
9,26,155,12,13,-1
9,26,156,17,18,-1
9,26,157,15,9,6
9,26,158,15,8,7
9,26,159,18,14,4
9,26,160,33,14,19
9,26,161,34,12,22
9,26,162,26,5,21
9,26,163,34,13,21
9,26,164,13,3,10
9,26,165,19,6,13
9,26,166,23,15,8
9,26,167,21,10,11
9,26,168,22,19,3
9,26,169,20,13,7
9,26,170,20,11,9
9,26,171,10,12,-2
9,26,172,9,9,0
9,26,173,45,11,34
9,26,174,30,6,24
9,26,175,22,5,17
9,26,176,18,14,4
9,26,177,10,11,-1
9,26,178,18,8,10
9,26,179,16,8,8
9,26,180,10,4,6
9,26,181,9,3,6
9,26,182,20,15,5
9,26,183,28,10,18
9,26,184,22,8,14
9,26,185,16,6,10
9,26,186,19,12,7
9,26,187,13,5,8
9,26,188,23,17,6
9,26,189,5,7,-2
9,26,190,26,11,15
9,26,191,25,14,11
9,26,192,8,3,5
9,26,193,22,11,11
9,26,194,17,14,3
9,26,195,27,7,20
9,26,196,26,19,7
9,26,197,12,9,3
9,26,198,14,14,0
9,26,199,18,15,3
9,26,200,25,16,9
9,26,201,13,9,4
9,26,202,12,16,-4
9,26,203,12,13,-1
9,26,204,8,6,2
9,26,205,14,15,-1
9,26,206,29,14,15
9,26,207,17,11,6
9,26,208,4,11,-7
9,26,209,31,11,20
9,26,210,11,11,0
9,26,211,19,10,9
9,26,212,25,16,9
9,26,213,39,11,28
9,26,214,13,11,2
9,26,215,24,5,19
9,26,216,27,20,7
9,26,217,17,26,-9
9,26,218,16,8,8
9,26,219,12,10,2
9,26,220,16,6,10
9,26,221,17,6,11
9,26,222,21,16,5
9,26,223,22,24,-2
9,26,224,30,6,24
9,26,225,21,12,9
9,26,226,18,12,6
9,26,227,32,17,15
9,26,228,21,4,17
9,26,229,6,12,-6
9,26,230,24,27,-3
9,26,231,14,10,4
9,26,232,22,11,11
9,26,233,4,1,3
9,26,234,17,15,2
9,26,235,24,16,8
9,26,236,29,18,11
9,26,237,13,10,3
9,26,238,16,11,5
9,26,239,15,10,5
9,26,240,9,9,0
9,26,241,28,17,11
9,26,242,31,6,25
9,26,243,23,18,5
9,26,244,10,3,7
9,26,245,29,12,17
9,26,246,28,11,17
9,26,247,8,14,-6
9,26,248,19,12,7
9,26,249,27,15,12
9,26,250,17,7,10
9,26,251,19,17,2
9,26,252,30,24,6
9,26,253,17,8,9
9,26,254,14,8,6
9,26,255,17,13,4
9,26,256,27,7,20
9,26,257,21,6,15
9,26,258,9,15,-6
9,26,259,31,10,21
9,26,260,10,4,6
9,26,261,21,15,6
9,26,262,25,4,21
9,26,263,15,3,12
9,26,264,6,14,-8
9,26,265,11,5,6
9,26,266,21,15,6
9,26,267,14,18,-4
9,26,268,32,12,20
9,26,269,12,19,-7
9,26,270,11,5,6
9,26,271,14,19,-5
9,26,272,28,19,9
9,26,273,23,23,0
9,26,274,7,6,1
9,26,275,13,13,0
9,26,276,23,6,17
9,26,277,26,18,8
9,26,278,21,12,9
9,26,279,21,22,-1
9,26,280,12,5,7
9,26,281,25,8,17
9,26,282,20,9,11
9,26,283,38,19,19
9,26,284,6,13,-7
9,26,285,35,19,16
9,26,286,26,1,25
9,26,287,35,18,17
9,26,288,22,15,7
9,26,289,19,10,9
9,26,290,22,16,6
9,26,291,13,5,8
9,26,292,26,6,20
9,26,293,14,6,8
9,26,294,29,10,19
9,26,295,17,9,8
9,26,296,12,14,-2
9,26,297,22,18,4
9,26,298,38,10,28
9,26,299,26,13,13
9,27,0,19,11,8
9,27,1,22,13,9
9,27,2,17,13,4
9,27,3,10,11,-1
9,27,4,12,15,-3
9,27,5,27,14,13
9,27,6,19,10,9
9,27,7,21,8,13
9,27,8,25,10,15
9,27,9,23,6,17
9,27,10,16,11,5
9,27,11,13,15,-2
9,27,12,10,3,7
9,27,13,13,6,7
9,27,14,12,4,8
9,27,15,15,20,-5
9,27,16,20,16,4
9,27,17,25,10,15
9,27,18,23,17,6
9,27,19,21,10,11
9,27,20,17,8,9
9,27,21,17,3,14
9,27,22,9,6,3
9,27,23,31,12,19
9,27,24,20,8,12
9,27,25,37,18,19
9,27,26,39,16,23
9,27,27,17,4,13
9,27,28,23,11,12
9,27,29,12,14,-2
9,27,30,19,10,9
9,27,31,11,13,-2
9,27,32,24,20,4
9,27,33,18,11,7
9,27,34,17,13,4
9,27,35,16,12,4
9,27,36,15,11,4
9,27,37,24,17,7
9,27,38,39,10,29
9,27,39,8,4,4
9,27,40,18,9,9
9,27,41,7,7,0
9,27,42,17,12,5
9,27,43,8,6,2
9,27,44,22,19,3
9,27,45,30,7,23
9,27,46,13,15,-2
9,27,47,11,5,6
9,27,48,22,4,18
9,27,49,18,13,5
9,27,50,19,12,7
9,27,51,18,2,16
9,27,52,14,12,2
9,27,53,19,15,4
9,27,54,37,11,26
9,27,55,16,8,8
9,27,56,9,16,-7
9,27,57,14,4,10
9,27,58,4,11,-7
9,27,59,16,10,6
9,27,60,9,8,1
9,27,61,18,9,9
9,27,62,21,7,14
9,27,63,13,3,10
9,27,64,8,17,-9
9,27,65,24,22,2
9,27,66,16,6,10
9,27,67,20,15,5
9,27,68,26,26,0
9,27,69,18,14,4
9,27,70,20,15,5
9,27,71,18,7,11
9,27,72,22,8,14
9,27,73,8,9,-1
9,27,74,10,9,1
9,27,75,25,12,13
9,27,76,9,6,3
9,27,77,9,12,-3
9,27,78,21,5,16
9,27,79,11,11,0
9,27,80,21,11,10
9,27,81,15,14,1
9,27,82,15,7,8
9,27,83,16,20,-4
9,27,84,14,12,2
9,27,85,30,11,19
9,27,86,9,7,2
9,27,87,21,22,-1
9,27,88,19,17,2
9,27,89,10,12,-2
9,27,90,14,13,1
9,27,91,17,18,-1
9,27,92,26,17,9
9,27,93,20,8,12
9,27,94,16,17,-1
9,27,95,13,6,7
9,27,96,11,2,9
9,27,97,14,9,5
9,27,98,27,15,12
9,27,99,12,8,4
9,27,100,9,9,0
9,27,101,19,14,5
9,27,102,14,14,0
9,27,103,11,13,-2
9,27,104,16,23,-7
9,27,105,13,9,4
9,27,106,15,2,13
9,27,107,22,7,15
9,27,108,22,12,10
9,27,109,16,18,-2
9,27,110,6,7,-1
9,27,111,24,8,16
9,27,112,25,10,15
9,27,113,15,14,1
9,27,114,10,12,-2
9,27,115,20,8,12
9,27,116,22,11,11
9,27,117,26,12,14
9,27,118,11,9,2
9,27,119,15,10,5
9,27,120,16,19,-3
9,27,121,19,9,10
9,27,122,16,15,1
9,27,123,19,8,11
9,27,124,23,9,14
9,27,125,14,9,5
9,27,126,16,7,9
9,27,127,22,1,21
9,27,128,33,9,24
9,27,129,13,9,4
9,27,130,15,17,-2
9,27,131,19,7,12
9,27,132,20,13,7
9,27,133,21,15,6
9,27,134,29,12,17
9,27,135,11,10,1
9,27,136,17,7,10
9,27,137,33,23,10
9,27,138,19,11,8
9,27,139,13,12,1
9,27,140,28,8,20
9,27,141,20,12,8
9,27,142,26,9,17
9,27,143,16,16,0
9,27,144,16,6,10
9,27,145,16,8,8
9,27,146,9,7,2
9,27,147,21,15,6
9,27,148,16,2,14
9,27,149,18,6,12
9,27,150,14,11,3
9,27,151,18,8,10
9,27,152,15,15,0
9,27,153,11,7,4
9,27,154,14,6,8
9,27,155,18,8,10
9,27,156,11,17,-6
9,27,157,19,14,5
9,27,158,21,10,11
9,27,159,18,10,8
9,27,160,30,7,23
9,27,161,16,23,-7
9,27,162,21,18,3
9,27,163,15,15,0
9,27,164,14,11,3
9,27,165,17,5,12
9,27,166,28,20,8
9,27,167,17,20,-3
9,27,168,14,12,2
9,27,169,22,10,12
9,27,170,22,25,-3
9,27,171,26,14,12
9,27,172,29,9,20
9,27,173,20,19,1
9,27,174,18,11,7
9,27,175,32,17,15
9,27,176,18,18,0
9,27,177,25,11,14
9,27,178,22,21,1
9,27,179,28,15,13
9,27,180,28,12,16
9,27,181,16,14,2
9,27,182,20,7,13
9,27,183,18,7,11
9,27,184,20,11,9
9,27,185,18,11,7
9,27,186,10,12,-2
9,27,187,23,6,17
9,27,188,16,16,0
9,27,189,17,23,-6
9,27,190,30,11,19
9,27,191,31,5,26
9,27,192,11,15,-4
9,27,193,12,18,-6
9,27,194,7,12,-5
9,27,195,25,11,14
9,27,196,22,12,10
9,27,197,30,17,13
9,27,198,39,6,33
9,27,199,25,10,15
9,27,200,9,11,-2
9,27,201,21,8,13
9,27,202,18,7,11
9,27,203,23,2,21
9,27,204,16,11,5
9,27,205,19,5,14
9,27,206,26,19,7
9,27,207,15,13,2
9,27,208,12,9,3
9,27,209,18,16,2
9,27,210,30,25,5
9,27,211,26,10,16
9,27,212,13,13,0
9,27,213,19,15,4
9,27,214,21,4,17
9,27,215,27,9,18
9,27,216,10,9,1
9,27,217,27,12,15
9,27,218,15,15,0
9,27,219,16,4,12
9,27,220,25,9,16
9,27,221,17,15,2
9,27,222,13,8,5
9,27,223,9,3,6
9,27,224,30,13,17
9,27,225,27,10,17
9,27,226,29,15,14
9,27,227,20,7,13
9,27,228,11,11,0
9,27,229,7,8,-1
9,27,230,30,15,15
9,27,231,15,15,0
9,27,232,15,10,5
9,27,233,28,19,9
9,27,234,26,21,5
9,27,235,14,14,0
9,27,236,12,9,3
9,27,237,16,17,-1
9,27,238,20,13,7
9,27,239,8,6,2
9,27,240,6,12,-6
9,27,241,24,12,12
9,27,242,24,11,13
9,27,243,14,14,0
9,27,244,18,5,13
9,27,245,13,19,-6
9,27,246,19,10,9
9,27,247,14,5,9
9,27,248,31,11,20
9,27,249,33,14,19
9,27,250,17,16,1
9,27,251,39,16,23
9,27,252,21,7,14
9,27,253,17,7,10
9,27,254,23,16,7
9,27,255,15,6,9
9,27,256,8,7,1
9,27,257,19,17,2
9,27,258,26,9,17
9,27,259,7,9,-2
9,27,260,11,12,-1
9,27,261,19,11,8
9,27,262,18,11,7
9,27,263,19,23,-4
9,27,264,23,19,4
9,27,265,17,9,8
9,27,266,22,25,-3
9,27,267,19,13,6
9,27,268,10,12,-2
9,27,269,21,7,14
9,27,270,24,10,14
9,27,271,29,13,16
9,27,272,11,8,3
9,27,273,16,16,0
9,27,274,12,8,4
9,27,275,19,20,-1
9,27,276,44,22,22
9,27,277,26,11,15
9,27,278,28,13,15
9,27,279,25,11,14
9,27,280,27,9,18
9,27,281,20,8,12
9,27,282,32,13,19
9,27,283,13,7,6
9,27,284,11,17,-6
9,27,285,21,10,11
9,27,286,11,10,1
9,27,287,32,22,10
9,27,288,24,11,13
9,27,289,13,11,2
9,27,290,13,17,-4
9,27,291,25,15,10
9,27,292,22,14,8
9,27,293,18,6,12
9,27,294,43,14,29
9,27,295,16,9,7
9,27,296,19,11,8
9,27,297,30,18,12
9,27,298,16,10,6
9,27,299,18,10,8
9,28,0,13,7,6
9,28,1,19,12,7
9,28,2,27,15,12
9,28,3,25,7,18
9,28,4,25,7,18
9,28,5,11,7,4
9,28,6,16,7,9
9,28,7,37,20,17
9,28,8,20,11,9
9,28,9,11,16,-5
9,28,10,14,16,-2
9,28,11,30,16,14
9,28,12,24,11,13
9,28,13,20,9,11
9,28,14,19,13,6
9,28,15,12,12,0
9,28,16,25,11,14
9,28,17,32,21,11
9,28,18,18,5,13
9,28,19,18,20,-2
9,28,20,20,19,1
9,28,21,19,9,10
9,28,22,22,10,12
9,28,23,11,10,1
9,28,24,8,11,-3
9,28,25,16,11,5
9,28,26,12,9,3
9,28,27,28,11,17
9,28,28,25,11,14
9,28,29,32,12,20
9,28,30,31,14,17
9,28,31,7,11,-4
9,28,32,22,17,5
9,28,33,24,14,10
9,28,34,17,19,-2
9,28,35,20,17,3
9,28,36,20,0,20
9,28,37,19,9,10
9,28,38,24,14,10
9,28,39,9,6,3
9,28,40,20,13,7
9,28,41,7,12,-5
9,28,42,25,9,16
9,28,43,14,6,8
9,28,44,26,13,13
9,28,45,17,8,9
9,28,46,25,6,19
9,28,47,7,3,4
9,28,48,14,17,-3
9,28,49,18,13,5
9,28,50,22,17,5
9,28,51,29,12,17
9,28,52,16,14,2
9,28,53,33,19,14
9,28,54,9,7,2
9,28,55,13,8,5
9,28,56,12,9,3
9,28,57,11,8,3
9,28,58,25,22,3
9,28,59,29,14,15
9,28,60,25,12,13
9,28,61,27,8,19
9,28,62,17,6,11
9,28,63,23,12,11
9,28,64,18,14,4
9,28,65,11,6,5
9,28,66,13,5,8
9,28,67,22,20,2
9,28,68,18,7,11
9,28,69,11,4,7
9,28,70,29,12,17
9,28,71,23,14,9
9,28,72,10,7,3
9,28,73,28,19,9
9,28,74,15,8,7
9,28,75,22,5,17
9,28,76,27,17,10
9,28,77,20,25,-5
9,28,78,13,2,11
9,28,79,23,12,11
9,28,80,14,9,5
9,28,81,28,12,16
9,28,82,20,17,3
9,28,83,12,7,5
9,28,84,19,8,11
9,28,85,17,8,9
9,28,86,34,14,20
9,28,87,19,7,12
9,28,88,13,17,-4
9,28,89,18,24,-6
9,28,90,25,22,3
9,28,91,26,9,17
9,28,92,27,12,15
9,28,93,29,16,13
9,28,94,14,9,5
9,28,95,23,9,14
9,28,96,22,15,7
9,28,97,22,5,17
9,28,98,16,10,6
9,28,99,28,17,11
9,28,100,16,9,7
9,28,101,18,5,13
9,28,102,20,7,13
9,28,103,14,8,6
9,28,104,26,13,13
9,28,105,11,10,1
9,28,106,18,9,9
9,28,107,16,15,1
9,28,108,27,19,8
9,28,109,14,8,6
9,28,110,14,17,-3
9,28,111,29,13,16
9,28,112,10,19,-9
9,28,113,22,12,10
9,28,114,17,9,8
9,28,115,21,10,11
9,28,116,15,2,13
9,28,117,14,4,10
9,28,118,19,8,11
9,28,119,18,10,8
9,28,120,21,4,17
9,28,121,24,16,8
9,28,122,22,15,7
9,28,123,22,7,15
9,28,124,37,12,25
9,28,125,13,20,-7
9,28,126,23,16,7
9,28,127,12,6,6
9,28,128,27,8,19
9,28,129,19,12,7
9,28,130,16,6,10
9,28,131,20,14,6
9,28,132,13,5,8
9,28,133,18,11,7
9,28,134,29,11,18
9,28,135,22,14,8
9,28,136,17,10,7
9,28,137,16,3,13
9,28,138,23,6,17
9,28,139,33,16,17
9,28,140,16,13,3
9,28,141,8,11,-3
9,28,142,9,9,0
9,28,143,24,13,11
9,28,144,14,4,10
9,28,145,13,12,1
9,28,146,20,7,13
9,28,147,30,24,6
9,28,148,45,20,25
9,28,149,32,15,17
9,28,150,9,9,0
9,28,151,29,10,19
9,28,152,22,4,18
9,28,153,10,4,6
9,28,154,11,9,2
9,28,155,36,9,27
9,28,156,16,11,5
9,28,157,13,14,-1
9,28,158,18,8,10
9,28,159,13,6,7
9,28,160,23,10,13
9,28,161,20,11,9
9,28,162,27,9,18
9,28,163,6,9,-3
9,28,164,22,11,11
9,28,165,18,15,3
9,28,166,16,14,2
9,28,167,17,4,13
9,28,168,25,7,18
9,28,169,18,8,10
9,28,170,22,12,10
9,28,171,12,8,4
9,28,172,8,9,-1
9,28,173,28,9,19
9,28,174,18,12,6
9,28,175,17,7,10
9,28,176,18,12,6
9,28,177,19,10,9
9,28,178,23,12,11
9,28,179,39,19,20
9,28,180,13,14,-1
9,28,181,21,7,14
9,28,182,28,11,17
9,28,183,12,10,2
9,28,184,21,3,18
9,28,185,23,11,12
9,28,186,41,10,31
9,28,187,24,14,10
9,28,188,17,14,3
9,28,189,10,6,4
9,28,190,17,9,8
9,28,191,22,8,14
9,28,192,24,13,11
9,28,193,23,13,10
9,28,194,25,25,0
9,28,195,27,12,15
9,28,196,12,8,4
9,28,197,16,5,11
9,28,198,16,11,5
9,28,199,16,6,10
9,28,200,24,11,13
9,28,201,13,8,5
9,28,202,12,10,2
9,28,203,14,10,4
9,28,204,32,8,24
9,28,205,21,8,13
9,28,206,24,6,18
9,28,207,23,16,7
9,28,208,15,16,-1
9,28,209,15,12,3
9,28,210,16,11,5
9,28,211,17,11,6
9,28,212,19,9,10
9,28,213,27,12,15
9,28,214,21,6,15
9,28,215,33,16,17
9,28,216,12,7,5
9,28,217,25,12,13
9,28,218,14,6,8
9,28,219,48,12,36
9,28,220,9,11,-2
9,28,221,15,2,13
9,28,222,19,7,12
9,28,223,26,11,15
9,28,224,7,3,4
9,28,225,22,8,14
9,28,226,14,11,3
9,28,227,23,9,14
9,28,228,27,13,14
9,28,229,17,15,2
9,28,230,23,10,13
9,28,231,20,21,-1
9,28,232,23,6,17
9,28,233,7,8,-1
9,28,234,10,6,4
9,28,235,21,11,10
9,28,236,21,5,16
9,28,237,21,15,6
9,28,238,10,13,-3
9,28,239,20,12,8
9,28,240,10,17,-7
9,28,241,18,16,2
9,28,242,10,2,8
9,28,243,15,11,4
9,28,244,25,10,15
9,28,245,29,13,16
9,28,246,17,15,2
9,28,247,17,8,9
9,28,248,16,9,7
9,28,249,11,7,4
9,28,250,23,22,1
9,28,251,12,11,1
9,28,252,23,13,10
9,28,253,24,13,11
9,28,254,27,24,3
9,28,255,25,14,11
9,28,256,14,7,7
9,28,257,6,12,-6
9,28,258,17,7,10
9,28,259,18,1,17
9,28,260,29,15,14
9,28,261,20,13,7
9,28,262,28,17,11
9,28,263,20,7,13
9,28,264,20,19,1
9,28,265,14,9,5
9,28,266,13,5,8
9,28,267,15,10,5
9,28,268,22,13,9
9,28,269,24,18,6
9,28,270,15,11,4
9,28,271,23,15,8
9,28,272,11,12,-1
9,28,273,12,6,6
9,28,274,30,11,19
9,28,275,13,1,12
9,28,276,16,10,6
9,28,277,13,4,9
9,28,278,11,4,7
9,28,279,20,24,-4
9,28,280,32,11,21
9,28,281,14,12,2
9,28,282,20,7,13
9,28,283,34,8,26
9,28,284,18,10,8
9,28,285,16,12,4
9,28,286,32,13,19
9,28,287,19,13,6
9,28,288,16,17,-1
9,28,289,23,14,9
9,28,290,23,6,17
9,28,291,13,18,-5
9,28,292,24,4,20
9,28,293,14,11,3
9,28,294,34,6,28
9,28,295,15,5,10
9,28,296,27,32,-5
9,28,297,15,11,4
9,28,298,23,10,13
9,28,299,10,8,2
9,29,0,10,8,2
9,29,1,21,14,7
9,29,2,30,11,19
9,29,3,30,17,13
9,29,4,26,15,11
9,29,5,11,1,10
9,29,6,17,15,2
9,29,7,19,10,9
9,29,8,14,7,7
9,29,9,8,7,1
9,29,10,18,15,3
9,29,11,15,5,10
9,29,12,27,10,17
9,29,13,16,23,-7
9,29,14,20,16,4
9,29,15,12,6,6
9,29,16,12,10,2
9,29,17,18,8,10
9,29,18,11,11,0
9,29,19,33,8,25
9,29,20,14,6,8
9,29,21,22,10,12
9,29,22,34,15,19
9,29,23,19,19,0
9,29,24,16,6,10
9,29,25,13,5,8
9,29,26,16,7,9
9,29,27,27,10,17
9,29,28,7,16,-9
9,29,29,18,2,16
9,29,30,27,16,11
9,29,31,21,9,12
9,29,32,9,6,3
9,29,33,28,8,20
9,29,34,18,9,9
9,29,35,16,11,5
9,29,36,24,10,14
9,29,37,14,13,1
9,29,38,25,23,2
9,29,39,22,17,5
9,29,40,25,23,2
9,29,41,13,12,1
9,29,42,14,8,6
9,29,43,21,16,5
9,29,44,3,3,0
9,29,45,23,12,11
9,29,46,19,9,10
9,29,47,10,10,0
9,29,48,23,12,11
9,29,49,18,5,13
9,29,50,22,15,7
9,29,51,20,7,13
9,29,52,19,14,5
9,29,53,25,8,17
9,29,54,25,12,13
9,29,55,23,5,18
9,29,56,15,8,7
9,29,57,28,12,16
9,29,58,22,10,12
9,29,59,26,11,15
9,29,60,21,7,14
9,29,61,19,15,4
9,29,62,21,14,7
9,29,63,26,24,2
9,29,64,20,16,4
9,29,65,18,9,9
9,29,66,18,9,9
9,29,67,17,4,13
9,29,68,30,14,16
9,29,69,10,13,-3
9,29,70,20,6,14
9,29,71,18,7,11
9,29,72,27,12,15
9,29,73,21,14,7
9,29,74,18,2,16
9,29,75,16,5,11
9,29,76,17,12,5
9,29,77,24,11,13
9,29,78,32,23,9
9,29,79,14,6,8
9,29,80,23,9,14
9,29,81,20,10,10
9,29,82,21,13,8
9,29,83,7,13,-6
9,29,84,29,11,18
9,29,85,20,5,15
9,29,86,15,16,-1
9,29,87,19,11,8
9,29,88,26,18,8
9,29,89,9,3,6
9,29,90,24,6,18
9,29,91,8,14,-6
9,29,92,35,7,28
9,29,93,12,11,1
9,29,94,11,12,-1
9,29,95,18,6,12
9,29,96,26,12,14
9,29,97,13,7,6
9,29,98,12,8,4
9,29,99,20,8,12
9,29,100,21,9,12
9,29,101,26,17,9
9,29,102,30,17,13
9,29,103,28,17,11
9,29,104,20,9,11
9,29,105,18,9,9
9,29,106,18,24,-6
9,29,107,18,20,-2
9,29,108,11,12,-1
9,29,109,16,8,8
9,29,110,22,10,12
9,29,111,18,10,8
9,29,112,9,12,-3
9,29,113,31,15,16
9,29,114,18,10,8
9,29,115,19,12,7
9,29,116,23,12,11
9,29,117,23,29,-6
9,29,118,13,8,5
9,29,119,18,11,7
9,29,120,8,14,-6
9,29,121,23,11,12
9,29,122,18,2,16
9,29,123,29,4,25
9,29,124,34,13,21
9,29,125,15,7,8
9,29,126,15,10,5
9,29,127,19,8,11
9,29,128,6,4,2
9,29,129,30,10,20
9,29,130,21,15,6
9,29,131,18,2,16
9,29,132,10,7,3
9,29,133,18,14,4
9,29,134,23,12,11
9,29,135,19,12,7
9,29,136,21,6,15
9,29,137,11,10,1
9,29,138,12,12,0
9,29,139,22,10,12
9,29,140,11,6,5
9,29,141,28,5,23
9,29,142,14,9,5
9,29,143,41,24,17
9,29,144,24,9,15
9,29,145,6,19,-13
9,29,146,17,9,8
9,29,147,20,9,11
9,29,148,18,9,9
9,29,149,26,11,15
9,29,150,20,7,13
9,29,151,13,18,-5
9,29,152,16,6,10
9,29,153,17,17,0
9,29,154,13,8,5
9,29,155,16,9,7
9,29,156,26,23,3
9,29,157,25,11,14
9,29,158,12,10,2
9,29,159,13,15,-2
9,29,160,21,8,13
9,29,161,10,11,-1
9,29,162,18,13,5
9,29,163,10,9,1
9,29,164,21,6,15
9,29,165,25,5,20
9,29,166,22,9,13
9,29,167,29,8,21
9,29,168,13,9,4
9,29,169,15,10,5
9,29,170,13,3,10
9,29,171,19,26,-7
9,29,172,22,9,13
9,29,173,34,15,19
9,29,174,23,9,14
9,29,175,33,15,18
9,29,176,16,12,4
9,29,177,24,13,11
9,29,178,10,7,3
9,29,179,15,10,5
9,29,180,9,12,-3
9,29,181,12,5,7
9,29,182,18,9,9
9,29,183,15,3,12
9,29,184,14,15,-1
9,29,185,15,5,10
9,29,186,14,5,9
9,29,187,7,9,-2
9,29,188,28,12,16
9,29,189,23,14,9
9,29,190,8,4,4
9,29,191,11,14,-3
9,29,192,27,9,18
9,29,193,31,7,24
9,29,194,21,13,8
9,29,195,19,25,-6
9,29,196,12,15,-3
9,29,197,23,9,14
9,29,198,13,8,5
9,29,199,24,8,16
9,29,200,18,19,-1
9,29,201,14,14,0
9,29,202,22,18,4
9,29,203,18,11,7
9,29,204,24,9,15
9,29,205,28,19,9
9,29,206,23,7,16
9,29,207,9,10,-1
9,29,208,35,17,18
9,29,209,24,12,12
9,29,210,13,10,3
9,29,211,15,11,4
9,29,212,17,9,8
9,29,213,16,13,3
9,29,214,31,10,21
9,29,215,20,17,3
9,29,216,17,9,8
9,29,217,9,7,2
9,29,218,18,15,3
9,29,219,31,4,27
9,29,220,15,12,3
9,29,221,13,9,4
9,29,222,30,12,18
9,29,223,25,27,-2
9,29,224,27,7,20
9,29,225,15,16,-1
9,29,226,26,12,14
9,29,227,33,20,13
9,29,228,19,11,8
9,29,229,19,7,12
9,29,230,15,8,7
9,29,231,19,14,5
9,29,232,26,11,15
9,29,233,28,9,19
9,29,234,16,13,3
9,29,235,19,8,11
9,29,236,31,10,21
9,29,237,23,16,7
9,29,238,6,9,-3
9,29,239,26,2,24
9,29,240,24,4,20
9,29,241,19,6,13
9,29,242,20,14,6
9,29,243,28,7,21
9,29,244,21,9,12
9,29,245,15,17,-2
9,29,246,9,14,-5
9,29,247,31,17,14
9,29,248,20,17,3
9,29,249,10,16,-6
9,29,250,17,10,7
9,29,251,22,11,11
9,29,252,8,8,0
9,29,253,11,3,8
9,29,254,13,10,3
9,29,255,17,10,7
9,29,256,14,13,1
9,29,257,14,7,7
9,29,258,14,5,9
9,29,259,17,6,11
9,29,260,21,13,8
9,29,261,22,17,5
9,29,262,21,11,10
9,29,263,21,9,12
9,29,264,24,8,16
9,29,265,10,12,-2
9,29,266,23,9,14
9,29,267,24,9,15
9,29,268,22,11,11
9,29,269,20,25,-5
9,29,270,21,9,12
9,29,271,25,8,17
9,29,272,29,11,18
9,29,273,16,12,4
9,29,274,26,7,19
9,29,275,22,5,17
9,29,276,20,7,13
9,29,277,21,17,4
9,29,278,41,9,32
9,29,279,10,2,8
9,29,280,19,16,3
9,29,281,32,9,23
9,29,282,22,14,8
9,29,283,11,9,2
9,29,284,16,11,5
9,29,285,18,16,2
9,29,286,16,2,14
9,29,287,31,8,23
9,29,288,40,31,9
9,29,289,9,9,0
9,29,290,12,7,5
9,29,291,33,17,16
9,29,292,23,3,20
9,29,293,11,10,1
9,29,294,26,10,16
9,29,295,13,8,5
9,29,296,14,14,0
9,29,297,23,10,13
9,29,298,20,22,-2
9,29,299,27,12,15
9,30,0,6,3,3
9,30,1,16,8,8
9,30,2,17,10,7
9,30,3,16,11,5
9,30,4,16,9,7
9,30,5,25,11,14
9,30,6,17,11,6
9,30,7,34,11,23
9,30,8,22,7,15
9,30,9,16,9,7
9,30,10,16,11,5
9,30,11,30,13,17
9,30,12,18,11,7
9,30,13,29,6,23
9,30,14,11,8,3
9,30,15,23,21,2
9,30,16,22,20,2
9,30,17,17,6,11
9,30,18,13,11,2
9,30,19,9,6,3
9,30,20,14,11,3
9,30,21,18,10,8
9,30,22,21,11,10
9,30,23,19,17,2
9,30,24,18,8,10
9,30,25,19,15,4
9,30,26,14,13,1
9,30,27,16,14,2
9,30,28,26,3,23
9,30,29,17,9,8
9,30,30,18,10,8
9,30,31,15,10,5
9,30,32,10,13,-3
9,30,33,24,14,10
9,30,34,18,5,13
9,30,35,20,4,16
9,30,36,18,21,-3
9,30,37,16,9,7
9,30,38,26,16,10
9,30,39,24,9,15
9,30,40,17,9,8
9,30,41,16,12,4
9,30,42,15,17,-2
9,30,43,13,8,5
9,30,44,25,14,11
9,30,45,20,6,14
9,30,46,14,19,-5
9,30,47,7,11,-4
9,30,48,25,21,4
9,30,49,18,8,10
9,30,50,15,8,7
9,30,51,18,3,15
9,30,52,19,10,9
9,30,53,20,12,8
9,30,54,15,6,9
9,30,55,11,4,7
9,30,56,13,12,1
9,30,57,18,14,4
9,30,58,20,18,2
9,30,59,12,6,6
9,30,60,17,8,9
9,30,61,11,6,5
9,30,62,15,11,4
9,30,63,18,12,6
9,30,64,20,8,12
9,30,65,9,10,-1
9,30,66,36,13,23
9,30,67,21,19,2
9,30,68,19,11,8
9,30,69,15,6,9
9,30,70,15,17,-2
9,30,71,23,7,16
9,30,72,11,6,5
9,30,73,13,4,9
9,30,74,27,11,16
9,30,75,22,13,9
9,30,76,29,8,21
9,30,77,20,5,15
9,30,78,24,17,7
9,30,79,29,7,22
9,30,80,13,19,-6
9,30,81,23,10,13
9,30,82,23,12,11
9,30,83,23,12,11
9,30,84,14,7,7
9,30,85,16,6,10
9,30,86,27,15,12
9,30,87,31,10,21
9,30,88,17,10,7
9,30,89,15,13,2
9,30,90,25,14,11
9,30,91,27,6,21
9,30,92,20,15,5
9,30,93,22,14,8
9,30,94,18,7,11
9,30,95,24,12,12
9,30,96,30,10,20
9,30,97,7,5,2
9,30,98,23,8,15
9,30,99,25,5,20
9,30,100,24,10,14
9,30,101,15,13,2
9,30,102,27,10,17
9,30,103,21,12,9
9,30,104,12,12,0
9,30,105,11,8,3
9,30,106,16,8,8
9,30,107,8,8,0
9,30,108,27,15,12
9,30,109,17,1,16
9,30,110,29,9,20
9,30,111,31,15,16
9,30,112,26,15,11
9,30,113,7,6,1
9,30,114,20,11,9
9,30,115,10,9,1
9,30,116,17,5,12
9,30,117,22,10,12
9,30,118,17,15,2
9,30,119,22,17,5
9,30,120,15,1,14
9,30,121,26,22,4
9,30,122,17,6,11
9,30,123,15,6,9
9,30,124,16,12,4
9,30,125,16,3,13
9,30,126,22,14,8
9,30,127,10,7,3
9,30,128,17,11,6
9,30,129,24,15,9
9,30,130,12,7,5
9,30,131,13,4,9
9,30,132,30,11,19
9,30,133,3,7,-4
9,30,134,15,18,-3
9,30,135,30,23,7
9,30,136,11,9,2
9,30,137,14,10,4
9,30,138,22,11,11
9,30,139,24,2,22
9,30,140,19,17,2
9,30,141,12,6,6
9,30,142,8,14,-6
9,30,143,10,10,0
9,30,144,17,14,3
9,30,145,22,16,6
9,30,146,25,15,10
9,30,147,11,4,7
9,30,148,18,14,4
9,30,149,15,20,-5
9,30,150,19,6,13
9,30,151,16,11,5
9,30,152,9,7,2
9,30,153,13,7,6
9,30,154,18,8,10
9,30,155,20,11,9
9,30,156,25,20,5
9,30,157,17,9,8
9,30,158,16,12,4
9,30,159,18,5,13
9,30,160,15,9,6
9,30,161,21,14,7
9,30,162,14,15,-1
9,30,163,25,14,11
9,30,164,18,19,-1
9,30,165,19,9,10
9,30,166,9,13,-4
9,30,167,15,14,1
9,30,168,11,13,-2
9,30,169,20,7,13
9,30,170,12,8,4
9,30,171,14,7,7
9,30,172,16,8,8
9,30,173,7,4,3
9,30,174,17,14,3
9,30,175,17,8,9
9,30,176,24,16,8
9,30,177,24,18,6
9,30,178,22,4,18
9,30,179,20,10,10
9,30,180,22,5,17
9,30,181,14,6,8
9,30,182,31,17,14
9,30,183,21,7,14
9,30,184,27,9,18
9,30,185,22,21,1
9,30,186,28,9,19
9,30,187,21,8,13
9,30,188,30,7,23
9,30,189,25,17,8
9,30,190,6,8,-2
9,30,191,24,15,9
9,30,192,16,20,-4
9,30,193,9,13,-4
9,30,194,10,8,2
9,30,195,13,6,7
9,30,196,9,6,3
9,30,197,12,8,4
9,30,198,27,12,15
9,30,199,7,9,-2
9,30,200,10,12,-2
9,30,201,9,4,5
9,30,202,16,4,12
9,30,203,10,4,6
9,30,204,15,14,1
9,30,205,24,21,3
9,30,206,28,9,19
9,30,207,22,14,8
9,30,208,10,11,-1
9,30,209,36,21,15
9,30,210,23,4,19
9,30,211,9,12,-3
9,30,212,15,10,5
9,30,213,16,17,-1
9,30,214,21,11,10
9,30,215,22,3,19
9,30,216,17,11,6
9,30,217,23,13,10
9,30,218,27,16,11
9,30,219,20,10,10
9,30,220,13,6,7
9,30,221,17,14,3
9,30,222,16,7,9
9,30,223,6,7,-1
9,30,224,16,7,9
9,30,225,13,13,0
9,30,226,8,13,-5
9,30,227,28,15,13
9,30,228,12,6,6
9,30,229,16,14,2
9,30,230,31,9,22
9,30,231,24,9,15
9,30,232,13,8,5
9,30,233,8,8,0
9,30,234,13,11,2
9,30,235,21,8,13
9,30,236,14,11,3
9,30,237,19,19,0
9,30,238,35,15,20
9,30,239,29,17,12
9,30,240,18,8,10
9,30,241,13,14,-1
9,30,242,11,4,7
9,30,243,12,20,-8
9,30,244,20,13,7
9,30,245,15,5,10
9,30,246,5,8,-3
9,30,247,33,10,23
9,30,248,17,2,15
9,30,249,20,4,16
9,30,250,21,12,9
9,30,251,19,13,6
9,30,252,35,19,16
9,30,253,15,0,15
9,30,254,12,14,-2
9,30,255,28,15,13
9,30,256,13,6,7
9,30,257,25,4,21
9,30,258,23,5,18
9,30,259,9,6,3
9,30,260,18,11,7
9,30,261,18,16,2
9,30,262,14,9,5
9,30,263,16,11,5
9,30,264,20,4,16
9,30,265,6,9,-3
9,30,266,5,7,-2
9,30,267,14,13,1
9,30,268,17,15,2
9,30,269,12,13,-1
9,30,270,15,12,3
9,30,271,12,13,-1
9,30,272,7,15,-8
9,30,273,22,6,16
9,30,274,17,10,7
9,30,275,9,15,-6
9,30,276,10,0,10
9,30,277,19,9,10
9,30,278,14,15,-1
9,30,279,21,12,9
9,30,280,22,6,16
9,30,281,26,19,7
9,30,282,18,5,13
9,30,283,12,8,4
9,30,284,23,4,19
9,30,285,25,12,13
9,30,286,27,18,9
9,30,287,18,5,13
9,30,288,17,3,14
9,30,289,28,8,20
9,30,290,26,17,9
9,30,291,19,15,4
9,30,292,23,13,10
9,30,293,17,11,6
9,30,294,19,8,11
9,30,295,14,8,6
9,30,296,22,4,18
9,30,297,21,6,15
9,30,298,22,11,11
9,30,299,21,12,9
10,1,0,13,18,-5
10,1,1,10,15,-5
10,1,2,11,9,2
10,1,3,10,15,-5
10,1,4,7,17,-10
10,1,5,1,7,-6
10,1,6,6,9,-3
10,1,7,8,12,-4
10,1,8,12,14,-2
10,1,9,14,25,-11
10,1,10,24,21,3
10,1,11,6,17,-11
10,1,12,10,9,1
10,1,13,2,10,-8
10,1,14,15,16,-1
10,1,15,9,12,-3
10,1,16,6,15,-9
10,1,17,4,35,-31
10,1,18,8,8,0
10,1,19,5,12,-7
10,1,20,9,16,-7
10,1,21,4,7,-3
10,1,22,9,20,-11
10,1,23,20,13,7
10,1,24,9,10,-1
10,1,25,4,18,-14
10,1,26,9,9,0
10,1,27,11,15,-4
10,1,28,6,16,-10
10,1,29,12,15,-3
10,1,30,6,17,-11
10,1,31,7,13,-6
10,1,32,11,19,-8
10,1,33,7,6,1
10,1,34,6,10,-4
10,1,35,6,7,-1
10,1,36,11,13,-2
10,1,37,4,18,-14
10,1,38,17,21,-4
10,1,39,11,2,9
10,1,40,13,20,-7
10,1,41,11,3,8
10,1,42,16,27,-11
10,1,43,10,18,-8
10,1,44,4,6,-2
10,1,45,20,12,8
10,1,46,6,7,-1
10,1,47,13,21,-8
10,1,48,4,21,-17
10,1,49,11,9,2
10,1,50,13,20,-7
10,1,51,6,15,-9
10,1,52,20,20,0
10,1,53,11,17,-6
10,1,54,13,21,-8
10,1,55,9,11,-2
10,1,56,5,14,-9
10,1,57,20,16,4
10,1,58,5,10,-5
10,1,59,9,9,0
10,1,60,13,13,0
10,1,61,10,10,0
10,1,62,14,14,0
10,1,63,8,18,-10
10,1,64,8,5,3
10,1,65,14,24,-10
10,1,66,10,15,-5
10,1,67,6,14,-8
10,1,68,11,16,-5
10,1,69,19,4,15
10,1,70,11,8,3
10,1,71,7,11,-4
10,1,72,10,20,-10
10,1,73,5,1,4
10,1,74,1,34,-33
10,1,75,8,11,-3
10,1,76,15,18,-3
10,1,77,6,9,-3
10,1,78,11,7,4
10,1,79,4,25,-21
10,1,80,5,19,-14
10,1,81,3,1,2
10,1,82,7,15,-8
10,1,83,9,12,-3
10,1,84,8,11,-3
10,1,85,5,9,-4
10,1,86,0,13,-13
10,1,87,6,21,-15
10,1,88,11,5,6
10,1,89,13,7,6
10,1,90,9,9,0
10,1,91,13,18,-5
10,1,92,11,15,-4
10,1,93,4,15,-11
10,1,94,11,16,-5
10,1,95,5,5,0
10,1,96,6,13,-7
10,1,97,6,10,-4
10,1,98,12,20,-8
10,1,99,9,18,-9
10,1,100,5,23,-18
10,1,101,9,10,-1
10,1,102,6,8,-2
10,1,103,11,13,-2
10,1,104,17,16,1
10,1,105,7,10,-3
10,1,106,8,6,2
10,1,107,15,17,-2
10,1,108,9,19,-10
10,1,109,11,23,-12
10,1,110,30,23,7
10,1,111,9,16,-7
10,1,112,11,13,-2
10,1,113,13,32,-19
10,1,114,11,18,-7
10,1,115,7,16,-9
10,1,116,17,14,3
10,1,117,8,19,-11
10,1,118,8,13,-5
10,1,119,7,19,-12
10,1,120,7,12,-5
10,1,121,10,14,-4
10,1,122,8,16,-8
10,1,123,5,12,-7
10,1,124,15,12,3
10,1,125,11,5,6
10,1,126,7,15,-8
10,1,127,7,9,-2
10,1,128,11,20,-9
10,1,129,7,10,-3
10,1,130,11,20,-9
10,1,131,10,13,-3
10,1,132,16,13,3
10,1,133,14,19,-5
10,1,134,2,8,-6
10,1,135,5,4,1
10,1,136,9,14,-5
10,1,137,5,10,-5
10,1,138,3,11,-8
10,1,139,18,17,1
10,1,140,19,14,5
10,1,141,7,15,-8
10,1,142,10,7,3
10,1,143,8,22,-14
10,1,144,10,9,1
10,1,145,4,9,-5
10,1,146,9,15,-6
10,1,147,9,18,-9
10,1,148,7,10,-3
10,1,149,10,8,2
10,1,150,15,17,-2
10,1,151,14,24,-10
10,1,152,12,23,-11
10,1,153,15,18,-3
10,1,154,11,9,2
10,1,155,6,14,-8
10,1,156,18,5,13
10,1,157,6,10,-4
10,1,158,15,25,-10
10,1,159,11,8,3
10,1,160,9,15,-6
10,1,161,9,12,-3
10,1,162,23,9,14
10,1,163,8,21,-13
10,1,164,7,13,-6
10,1,165,18,11,7
10,1,166,3,4,-1
10,1,167,8,10,-2
10,1,168,5,9,-4
10,1,169,7,4,3
10,1,170,12,18,-6
10,1,171,14,14,0
10,1,172,6,18,-12
10,1,173,4,12,-8
10,1,174,18,15,3
10,1,175,11,20,-9
10,1,176,12,14,-2
10,1,177,11,9,2
10,1,178,7,7,0
10,1,179,5,7,-2
10,1,180,6,10,-4
10,1,181,8,17,-9
10,1,182,9,16,-7
10,1,183,6,14,-8
10,1,184,6,7,-1
10,1,185,16,5,11
10,1,186,3,12,-9
10,1,187,12,19,-7
10,1,188,12,21,-9
10,1,189,8,15,-7
10,1,190,13,23,-10
10,1,191,7,13,-6
10,1,192,9,7,2
10,1,193,4,11,-7
10,1,194,9,12,-3
10,1,195,12,15,-3
10,1,196,11,14,-3
10,1,197,6,18,-12
10,1,198,10,4,6
10,1,199,8,5,3
10,1,200,17,8,9
10,1,201,8,8,0
10,1,202,13,6,7
10,1,203,15,14,1
10,1,204,12,15,-3
10,1,205,16,10,6
10,1,206,5,19,-14
10,1,207,13,19,-6
10,1,208,16,21,-5
10,1,209,9,27,-18
10,1,210,6,10,-4
10,1,211,13,23,-10
10,1,212,4,8,-4
10,1,213,14,13,1
10,1,214,10,6,4
10,1,215,13,11,2
10,1,216,5,11,-6
10,1,217,9,13,-4
10,1,218,13,24,-11
10,1,219,7,10,-3
10,1,220,4,16,-12
10,1,221,13,21,-8
10,1,222,7,10,-3
10,1,223,7,11,-4
10,1,224,14,14,0
10,1,225,8,8,0
10,1,226,7,11,-4
10,1,227,7,5,2
10,1,228,12,13,-1
10,1,229,13,11,2
10,1,230,13,8,5
10,1,231,9,18,-9
10,1,232,3,6,-3
10,1,233,16,21,-5
10,1,234,14,10,4
10,1,235,8,22,-14
10,1,236,13,19,-6
10,1,237,9,14,-5
10,1,238,12,19,-7
10,1,239,7,18,-11
10,1,240,4,4,0
10,1,241,13,13,0
10,1,242,12,12,0
10,1,243,5,8,-3
10,1,244,18,5,13
10,1,245,10,15,-5
10,1,246,4,11,-7
10,1,247,13,14,-1
10,1,248,11,6,5
10,1,249,11,23,-12
10,1,250,4,7,-3
10,1,251,6,10,-4
10,1,252,13,14,-1
10,1,253,8,12,-4
10,1,254,9,14,-5
10,1,255,9,4,5
10,1,256,5,12,-7
10,1,257,10,12,-2
10,1,258,3,5,-2
10,1,259,16,15,1
10,1,260,3,11,-8
10,1,261,9,15,-6
10,1,262,15,12,3
10,1,263,23,16,7
10,1,264,17,8,9
10,1,265,6,10,-4
10,1,266,13,8,5
10,1,267,19,24,-5
10,1,268,12,13,-1
10,1,269,15,14,1
10,1,270,4,5,-1
10,1,271,8,6,2
10,1,272,7,16,-9
10,1,273,8,20,-12
10,1,274,17,20,-3
10,1,275,9,24,-15
10,1,276,8,5,3
10,1,277,10,12,-2
10,1,278,7,11,-4
10,1,279,5,10,-5
10,1,280,1,6,-5
10,1,281,6,22,-16
10,1,282,15,26,-11
10,1,283,9,13,-4
10,1,284,15,10,5
10,1,285,10,12,-2
10,1,286,16,12,4
10,1,287,9,14,-5
10,1,288,12,17,-5
10,1,289,3,11,-8
10,1,290,10,14,-4
10,1,291,6,8,-2
10,1,292,7,18,-11
10,1,293,12,11,1
10,1,294,7,6,1
10,1,295,10,15,-5
10,1,296,13,14,-1
10,1,297,9,14,-5
10,1,298,8,8,0
10,1,299,3,3,0
10,2,0,10,15,-5
10,2,1,3,11,-8
10,2,2,7,7,0
10,2,3,7,12,-5
10,2,4,12,11,1
10,2,5,12,26,-14
10,2,6,7,16,-9
10,2,7,1,6,-5
10,2,8,11,9,2
10,2,9,7,10,-3
10,2,10,4,14,-10
10,2,11,8,9,-1
10,2,12,21,18,3
10,2,13,20,18,2
10,2,14,6,12,-6
10,2,15,18,24,-6
10,2,16,10,20,-10
10,2,17,20,17,3
10,2,18,7,7,0
10,2,19,2,8,-6
10,2,20,13,31,-18
10,2,21,5,17,-12
10,2,22,24,13,11
10,2,23,9,11,-2
10,2,24,17,10,7
10,2,25,13,9,4
10,2,26,8,15,-7
10,2,27,14,27,-13
10,2,28,6,16,-10
10,2,29,9,11,-2
10,2,30,7,3,4
10,2,31,8,18,-10
10,2,32,5,8,-3
10,2,33,9,17,-8
10,2,34,8,14,-6
10,2,35,15,14,1
10,2,36,21,14,7
10,2,37,17,11,6
10,2,38,6,8,-2
10,2,39,5,11,-6
10,2,40,3,4,-1
10,2,41,17,12,5
10,2,42,5,13,-8
10,2,43,19,18,1
10,2,44,10,10,0
10,2,45,16,28,-12
10,2,46,15,15,0
10,2,47,13,14,-1
10,2,48,14,11,3
10,2,49,6,19,-13
10,2,50,7,8,-1
10,2,51,7,10,-3
10,2,52,9,19,-10
10,2,53,3,14,-11
10,2,54,3,19,-16
10,2,55,5,22,-17
10,2,56,11,14,-3
10,2,57,16,14,2
10,2,58,5,10,-5
10,2,59,16,10,6
10,2,60,11,21,-10
10,2,61,15,22,-7
10,2,62,13,19,-6
10,2,63,10,12,-2
10,2,64,5,13,-8
10,2,65,18,19,-1
10,2,66,11,12,-1
10,2,67,0,11,-11
10,2,68,11,1,10
10,2,69,8,15,-7
10,2,70,14,23,-9
10,2,71,14,6,8
10,2,72,17,19,-2
10,2,73,20,29,-9
10,2,74,3,14,-11
10,2,75,4,12,-8
10,2,76,19,23,-4
10,2,77,16,22,-6
10,2,78,13,17,-4
10,2,79,9,10,-1
10,2,80,6,14,-8
10,2,81,8,8,0
10,2,82,7,6,1
10,2,83,4,6,-2
10,2,84,6,9,-3
10,2,85,5,10,-5
10,2,86,9,14,-5
10,2,87,13,15,-2
10,2,88,9,12,-3
10,2,89,4,8,-4
10,2,90,17,11,6
10,2,91,15,16,-1
10,2,92,14,17,-3
10,2,93,10,10,0
10,2,94,17,27,-10
10,2,95,5,7,-2
10,2,96,14,19,-5
10,2,97,5,8,-3
10,2,98,10,15,-5
10,2,99,8,2,6
10,2,100,9,13,-4
10,2,101,2,17,-15
10,2,102,3,8,-5
10,2,103,11,12,-1
10,2,104,6,23,-17
10,2,105,9,17,-8
10,2,106,4,9,-5
10,2,107,11,13,-2
10,2,108,9,8,1
10,2,109,5,13,-8
10,2,110,30,27,3
10,2,111,5,16,-11
10,2,112,7,11,-4
10,2,113,8,10,-2
10,2,114,10,16,-6
10,2,115,13,15,-2
10,2,116,12,17,-5
10,2,117,16,13,3
10,2,118,14,18,-4
10,2,119,23,23,0
10,2,120,9,12,-3
10,2,121,8,2,6
10,2,122,10,13,-3
10,2,123,3,6,-3
10,2,124,17,11,6
10,2,125,5,7,-2
10,2,126,7,17,-10
10,2,127,11,17,-6
10,2,128,5,18,-13
10,2,129,9,9,0
10,2,130,8,25,-17
10,2,131,8,16,-8
10,2,132,11,17,-6
10,2,133,14,18,-4
10,2,134,13,15,-2
10,2,135,10,8,2
10,2,136,10,17,-7
10,2,137,12,7,5
10,2,138,9,11,-2
10,2,139,11,13,-2
10,2,140,12,21,-9
10,2,141,18,17,1
10,2,142,3,12,-9
10,2,143,10,15,-5
10,2,144,8,4,4
10,2,145,5,11,-6
10,2,146,9,13,-4
10,2,147,11,9,2
10,2,148,8,19,-11
10,2,149,9,11,-2
10,2,150,5,8,-3
10,2,151,11,17,-6
10,2,152,10,22,-12
10,2,153,14,9,5
10,2,154,12,9,3
10,2,155,4,6,-2
10,2,156,6,5,1
10,2,157,4,13,-9
10,2,158,8,12,-4
10,2,159,11,13,-2
10,2,160,8,14,-6
10,2,161,27,18,9
10,2,162,4,7,-3
10,2,163,9,13,-4
10,2,164,7,12,-5
10,2,165,7,13,-6
10,2,166,9,19,-10
10,2,167,12,12,0
10,2,168,13,11,2
10,2,169,5,11,-6
10,2,170,10,17,-7
10,2,171,15,14,1
10,2,172,20,16,4
10,2,173,15,19,-4
10,2,174,6,10,-4
10,2,175,6,15,-9
10,2,176,13,12,1
10,2,177,0,15,-15
10,2,178,16,18,-2
10,2,179,9,17,-8
10,2,180,16,11,5
10,2,181,11,16,-5
10,2,182,4,13,-9
10,2,183,10,17,-7
10,2,184,10,5,5
10,2,185,11,11,0
10,2,186,9,10,-1
10,2,187,10,18,-8
10,2,188,9,34,-25
10,2,189,8,11,-3
10,2,190,12,11,1
10,2,191,14,12,2
10,2,192,5,9,-4
10,2,193,11,20,-9
10,2,194,12,15,-3
10,2,195,9,16,-7
10,2,196,3,10,-7
10,2,197,5,8,-3
10,2,198,6,7,-1
10,2,199,18,12,6
10,2,200,16,25,-9
10,2,201,5,14,-9
10,2,202,7,18,-11
10,2,203,7,12,-5
10,2,204,13,23,-10
10,2,205,16,21,-5
10,2,206,16,19,-3
10,2,207,7,19,-12
10,2,208,3,9,-6
10,2,209,21,14,7
10,2,210,18,15,3
10,2,211,9,10,-1
10,2,212,15,10,5
10,2,213,7,20,-13
10,2,214,11,18,-7
10,2,215,5,6,-1
10,2,216,4,14,-10
10,2,217,5,17,-12
10,2,218,16,18,-2
10,2,219,10,12,-2
10,2,220,6,18,-12
10,2,221,13,16,-3
10,2,222,23,18,5
10,2,223,13,20,-7
10,2,224,4,12,-8
10,2,225,20,22,-2
10,2,226,17,10,7
10,2,227,11,12,-1
10,2,228,16,15,1
10,2,229,19,19,0
10,2,230,17,12,5
10,2,231,11,12,-1
10,2,232,8,13,-5
10,2,233,5,12,-7
10,2,234,12,9,3
10,2,235,9,11,-2
10,2,236,11,17,-6
10,2,237,15,27,-12
10,2,238,6,5,1
10,2,239,6,19,-13
10,2,240,17,11,6
10,2,241,20,16,4
10,2,242,13,16,-3
10,2,243,13,14,-1
10,2,244,4,12,-8
10,2,245,6,9,-3
10,2,246,6,10,-4
10,2,247,9,13,-4
10,2,248,10,9,1
10,2,249,12,5,7
10,2,250,8,10,-2
10,2,251,15,22,-7
10,2,252,4,5,-1
10,2,253,14,18,-4
10,2,254,11,26,-15
10,2,255,8,21,-13
10,2,256,13,9,4
10,2,257,3,21,-18
10,2,258,6,25,-19
10,2,259,10,19,-9
10,2,260,19,11,8
10,2,261,15,11,4
10,2,262,4,6,-2
10,2,263,8,10,-2
10,2,264,12,15,-3
10,2,265,2,9,-7
10,2,266,8,23,-15
10,2,267,15,16,-1
10,2,268,12,16,-4
10,2,269,17,19,-2
10,2,270,14,4,10
10,2,271,14,29,-15
10,2,272,4,7,-3
10,2,273,13,13,0
10,2,274,19,13,6
10,2,275,10,10,0
10,2,276,8,10,-2
10,2,277,6,17,-11
10,2,278,8,16,-8
10,2,279,10,11,-1
10,2,280,9,9,0
10,2,281,6,12,-6
10,2,282,8,13,-5
10,2,283,4,10,-6
10,2,284,3,9,-6
10,2,285,4,13,-9
10,2,286,9,30,-21
10,2,287,12,13,-1
10,2,288,10,13,-3
10,2,289,7,31,-24
10,2,290,9,11,-2
10,2,291,14,21,-7
10,2,292,11,9,2
10,2,293,17,16,1
10,2,294,9,24,-15
10,2,295,24,21,3
10,2,296,17,14,3
10,2,297,8,19,-11
10,2,298,4,12,-8
10,2,299,24,14,10
10,3,0,0,9,-9
10,3,1,12,7,5
10,3,2,12,16,-4
10,3,3,18,25,-7
10,3,4,10,12,-2
10,3,5,18,11,7
10,3,6,23,15,8
10,3,7,15,9,6
10,3,8,5,22,-17
10,3,9,23,13,10
10,3,10,16,23,-7
10,3,11,6,17,-11
10,3,12,10,12,-2
10,3,13,24,26,-2
10,3,14,12,16,-4
10,3,15,8,18,-10
10,3,16,10,19,-9
10,3,17,15,21,-6
10,3,18,3,7,-4
10,3,19,5,10,-5
10,3,20,10,10,0
10,3,21,12,14,-2
10,3,22,4,13,-9
10,3,23,14,14,0
10,3,24,16,19,-3
10,3,25,14,16,-2
10,3,26,15,11,4
10,3,27,14,20,-6
10,3,28,7,16,-9
10,3,29,4,10,-6
10,3,30,5,8,-3
10,3,31,10,21,-11
10,3,32,15,12,3
10,3,33,12,8,4
10,3,34,11,13,-2
10,3,35,17,21,-4
10,3,36,15,14,1
10,3,37,19,10,9
10,3,38,6,16,-10
10,3,39,11,11,0
10,3,40,18,22,-4
10,3,41,18,16,2
10,3,42,12,26,-14
10,3,43,11,10,1
10,3,44,7,27,-20
10,3,45,12,12,0
10,3,46,6,23,-17
10,3,47,6,7,-1
10,3,48,10,11,-1
10,3,49,16,9,7
10,3,50,12,12,0
10,3,51,10,29,-19
10,3,52,15,17,-2
10,3,53,13,14,-1
10,3,54,18,13,5
10,3,55,4,6,-2
10,3,56,19,16,3
10,3,57,11,12,-1
10,3,58,15,15,0
10,3,59,16,32,-16
10,3,60,10,17,-7
10,3,61,15,26,-11
10,3,62,18,19,-1
10,3,63,8,10,-2
10,3,64,14,12,2
10,3,65,10,12,-2
10,3,66,13,22,-9
10,3,67,3,14,-11
10,3,68,13,20,-7
10,3,69,6,5,1
10,3,70,9,12,-3
10,3,71,24,16,8
10,3,72,7,12,-5
10,3,73,6,20,-14
10,3,74,13,11,2
10,3,75,12,8,4
10,3,76,5,5,0
10,3,77,6,10,-4
10,3,78,17,12,5
10,3,79,6,12,-6
10,3,80,5,10,-5
10,3,81,13,18,-5
10,3,82,10,12,-2
10,3,83,17,17,0
10,3,84,7,11,-4
10,3,85,5,9,-4
10,3,86,11,5,6
10,3,87,11,13,-2
10,3,88,7,16,-9
10,3,89,14,13,1
10,3,90,7,4,3
10,3,91,2,11,-9
10,3,92,10,17,-7
10,3,93,14,18,-4
10,3,94,13,11,2
10,3,95,19,15,4
10,3,96,16,19,-3
10,3,97,14,15,-1
10,3,98,16,5,11
10,3,99,6,7,-1
10,3,100,7,20,-13
10,3,101,11,20,-9
10,3,102,12,16,-4
10,3,103,9,10,-1
10,3,104,3,22,-19
10,3,105,7,12,-5
10,3,106,14,26,-12
10,3,107,19,16,3
10,3,108,8,9,-1
10,3,109,21,8,13
10,3,110,14,12,2
10,3,111,6,11,-5
10,3,112,8,11,-3
10,3,113,6,15,-9
10,3,114,7,15,-8
10,3,115,13,12,1
10,3,116,7,12,-5
10,3,117,12,7,5
10,3,118,5,16,-11
10,3,119,7,19,-12
10,3,120,15,33,-18
10,3,121,13,26,-13
10,3,122,16,16,0
10,3,123,8,21,-13
10,3,124,23,11,12
10,3,125,10,20,-10
10,3,126,11,17,-6
10,3,127,10,7,3
10,3,128,7,14,-7
10,3,129,15,17,-2
10,3,130,11,10,1
10,3,131,9,8,1
10,3,132,4,22,-18
10,3,133,9,8,1
10,3,134,7,5,2
10,3,135,10,19,-9
10,3,136,6,7,-1
10,3,137,5,8,-3
10,3,138,11,9,2
10,3,139,13,23,-10
10,3,140,15,17,-2
10,3,141,8,14,-6
10,3,142,6,13,-7
10,3,143,13,28,-15
10,3,144,18,16,2
10,3,145,10,12,-2
10,3,146,7,12,-5
10,3,147,20,14,6
10,3,148,5,11,-6
10,3,149,12,11,1
10,3,150,3,14,-11
10,3,151,19,27,-8
10,3,152,18,19,-1
10,3,153,8,12,-4
10,3,154,14,11,3
10,3,155,3,21,-18
10,3,156,7,12,-5
10,3,157,14,13,1
10,3,158,3,6,-3
10,3,159,16,11,5
10,3,160,6,14,-8
10,3,161,10,13,-3
10,3,162,13,16,-3
10,3,163,12,24,-12
10,3,164,19,17,2
10,3,165,14,27,-13
10,3,166,15,24,-9
10,3,167,3,7,-4
10,3,168,9,18,-9
10,3,169,12,28,-16
10,3,170,5,16,-11
10,3,171,6,11,-5
10,3,172,15,14,1
10,3,173,10,18,-8
10,3,174,18,19,-1
10,3,175,7,9,-2
10,3,176,11,17,-6
10,3,177,5,13,-8
10,3,178,5,8,-3
10,3,179,4,20,-16
10,3,180,13,23,-10
10,3,181,12,26,-14
10,3,182,13,16,-3
10,3,183,8,30,-22
10,3,184,8,11,-3
10,3,185,25,27,-2
10,3,186,14,18,-4
10,3,187,5,10,-5
10,3,188,9,28,-19
10,3,189,12,16,-4
10,3,190,4,5,-1
10,3,191,12,20,-8
10,3,192,8,6,2
10,3,193,8,30,-22
10,3,194,9,5,4
10,3,195,10,22,-12
10,3,196,15,21,-6
10,3,197,10,13,-3
10,3,198,8,32,-24
10,3,199,6,15,-9
10,3,200,13,11,2
10,3,201,12,20,-8
10,3,202,9,9,0
10,3,203,11,9,2
10,3,204,4,15,-11
10,3,205,17,26,-9
10,3,206,11,11,0
10,3,207,9,6,3
10,3,208,17,10,7
10,3,209,20,22,-2
10,3,210,16,17,-1
10,3,211,20,14,6
10,3,212,7,15,-8
10,3,213,11,17,-6
10,3,214,15,25,-10
10,3,215,8,24,-16
10,3,216,17,17,0
10,3,217,2,5,-3
10,3,218,24,11,13
10,3,219,21,27,-6
10,3,220,5,10,-5
10,3,221,15,15,0
10,3,222,12,19,-7
10,3,223,8,11,-3
10,3,224,25,19,6
10,3,225,14,12,2
10,3,226,13,16,-3
10,3,227,2,14,-12
10,3,228,5,8,-3
10,3,229,13,22,-9
10,3,230,11,18,-7
10,3,231,11,20,-9
10,3,232,6,19,-13
10,3,233,13,20,-7
10,3,234,16,15,1
10,3,235,6,17,-11
10,3,236,13,11,2
10,3,237,1,4,-3
10,3,238,7,12,-5
10,3,239,12,17,-5
10,3,240,3,18,-15
10,3,241,17,19,-2
10,3,242,5,5,0
10,3,243,9,14,-5
10,3,244,4,8,-4
10,3,245,10,12,-2
10,3,246,12,13,-1
10,3,247,8,18,-10
10,3,248,11,20,-9
10,3,249,7,11,-4
10,3,250,13,16,-3
10,3,251,10,19,-9
10,3,252,8,26,-18
10,3,253,4,11,-7
10,3,254,6,12,-6
10,3,255,9,17,-8
10,3,256,19,21,-2
10,3,257,10,6,4
10,3,258,14,10,4
10,3,259,7,3,4
10,3,260,13,24,-11
10,3,261,12,18,-6
10,3,262,7,22,-15
10,3,263,14,17,-3
10,3,264,15,13,2
10,3,265,15,13,2
10,3,266,10,17,-7
10,3,267,7,10,-3
10,3,268,12,14,-2
10,3,269,17,16,1
10,3,270,13,26,-13
10,3,271,13,11,2
10,3,272,17,19,-2
10,3,273,13,9,4
10,3,274,11,12,-1
10,3,275,4,10,-6
10,3,276,12,12,0
10,3,277,14,14,0
10,3,278,13,9,4
10,3,279,16,12,4
10,3,280,19,24,-5
10,3,281,12,12,0
10,3,282,5,16,-11
10,3,283,14,8,6
10,3,284,16,22,-6
10,3,285,16,14,2
10,3,286,8,7,1
10,3,287,11,14,-3
10,3,288,9,8,1
10,3,289,5,16,-11
10,3,290,4,18,-14
10,3,291,6,12,-6
10,3,292,3,3,0
10,3,293,5,15,-10
10,3,294,6,14,-8
10,3,295,11,19,-8
10,3,296,14,10,4
10,3,297,7,13,-6
10,3,298,12,15,-3
10,3,299,14,13,1
10,4,0,25,12,13
10,4,1,11,10,1
10,4,2,9,19,-10
10,4,3,7,11,-4
10,4,4,13,20,-7
10,4,5,7,10,-3
10,4,6,8,10,-2
10,4,7,7,19,-12
10,4,8,13,30,-17
10,4,9,4,9,-5
10,4,10,10,34,-24
10,4,11,6,12,-6
10,4,12,16,21,-5
10,4,13,16,22,-6
10,4,14,14,15,-1
10,4,15,11,6,5
10,4,16,12,20,-8
10,4,17,9,22,-13
10,4,18,17,25,-8
10,4,19,15,10,5
10,4,20,18,28,-10
10,4,21,6,11,-5
10,4,22,10,24,-14
10,4,23,9,13,-4
10,4,24,17,21,-4
10,4,25,8,7,1
10,4,26,10,14,-4
10,4,27,22,14,8
10,4,28,23,23,0
10,4,29,7,8,-1
10,4,30,9,23,-14
10,4,31,9,20,-11
10,4,32,5,8,-3
10,4,33,17,11,6
10,4,34,18,15,3
10,4,35,6,10,-4
10,4,36,17,24,-7
10,4,37,4,13,-9
10,4,38,13,21,-8
10,4,39,10,19,-9
10,4,40,22,11,11
10,4,41,19,23,-4
10,4,42,20,12,8
10,4,43,15,12,3
10,4,44,10,24,-14
10,4,45,7,12,-5
10,4,46,16,26,-10
10,4,47,11,26,-15
10,4,48,10,11,-1
10,4,49,10,28,-18
10,4,50,13,17,-4
10,4,51,15,14,1
10,4,52,13,12,1
10,4,53,9,25,-16
10,4,54,22,20,2
10,4,55,16,16,0
10,4,56,11,8,3
10,4,57,5,11,-6
10,4,58,8,16,-8
10,4,59,15,21,-6
10,4,60,16,16,0
10,4,61,18,23,-5
10,4,62,13,6,7
10,4,63,5,11,-6
10,4,64,21,15,6
10,4,65,6,12,-6
10,4,66,4,6,-2
10,4,67,16,21,-5
10,4,68,5,5,0
10,4,69,14,11,3
10,4,70,8,11,-3
10,4,71,13,8,5
10,4,72,4,5,-1
10,4,73,15,15,0
10,4,74,24,18,6
10,4,75,15,17,-2
10,4,76,17,23,-6
10,4,77,5,15,-10
10,4,78,11,12,-1
10,4,79,17,9,8
10,4,80,12,26,-14
10,4,81,9,6,3
10,4,82,11,10,1
10,4,83,7,12,-5
10,4,84,13,18,-5
10,4,85,16,24,-8
10,4,86,19,16,3
10,4,87,15,23,-8
10,4,88,10,17,-7
10,4,89,6,11,-5
10,4,90,17,24,-7
10,4,91,18,27,-9
10,4,92,12,17,-5
10,4,93,13,13,0
10,4,94,10,16,-6
10,4,95,20,15,5
10,4,96,8,9,-1
10,4,97,10,14,-4
10,4,98,11,5,6
10,4,99,12,18,-6
10,4,100,6,10,-4
10,4,101,9,22,-13
10,4,102,4,18,-14
10,4,103,10,10,0
10,4,104,9,8,1
10,4,105,17,8,9
10,4,106,15,15,0
10,4,107,10,18,-8
10,4,108,6,3,3
10,4,109,16,12,4
10,4,110,10,10,0
10,4,111,17,36,-19
10,4,112,12,13,-1
10,4,113,14,9,5
10,4,114,5,28,-23
10,4,115,8,13,-5
10,4,116,8,19,-11
10,4,117,6,27,-21
10,4,118,10,5,5
10,4,119,18,26,-8
10,4,120,20,15,5
10,4,121,13,15,-2
10,4,122,14,15,-1
10,4,123,9,26,-17
10,4,124,17,37,-20
10,4,125,24,12,12
10,4,126,10,26,-16
10,4,127,7,6,1
10,4,128,15,23,-8
10,4,129,10,6,4
10,4,130,7,8,-1
10,4,131,5,8,-3
10,4,132,4,7,-3
10,4,133,14,24,-10
10,4,134,18,23,-5
10,4,135,13,17,-4
10,4,136,8,7,1
10,4,137,29,19,10
10,4,138,9,31,-22
10,4,139,12,14,-2
10,4,140,17,9,8
10,4,141,13,13,0
10,4,142,9,10,-1
10,4,143,11,26,-15
10,4,144,4,20,-16
10,4,145,16,12,4
10,4,146,16,19,-3
10,4,147,13,23,-10
10,4,148,6,22,-16
10,4,149,10,3,7
10,4,150,15,24,-9
10,4,151,13,15,-2
10,4,152,7,15,-8
10,4,153,7,15,-8
10,4,154,15,10,5
10,4,155,16,13,3
10,4,156,25,13,12
10,4,157,16,14,2
10,4,158,6,8,-2
10,4,159,24,23,1
10,4,160,6,10,-4
10,4,161,8,7,1
10,4,162,7,9,-2
10,4,163,17,25,-8
10,4,164,32,11,21
10,4,165,10,7,3
10,4,166,11,18,-7
10,4,167,16,19,-3
10,4,168,29,26,3
10,4,169,5,4,1
10,4,170,6,25,-19
10,4,171,14,25,-11
10,4,172,12,22,-10
10,4,173,6,17,-11
10,4,174,17,22,-5
10,4,175,3,4,-1
10,4,176,13,20,-7
10,4,177,12,14,-2
10,4,178,7,15,-8
10,4,179,12,10,2
10,4,180,17,21,-4
10,4,181,10,24,-14
10,4,182,16,7,9
10,4,183,14,23,-9
10,4,184,8,20,-12
10,4,185,26,18,8
10,4,186,20,13,7
10,4,187,7,8,-1
10,4,188,16,10,6
10,4,189,7,15,-8
10,4,190,17,16,1
10,4,191,12,5,7
10,4,192,17,16,1
10,4,193,14,10,4
10,4,194,13,16,-3
10,4,195,29,16,13
10,4,196,20,29,-9
10,4,197,19,15,4
10,4,198,10,10,0
10,4,199,4,6,-2
10,4,200,17,22,-5
10,4,201,12,12,0
10,4,202,9,27,-18
10,4,203,10,13,-3
10,4,204,13,9,4
10,4,205,3,13,-10
10,4,206,10,30,-20
10,4,207,9,6,3
10,4,208,12,14,-2
10,4,209,9,13,-4
10,4,210,17,12,5
10,4,211,7,10,-3
10,4,212,16,12,4
10,4,213,15,14,1
10,4,214,16,19,-3
10,4,215,38,22,16
10,4,216,8,40,-32
10,4,217,8,8,0
10,4,218,12,26,-14
10,4,219,21,28,-7
10,4,220,14,14,0
10,4,221,17,15,2
10,4,222,8,6,2
10,4,223,2,11,-9
10,4,224,3,16,-13
10,4,225,23,25,-2
10,4,226,22,20,2
10,4,227,8,15,-7
10,4,228,13,10,3
10,4,229,2,15,-13
10,4,230,10,24,-14
10,4,231,12,17,-5
10,4,232,6,17,-11
10,4,233,7,7,0
10,4,234,12,9,3
10,4,235,9,18,-9
10,4,236,11,17,-6
10,4,237,6,18,-12
10,4,238,12,9,3
10,4,239,10,9,1
10,4,240,15,22,-7
10,4,241,10,27,-17
10,4,242,13,16,-3
10,4,243,13,16,-3
10,4,244,12,10,2
10,4,245,3,9,-6
10,4,246,6,17,-11
10,4,247,8,6,2
10,4,248,18,37,-19
10,4,249,12,19,-7
10,4,250,9,14,-5
10,4,251,11,16,-5
10,4,252,6,11,-5
10,4,253,24,22,2
10,4,254,19,29,-10
10,4,255,13,10,3
10,4,256,12,12,0
10,4,257,14,14,0
10,4,258,9,4,5
10,4,259,12,7,5
10,4,260,20,22,-2
10,4,261,11,16,-5
10,4,262,12,12,0
10,4,263,6,7,-1
10,4,264,12,20,-8
10,4,265,6,18,-12
10,4,266,6,14,-8
10,4,267,11,21,-10
10,4,268,11,11,0
10,4,269,9,18,-9
10,4,270,13,10,3
10,4,271,14,18,-4
10,4,272,15,19,-4
10,4,273,14,26,-12
10,4,274,5,14,-9
10,4,275,20,19,1
10,4,276,9,11,-2
10,4,277,12,32,-20
10,4,278,13,22,-9
10,4,279,10,12,-2
10,4,280,11,8,3
10,4,281,6,13,-7
10,4,282,10,17,-7
10,4,283,21,20,1
10,4,284,10,20,-10
10,4,285,19,25,-6
10,4,286,21,15,6
10,4,287,17,14,3
10,4,288,12,23,-11
10,4,289,21,23,-2
10,4,290,13,23,-10
10,4,291,2,14,-12
10,4,292,6,21,-15
10,4,293,11,18,-7
10,4,294,8,21,-13
10,4,295,13,11,2
10,4,296,9,6,3
10,4,297,20,23,-3
10,4,298,12,14,-2
10,4,299,7,17,-10
10,5,0,13,18,-5
10,5,1,15,25,-10
10,5,2,11,13,-2
10,5,3,13,27,-14
10,5,4,12,35,-23
10,5,5,12,14,-2
10,5,6,10,15,-5
10,5,7,13,15,-2
10,5,8,13,16,-3
10,5,9,13,15,-2
10,5,10,10,18,-8
10,5,11,12,20,-8
10,5,12,9,37,-28
10,5,13,7,14,-7
10,5,14,5,6,-1
10,5,15,14,22,-8
10,5,16,15,28,-13
10,5,17,9,26,-17
10,5,18,22,19,3
10,5,19,4,15,-11
10,5,20,8,8,0
10,5,21,17,16,1
10,5,22,8,31,-23
10,5,23,11,29,-18
10,5,24,22,17,5
10,5,25,8,13,-5
10,5,26,10,15,-5
10,5,27,10,11,-1
10,5,28,9,9,0
10,5,29,17,24,-7
10,5,30,19,34,-15
10,5,31,20,29,-9
10,5,32,9,6,3
10,5,33,11,27,-16
10,5,34,11,17,-6
10,5,35,22,28,-6
10,5,36,13,15,-2
10,5,37,14,14,0
10,5,38,16,17,-1
10,5,39,13,27,-14
10,5,40,10,8,2
10,5,41,18,23,-5
10,5,42,8,23,-15
10,5,43,9,16,-7
10,5,44,4,18,-14
10,5,45,13,17,-4
10,5,46,8,26,-18
10,5,47,23,18,5
10,5,48,8,13,-5
10,5,49,34,13,21
10,5,50,25,23,2
10,5,51,8,16,-8
10,5,52,17,15,2
10,5,53,19,24,-5
10,5,54,14,30,-16
10,5,55,8,8,0
10,5,56,8,21,-13
10,5,57,10,16,-6
10,5,58,17,14,3
10,5,59,6,5,1
10,5,60,13,10,3
10,5,61,25,14,11
10,5,62,10,11,-1
10,5,63,11,15,-4
10,5,64,11,16,-5
10,5,65,24,5,19
10,5,66,11,17,-6
10,5,67,10,16,-6
10,5,68,11,32,-21
10,5,69,13,15,-2
10,5,70,21,13,8
10,5,71,27,12,15
10,5,72,11,12,-1
10,5,73,11,19,-8
10,5,74,19,8,11
10,5,75,12,14,-2
10,5,76,4,13,-9
10,5,77,7,17,-10
10,5,78,4,18,-14
10,5,79,13,19,-6
10,5,80,4,13,-9
10,5,81,8,15,-7
10,5,82,15,16,-1
10,5,83,11,18,-7
10,5,84,14,16,-2
10,5,85,20,22,-2
10,5,86,11,20,-9
10,5,87,34,22,12
10,5,88,22,14,8
10,5,89,11,7,4
10,5,90,15,21,-6
10,5,91,10,7,3
10,5,92,26,20,6
10,5,93,5,17,-12
10,5,94,18,29,-11
10,5,95,15,11,4
10,5,96,14,12,2
10,5,97,7,8,-1
10,5,98,8,17,-9
10,5,99,22,12,10
10,5,100,5,12,-7
10,5,101,22,14,8
10,5,102,15,19,-4
10,5,103,9,9,0
10,5,104,11,16,-5
10,5,105,15,24,-9
10,5,106,12,14,-2
10,5,107,11,17,-6
10,5,108,8,4,4
10,5,109,20,14,6
10,5,110,9,7,2
10,5,111,12,15,-3
10,5,112,11,12,-1
10,5,113,19,25,-6
10,5,114,9,5,4
10,5,115,6,12,-6
10,5,116,7,21,-14
10,5,117,8,16,-8
10,5,118,9,26,-17
10,5,119,26,20,6
10,5,120,5,21,-16
10,5,121,10,13,-3
10,5,122,15,22,-7
10,5,123,13,13,0
10,5,124,15,19,-4
10,5,125,8,15,-7
10,5,126,9,11,-2
10,5,127,18,13,5
10,5,128,19,18,1
10,5,129,12,11,1
10,5,130,8,10,-2
10,5,131,9,15,-6
10,5,132,12,22,-10
10,5,133,11,10,1
10,5,134,17,25,-8
10,5,135,16,23,-7
10,5,136,9,9,0
10,5,137,4,11,-7
10,5,138,15,17,-2
10,5,139,9,21,-12
10,5,140,21,20,1
10,5,141,10,8,2
10,5,142,2,13,-11
10,5,143,9,15,-6
10,5,144,9,18,-9
10,5,145,17,25,-8
10,5,146,16,27,-11
10,5,147,5,12,-7
10,5,148,8,13,-5
10,5,149,13,26,-13
10,5,150,13,13,0
10,5,151,18,15,3
10,5,152,10,4,6
10,5,153,10,17,-7
10,5,154,9,11,-2
10,5,155,8,18,-10
10,5,156,7,19,-12
10,5,157,16,31,-15
10,5,158,4,4,0
10,5,159,3,16,-13
10,5,160,19,16,3
10,5,161,23,23,0
10,5,162,8,18,-10
10,5,163,10,23,-13
10,5,164,12,13,-1
10,5,165,12,6,6
10,5,166,15,25,-10
10,5,167,26,17,9
10,5,168,12,19,-7
10,5,169,12,16,-4
10,5,170,7,7,0
10,5,171,15,23,-8
10,5,172,20,15,5
10,5,173,12,19,-7
10,5,174,30,20,10
10,5,175,12,28,-16
10,5,176,14,21,-7
10,5,177,7,6,1
10,5,178,17,15,2
10,5,179,7,10,-3
10,5,180,15,12,3
10,5,181,22,11,11
10,5,182,16,22,-6
10,5,183,8,11,-3
10,5,184,7,12,-5
10,5,185,6,12,-6
10,5,186,8,19,-11
10,5,187,12,15,-3
10,5,188,8,14,-6
10,5,189,11,18,-7
10,5,190,18,17,1
10,5,191,14,15,-1
10,5,192,4,4,0
10,5,193,12,26,-14
10,5,194,10,23,-13
10,5,195,9,14,-5
10,5,196,7,18,-11
10,5,197,15,21,-6
10,5,198,22,20,2
10,5,199,10,13,-3
10,5,200,12,22,-10
10,5,201,15,22,-7
10,5,202,14,6,8
10,5,203,19,17,2
10,5,204,13,17,-4
10,5,205,12,14,-2
10,5,206,5,13,-8
10,5,207,13,14,-1
10,5,208,9,12,-3
10,5,209,19,8,11
10,5,210,15,16,-1
10,5,211,11,18,-7
10,5,212,10,11,-1
10,5,213,21,19,2
10,5,214,8,26,-18
10,5,215,23,19,4
10,5,216,4,12,-8
10,5,217,17,25,-8
10,5,218,10,13,-3
10,5,219,1,20,-19
10,5,220,9,13,-4
10,5,221,22,13,9
10,5,222,15,21,-6
10,5,223,7,4,3
10,5,224,11,15,-4
10,5,225,9,22,-13
10,5,226,7,8,-1
10,5,227,2,4,-2
10,5,228,9,15,-6
10,5,229,14,21,-7
10,5,230,5,14,-9
10,5,231,11,11,0
10,5,232,10,10,0
10,5,233,14,20,-6
10,5,234,10,16,-6
10,5,235,15,19,-4
10,5,236,15,29,-14
10,5,237,18,19,-1
10,5,238,11,10,1
10,5,239,3,9,-6
10,5,240,14,28,-14
10,5,241,12,10,2
10,5,242,11,12,-1
10,5,243,3,11,-8
10,5,244,15,26,-11
10,5,245,21,23,-2
10,5,246,15,22,-7
10,5,247,7,9,-2
10,5,248,10,17,-7
10,5,249,15,15,0
10,5,250,9,26,-17
10,5,251,3,17,-14
10,5,252,15,15,0
10,5,253,14,10,4
10,5,254,5,10,-5
10,5,255,18,9,9
10,5,256,13,13,0
10,5,257,10,15,-5
10,5,258,16,27,-11
10,5,259,1,8,-7
10,5,260,22,22,0
10,5,261,16,25,-9
10,5,262,17,18,-1
10,5,263,11,25,-14
10,5,264,7,8,-1
10,5,265,14,20,-6
10,5,266,14,23,-9
10,5,267,16,13,3
10,5,268,14,11,3
10,5,269,12,16,-4
10,5,270,9,13,-4
10,5,271,15,13,2
10,5,272,10,15,-5
10,5,273,16,13,3
10,5,274,16,15,1
10,5,275,23,28,-5
10,5,276,12,17,-5
10,5,277,13,14,-1
10,5,278,8,12,-4
10,5,279,14,18,-4
10,5,280,20,13,7
10,5,281,16,24,-8
10,5,282,15,15,0
10,5,283,17,28,-11
10,5,284,10,15,-5
10,5,285,10,20,-10
10,5,286,32,15,17
10,5,287,28,17,11
10,5,288,10,11,-1
10,5,289,8,13,-5
10,5,290,10,15,-5
10,5,291,2,14,-12
10,5,292,6,18,-12
10,5,293,7,7,0
10,5,294,15,20,-5
10,5,295,10,17,-7
10,5,296,14,13,1
10,5,297,3,16,-13
10,5,298,9,9,0
10,5,299,6,14,-8
10,6,0,12,15,-3
10,6,1,9,8,1
10,6,2,25,16,9
10,6,3,11,8,3
10,6,4,7,12,-5
10,6,5,13,13,0
10,6,6,22,21,1
10,6,7,16,15,1
10,6,8,10,12,-2
10,6,9,7,14,-7
10,6,10,25,22,3
10,6,11,12,13,-1
10,6,12,12,11,1
10,6,13,11,16,-5
10,6,14,8,11,-3
10,6,15,8,9,-1
10,6,16,11,14,-3
10,6,17,4,11,-7
10,6,18,4,13,-9
10,6,19,10,17,-7
10,6,20,15,21,-6
10,6,21,19,23,-4
10,6,22,8,8,0
10,6,23,12,29,-17
10,6,24,12,27,-15
10,6,25,13,4,9
10,6,26,11,17,-6
10,6,27,12,13,-1
10,6,28,11,12,-1
10,6,29,13,22,-9
10,6,30,23,25,-2
10,6,31,9,8,1
10,6,32,11,27,-16
10,6,33,16,17,-1
10,6,34,14,18,-4
10,6,35,17,20,-3
10,6,36,12,8,4
10,6,37,30,21,9
10,6,38,22,11,11
10,6,39,12,6,6
10,6,40,13,11,2
10,6,41,9,27,-18
10,6,42,22,13,9
10,6,43,7,13,-6
10,6,44,7,15,-8
10,6,45,10,16,-6
10,6,46,11,19,-8
10,6,47,16,21,-5
10,6,48,15,25,-10
10,6,49,7,8,-1
10,6,50,8,16,-8
10,6,51,17,14,3
10,6,52,9,15,-6
10,6,53,14,13,1
10,6,54,19,19,0
10,6,55,16,9,7
10,6,56,13,20,-7
10,6,57,15,5,10
10,6,58,17,29,-12
10,6,59,12,17,-5
10,6,60,9,10,-1
10,6,61,17,15,2
10,6,62,20,11,9
10,6,63,19,9,10
10,6,64,10,25,-15
10,6,65,18,20,-2
10,6,66,23,27,-4
10,6,67,16,21,-5
10,6,68,18,23,-5
10,6,69,10,13,-3
10,6,70,10,12,-2
10,6,71,12,14,-2
10,6,72,12,13,-1
10,6,73,18,9,9
10,6,74,20,34,-14
10,6,75,16,24,-8
10,6,76,6,17,-11
10,6,77,10,13,-3
10,6,78,6,13,-7
10,6,79,8,15,-7
10,6,80,11,17,-6
10,6,81,11,14,-3
10,6,82,10,17,-7
10,6,83,10,8,2
10,6,84,12,17,-5
10,6,85,19,16,3
10,6,86,10,23,-13
10,6,87,7,11,-4
10,6,88,16,19,-3
10,6,89,10,13,-3
10,6,90,6,16,-10
10,6,91,6,12,-6
10,6,92,6,8,-2
10,6,93,6,12,-6
10,6,94,8,9,-1
10,6,95,15,9,6
10,6,96,23,23,0
10,6,97,6,8,-2
10,6,98,14,9,5
10,6,99,6,21,-15
10,6,100,10,22,-12
10,6,101,11,31,-20
10,6,102,10,19,-9
10,6,103,21,19,2
10,6,104,7,9,-2
10,6,105,16,18,-2
10,6,106,23,40,-17
10,6,107,19,13,6
10,6,108,13,19,-6
10,6,109,16,7,9
10,6,110,8,20,-12
10,6,111,16,18,-2
10,6,112,14,21,-7
10,6,113,9,7,2
10,6,114,13,23,-10
10,6,115,6,6,0
10,6,116,11,14,-3
10,6,117,9,20,-11
10,6,118,9,23,-14
10,6,119,18,19,-1
10,6,120,14,12,2
10,6,121,15,26,-11
10,6,122,9,16,-7
10,6,123,12,27,-15
10,6,124,11,12,-1
10,6,125,9,15,-6
10,6,126,13,16,-3
10,6,127,8,20,-12
10,6,128,6,8,-2
10,6,129,10,20,-10
10,6,130,17,18,-1
10,6,131,14,11,3
10,6,132,14,18,-4
10,6,133,11,22,-11
10,6,134,14,12,2
10,6,135,9,16,-7
10,6,136,19,17,2
10,6,137,12,27,-15
10,6,138,12,24,-12
10,6,139,7,5,2
10,6,140,12,39,-27
10,6,141,17,31,-14
10,6,142,12,27,-15
10,6,143,20,10,10
10,6,144,8,14,-6
10,6,145,5,18,-13
10,6,146,9,18,-9
10,6,147,8,6,2
10,6,148,9,26,-17
10,6,149,9,6,3
10,6,150,15,13,2
10,6,151,7,14,-7
10,6,152,15,16,-1
10,6,153,15,19,-4
10,6,154,19,7,12
10,6,155,8,22,-14
10,6,156,5,27,-22
10,6,157,26,13,13
10,6,158,5,7,-2
10,6,159,15,18,-3
10,6,160,3,5,-2
10,6,161,15,22,-7
10,6,162,20,16,4
10,6,163,13,18,-5
10,6,164,19,20,-1
10,6,165,14,10,4
10,6,166,13,16,-3
10,6,167,26,16,10
10,6,168,14,18,-4
10,6,169,4,6,-2
10,6,170,14,48,-34
10,6,171,6,7,-1
10,6,172,11,5,6
10,6,173,20,12,8
10,6,174,15,14,1
10,6,175,20,14,6
10,6,176,16,28,-12
10,6,177,15,9,6
10,6,178,23,13,10
10,6,179,3,17,-14
10,6,180,24,23,1
10,6,181,12,13,-1
10,6,182,13,16,-3
10,6,183,19,13,6
10,6,184,18,11,7
10,6,185,22,20,2
10,6,186,13,8,5
10,6,187,18,11,7
10,6,188,12,19,-7
10,6,189,16,18,-2
10,6,190,13,19,-6
10,6,191,9,12,-3
10,6,192,10,14,-4
10,6,193,19,9,10
10,6,194,19,10,9
10,6,195,11,13,-2
10,6,196,18,20,-2
10,6,197,5,11,-6
10,6,198,8,18,-10
10,6,199,14,15,-1
10,6,200,9,15,-6
10,6,201,22,18,4
10,6,202,21,16,5
10,6,203,10,8,2
10,6,204,27,15,12
10,6,205,25,15,10
10,6,206,7,25,-18
10,6,207,9,9,0
10,6,208,12,34,-22
10,6,209,10,11,-1
10,6,210,12,11,1
10,6,211,18,17,1
10,6,212,15,12,3
10,6,213,17,25,-8
10,6,214,11,19,-8
10,6,215,11,12,-1
10,6,216,12,14,-2
10,6,217,20,16,4
10,6,218,19,17,2
10,6,219,26,21,5
10,6,220,7,24,-17
10,6,221,9,16,-7
10,6,222,15,9,6
10,6,223,9,6,3
10,6,224,15,17,-2
10,6,225,12,10,2
10,6,226,22,18,4
10,6,227,28,24,4
10,6,228,23,21,2
10,6,229,17,21,-4
10,6,230,15,10,5
10,6,231,11,8,3
10,6,232,12,11,1
10,6,233,6,22,-16
10,6,234,15,23,-8
10,6,235,14,10,4
10,6,236,10,13,-3
10,6,237,19,23,-4
10,6,238,10,17,-7
10,6,239,27,23,4
10,6,240,22,12,10
10,6,241,14,11,3
10,6,242,12,12,0
10,6,243,25,24,1
10,6,244,18,18,0
10,6,245,9,14,-5
10,6,246,18,8,10
10,6,247,28,20,8
10,6,248,14,8,6
10,6,249,12,21,-9
10,6,250,16,21,-5
10,6,251,4,20,-16
10,6,252,23,25,-2
10,6,253,26,12,14
10,6,254,16,23,-7
10,6,255,13,5,8
10,6,256,10,25,-15
10,6,257,21,12,9
10,6,258,21,14,7
10,6,259,16,30,-14
10,6,260,8,21,-13
10,6,261,14,20,-6
10,6,262,15,20,-5
10,6,263,13,23,-10
10,6,264,22,23,-1
10,6,265,7,19,-12
10,6,266,20,30,-10
10,6,267,13,26,-13
10,6,268,12,13,-1
10,6,269,6,12,-6
10,6,270,14,16,-2
10,6,271,8,17,-9
10,6,272,13,34,-21
10,6,273,15,32,-17
10,6,274,12,11,1
10,6,275,1,7,-6
10,6,276,12,14,-2
10,6,277,7,11,-4
10,6,278,16,14,2
10,6,279,12,15,-3
10,6,280,14,20,-6
10,6,281,4,22,-18
10,6,282,5,9,-4
10,6,283,12,15,-3
10,6,284,27,13,14
10,6,285,14,11,3
10,6,286,16,27,-11
10,6,287,8,13,-5
10,6,288,14,23,-9
10,6,289,21,17,4
10,6,290,14,16,-2
10,6,291,11,16,-5
10,6,292,20,23,-3
10,6,293,11,15,-4
10,6,294,10,13,-3
10,6,295,13,18,-5
10,6,296,16,8,8
10,6,297,16,14,2
10,6,298,11,18,-7
10,6,299,17,18,-1
10,7,0,12,14,-2
10,7,1,12,13,-1
10,7,2,15,26,-11
10,7,3,18,27,-9
10,7,4,22,14,8
10,7,5,12,17,-5
10,7,6,18,18,0
10,7,7,16,18,-2
10,7,8,15,12,3
10,7,9,7,24,-17
10,7,10,21,17,4
10,7,11,12,18,-6
10,7,12,8,20,-12
10,7,13,9,25,-16
10,7,14,8,12,-4
10,7,15,6,9,-3
10,7,16,12,10,2
10,7,17,10,17,-7
10,7,18,24,27,-3
10,7,19,24,16,8
10,7,20,24,31,-7
10,7,21,15,10,5
10,7,22,11,25,-14
10,7,23,14,22,-8
10,7,24,16,28,-12
10,7,25,17,17,0
10,7,26,16,26,-10
10,7,27,5,18,-13
10,7,28,4,17,-13
10,7,29,15,13,2
10,7,30,24,22,2
10,7,31,15,20,-5
10,7,32,19,12,7
10,7,33,10,15,-5
10,7,34,15,11,4
10,7,35,11,19,-8
10,7,36,10,16,-6
10,7,37,11,16,-5
10,7,38,23,21,2
10,7,39,10,19,-9
10,7,40,23,17,6
10,7,41,16,19,-3
10,7,42,12,24,-12
10,7,43,11,19,-8
10,7,44,9,13,-4
10,7,45,13,27,-14
10,7,46,9,26,-17
10,7,47,22,24,-2
10,7,48,6,15,-9
10,7,49,12,10,2
10,7,50,14,8,6
10,7,51,21,11,10
10,7,52,12,15,-3
10,7,53,12,18,-6
10,7,54,14,11,3
10,7,55,18,6,12
10,7,56,34,22,12
10,7,57,12,15,-3
10,7,58,16,23,-7
10,7,59,16,8,8
10,7,60,10,11,-1
10,7,61,13,15,-2
10,7,62,7,14,-7
10,7,63,12,17,-5
10,7,64,5,8,-3
10,7,65,10,4,6
10,7,66,11,13,-2
10,7,67,17,13,4
10,7,68,16,14,2
10,7,69,16,15,1
10,7,70,17,38,-21
10,7,71,26,24,2
10,7,72,6,7,-1
10,7,73,11,18,-7
10,7,74,8,23,-15
10,7,75,18,20,-2
10,7,76,21,19,2
10,7,77,15,15,0
10,7,78,11,25,-14
10,7,79,12,18,-6
10,7,80,20,32,-12
10,7,81,14,10,4
10,7,82,14,22,-8
10,7,83,3,11,-8
10,7,84,6,10,-4
10,7,85,11,19,-8
10,7,86,16,18,-2
10,7,87,20,19,1
10,7,88,17,23,-6
10,7,89,25,26,-1
10,7,90,15,30,-15
10,7,91,11,40,-29
10,7,92,8,9,-1
10,7,93,28,18,10
10,7,94,11,6,5
10,7,95,7,7,0
10,7,96,15,18,-3
10,7,97,13,8,5
10,7,98,10,5,5
10,7,99,13,17,-4
10,7,100,8,10,-2
10,7,101,11,20,-9
10,7,102,11,15,-4
10,7,103,15,14,1
10,7,104,12,13,-1
10,7,105,9,11,-2
10,7,106,8,9,-1
10,7,107,10,4,6
10,7,108,8,16,-8
10,7,109,12,18,-6
10,7,110,14,13,1
10,7,111,5,6,-1
10,7,112,20,15,5
10,7,113,11,17,-6
10,7,114,11,10,1
10,7,115,30,30,0
10,7,116,28,26,2
10,7,117,13,31,-18
10,7,118,3,13,-10
10,7,119,19,10,9
10,7,120,15,11,4
10,7,121,14,22,-8
10,7,122,10,22,-12
10,7,123,28,21,7
10,7,124,13,13,0
10,7,125,24,26,-2
10,7,126,8,22,-14
10,7,127,16,24,-8
10,7,128,14,10,4
10,7,129,13,18,-5
10,7,130,6,15,-9
10,7,131,12,9,3
10,7,132,14,12,2
10,7,133,20,25,-5
10,7,134,15,12,3
10,7,135,11,17,-6
10,7,136,13,23,-10
10,7,137,19,22,-3
10,7,138,12,8,4
10,7,139,17,15,2
10,7,140,11,12,-1
10,7,141,12,14,-2
10,7,142,16,16,0
10,7,143,11,14,-3
10,7,144,7,14,-7
10,7,145,14,20,-6
10,7,146,20,17,3
10,7,147,15,21,-6
10,7,148,18,30,-12
10,7,149,7,21,-14
10,7,150,9,9,0
10,7,151,12,21,-9
10,7,152,8,16,-8
10,7,153,14,12,2
10,7,154,15,13,2
10,7,155,11,13,-2
10,7,156,7,24,-17
10,7,157,5,14,-9
10,7,158,17,14,3
10,7,159,11,18,-7
10,7,160,16,10,6
10,7,161,6,14,-8
10,7,162,14,22,-8
10,7,163,14,17,-3
10,7,164,24,16,8
10,7,165,15,14,1
10,7,166,11,14,-3
10,7,167,14,12,2
10,7,168,13,21,-8
10,7,169,10,10,0
10,7,170,15,17,-2
10,7,171,7,19,-12
10,7,172,11,19,-8
10,7,173,8,37,-29
10,7,174,7,15,-8
10,7,175,18,12,6
10,7,176,18,17,1
10,7,177,13,7,6
10,7,178,13,25,-12
10,7,179,23,22,1
10,7,180,19,23,-4
10,7,181,17,17,0
10,7,182,15,24,-9
10,7,183,21,21,0
10,7,184,11,7,4
10,7,185,5,16,-11
10,7,186,20,5,15
10,7,187,5,13,-8
10,7,188,8,16,-8
10,7,189,7,16,-9
10,7,190,23,21,2
10,7,191,13,11,2
10,7,192,9,11,-2
10,7,193,8,19,-11
10,7,194,9,20,-11
10,7,195,7,6,1
10,7,196,10,13,-3
10,7,197,21,13,8
10,7,198,12,10,2
10,7,199,12,12,0
10,7,200,9,9,0
10,7,201,20,16,4
10,7,202,5,8,-3
10,7,203,16,14,2
10,7,204,15,26,-11
10,7,205,15,14,1
10,7,206,9,14,-5
10,7,207,10,9,1
10,7,208,15,15,0
10,7,209,8,6,2
10,7,210,13,21,-8
10,7,211,13,23,-10
10,7,212,14,15,-1
10,7,213,9,8,1
10,7,214,8,10,-2
10,7,215,4,8,-4
10,7,216,21,9,12
10,7,217,21,9,12
10,7,218,14,8,6
10,7,219,13,9,4
10,7,220,12,10,2
10,7,221,20,27,-7
10,7,222,14,26,-12
10,7,223,14,24,-10
10,7,224,17,22,-5
10,7,225,12,17,-5
10,7,226,25,20,5
10,7,227,13,6,7
10,7,228,15,11,4
10,7,229,14,20,-6
10,7,230,14,22,-8
10,7,231,16,28,-12
10,7,232,17,10,7
10,7,233,14,16,-2
10,7,234,18,26,-8
10,7,235,21,29,-8
10,7,236,24,12,12
10,7,237,19,12,7
10,7,238,12,21,-9
10,7,239,13,21,-8
10,7,240,4,16,-12
10,7,241,12,16,-4
10,7,242,30,22,8
10,7,243,6,15,-9
10,7,244,7,14,-7
10,7,245,7,24,-17
10,7,246,13,17,-4
10,7,247,24,15,9
10,7,248,10,9,1
10,7,249,25,29,-4
10,7,250,19,18,1
10,7,251,15,19,-4
10,7,252,10,19,-9
10,7,253,8,6,2
10,7,254,24,24,0
10,7,255,15,16,-1
10,7,256,15,27,-12
10,7,257,10,13,-3
10,7,258,16,14,2
10,7,259,7,17,-10
10,7,260,11,20,-9
10,7,261,5,20,-15
10,7,262,20,22,-2
10,7,263,11,13,-2
10,7,264,22,18,4
10,7,265,17,20,-3
10,7,266,14,12,2
10,7,267,9,16,-7
10,7,268,6,12,-6
10,7,269,5,17,-12
10,7,270,17,24,-7
10,7,271,26,33,-7
10,7,272,11,6,5
10,7,273,9,7,2
10,7,274,12,17,-5
10,7,275,7,8,-1
10,7,276,30,17,13
10,7,277,8,20,-12
10,7,278,7,10,-3
10,7,279,12,9,3
10,7,280,12,12,0
10,7,281,11,13,-2
10,7,282,18,13,5
10,7,283,9,17,-8
10,7,284,11,17,-6
10,7,285,7,28,-21
10,7,286,22,12,10
10,7,287,18,14,4
10,7,288,24,14,10
10,7,289,24,12,12
10,7,290,15,22,-7
10,7,291,12,23,-11
10,7,292,14,25,-11
10,7,293,9,15,-6
10,7,294,24,17,7
10,7,295,27,24,3
10,7,296,25,20,5
10,7,297,6,23,-17
10,7,298,23,17,6
10,7,299,8,18,-10
10,8,0,11,12,-1
10,8,1,17,9,8
10,8,2,20,22,-2
10,8,3,4,10,-6
10,8,4,13,7,6
10,8,5,13,28,-15
10,8,6,10,18,-8
10,8,7,29,13,16
10,8,8,15,13,2
10,8,9,14,15,-1
10,8,10,17,13,4
10,8,11,22,17,5
10,8,12,6,2,4
10,8,13,15,27,-12
10,8,14,14,16,-2
10,8,15,21,17,4
10,8,16,19,13,6
10,8,17,26,23,3
10,8,18,20,10,10
10,8,19,16,19,-3
10,8,20,17,24,-7
10,8,21,12,15,-3
10,8,22,12,17,-5
10,8,23,27,20,7
10,8,24,4,6,-2
10,8,25,10,13,-3
10,8,26,8,18,-10
10,8,27,16,18,-2
10,8,28,13,21,-8
10,8,29,15,16,-1
10,8,30,17,16,1
10,8,31,15,17,-2
10,8,32,17,15,2
10,8,33,12,20,-8
10,8,34,14,27,-13
10,8,35,12,12,0
10,8,36,10,30,-20
10,8,37,9,17,-8
10,8,38,23,22,1
10,8,39,36,29,7
10,8,40,11,23,-12
10,8,41,20,12,8
10,8,42,13,25,-12
10,8,43,6,7,-1
10,8,44,15,22,-7
10,8,45,16,7,9
10,8,46,15,31,-16
10,8,47,14,19,-5
10,8,48,26,17,9
10,8,49,15,9,6
10,8,50,12,21,-9
10,8,51,15,16,-1
10,8,52,19,13,6
10,8,53,4,11,-7
10,8,54,12,20,-8
10,8,55,7,8,-1
10,8,56,12,21,-9
10,8,57,25,21,4
10,8,58,24,14,10
10,8,59,15,15,0
10,8,60,22,19,3
10,8,61,8,7,1
10,8,62,7,14,-7
10,8,63,11,25,-14
10,8,64,16,3,13
10,8,65,10,27,-17
10,8,66,20,6,14
10,8,67,8,17,-9
10,8,68,14,7,7
10,8,69,10,27,-17
10,8,70,12,10,2
10,8,71,18,15,3
10,8,72,18,30,-12
10,8,73,8,24,-16
10,8,74,10,17,-7
10,8,75,8,12,-4
10,8,76,13,8,5
10,8,77,22,24,-2
10,8,78,11,21,-10
10,8,79,21,11,10
10,8,80,7,12,-5
10,8,81,13,22,-9
10,8,82,14,10,4
10,8,83,18,25,-7
10,8,84,20,15,5
10,8,85,25,28,-3
10,8,86,7,4,3
10,8,87,9,14,-5
10,8,88,11,18,-7
10,8,89,18,21,-3
10,8,90,9,21,-12
10,8,91,16,10,6
10,8,92,12,18,-6
10,8,93,9,22,-13
10,8,94,22,22,0
10,8,95,12,22,-10
10,8,96,18,8,10
10,8,97,15,28,-13
10,8,98,10,11,-1
10,8,99,9,13,-4
10,8,100,10,14,-4
10,8,101,32,20,12
10,8,102,24,22,2
10,8,103,11,10,1
10,8,104,7,11,-4
10,8,105,8,11,-3
10,8,106,13,18,-5
10,8,107,10,24,-14
10,8,108,21,12,9
10,8,109,19,10,9
10,8,110,17,28,-11
10,8,111,16,18,-2
10,8,112,9,18,-9
10,8,113,13,24,-11
10,8,114,8,6,2
10,8,115,15,28,-13
10,8,116,7,6,1
10,8,117,13,14,-1
10,8,118,13,4,9
10,8,119,13,12,1
10,8,120,15,20,-5
10,8,121,13,19,-6
10,8,122,9,8,1
10,8,123,8,14,-6
10,8,124,19,17,2
10,8,125,12,15,-3
10,8,126,11,23,-12
10,8,127,12,14,-2
10,8,128,11,11,0
10,8,129,3,7,-4
10,8,130,20,12,8
10,8,131,9,7,2
10,8,132,13,9,4
10,8,133,13,11,2
10,8,134,3,14,-11
10,8,135,10,2,8
10,8,136,14,21,-7
10,8,137,15,21,-6
10,8,138,15,15,0
10,8,139,8,6,2
10,8,140,19,16,3
10,8,141,24,17,7
10,8,142,17,14,3
10,8,143,22,16,6
10,8,144,15,22,-7
10,8,145,9,10,-1
10,8,146,10,14,-4
10,8,147,23,12,11
10,8,148,8,17,-9
10,8,149,10,18,-8
10,8,150,9,21,-12
10,8,151,22,13,9
10,8,152,14,11,3
10,8,153,14,19,-5
10,8,154,12,16,-4
10,8,155,10,17,-7
10,8,156,19,15,4
10,8,157,16,17,-1
10,8,158,8,13,-5
10,8,159,10,5,5
10,8,160,12,5,7
10,8,161,4,2,2
10,8,162,12,19,-7
10,8,163,3,12,-9
10,8,164,11,17,-6
10,8,165,20,14,6
10,8,166,15,18,-3
10,8,167,18,22,-4
10,8,168,12,22,-10
10,8,169,13,4,9
10,8,170,12,18,-6
10,8,171,8,16,-8
10,8,172,9,15,-6
10,8,173,14,17,-3
10,8,174,16,18,-2
10,8,175,18,16,2
10,8,176,10,21,-11
10,8,177,17,13,4
10,8,178,20,14,6
10,8,179,13,14,-1
10,8,180,5,8,-3
10,8,181,19,20,-1
10,8,182,17,10,7
10,8,183,12,19,-7
10,8,184,11,9,2
10,8,185,9,28,-19
10,8,186,13,20,-7
10,8,187,16,21,-5
10,8,188,12,20,-8
10,8,189,5,5,0
10,8,190,8,27,-19
10,8,191,6,14,-8
10,8,192,14,14,0
10,8,193,10,13,-3
10,8,194,16,24,-8
10,8,195,19,26,-7
10,8,196,18,13,5
10,8,197,11,17,-6
10,8,198,11,18,-7
10,8,199,8,22,-14
10,8,200,17,23,-6
10,8,201,21,17,4
10,8,202,7,15,-8
10,8,203,9,20,-11
10,8,204,11,21,-10
10,8,205,18,15,3
10,8,206,8,6,2
10,8,207,10,8,2
10,8,208,29,10,19
10,8,209,3,6,-3
10,8,210,16,25,-9
10,8,211,24,5,19
10,8,212,6,10,-4
10,8,213,12,24,-12
10,8,214,13,18,-5
10,8,215,15,13,2
10,8,216,10,21,-11
10,8,217,10,19,-9
10,8,218,6,13,-7
10,8,219,14,14,0
10,8,220,20,25,-5
10,8,221,6,11,-5
10,8,222,17,14,3
10,8,223,21,21,0
10,8,224,15,19,-4
10,8,225,9,27,-18
10,8,226,22,17,5
10,8,227,18,16,2
10,8,228,16,21,-5
10,8,229,10,14,-4
10,8,230,10,23,-13
10,8,231,7,11,-4
10,8,232,12,18,-6
10,8,233,16,22,-6
10,8,234,14,11,3
10,8,235,11,25,-14
10,8,236,5,14,-9
10,8,237,17,26,-9
10,8,238,11,8,3
10,8,239,27,15,12
10,8,240,8,9,-1
10,8,241,28,25,3
10,8,242,11,14,-3
10,8,243,5,8,-3
10,8,244,7,13,-6
10,8,245,19,8,11
10,8,246,10,7,3
10,8,247,15,15,0
10,8,248,11,11,0
10,8,249,7,24,-17
10,8,250,9,9,0
10,8,251,11,16,-5
10,8,252,5,13,-8
10,8,253,14,16,-2
10,8,254,10,9,1
10,8,255,21,12,9
10,8,256,6,16,-10
10,8,257,9,12,-3
10,8,258,10,20,-10
10,8,259,14,19,-5
10,8,260,10,17,-7
10,8,261,10,16,-6
10,8,262,16,18,-2
10,8,263,15,24,-9
10,8,264,13,18,-5
10,8,265,20,17,3
10,8,266,17,9,8
10,8,267,12,11,1
10,8,268,18,16,2
10,8,269,17,25,-8
10,8,270,10,19,-9
10,8,271,15,17,-2
10,8,272,13,14,-1
10,8,273,29,18,11
10,8,274,15,12,3
10,8,275,9,16,-7
10,8,276,12,20,-8
10,8,277,6,7,-1
10,8,278,12,16,-4
10,8,279,20,12,8
10,8,280,14,13,1
10,8,281,8,17,-9
10,8,282,13,19,-6
10,8,283,15,11,4
10,8,284,18,15,3
10,8,285,32,11,21
10,8,286,18,17,1
10,8,287,18,22,-4
10,8,288,14,11,3
10,8,289,15,18,-3
10,8,290,14,15,-1
10,8,291,10,21,-11
10,8,292,12,31,-19
10,8,293,7,6,1
10,8,294,10,5,5
10,8,295,20,19,1
10,8,296,14,14,0
10,8,297,13,21,-8
10,8,298,13,18,-5
10,8,299,23,14,9
10,9,0,9,24,-15
10,9,1,20,25,-5
10,9,2,5,9,-4
10,9,3,11,16,-5
10,9,4,17,20,-3
10,9,5,3,9,-6
10,9,6,8,10,-2
10,9,7,8,13,-5
10,9,8,19,15,4
10,9,9,9,12,-3
10,9,10,16,18,-2
10,9,11,8,13,-5
10,9,12,12,10,2
10,9,13,13,15,-2
10,9,14,12,16,-4
10,9,15,27,30,-3
10,9,16,22,11,11
10,9,17,14,10,4
10,9,18,5,15,-10
10,9,19,16,16,0
10,9,20,12,23,-11
10,9,21,13,14,-1
10,9,22,5,6,-1
10,9,23,23,17,6
10,9,24,21,13,8
10,9,25,23,10,13
10,9,26,13,12,1
10,9,27,17,22,-5
10,9,28,10,19,-9
10,9,29,15,7,8
10,9,30,26,25,1
10,9,31,7,10,-3
10,9,32,11,17,-6
10,9,33,4,12,-8
10,9,34,17,14,3
10,9,35,24,22,2
10,9,36,15,23,-8
10,9,37,22,35,-13
10,9,38,19,8,11
10,9,39,16,21,-5
10,9,40,21,18,3
10,9,41,9,12,-3
10,9,42,15,21,-6
10,9,43,7,5,2
10,9,44,10,12,-2
10,9,45,12,19,-7
10,9,46,7,9,-2
10,9,47,11,15,-4
10,9,48,14,12,2
10,9,49,9,16,-7
10,9,50,26,15,11
10,9,51,8,10,-2
10,9,52,12,15,-3
10,9,53,15,12,3
10,9,54,15,15,0
10,9,55,12,12,0
10,9,56,28,17,11
10,9,57,21,20,1
10,9,58,10,21,-11
10,9,59,12,11,1
10,9,60,9,20,-11
10,9,61,5,12,-7
10,9,62,6,15,-9
10,9,63,17,22,-5
10,9,64,16,14,2
10,9,65,9,13,-4
10,9,66,13,17,-4
10,9,67,9,17,-8
10,9,68,5,9,-4
10,9,69,15,13,2
10,9,70,20,10,10
10,9,71,18,8,10
10,9,72,7,20,-13
10,9,73,8,17,-9
10,9,74,17,17,0
10,9,75,9,13,-4
10,9,76,24,11,13
10,9,77,24,22,2
10,9,78,11,19,-8
10,9,79,19,16,3
10,9,80,22,13,9
10,9,81,15,18,-3
10,9,82,12,10,2
10,9,83,5,11,-6
10,9,84,14,18,-4
10,9,85,21,10,11
10,9,86,12,16,-4
10,9,87,9,20,-11
10,9,88,12,11,1
10,9,89,11,19,-8
10,9,90,21,10,11
10,9,91,26,30,-4
10,9,92,16,22,-6
10,9,93,9,17,-8
10,9,94,20,13,7
10,9,95,15,24,-9
10,9,96,9,12,-3
10,9,97,10,10,0
10,9,98,15,24,-9
10,9,99,27,26,1
10,9,100,22,17,5
10,9,101,13,8,5
10,9,102,6,12,-6
10,9,103,18,18,0
10,9,104,13,17,-4
10,9,105,5,7,-2
10,9,106,11,21,-10
10,9,107,15,17,-2
10,9,108,13,21,-8
10,9,109,15,22,-7
10,9,110,3,17,-14
10,9,111,10,11,-1
10,9,112,14,11,3
10,9,113,9,28,-19
10,9,114,17,9,8
10,9,115,10,27,-17
10,9,116,7,18,-11
10,9,117,11,19,-8
10,9,118,14,24,-10
10,9,119,0,16,-16
10,9,120,16,10,6
10,9,121,15,18,-3
10,9,122,18,12,6
10,9,123,10,16,-6
10,9,124,19,18,1
10,9,125,7,17,-10
10,9,126,13,8,5
10,9,127,6,18,-12
10,9,128,15,16,-1
10,9,129,22,11,11
10,9,130,10,10,0
10,9,131,9,16,-7
10,9,132,25,17,8
10,9,133,19,16,3
10,9,134,2,5,-3
10,9,135,5,12,-7
10,9,136,13,16,-3
10,9,137,4,11,-7
10,9,138,17,13,4
10,9,139,9,17,-8
10,9,140,16,12,4
10,9,141,17,17,0
10,9,142,3,13,-10
10,9,143,10,11,-1
10,9,144,14,10,4
10,9,145,9,12,-3
10,9,146,14,19,-5
10,9,147,17,19,-2
10,9,148,13,15,-2
10,9,149,15,13,2
10,9,150,13,22,-9
10,9,151,10,30,-20
10,9,152,4,5,-1
10,9,153,12,8,4
10,9,154,16,21,-5
10,9,155,8,17,-9
10,9,156,10,10,0
10,9,157,10,11,-1
10,9,158,15,16,-1
10,9,159,27,22,5
10,9,160,15,14,1
10,9,161,8,8,0
10,9,162,15,10,5
10,9,163,15,31,-16
10,9,164,15,14,1
10,9,165,16,10,6
10,9,166,17,22,-5
10,9,167,11,26,-15
10,9,168,9,22,-13
10,9,169,18,22,-4
10,9,170,13,27,-14
10,9,171,13,10,3
10,9,172,17,18,-1
10,9,173,33,18,15
10,9,174,11,5,6
10,9,175,20,23,-3
10,9,176,9,11,-2
10,9,177,28,17,11
10,9,178,29,21,8
10,9,179,16,18,-2
10,9,180,10,14,-4
10,9,181,11,18,-7
10,9,182,9,11,-2
10,9,183,16,20,-4
10,9,184,13,12,1
10,9,185,20,16,4
10,9,186,23,19,4
10,9,187,7,14,-7
10,9,188,24,27,-3
10,9,189,13,12,1
10,9,190,13,13,0
10,9,191,10,10,0
10,9,192,9,13,-4
10,9,193,22,21,1
10,9,194,10,6,4
10,9,195,19,10,9
10,9,196,10,10,0
10,9,197,22,28,-6
10,9,198,5,12,-7
10,9,199,24,19,5
10,9,200,17,15,2
10,9,201,14,20,-6
10,9,202,26,17,9
10,9,203,19,30,-11
10,9,204,9,25,-16
10,9,205,17,13,4
10,9,206,15,23,-8
10,9,207,14,29,-15
10,9,208,24,28,-4
10,9,209,15,19,-4
10,9,210,15,10,5
10,9,211,10,9,1
10,9,212,18,9,9
10,9,213,15,11,4
10,9,214,25,17,8
10,9,215,10,15,-5
10,9,216,8,22,-14
10,9,217,8,11,-3
10,9,218,11,15,-4
10,9,219,14,21,-7
10,9,220,15,13,2
10,9,221,10,17,-7
10,9,222,17,9,8
10,9,223,18,14,4
10,9,224,24,19,5
10,9,225,12,16,-4
10,9,226,17,8,9
10,9,227,11,17,-6
10,9,228,30,16,14
10,9,229,10,18,-8
10,9,230,3,24,-21
10,9,231,16,17,-1
10,9,232,14,16,-2
10,9,233,19,17,2
10,9,234,22,17,5
10,9,235,5,15,-10
10,9,236,10,14,-4
10,9,237,12,17,-5
10,9,238,12,10,2
10,9,239,8,7,1
10,9,240,11,27,-16
10,9,241,30,32,-2
10,9,242,9,15,-6
10,9,243,12,22,-10
10,9,244,10,14,-4
10,9,245,17,17,0
10,9,246,9,7,2
10,9,247,14,16,-2
10,9,248,12,23,-11
10,9,249,12,17,-5
10,9,250,2,7,-5
10,9,251,13,14,-1
10,9,252,13,17,-4
10,9,253,18,23,-5
10,9,254,17,9,8
10,9,255,13,6,7
10,9,256,20,12,8
10,9,257,11,12,-1
10,9,258,10,12,-2
10,9,259,16,23,-7
10,9,260,15,11,4
10,9,261,5,7,-2
10,9,262,5,21,-16
10,9,263,17,8,9
10,9,264,5,6,-1
10,9,265,19,7,12
10,9,266,7,19,-12
10,9,267,7,18,-11
10,9,268,6,24,-18
10,9,269,15,13,2
10,9,270,7,8,-1
10,9,271,11,9,2
10,9,272,10,6,4
10,9,273,10,13,-3
10,9,274,15,14,1
10,9,275,15,22,-7
10,9,276,22,22,0
10,9,277,18,13,5
10,9,278,18,11,7
10,9,279,21,22,-1
10,9,280,9,30,-21
10,9,281,13,17,-4
10,9,282,18,21,-3
10,9,283,19,17,2
10,9,284,16,16,0
10,9,285,12,14,-2
10,9,286,8,21,-13
10,9,287,22,15,7
10,9,288,9,9,0
10,9,289,15,34,-19
10,9,290,12,20,-8
10,9,291,24,32,-8
10,9,292,35,17,18
10,9,293,13,24,-11
10,9,294,9,11,-2
10,9,295,11,26,-15
10,9,296,24,26,-2
10,9,297,13,14,-1
10,9,298,21,15,6
10,9,299,23,21,2
10,10,0,7,7,0
10,10,1,10,16,-6
10,10,2,11,12,-1
10,10,3,26,17,9
10,10,4,32,23,9
10,10,5,11,27,-16
10,10,6,22,20,2
10,10,7,12,20,-8
10,10,8,13,27,-14
10,10,9,7,12,-5
10,10,10,12,19,-7
10,10,11,23,18,5
10,10,12,20,12,8
10,10,13,14,14,0
10,10,14,15,22,-7
10,10,15,16,11,5
10,10,16,9,16,-7
10,10,17,16,19,-3
10,10,18,9,18,-9
10,10,19,9,11,-2
10,10,20,25,30,-5
10,10,21,9,17,-8
10,10,22,12,17,-5
10,10,23,19,20,-1
10,10,24,19,9,10
10,10,25,20,20,0
10,10,26,21,20,1
10,10,27,19,13,6
10,10,28,17,18,-1
10,10,29,7,21,-14
10,10,30,12,15,-3
10,10,31,18,17,1
10,10,32,17,20,-3
10,10,33,27,17,10
10,10,34,14,15,-1
10,10,35,15,32,-17
10,10,36,19,12,7
10,10,37,6,1,5
10,10,38,21,23,-2
10,10,39,20,20,0
10,10,40,15,21,-6
10,10,41,23,17,6
10,10,42,5,20,-15
10,10,43,21,22,-1
10,10,44,5,20,-15
10,10,45,14,18,-4
10,10,46,13,1,12
10,10,47,17,11,6
10,10,48,16,13,3
10,10,49,16,20,-4
10,10,50,18,11,7
10,10,51,13,28,-15
10,10,52,17,9,8
10,10,53,10,9,1
10,10,54,20,9,11
10,10,55,14,8,6
10,10,56,16,13,3
10,10,57,17,12,5
10,10,58,14,16,-2
10,10,59,20,17,3
10,10,60,22,16,6
10,10,61,26,29,-3
10,10,62,11,14,-3
10,10,63,13,23,-10
10,10,64,24,16,8
10,10,65,13,7,6
10,10,66,7,18,-11
10,10,67,7,26,-19
10,10,68,18,15,3
10,10,69,8,11,-3
10,10,70,13,16,-3
10,10,71,13,11,2
10,10,72,14,17,-3
10,10,73,18,27,-9
10,10,74,25,16,9
10,10,75,15,20,-5
10,10,76,5,3,2
10,10,77,9,15,-6
10,10,78,15,12,3
10,10,79,20,14,6
10,10,80,14,18,-4
10,10,81,7,16,-9
10,10,82,7,10,-3
10,10,83,15,25,-10
10,10,84,23,15,8
10,10,85,24,25,-1
10,10,86,15,15,0
10,10,87,21,26,-5
10,10,88,14,19,-5
10,10,89,10,17,-7
10,10,90,7,19,-12
10,10,91,22,25,-3
10,10,92,14,21,-7
10,10,93,28,21,7
10,10,94,11,15,-4
10,10,95,9,15,-6
10,10,96,23,37,-14
10,10,97,19,14,5
10,10,98,10,6,4
10,10,99,16,22,-6
10,10,100,29,24,5
10,10,101,15,23,-8
10,10,102,5,5,0
10,10,103,8,15,-7
10,10,104,17,8,9
10,10,105,22,17,5
10,10,106,10,37,-27
10,10,107,18,16,2
10,10,108,17,11,6
10,10,109,11,24,-13
10,10,110,8,9,-1
10,10,111,15,19,-4
10,10,112,19,14,5
10,10,113,15,17,-2
10,10,114,6,9,-3
10,10,115,14,13,1
10,10,116,13,19,-6
10,10,117,10,5,5
10,10,118,15,6,9
10,10,119,10,14,-4
10,10,120,17,17,0
10,10,121,11,23,-12
10,10,122,15,15,0
10,10,123,11,17,-6
10,10,124,12,8,4
10,10,125,10,9,1
10,10,126,17,24,-7
10,10,127,6,10,-4
10,10,128,6,12,-6
10,10,129,17,23,-6
10,10,130,11,18,-7
10,10,131,25,17,8
10,10,132,10,15,-5
10,10,133,16,15,1
10,10,134,17,23,-6
10,10,135,13,11,2
10,10,136,5,12,-7
10,10,137,9,12,-3
10,10,138,15,19,-4
10,10,139,13,25,-12
10,10,140,8,7,1
10,10,141,15,29,-14
10,10,142,8,23,-15
10,10,143,33,26,7
10,10,144,15,17,-2
10,10,145,13,15,-2
10,10,146,9,13,-4
10,10,147,14,22,-8
10,10,148,19,17,2
10,10,149,19,13,6
10,10,150,8,18,-10
10,10,151,15,15,0
10,10,152,11,25,-14
10,10,153,21,11,10
10,10,154,15,27,-12
10,10,155,9,11,-2
10,10,156,20,11,9
10,10,157,26,20,6
10,10,158,18,14,4
10,10,159,11,15,-4
10,10,160,14,21,-7
10,10,161,13,23,-10
10,10,162,14,36,-22
10,10,163,14,23,-9
10,10,164,22,14,8
10,10,165,28,19,9
10,10,166,14,8,6
10,10,167,17,22,-5
10,10,168,13,23,-10
10,10,169,10,13,-3
10,10,170,20,25,-5
10,10,171,14,15,-1
10,10,172,10,16,-6
10,10,173,9,25,-16
10,10,174,14,16,-2
10,10,175,13,19,-6
10,10,176,12,10,2
10,10,177,20,16,4
10,10,178,20,12,8
10,10,179,14,13,1
10,10,180,18,9,9
10,10,181,19,14,5
10,10,182,22,13,9
10,10,183,9,13,-4
10,10,184,9,12,-3
10,10,185,7,16,-9
10,10,186,10,16,-6
10,10,187,10,9,1
10,10,188,9,20,-11
10,10,189,15,23,-8
10,10,190,9,12,-3
10,10,191,25,26,-1
10,10,192,10,15,-5
10,10,193,7,6,1
10,10,194,9,5,4
10,10,195,20,25,-5
10,10,196,13,14,-1
10,10,197,30,17,13
10,10,198,16,16,0
10,10,199,21,17,4
10,10,200,16,10,6
10,10,201,16,21,-5
10,10,202,16,6,10
10,10,203,24,16,8
10,10,204,24,5,19
10,10,205,20,11,9
10,10,206,14,21,-7
10,10,207,27,27,0
10,10,208,21,20,1
10,10,209,18,28,-10
10,10,210,16,18,-2
10,10,211,15,22,-7
10,10,212,9,14,-5
10,10,213,7,12,-5
10,10,214,10,17,-7
10,10,215,17,14,3
10,10,216,23,25,-2
10,10,217,16,19,-3
10,10,218,10,31,-21
10,10,219,9,20,-11
10,10,220,16,17,-1
10,10,221,12,29,-17
10,10,222,14,10,4
10,10,223,8,10,-2
10,10,224,16,19,-3
10,10,225,22,24,-2
10,10,226,19,25,-6
10,10,227,18,38,-20
10,10,228,29,11,18
10,10,229,19,17,2
10,10,230,14,15,-1
10,10,231,20,23,-3
10,10,232,14,14,0
10,10,233,4,24,-20
10,10,234,10,21,-11
10,10,235,6,6,0
10,10,236,19,22,-3
10,10,237,14,22,-8
10,10,238,9,20,-11
10,10,239,15,17,-2
10,10,240,14,12,2
10,10,241,5,5,0
10,10,242,13,29,-16
10,10,243,10,15,-5
10,10,244,17,31,-14
10,10,245,12,21,-9
10,10,246,17,15,2
10,10,247,12,20,-8
10,10,248,30,22,8
10,10,249,16,11,5
10,10,250,20,17,3
10,10,251,8,9,-1
10,10,252,21,11,10
10,10,253,10,15,-5
10,10,254,18,32,-14
10,10,255,10,15,-5
10,10,256,17,12,5
10,10,257,29,17,12
10,10,258,14,24,-10
10,10,259,19,11,8
10,10,260,32,21,11
10,10,261,20,10,10
10,10,262,12,11,1
10,10,263,11,8,3
10,10,264,2,17,-15
10,10,265,9,14,-5
10,10,266,16,15,1
10,10,267,14,21,-7
10,10,268,16,18,-2
10,10,269,21,29,-8
10,10,270,11,16,-5
10,10,271,13,16,-3
10,10,272,22,12,10
10,10,273,13,15,-2
10,10,274,14,23,-9
10,10,275,8,10,-2
10,10,276,17,24,-7
10,10,277,14,13,1
10,10,278,27,13,14
10,10,279,3,13,-10
10,10,280,7,13,-6
10,10,281,11,23,-12
10,10,282,9,24,-15
10,10,283,16,21,-5
10,10,284,11,19,-8
10,10,285,37,23,14
10,10,286,15,30,-15
10,10,287,10,13,-3
10,10,288,18,21,-3
10,10,289,17,14,3
10,10,290,17,8,9
10,10,291,15,12,3
10,10,292,7,10,-3
10,10,293,15,14,1
10,10,294,20,24,-4
10,10,295,25,21,4
10,10,296,9,20,-11
10,10,297,5,11,-6
10,10,298,17,17,0
10,10,299,12,14,-2
10,11,0,11,10,1
10,11,1,6,13,-7
10,11,2,24,20,4
10,11,3,20,13,7
10,11,4,10,9,1
10,11,5,35,16,19
10,11,6,4,19,-15
10,11,7,14,22,-8
10,11,8,11,16,-5
10,11,9,10,8,2
10,11,10,16,8,8
10,11,11,4,6,-2
10,11,12,8,10,-2
10,11,13,3,10,-7
10,11,14,4,8,-4
10,11,15,5,8,-3
10,11,16,7,17,-10
10,11,17,15,18,-3
10,11,18,9,14,-5
10,11,19,13,10,3
10,11,20,23,19,4
10,11,21,10,5,5
10,11,22,14,8,6
10,11,23,15,20,-5
10,11,24,22,31,-9
10,11,25,20,23,-3
10,11,26,15,8,7
10,11,27,18,14,4
10,11,28,26,15,11
10,11,29,20,17,3
10,11,30,26,13,13
10,11,31,14,24,-10
10,11,32,17,22,-5
10,11,33,16,10,6
10,11,34,10,12,-2
10,11,35,4,14,-10
10,11,36,15,13,2
10,11,37,16,18,-2
10,11,38,18,22,-4
10,11,39,10,9,1
10,11,40,14,12,2
10,11,41,19,23,-4
10,11,42,22,24,-2
10,11,43,10,19,-9
10,11,44,11,11,0
10,11,45,17,14,3
10,11,46,17,15,2
10,11,47,10,13,-3
10,11,48,8,9,-1
10,11,49,7,16,-9
10,11,50,19,22,-3
10,11,51,16,12,4
10,11,52,7,11,-4
10,11,53,13,17,-4
10,11,54,14,6,8
10,11,55,19,10,9
10,11,56,17,6,11
10,11,57,17,18,-1
10,11,58,18,13,5
10,11,59,11,16,-5
10,11,60,18,23,-5
10,11,61,6,4,2
10,11,62,9,13,-4
10,11,63,12,14,-2
10,11,64,29,19,10
10,11,65,14,9,5
10,11,66,16,22,-6
10,11,67,7,10,-3
10,11,68,5,6,-1
10,11,69,15,8,7
10,11,70,15,20,-5
10,11,71,15,11,4
10,11,72,27,20,7
10,11,73,18,8,10
10,11,74,28,25,3
10,11,75,20,14,6
10,11,76,6,9,-3
10,11,77,23,21,2
10,11,78,12,8,4
10,11,79,18,9,9
10,11,80,16,19,-3
10,11,81,5,21,-16
10,11,82,14,24,-10
10,11,83,7,26,-19
10,11,84,6,9,-3
10,11,85,6,11,-5
10,11,86,19,23,-4
10,11,87,27,25,2
10,11,88,18,21,-3
10,11,89,15,14,1
10,11,90,5,12,-7
10,11,91,18,12,6
10,11,92,11,11,0
10,11,93,11,2,9
10,11,94,17,22,-5
10,11,95,4,12,-8
10,11,96,24,13,11
10,11,97,11,6,5
10,11,98,16,21,-5
10,11,99,42,15,27
10,11,100,14,21,-7
10,11,101,21,8,13
10,11,102,17,12,5
10,11,103,22,15,7
10,11,104,18,13,5
10,11,105,18,14,4
10,11,106,14,17,-3
10,11,107,12,8,4
10,11,108,11,10,1
10,11,109,10,20,-10
10,11,110,15,11,4
10,11,111,17,7,10
10,11,112,23,16,7
10,11,113,16,18,-2
10,11,114,9,8,1
10,11,115,26,16,10
10,11,116,12,31,-19
10,11,117,11,25,-14
10,11,118,6,10,-4
10,11,119,15,17,-2
10,11,120,23,23,0
10,11,121,25,16,9
10,11,122,6,25,-19
10,11,123,12,23,-11
10,11,124,8,5,3
10,11,125,11,17,-6
10,11,126,14,25,-11
10,11,127,18,18,0
10,11,128,22,7,15
10,11,129,21,19,2
10,11,130,19,27,-8
10,11,131,19,13,6
10,11,132,14,8,6
10,11,133,16,15,1
10,11,134,19,19,0
10,11,135,7,6,1
10,11,136,13,25,-12
10,11,137,12,17,-5
10,11,138,13,18,-5
10,11,139,12,14,-2
10,11,140,11,9,2
10,11,141,12,9,3
10,11,142,23,16,7
10,11,143,10,10,0
10,11,144,19,12,7
10,11,145,29,22,7
10,11,146,12,6,6
10,11,147,12,19,-7
10,11,148,20,17,3
10,11,149,20,13,7
10,11,150,14,21,-7
10,11,151,16,14,2
10,11,152,16,11,5
10,11,153,18,17,1
10,11,154,15,9,6
10,11,155,12,20,-8
10,11,156,19,14,5
10,11,157,23,18,5
10,11,158,13,6,7
10,11,159,13,13,0
10,11,160,16,20,-4
10,11,161,12,15,-3
10,11,162,20,9,11
10,11,163,17,16,1
10,11,164,25,12,13
10,11,165,25,20,5
10,11,166,20,8,12
10,11,167,13,19,-6
10,11,168,17,7,10
10,11,169,12,16,-4
10,11,170,22,24,-2
10,11,171,19,9,10
10,11,172,8,10,-2
10,11,173,15,16,-1
10,11,174,11,10,1
10,11,175,13,17,-4
10,11,176,37,11,26
10,11,177,19,32,-13
10,11,178,13,7,6
10,11,179,11,12,-1
10,11,180,17,12,5
10,11,181,7,7,0
10,11,182,16,11,5
10,11,183,10,18,-8
10,11,184,15,16,-1
10,11,185,11,23,-12
10,11,186,15,11,4
10,11,187,9,14,-5
10,11,188,11,6,5
10,11,189,16,17,-1
10,11,190,11,11,0
10,11,191,13,14,-1
10,11,192,14,8,6
10,11,193,11,17,-6
10,11,194,6,14,-8
10,11,195,33,38,-5
10,11,196,21,17,4
10,11,197,18,21,-3
10,11,198,11,7,4
10,11,199,24,10,14
10,11,200,10,13,-3
10,11,201,14,20,-6
10,11,202,13,16,-3
10,11,203,19,7,12
10,11,204,10,12,-2
10,11,205,19,29,-10
10,11,206,22,9,13
10,11,207,16,5,11
10,11,208,10,22,-12
10,11,209,20,20,0
10,11,210,12,15,-3
10,11,211,19,15,4
10,11,212,7,12,-5
10,11,213,13,22,-9
10,11,214,25,16,9
10,11,215,18,10,8
10,11,216,14,15,-1
10,11,217,15,14,1
10,11,218,10,12,-2
10,11,219,23,20,3
10,11,220,16,29,-13
10,11,221,17,5,12
10,11,222,16,17,-1
10,11,223,8,4,4
10,11,224,13,18,-5
10,11,225,29,28,1
10,11,226,21,17,4
10,11,227,29,23,6
10,11,228,15,17,-2
10,11,229,27,24,3
10,11,230,24,20,4
10,11,231,24,9,15
10,11,232,14,15,-1
10,11,233,18,11,7
10,11,234,12,16,-4
10,11,235,9,9,0
10,11,236,18,16,2
10,11,237,14,6,8
10,11,238,19,14,5
10,11,239,13,15,-2
10,11,240,13,15,-2
10,11,241,12,19,-7
10,11,242,13,8,5
10,11,243,14,4,10
10,11,244,17,24,-7
10,11,245,16,10,6
10,11,246,15,15,0
10,11,247,26,14,12
10,11,248,11,23,-12
10,11,249,21,13,8
10,11,250,15,14,1
10,11,251,13,17,-4
10,11,252,18,14,4
10,11,253,10,5,5
10,11,254,14,10,4
10,11,255,12,12,0
10,11,256,9,9,0
10,11,257,16,19,-3
10,11,258,11,9,2
10,11,259,12,19,-7
10,11,260,15,12,3
10,11,261,9,15,-6
10,11,262,6,6,0
10,11,263,13,7,6
10,11,264,5,14,-9
10,11,265,17,13,4
10,11,266,9,12,-3
10,11,267,15,10,5
10,11,268,18,15,3
10,11,269,20,13,7
10,11,270,9,12,-3
10,11,271,15,16,-1
10,11,272,19,19,0
10,11,273,10,18,-8
10,11,274,24,20,4
10,11,275,17,8,9
10,11,276,10,8,2
10,11,277,13,11,2
10,11,278,8,9,-1
10,11,279,6,16,-10
10,11,280,20,20,0
10,11,281,23,14,9
10,11,282,11,13,-2
10,11,283,14,9,5
10,11,284,12,12,0
10,11,285,21,11,10
10,11,286,18,19,-1
10,11,287,13,15,-2
10,11,288,21,17,4
10,11,289,23,7,16
10,11,290,8,11,-3
10,11,291,12,6,6
10,11,292,16,27,-11
10,11,293,21,18,3
10,11,294,8,21,-13
10,11,295,8,13,-5
10,11,296,18,11,7
10,11,297,13,7,6
10,11,298,11,11,0
10,11,299,12,8,4
10,12,0,11,15,-4
10,12,1,12,15,-3
10,12,2,12,10,2
10,12,3,29,16,13
10,12,4,22,25,-3
10,12,5,23,12,11
10,12,6,14,22,-8
10,12,7,13,19,-6
10,12,8,29,19,10
10,12,9,16,10,6
10,12,10,12,20,-8
10,12,11,3,23,-20
10,12,12,26,14,12
10,12,13,10,20,-10
10,12,14,15,8,7
10,12,15,12,8,4
10,12,16,16,19,-3
10,12,17,17,9,8
10,12,18,29,16,13
10,12,19,10,18,-8
10,12,20,23,16,7
10,12,21,9,10,-1
10,12,22,16,17,-1
10,12,23,9,8,1
10,12,24,4,12,-8
10,12,25,30,17,13
10,12,26,19,10,9
10,12,27,15,12,3
10,12,28,15,18,-3
10,12,29,18,13,5
10,12,30,25,10,15
10,12,31,16,10,6
10,12,32,14,17,-3
10,12,33,6,12,-6
10,12,34,11,13,-2
10,12,35,14,13,1
10,12,36,16,4,12
10,12,37,24,21,3
10,12,38,19,19,0
10,12,39,17,19,-2
10,12,40,14,15,-1
10,12,41,22,12,10
10,12,42,15,20,-5
10,12,43,27,12,15
10,12,44,18,16,2
10,12,45,17,41,-24
10,12,46,10,19,-9
10,12,47,9,8,1
10,12,48,21,24,-3
10,12,49,14,6,8
10,12,50,15,10,5
10,12,51,7,12,-5
10,12,52,13,14,-1
10,12,53,17,11,6
10,12,54,9,15,-6
10,12,55,15,12,3
10,12,56,15,16,-1
10,12,57,15,20,-5
10,12,58,19,14,5
10,12,59,5,5,0
10,12,60,22,18,4
10,12,61,8,15,-7
10,12,62,14,21,-7
10,12,63,17,22,-5
10,12,64,14,17,-3
10,12,65,21,20,1
10,12,66,8,15,-7
10,12,67,16,10,6
10,12,68,9,10,-1
10,12,69,18,25,-7
10,12,70,18,29,-11
10,12,71,20,13,7
10,12,72,29,20,9
10,12,73,20,25,-5
10,12,74,12,20,-8
10,12,75,13,16,-3
10,12,76,24,9,15
10,12,77,22,10,12
10,12,78,23,20,3
10,12,79,13,16,-3
10,12,80,14,12,2
10,12,81,16,10,6
10,12,82,19,15,4
10,12,83,28,21,7
10,12,84,8,2,6
10,12,85,10,18,-8
10,12,86,19,15,4
10,12,87,23,15,8
10,12,88,8,20,-12
10,12,89,12,18,-6
10,12,90,13,16,-3
10,12,91,15,16,-1
10,12,92,12,17,-5
10,12,93,6,12,-6
10,12,94,12,5,7
10,12,95,23,21,2
10,12,96,22,14,8
10,12,97,10,14,-4
10,12,98,16,12,4
10,12,99,12,15,-3
10,12,100,15,12,3
10,12,101,15,11,4
10,12,102,25,17,8
10,12,103,15,24,-9
10,12,104,21,24,-3
10,12,105,17,15,2
10,12,106,23,17,6
10,12,107,15,19,-4
10,12,108,18,19,-1
10,12,109,5,10,-5
10,12,110,19,19,0
10,12,111,14,15,-1
10,12,112,24,25,-1
10,12,113,27,26,1
10,12,114,7,12,-5
10,12,115,23,18,5
10,12,116,16,15,1
10,12,117,15,15,0
10,12,118,16,18,-2
10,12,119,15,9,6
10,12,120,12,19,-7
10,12,121,10,16,-6
10,12,122,17,17,0
10,12,123,12,16,-4
10,12,124,8,14,-6
10,12,125,6,20,-14
10,12,126,21,21,0
10,12,127,14,23,-9
10,12,128,22,12,10
10,12,129,13,27,-14
10,12,130,19,17,2
10,12,131,19,29,-10
10,12,132,14,14,0
10,12,133,13,6,7
10,12,134,12,25,-13
10,12,135,16,21,-5
10,12,136,12,10,2
10,12,137,7,7,0
10,12,138,11,18,-7
10,12,139,23,14,9
10,12,140,14,11,3
10,12,141,24,5,19
10,12,142,16,11,5
10,12,143,23,15,8
10,12,144,16,12,4
10,12,145,20,15,5
10,12,146,16,10,6
10,12,147,21,23,-2
10,12,148,9,15,-6
10,12,149,17,18,-1
10,12,150,15,12,3
10,12,151,18,11,7
10,12,152,8,15,-7
10,12,153,20,27,-7
10,12,154,10,4,6
10,12,155,9,14,-5
10,12,156,17,18,-1
10,12,157,23,23,0
10,12,158,16,13,3
10,12,159,15,18,-3
10,12,160,14,12,2
10,12,161,17,20,-3
10,12,162,22,35,-13
10,12,163,11,15,-4
10,12,164,19,11,8
10,12,165,10,15,-5
10,12,166,20,11,9
10,12,167,26,16,10
10,12,168,19,13,6
10,12,169,16,15,1
10,12,170,18,19,-1
10,12,171,19,14,5
10,12,172,11,12,-1
10,12,173,18,14,4
10,12,174,15,17,-2
10,12,175,13,14,-1
10,12,176,18,16,2
10,12,177,21,5,16
10,12,178,10,13,-3
10,12,179,18,27,-9
10,12,180,21,12,9
10,12,181,18,13,5
10,12,182,11,6,5
10,12,183,12,13,-1
10,12,184,27,8,19
10,12,185,12,18,-6
10,12,186,12,11,1
10,12,187,32,15,17
10,12,188,13,15,-2
10,12,189,11,17,-6
10,12,190,13,14,-1
10,12,191,23,18,5
10,12,192,6,22,-16
10,12,193,20,11,9
10,12,194,8,6,2
10,12,195,13,13,0
10,12,196,23,14,9
10,12,197,15,13,2
10,12,198,22,12,10
10,12,199,17,12,5
10,12,200,14,17,-3
10,12,201,27,13,14
10,12,202,13,12,1
10,12,203,14,24,-10
10,12,204,19,22,-3
10,12,205,11,13,-2
10,12,206,19,17,2
10,12,207,22,18,4
10,12,208,22,19,3
10,12,209,20,23,-3
10,12,210,12,22,-10
10,12,211,23,12,11
10,12,212,20,17,3
10,12,213,10,10,0
10,12,214,9,15,-6
10,12,215,10,26,-16
10,12,216,21,24,-3
10,12,217,12,12,0
10,12,218,18,14,4
10,12,219,23,15,8
10,12,220,20,17,3
10,12,221,16,15,1
10,12,222,12,10,2
10,12,223,10,9,1
10,12,224,13,19,-6
10,12,225,22,19,3
10,12,226,15,11,4
10,12,227,3,11,-8
10,12,228,14,20,-6
10,12,229,17,16,1
10,12,230,18,22,-4
10,12,231,19,20,-1
10,12,232,17,15,2
10,12,233,26,22,4
10,12,234,12,11,1
10,12,235,19,13,6
10,12,236,10,20,-10
10,12,237,9,17,-8
10,12,238,17,12,5
10,12,239,18,12,6
10,12,240,11,9,2
10,12,241,22,6,16
10,12,242,26,17,9
10,12,243,11,17,-6
10,12,244,12,9,3
10,12,245,11,8,3
10,12,246,16,17,-1
10,12,247,20,15,5
10,12,248,25,26,-1
10,12,249,17,18,-1
10,12,250,20,14,6
10,12,251,10,10,0
10,12,252,23,23,0
10,12,253,11,23,-12
10,12,254,19,18,1
10,12,255,12,19,-7
10,12,256,12,18,-6
10,12,257,19,14,5
10,12,258,20,15,5
10,12,259,10,4,6
10,12,260,14,19,-5
10,12,261,22,8,14
10,12,262,16,16,0
10,12,263,17,12,5
10,12,264,10,10,0
10,12,265,21,15,6
10,12,266,22,17,5
10,12,267,14,12,2
10,12,268,13,10,3
10,12,269,11,20,-9
10,12,270,29,31,-2
10,12,271,29,13,16
10,12,272,24,21,3
10,12,273,16,15,1
10,12,274,11,0,11
10,12,275,18,13,5
10,12,276,17,15,2
10,12,277,13,4,9
10,12,278,22,18,4
10,12,279,12,8,4
10,12,280,10,15,-5
10,12,281,18,18,0
10,12,282,12,24,-12
10,12,283,10,12,-2
10,12,284,13,14,-1
10,12,285,18,16,2
10,12,286,27,12,15
10,12,287,14,10,4
10,12,288,20,16,4
10,12,289,9,10,-1
10,12,290,9,16,-7
10,12,291,10,21,-11
10,12,292,22,18,4
10,12,293,21,13,8
10,12,294,20,12,8
10,12,295,22,14,8
10,12,296,13,29,-16
10,12,297,18,11,7
10,12,298,11,7,4
10,12,299,5,9,-4
10,13,0,24,16,8
10,13,1,22,7,15
10,13,2,22,29,-7
10,13,3,24,16,8
10,13,4,14,18,-4
10,13,5,8,10,-2
10,13,6,11,14,-3
10,13,7,23,14,9
10,13,8,18,12,6
10,13,9,15,5,10
10,13,10,14,22,-8
10,13,11,19,20,-1
10,13,12,11,18,-7
10,13,13,19,19,0
10,13,14,13,15,-2
10,13,15,19,5,14
10,13,16,23,14,9
10,13,17,28,28,0
10,13,18,19,17,2
10,13,19,15,24,-9
10,13,20,24,9,15
10,13,21,21,8,13
10,13,22,14,20,-6
10,13,23,24,16,8
10,13,24,9,14,-5
10,13,25,28,25,3
10,13,26,19,13,6
10,13,27,8,24,-16
10,13,28,16,15,1
10,13,29,13,30,-17
10,13,30,27,17,10
10,13,31,12,16,-4
10,13,32,21,25,-4
10,13,33,17,19,-2
10,13,34,12,19,-7
10,13,35,25,17,8
10,13,36,13,22,-9
10,13,37,15,14,1
10,13,38,17,17,0
10,13,39,14,26,-12
10,13,40,16,5,11
10,13,41,9,6,3
10,13,42,20,14,6
10,13,43,22,9,13
10,13,44,9,16,-7
10,13,45,21,15,6
10,13,46,9,24,-15
10,13,47,23,10,13
10,13,48,6,15,-9
10,13,49,10,18,-8
10,13,50,9,11,-2
10,13,51,22,8,14
10,13,52,7,8,-1
10,13,53,12,10,2
10,13,54,6,20,-14
10,13,55,20,21,-1
10,13,56,20,27,-7
10,13,57,7,9,-2
10,13,58,11,4,7
10,13,59,21,19,2
10,13,60,9,21,-12
10,13,61,24,15,9
10,13,62,14,32,-18
10,13,63,12,10,2
10,13,64,13,7,6
10,13,65,27,15,12
10,13,66,6,24,-18
10,13,67,14,15,-1
10,13,68,3,11,-8
10,13,69,18,9,9
10,13,70,10,11,-1
10,13,71,20,13,7
10,13,72,19,20,-1
10,13,73,14,16,-2
10,13,74,20,20,0
10,13,75,17,20,-3
10,13,76,14,10,4
10,13,77,25,25,0
10,13,78,22,19,3
10,13,79,11,14,-3
10,13,80,13,19,-6
10,13,81,14,16,-2
10,13,82,10,22,-12
10,13,83,14,25,-11
10,13,84,11,22,-11
10,13,85,16,17,-1
10,13,86,29,21,8
10,13,87,26,18,8
10,13,88,8,13,-5
10,13,89,12,15,-3
10,13,90,9,6,3
10,13,91,19,20,-1
10,13,92,15,13,2
10,13,93,7,15,-8
10,13,94,11,12,-1
10,13,95,10,17,-7
10,13,96,17,9,8
10,13,97,7,10,-3
10,13,98,14,11,3
10,13,99,11,10,1
10,13,100,10,22,-12
10,13,101,14,12,2
10,13,102,9,14,-5
10,13,103,21,19,2
10,13,104,21,27,-6
10,13,105,14,10,4
10,13,106,14,21,-7
10,13,107,7,9,-2
10,13,108,6,10,-4
10,13,109,12,18,-6
10,13,110,8,15,-7
10,13,111,16,13,3
10,13,112,14,11,3
10,13,113,16,4,12
10,13,114,13,25,-12
10,13,115,16,20,-4
10,13,116,17,11,6
10,13,117,13,20,-7
10,13,118,9,15,-6
10,13,119,10,16,-6
10,13,120,16,8,8
10,13,121,11,14,-3
10,13,122,9,12,-3
10,13,123,12,17,-5
10,13,124,21,9,12
10,13,125,21,18,3
10,13,126,19,15,4
10,13,127,22,15,7
10,13,128,17,7,10
10,13,129,20,12,8
10,13,130,8,6,2
10,13,131,17,12,5
10,13,132,13,21,-8
10,13,133,13,27,-14
10,13,134,1,6,-5
10,13,135,14,13,1
10,13,136,14,13,1
10,13,137,14,13,1
10,13,138,16,15,1
10,13,139,9,15,-6
10,13,140,8,12,-4
10,13,141,21,27,-6
10,13,142,4,7,-3
10,13,143,11,14,-3
10,13,144,27,13,14
10,13,145,15,18,-3
10,13,146,24,25,-1
10,13,147,13,14,-1
10,13,148,13,8,5
10,13,149,13,8,5
10,13,150,12,19,-7
10,13,151,13,4,9
10,13,152,19,29,-10
10,13,153,14,8,6
10,13,154,13,23,-10
10,13,155,18,8,10
10,13,156,7,17,-10
10,13,157,23,22,1
10,13,158,7,20,-13
10,13,159,29,7,22
10,13,160,9,23,-14
10,13,161,19,12,7
10,13,162,21,13,8
10,13,163,12,11,1
10,13,164,15,13,2
10,13,165,19,19,0
10,13,166,12,13,-1
10,13,167,23,19,4
10,13,168,34,17,17
10,13,169,20,23,-3
10,13,170,25,14,11
10,13,171,16,12,4
10,13,172,18,30,-12
10,13,173,21,16,5
10,13,174,17,23,-6
10,13,175,23,7,16
10,13,176,19,19,0
10,13,177,18,22,-4
10,13,178,7,12,-5
10,13,179,29,24,5
10,13,180,15,12,3
10,13,181,12,16,-4
10,13,182,15,28,-13
10,13,183,17,13,4
10,13,184,19,16,3
10,13,185,18,6,12
10,13,186,22,10,12
10,13,187,7,14,-7
10,13,188,26,10,16
10,13,189,13,10,3
10,13,190,9,11,-2
10,13,191,28,11,17
10,13,192,17,24,-7
10,13,193,8,12,-4
10,13,194,10,9,1
10,13,195,15,19,-4
10,13,196,18,11,7
10,13,197,20,12,8
10,13,198,10,11,-1
10,13,199,14,11,3
10,13,200,17,28,-11
10,13,201,19,17,2
10,13,202,13,9,4
10,13,203,13,12,1
10,13,204,16,25,-9
10,13,205,22,15,7
10,13,206,23,17,6
10,13,207,25,14,11
10,13,208,14,11,3
10,13,209,15,29,-14
10,13,210,20,22,-2
10,13,211,26,15,11
10,13,212,7,12,-5
10,13,213,21,19,2
10,13,214,15,10,5
10,13,215,32,13,19
10,13,216,16,18,-2
10,13,217,14,18,-4
10,13,218,10,11,-1
10,13,219,20,9,11
10,13,220,18,18,0
10,13,221,16,31,-15
10,13,222,18,21,-3
10,13,223,17,15,2
10,13,224,15,16,-1
10,13,225,20,13,7
10,13,226,14,18,-4
10,13,227,27,15,12
10,13,228,14,16,-2
10,13,229,16,11,5
10,13,230,12,17,-5
10,13,231,10,13,-3
10,13,232,5,4,1
10,13,233,19,10,9
10,13,234,26,16,10
10,13,235,10,22,-12
10,13,236,4,7,-3
10,13,237,16,15,1
10,13,238,20,9,11
10,13,239,11,9,2
10,13,240,12,7,5
10,13,241,25,16,9
10,13,242,8,20,-12
10,13,243,9,9,0
10,13,244,18,28,-10
10,13,245,17,29,-12
10,13,246,20,13,7
10,13,247,10,19,-9
10,13,248,12,10,2
10,13,249,22,16,6
10,13,250,18,8,10
10,13,251,7,11,-4
10,13,252,13,13,0
10,13,253,13,16,-3
10,13,254,13,18,-5
10,13,255,8,10,-2
10,13,256,17,16,1
10,13,257,8,9,-1
10,13,258,9,17,-8
10,13,259,15,12,3
10,13,260,26,25,1
10,13,261,12,16,-4
10,13,262,21,22,-1
10,13,263,20,24,-4
10,13,264,20,10,10
10,13,265,13,16,-3
10,13,266,25,11,14
10,13,267,19,6,13
10,13,268,10,8,2
10,13,269,9,9,0
10,13,270,18,5,13
10,13,271,17,11,6
10,13,272,24,24,0
10,13,273,7,15,-8
10,13,274,19,16,3
10,13,275,13,13,0
10,13,276,22,10,12
10,13,277,17,19,-2
10,13,278,10,18,-8
10,13,279,25,9,16
10,13,280,14,14,0
10,13,281,20,20,0
10,13,282,15,15,0
10,13,283,23,27,-4
10,13,284,8,14,-6
10,13,285,17,13,4
10,13,286,19,16,3
10,13,287,27,17,10
10,13,288,11,11,0
10,13,289,20,18,2
10,13,290,15,12,3
10,13,291,14,17,-3
10,13,292,24,23,1
10,13,293,15,16,-1
10,13,294,6,7,-1
10,13,295,27,18,9
10,13,296,17,15,2
10,13,297,16,18,-2
10,13,298,9,11,-2
10,13,299,19,17,2
10,14,0,14,8,6
10,14,1,11,30,-19
10,14,2,12,18,-6
10,14,3,21,17,4
10,14,4,12,19,-7
10,14,5,9,14,-5
10,14,6,17,11,6
10,14,7,20,11,9
10,14,8,26,9,17
10,14,9,11,6,5
10,14,10,9,10,-1
10,14,11,8,6,2
10,14,12,14,32,-18
10,14,13,12,15,-3
10,14,14,14,9,5
10,14,15,11,12,-1
10,14,16,13,9,4
10,14,17,13,10,3
10,14,18,19,19,0
10,14,19,19,7,12
10,14,20,11,10,1
10,14,21,19,16,3
10,14,22,11,13,-2
10,14,23,10,11,-1
10,14,24,20,11,9
10,14,25,8,9,-1
10,14,26,11,5,6
10,14,27,17,19,-2
10,14,28,24,23,1
10,14,29,20,14,6
10,14,30,16,10,6
10,14,31,14,18,-4
10,14,32,23,7,16
10,14,33,17,14,3
10,14,34,9,6,3
10,14,35,25,14,11
10,14,36,16,12,4
10,14,37,13,20,-7
10,14,38,15,18,-3
10,14,39,19,10,9
10,14,40,21,6,15
10,14,41,16,13,3
10,14,42,9,10,-1
10,14,43,33,20,13
10,14,44,17,20,-3
10,14,45,23,23,0
10,14,46,21,8,13
10,14,47,24,19,5
10,14,48,18,15,3
10,14,49,12,23,-11
10,14,50,20,17,3
10,14,51,18,25,-7
10,14,52,14,18,-4
10,14,53,7,10,-3
10,14,54,10,26,-16
10,14,55,7,6,1
10,14,56,19,6,13
10,14,57,24,17,7
10,14,58,24,23,1
10,14,59,16,11,5
10,14,60,6,11,-5
10,14,61,17,19,-2
10,14,62,25,13,12
10,14,63,18,13,5
10,14,64,17,16,1
10,14,65,16,15,1
10,14,66,23,15,8
10,14,67,19,6,13
10,14,68,21,18,3
10,14,69,23,23,0
10,14,70,11,12,-1
10,14,71,13,21,-8
10,14,72,15,14,1
10,14,73,15,26,-11
10,14,74,12,16,-4
10,14,75,22,9,13
10,14,76,10,14,-4
10,14,77,14,20,-6
10,14,78,22,17,5
10,14,79,15,24,-9
10,14,80,18,18,0
10,14,81,9,19,-10
10,14,82,16,21,-5
10,14,83,18,8,10
10,14,84,24,9,15
10,14,85,12,11,1
10,14,86,24,23,1
10,14,87,8,10,-2
10,14,88,24,22,2
10,14,89,14,10,4
10,14,90,18,15,3
10,14,91,24,18,6
10,14,92,19,13,6
10,14,93,26,23,3
10,14,94,14,18,-4
10,14,95,15,10,5
10,14,96,22,11,11
10,14,97,22,18,4
10,14,98,10,8,2
10,14,99,11,12,-1
10,14,100,17,18,-1
10,14,101,10,6,4
10,14,102,11,8,3
10,14,103,21,15,6
10,14,104,13,14,-1
10,14,105,26,15,11
10,14,106,14,8,6
10,14,107,9,7,2
10,14,108,13,24,-11
10,14,109,5,9,-4
10,14,110,13,9,4
10,14,111,17,11,6
10,14,112,6,13,-7
10,14,113,20,13,7
10,14,114,26,23,3
10,14,115,28,16,12
10,14,116,23,13,10
10,14,117,18,12,6
10,14,118,10,17,-7
10,14,119,8,14,-6
10,14,120,11,16,-5
10,14,121,19,10,9
10,14,122,16,11,5
10,14,123,17,18,-1
10,14,124,33,19,14
10,14,125,15,14,1
10,14,126,21,21,0
10,14,127,13,28,-15
10,14,128,8,9,-1
10,14,129,10,19,-9
10,14,130,19,16,3
10,14,131,26,14,12
10,14,132,13,13,0
10,14,133,9,18,-9
10,14,134,24,31,-7
10,14,135,12,19,-7
10,14,136,24,12,12
10,14,137,7,9,-2
10,14,138,17,9,8
10,14,139,24,31,-7
10,14,140,27,20,7
10,14,141,18,17,1
10,14,142,9,18,-9
10,14,143,22,15,7
10,14,144,9,8,1
10,14,145,11,18,-7
10,14,146,5,30,-25
10,14,147,11,17,-6
10,14,148,20,23,-3
10,14,149,12,14,-2
10,14,150,8,6,2
10,14,151,19,18,1
10,14,152,27,12,15
10,14,153,11,18,-7
10,14,154,14,24,-10
10,14,155,21,29,-8
10,14,156,15,13,2
10,14,157,12,8,4
10,14,158,15,9,6
10,14,159,18,13,5
10,14,160,18,29,-11
10,14,161,18,17,1
10,14,162,7,18,-11
10,14,163,20,23,-3
10,14,164,9,11,-2
10,14,165,21,21,0
10,14,166,15,17,-2
10,14,167,21,15,6
10,14,168,21,30,-9
10,14,169,12,10,2
10,14,170,16,16,0
10,14,171,12,14,-2
10,14,172,26,19,7
10,14,173,14,8,6
10,14,174,14,19,-5
10,14,175,17,20,-3
10,14,176,22,29,-7
10,14,177,17,13,4
10,14,178,14,12,2
10,14,179,17,9,8
10,14,180,11,14,-3
10,14,181,7,17,-10
10,14,182,29,21,8
10,14,183,10,28,-18
10,14,184,8,13,-5
10,14,185,20,15,5
10,14,186,23,19,4
10,14,187,12,9,3
10,14,188,17,21,-4
10,14,189,19,15,4
10,14,190,14,22,-8
10,14,191,10,21,-11
10,14,192,12,11,1
10,14,193,21,20,1
10,14,194,27,11,16
10,14,195,21,26,-5
10,14,196,27,20,7
10,14,197,22,26,-4
10,14,198,12,9,3
10,14,199,13,18,-5
10,14,200,21,22,-1
10,14,201,12,19,-7
10,14,202,17,21,-4
10,14,203,13,13,0
10,14,204,10,8,2
10,14,205,11,15,-4
10,14,206,17,7,10
10,14,207,15,11,4
10,14,208,10,10,0
10,14,209,19,17,2
10,14,210,8,25,-17
10,14,211,14,6,8
10,14,212,14,15,-1
10,14,213,19,18,1
10,14,214,19,28,-9
10,14,215,18,11,7
10,14,216,14,19,-5
10,14,217,23,18,5
10,14,218,17,10,7
10,14,219,22,15,7
10,14,220,21,8,13
10,14,221,30,28,2
10,14,222,16,15,1
10,14,223,17,25,-8
10,14,224,22,9,13
10,14,225,15,19,-4
10,14,226,14,13,1
10,14,227,15,11,4
10,14,228,17,9,8
10,14,229,17,6,11
10,14,230,25,10,15
10,14,231,27,25,2
10,14,232,15,14,1
10,14,233,5,14,-9
10,14,234,13,14,-1
10,14,235,30,22,8
10,14,236,14,7,7
10,14,237,13,12,1
10,14,238,19,14,5
10,14,239,17,20,-3
10,14,240,6,11,-5
10,14,241,10,13,-3
10,14,242,11,19,-8
10,14,243,16,16,0
10,14,244,25,24,1
10,14,245,22,18,4
10,14,246,15,6,9
10,14,247,23,30,-7
10,14,248,14,26,-12
10,14,249,27,30,-3
10,14,250,27,12,15
10,14,251,11,12,-1
10,14,252,12,12,0
10,14,253,30,15,15
10,14,254,12,8,4
10,14,255,14,13,1
10,14,256,10,9,1
10,14,257,12,18,-6
10,14,258,23,19,4
10,14,259,17,25,-8
10,14,260,21,28,-7
10,14,261,9,4,5
10,14,262,11,16,-5
10,14,263,20,12,8
10,14,264,15,13,2
10,14,265,15,12,3
10,14,266,18,20,-2
10,14,267,19,13,6
10,14,268,19,20,-1
10,14,269,18,14,4
10,14,270,19,21,-2
10,14,271,10,23,-13
10,14,272,12,19,-7
10,14,273,24,19,5
10,14,274,14,18,-4
10,14,275,17,13,4
10,14,276,16,14,2
10,14,277,12,6,6
10,14,278,20,9,11
10,14,279,31,10,21
10,14,280,14,9,5
10,14,281,12,9,3
10,14,282,20,15,5
10,14,283,5,8,-3
10,14,284,22,10,12
10,14,285,13,21,-8
10,14,286,25,15,10
10,14,287,17,13,4
10,14,288,17,16,1
10,14,289,9,7,2
10,14,290,8,13,-5
10,14,291,21,24,-3
10,14,292,13,26,-13
10,14,293,23,18,5
10,14,294,10,13,-3
10,14,295,17,17,0
10,14,296,15,8,7
10,14,297,25,15,10
10,14,298,21,15,6
10,14,299,13,23,-10
10,15,0,23,10,13
10,15,1,18,20,-2
10,15,2,16,12,4
10,15,3,27,15,12
10,15,4,17,15,2
10,15,5,13,13,0
10,15,6,19,11,8
10,15,7,13,20,-7
10,15,8,7,12,-5
10,15,9,6,2,4
10,15,10,8,23,-15
10,15,11,15,6,9
10,15,12,23,9,14
10,15,13,11,11,0
10,15,14,15,9,6
10,15,15,13,9,4
10,15,16,28,7,21
10,15,17,28,26,2
10,15,18,9,8,1
10,15,19,25,27,-2
10,15,20,10,16,-6
10,15,21,16,19,-3
10,15,22,18,17,1
10,15,23,19,14,5
10,15,24,18,15,3
10,15,25,25,20,5
10,15,26,24,8,16
10,15,27,13,18,-5
10,15,28,15,20,-5
10,15,29,10,14,-4
10,15,30,6,9,-3
10,15,31,17,6,11
10,15,32,9,11,-2
10,15,33,28,14,14
10,15,34,23,24,-1
10,15,35,14,8,6
10,15,36,12,10,2
10,15,37,14,12,2
10,15,38,20,8,12
10,15,39,11,12,-1
10,15,40,9,12,-3
10,15,41,23,11,12
10,15,42,13,14,-1
10,15,43,10,15,-5
10,15,44,15,12,3
10,15,45,15,21,-6
10,15,46,18,14,4
10,15,47,21,13,8
10,15,48,21,14,7
10,15,49,13,10,3
10,15,50,11,26,-15
10,15,51,13,17,-4
10,15,52,15,27,-12
10,15,53,14,22,-8
10,15,54,24,14,10
10,15,55,8,9,-1
10,15,56,26,22,4
10,15,57,17,11,6
10,15,58,14,12,2
10,15,59,19,18,1
10,15,60,17,23,-6
10,15,61,13,13,0
10,15,62,16,22,-6
10,15,63,8,13,-5
10,15,64,15,10,5
10,15,65,17,29,-12
10,15,66,5,9,-4
10,15,67,12,12,0
10,15,68,16,19,-3
10,15,69,21,14,7
10,15,70,10,16,-6
10,15,71,9,12,-3
10,15,72,8,23,-15
10,15,73,10,4,6
10,15,74,16,5,11
10,15,75,9,20,-11
10,15,76,12,20,-8
10,15,77,10,13,-3
10,15,78,13,14,-1
10,15,79,11,14,-3
10,15,80,23,15,8
10,15,81,14,17,-3
10,15,82,13,12,1
10,15,83,22,11,11
10,15,84,7,11,-4
10,15,85,16,13,3
10,15,86,10,9,1
10,15,87,22,14,8
10,15,88,11,16,-5
10,15,89,25,24,1
10,15,90,11,17,-6
10,15,91,17,5,12
10,15,92,23,30,-7
10,15,93,17,10,7
10,15,94,15,14,1
10,15,95,11,10,1
10,15,96,14,17,-3
10,15,97,17,10,7
10,15,98,12,29,-17
10,15,99,10,12,-2
10,15,100,14,16,-2
10,15,101,10,9,1
10,15,102,8,13,-5
10,15,103,19,16,3
10,15,104,16,22,-6
10,15,105,11,12,-1
10,15,106,16,19,-3
10,15,107,15,10,5
10,15,108,13,4,9
10,15,109,8,11,-3
10,15,110,16,4,12
10,15,111,20,20,0
10,15,112,16,12,4
10,15,113,4,18,-14
10,15,114,20,21,-1
10,15,115,20,19,1
10,15,116,22,15,7
10,15,117,16,13,3
10,15,118,22,10,12
10,15,119,33,33,0
10,15,120,3,9,-6
10,15,121,25,20,5
10,15,122,30,21,9
10,15,123,14,22,-8
10,15,124,10,7,3
10,15,125,26,16,10
10,15,126,8,11,-3
10,15,127,11,2,9
10,15,128,10,19,-9
10,15,129,16,9,7
10,15,130,22,16,6
10,15,131,23,18,5
10,15,132,8,13,-5
10,15,133,16,13,3
10,15,134,25,12,13
10,15,135,18,31,-13
10,15,136,22,17,5
10,15,137,11,19,-8
10,15,138,14,8,6
10,15,139,21,21,0
10,15,140,21,19,2
10,15,141,23,10,13
10,15,142,21,20,1
10,15,143,15,15,0
10,15,144,23,12,11
10,15,145,19,3,16
10,15,146,16,17,-1
10,15,147,17,13,4
10,15,148,15,12,3
10,15,149,14,11,3
10,15,150,9,21,-12
10,15,151,17,15,2
10,15,152,11,21,-10
10,15,153,12,16,-4
10,15,154,9,10,-1
10,15,155,23,21,2
10,15,156,24,24,0
10,15,157,14,13,1
10,15,158,18,13,5
10,15,159,15,23,-8
10,15,160,32,22,10
10,15,161,15,11,4
10,15,162,13,10,3
10,15,163,12,18,-6
10,15,164,13,23,-10
10,15,165,7,6,1
10,15,166,15,10,5
10,15,167,16,16,0
10,15,168,13,8,5
10,15,169,11,17,-6
10,15,170,33,11,22
10,15,171,9,14,-5
10,15,172,7,18,-11
10,15,173,15,31,-16
10,15,174,12,10,2
10,15,175,14,30,-16
10,15,176,18,21,-3
10,15,177,7,9,-2
10,15,178,24,14,10
10,15,179,21,9,12
10,15,180,5,18,-13
10,15,181,20,12,8
10,15,182,35,11,24
10,15,183,15,21,-6
10,15,184,25,15,10
10,15,185,19,13,6
10,15,186,20,13,7
10,15,187,23,12,11
10,15,188,19,24,-5
10,15,189,17,15,2
10,15,190,15,26,-11
10,15,191,18,8,10
10,15,192,16,13,3
10,15,193,12,9,3
10,15,194,15,10,5
10,15,195,8,13,-5
10,15,196,17,14,3
10,15,197,23,16,7
10,15,198,23,29,-6
10,15,199,26,12,14
10,15,200,14,7,7
10,15,201,16,6,10
10,15,202,23,27,-4
10,15,203,16,9,7
10,15,204,25,13,12
10,15,205,20,23,-3
10,15,206,10,9,1
10,15,207,12,24,-12
10,15,208,17,9,8
10,15,209,18,11,7
10,15,210,18,8,10
10,15,211,12,8,4
10,15,212,21,29,-8
10,15,213,21,23,-2
10,15,214,11,18,-7
10,15,215,24,19,5
10,15,216,24,23,1
10,15,217,25,10,15
10,15,218,14,13,1
10,15,219,15,23,-8
10,15,220,12,24,-12
10,15,221,23,14,9
10,15,222,26,18,8
10,15,223,20,18,2
10,15,224,15,23,-8
10,15,225,12,9,3
10,15,226,28,10,18
10,15,227,10,6,4
10,15,228,7,21,-14
10,15,229,14,13,1
10,15,230,15,16,-1
10,15,231,14,12,2
10,15,232,12,11,1
10,15,233,21,21,0
10,15,234,16,13,3
10,15,235,14,19,-5
10,15,236,12,21,-9
10,15,237,15,16,-1
10,15,238,17,25,-8
10,15,239,23,19,4
10,15,240,12,11,1
10,15,241,17,12,5
10,15,242,12,11,1
10,15,243,15,11,4
10,15,244,19,15,4
10,15,245,17,11,6
10,15,246,12,20,-8
10,15,247,14,20,-6
10,15,248,8,9,-1
10,15,249,17,18,-1
10,15,250,9,8,1
10,15,251,32,21,11
10,15,252,27,19,8
10,15,253,11,18,-7
10,15,254,23,17,6
10,15,255,27,14,13
10,15,256,9,27,-18
10,15,257,17,12,5
10,15,258,9,12,-3
10,15,259,13,22,-9
10,15,260,13,9,4
10,15,261,23,25,-2
10,15,262,12,11,1
10,15,263,28,20,8
10,15,264,9,9,0
10,15,265,16,11,5
10,15,266,17,12,5
10,15,267,21,10,11
10,15,268,31,16,15
10,15,269,13,9,4
10,15,270,18,11,7
10,15,271,15,17,-2
10,15,272,30,17,13
10,15,273,8,11,-3
10,15,274,20,6,14
10,15,275,11,21,-10
10,15,276,18,10,8
10,15,277,19,10,9
10,15,278,12,25,-13
10,15,279,18,15,3
10,15,280,8,14,-6
10,15,281,17,22,-5
10,15,282,19,20,-1
10,15,283,8,20,-12
10,15,284,17,10,7
10,15,285,17,8,9
10,15,286,9,13,-4
10,15,287,26,8,18
10,15,288,11,12,-1
10,15,289,7,11,-4
10,15,290,19,23,-4
10,15,291,17,11,6
10,15,292,10,17,-7
10,15,293,20,16,4
10,15,294,11,10,1
10,15,295,18,26,-8
10,15,296,16,7,9
10,15,297,2,12,-10
10,15,298,17,17,0
10,15,299,12,19,-7
10,16,0,10,9,1
10,16,1,10,10,0
10,16,2,12,22,-10
10,16,3,26,8,18
10,16,4,17,9,8
10,16,5,14,10,4
10,16,6,18,14,4
10,16,7,21,17,4
10,16,8,5,10,-5
10,16,9,21,16,5
10,16,10,23,13,10
10,16,11,27,7,20
10,16,12,18,16,2
10,16,13,10,11,-1
10,16,14,21,17,4
10,16,15,13,13,0
10,16,16,40,23,17
10,16,17,14,26,-12
10,16,18,31,6,25
10,16,19,25,16,9
10,16,20,16,15,1
10,16,21,14,8,6
10,16,22,12,9,3
10,16,23,5,10,-5
10,16,24,9,13,-4
10,16,25,20,15,5
10,16,26,9,7,2
10,16,27,7,20,-13
10,16,28,19,12,7
10,16,29,20,16,4
10,16,30,4,15,-11
10,16,31,15,12,3
10,16,32,16,11,5
10,16,33,16,17,-1
10,16,34,14,16,-2
10,16,35,10,14,-4
10,16,36,17,14,3
10,16,37,14,19,-5
10,16,38,9,19,-10
10,16,39,10,7,3
10,16,40,10,13,-3
10,16,41,18,12,6
10,16,42,16,25,-9
10,16,43,16,11,5
10,16,44,26,11,15
10,16,45,27,11,16
10,16,46,16,23,-7
10,16,47,10,14,-4
10,16,48,27,21,6
10,16,49,25,12,13
10,16,50,19,13,6
10,16,51,30,5,25
10,16,52,21,4,17
10,16,53,9,20,-11
10,16,54,31,12,19
10,16,55,14,4,10
10,16,56,14,6,8
10,16,57,12,9,3
10,16,58,12,21,-9
10,16,59,13,19,-6
10,16,60,9,11,-2
10,16,61,9,8,1
10,16,62,8,11,-3
10,16,63,19,10,9
10,16,64,21,19,2
10,16,65,16,18,-2
10,16,66,5,14,-9
10,16,67,12,11,1
10,16,68,14,11,3
10,16,69,14,5,9
10,16,70,25,16,9
10,16,71,16,11,5
10,16,72,10,14,-4
10,16,73,14,14,0
10,16,74,24,15,9
10,16,75,3,12,-9
10,16,76,12,13,-1
10,16,77,13,8,5
10,16,78,14,4,10
10,16,79,13,7,6
10,16,80,4,14,-10
10,16,81,23,9,14
10,16,82,22,23,-1
10,16,83,24,16,8
10,16,84,12,7,5
10,16,85,15,11,4
10,16,86,19,25,-6
10,16,87,14,10,4
10,16,88,10,11,-1
10,16,89,17,22,-5
10,16,90,26,11,15
10,16,91,12,6,6
10,16,92,28,17,11
10,16,93,14,20,-6
10,16,94,20,18,2
10,16,95,16,7,9
10,16,96,16,4,12
10,16,97,34,15,19
10,16,98,7,7,0
10,16,99,10,15,-5
10,16,100,21,15,6
10,16,101,17,21,-4
10,16,102,11,6,5
10,16,103,22,20,2
10,16,104,23,13,10
10,16,105,16,6,10
10,16,106,20,10,10
10,16,107,12,8,4
10,16,108,31,18,13
10,16,109,10,14,-4
10,16,110,19,31,-12
10,16,111,31,11,20
10,16,112,29,10,19
10,16,113,17,12,5
10,16,114,28,25,3
10,16,115,14,7,7
10,16,116,23,22,1
10,16,117,19,7,12
10,16,118,29,13,16
10,16,119,23,9,14
10,16,120,13,16,-3
10,16,121,11,13,-2
10,16,122,16,15,1
10,16,123,16,12,4
10,16,124,26,13,13
10,16,125,16,16,0
10,16,126,22,13,9
10,16,127,9,12,-3
10,16,128,21,28,-7
10,16,129,12,11,1
10,16,130,19,9,10
10,16,131,24,20,4
10,16,132,17,14,3
10,16,133,24,12,12
10,16,134,16,7,9
10,16,135,12,16,-4
10,16,136,16,18,-2
10,16,137,6,4,2
10,16,138,14,10,4
10,16,139,19,20,-1
10,16,140,8,15,-7
10,16,141,7,15,-8
10,16,142,10,13,-3
10,16,143,13,12,1
10,16,144,17,13,4
10,16,145,23,7,16
10,16,146,17,16,1
10,16,147,20,26,-6
10,16,148,19,19,0
10,16,149,20,16,4
10,16,150,24,13,11
10,16,151,19,18,1
10,16,152,23,16,7
10,16,153,10,16,-6
10,16,154,14,17,-3
10,16,155,21,16,5
10,16,156,19,10,9
10,16,157,30,18,12
10,16,158,14,15,-1
10,16,159,9,12,-3
10,16,160,28,16,12
10,16,161,18,10,8
10,16,162,26,11,15
10,16,163,18,20,-2
10,16,164,19,31,-12
10,16,165,7,9,-2
10,16,166,13,8,5
10,16,167,12,11,1
10,16,168,29,8,21
10,16,169,15,23,-8
10,16,170,15,14,1
10,16,171,2,10,-8
10,16,172,16,13,3
10,16,173,10,9,1
10,16,174,18,18,0
10,16,175,8,2,6
10,16,176,23,13,10
10,16,177,12,17,-5
10,16,178,31,27,4
10,16,179,25,21,4
10,16,180,17,10,7
10,16,181,18,14,4
10,16,182,12,16,-4
10,16,183,14,7,7
10,16,184,9,10,-1
10,16,185,10,8,2
10,16,186,19,16,3
10,16,187,13,17,-4
10,16,188,11,8,3
10,16,189,13,13,0
10,16,190,5,15,-10
10,16,191,13,7,6
10,16,192,9,10,-1
10,16,193,17,24,-7
10,16,194,9,12,-3
10,16,195,15,22,-7
10,16,196,21,14,7
10,16,197,20,21,-1
10,16,198,9,15,-6
10,16,199,17,14,3
10,16,200,27,15,12
10,16,201,17,11,6
10,16,202,18,8,10
10,16,203,23,38,-15
10,16,204,23,11,12
10,16,205,18,7,11
10,16,206,17,18,-1
10,16,207,9,31,-22
10,16,208,12,9,3
10,16,209,12,17,-5
10,16,210,25,22,3
10,16,211,15,7,8
10,16,212,20,9,11
10,16,213,9,18,-9
10,16,214,5,7,-2
10,16,215,14,8,6
10,16,216,15,17,-2
10,16,217,23,28,-5
10,16,218,10,24,-14
10,16,219,20,11,9
10,16,220,15,8,7
10,16,221,8,16,-8
10,16,222,36,17,19
10,16,223,19,14,5
10,16,224,20,15,5
10,16,225,13,18,-5
10,16,226,3,17,-14
10,16,227,10,13,-3
10,16,228,20,17,3
10,16,229,6,10,-4
10,16,230,17,4,13
10,16,231,16,15,1
10,16,232,15,14,1
10,16,233,19,20,-1
10,16,234,17,14,3
10,16,235,10,19,-9
10,16,236,12,6,6
10,16,237,18,19,-1
10,16,238,18,17,1
10,16,239,13,22,-9
10,16,240,8,8,0
10,16,241,16,10,6
10,16,242,17,12,5
10,16,243,30,12,18
10,16,244,11,17,-6
10,16,245,19,12,7
10,16,246,25,15,10
10,16,247,16,10,6
10,16,248,18,16,2
10,16,249,6,9,-3
10,16,250,20,7,13
10,16,251,15,16,-1
10,16,252,13,8,5
10,16,253,26,23,3
10,16,254,20,22,-2
10,16,255,11,11,0
10,16,256,19,9,10
10,16,257,17,6,11
10,16,258,25,12,13
10,16,259,13,12,1
10,16,260,10,22,-12
10,16,261,7,11,-4
10,16,262,6,3,3
10,16,263,7,24,-17
10,16,264,22,14,8
10,16,265,22,12,10
10,16,266,20,10,10
10,16,267,8,15,-7
10,16,268,7,9,-2
10,16,269,9,14,-5
10,16,270,17,6,11
10,16,271,18,8,10
10,16,272,13,7,6
10,16,273,18,13,5
10,16,274,16,20,-4
10,16,275,11,22,-11
10,16,276,23,16,7
10,16,277,20,22,-2
10,16,278,12,16,-4
10,16,279,10,12,-2
10,16,280,16,11,5
10,16,281,19,17,2
10,16,282,15,10,5
10,16,283,22,18,4
10,16,284,16,22,-6
10,16,285,32,4,28
10,16,286,12,21,-9
10,16,287,23,11,12
10,16,288,21,19,2
10,16,289,10,13,-3
10,16,290,24,13,11
10,16,291,8,13,-5
10,16,292,9,9,0
10,16,293,22,9,13
10,16,294,12,6,6
10,16,295,18,12,6
10,16,296,24,15,9
10,16,297,14,16,-2
10,16,298,22,13,9
10,16,299,16,9,7
10,17,0,14,15,-1
10,17,1,11,16,-5
10,17,2,8,6,2
10,17,3,7,17,-10
10,17,4,16,10,6
10,17,5,7,7,0
10,17,6,16,15,1
10,17,7,27,14,13
10,17,8,35,13,22
10,17,9,12,16,-4
10,17,10,10,6,4
10,17,11,24,14,10
10,17,12,19,22,-3
10,17,13,14,16,-2
10,17,14,16,13,3
10,17,15,21,6,15
10,17,16,19,14,5
10,17,17,17,13,4
10,17,18,38,6,32
10,17,19,22,24,-2
10,17,20,26,12,14
10,17,21,13,7,6
10,17,22,19,16,3
10,17,23,23,13,10
10,17,24,8,10,-2
10,17,25,14,10,4
10,17,26,8,12,-4
10,17,27,22,22,0
10,17,28,9,7,2
10,17,29,9,12,-3
10,17,30,12,7,5
10,17,31,19,11,8
10,17,32,17,15,2
10,17,33,15,14,1
10,17,34,4,11,-7
10,17,35,6,2,4
10,17,36,26,16,10
10,17,37,11,12,-1
10,17,38,18,11,7
10,17,39,19,17,2
10,17,40,21,14,7
10,17,41,26,15,11
10,17,42,12,13,-1
10,17,43,17,10,7
10,17,44,30,19,11
10,17,45,19,14,5
10,17,46,16,20,-4
10,17,47,16,28,-12
10,17,48,11,17,-6
10,17,49,17,12,5
10,17,50,27,16,11
10,17,51,5,10,-5
10,17,52,16,24,-8
10,17,53,8,18,-10
10,17,54,28,15,13
10,17,55,13,15,-2
10,17,56,30,21,9
10,17,57,9,11,-2
10,17,58,20,14,6
10,17,59,9,7,2
10,17,60,15,8,7
10,17,61,23,13,10
10,17,62,10,6,4
10,17,63,16,17,-1
10,17,64,22,15,7
10,17,65,8,16,-8
10,17,66,13,10,3
10,17,67,3,5,-2
10,17,68,21,5,16
10,17,69,20,6,14
10,17,70,24,8,16
10,17,71,21,10,11
10,17,72,11,17,-6
10,17,73,23,19,4
10,17,74,9,8,1
10,17,75,8,15,-7
10,17,76,17,7,10
10,17,77,19,25,-6
10,17,78,15,6,9
10,17,79,14,20,-6
10,17,80,11,6,5
10,17,81,30,6,24
10,17,82,11,8,3
10,17,83,22,23,-1
10,17,84,18,9,9
10,17,85,13,16,-3
10,17,86,21,11,10
10,17,87,8,13,-5
10,17,88,19,17,2
10,17,89,21,11,10
10,17,90,25,12,13
10,17,91,17,20,-3
10,17,92,19,11,8
10,17,93,14,10,4
10,17,94,12,10,2
10,17,95,19,13,6
10,17,96,15,21,-6
10,17,97,20,10,10
10,17,98,8,16,-8
10,17,99,18,19,-1
10,17,100,17,9,8
10,17,101,16,10,6
10,17,102,18,18,0
10,17,103,30,12,18
10,17,104,15,8,7
10,17,105,19,16,3
10,17,106,28,17,11
10,17,107,20,10,10
10,17,108,21,12,9
10,17,109,19,24,-5
10,17,110,25,17,8
10,17,111,17,28,-11
10,17,112,26,19,7
10,17,113,9,26,-17
10,17,114,14,13,1
10,17,115,15,10,5
10,17,116,20,13,7
10,17,117,18,6,12
10,17,118,22,18,4
10,17,119,17,19,-2
10,17,120,13,18,-5
10,17,121,12,7,5
10,17,122,30,10,20
10,17,123,27,22,5
10,17,124,8,9,-1
10,17,125,12,14,-2
10,17,126,9,7,2
10,17,127,10,13,-3
10,17,128,31,26,5
10,17,129,6,1,5
10,17,130,17,21,-4
10,17,131,28,25,3
10,17,132,18,33,-15
10,17,133,22,9,13
10,17,134,27,14,13
10,17,135,20,28,-8
10,17,136,27,26,1
10,17,137,10,20,-10
10,17,138,25,15,10
10,17,139,26,13,13
10,17,140,11,4,7
10,17,141,9,15,-6
10,17,142,11,12,-1
10,17,143,21,10,11
10,17,144,16,8,8
10,17,145,25,30,-5
10,17,146,11,9,2
10,17,147,25,16,9
10,17,148,23,15,8
10,17,149,13,8,5
10,17,150,21,13,8
10,17,151,23,18,5
10,17,152,10,7,3
10,17,153,9,12,-3
10,17,154,23,19,4
10,17,155,19,15,4
10,17,156,14,21,-7
10,17,157,12,10,2
10,17,158,12,15,-3
10,17,159,9,7,2
10,17,160,27,11,16
10,17,161,20,5,15
10,17,162,17,11,6
10,17,163,10,3,7
10,17,164,11,15,-4
10,17,165,28,16,12
10,17,166,14,20,-6
10,17,167,27,16,11
10,17,168,15,13,2
10,17,169,15,10,5
10,17,170,22,23,-1
10,17,171,25,12,13
10,17,172,20,17,3
10,17,173,11,12,-1
10,17,174,16,17,-1
10,17,175,19,23,-4
10,17,176,11,20,-9
10,17,177,15,13,2
10,17,178,18,20,-2
10,17,179,29,3,26
10,17,180,7,12,-5
10,17,181,17,8,9
10,17,182,10,16,-6
10,17,183,18,18,0
10,17,184,14,16,-2
10,17,185,11,19,-8
10,17,186,23,18,5
10,17,187,13,15,-2
10,17,188,20,13,7
10,17,189,14,17,-3
10,17,190,15,12,3
10,17,191,16,15,1
10,17,192,16,12,4
10,17,193,36,19,17
10,17,194,10,12,-2
10,17,195,34,26,8
10,17,196,29,17,12
10,17,197,15,20,-5
10,17,198,13,14,-1
10,17,199,21,14,7
10,17,200,16,13,3
10,17,201,19,16,3
10,17,202,25,14,11
10,17,203,8,16,-8
10,17,204,14,8,6
10,17,205,12,10,2
10,17,206,15,14,1
10,17,207,10,18,-8
10,17,208,24,14,10
10,17,209,12,11,1
10,17,210,10,13,-3
10,17,211,27,16,11
10,17,212,16,23,-7
10,17,213,29,18,11
10,17,214,21,11,10
10,17,215,27,17,10
10,17,216,16,19,-3
10,17,217,22,17,5
10,17,218,29,12,17
10,17,219,14,14,0
10,17,220,28,24,4
10,17,221,9,9,0
10,17,222,9,8,1
10,17,223,15,18,-3
10,17,224,11,15,-4
10,17,225,20,15,5
10,17,226,19,10,9
10,17,227,36,23,13
10,17,228,14,12,2
10,17,229,24,15,9
10,17,230,31,11,20
10,17,231,8,15,-7
10,17,232,15,22,-7
10,17,233,23,9,14
10,17,234,17,16,1
10,17,235,16,11,5
10,17,236,22,20,2
10,17,237,33,12,21
10,17,238,15,16,-1
10,17,239,19,21,-2
10,17,240,24,24,0
10,17,241,5,15,-10
10,17,242,20,11,9
10,17,243,7,10,-3
10,17,244,11,6,5
10,17,245,13,11,2
10,17,246,19,21,-2
10,17,247,16,17,-1
10,17,248,16,20,-4
10,17,249,6,23,-17
10,17,250,16,12,4
10,17,251,27,11,16
10,17,252,18,7,11
10,17,253,8,16,-8
10,17,254,15,20,-5
10,17,255,26,11,15
10,17,256,19,13,6
10,17,257,24,15,9
10,17,258,29,24,5
10,17,259,20,11,9
10,17,260,17,7,10
10,17,261,13,20,-7
10,17,262,13,6,7
10,17,263,8,3,5
10,17,264,23,12,11
10,17,265,26,21,5
10,17,266,11,13,-2
10,17,267,12,14,-2
10,17,268,19,6,13
10,17,269,5,10,-5
10,17,270,12,26,-14
10,17,271,15,9,6
10,17,272,12,19,-7
10,17,273,18,22,-4
10,17,274,11,7,4
10,17,275,22,22,0
10,17,276,18,15,3
10,17,277,16,20,-4
10,17,278,13,15,-2
10,17,279,16,11,5
10,17,280,8,5,3
10,17,281,15,8,7
10,17,282,10,10,0
10,17,283,12,9,3
10,17,284,16,7,9
10,17,285,29,21,8
10,17,286,5,9,-4
10,17,287,22,15,7
10,17,288,10,26,-16
10,17,289,14,7,7
10,17,290,24,14,10
10,17,291,19,7,12
10,17,292,15,9,6
10,17,293,13,17,-4
10,17,294,14,21,-7
10,17,295,9,15,-6
10,17,296,18,11,7
10,17,297,19,12,7
10,17,298,13,8,5
10,17,299,16,14,2
10,18,0,19,14,5
10,18,1,17,21,-4
10,18,2,17,14,3
10,18,3,20,12,8
10,18,4,24,16,8
10,18,5,17,13,4
10,18,6,21,17,4
10,18,7,20,17,3
10,18,8,10,8,2
10,18,9,25,14,11
10,18,10,17,17,0
10,18,11,5,9,-4
10,18,12,12,13,-1
10,18,13,16,14,2
10,18,14,20,16,4
10,18,15,19,23,-4
10,18,16,8,9,-1
10,18,17,19,15,4
10,18,18,9,25,-16
10,18,19,21,18,3
10,18,20,21,17,4
10,18,21,20,12,8
10,18,22,21,11,10
10,18,23,13,6,7
10,18,24,17,4,13
10,18,25,9,15,-6
10,18,26,26,8,18
10,18,27,17,16,1
10,18,28,13,15,-2
10,18,29,6,3,3
10,18,30,13,5,8
10,18,31,24,23,1
10,18,32,23,22,1
10,18,33,22,11,11
10,18,34,29,19,10
10,18,35,10,12,-2
10,18,36,19,25,-6
10,18,37,18,4,14
10,18,38,12,6,6
10,18,39,25,10,15
10,18,40,25,17,8
10,18,41,20,12,8
10,18,42,16,8,8
10,18,43,22,8,14
10,18,44,16,12,4
10,18,45,9,17,-8
10,18,46,27,14,13
10,18,47,14,9,5
10,18,48,21,11,10
10,18,49,11,18,-7
10,18,50,37,10,27
10,18,51,12,17,-5
10,18,52,19,15,4
10,18,53,13,7,6
10,18,54,13,12,1
10,18,55,21,8,13
10,18,56,29,13,16
10,18,57,10,12,-2
10,18,58,18,15,3
10,18,59,28,19,9
10,18,60,15,15,0
10,18,61,38,15,23
10,18,62,21,5,16
10,18,63,12,6,6
10,18,64,23,13,10
10,18,65,9,15,-6
10,18,66,24,10,14
10,18,67,15,12,3
10,18,68,24,21,3
10,18,69,12,10,2
10,18,70,14,4,10
10,18,71,23,28,-5
10,18,72,27,26,1
10,18,73,20,13,7
10,18,74,20,16,4
10,18,75,16,15,1
10,18,76,9,9,0
10,18,77,17,8,9
10,18,78,9,18,-9
10,18,79,14,12,2
10,18,80,17,3,14
10,18,81,19,7,12
10,18,82,21,10,11
10,18,83,15,4,11
10,18,84,20,21,-1
10,18,85,16,16,0
10,18,86,11,23,-12
10,18,87,20,6,14
10,18,88,20,10,10
10,18,89,9,20,-11
10,18,90,30,41,-11
10,18,91,18,19,-1
10,18,92,14,13,1
10,18,93,17,20,-3
10,18,94,20,13,7
10,18,95,13,18,-5
10,18,96,25,16,9
10,18,97,16,10,6
10,18,98,19,9,10
10,18,99,21,15,6
10,18,100,14,15,-1
10,18,101,13,18,-5
10,18,102,16,15,1
10,18,103,23,15,8
10,18,104,11,20,-9
10,18,105,13,14,-1
10,18,106,13,11,2
10,18,107,19,16,3
10,18,108,13,14,-1
10,18,109,8,6,2
10,18,110,12,17,-5
10,18,111,26,20,6
10,18,112,6,11,-5
10,18,113,25,9,16
10,18,114,8,13,-5
10,18,115,18,18,0
10,18,116,28,17,11
10,18,117,15,14,1
10,18,118,8,15,-7
10,18,119,14,8,6
10,18,120,16,11,5
10,18,121,13,12,1
10,18,122,25,11,14
10,18,123,11,13,-2
10,18,124,21,27,-6
10,18,125,8,7,1
10,18,126,24,18,6
10,18,127,8,10,-2
10,18,128,23,19,4
10,18,129,14,13,1
10,18,130,16,12,4
10,18,131,19,21,-2
10,18,132,15,15,0
10,18,133,14,5,9
10,18,134,9,16,-7
10,18,135,26,20,6
10,18,136,14,17,-3
10,18,137,24,18,6
10,18,138,19,3,16
10,18,139,14,6,8
10,18,140,11,19,-8
10,18,141,18,17,1
10,18,142,16,10,6
10,18,143,23,21,2
10,18,144,15,9,6
10,18,145,27,17,10
10,18,146,9,10,-1
10,18,147,21,13,8
10,18,148,17,9,8
10,18,149,25,14,11
10,18,150,19,30,-11
10,18,151,8,11,-3
10,18,152,18,16,2
10,18,153,10,8,2
10,18,154,26,14,12
10,18,155,12,9,3
10,18,156,31,20,11
10,18,157,14,17,-3
10,18,158,24,15,9
10,18,159,6,13,-7
10,18,160,13,12,1
10,18,161,15,16,-1
10,18,162,19,16,3
10,18,163,14,14,0
10,18,164,30,15,15
10,18,165,21,17,4
10,18,166,11,20,-9
10,18,167,16,16,0
10,18,168,20,8,12
10,18,169,20,16,4
10,18,170,16,8,8
10,18,171,18,22,-4
10,18,172,16,10,6
10,18,173,9,20,-11
10,18,174,10,19,-9
10,18,175,34,25,9
10,18,176,20,12,8
10,18,177,16,5,11
10,18,178,8,12,-4
10,18,179,18,18,0
10,18,180,20,8,12
10,18,181,16,17,-1
10,18,182,17,7,10
10,18,183,18,3,15
10,18,184,20,19,1
10,18,185,15,6,9
10,18,186,27,15,12
10,18,187,17,6,11
10,18,188,25,20,5
10,18,189,34,17,17
10,18,190,12,10,2
10,18,191,16,9,7
10,18,192,19,17,2
10,18,193,18,9,9
10,18,194,19,7,12
10,18,195,19,19,0
10,18,196,13,14,-1
10,18,197,18,15,3
10,18,198,20,9,11
10,18,199,11,14,-3
10,18,200,19,20,-1
10,18,201,13,7,6
10,18,202,20,9,11
10,18,203,9,7,2
10,18,204,13,7,6
10,18,205,13,14,-1
10,18,206,13,16,-3
10,18,207,28,15,13
10,18,208,21,12,9
10,18,209,24,21,3
10,18,210,19,17,2
10,18,211,18,12,6
10,18,212,25,15,10
10,18,213,10,16,-6
10,18,214,16,6,10
10,18,215,5,17,-12
10,18,216,17,13,4
10,18,217,18,19,-1
10,18,218,34,6,28
10,18,219,20,13,7
10,18,220,9,10,-1
10,18,221,27,17,10
10,18,222,31,8,23
10,18,223,13,13,0
10,18,224,15,23,-8
10,18,225,39,14,25
10,18,226,20,14,6
10,18,227,11,10,1
10,18,228,12,14,-2
10,18,229,12,4,8
10,18,230,37,24,13
10,18,231,24,7,17
10,18,232,15,14,1
10,18,233,26,13,13
10,18,234,20,7,13
10,18,235,3,16,-13
10,18,236,18,16,2
10,18,237,26,14,12
10,18,238,23,23,0
10,18,239,12,10,2
10,18,240,19,10,9
10,18,241,15,6,9
10,18,242,12,8,4
10,18,243,21,17,4
10,18,244,19,18,1
10,18,245,20,11,9
10,18,246,20,17,3
10,18,247,15,13,2
10,18,248,16,15,1
10,18,249,14,11,3
10,18,250,29,13,16
10,18,251,25,18,7
10,18,252,10,15,-5
10,18,253,6,7,-1
10,18,254,13,11,2
10,18,255,18,10,8
10,18,256,34,14,20
10,18,257,10,17,-7
10,18,258,11,20,-9
10,18,259,25,26,-1
10,18,260,22,12,10
10,18,261,6,11,-5
10,18,262,22,13,9
10,18,263,35,14,21
10,18,264,15,16,-1
10,18,265,34,12,22
10,18,266,7,4,3
10,18,267,23,12,11
10,18,268,18,14,4
10,18,269,14,10,4
10,18,270,22,18,4
10,18,271,17,18,-1
10,18,272,10,8,2
10,18,273,33,17,16
10,18,274,14,8,6
10,18,275,16,16,0
10,18,276,11,11,0
10,18,277,18,13,5
10,18,278,10,11,-1
10,18,279,16,21,-5
10,18,280,14,11,3
10,18,281,20,8,12
10,18,282,17,9,8
10,18,283,18,10,8
10,18,284,15,9,6
10,18,285,20,12,8
10,18,286,20,15,5
10,18,287,14,14,0
10,18,288,13,7,6
10,18,289,25,22,3
10,18,290,15,7,8
10,18,291,19,20,-1
10,18,292,18,11,7
10,18,293,25,17,8
10,18,294,18,16,2
10,18,295,16,13,3
10,18,296,11,14,-3
10,18,297,16,24,-8
10,18,298,14,25,-11
10,18,299,17,12,5
10,19,0,19,24,-5
10,19,1,23,13,10
10,19,2,30,16,14
10,19,3,9,6,3
10,19,4,24,9,15
10,19,5,7,10,-3
10,19,6,8,13,-5
10,19,7,31,17,14
10,19,8,15,12,3
10,19,9,23,14,9
10,19,10,16,15,1
10,19,11,20,24,-4
10,19,12,14,8,6
10,19,13,29,9,20
10,19,14,13,11,2
10,19,15,9,18,-9
10,19,16,11,14,-3
10,19,17,9,11,-2
10,19,18,17,11,6
10,19,19,22,15,7
10,19,20,22,14,8
10,19,21,28,11,17
10,19,22,10,8,2
10,19,23,33,15,18
10,19,24,12,11,1
10,19,25,9,6,3
10,19,26,19,22,-3
10,19,27,26,20,6
10,19,28,18,25,-7
10,19,29,16,18,-2
10,19,30,6,7,-1
10,19,31,19,19,0
10,19,32,12,14,-2
10,19,33,22,17,5
10,19,34,13,3,10
10,19,35,14,10,4
10,19,36,21,19,2
10,19,37,8,19,-11
10,19,38,31,11,20
10,19,39,18,11,7
10,19,40,14,9,5
10,19,41,23,8,15
10,19,42,22,19,3
10,19,43,10,10,0
10,19,44,22,11,11
10,19,45,17,21,-4
10,19,46,9,16,-7
10,19,47,21,15,6
10,19,48,18,16,2
10,19,49,21,18,3
10,19,50,22,17,5
10,19,51,10,8,2
10,19,52,19,12,7
10,19,53,13,14,-1
10,19,54,14,22,-8
10,19,55,10,7,3
10,19,56,16,18,-2
10,19,57,16,13,3
10,19,58,16,24,-8
10,19,59,27,15,12
10,19,60,26,11,15
10,19,61,21,12,9
10,19,62,15,7,8
10,19,63,22,15,7
10,19,64,25,10,15
10,19,65,29,10,19
10,19,66,12,11,1
10,19,67,10,8,2
10,19,68,28,10,18
10,19,69,24,15,9
10,19,70,13,13,0
10,19,71,24,17,7
10,19,72,17,9,8
10,19,73,8,13,-5
10,19,74,14,15,-1
10,19,75,16,11,5
10,19,76,15,15,0
10,19,77,20,20,0
10,19,78,26,22,4
10,19,79,19,12,7
10,19,80,11,9,2
10,19,81,17,22,-5
10,19,82,14,13,1
10,19,83,18,6,12
10,19,84,20,9,11
10,19,85,12,5,7
10,19,86,21,9,12
10,19,87,13,20,-7
10,19,88,12,19,-7
10,19,89,19,15,4
10,19,90,8,12,-4
10,19,91,9,17,-8
10,19,92,24,13,11
10,19,93,11,9,2
10,19,94,7,16,-9
10,19,95,25,9,16
10,19,96,15,18,-3
10,19,97,6,13,-7
10,19,98,17,21,-4
10,19,99,24,8,16
10,19,100,12,8,4
10,19,101,26,13,13
10,19,102,33,16,17
10,19,103,14,13,1
10,19,104,7,5,2
10,19,105,12,17,-5
10,19,106,4,15,-11
10,19,107,30,18,12
10,19,108,22,13,9
10,19,109,19,8,11
10,19,110,30,16,14
10,19,111,30,17,13
10,19,112,10,7,3
10,19,113,17,23,-6
10,19,114,29,17,12
10,19,115,14,12,2
10,19,116,13,11,2
10,19,117,22,17,5
10,19,118,21,14,7
10,19,119,22,11,11
10,19,120,25,16,9
10,19,121,19,9,10
10,19,122,23,7,16
10,19,123,19,10,9
10,19,124,25,13,12
10,19,125,20,19,1
10,19,126,33,17,16
10,19,127,21,10,11
10,19,128,16,14,2
10,19,129,7,7,0
10,19,130,21,13,8
10,19,131,18,16,2
10,19,132,12,26,-14
10,19,133,16,19,-3
10,19,134,13,10,3
10,19,135,15,14,1
10,19,136,24,10,14
10,19,137,21,15,6
10,19,138,20,14,6
10,19,139,20,23,-3
10,19,140,14,15,-1
10,19,141,14,8,6
10,19,142,16,9,7
10,19,143,40,21,19
10,19,144,15,9,6
10,19,145,27,13,14
10,19,146,17,13,4
10,19,147,14,6,8
10,19,148,26,20,6
10,19,149,10,10,0
10,19,150,21,28,-7
10,19,151,16,8,8
10,19,152,25,10,15
10,19,153,12,9,3
10,19,154,21,19,2
10,19,155,17,30,-13
10,19,156,15,14,1
10,19,157,14,11,3
10,19,158,24,12,12
10,19,159,18,22,-4
10,19,160,10,11,-1
10,19,161,24,16,8
10,19,162,15,12,3
10,19,163,12,16,-4
10,19,164,15,9,6
10,19,165,22,13,9
10,19,166,22,7,15
10,19,167,11,3,8
10,19,168,9,16,-7
10,19,169,21,19,2
10,19,170,16,14,2
10,19,171,20,13,7
10,19,172,17,18,-1
10,19,173,13,19,-6
10,19,174,12,15,-3
10,19,175,16,14,2
10,19,176,19,8,11
10,19,177,10,11,-1
10,19,178,15,18,-3
10,19,179,22,16,6
10,19,180,15,14,1
10,19,181,9,21,-12
10,19,182,20,7,13
10,19,183,19,23,-4
10,19,184,17,17,0
10,19,185,14,4,10
10,19,186,18,18,0
10,19,187,10,17,-7
10,19,188,10,15,-5
10,19,189,15,16,-1
10,19,190,14,14,0
10,19,191,13,13,0
10,19,192,16,10,6
10,19,193,14,10,4
10,19,194,7,16,-9
10,19,195,20,30,-10
10,19,196,16,8,8
10,19,197,19,24,-5
10,19,198,23,28,-5
10,19,199,11,10,1
10,19,200,23,7,16
10,19,201,17,12,5
10,19,202,8,7,1
10,19,203,16,18,-2
10,19,204,14,16,-2
10,19,205,20,19,1
10,19,206,16,26,-10
10,19,207,28,16,12
10,19,208,18,12,6
10,19,209,11,11,0
10,19,210,8,7,1
10,19,211,26,12,14
10,19,212,19,21,-2
10,19,213,8,12,-4
10,19,214,18,16,2
10,19,215,11,10,1
10,19,216,21,10,11
10,19,217,33,12,21
10,19,218,23,19,4
10,19,219,21,27,-6
10,19,220,26,14,12
10,19,221,23,7,16
10,19,222,13,9,4
10,19,223,10,9,1
10,19,224,19,15,4
10,19,225,14,6,8
10,19,226,7,10,-3
10,19,227,8,9,-1
10,19,228,30,9,21
10,19,229,16,8,8
10,19,230,12,22,-10
10,19,231,19,9,10
10,19,232,16,16,0
10,19,233,6,9,-3
10,19,234,17,11,6
10,19,235,16,19,-3
10,19,236,20,23,-3
10,19,237,12,9,3
10,19,238,13,12,1
10,19,239,17,7,10
10,19,240,30,11,19
10,19,241,19,15,4
10,19,242,22,16,6
10,19,243,17,19,-2
10,19,244,16,11,5
10,19,245,15,20,-5
10,19,246,18,19,-1
10,19,247,12,12,0
10,19,248,24,9,15
10,19,249,16,14,2
10,19,250,20,12,8
10,19,251,20,12,8
10,19,252,19,11,8
10,19,253,24,8,16
10,19,254,18,12,6
10,19,255,16,13,3
10,19,256,13,22,-9
10,19,257,35,21,14
10,19,258,20,13,7
10,19,259,14,7,7
10,19,260,23,15,8
10,19,261,18,22,-4
10,19,262,13,15,-2
10,19,263,20,7,13
10,19,264,6,4,2
10,19,265,13,10,3
10,19,266,14,8,6
10,19,267,15,14,1
10,19,268,16,13,3
10,19,269,16,24,-8
10,19,270,18,14,4
10,19,271,12,14,-2
10,19,272,28,10,18
10,19,273,15,12,3
10,19,274,17,4,13
10,19,275,29,19,10
10,19,276,16,16,0
10,19,277,9,9,0
10,19,278,17,11,6
10,19,279,13,14,-1
10,19,280,21,13,8
10,19,281,15,16,-1
10,19,282,11,13,-2
10,19,283,11,4,7
10,19,284,12,9,3
10,19,285,18,12,6
10,19,286,15,10,5
10,19,287,13,11,2
10,19,288,18,20,-2
10,19,289,17,19,-2
10,19,290,34,9,25
10,19,291,23,7,16
10,19,292,15,16,-1
10,19,293,25,13,12
10,19,294,19,15,4
10,19,295,16,7,9
10,19,296,14,6,8
10,19,297,30,2,28
10,19,298,25,14,11
10,19,299,12,14,-2
10,20,0,19,8,11
10,20,1,24,22,2
10,20,2,21,6,15
10,20,3,15,8,7
10,20,4,21,16,5
10,20,5,18,13,5
10,20,6,13,10,3
10,20,7,23,18,5
10,20,8,5,12,-7
10,20,9,23,10,13
10,20,10,19,17,2
10,20,11,15,13,2
10,20,12,15,9,6
10,20,13,20,10,10
10,20,14,8,19,-11
10,20,15,12,13,-1
10,20,16,20,9,11
10,20,17,11,13,-2
10,20,18,26,10,16
10,20,19,18,11,7
10,20,20,10,5,5
10,20,21,21,9,12
10,20,22,18,20,-2
10,20,23,11,14,-3
10,20,24,33,18,15
10,20,25,34,17,17
10,20,26,17,8,9
10,20,27,18,8,10
10,20,28,20,17,3
10,20,29,16,12,4
10,20,30,32,16,16
10,20,31,20,24,-4
10,20,32,21,9,12
10,20,33,14,6,8
10,20,34,14,11,3
10,20,35,10,25,-15
10,20,36,12,17,-5
10,20,37,26,16,10
10,20,38,13,13,0
10,20,39,21,12,9
10,20,40,15,16,-1
10,20,41,14,16,-2
10,20,42,14,3,11
10,20,43,23,14,9
10,20,44,18,21,-3
10,20,45,16,13,3
10,20,46,14,24,-10
10,20,47,8,30,-22
10,20,48,14,13,1
10,20,49,15,13,2
10,20,50,19,29,-10
10,20,51,11,4,7
10,20,52,11,9,2
10,20,53,19,19,0
10,20,54,10,9,1
10,20,55,11,21,-10
10,20,56,12,7,5
10,20,57,13,10,3
10,20,58,29,11,18
10,20,59,14,12,2
10,20,60,41,14,27
10,20,61,5,7,-2
10,20,62,15,16,-1
10,20,63,19,13,6
10,20,64,24,8,16
10,20,65,23,11,12
10,20,66,22,10,12
10,20,67,27,18,9
10,20,68,13,8,5
10,20,69,26,22,4
10,20,70,27,13,14
10,20,71,17,14,3
10,20,72,19,11,8
10,20,73,9,11,-2
10,20,74,10,13,-3
10,20,75,17,19,-2
10,20,76,13,12,1
10,20,77,17,24,-7
10,20,78,20,14,6
10,20,79,16,4,12
10,20,80,29,22,7
10,20,81,23,21,2
10,20,82,28,36,-8
10,20,83,17,12,5
10,20,84,14,16,-2
10,20,85,24,22,2
10,20,86,13,16,-3
10,20,87,5,5,0
10,20,88,20,5,15
10,20,89,9,25,-16
10,20,90,26,9,17
10,20,91,15,11,4
10,20,92,25,15,10
10,20,93,12,16,-4
10,20,94,21,11,10
10,20,95,16,20,-4
10,20,96,11,20,-9
10,20,97,19,13,6
10,20,98,11,6,5
10,20,99,26,17,9
10,20,100,14,16,-2
10,20,101,31,10,21
10,20,102,20,18,2
10,20,103,21,19,2
10,20,104,18,32,-14
10,20,105,10,6,4
10,20,106,20,21,-1
10,20,107,19,11,8
10,20,108,26,10,16
10,20,109,11,9,2
10,20,110,15,22,-7
10,20,111,16,8,8
10,20,112,15,18,-3
10,20,113,19,25,-6
10,20,114,9,16,-7
10,20,115,7,10,-3
10,20,116,24,9,15
10,20,117,16,15,1
10,20,118,20,13,7
10,20,119,23,7,16
10,20,120,14,15,-1
10,20,121,16,25,-9
10,20,122,21,10,11
10,20,123,16,22,-6
10,20,124,26,21,5
10,20,125,5,6,-1
10,20,126,26,14,12
10,20,127,13,15,-2
10,20,128,15,14,1
10,20,129,9,11,-2
10,20,130,14,13,1
10,20,131,17,11,6
10,20,132,22,11,11
10,20,133,19,20,-1
10,20,134,14,14,0
10,20,135,17,10,7
10,20,136,20,12,8
10,20,137,19,4,15
10,20,138,18,14,4
10,20,139,20,7,13
10,20,140,25,6,19
10,20,141,23,12,11
10,20,142,17,12,5
10,20,143,11,5,6
10,20,144,7,6,1
10,20,145,7,12,-5
10,20,146,10,8,2
10,20,147,24,10,14
10,20,148,15,13,2
10,20,149,7,7,0
10,20,150,21,16,5
10,20,151,11,8,3
10,20,152,13,11,2
10,20,153,19,17,2
10,20,154,8,8,0
10,20,155,17,19,-2
10,20,156,13,19,-6
10,20,157,12,10,2
10,20,158,18,13,5
10,20,159,15,15,0
10,20,160,18,9,9
10,20,161,10,12,-2
10,20,162,14,12,2
10,20,163,13,22,-9
10,20,164,13,12,1
10,20,165,14,19,-5
10,20,166,8,7,1
10,20,167,8,14,-6
10,20,168,23,7,16
10,20,169,14,8,6
10,20,170,12,7,5
10,20,171,21,30,-9
10,20,172,26,16,10
10,20,173,33,9,24
10,20,174,19,13,6
10,20,175,8,11,-3
10,20,176,27,22,5
10,20,177,20,7,13
10,20,178,16,20,-4
10,20,179,13,18,-5
10,20,180,16,17,-1
10,20,181,19,17,2
10,20,182,12,9,3
10,20,183,26,22,4
10,20,184,11,12,-1
10,20,185,12,13,-1
10,20,186,20,10,10
10,20,187,11,16,-5
10,20,188,23,19,4
10,20,189,22,10,12
10,20,190,18,17,1
10,20,191,17,14,3
10,20,192,18,12,6
10,20,193,21,28,-7
10,20,194,22,20,2
10,20,195,19,3,16
10,20,196,37,20,17
10,20,197,17,14,3
10,20,198,10,7,3
10,20,199,30,17,13
10,20,200,14,11,3
10,20,201,13,13,0
10,20,202,20,11,9
10,20,203,9,17,-8
10,20,204,29,32,-3
10,20,205,31,23,8
10,20,206,7,14,-7
10,20,207,7,11,-4
10,20,208,11,7,4
10,20,209,21,18,3
10,20,210,11,7,4
10,20,211,27,24,3
10,20,212,29,19,10
10,20,213,11,9,2
10,20,214,23,18,5
10,20,215,13,21,-8
10,20,216,16,10,6
10,20,217,11,10,1
10,20,218,21,11,10
10,20,219,11,7,4
10,20,220,13,24,-11
10,20,221,10,12,-2
10,20,222,21,10,11
10,20,223,30,22,8
10,20,224,15,14,1
10,20,225,17,14,3
10,20,226,12,7,5
10,20,227,14,7,7
10,20,228,26,19,7
10,20,229,19,23,-4
10,20,230,13,11,2
10,20,231,26,15,11
10,20,232,16,22,-6
10,20,233,30,13,17
10,20,234,27,22,5
10,20,235,10,14,-4
10,20,236,21,11,10
10,20,237,22,16,6
10,20,238,7,11,-4
10,20,239,8,15,-7
10,20,240,8,10,-2
10,20,241,14,5,9
10,20,242,15,14,1
10,20,243,21,10,11
10,20,244,13,18,-5
10,20,245,13,8,5
10,20,246,18,15,3
10,20,247,8,13,-5
10,20,248,21,15,6
10,20,249,13,24,-11
10,20,250,18,15,3
10,20,251,19,5,14
10,20,252,29,19,10
10,20,253,20,14,6
10,20,254,11,4,7
10,20,255,15,14,1
10,20,256,10,8,2
10,20,257,10,9,1
10,20,258,23,11,12
10,20,259,13,20,-7
10,20,260,8,10,-2
10,20,261,21,7,14
10,20,262,13,6,7
10,20,263,28,20,8
10,20,264,16,18,-2
10,20,265,8,8,0
10,20,266,11,16,-5
10,20,267,18,11,7
10,20,268,13,24,-11
10,20,269,26,24,2
10,20,270,15,14,1
10,20,271,21,13,8
10,20,272,25,21,4
10,20,273,12,10,2
10,20,274,17,20,-3
10,20,275,16,14,2
10,20,276,26,19,7
10,20,277,14,23,-9
10,20,278,6,11,-5
10,20,279,26,8,18
10,20,280,16,20,-4
10,20,281,22,24,-2
10,20,282,35,24,11
10,20,283,18,7,11
10,20,284,8,8,0
10,20,285,14,8,6
10,20,286,13,24,-11
10,20,287,11,6,5
10,20,288,11,19,-8
10,20,289,15,12,3
10,20,290,13,14,-1
10,20,291,16,15,1
10,20,292,13,21,-8
10,20,293,26,29,-3
10,20,294,10,13,-3
10,20,295,10,21,-11
10,20,296,8,9,-1
10,20,297,9,9,0
10,20,298,12,22,-10
10,20,299,14,15,-1
10,21,0,16,9,7
10,21,1,22,15,7
10,21,2,14,18,-4
10,21,3,13,12,1
10,21,4,22,12,10
10,21,5,17,5,12
10,21,6,14,8,6
10,21,7,16,12,4
10,21,8,20,27,-7
10,21,9,28,14,14
10,21,10,20,20,0
10,21,11,20,17,3
10,21,12,14,13,1
10,21,13,22,13,9
10,21,14,15,19,-4
10,21,15,14,17,-3
10,21,16,39,21,18
10,21,17,15,5,10
10,21,18,15,17,-2
10,21,19,18,14,4
10,21,20,12,5,7
10,21,21,24,6,18
10,21,22,11,12,-1
10,21,23,15,7,8
10,21,24,18,5,13
10,21,25,21,23,-2
10,21,26,16,9,7
10,21,27,22,3,19
10,21,28,21,10,11
10,21,29,23,17,6
10,21,30,14,5,9
10,21,31,21,12,9
10,21,32,24,14,10
10,21,33,13,12,1
10,21,34,20,7,13
10,21,35,15,10,5
10,21,36,26,7,19
10,21,37,11,12,-1
10,21,38,24,18,6
10,21,39,13,3,10
10,21,40,12,23,-11
10,21,41,14,19,-5
10,21,42,10,16,-6
10,21,43,24,23,1
10,21,44,16,19,-3
10,21,45,35,21,14
10,21,46,22,11,11
10,21,47,19,26,-7
10,21,48,16,7,9
10,21,49,15,7,8
10,21,50,17,8,9
10,21,51,18,12,6
10,21,52,14,19,-5
10,21,53,25,18,7
10,21,54,14,13,1
10,21,55,18,16,2
10,21,56,15,23,-8
10,21,57,11,13,-2
10,21,58,16,5,11
10,21,59,22,22,0
10,21,60,15,11,4
10,21,61,16,16,0
10,21,62,12,17,-5
10,21,63,21,9,12
10,21,64,22,15,7
10,21,65,19,16,3
10,21,66,15,9,6
10,21,67,26,12,14
10,21,68,24,8,16
10,21,69,23,11,12
10,21,70,23,17,6
10,21,71,10,17,-7
10,21,72,17,17,0
10,21,73,16,5,11
10,21,74,21,14,7
10,21,75,23,7,16
10,21,76,14,16,-2
10,21,77,16,14,2
10,21,78,19,18,1
10,21,79,27,11,16
10,21,80,28,16,12
10,21,81,8,16,-8
10,21,82,8,7,1
10,21,83,8,5,3
10,21,84,17,34,-17
10,21,85,19,17,2
10,21,86,13,13,0
10,21,87,13,7,6
10,21,88,26,10,16
10,21,89,22,19,3
10,21,90,29,15,14
10,21,91,31,8,23
10,21,92,21,8,13
10,21,93,29,26,3
10,21,94,27,24,3
10,21,95,22,11,11
10,21,96,10,20,-10
10,21,97,14,3,11
10,21,98,19,16,3
10,21,99,13,14,-1
10,21,100,9,12,-3
10,21,101,11,22,-11
10,21,102,23,13,10
10,21,103,24,12,12
10,21,104,17,20,-3
10,21,105,10,6,4
10,21,106,11,13,-2
10,21,107,9,18,-9
10,21,108,23,9,14
10,21,109,14,25,-11
10,21,110,21,23,-2
10,21,111,9,11,-2
10,21,112,13,6,7
10,21,113,13,17,-4
10,21,114,21,15,6
10,21,115,25,30,-5
10,21,116,11,17,-6
10,21,117,28,20,8
10,21,118,16,13,3
10,21,119,18,21,-3
10,21,120,24,13,11
10,21,121,32,21,11
10,21,122,6,5,1
10,21,123,6,8,-2
10,21,124,13,11,2
10,21,125,13,19,-6
10,21,126,14,15,-1
10,21,127,14,13,1
10,21,128,17,22,-5
10,21,129,12,8,4
10,21,130,11,12,-1
10,21,131,11,13,-2
10,21,132,9,11,-2
10,21,133,28,22,6
10,21,134,16,18,-2
10,21,135,13,21,-8
10,21,136,12,17,-5
10,21,137,12,10,2
10,21,138,15,18,-3
10,21,139,38,11,27
10,21,140,18,19,-1
10,21,141,16,9,7
10,21,142,22,8,14
10,21,143,18,13,5
10,21,144,12,33,-21
10,21,145,19,19,0
10,21,146,10,20,-10
10,21,147,9,14,-5
10,21,148,8,14,-6
10,21,149,8,5,3
10,21,150,11,13,-2
10,21,151,16,8,8
10,21,152,24,12,12
10,21,153,11,9,2
10,21,154,13,7,6
10,21,155,15,17,-2
10,21,156,30,3,27
10,21,157,9,8,1
10,21,158,16,23,-7
10,21,159,18,8,10
10,21,160,33,19,14
10,21,161,8,13,-5
10,21,162,14,23,-9
10,21,163,13,7,6
10,21,164,24,12,12
10,21,165,25,14,11
10,21,166,18,7,11
10,21,167,14,14,0
10,21,168,23,11,12
10,21,169,24,16,8
10,21,170,11,7,4
10,21,171,46,29,17
10,21,172,22,19,3
10,21,173,22,12,10
10,21,174,21,17,4
10,21,175,22,15,7
10,21,176,32,14,18
10,21,177,11,18,-7
10,21,178,12,13,-1
10,21,179,6,9,-3
10,21,180,6,3,3
10,21,181,22,22,0
10,21,182,19,12,7
10,21,183,10,12,-2
10,21,184,7,8,-1
10,21,185,12,6,6
10,21,186,13,12,1
10,21,187,12,16,-4
10,21,188,15,7,8
10,21,189,28,11,17
10,21,190,17,21,-4
10,21,191,15,16,-1
10,21,192,30,19,11
10,21,193,12,11,1
10,21,194,24,14,10
10,21,195,10,14,-4
10,21,196,19,15,4
10,21,197,29,8,21
10,21,198,22,7,15
10,21,199,26,6,20
10,21,200,31,20,11
10,21,201,17,18,-1
10,21,202,19,12,7
10,21,203,18,24,-6
10,21,204,15,8,7
10,21,205,31,17,14
10,21,206,28,22,6
10,21,207,14,21,-7
10,21,208,26,17,9
10,21,209,24,9,15
10,21,210,18,18,0
10,21,211,23,14,9
10,21,212,25,10,15
10,21,213,12,17,-5
10,21,214,4,8,-4
10,21,215,23,8,15
10,21,216,14,7,7
10,21,217,17,17,0
10,21,218,30,14,16
10,21,219,16,11,5
10,21,220,29,13,16
10,21,221,30,19,11
10,21,222,31,11,20
10,21,223,19,18,1
10,21,224,23,5,18
10,21,225,12,15,-3
10,21,226,15,15,0
10,21,227,27,21,6
10,21,228,7,27,-20
10,21,229,19,15,4
10,21,230,19,10,9
10,21,231,16,13,3
10,21,232,27,17,10
10,21,233,19,24,-5
10,21,234,15,7,8
10,21,235,18,14,4
10,21,236,15,12,3
10,21,237,12,17,-5
10,21,238,27,10,17
10,21,239,23,3,20
10,21,240,27,6,21
10,21,241,15,9,6
10,21,242,22,8,14
10,21,243,27,14,13
10,21,244,26,9,17
10,21,245,24,22,2
10,21,246,10,7,3
10,21,247,23,22,1
10,21,248,23,8,15
10,21,249,15,13,2
10,21,250,11,12,-1
10,21,251,15,12,3
10,21,252,18,15,3
10,21,253,18,21,-3
10,21,254,26,11,15
10,21,255,11,16,-5
10,21,256,11,19,-8
10,21,257,7,8,-1
10,21,258,16,15,1
10,21,259,20,4,16
10,21,260,18,8,10
10,21,261,21,14,7
10,21,262,9,1,8
10,21,263,14,16,-2
10,21,264,12,14,-2
10,21,265,35,13,22
10,21,266,20,7,13
10,21,267,6,3,3
10,21,268,11,12,-1
10,21,269,13,10,3
10,21,270,15,19,-4
10,21,271,32,14,18
10,21,272,12,9,3
10,21,273,20,22,-2
10,21,274,10,10,0
10,21,275,15,12,3
10,21,276,28,18,10
10,21,277,25,12,13
10,21,278,15,24,-9
10,21,279,10,7,3
10,21,280,14,17,-3
10,21,281,20,7,13
10,21,282,15,15,0
10,21,283,13,13,0
10,21,284,16,10,6
10,21,285,8,12,-4
10,21,286,17,4,13
10,21,287,23,12,11
10,21,288,15,17,-2
10,21,289,21,8,13
10,21,290,15,16,-1
10,21,291,25,16,9
10,21,292,15,18,-3
10,21,293,15,21,-6
10,21,294,18,17,1
10,21,295,17,12,5
10,21,296,22,17,5
10,21,297,20,19,1
10,21,298,24,14,10
10,21,299,28,22,6
10,22,0,26,9,17
10,22,1,22,10,12
10,22,2,11,12,-1
10,22,3,34,18,16
10,22,4,9,27,-18
10,22,5,10,16,-6
10,22,6,15,13,2
10,22,7,23,23,0
10,22,8,23,6,17
10,22,9,19,11,8
10,22,10,24,12,12
10,22,11,14,8,6
10,22,12,35,24,11
10,22,13,5,10,-5
10,22,14,13,14,-1
10,22,15,25,12,13
10,22,16,13,17,-4
10,22,17,10,15,-5
10,22,18,15,13,2
10,22,19,15,17,-2
10,22,20,23,22,1
10,22,21,18,16,2
10,22,22,16,14,2
10,22,23,16,8,8
10,22,24,25,21,4
10,22,25,25,7,18
10,22,26,27,8,19
10,22,27,18,10,8
10,22,28,27,24,3
10,22,29,11,7,4
10,22,30,25,13,12
10,22,31,15,12,3
10,22,32,13,13,0
10,22,33,26,8,18
10,22,34,5,10,-5
10,22,35,18,3,15
10,22,36,16,16,0
10,22,37,22,14,8
10,22,38,11,8,3
10,22,39,25,17,8
10,22,40,23,14,9
10,22,41,22,15,7
10,22,42,12,16,-4
10,22,43,20,13,7
10,22,44,31,13,18
10,22,45,18,23,-5
10,22,46,21,9,12
10,22,47,24,13,11
10,22,48,15,36,-21
10,22,49,10,5,5
10,22,50,11,16,-5
10,22,51,18,9,9
10,22,52,15,11,4
10,22,53,6,6,0
10,22,54,18,9,9
10,22,55,10,15,-5
10,22,56,24,17,7
10,22,57,19,15,4
10,22,58,26,6,20
10,22,59,25,17,8
10,22,60,7,15,-8
10,22,61,17,14,3
10,22,62,21,14,7
10,22,63,25,15,10
10,22,64,18,11,7
10,22,65,15,9,6
10,22,66,28,15,13
10,22,67,11,15,-4
10,22,68,12,13,-1
10,22,69,13,16,-3
10,22,70,12,22,-10
10,22,71,25,16,9
10,22,72,18,10,8
10,22,73,7,3,4
10,22,74,12,3,9
10,22,75,14,16,-2
10,22,76,24,20,4
10,22,77,17,15,2
10,22,78,18,10,8
10,22,79,4,8,-4
10,22,80,31,10,21
10,22,81,14,8,6
10,22,82,27,19,8
10,22,83,6,5,1
10,22,84,16,8,8
10,22,85,27,26,1
10,22,86,26,20,6
10,22,87,20,20,0
10,22,88,31,21,10
10,22,89,22,16,6
10,22,90,16,14,2
10,22,91,26,13,13
10,22,92,16,16,0
10,22,93,19,10,9
10,22,94,12,10,2
10,22,95,21,12,9
10,22,96,33,9,24
10,22,97,13,6,7
10,22,98,14,8,6
10,22,99,13,9,4
10,22,100,9,12,-3
10,22,101,29,21,8
10,22,102,10,7,3
10,22,103,21,17,4
10,22,104,7,5,2
10,22,105,23,18,5
10,22,106,32,16,16
10,22,107,7,12,-5
10,22,108,15,6,9
10,22,109,31,10,21
10,22,110,16,13,3
10,22,111,16,5,11
10,22,112,16,3,13
10,22,113,10,14,-4
10,22,114,12,6,6
10,22,115,18,18,0
10,22,116,7,7,0
10,22,117,18,8,10
10,22,118,11,7,4
10,22,119,20,12,8
10,22,120,29,11,18
10,22,121,13,7,6
10,22,122,9,16,-7
10,22,123,25,15,10
10,22,124,15,18,-3
10,22,125,23,19,4
10,22,126,18,21,-3
10,22,127,23,9,14
10,22,128,21,10,11
10,22,129,22,9,13
10,22,130,27,12,15
10,22,131,18,17,1
10,22,132,21,15,6
10,22,133,14,11,3
10,22,134,18,10,8
10,22,135,21,11,10
10,22,136,19,17,2
10,22,137,11,12,-1
10,22,138,24,4,20
10,22,139,13,15,-2
10,22,140,19,8,11
10,22,141,19,8,11
10,22,142,9,7,2
10,22,143,6,10,-4
10,22,144,15,9,6
10,22,145,21,11,10
10,22,146,13,9,4
10,22,147,21,8,13
10,22,148,34,16,18
10,22,149,10,9,1
10,22,150,30,13,17
10,22,151,12,22,-10
10,22,152,7,10,-3
10,22,153,12,15,-3
10,22,154,28,10,18
10,22,155,25,11,14
10,22,156,18,16,2
10,22,157,20,13,7
10,22,158,10,9,1
10,22,159,17,10,7
10,22,160,23,23,0
10,22,161,23,13,10
10,22,162,8,13,-5
10,22,163,25,11,14
10,22,164,11,23,-12
10,22,165,26,22,4
10,22,166,23,10,13
10,22,167,27,19,8
10,22,168,31,14,17
10,22,169,19,7,12
10,22,170,12,11,1
10,22,171,26,15,11
10,22,172,18,10,8
10,22,173,10,10,0
10,22,174,17,13,4
10,22,175,19,18,1
10,22,176,17,8,9
10,22,177,32,12,20
10,22,178,23,15,8
10,22,179,17,20,-3
10,22,180,23,23,0
10,22,181,16,16,0
10,22,182,22,8,14
10,22,183,12,20,-8
10,22,184,28,19,9
10,22,185,9,14,-5
10,22,186,11,8,3
10,22,187,22,21,1
10,22,188,20,15,5
10,22,189,24,22,2
10,22,190,15,11,4
10,22,191,29,11,18
10,22,192,19,7,12
10,22,193,17,12,5
10,22,194,19,18,1
10,22,195,17,12,5
10,22,196,16,5,11
10,22,197,33,19,14
10,22,198,23,12,11
10,22,199,32,9,23
10,22,200,13,7,6
10,22,201,31,16,15
10,22,202,11,9,2
10,22,203,9,13,-4
10,22,204,18,10,8
10,22,205,18,5,13
10,22,206,14,12,2
10,22,207,11,6,5
10,22,208,22,16,6
10,22,209,16,9,7
10,22,210,17,17,0
10,22,211,18,13,5
10,22,212,29,20,9
10,22,213,14,14,0
10,22,214,12,13,-1
10,22,215,20,7,13
10,22,216,22,13,9
10,22,217,26,16,10
10,22,218,37,28,9
10,22,219,21,12,9
10,22,220,13,16,-3
10,22,221,27,13,14
10,22,222,19,12,7
10,22,223,15,9,6
10,22,224,18,12,6
10,22,225,15,4,11
10,22,226,10,8,2
10,22,227,14,10,4
10,22,228,6,9,-3
10,22,229,25,16,9
10,22,230,19,13,6
10,22,231,11,5,6
10,22,232,20,12,8
10,22,233,25,26,-1
10,22,234,13,8,5
10,22,235,27,13,14
10,22,236,7,7,0
10,22,237,21,13,8
10,22,238,14,31,-17
10,22,239,27,13,14
10,22,240,9,11,-2
10,22,241,14,17,-3
10,22,242,11,12,-1
10,22,243,17,5,12
10,22,244,23,16,7
10,22,245,8,8,0
10,22,246,12,6,6
10,22,247,25,9,16
10,22,248,19,12,7
10,22,249,14,11,3
10,22,250,20,14,6
10,22,251,13,11,2
10,22,252,22,12,10
10,22,253,5,5,0
10,22,254,9,11,-2
10,22,255,12,3,9
10,22,256,25,13,12
10,22,257,19,17,2
10,22,258,11,11,0
10,22,259,14,10,4
10,22,260,25,10,15
10,22,261,16,13,3
10,22,262,24,15,9
10,22,263,20,6,14
10,22,264,17,18,-1
10,22,265,26,28,-2
10,22,266,16,7,9
10,22,267,29,26,3
10,22,268,29,14,15
10,22,269,11,10,1
10,22,270,12,16,-4
10,22,271,20,27,-7
10,22,272,14,20,-6
10,22,273,13,8,5
10,22,274,19,16,3
10,22,275,17,12,5
10,22,276,28,7,21
10,22,277,10,6,4
10,22,278,12,17,-5
10,22,279,16,11,5
10,22,280,11,13,-2
10,22,281,29,11,18
10,22,282,20,22,-2
10,22,283,17,8,9
10,22,284,23,18,5
10,22,285,12,7,5
10,22,286,22,30,-8
10,22,287,16,13,3
10,22,288,21,19,2
10,22,289,25,10,15
10,22,290,15,15,0
10,22,291,25,6,19
10,22,292,16,7,9
10,22,293,15,5,10
10,22,294,17,11,6
10,22,295,16,25,-9
10,22,296,20,10,10
10,22,297,23,11,12
10,22,298,17,16,1
10,22,299,7,6,1
10,23,0,10,13,-3
10,23,1,28,8,20
10,23,2,8,10,-2
10,23,3,9,7,2
10,23,4,8,4,4
10,23,5,10,9,1
10,23,6,24,18,6
10,23,7,17,12,5
10,23,8,38,13,25
10,23,9,16,12,4
10,23,10,20,21,-1
10,23,11,23,14,9
10,23,12,4,7,-3
10,23,13,16,9,7
10,23,14,22,16,6
10,23,15,10,8,2
10,23,16,19,12,7
10,23,17,5,4,1
10,23,18,15,17,-2
10,23,19,9,10,-1
10,23,20,15,13,2
10,23,21,16,10,6
10,23,22,23,9,14
10,23,23,13,13,0
10,23,24,21,17,4
10,23,25,9,14,-5
10,23,26,18,5,13
10,23,27,10,7,3
10,23,28,23,5,18
10,23,29,13,12,1
10,23,30,16,8,8
10,23,31,17,14,3
10,23,32,29,10,19
10,23,33,31,21,10
10,23,34,27,22,5
10,23,35,18,3,15
10,23,36,15,12,3
10,23,37,16,21,-5
10,23,38,9,7,2
10,23,39,25,9,16
10,23,40,10,9,1
10,23,41,12,16,-4
10,23,42,13,10,3
10,23,43,14,14,0
10,23,44,15,7,8
10,23,45,24,23,1
10,23,46,33,22,11
10,23,47,24,7,17
10,23,48,13,8,5
10,23,49,24,19,5
10,23,50,15,12,3
10,23,51,24,16,8
10,23,52,12,13,-1
10,23,53,18,12,6
10,23,54,15,15,0
10,23,55,27,10,17
10,23,56,12,16,-4
10,23,57,28,20,8
10,23,58,28,26,2
10,23,59,15,10,5
10,23,60,11,19,-8
10,23,61,19,13,6
10,23,62,13,7,6
10,23,63,24,20,4
10,23,64,28,16,12
10,23,65,13,16,-3
10,23,66,15,16,-1
10,23,67,24,11,13
10,23,68,23,21,2
10,23,69,32,21,11
10,23,70,19,12,7
10,23,71,24,15,9
10,23,72,21,7,14
10,23,73,23,6,17
10,23,74,22,15,7
10,23,75,13,3,10
10,23,76,12,18,-6
10,23,77,10,11,-1
10,23,78,16,15,1
10,23,79,19,16,3
10,23,80,23,7,16
10,23,81,23,9,14
10,23,82,17,15,2
10,23,83,20,25,-5
10,23,84,10,9,1
10,23,85,23,11,12
10,23,86,16,14,2
10,23,87,17,22,-5
10,23,88,31,14,17
10,23,89,30,7,23
10,23,90,19,18,1
10,23,91,20,28,-8
10,23,92,9,12,-3
10,23,93,24,22,2
10,23,94,6,7,-1
10,23,95,21,12,9
10,23,96,18,11,7
10,23,97,15,5,10
10,23,98,13,29,-16
10,23,99,14,11,3
10,23,100,22,20,2
10,23,101,24,12,12
10,23,102,22,7,15
10,23,103,27,4,23
10,23,104,27,13,14
10,23,105,9,11,-2
10,23,106,20,12,8
10,23,107,12,3,9
10,23,108,23,19,4
10,23,109,11,15,-4
10,23,110,18,6,12
10,23,111,26,19,7
10,23,112,28,10,18
10,23,113,25,26,-1
10,23,114,19,16,3
10,23,115,11,13,-2
10,23,116,23,19,4
10,23,117,23,16,7
10,23,118,9,10,-1
10,23,119,13,11,2
10,23,120,19,14,5
10,23,121,11,12,-1
10,23,122,24,12,12
10,23,123,22,12,10
10,23,124,20,10,10
10,23,125,19,18,1
10,23,126,26,11,15
10,23,127,13,18,-5
10,23,128,20,21,-1
10,23,129,18,17,1
10,23,130,18,8,10
10,23,131,20,8,12
10,23,132,10,14,-4
10,23,133,17,20,-3
10,23,134,10,15,-5
10,23,135,16,9,7
10,23,136,12,14,-2
10,23,137,14,9,5
10,23,138,8,13,-5
10,23,139,12,9,3
10,23,140,19,19,0
10,23,141,31,14,17
10,23,142,15,15,0
10,23,143,18,14,4
10,23,144,9,19,-10
10,23,145,21,11,10
10,23,146,26,13,13
10,23,147,18,13,5
10,23,148,16,14,2
10,23,149,21,4,17
10,23,150,18,2,16
10,23,151,9,14,-5
10,23,152,28,15,13
10,23,153,11,13,-2
10,23,154,18,11,7
10,23,155,9,11,-2
10,23,156,18,12,6
10,23,157,15,8,7
10,23,158,20,7,13
10,23,159,21,13,8
10,23,160,10,11,-1
10,23,161,24,8,16
10,23,162,21,15,6
10,23,163,20,15,5
10,23,164,8,13,-5
10,23,165,23,14,9
10,23,166,17,8,9
10,23,167,11,9,2
10,23,168,24,6,18
10,23,169,11,4,7
10,23,170,21,7,14
10,23,171,8,9,-1
10,23,172,8,17,-9
10,23,173,19,20,-1
10,23,174,21,20,1
10,23,175,8,12,-4
10,23,176,20,11,9
10,23,177,15,13,2
10,23,178,10,7,3
10,23,179,8,8,0
10,23,180,20,18,2
10,23,181,22,11,11
10,23,182,12,13,-1
10,23,183,18,8,10
10,23,184,18,19,-1
10,23,185,25,27,-2
10,23,186,14,24,-10
10,23,187,15,13,2
10,23,188,14,17,-3
10,23,189,27,11,16
10,23,190,32,12,20
10,23,191,30,24,6
10,23,192,14,10,4
10,23,193,23,15,8
10,23,194,12,7,5
10,23,195,26,16,10
10,23,196,31,7,24
10,23,197,24,5,19
10,23,198,16,17,-1
10,23,199,18,14,4
10,23,200,15,19,-4
10,23,201,22,10,12
10,23,202,20,13,7
10,23,203,18,19,-1
10,23,204,26,16,10
10,23,205,24,12,12
10,23,206,12,14,-2
10,23,207,14,25,-11
10,23,208,14,10,4
10,23,209,29,16,13
10,23,210,22,20,2
10,23,211,15,15,0
10,23,212,28,7,21
10,23,213,27,13,14
10,23,214,10,15,-5
10,23,215,17,11,6
10,23,216,24,21,3
10,23,217,19,15,4
10,23,218,17,12,5
10,23,219,10,9,1
10,23,220,12,13,-1
10,23,221,25,14,11
10,23,222,15,11,4
10,23,223,13,8,5
10,23,224,10,3,7
10,23,225,19,20,-1
10,23,226,8,21,-13
10,23,227,17,12,5
10,23,228,27,7,20
10,23,229,33,17,16
10,23,230,16,12,4
10,23,231,30,12,18
10,23,232,20,11,9
10,23,233,23,7,16
10,23,234,18,12,6
10,23,235,17,20,-3
10,23,236,11,5,6
10,23,237,25,14,11
10,23,238,14,19,-5
10,23,239,15,12,3
10,23,240,12,10,2
10,23,241,14,4,10
10,23,242,10,4,6
10,23,243,18,12,6
10,23,244,21,6,15
10,23,245,11,10,1
10,23,246,26,24,2
10,23,247,22,8,14
10,23,248,18,14,4
10,23,249,18,9,9
10,23,250,15,13,2
10,23,251,18,15,3
10,23,252,15,12,3
10,23,253,35,11,24
10,23,254,25,10,15
10,23,255,14,11,3
10,23,256,21,4,17
10,23,257,24,21,3
10,23,258,16,10,6
10,23,259,28,5,23
10,23,260,26,10,16
10,23,261,10,9,1
10,23,262,11,12,-1
10,23,263,25,11,14
10,23,264,16,14,2
10,23,265,18,11,7
10,23,266,19,8,11
10,23,267,20,15,5
10,23,268,24,13,11
10,23,269,11,8,3
10,23,270,13,11,2
10,23,271,10,9,1
10,23,272,12,14,-2
10,23,273,5,17,-12
10,23,274,20,16,4
10,23,275,15,2,13
10,23,276,15,12,3
10,23,277,29,18,11
10,23,278,24,7,17
10,23,279,24,17,7
10,23,280,17,7,10
10,23,281,13,11,2
10,23,282,14,12,2
10,23,283,21,7,14
10,23,284,7,10,-3
10,23,285,23,16,7
10,23,286,18,20,-2
10,23,287,13,11,2
10,23,288,15,6,9
10,23,289,10,8,2
10,23,290,27,13,14
10,23,291,15,8,7
10,23,292,29,20,9
10,23,293,17,16,1
10,23,294,9,15,-6
10,23,295,14,13,1
10,23,296,2,11,-9
10,23,297,22,15,7
10,23,298,24,22,2
10,23,299,15,13,2
10,24,0,26,12,14
10,24,1,12,16,-4
10,24,2,18,8,10
10,24,3,16,15,1
10,24,4,13,14,-1
10,24,5,20,10,10
10,24,6,12,8,4
10,24,7,23,25,-2
10,24,8,20,6,14
10,24,9,9,5,4
10,24,10,19,13,6
10,24,11,18,21,-3
10,24,12,17,5,12
10,24,13,22,11,11
10,24,14,16,6,10
10,24,15,22,21,1
10,24,16,6,9,-3
10,24,17,12,23,-11
10,24,18,19,15,4
10,24,19,18,17,1
10,24,20,13,19,-6
10,24,21,13,9,4
10,24,22,4,2,2
10,24,23,25,18,7
10,24,24,13,7,6
10,24,25,13,8,5
10,24,26,13,5,8
10,24,27,9,5,4
10,24,28,19,11,8
10,24,29,16,15,1
10,24,30,26,15,11
10,24,31,13,5,8
10,24,32,21,9,12
10,24,33,21,16,5
10,24,34,30,23,7
10,24,35,21,17,4
10,24,36,3,14,-11
10,24,37,18,15,3
10,24,38,21,15,6
10,24,39,25,15,10
10,24,40,8,5,3
10,24,41,12,14,-2
10,24,42,23,15,8
10,24,43,7,4,3
10,24,44,15,16,-1
10,24,45,8,4,4
10,24,46,13,7,6
10,24,47,20,12,8
10,24,48,14,9,5
10,24,49,8,9,-1
10,24,50,16,12,4
10,24,51,19,6,13
10,24,52,23,18,5
10,24,53,21,4,17
10,24,54,33,13,20
10,24,55,24,18,6
10,24,56,25,20,5
10,24,57,20,16,4
10,24,58,11,13,-2
10,24,59,14,6,8
10,24,60,10,12,-2
10,24,61,25,14,11
10,24,62,31,11,20
10,24,63,8,7,1
10,24,64,16,7,9
10,24,65,22,14,8
10,24,66,22,5,17
10,24,67,6,9,-3
10,24,68,22,8,14
10,24,69,15,19,-4
10,24,70,13,6,7
10,24,71,11,11,0
10,24,72,14,7,7
10,24,73,11,12,-1
10,24,74,17,19,-2
10,24,75,15,5,10
10,24,76,25,20,5
10,24,77,25,15,10
10,24,78,19,12,7
10,24,79,9,22,-13
10,24,80,13,9,4
10,24,81,30,20,10
10,24,82,16,10,6
10,24,83,28,13,15
10,24,84,30,19,11
10,24,85,12,8,4
10,24,86,29,15,14
10,24,87,16,1,15
10,24,88,11,9,2
10,24,89,14,7,7
10,24,90,19,23,-4
10,24,91,27,15,12
10,24,92,22,16,6
10,24,93,23,22,1
10,24,94,14,15,-1
10,24,95,18,18,0
10,24,96,21,3,18
10,24,97,27,12,15
10,24,98,21,15,6
10,24,99,16,21,-5
10,24,100,11,4,7
10,24,101,23,14,9
10,24,102,21,12,9
10,24,103,16,12,4
10,24,104,21,22,-1
10,24,105,14,6,8
10,24,106,6,8,-2
10,24,107,19,10,9
10,24,108,13,17,-4
10,24,109,14,10,4
10,24,110,15,10,5
10,24,111,14,15,-1
10,24,112,28,19,9
10,24,113,16,7,9
10,24,114,14,15,-1
10,24,115,16,19,-3
10,24,116,21,13,8
10,24,117,20,18,2
10,24,118,6,10,-4
10,24,119,17,13,4
10,24,120,16,22,-6
10,24,121,23,9,14
10,24,122,18,9,9
10,24,123,21,20,1
10,24,124,8,11,-3
10,24,125,14,19,-5
10,24,126,19,9,10
10,24,127,20,11,9
10,24,128,5,7,-2
10,24,129,17,12,5
10,24,130,18,10,8
10,24,131,11,13,-2
10,24,132,27,4,23
10,24,133,23,12,11
10,24,134,21,4,17
10,24,135,20,17,3
10,24,136,19,7,12
10,24,137,29,11,18
10,24,138,25,12,13
10,24,139,22,12,10
10,24,140,24,15,9
10,24,141,16,15,1
10,24,142,17,11,6
10,24,143,22,7,15
10,24,144,13,18,-5
10,24,145,14,20,-6
10,24,146,19,17,2
10,24,147,34,17,17
10,24,148,14,10,4
10,24,149,13,9,4
10,24,150,15,12,3
10,24,151,19,9,10
10,24,152,15,13,2
10,24,153,17,12,5
10,24,154,31,13,18
10,24,155,14,9,5
10,24,156,22,11,11
10,24,157,19,25,-6
10,24,158,20,14,6
10,24,159,16,15,1
10,24,160,19,20,-1
10,24,161,21,14,7
10,24,162,12,0,12
10,24,163,12,9,3
10,24,164,12,15,-3
10,24,165,14,8,6
10,24,166,10,12,-2
10,24,167,9,11,-2
10,24,168,18,7,11
10,24,169,41,29,12
10,24,170,10,9,1
10,24,171,28,26,2
10,24,172,13,18,-5
10,24,173,26,14,12
10,24,174,25,15,10
10,24,175,9,9,0
10,24,176,23,8,15
10,24,177,28,19,9
10,24,178,9,10,-1
10,24,179,25,19,6
10,24,180,18,11,7
10,24,181,20,16,4
10,24,182,31,18,13
10,24,183,20,9,11
10,24,184,18,12,6
10,24,185,9,12,-3
10,24,186,26,11,15
10,24,187,11,13,-2
10,24,188,25,19,6
10,24,189,24,8,16
10,24,190,15,5,10
10,24,191,15,10,5
10,24,192,16,13,3
10,24,193,10,15,-5
10,24,194,10,4,6
10,24,195,5,12,-7
10,24,196,14,23,-9
10,24,197,31,13,18
10,24,198,8,3,5
10,24,199,16,7,9
10,24,200,30,19,11
10,24,201,26,8,18
10,24,202,17,10,7
10,24,203,22,19,3
10,24,204,19,12,7
10,24,205,15,4,11
10,24,206,17,5,12
10,24,207,23,5,18
10,24,208,13,8,5
10,24,209,20,15,5
10,24,210,21,15,6
10,24,211,33,21,12
10,24,212,8,6,2
10,24,213,28,7,21
10,24,214,28,18,10
10,24,215,14,6,8
10,24,216,8,7,1
10,24,217,21,15,6
10,24,218,20,15,5
10,24,219,30,29,1
10,24,220,6,9,-3
10,24,221,20,12,8
10,24,222,18,8,10
10,24,223,16,12,4
10,24,224,16,9,7
10,24,225,25,23,2
10,24,226,16,9,7
10,24,227,15,11,4
10,24,228,10,6,4
10,24,229,21,16,5
10,24,230,17,9,8
10,24,231,16,13,3
10,24,232,20,20,0
10,24,233,14,13,1
10,24,234,22,20,2
10,24,235,17,10,7
10,24,236,21,19,2
10,24,237,12,15,-3
10,24,238,16,12,4
10,24,239,14,8,6
10,24,240,14,9,5
10,24,241,14,14,0
10,24,242,19,9,10
10,24,243,19,21,-2
10,24,244,23,10,13
10,24,245,24,11,13
10,24,246,9,5,4
10,24,247,27,5,22
10,24,248,29,14,15
10,24,249,11,11,0
10,24,250,25,10,15
10,24,251,15,14,1
10,24,252,23,14,9
10,24,253,31,18,13
10,24,254,12,6,6
10,24,255,33,13,20
10,24,256,8,19,-11
10,24,257,12,11,1
10,24,258,14,10,4
10,24,259,22,7,15
10,24,260,15,13,2
10,24,261,22,18,4
10,24,262,14,15,-1
10,24,263,14,12,2
10,24,264,25,16,9
10,24,265,16,4,12
10,24,266,12,8,4
10,24,267,19,10,9
10,24,268,15,20,-5
10,24,269,11,10,1
10,24,270,17,17,0
10,24,271,13,24,-11
10,24,272,26,13,13
10,24,273,5,4,1
10,24,274,17,3,14
10,24,275,20,11,9
10,24,276,7,13,-6
10,24,277,13,8,5
10,24,278,14,7,7
10,24,279,15,9,6
10,24,280,14,9,5
10,24,281,20,17,3
10,24,282,18,7,11
10,24,283,22,6,16
10,24,284,32,21,11
10,24,285,23,14,9
10,24,286,20,7,13
10,24,287,18,15,3
10,24,288,7,13,-6
10,24,289,10,6,4
10,24,290,13,12,1
10,24,291,15,8,7
10,24,292,19,5,14
10,24,293,29,11,18
10,24,294,13,8,5
10,24,295,17,13,4
10,24,296,21,13,8
10,24,297,17,18,-1
10,24,298,23,16,7
10,24,299,18,19,-1
10,25,0,14,3,11
10,25,1,23,9,14
10,25,2,11,17,-6
10,25,3,46,6,40
10,25,4,24,12,12
10,25,5,21,12,9
10,25,6,15,9,6
10,25,7,17,15,2
10,25,8,20,16,4
10,25,9,24,17,7
10,25,10,24,9,15
10,25,11,12,16,-4
10,25,12,18,14,4
10,25,13,9,10,-1
10,25,14,12,4,8
10,25,15,34,21,13
10,25,16,19,12,7
10,25,17,20,10,10
10,25,18,8,2,6
10,25,19,17,16,1
10,25,20,8,11,-3
10,25,21,32,18,14
10,25,22,14,16,-2
10,25,23,23,14,9
10,25,24,14,7,7
10,25,25,17,14,3
10,25,26,7,5,2
10,25,27,27,13,14
10,25,28,14,7,7
10,25,29,17,11,6
10,25,30,28,17,11
10,25,31,18,11,7
10,25,32,19,6,13
10,25,33,22,6,16
10,25,34,12,5,7
10,25,35,16,12,4
10,25,36,12,5,7
10,25,37,21,17,4
10,25,38,38,13,25
10,25,39,22,20,2
10,25,40,16,9,7
10,25,41,13,15,-2
10,25,42,22,8,14
10,25,43,24,12,12
10,25,44,19,11,8
10,25,45,21,19,2
10,25,46,23,8,15
10,25,47,19,10,9
10,25,48,17,17,0
10,25,49,21,9,12
10,25,50,27,19,8
10,25,51,25,19,6
10,25,52,13,9,4
10,25,53,19,11,8
10,25,54,15,15,0
10,25,55,24,15,9
10,25,56,14,11,3
10,25,57,20,17,3
10,25,58,21,11,10
10,25,59,31,16,15
10,25,60,18,11,7
10,25,61,17,11,6
10,25,62,29,8,21
10,25,63,22,9,13
10,25,64,13,5,8
10,25,65,21,11,10
10,25,66,12,18,-6
10,25,67,3,5,-2
10,25,68,12,9,3
10,25,69,23,23,0
10,25,70,23,16,7
10,25,71,6,7,-1
10,25,72,7,16,-9
10,25,73,7,10,-3
10,25,74,23,20,3
10,25,75,38,14,24
10,25,76,16,5,11
10,25,77,15,8,7
10,25,78,16,12,4
10,25,79,7,17,-10
10,25,80,18,15,3
10,25,81,18,16,2
10,25,82,30,26,4
10,25,83,16,11,5
10,25,84,22,20,2
10,25,85,12,4,8
10,25,86,21,8,13
10,25,87,28,17,11
10,25,88,20,9,11
10,25,89,33,19,14
10,25,90,14,5,9
10,25,91,12,13,-1
10,25,92,13,10,3
10,25,93,34,12,22
10,25,94,18,11,7
10,25,95,31,12,19
10,25,96,10,15,-5
10,25,97,19,16,3
10,25,98,9,17,-8
10,25,99,25,12,13
10,25,100,16,11,5
10,25,101,27,9,18
10,25,102,12,20,-8
10,25,103,16,9,7
10,25,104,15,9,6
10,25,105,25,10,15
10,25,106,18,14,4
10,25,107,14,8,6
10,25,108,14,12,2
10,25,109,29,12,17
10,25,110,20,3,17
10,25,111,11,10,1
10,25,112,26,17,9
10,25,113,10,8,2
10,25,114,18,9,9
10,25,115,21,10,11
10,25,116,21,16,5
10,25,117,11,12,-1
10,25,118,15,15,0
10,25,119,12,7,5
10,25,120,9,2,7
10,25,121,7,12,-5
10,25,122,32,13,19
10,25,123,24,19,5
10,25,124,17,17,0
10,25,125,25,11,14
10,25,126,22,14,8
10,25,127,16,9,7
10,25,128,12,12,0
10,25,129,25,16,9
10,25,130,15,8,7
10,25,131,15,18,-3
10,25,132,13,10,3
10,25,133,16,14,2
10,25,134,24,11,13
10,25,135,12,6,6
10,25,136,12,11,1
10,25,137,7,10,-3
10,25,138,19,19,0
10,25,139,10,9,1
10,25,140,16,11,5
10,25,141,29,13,16
10,25,142,21,12,9
10,25,143,31,21,10
10,25,144,18,10,8
10,25,145,14,2,12
10,25,146,30,11,19
10,25,147,19,5,14
10,25,148,32,16,16
10,25,149,27,14,13
10,25,150,12,9,3
10,25,151,14,8,6
10,25,152,17,6,11
10,25,153,14,17,-3
10,25,154,21,10,11
10,25,155,13,9,4
10,25,156,10,12,-2
10,25,157,22,22,0
10,25,158,32,14,18
10,25,159,16,10,6
10,25,160,38,23,15
10,25,161,16,11,5
10,25,162,11,9,2
10,25,163,7,9,-2
10,25,164,16,14,2
10,25,165,14,10,4
10,25,166,22,13,9
10,25,167,10,20,-10
10,25,168,12,8,4
10,25,169,21,13,8
10,25,170,10,9,1
10,25,171,16,22,-6
10,25,172,15,6,9
10,25,173,26,14,12
10,25,174,28,11,17
10,25,175,12,3,9
10,25,176,17,14,3
10,25,177,21,19,2
10,25,178,13,8,5
10,25,179,27,7,20
10,25,180,23,26,-3
10,25,181,25,6,19
10,25,182,25,23,2
10,25,183,15,11,4
10,25,184,16,13,3
10,25,185,15,11,4
10,25,186,11,8,3
10,25,187,16,15,1
10,25,188,5,8,-3
10,25,189,15,7,8
10,25,190,14,15,-1
10,25,191,31,21,10
10,25,192,18,9,9
10,25,193,14,5,9
10,25,194,9,12,-3
10,25,195,16,25,-9
10,25,196,8,8,0
10,25,197,29,7,22
10,25,198,10,3,7
10,25,199,26,15,11
10,25,200,13,17,-4
10,25,201,30,7,23
10,25,202,24,21,3
10,25,203,15,22,-7
10,25,204,22,17,5
10,25,205,11,8,3
10,25,206,11,20,-9
10,25,207,16,5,11
10,25,208,9,10,-1
10,25,209,26,12,14
10,25,210,28,11,17
10,25,211,28,18,10
10,25,212,26,10,16
10,25,213,17,21,-4
10,25,214,12,11,1
10,25,215,21,17,4
10,25,216,23,18,5
10,25,217,23,13,10
10,25,218,14,7,7
10,25,219,19,16,3
10,25,220,28,21,7
10,25,221,17,10,7
10,25,222,23,13,10
10,25,223,5,8,-3
10,25,224,37,23,14
10,25,225,18,16,2
10,25,226,15,13,2
10,25,227,6,5,1
10,25,228,12,14,-2
10,25,229,26,20,6
10,25,230,10,17,-7
10,25,231,24,20,4
10,25,232,16,14,2
10,25,233,11,7,4
10,25,234,18,9,9
10,25,235,28,8,20
10,25,236,16,10,6
10,25,237,16,10,6
10,25,238,17,14,3
10,25,239,34,18,16
10,25,240,17,15,2
10,25,241,24,19,5
10,25,242,12,6,6
10,25,243,10,18,-8
10,25,244,26,9,17
10,25,245,13,8,5
10,25,246,14,7,7
10,25,247,21,18,3
10,25,248,12,7,5
10,25,249,16,17,-1
10,25,250,11,19,-8
10,25,251,5,17,-12
10,25,252,20,11,9
10,25,253,32,12,20
10,25,254,24,12,12
10,25,255,20,18,2
10,25,256,11,10,1
10,25,257,13,6,7
10,25,258,11,6,5
10,25,259,23,10,13
10,25,260,14,11,3
10,25,261,22,12,10
10,25,262,10,15,-5
10,25,263,15,9,6
10,25,264,12,9,3
10,25,265,30,15,15
10,25,266,23,14,9
10,25,267,13,17,-4
10,25,268,21,12,9
10,25,269,23,11,12
10,25,270,15,11,4
10,25,271,17,5,12
10,25,272,20,9,11
10,25,273,20,6,14
10,25,274,17,18,-1
10,25,275,29,9,20
10,25,276,37,17,20
10,25,277,19,12,7
10,25,278,17,12,5
10,25,279,20,14,6
10,25,280,13,15,-2
10,25,281,26,26,0
10,25,282,29,8,21
10,25,283,22,8,14
10,25,284,23,20,3
10,25,285,16,7,9
10,25,286,11,18,-7
10,25,287,13,13,0
10,25,288,20,13,7
10,25,289,11,18,-7
10,25,290,24,17,7
10,25,291,10,8,2
10,25,292,25,14,11
10,25,293,26,20,6
10,25,294,19,21,-2
10,25,295,27,23,4
10,25,296,36,13,23
10,25,297,18,10,8
10,25,298,14,12,2
10,25,299,10,16,-6
10,26,0,9,15,-6
10,26,1,15,15,0
10,26,2,20,21,-1
10,26,3,20,13,7
10,26,4,23,17,6
10,26,5,21,12,9
10,26,6,22,13,9
10,26,7,12,10,2
10,26,8,13,8,5
10,26,9,19,10,9
10,26,10,9,10,-1
10,26,11,24,7,17
10,26,12,15,7,8
10,26,13,14,6,8
10,26,14,20,13,7
10,26,15,7,3,4
10,26,16,6,9,-3
10,26,17,18,15,3
10,26,18,14,9,5
10,26,19,18,15,3
10,26,20,12,3,9
10,26,21,16,8,8
10,26,22,20,11,9
10,26,23,26,9,17
10,26,24,6,7,-1
10,26,25,25,7,18
10,26,26,15,9,6
10,26,27,28,18,10
10,26,28,26,17,9
10,26,29,17,14,3
10,26,30,10,6,4
10,26,31,9,9,0
10,26,32,9,6,3
10,26,33,15,13,2
10,26,34,11,10,1
10,26,35,10,8,2
10,26,36,34,6,28
10,26,37,21,15,6
10,26,38,10,12,-2
10,26,39,14,8,6
10,26,40,13,10,3
10,26,41,20,12,8
10,26,42,20,11,9
10,26,43,24,8,16
10,26,44,18,20,-2
10,26,45,16,23,-7
10,26,46,21,14,7
10,26,47,14,7,7
10,26,48,13,17,-4
10,26,49,13,7,6
10,26,50,11,11,0
10,26,51,13,16,-3
10,26,52,21,7,14
10,26,53,16,16,0
10,26,54,23,9,14
10,26,55,20,9,11
10,26,56,26,5,21
10,26,57,15,11,4
10,26,58,11,14,-3
10,26,59,16,17,-1
10,26,60,30,8,22
10,26,61,16,5,11
10,26,62,17,8,9
10,26,63,25,14,11
10,26,64,22,15,7
10,26,65,30,17,13
10,26,66,20,9,11
10,26,67,12,6,6
10,26,68,32,20,12
10,26,69,13,10,3
10,26,70,28,12,16
10,26,71,14,8,6
10,26,72,21,20,1
10,26,73,13,6,7
10,26,74,22,11,11
10,26,75,16,14,2
10,26,76,18,15,3
10,26,77,29,15,14
10,26,78,18,9,9
10,26,79,15,14,1
10,26,80,31,11,20
10,26,81,16,4,12
10,26,82,24,11,13
10,26,83,23,13,10
10,26,84,21,12,9
10,26,85,13,8,5
10,26,86,9,10,-1
10,26,87,27,10,17
10,26,88,6,14,-8
10,26,89,18,18,0
10,26,90,11,7,4
10,26,91,21,10,11
10,26,92,14,8,6
10,26,93,10,15,-5
10,26,94,15,15,0
10,26,95,18,12,6
10,26,96,4,6,-2
10,26,97,23,19,4
10,26,98,18,7,11
10,26,99,16,2,14
10,26,100,13,13,0
10,26,101,18,10,8
10,26,102,18,15,3
10,26,103,13,9,4
10,26,104,20,5,15
10,26,105,15,6,9
10,26,106,28,16,12
10,26,107,16,9,7
10,26,108,16,8,8
10,26,109,23,13,10
10,26,110,17,9,8
10,26,111,23,19,4
10,26,112,18,19,-1
10,26,113,27,19,8
10,26,114,9,15,-6
10,26,115,30,21,9
10,26,116,30,9,21
10,26,117,10,7,3
10,26,118,18,16,2
10,26,119,16,22,-6
10,26,120,14,6,8
10,26,121,27,15,12
10,26,122,17,11,6
10,26,123,22,15,7
10,26,124,15,13,2
10,26,125,28,16,12
10,26,126,33,15,18
10,26,127,31,8,23
10,26,128,24,6,18
10,26,129,15,4,11
10,26,130,20,21,-1
10,26,131,16,7,9
10,26,132,10,4,6
10,26,133,22,9,13
10,26,134,21,12,9
10,26,135,40,20,20
10,26,136,14,8,6
10,26,137,15,10,5
10,26,138,16,15,1
10,26,139,24,14,10
10,26,140,13,7,6
10,26,141,17,5,12
10,26,142,32,17,15
10,26,143,32,21,11
10,26,144,20,11,9
10,26,145,22,11,11
10,26,146,10,10,0
10,26,147,12,10,2
10,26,148,6,7,-1
10,26,149,16,6,10
10,26,150,23,10,13
10,26,151,43,17,26
10,26,152,33,24,9
10,26,153,12,5,7
10,26,154,11,16,-5
10,26,155,16,10,6
10,26,156,19,10,9
10,26,157,15,17,-2
10,26,158,8,5,3
10,26,159,10,8,2
10,26,160,18,13,5
10,26,161,21,8,13
10,26,162,16,19,-3
10,26,163,27,10,17
10,26,164,15,10,5
10,26,165,10,8,2
10,26,166,21,12,9
10,26,167,23,14,9
10,26,168,17,13,4
10,26,169,21,12,9
10,26,170,13,7,6
10,26,171,16,12,4
10,26,172,19,16,3
10,26,173,18,0,18
10,26,174,11,13,-2
10,26,175,20,18,2
10,26,176,11,11,0
10,26,177,22,9,13
10,26,178,16,9,7
10,26,179,21,15,6
10,26,180,21,25,-4
10,26,181,19,8,11
10,26,182,18,10,8
10,26,183,21,6,15
10,26,184,15,5,10
10,26,185,11,15,-4
10,26,186,12,6,6
10,26,187,11,5,6
10,26,188,11,7,4
10,26,189,14,9,5
10,26,190,22,11,11
10,26,191,13,21,-8
10,26,192,22,21,1
10,26,193,16,14,2
10,26,194,30,13,17
10,26,195,25,21,4
10,26,196,11,8,3
10,26,197,18,14,4
10,26,198,15,22,-7
10,26,199,37,16,21
10,26,200,17,10,7
10,26,201,14,17,-3
10,26,202,17,7,10
10,26,203,24,12,12
10,26,204,30,13,17
10,26,205,28,17,11
10,26,206,14,16,-2
10,26,207,15,10,5
10,26,208,10,16,-6
10,26,209,15,13,2
10,26,210,15,8,7
10,26,211,12,7,5
10,26,212,16,7,9
10,26,213,25,9,16
10,26,214,19,12,7
10,26,215,34,17,17
10,26,216,13,12,1
10,26,217,10,15,-5
10,26,218,19,8,11
10,26,219,19,8,11
10,26,220,21,12,9
10,26,221,30,16,14
10,26,222,20,13,7
10,26,223,23,18,5
10,26,224,26,8,18
10,26,225,16,12,4
10,26,226,18,8,10
10,26,227,16,20,-4
10,26,228,10,13,-3
10,26,229,14,3,11
10,26,230,26,12,14
10,26,231,29,14,15
10,26,232,41,17,24
10,26,233,21,11,10
10,26,234,9,11,-2
10,26,235,9,9,0
10,26,236,31,13,18
10,26,237,13,17,-4
10,26,238,20,12,8
10,26,239,22,20,2
10,26,240,10,9,1
10,26,241,12,10,2
10,26,242,29,14,15
10,26,243,18,3,15
10,26,244,26,13,13
10,26,245,7,13,-6
10,26,246,20,15,5
10,26,247,13,8,5
10,26,248,32,11,21
10,26,249,22,15,7
10,26,250,13,4,9
10,26,251,25,16,9
10,26,252,16,10,6
10,26,253,24,10,14
10,26,254,10,10,0
10,26,255,11,6,5
10,26,256,21,20,1
10,26,257,11,6,5
10,26,258,26,14,12
10,26,259,10,5,5
10,26,260,9,2,7
10,26,261,16,9,7
10,26,262,12,26,-14
10,26,263,11,6,5
10,26,264,14,10,4
10,26,265,23,11,12
10,26,266,17,15,2
10,26,267,23,19,4
10,26,268,18,11,7
10,26,269,24,11,13
10,26,270,18,21,-3
10,26,271,14,7,7
10,26,272,21,23,-2
10,26,273,20,24,-4
10,26,274,6,14,-8
10,26,275,22,15,7
10,26,276,12,14,-2
10,26,277,25,14,11
10,26,278,14,18,-4
10,26,279,20,11,9
10,26,280,17,8,9
10,26,281,19,21,-2
10,26,282,18,15,3
10,26,283,9,7,2
10,26,284,23,24,-1
10,26,285,11,5,6
10,26,286,29,12,17
10,26,287,20,26,-6
10,26,288,14,6,8
10,26,289,34,15,19
10,26,290,21,9,12
10,26,291,22,7,15
10,26,292,8,6,2
10,26,293,10,12,-2
10,26,294,7,12,-5
10,26,295,9,8,1
10,26,296,13,9,4
10,26,297,21,11,10
10,26,298,22,12,10
10,26,299,9,10,-1
10,27,0,11,10,1
10,27,1,36,17,19
10,27,2,14,9,5
10,27,3,29,9,20
10,27,4,24,7,17
10,27,5,22,16,6
10,27,6,14,12,2
10,27,7,26,9,17
10,27,8,32,7,25
10,27,9,15,7,8
10,27,10,9,12,-3
10,27,11,23,9,14
10,27,12,28,19,9
10,27,13,15,11,4
10,27,14,21,19,2
10,27,15,21,10,11
10,27,16,20,16,4
10,27,17,14,9,5
10,27,18,19,17,2
10,27,19,11,7,4
10,27,20,21,10,11
10,27,21,27,8,19
10,27,22,17,9,8
10,27,23,23,13,10
10,27,24,23,10,13
10,27,25,29,18,11
10,27,26,29,3,26
10,27,27,21,11,10
10,27,28,24,12,12
10,27,29,13,5,8
10,27,30,37,15,22
10,27,31,20,19,1
10,27,32,12,8,4
10,27,33,11,9,2
10,27,34,11,6,5
10,27,35,23,13,10
10,27,36,26,24,2
10,27,37,5,4,1
10,27,38,21,17,4
10,27,39,17,15,2
10,27,40,27,6,21
10,27,41,28,26,2
10,27,42,12,6,6
10,27,43,16,8,8
10,27,44,29,10,19
10,27,45,7,9,-2
10,27,46,20,6,14
10,27,47,17,1,16
10,27,48,8,10,-2
10,27,49,28,7,21
10,27,50,9,5,4
10,27,51,20,12,8
10,27,52,17,6,11
10,27,53,21,19,2
10,27,54,24,9,15
10,27,55,23,18,5
10,27,56,19,10,9
10,27,57,18,11,7
10,27,58,6,7,-1
10,27,59,17,16,1
10,27,60,8,6,2
10,27,61,21,7,14
10,27,62,15,9,6
10,27,63,20,7,13
10,27,64,15,14,1
10,27,65,22,10,12
10,27,66,20,3,17
10,27,67,14,4,10
10,27,68,29,14,15
10,27,69,18,5,13
10,27,70,22,4,18
10,27,71,22,15,7
10,27,72,26,10,16
10,27,73,20,9,11
10,27,74,21,17,4
10,27,75,17,10,7
10,27,76,27,8,19
10,27,77,7,6,1
10,27,78,24,8,16
10,27,79,24,15,9
10,27,80,28,17,11
10,27,81,14,15,-1
10,27,82,19,16,3
10,27,83,19,15,4
10,27,84,12,29,-17
10,27,85,9,9,0
10,27,86,17,14,3
10,27,87,22,7,15
10,27,88,32,12,20
10,27,89,27,13,14
10,27,90,20,7,13
10,27,91,17,2,15
10,27,92,18,13,5
10,27,93,20,6,14
10,27,94,26,15,11
10,27,95,20,10,10
10,27,96,6,11,-5
10,27,97,11,8,3
10,27,98,22,5,17
10,27,99,9,12,-3
10,27,100,9,9,0
10,27,101,11,11,0
10,27,102,32,9,23
10,27,103,11,8,3
10,27,104,47,21,26
10,27,105,22,14,8
10,27,106,24,7,17
10,27,107,24,16,8
10,27,108,16,7,9
10,27,109,12,11,1
10,27,110,21,15,6
10,27,111,20,17,3
10,27,112,31,24,7
10,27,113,18,16,2
10,27,114,13,6,7
10,27,115,11,2,9
10,27,116,21,13,8
10,27,117,17,16,1
10,27,118,12,5,7
10,27,119,13,19,-6
10,27,120,17,15,2
10,27,121,17,10,7
10,27,122,24,9,15
10,27,123,23,16,7
10,27,124,26,10,16
10,27,125,8,13,-5
10,27,126,10,12,-2
10,27,127,28,8,20
10,27,128,21,16,5
10,27,129,18,4,14
10,27,130,23,15,8
10,27,131,24,15,9
10,27,132,18,10,8
10,27,133,22,5,17
10,27,134,13,8,5
10,27,135,11,11,0
10,27,136,26,7,19
10,27,137,12,5,7
10,27,138,15,22,-7
10,27,139,22,11,11
10,27,140,23,11,12
10,27,141,34,11,23
10,27,142,34,10,24
10,27,143,10,5,5
10,27,144,23,13,10
10,27,145,13,12,1
10,27,146,23,10,13
10,27,147,22,8,14
10,27,148,13,12,1
10,27,149,12,11,1
10,27,150,13,5,8
10,27,151,24,21,3
10,27,152,10,7,3
10,27,153,32,12,20
10,27,154,18,18,0
10,27,155,12,8,4
10,27,156,29,9,20
10,27,157,23,17,6
10,27,158,15,14,1
10,27,159,23,16,7
10,27,160,13,8,5
10,27,161,8,13,-5
10,27,162,27,14,13
10,27,163,17,9,8
10,27,164,12,14,-2
10,27,165,18,7,11
10,27,166,17,9,8
10,27,167,22,21,1
10,27,168,22,13,9
10,27,169,19,25,-6
10,27,170,23,24,-1
10,27,171,21,3,18
10,27,172,31,15,16
10,27,173,29,15,14
10,27,174,26,9,17
10,27,175,16,14,2
10,27,176,17,9,8
10,27,177,10,8,2
10,27,178,25,13,12
10,27,179,17,12,5
10,27,180,25,17,8
10,27,181,18,9,9
10,27,182,20,15,5
10,27,183,15,10,5
10,27,184,9,14,-5
10,27,185,30,31,-1
10,27,186,18,11,7
10,27,187,15,13,2
10,27,188,21,17,4
10,27,189,16,14,2
10,27,190,30,22,8
10,27,191,23,15,8
10,27,192,11,17,-6
10,27,193,30,11,19
10,27,194,22,13,9
10,27,195,16,5,11
10,27,196,11,8,3
10,27,197,10,11,-1
10,27,198,23,10,13
10,27,199,25,25,0
10,27,200,10,9,1
10,27,201,16,4,12
10,27,202,24,9,15
10,27,203,9,5,4
10,27,204,19,7,12
10,27,205,26,21,5
10,27,206,31,16,15
10,27,207,17,8,9
10,27,208,25,5,20
10,27,209,21,10,11
10,27,210,18,6,12
10,27,211,8,1,7
10,27,212,15,14,1
10,27,213,18,12,6
10,27,214,10,14,-4
10,27,215,12,14,-2
10,27,216,28,13,15
10,27,217,15,5,10
10,27,218,18,6,12
10,27,219,11,8,3
10,27,220,16,10,6
10,27,221,21,6,15
10,27,222,9,6,3
10,27,223,16,8,8
10,27,224,17,12,5
10,27,225,27,11,16
10,27,226,17,9,8
10,27,227,20,7,13
10,27,228,13,15,-2
10,27,229,26,13,13
10,27,230,22,12,10
10,27,231,14,13,1
10,27,232,20,9,11
10,27,233,21,6,15
10,27,234,28,17,11
10,27,235,22,8,14
10,27,236,24,19,5
10,27,237,28,7,21
10,27,238,21,5,16
10,27,239,22,15,7
10,27,240,22,12,10
10,27,241,10,8,2
10,27,242,27,8,19
10,27,243,24,7,17
10,27,244,16,11,5
10,27,245,12,8,4
10,27,246,18,5,13
10,27,247,20,4,16
10,27,248,29,11,18
10,27,249,36,26,10
10,27,250,20,16,4
10,27,251,18,15,3
10,27,252,11,7,4
10,27,253,21,15,6
10,27,254,15,5,10
10,27,255,13,6,7
10,27,256,23,18,5
10,27,257,19,9,10
10,27,258,16,6,10
10,27,259,19,11,8
10,27,260,15,13,2
10,27,261,24,10,14
10,27,262,32,26,6
10,27,263,23,13,10
10,27,264,15,16,-1
10,27,265,8,14,-6
10,27,266,19,16,3
10,27,267,18,7,11
10,27,268,14,12,2
10,27,269,9,23,-14
10,27,270,19,6,13
10,27,271,34,14,20
10,27,272,38,25,13
10,27,273,19,9,10
10,27,274,16,7,9
10,27,275,24,7,17
10,27,276,9,6,3
10,27,277,15,13,2
10,27,278,22,10,12
10,27,279,17,9,8
10,27,280,21,13,8
10,27,281,23,15,8
10,27,282,10,9,1
10,27,283,11,13,-2
10,27,284,21,3,18
10,27,285,28,13,15
10,27,286,23,16,7
10,27,287,18,12,6
10,27,288,15,13,2
10,27,289,19,15,4
10,27,290,16,18,-2
10,27,291,36,11,25
10,27,292,19,15,4
10,27,293,33,22,11
10,27,294,8,13,-5
10,27,295,26,13,13
10,27,296,17,15,2
10,27,297,15,8,7
10,27,298,30,13,17
10,27,299,15,3,12
10,28,0,12,11,1
10,28,1,17,7,10
10,28,2,19,8,11
10,28,3,22,9,13
10,28,4,12,4,8
10,28,5,15,6,9
10,28,6,10,8,2
10,28,7,16,21,-5
10,28,8,10,5,5
10,28,9,22,9,13
10,28,10,19,10,9
10,28,11,18,12,6
10,28,12,18,20,-2
10,28,13,6,17,-11
10,28,14,21,14,7
10,28,15,27,21,6
10,28,16,11,3,8
10,28,17,15,14,1
10,28,18,15,7,8
10,28,19,22,15,7
10,28,20,16,14,2
10,28,21,29,14,15
10,28,22,23,14,9
10,28,23,3,18,-15
10,28,24,28,10,18
10,28,25,18,14,4
10,28,26,27,6,21
10,28,27,30,14,16
10,28,28,10,11,-1
10,28,29,18,2,16
10,28,30,18,23,-5
10,28,31,29,10,19
10,28,32,10,5,5
10,28,33,29,14,15
10,28,34,31,15,16
10,28,35,22,9,13
10,28,36,24,13,11
10,28,37,16,18,-2
10,28,38,19,19,0
10,28,39,15,6,9
10,28,40,21,13,8
10,28,41,33,22,11
10,28,42,16,8,8
10,28,43,9,8,1
10,28,44,15,8,7
10,28,45,14,7,7
10,28,46,30,7,23
10,28,47,13,10,3
10,28,48,11,6,5
10,28,49,25,7,18
10,28,50,16,14,2
10,28,51,18,8,10
10,28,52,9,7,2
10,28,53,27,7,20
10,28,54,15,3,12
10,28,55,25,11,14
10,28,56,15,12,3
10,28,57,22,12,10
10,28,58,18,21,-3
10,28,59,30,12,18
10,28,60,24,1,23
10,28,61,15,4,11
10,28,62,16,10,6
10,28,63,23,9,14
10,28,64,19,10,9
10,28,65,14,34,-20
10,28,66,24,10,14
10,28,67,28,17,11
10,28,68,16,13,3
10,28,69,20,12,8
10,28,70,23,19,4
10,28,71,20,17,3
10,28,72,30,8,22
10,28,73,8,11,-3
10,28,74,15,2,13
10,28,75,14,14,0
10,28,76,32,15,17
10,28,77,6,2,4
10,28,78,14,10,4
10,28,79,15,14,1
10,28,80,12,7,5
10,28,81,19,10,9
10,28,82,20,13,7
10,28,83,17,4,13
10,28,84,27,6,21
10,28,85,16,7,9
10,28,86,19,16,3
10,28,87,15,10,5
10,28,88,15,5,10
10,28,89,22,13,9
10,28,90,24,15,9
10,28,91,17,8,9
10,28,92,14,17,-3
10,28,93,28,14,14
10,28,94,16,9,7
10,28,95,13,10,3
10,28,96,21,14,7
10,28,97,11,1,10
10,28,98,32,12,20
10,28,99,17,7,10
10,28,100,10,19,-9
10,28,101,21,5,16
10,28,102,12,8,4
10,28,103,19,15,4
10,28,104,24,15,9
10,28,105,18,13,5
10,28,106,19,12,7
10,28,107,16,17,-1
10,28,108,14,10,4
10,28,109,15,27,-12
10,28,110,15,8,7
10,28,111,15,12,3
10,28,112,20,5,15
10,28,113,12,11,1
10,28,114,14,10,4
10,28,115,13,11,2
10,28,116,15,12,3
10,28,117,19,6,13
10,28,118,17,14,3
10,28,119,17,21,-4
10,28,120,20,24,-4
10,28,121,9,7,2
10,28,122,18,12,6
10,28,123,11,15,-4
10,28,124,17,7,10
10,28,125,24,16,8
10,28,126,15,13,2
10,28,127,17,19,-2
10,28,128,24,13,11
10,28,129,27,5,22
10,28,130,12,5,7
10,28,131,15,14,1
10,28,132,15,13,2
10,28,133,25,9,16
10,28,134,33,18,15
10,28,135,14,9,5
10,28,136,17,14,3
10,28,137,28,19,9
10,28,138,21,12,9
10,28,139,16,9,7
10,28,140,15,6,9
10,28,141,9,13,-4
10,28,142,11,7,4
10,28,143,12,10,2
10,28,144,23,17,6
10,28,145,23,17,6
10,28,146,11,13,-2
10,28,147,8,11,-3
10,28,148,20,15,5
10,28,149,30,22,8
10,28,150,11,5,6
10,28,151,20,16,4
10,28,152,21,8,13
10,28,153,29,2,27
10,28,154,25,12,13
10,28,155,15,7,8
10,28,156,16,9,7
10,28,157,23,5,18
10,28,158,28,11,17
10,28,159,33,15,18
10,28,160,8,5,3
10,28,161,34,24,10
10,28,162,27,14,13
10,28,163,22,9,13
10,28,164,14,2,12
10,28,165,21,12,9
10,28,166,28,17,11
10,28,167,16,19,-3
10,28,168,29,8,21
10,28,169,19,13,6
10,28,170,24,20,4
10,28,171,22,17,5
10,28,172,24,4,20
10,28,173,25,15,10
10,28,174,6,15,-9
10,28,175,19,19,0
10,28,176,29,16,13
10,28,177,20,17,3
10,28,178,25,9,16
10,28,179,21,20,1
10,28,180,9,2,7
10,28,181,14,14,0
10,28,182,30,17,13
10,28,183,7,11,-4
10,28,184,25,16,9
10,28,185,17,9,8
10,28,186,21,10,11
10,28,187,15,12,3
10,28,188,10,9,1
10,28,189,16,14,2
10,28,190,20,6,14
10,28,191,24,11,13
10,28,192,18,14,4
10,28,193,20,11,9
10,28,194,20,17,3
10,28,195,9,6,3
10,28,196,17,11,6
10,28,197,16,11,5
10,28,198,17,9,8
10,28,199,31,17,14
10,28,200,20,14,6
10,28,201,6,8,-2
10,28,202,20,10,10
10,28,203,14,7,7
10,28,204,10,10,0
10,28,205,26,13,13
10,28,206,12,6,6
10,28,207,24,10,14
10,28,208,16,16,0
10,28,209,15,13,2
10,28,210,22,22,0
10,28,211,5,6,-1
10,28,212,9,10,-1
10,28,213,6,10,-4
10,28,214,30,17,13
10,28,215,18,8,10
10,28,216,18,22,-4
10,28,217,11,7,4
10,28,218,21,9,12
10,28,219,21,11,10
10,28,220,31,15,16
10,28,221,27,9,18
10,28,222,21,4,17
10,28,223,9,10,-1
10,28,224,25,5,20
10,28,225,23,9,14
10,28,226,25,19,6
10,28,227,22,7,15
10,28,228,16,22,-6
10,28,229,30,22,8
10,28,230,18,10,8
10,28,231,17,12,5
10,28,232,17,11,6
10,28,233,22,10,12
10,28,234,7,11,-4
10,28,235,16,2,14
10,28,236,13,9,4
10,28,237,25,22,3
10,28,238,23,8,15
10,28,239,14,14,0
10,28,240,21,18,3
10,28,241,20,10,10
10,28,242,30,11,19
10,28,243,12,6,6
10,28,244,15,8,7
10,28,245,18,12,6
10,28,246,12,8,4
10,28,247,12,22,-10
10,28,248,7,17,-10
10,28,249,22,15,7
10,28,250,11,3,8
10,28,251,21,14,7
10,28,252,31,18,13
10,28,253,24,7,17
10,28,254,29,25,4
10,28,255,31,15,16
10,28,256,9,10,-1
10,28,257,12,9,3
10,28,258,15,9,6
10,28,259,27,11,16
10,28,260,22,13,9
10,28,261,8,11,-3
10,28,262,12,7,5
10,28,263,16,8,8
10,28,264,11,27,-16
10,28,265,15,6,9
10,28,266,14,19,-5
10,28,267,46,17,29
10,28,268,34,15,19
10,28,269,35,15,20
10,28,270,27,15,12
10,28,271,11,11,0
10,28,272,26,7,19
10,28,273,11,11,0
10,28,274,19,6,13
10,28,275,15,11,4
10,28,276,28,9,19
10,28,277,22,2,20
10,28,278,17,14,3
10,28,279,27,11,16
10,28,280,11,11,0
10,28,281,28,10,18
10,28,282,10,4,6
10,28,283,21,16,5
10,28,284,29,18,11
10,28,285,22,10,12
10,28,286,16,17,-1
10,28,287,20,18,2
10,28,288,18,9,9
10,28,289,21,13,8
10,28,290,19,11,8
10,28,291,19,15,4
10,28,292,13,9,4
10,28,293,22,7,15
10,28,294,16,7,9
10,28,295,32,27,5
10,28,296,10,5,5
10,28,297,19,16,3
10,28,298,23,21,2
10,28,299,17,14,3
10,29,0,23,7,16
10,29,1,24,9,15
10,29,2,17,6,11
10,29,3,23,22,1
10,29,4,37,14,23
10,29,5,23,9,14
10,29,6,37,7,30
10,29,7,19,7,12
10,29,8,40,15,25
10,29,9,20,16,4
10,29,10,10,13,-3
10,29,11,22,16,6
10,29,12,24,27,-3
10,29,13,15,4,11
10,29,14,18,11,7
10,29,15,14,7,7
10,29,16,32,12,20
10,29,17,31,12,19
10,29,18,13,10,3
10,29,19,24,10,14
10,29,20,20,12,8
10,29,21,19,11,8
10,29,22,30,10,20
10,29,23,14,9,5
10,29,24,23,6,17
10,29,25,26,14,12
10,29,26,20,2,18
10,29,27,23,18,5
10,29,28,13,4,9
10,29,29,25,15,10
10,29,30,26,19,7
10,29,31,20,11,9
10,29,32,14,7,7
10,29,33,41,18,23
10,29,34,16,8,8
10,29,35,25,12,13
10,29,36,15,9,6
10,29,37,22,4,18
10,29,38,19,25,-6
10,29,39,11,0,11
10,29,40,24,8,16
10,29,41,22,9,13
10,29,42,16,7,9
10,29,43,19,14,5
10,29,44,21,6,15
10,29,45,14,3,11
10,29,46,33,11,22
10,29,47,20,8,12
10,29,48,9,7,2
10,29,49,20,9,11
10,29,50,18,9,9
10,29,51,15,10,5
10,29,52,10,2,8
10,29,53,22,15,7
10,29,54,18,4,14
10,29,55,20,14,6
10,29,56,17,25,-8
10,29,57,15,6,9
10,29,58,20,9,11
10,29,59,29,12,17
10,29,60,22,8,14
10,29,61,19,13,6
10,29,62,17,0,17
10,29,63,7,10,-3
10,29,64,15,7,8
10,29,65,26,9,17
10,29,66,14,15,-1
10,29,67,24,17,7
10,29,68,24,11,13
10,29,69,13,14,-1
10,29,70,17,8,9
10,29,71,15,18,-3
10,29,72,10,4,6
10,29,73,17,6,11
10,29,74,14,17,-3
10,29,75,19,19,0
10,29,76,16,7,9
10,29,77,12,10,2
10,29,78,14,20,-6
10,29,79,12,10,2
10,29,80,24,15,9
10,29,81,28,12,16
10,29,82,12,16,-4
10,29,83,23,10,13
10,29,84,22,19,3
10,29,85,37,11,26
10,29,86,16,12,4
10,29,87,12,7,5
10,29,88,17,17,0
10,29,89,16,10,6
10,29,90,15,15,0
10,29,91,21,6,15
10,29,92,20,19,1
10,29,93,26,11,15
10,29,94,6,9,-3
10,29,95,10,7,3
10,29,96,23,6,17
10,29,97,24,16,8
10,29,98,23,7,16
10,29,99,16,12,4
10,29,100,19,5,14
10,29,101,18,6,12
10,29,102,18,7,11
10,29,103,18,13,5
10,29,104,15,22,-7
10,29,105,21,12,9
10,29,106,23,13,10
10,29,107,24,14,10
10,29,108,27,12,15
10,29,109,21,10,11
10,29,110,19,8,11
10,29,111,21,6,15
10,29,112,12,9,3
10,29,113,24,12,12
10,29,114,19,9,10
10,29,115,14,11,3
10,29,116,13,16,-3
10,29,117,23,10,13
10,29,118,21,19,2
10,29,119,20,7,13
10,29,120,16,9,7
10,29,121,24,13,11
10,29,122,7,3,4
10,29,123,24,11,13
10,29,124,30,13,17
10,29,125,17,13,4
10,29,126,21,8,13
10,29,127,34,12,22
10,29,128,16,13,3
10,29,129,24,19,5
10,29,130,23,8,15
10,29,131,16,5,11
10,29,132,11,10,1
10,29,133,24,8,16
10,29,134,6,9,-3
10,29,135,14,11,3
10,29,136,21,7,14
10,29,137,20,12,8
10,29,138,10,4,6
10,29,139,19,11,8
10,29,140,38,14,24
10,29,141,11,1,10
10,29,142,6,6,0
10,29,143,17,15,2
10,29,144,16,11,5
10,29,145,15,15,0
10,29,146,17,11,6
10,29,147,19,14,5
10,29,148,23,9,14
10,29,149,23,11,12
10,29,150,19,10,9
10,29,151,21,15,6
10,29,152,23,11,12
10,29,153,11,16,-5
10,29,154,15,14,1
10,29,155,11,2,9
10,29,156,21,13,8
10,29,157,8,7,1
10,29,158,28,11,17
10,29,159,15,10,5
10,29,160,4,11,-7
10,29,161,13,8,5
10,29,162,21,5,16
10,29,163,19,7,12
10,29,164,16,13,3
10,29,165,15,1,14
10,29,166,10,9,1
10,29,167,17,10,7
10,29,168,20,13,7
10,29,169,10,11,-1
10,29,170,10,7,3
10,29,171,23,15,8
10,29,172,16,11,5
10,29,173,21,15,6
10,29,174,23,11,12
10,29,175,7,2,5
10,29,176,14,7,7
10,29,177,22,14,8
10,29,178,18,14,4
10,29,179,28,16,12
10,29,180,19,9,10
10,29,181,24,7,17
10,29,182,32,11,21
10,29,183,18,8,10
10,29,184,16,16,0
10,29,185,23,11,12
10,29,186,16,12,4
10,29,187,29,12,17
10,29,188,27,9,18
10,29,189,22,7,15
10,29,190,19,12,7
10,29,191,31,18,13
10,29,192,24,4,20
10,29,193,24,15,9
10,29,194,31,3,28
10,29,195,24,6,18
10,29,196,16,14,2
10,29,197,11,10,1
10,29,198,23,10,13
10,29,199,21,10,11
10,29,200,31,13,18
10,29,201,7,6,1
10,29,202,35,13,22
10,29,203,26,11,15
10,29,204,28,11,17
10,29,205,16,6,10
10,29,206,11,12,-1
10,29,207,16,6,10
10,29,208,15,12,3
10,29,209,16,10,6
10,29,210,16,13,3
10,29,211,19,14,5
10,29,212,15,7,8
10,29,213,24,22,2
10,29,214,20,16,4
10,29,215,16,6,10
10,29,216,29,17,12
10,29,217,14,11,3
10,29,218,13,12,1
10,29,219,21,24,-3
10,29,220,29,8,21
10,29,221,22,8,14
10,29,222,30,10,20
10,29,223,24,9,15
10,29,224,27,11,16
10,29,225,16,2,14
10,29,226,15,10,5
10,29,227,26,12,14
10,29,228,10,10,0
10,29,229,26,10,16
10,29,230,11,8,3
10,29,231,21,10,11
10,29,232,22,14,8
10,29,233,28,11,17
10,29,234,26,10,16
10,29,235,12,8,4
10,29,236,6,3,3
10,29,237,23,3,20
10,29,238,27,13,14
10,29,239,13,9,4
10,29,240,18,4,14
10,29,241,20,5,15
10,29,242,24,13,11
10,29,243,20,12,8
10,29,244,34,11,23
10,29,245,22,21,1
10,29,246,20,7,13
10,29,247,10,13,-3
10,29,248,14,10,4
10,29,249,28,15,13
10,29,250,30,15,15
10,29,251,15,9,6
10,29,252,25,7,18
10,29,253,17,13,4
10,29,254,26,8,18
10,29,255,9,5,4
10,29,256,34,27,7
10,29,257,10,7,3
10,29,258,24,13,11
10,29,259,19,9,10
10,29,260,20,5,15
10,29,261,14,12,2
10,29,262,19,15,4
10,29,263,20,10,10
10,29,264,15,11,4
10,29,265,17,17,0
10,29,266,38,10,28
10,29,267,12,17,-5
10,29,268,20,20,0
10,29,269,17,14,3
10,29,270,15,8,7
10,29,271,29,10,19
10,29,272,14,16,-2
10,29,273,12,5,7
10,29,274,11,5,6
10,29,275,26,12,14
10,29,276,17,13,4
10,29,277,20,15,5
10,29,278,10,8,2
10,29,279,25,17,8
10,29,280,15,9,6
10,29,281,22,18,4
10,29,282,23,8,15
10,29,283,13,9,4
10,29,284,12,5,7
10,29,285,15,10,5
10,29,286,21,13,8
10,29,287,11,11,0
10,29,288,15,5,10
10,29,289,7,5,2
10,29,290,16,11,5
10,29,291,18,7,11
10,29,292,21,9,12
10,29,293,21,13,8
10,29,294,12,7,5
10,29,295,20,13,7
10,29,296,12,20,-8
10,29,297,18,17,1
10,29,298,10,6,4
10,29,299,19,3,16
10,30,0,18,17,1
10,30,1,23,7,16
10,30,2,14,7,7
10,30,3,48,12,36
10,30,4,21,19,2
10,30,5,25,15,10
10,30,6,18,15,3
10,30,7,16,11,5
10,30,8,16,15,1
10,30,9,18,2,16
10,30,10,11,4,7
10,30,11,22,24,-2
10,30,12,17,12,5
10,30,13,6,4,2
10,30,14,16,13,3
10,30,15,20,10,10
10,30,16,13,14,-1
10,30,17,18,7,11
10,30,18,20,9,11
10,30,19,25,19,6
10,30,20,19,7,12
10,30,21,14,11,3
10,30,22,32,18,14
10,30,23,19,7,12
10,30,24,30,8,22
10,30,25,16,18,-2
10,30,26,21,11,10
10,30,27,11,8,3
10,30,28,19,2,17
10,30,29,22,26,-4
10,30,30,15,6,9
10,30,31,39,17,22
10,30,32,16,3,13
10,30,33,15,2,13
10,30,34,14,12,2
10,30,35,6,14,-8
10,30,36,22,14,8
10,30,37,13,8,5
10,30,38,17,11,6
10,30,39,19,17,2
10,30,40,16,13,3
10,30,41,13,13,0
10,30,42,15,4,11
10,30,43,23,16,7
10,30,44,14,6,8
10,30,45,15,6,9
10,30,46,16,11,5
10,30,47,16,11,5
10,30,48,14,3,11
10,30,49,11,9,2
10,30,50,11,13,-2
10,30,51,33,13,20
10,30,52,17,4,13
10,30,53,15,14,1
10,30,54,22,21,1
10,30,55,21,13,8
10,30,56,17,4,13
10,30,57,27,9,18
10,30,58,19,10,9
10,30,59,18,21,-3
10,30,60,28,16,12
10,30,61,23,14,9
10,30,62,23,6,17
10,30,63,15,7,8
10,30,64,21,13,8
10,30,65,28,12,16
10,30,66,7,3,4
10,30,67,10,6,4
10,30,68,38,9,29
10,30,69,12,10,2
10,30,70,23,22,1
10,30,71,17,8,9
10,30,72,14,3,11
10,30,73,17,14,3
10,30,74,13,11,2
10,30,75,26,6,20
10,30,76,16,14,2
10,30,77,17,11,6
10,30,78,30,14,16
10,30,79,27,21,6
10,30,80,14,4,10
10,30,81,11,19,-8
10,30,82,22,10,12
10,30,83,18,13,5
10,30,84,15,9,6
10,30,85,23,10,13
10,30,86,14,9,5
10,30,87,20,9,11
10,30,88,7,6,1
10,30,89,11,18,-7
10,30,90,13,9,4
10,30,91,27,12,15
10,30,92,9,9,0
10,30,93,32,14,18
10,30,94,16,5,11
10,30,95,5,18,-13
10,30,96,15,20,-5
10,30,97,30,5,25
10,30,98,28,14,14
10,30,99,15,12,3
10,30,100,22,11,11
10,30,101,23,9,14
10,30,102,28,8,20
10,30,103,24,11,13
10,30,104,20,17,3
10,30,105,18,12,6
10,30,106,6,9,-3
10,30,107,10,14,-4
10,30,108,17,12,5
10,30,109,18,7,11
10,30,110,21,8,13
10,30,111,16,11,5
10,30,112,11,7,4
10,30,113,24,9,15
10,30,114,19,10,9
10,30,115,14,10,4
10,30,116,16,16,0
10,30,117,26,17,9
10,30,118,24,17,7
10,30,119,25,15,10
10,30,120,22,12,10
10,30,121,22,17,5
10,30,122,10,14,-4
10,30,123,18,15,3
10,30,124,12,10,2
10,30,125,7,4,3
10,30,126,17,9,8
10,30,127,23,10,13
10,30,128,18,4,14
10,30,129,25,10,15
10,30,130,17,7,10
10,30,131,14,22,-8
10,30,132,16,12,4
10,30,133,18,16,2
10,30,134,23,7,16
10,30,135,24,11,13
10,30,136,12,11,1
10,30,137,20,9,11
10,30,138,15,7,8
10,30,139,17,6,11
10,30,140,31,17,14
10,30,141,21,14,7
10,30,142,7,4,3
10,30,143,18,7,11
10,30,144,31,11,20
10,30,145,3,8,-5
10,30,146,15,14,1
10,30,147,21,8,13
10,30,148,9,8,1
10,30,149,24,14,10
10,30,150,17,10,7
10,30,151,15,12,3
10,30,152,17,12,5
10,30,153,22,8,14
10,30,154,15,22,-7
10,30,155,21,25,-4
10,30,156,14,7,7
10,30,157,17,3,14
10,30,158,28,10,18
10,30,159,19,22,-3
10,30,160,9,2,7
10,30,161,4,1,3
10,30,162,12,7,5
10,30,163,22,15,7
10,30,164,11,10,1
10,30,165,14,8,6
10,30,166,23,13,10
10,30,167,12,8,4
10,30,168,13,8,5
10,30,169,23,12,11
10,30,170,25,13,12
10,30,171,13,1,12
10,30,172,14,6,8
10,30,173,19,10,9
10,30,174,13,17,-4
10,30,175,12,8,4
10,30,176,11,11,0
10,30,177,19,9,10
10,30,178,30,8,22
10,30,179,16,18,-2
10,30,180,16,9,7
10,30,181,20,16,4
10,30,182,14,16,-2
10,30,183,11,10,1
10,30,184,12,15,-3
10,30,185,12,6,6
10,30,186,10,11,-1
10,30,187,27,11,16
10,30,188,14,9,5
10,30,189,19,2,17
10,30,190,17,16,1
10,30,191,12,17,-5
10,30,192,24,7,17
10,30,193,4,3,1
10,30,194,12,8,4
10,30,195,15,16,-1
10,30,196,17,4,13
10,30,197,7,5,2
10,30,198,11,7,4
10,30,199,24,11,13
10,30,200,15,6,9
10,30,201,29,6,23
10,30,202,17,2,15
10,30,203,17,9,8
10,30,204,22,14,8
10,30,205,7,19,-12
10,30,206,5,5,0
10,30,207,11,14,-3
10,30,208,21,14,7
10,30,209,15,6,9
10,30,210,21,12,9
10,30,211,19,12,7
10,30,212,29,10,19
10,30,213,22,9,13
10,30,214,14,12,2
10,30,215,9,7,2
10,30,216,19,10,9
10,30,217,16,4,12
10,30,218,13,9,4
10,30,219,20,10,10
10,30,220,26,11,15
10,30,221,10,3,7
10,30,222,22,28,-6
10,30,223,24,9,15
10,30,224,24,17,7
10,30,225,21,6,15
10,30,226,12,2,10
10,30,227,14,11,3
10,30,228,29,7,22
10,30,229,29,12,17
10,30,230,16,8,8
10,30,231,24,15,9
10,30,232,15,10,5
10,30,233,10,5,5
10,30,234,11,8,3
10,30,235,15,4,11
10,30,236,19,21,-2
10,30,237,25,5,20
10,30,238,21,15,6
10,30,239,13,15,-2
10,30,240,23,16,7
10,30,241,14,9,5
10,30,242,32,7,25
10,30,243,27,30,-3
10,30,244,13,6,7
10,30,245,7,11,-4
10,30,246,15,5,10
10,30,247,15,13,2
10,30,248,22,0,22
10,30,249,21,15,6
10,30,250,23,15,8
10,30,251,20,10,10
10,30,252,10,10,0
10,30,253,14,10,4
10,30,254,29,8,21
10,30,255,32,15,17
10,30,256,18,7,11
10,30,257,12,15,-3
10,30,258,19,11,8
10,30,259,7,6,1
10,30,260,9,5,4
10,30,261,28,16,12
10,30,262,11,9,2
10,30,263,16,14,2
10,30,264,23,9,14
10,30,265,18,5,13
10,30,266,11,7,4
10,30,267,14,10,4
10,30,268,18,7,11
10,30,269,32,11,21
10,30,270,10,11,-1
10,30,271,13,8,5
10,30,272,32,6,26
10,30,273,20,26,-6
10,30,274,19,17,2
10,30,275,21,3,18
10,30,276,28,13,15
10,30,277,30,19,11
10,30,278,14,4,10
10,30,279,28,9,19
10,30,280,21,10,11
10,30,281,11,8,3
10,30,282,22,19,3
10,30,283,23,7,16
10,30,284,15,8,7
10,30,285,18,20,-2
10,30,286,34,15,19
10,30,287,25,16,9
10,30,288,14,5,9
10,30,289,13,17,-4
10,30,290,21,15,6
10,30,291,16,12,4
10,30,292,17,8,9
10,30,293,8,14,-6
10,30,294,15,12,3
10,30,295,17,9,8
10,30,296,14,15,-1
10,30,297,15,11,4
10,30,298,8,17,-9
10,30,299,11,9,2
